Gemeinde,Altersklassen,Geschlecht,Männer,Frauen,Insgesamt
001 Aldein,0,,9,11,20
001 Aldein,1,,13,6,19
001 Aldein,2,,12,10,22
001 Aldein,3,,8,12,20
001 Aldein,4,,7,7,14
001 Aldein,5,,7,6,13
001 Aldein,6,,9,17,26
001 Aldein,7,,12,9,21
001 Aldein,8,,11,7,18
001 Aldein,9,,11,10,21
001 Aldein,10,,12,12,24
001 Aldein,11,,10,7,17
001 Aldein,12,,14,12,26
001 Aldein,13,,18,7,25
001 Aldein,14,,10,16,26
001 Aldein,15,,10,15,25
001 Aldein,16,,10,20,30
001 Aldein,17,,10,9,19
001 Aldein,18,,8,23,31
001 Aldein,19,,15,17,32
001 Aldein,20,,17,19,36
001 Aldein,21,,11,20,31
001 Aldein,22,,16,14,30
001 Aldein,23,,18,12,30
001 Aldein,24,,17,25,42
001 Aldein,25,,18,18,36
001 Aldein,26,,21,9,30
001 Aldein,27,,12,16,28
001 Aldein,28,,9,20,29
001 Aldein,29,,11,19,30
001 Aldein,30,,21,10,31
001 Aldein,31,,15,9,24
001 Aldein,32,,15,6,21
001 Aldein,33,,9,13,22
001 Aldein,34,,16,16,32
001 Aldein,35,,17,10,27
001 Aldein,36,,13,14,27
001 Aldein,37,,8,5,13
001 Aldein,38,,9,10,19
001 Aldein,39,,11,10,21
001 Aldein,40,,10,10,20
001 Aldein,41,,10,7,17
001 Aldein,42,,8,9,17
001 Aldein,43,,6,4,10
001 Aldein,44,,15,10,25
001 Aldein,45,,6,12,18
001 Aldein,46,,10,6,16
001 Aldein,47,,9,9,18
001 Aldein,48,,4,10,14
001 Aldein,49,,7,11,18
001 Aldein,50,,7,5,12
001 Aldein,51,,6,7,13
001 Aldein,52,,11,11,22
001 Aldein,53,,10,13,23
001 Aldein,54,,8,12,20
001 Aldein,55,,9,9,18
001 Aldein,56,,4,8,12
001 Aldein,57,,6,8,14
001 Aldein,58,,7,9,16
001 Aldein,59,,10,6,16
001 Aldein,60,,4,4,8
001 Aldein,61,,17,5,22
001 Aldein,62,,9,4,13
001 Aldein,63,,5,8,13
001 Aldein,64,,11,3,14
001 Aldein,65,,7,6,13
001 Aldein,66,,9,10,19
001 Aldein,67,,6,4,10
001 Aldein,68,,9,6,15
001 Aldein,69,,4,8,12
001 Aldein,70,,3,9,12
001 Aldein,71,,5,8,13
001 Aldein,72,,3,6,9
001 Aldein,73,,3,9,12
001 Aldein,74,,8,15,23
001 Aldein,75,,7,3,10
001 Aldein,76,,2,5,7
001 Aldein,77,,3,3,6
001 Aldein,78,,-,3,3
001 Aldein,79,,2,2,4
001 Aldein,80,,4,3,7
001 Aldein,81,,1,2,3
001 Aldein,82,,2,6,8
001 Aldein,83,,3,3,6
001 Aldein,84,,2,3,5
001 Aldein,85,,2,3,5
001 Aldein,86,,2,1,3
001 Aldein,87,,-,2,2
001 Aldein,88,,1,1,2
001 Aldein,89,,1,2,3
001 Aldein,91,,-,2,2
001 Aldein,92,,1,-,1
001 Aldein,93,,-,1,1
002 Andrian,0,,7,5,12
002 Andrian,1,,5,4,9
002 Andrian,2,,6,6,12
002 Andrian,3,,7,6,13
002 Andrian,4,,7,7,14
002 Andrian,5,,5,4,9
002 Andrian,6,,5,5,10
002 Andrian,7,,12,6,18
002 Andrian,8,,6,7,13
002 Andrian,9,,8,6,14
002 Andrian,10,,1,4,5
002 Andrian,11,,6,4,10
002 Andrian,12,,5,2,7
002 Andrian,13,,10,7,17
002 Andrian,14,,1,3,4
002 Andrian,15,,5,2,7
002 Andrian,16,,5,3,8
002 Andrian,17,,4,4,8
002 Andrian,18,,5,3,8
002 Andrian,19,,6,4,10
002 Andrian,20,,4,2,6
002 Andrian,21,,5,3,8
002 Andrian,22,,5,5,10
002 Andrian,23,,4,4,8
002 Andrian,24,,6,11,17
002 Andrian,25,,10,9,19
002 Andrian,26,,4,7,11
002 Andrian,27,,7,7,14
002 Andrian,28,,7,6,13
002 Andrian,29,,8,11,19
002 Andrian,30,,11,7,18
002 Andrian,31,,6,5,11
002 Andrian,32,,6,12,18
002 Andrian,33,,7,5,12
002 Andrian,34,,7,2,9
002 Andrian,35,,6,4,10
002 Andrian,36,,7,3,10
002 Andrian,37,,7,8,15
002 Andrian,38,,5,9,14
002 Andrian,39,,6,9,15
002 Andrian,40,,1,4,5
002 Andrian,41,,7,2,9
002 Andrian,42,,6,7,13
002 Andrian,43,,3,3,6
002 Andrian,44,,4,3,7
002 Andrian,45,,7,6,13
002 Andrian,46,,4,1,5
002 Andrian,47,,8,5,13
002 Andrian,48,,5,4,9
002 Andrian,49,,3,7,10
002 Andrian,50,,1,2,3
002 Andrian,51,,2,4,6
002 Andrian,52,,5,7,12
002 Andrian,53,,4,5,9
002 Andrian,54,,6,4,10
002 Andrian,55,,5,9,14
002 Andrian,56,,1,8,9
002 Andrian,57,,4,4,8
002 Andrian,58,,6,4,10
002 Andrian,59,,2,3,5
002 Andrian,60,,3,3,6
002 Andrian,61,,5,3,8
002 Andrian,62,,3,4,7
002 Andrian,63,,8,5,13
002 Andrian,64,,3,5,8
002 Andrian,65,,3,1,4
002 Andrian,66,,2,1,3
002 Andrian,67,,3,5,8
002 Andrian,68,,2,2,4
002 Andrian,69,,4,4,8
002 Andrian,70,,2,1,3
002 Andrian,71,,2,5,7
002 Andrian,72,,1,3,4
002 Andrian,73,,1,5,6
002 Andrian,74,,1,4,5
002 Andrian,75,,1,1,2
002 Andrian,76,,3,4,7
002 Andrian,77,,2,2,4
002 Andrian,79,,1,-,1
002 Andrian,80,,1,2,3
002 Andrian,81,,1,3,4
002 Andrian,82,,1,2,3
002 Andrian,83,,-,2,2
002 Andrian,84,,-,1,1
002 Andrian,85,,-,1,1
002 Andrian,86,,2,1,3
002 Andrian,87,,1,1,2
002 Andrian,88,,2,2,4
002 Andrian,90,,-,1,1
002 Andrian,92,,-,2,2
003 Altrei,0,,1,1,2
003 Altrei,1,,4,2,6
003 Altrei,2,,3,-,3
003 Altrei,3,,5,2,7
003 Altrei,4,,1,1,2
003 Altrei,5,,2,2,4
003 Altrei,6,,2,2,4
003 Altrei,7,,4,4,8
003 Altrei,8,,2,1,3
003 Altrei,9,,3,3,6
003 Altrei,10,,2,2,4
003 Altrei,11,,3,1,4
003 Altrei,12,,4,2,6
003 Altrei,13,,2,2,4
003 Altrei,14,,3,2,5
003 Altrei,15,,3,4,7
003 Altrei,16,,-,1,1
003 Altrei,17,,2,4,6
003 Altrei,18,,1,4,5
003 Altrei,19,,2,3,5
003 Altrei,20,,2,1,3
003 Altrei,21,,1,1,2
003 Altrei,22,,2,3,5
003 Altrei,23,,2,-,2
003 Altrei,24,,5,4,9
003 Altrei,25,,2,2,4
003 Altrei,26,,3,5,8
003 Altrei,27,,-,2,2
003 Altrei,28,,2,1,3
003 Altrei,29,,4,5,9
003 Altrei,30,,2,5,7
003 Altrei,31,,3,4,7
003 Altrei,32,,3,3,6
003 Altrei,33,,9,1,10
003 Altrei,34,,3,3,6
003 Altrei,35,,5,3,8
003 Altrei,36,,5,2,7
003 Altrei,37,,1,3,4
003 Altrei,38,,1,3,4
003 Altrei,39,,5,1,6
003 Altrei,40,,3,3,6
003 Altrei,41,,1,1,2
003 Altrei,42,,3,2,5
003 Altrei,43,,6,3,9
003 Altrei,44,,6,4,10
003 Altrei,45,,1,2,3
003 Altrei,46,,2,-,2
003 Altrei,47,,3,3,6
003 Altrei,48,,2,2,4
003 Altrei,49,,-,2,2
003 Altrei,50,,4,-,4
003 Altrei,51,,2,2,4
003 Altrei,52,,1,3,4
003 Altrei,53,,3,1,4
003 Altrei,54,,1,2,3
003 Altrei,55,,2,4,6
003 Altrei,56,,1,3,4
003 Altrei,57,,1,-,1
003 Altrei,58,,2,1,3
003 Altrei,59,,2,1,3
003 Altrei,60,,3,2,5
003 Altrei,61,,-,2,2
003 Altrei,62,,3,3,6
003 Altrei,63,,-,3,3
003 Altrei,64,,-,2,2
003 Altrei,65,,5,2,7
003 Altrei,66,,2,3,5
003 Altrei,67,,1,3,4
003 Altrei,68,,3,4,7
003 Altrei,69,,1,4,5
003 Altrei,70,,-,3,3
003 Altrei,71,,1,3,4
003 Altrei,72,,1,3,4
003 Altrei,73,,3,2,5
003 Altrei,74,,-,3,3
003 Altrei,75,,3,1,4
003 Altrei,76,,-,2,2
003 Altrei,77,,-,2,2
003 Altrei,78,,-,3,3
003 Altrei,80,,-,1,1
003 Altrei,81,,1,3,4
003 Altrei,82,,1,1,2
003 Altrei,83,,3,-,3
003 Altrei,84,,1,2,3
003 Altrei,86,,1,1,2
003 Altrei,87,,-,1,1
003 Altrei,89,,1,-,1
003 Altrei,90,,-,1,1
003 Altrei,91,,1,-,1
003 Altrei,95,,-,1,1
003 Altrei,96,,-,1,1
004 Eppan a.d. Weinstr.,0,,59,58,117
004 Eppan a.d. Weinstr.,1,,73,66,139
004 Eppan a.d. Weinstr.,2,,72,82,154
004 Eppan a.d. Weinstr.,3,,65,64,129
004 Eppan a.d. Weinstr.,4,,68,59,127
004 Eppan a.d. Weinstr.,5,,78,61,139
004 Eppan a.d. Weinstr.,6,,77,58,135
004 Eppan a.d. Weinstr.,7,,77,72,149
004 Eppan a.d. Weinstr.,8,,73,60,133
004 Eppan a.d. Weinstr.,9,,78,66,144
004 Eppan a.d. Weinstr.,10,,75,55,130
004 Eppan a.d. Weinstr.,11,,80,71,151
004 Eppan a.d. Weinstr.,12,,62,62,124
004 Eppan a.d. Weinstr.,13,,65,66,131
004 Eppan a.d. Weinstr.,14,,53,72,125
004 Eppan a.d. Weinstr.,15,,74,63,137
004 Eppan a.d. Weinstr.,16,,67,58,125
004 Eppan a.d. Weinstr.,17,,77,65,142
004 Eppan a.d. Weinstr.,18,,77,50,127
004 Eppan a.d. Weinstr.,19,,70,64,134
004 Eppan a.d. Weinstr.,20,,77,72,149
004 Eppan a.d. Weinstr.,21,,65,86,151
004 Eppan a.d. Weinstr.,22,,76,79,155
004 Eppan a.d. Weinstr.,23,,79,98,177
004 Eppan a.d. Weinstr.,24,,101,78,179
004 Eppan a.d. Weinstr.,25,,105,110,215
004 Eppan a.d. Weinstr.,26,,106,106,212
004 Eppan a.d. Weinstr.,27,,101,100,201
004 Eppan a.d. Weinstr.,28,,124,105,229
004 Eppan a.d. Weinstr.,29,,104,123,227
004 Eppan a.d. Weinstr.,30,,108,107,215
004 Eppan a.d. Weinstr.,31,,119,102,221
004 Eppan a.d. Weinstr.,32,,102,122,224
004 Eppan a.d. Weinstr.,33,,109,99,208
004 Eppan a.d. Weinstr.,34,,124,97,221
004 Eppan a.d. Weinstr.,35,,95,111,206
004 Eppan a.d. Weinstr.,36,,114,98,212
004 Eppan a.d. Weinstr.,37,,97,92,189
004 Eppan a.d. Weinstr.,38,,101,86,187
004 Eppan a.d. Weinstr.,39,,80,69,149
004 Eppan a.d. Weinstr.,40,,84,90,174
004 Eppan a.d. Weinstr.,41,,69,89,158
004 Eppan a.d. Weinstr.,42,,78,75,153
004 Eppan a.d. Weinstr.,43,,70,79,149
004 Eppan a.d. Weinstr.,44,,80,68,148
004 Eppan a.d. Weinstr.,45,,63,72,135
004 Eppan a.d. Weinstr.,46,,65,60,125
004 Eppan a.d. Weinstr.,47,,81,72,153
004 Eppan a.d. Weinstr.,48,,69,83,152
004 Eppan a.d. Weinstr.,49,,83,72,155
004 Eppan a.d. Weinstr.,50,,64,52,116
004 Eppan a.d. Weinstr.,51,,72,86,158
004 Eppan a.d. Weinstr.,52,,96,79,175
004 Eppan a.d. Weinstr.,53,,100,79,179
004 Eppan a.d. Weinstr.,54,,68,104,172
004 Eppan a.d. Weinstr.,55,,81,63,144
004 Eppan a.d. Weinstr.,56,,59,80,139
004 Eppan a.d. Weinstr.,57,,67,50,117
004 Eppan a.d. Weinstr.,58,,47,57,104
004 Eppan a.d. Weinstr.,59,,50,52,102
004 Eppan a.d. Weinstr.,60,,45,45,90
004 Eppan a.d. Weinstr.,61,,37,59,96
004 Eppan a.d. Weinstr.,62,,61,62,123
004 Eppan a.d. Weinstr.,63,,49,56,105
004 Eppan a.d. Weinstr.,64,,47,59,106
004 Eppan a.d. Weinstr.,65,,55,70,125
004 Eppan a.d. Weinstr.,66,,56,59,115
004 Eppan a.d. Weinstr.,67,,53,54,107
004 Eppan a.d. Weinstr.,68,,40,50,90
004 Eppan a.d. Weinstr.,69,,51,48,99
004 Eppan a.d. Weinstr.,70,,44,64,108
004 Eppan a.d. Weinstr.,71,,34,77,111
004 Eppan a.d. Weinstr.,72,,32,52,84
004 Eppan a.d. Weinstr.,73,,28,54,82
004 Eppan a.d. Weinstr.,74,,31,51,82
004 Eppan a.d. Weinstr.,75,,24,35,59
004 Eppan a.d. Weinstr.,76,,20,41,61
004 Eppan a.d. Weinstr.,77,,15,24,39
004 Eppan a.d. Weinstr.,78,,16,14,30
004 Eppan a.d. Weinstr.,79,,18,21,39
004 Eppan a.d. Weinstr.,80,,20,21,41
004 Eppan a.d. Weinstr.,81,,20,44,64
004 Eppan a.d. Weinstr.,82,,13,37,50
004 Eppan a.d. Weinstr.,83,,12,24,36
004 Eppan a.d. Weinstr.,84,,8,35,43
004 Eppan a.d. Weinstr.,85,,4,22,26
004 Eppan a.d. Weinstr.,86,,7,16,23
004 Eppan a.d. Weinstr.,87,,6,15,21
004 Eppan a.d. Weinstr.,88,,7,13,20
004 Eppan a.d. Weinstr.,89,,4,7,11
004 Eppan a.d. Weinstr.,90,,1,13,14
004 Eppan a.d. Weinstr.,91,,2,10,12
004 Eppan a.d. Weinstr.,92,,-,4,4
004 Eppan a.d. Weinstr.,93,,-,4,4
004 Eppan a.d. Weinstr.,94,,1,3,4
004 Eppan a.d. Weinstr.,95,,1,3,4
004 Eppan a.d. Weinstr.,96,,-,1,1
004 Eppan a.d. Weinstr.,97,,1,-,1
004 Eppan a.d. Weinstr.,98,,-,1,1
004 Eppan a.d. Weinstr.,99,,-,1,1
004 Eppan a.d. Weinstr.,101,,-,1,1
005 Hafling,0,,8,6,14
005 Hafling,1,,5,7,12
005 Hafling,2,,3,8,11
005 Hafling,3,,3,5,8
005 Hafling,4,,9,2,11
005 Hafling,5,,5,6,11
005 Hafling,6,,5,2,7
005 Hafling,7,,2,7,9
005 Hafling,8,,4,3,7
005 Hafling,9,,4,3,7
005 Hafling,10,,5,5,10
005 Hafling,11,,6,7,13
005 Hafling,12,,3,-,3
005 Hafling,13,,7,2,9
005 Hafling,14,,4,4,8
005 Hafling,15,,3,9,12
005 Hafling,16,,4,5,9
005 Hafling,17,,2,4,6
005 Hafling,18,,3,3,6
005 Hafling,19,,4,6,10
005 Hafling,20,,6,4,10
005 Hafling,21,,7,8,15
005 Hafling,22,,7,4,11
005 Hafling,23,,6,3,9
005 Hafling,24,,9,4,13
005 Hafling,25,,6,7,13
005 Hafling,26,,6,10,16
005 Hafling,27,,5,12,17
005 Hafling,28,,6,4,10
005 Hafling,29,,9,7,16
005 Hafling,30,,6,10,16
005 Hafling,31,,4,3,7
005 Hafling,32,,6,4,10
005 Hafling,33,,4,2,6
005 Hafling,34,,7,4,11
005 Hafling,35,,9,6,15
005 Hafling,36,,7,5,12
005 Hafling,37,,3,5,8
005 Hafling,38,,2,5,7
005 Hafling,39,,3,9,12
005 Hafling,40,,5,1,6
005 Hafling,41,,4,1,5
005 Hafling,42,,2,3,5
005 Hafling,43,,6,2,8
005 Hafling,44,,2,2,4
005 Hafling,45,,4,3,7
005 Hafling,46,,5,3,8
005 Hafling,47,,8,2,10
005 Hafling,48,,3,4,7
005 Hafling,49,,1,4,5
005 Hafling,50,,5,2,7
005 Hafling,51,,1,2,3
005 Hafling,52,,6,4,10
005 Hafling,53,,5,3,8
005 Hafling,54,,5,4,9
005 Hafling,55,,2,1,3
005 Hafling,56,,3,5,8
005 Hafling,57,,2,3,5
005 Hafling,58,,4,2,6
005 Hafling,59,,1,2,3
005 Hafling,60,,1,1,2
005 Hafling,61,,1,4,5
005 Hafling,62,,6,3,9
005 Hafling,63,,4,4,8
005 Hafling,64,,3,6,9
005 Hafling,65,,2,4,6
005 Hafling,66,,4,1,5
005 Hafling,67,,3,3,6
005 Hafling,68,,4,5,9
005 Hafling,69,,1,2,3
005 Hafling,70,,2,-,2
005 Hafling,71,,1,3,4
005 Hafling,72,,1,-,1
005 Hafling,73,,-,2,2
005 Hafling,74,,-,4,4
005 Hafling,75,,3,1,4
005 Hafling,76,,1,3,4
005 Hafling,77,,-,2,2
005 Hafling,78,,-,1,1
005 Hafling,79,,1,2,3
005 Hafling,80,,2,-,2
005 Hafling,81,,1,-,1
005 Hafling,82,,-,3,3
005 Hafling,83,,-,1,1
005 Hafling,84,,1,2,3
005 Hafling,85,,1,-,1
005 Hafling,86,,2,-,2
005 Hafling,89,,-,1,1
005 Hafling,91,,2,-,2
006 Abtei,0,,25,26,51
006 Abtei,1,,18,14,32
006 Abtei,2,,16,19,35
006 Abtei,3,,24,14,38
006 Abtei,4,,20,14,34
006 Abtei,5,,22,15,37
006 Abtei,6,,15,14,29
006 Abtei,7,,13,8,21
006 Abtei,8,,19,12,31
006 Abtei,9,,16,17,33
006 Abtei,10,,11,13,24
006 Abtei,11,,11,20,31
006 Abtei,12,,15,11,26
006 Abtei,13,,17,20,37
006 Abtei,14,,18,18,36
006 Abtei,15,,23,15,38
006 Abtei,16,,10,23,33
006 Abtei,17,,21,25,46
006 Abtei,18,,19,28,47
006 Abtei,19,,24,23,47
006 Abtei,20,,18,27,45
006 Abtei,21,,19,26,45
006 Abtei,22,,20,24,44
006 Abtei,23,,37,27,64
006 Abtei,24,,16,32,48
006 Abtei,25,,27,31,58
006 Abtei,26,,27,33,60
006 Abtei,27,,22,32,54
006 Abtei,28,,32,35,67
006 Abtei,29,,20,28,48
006 Abtei,30,,30,21,51
006 Abtei,31,,24,31,55
006 Abtei,32,,25,27,52
006 Abtei,33,,25,28,53
006 Abtei,34,,21,27,48
006 Abtei,35,,24,20,44
006 Abtei,36,,26,22,48
006 Abtei,37,,17,24,41
006 Abtei,38,,18,16,34
006 Abtei,39,,20,17,37
006 Abtei,40,,16,14,30
006 Abtei,41,,11,16,27
006 Abtei,42,,16,18,34
006 Abtei,43,,12,12,24
006 Abtei,44,,12,12,24
006 Abtei,45,,15,20,35
006 Abtei,46,,13,19,32
006 Abtei,47,,25,17,42
006 Abtei,48,,16,15,31
006 Abtei,49,,27,18,45
006 Abtei,50,,16,20,36
006 Abtei,51,,14,18,32
006 Abtei,52,,14,11,25
006 Abtei,53,,19,11,30
006 Abtei,54,,18,24,42
006 Abtei,55,,19,19,38
006 Abtei,56,,17,13,30
006 Abtei,57,,15,18,33
006 Abtei,58,,9,19,28
006 Abtei,59,,22,10,32
006 Abtei,60,,13,20,33
006 Abtei,61,,15,18,33
006 Abtei,62,,12,17,29
006 Abtei,63,,9,6,15
006 Abtei,64,,13,14,27
006 Abtei,65,,18,13,31
006 Abtei,66,,12,8,20
006 Abtei,67,,10,16,26
006 Abtei,68,,9,10,19
006 Abtei,69,,12,7,19
006 Abtei,70,,12,7,19
006 Abtei,71,,6,11,17
006 Abtei,72,,9,17,26
006 Abtei,73,,8,6,14
006 Abtei,74,,5,7,12
006 Abtei,75,,4,16,20
006 Abtei,76,,2,5,7
006 Abtei,77,,3,4,7
006 Abtei,78,,-,6,6
006 Abtei,79,,1,3,4
006 Abtei,80,,1,4,5
006 Abtei,81,,3,5,8
006 Abtei,82,,3,3,6
006 Abtei,83,,3,9,12
006 Abtei,84,,2,6,8
006 Abtei,85,,2,8,10
006 Abtei,86,,4,6,10
006 Abtei,87,,1,5,6
006 Abtei,88,,-,2,2
006 Abtei,89,,1,2,3
006 Abtei,90,,-,3,3
006 Abtei,91,,1,-,1
006 Abtei,92,,1,1,2
006 Abtei,93,,3,1,4
006 Abtei,95,,1,1,2
006 Abtei,99,,-,1,1
007 Barbian,0,,11,9,20
007 Barbian,1,,9,3,12
007 Barbian,2,,11,15,26
007 Barbian,3,,11,10,21
007 Barbian,4,,11,10,21
007 Barbian,5,,14,13,27
007 Barbian,6,,8,13,21
007 Barbian,7,,11,5,16
007 Barbian,8,,8,6,14
007 Barbian,9,,13,6,19
007 Barbian,10,,8,10,18
007 Barbian,11,,9,7,16
007 Barbian,12,,11,8,19
007 Barbian,13,,10,5,15
007 Barbian,14,,14,15,29
007 Barbian,15,,8,7,15
007 Barbian,16,,18,13,31
007 Barbian,17,,11,9,20
007 Barbian,18,,7,16,23
007 Barbian,19,,7,11,18
007 Barbian,20,,10,11,21
007 Barbian,21,,16,10,26
007 Barbian,22,,9,16,25
007 Barbian,23,,18,20,38
007 Barbian,24,,16,16,32
007 Barbian,25,,11,12,23
007 Barbian,26,,17,7,24
007 Barbian,27,,13,10,23
007 Barbian,28,,7,10,17
007 Barbian,29,,12,12,24
007 Barbian,30,,9,9,18
007 Barbian,31,,12,15,27
007 Barbian,32,,16,14,30
007 Barbian,33,,17,14,31
007 Barbian,34,,18,9,27
007 Barbian,35,,13,15,28
007 Barbian,36,,10,8,18
007 Barbian,37,,11,6,17
007 Barbian,38,,13,7,20
007 Barbian,39,,5,10,15
007 Barbian,40,,11,8,19
007 Barbian,41,,5,14,19
007 Barbian,42,,10,7,17
007 Barbian,43,,7,4,11
007 Barbian,44,,7,11,18
007 Barbian,45,,12,11,23
007 Barbian,46,,6,5,11
007 Barbian,47,,4,4,8
007 Barbian,48,,6,10,16
007 Barbian,49,,17,7,24
007 Barbian,50,,8,4,12
007 Barbian,51,,12,9,21
007 Barbian,52,,9,6,15
007 Barbian,53,,11,13,24
007 Barbian,54,,9,14,23
007 Barbian,55,,8,3,11
007 Barbian,56,,7,6,13
007 Barbian,57,,5,10,15
007 Barbian,58,,9,8,17
007 Barbian,59,,5,8,13
007 Barbian,60,,3,8,11
007 Barbian,61,,5,6,11
007 Barbian,62,,8,5,13
007 Barbian,63,,5,8,13
007 Barbian,64,,6,10,16
007 Barbian,65,,7,6,13
007 Barbian,66,,9,8,17
007 Barbian,67,,5,10,15
007 Barbian,68,,7,4,11
007 Barbian,69,,5,4,9
007 Barbian,70,,11,3,14
007 Barbian,71,,4,6,10
007 Barbian,72,,3,10,13
007 Barbian,73,,3,6,9
007 Barbian,74,,3,3,6
007 Barbian,75,,4,4,8
007 Barbian,76,,2,4,6
007 Barbian,77,,4,1,5
007 Barbian,78,,-,1,1
007 Barbian,79,,1,3,4
007 Barbian,80,,-,5,5
007 Barbian,81,,4,6,10
007 Barbian,82,,2,4,6
007 Barbian,83,,-,1,1
007 Barbian,84,,3,3,6
007 Barbian,85,,3,4,7
007 Barbian,86,,-,1,1
007 Barbian,87,,-,3,3
007 Barbian,88,,-,1,1
007 Barbian,91,,-,1,1
008 Bozen,0,,387,356,743
008 Bozen,1,,413,391,804
008 Bozen,2,,395,390,785
008 Bozen,3,,390,374,764
008 Bozen,4,,446,364,810
008 Bozen,5,,426,375,801
008 Bozen,6,,411,367,778
008 Bozen,7,,399,396,795
008 Bozen,8,,337,369,706
008 Bozen,9,,367,343,710
008 Bozen,10,,391,357,748
008 Bozen,11,,369,371,740
008 Bozen,12,,396,343,739
008 Bozen,13,,403,383,786
008 Bozen,14,,403,379,782
008 Bozen,15,,445,385,830
008 Bozen,16,,386,411,797
008 Bozen,17,,442,415,857
008 Bozen,18,,476,420,896
008 Bozen,19,,491,487,978
008 Bozen,20,,579,558,1.137
008 Bozen,21,,635,614,1.249
008 Bozen,22,,676,693,1.369
008 Bozen,23,,745,687,1.432
008 Bozen,24,,857,788,1.645
008 Bozen,25,,818,663,1.481
008 Bozen,26,,890,743,1.633
008 Bozen,27,,808,736,1.544
008 Bozen,28,,808,758,1.566
008 Bozen,29,,894,806,1.700
008 Bozen,30,,889,802,1.691
008 Bozen,31,,905,881,1.786
008 Bozen,32,,823,763,1.586
008 Bozen,33,,802,752,1.554
008 Bozen,34,,777,719,1.496
008 Bozen,35,,711,671,1.382
008 Bozen,36,,700,646,1.346
008 Bozen,37,,697,684,1.381
008 Bozen,38,,662,703,1.365
008 Bozen,39,,668,655,1.323
008 Bozen,40,,633,636,1.269
008 Bozen,41,,636,600,1.236
008 Bozen,42,,565,606,1.171
008 Bozen,43,,586,644,1.230
008 Bozen,44,,571,653,1.224
008 Bozen,45,,641,685,1.326
008 Bozen,46,,659,665,1.324
008 Bozen,47,,687,730,1.417
008 Bozen,48,,711,844,1.555
008 Bozen,49,,795,916,1.711
008 Bozen,50,,591,635,1.226
008 Bozen,51,,653,767,1.420
008 Bozen,52,,707,773,1.480
008 Bozen,53,,717,780,1.497
008 Bozen,54,,811,822,1.633
008 Bozen,55,,746,784,1.530
008 Bozen,56,,678,779,1.457
008 Bozen,57,,752,703,1.455
008 Bozen,58,,629,630,1.259
008 Bozen,59,,582,630,1.212
008 Bozen,60,,562,612,1.174
008 Bozen,61,,578,617,1.195
008 Bozen,62,,496,610,1.106
008 Bozen,63,,525,621,1.146
008 Bozen,64,,526,627,1.153
008 Bozen,65,,540,638,1.178
008 Bozen,66,,437,626,1.063
008 Bozen,67,,460,580,1.040
008 Bozen,68,,446,586,1.032
008 Bozen,69,,511,575,1.086
008 Bozen,70,,411,598,1.009
008 Bozen,71,,401,601,1.002
008 Bozen,72,,428,619,1.047
008 Bozen,73,,409,648,1.057
008 Bozen,74,,340,608,948
008 Bozen,75,,349,596,945
008 Bozen,76,,200,373,573
008 Bozen,77,,126,248,374
008 Bozen,78,,147,259,406
008 Bozen,79,,149,265,414
008 Bozen,80,,208,382,590
008 Bozen,81,,224,375,599
008 Bozen,82,,219,393,612
008 Bozen,83,,189,382,571
008 Bozen,84,,146,308,454
008 Bozen,85,,106,251,357
008 Bozen,86,,97,235,332
008 Bozen,87,,82,200,282
008 Bozen,88,,48,172,220
008 Bozen,89,,53,135,188
008 Bozen,90,,30,96,126
008 Bozen,91,,17,93,110
008 Bozen,92,,13,72,85
008 Bozen,93,,12,43,55
008 Bozen,94,,9,32,41
008 Bozen,95,,4,26,30
008 Bozen,96,,8,13,21
008 Bozen,97,,2,14,16
008 Bozen,98,,2,4,6
008 Bozen,99,,-,4,4
008 Bozen,100,,1,3,4
008 Bozen,101,,1,-,1
008 Bozen,102,,-,2,2
009 Prags,0,,3,3,6
009 Prags,1,,4,6,10
009 Prags,2,,7,4,11
009 Prags,3,,6,3,9
009 Prags,4,,7,2,9
009 Prags,5,,4,2,6
009 Prags,6,,9,3,12
009 Prags,7,,3,3,6
009 Prags,8,,3,3,6
009 Prags,9,,5,6,11
009 Prags,10,,8,2,10
009 Prags,11,,5,3,8
009 Prags,12,,3,7,10
009 Prags,13,,3,5,8
009 Prags,14,,1,6,7
009 Prags,15,,4,1,5
009 Prags,16,,2,1,3
009 Prags,17,,6,3,9
009 Prags,18,,4,2,6
009 Prags,19,,5,4,9
009 Prags,20,,2,7,9
009 Prags,21,,4,3,7
009 Prags,22,,8,8,16
009 Prags,23,,3,1,4
009 Prags,24,,6,6,12
009 Prags,25,,6,3,9
009 Prags,26,,7,5,12
009 Prags,27,,8,6,14
009 Prags,28,,8,8,16
009 Prags,29,,7,4,11
009 Prags,30,,9,7,16
009 Prags,31,,7,5,12
009 Prags,32,,7,6,13
009 Prags,33,,4,6,10
009 Prags,34,,5,8,13
009 Prags,35,,7,3,10
009 Prags,36,,12,6,18
009 Prags,37,,6,3,9
009 Prags,38,,5,3,8
009 Prags,39,,3,6,9
009 Prags,40,,3,4,7
009 Prags,41,,6,4,10
009 Prags,42,,4,2,6
009 Prags,43,,3,5,8
009 Prags,44,,3,1,4
009 Prags,45,,5,1,6
009 Prags,46,,1,2,3
009 Prags,47,,5,1,6
009 Prags,48,,1,-,1
009 Prags,49,,2,4,6
009 Prags,50,,2,2,4
009 Prags,51,,5,5,10
009 Prags,52,,1,5,6
009 Prags,53,,4,4,8
009 Prags,54,,5,2,7
009 Prags,55,,1,3,4
009 Prags,56,,3,5,8
009 Prags,57,,5,3,8
009 Prags,58,,1,3,4
009 Prags,59,,2,2,4
009 Prags,60,,2,4,6
009 Prags,61,,4,2,6
009 Prags,62,,5,2,7
009 Prags,63,,6,7,13
009 Prags,64,,1,4,5
009 Prags,65,,2,1,3
009 Prags,66,,5,-,5
009 Prags,67,,3,2,5
009 Prags,68,,3,7,10
009 Prags,69,,2,4,6
009 Prags,70,,2,5,7
009 Prags,71,,4,2,6
009 Prags,72,,-,5,5
009 Prags,73,,3,2,5
009 Prags,74,,2,3,5
009 Prags,75,,1,1,2
009 Prags,76,,3,4,7
009 Prags,77,,-,1,1
009 Prags,78,,2,2,4
009 Prags,79,,-,1,1
009 Prags,80,,1,2,3
009 Prags,81,,2,2,4
009 Prags,82,,-,2,2
009 Prags,83,,-,1,1
009 Prags,84,,-,1,1
009 Prags,86,,1,-,1
009 Prags,87,,-,2,2
009 Prags,88,,-,1,1
009 Prags,91,,2,-,2
009 Prags,100,,-,1,1
010 Brenner,0,,9,10,19
010 Brenner,1,,18,8,26
010 Brenner,2,,8,7,15
010 Brenner,3,,9,7,16
010 Brenner,4,,8,17,25
010 Brenner,5,,13,8,21
010 Brenner,6,,15,4,19
010 Brenner,7,,12,5,17
010 Brenner,8,,8,9,17
010 Brenner,9,,11,11,22
010 Brenner,10,,20,11,31
010 Brenner,11,,14,15,29
010 Brenner,12,,16,17,33
010 Brenner,13,,12,7,19
010 Brenner,14,,9,15,24
010 Brenner,15,,12,15,27
010 Brenner,16,,13,9,22
010 Brenner,17,,16,11,27
010 Brenner,18,,17,11,28
010 Brenner,19,,12,10,22
010 Brenner,20,,12,19,31
010 Brenner,21,,16,12,28
010 Brenner,22,,19,14,33
010 Brenner,23,,32,21,53
010 Brenner,24,,39,15,54
010 Brenner,25,,25,24,49
010 Brenner,26,,16,19,35
010 Brenner,27,,22,20,42
010 Brenner,28,,22,20,42
010 Brenner,29,,26,16,42
010 Brenner,30,,28,20,48
010 Brenner,31,,32,17,49
010 Brenner,32,,18,21,39
010 Brenner,33,,20,12,32
010 Brenner,34,,27,12,39
010 Brenner,35,,23,17,40
010 Brenner,36,,22,15,37
010 Brenner,37,,20,11,31
010 Brenner,38,,20,18,38
010 Brenner,39,,22,13,35
010 Brenner,40,,14,11,25
010 Brenner,41,,12,15,27
010 Brenner,42,,11,18,29
010 Brenner,43,,21,9,30
010 Brenner,44,,20,11,31
010 Brenner,45,,14,14,28
010 Brenner,46,,16,16,32
010 Brenner,47,,6,8,14
010 Brenner,48,,21,13,34
010 Brenner,49,,13,17,30
010 Brenner,50,,10,8,18
010 Brenner,51,,22,13,35
010 Brenner,52,,22,14,36
010 Brenner,53,,9,10,19
010 Brenner,54,,13,13,26
010 Brenner,55,,13,12,25
010 Brenner,56,,12,8,20
010 Brenner,57,,12,18,30
010 Brenner,58,,10,14,24
010 Brenner,59,,15,7,22
010 Brenner,60,,7,6,13
010 Brenner,61,,12,8,20
010 Brenner,62,,7,8,15
010 Brenner,63,,2,3,5
010 Brenner,64,,10,11,21
010 Brenner,65,,9,12,21
010 Brenner,66,,13,11,24
010 Brenner,67,,13,11,24
010 Brenner,68,,10,5,15
010 Brenner,69,,11,11,22
010 Brenner,70,,6,12,18
010 Brenner,71,,6,10,16
010 Brenner,72,,5,11,16
010 Brenner,73,,2,9,11
010 Brenner,74,,4,6,10
010 Brenner,75,,7,9,16
010 Brenner,76,,3,2,5
010 Brenner,77,,2,2,4
010 Brenner,78,,1,6,7
010 Brenner,79,,2,-,2
010 Brenner,80,,3,3,6
010 Brenner,81,,1,7,8
010 Brenner,82,,2,5,7
010 Brenner,83,,-,6,6
010 Brenner,84,,5,1,6
010 Brenner,85,,1,5,6
010 Brenner,86,,2,3,5
010 Brenner,87,,2,-,2
010 Brenner,88,,-,1,1
010 Brenner,89,,-,4,4
010 Brenner,90,,1,1,2
010 Brenner,91,,-,1,1
010 Brenner,92,,-,2,2
010 Brenner,93,,1,1,2
010 Brenner,94,,1,1,2
011 Brixen,0,,102,106,208
011 Brixen,1,,111,117,228
011 Brixen,2,,98,101,199
011 Brixen,3,,98,114,212
011 Brixen,4,,104,106,210
011 Brixen,5,,89,103,192
011 Brixen,6,,109,84,193
011 Brixen,7,,104,90,194
011 Brixen,8,,96,83,179
011 Brixen,9,,97,102,199
011 Brixen,10,,113,83,196
011 Brixen,11,,107,81,188
011 Brixen,12,,108,117,225
011 Brixen,13,,116,99,215
011 Brixen,14,,104,92,196
011 Brixen,15,,95,98,193
011 Brixen,16,,115,94,209
011 Brixen,17,,89,98,187
011 Brixen,18,,115,104,219
011 Brixen,19,,123,112,235
011 Brixen,20,,104,96,200
011 Brixen,21,,127,124,251
011 Brixen,22,,123,135,258
011 Brixen,23,,142,139,281
011 Brixen,24,,146,162,308
011 Brixen,25,,156,138,294
011 Brixen,26,,179,165,344
011 Brixen,27,,158,160,318
011 Brixen,28,,159,152,311
011 Brixen,29,,167,173,340
011 Brixen,30,,185,140,325
011 Brixen,31,,179,179,358
011 Brixen,32,,152,151,303
011 Brixen,33,,151,153,304
011 Brixen,34,,151,150,301
011 Brixen,35,,146,142,288
011 Brixen,36,,145,140,285
011 Brixen,37,,154,107,261
011 Brixen,38,,133,130,263
011 Brixen,39,,96,130,226
011 Brixen,40,,126,92,218
011 Brixen,41,,95,105,200
011 Brixen,42,,81,106,187
011 Brixen,43,,107,99,206
011 Brixen,44,,102,101,203
011 Brixen,45,,109,102,211
011 Brixen,46,,86,126,212
011 Brixen,47,,117,117,234
011 Brixen,48,,92,111,203
011 Brixen,49,,107,118,225
011 Brixen,50,,71,98,169
011 Brixen,51,,121,103,224
011 Brixen,52,,140,122,262
011 Brixen,53,,104,104,208
011 Brixen,54,,118,119,237
011 Brixen,55,,94,123,217
011 Brixen,56,,103,111,214
011 Brixen,57,,96,97,193
011 Brixen,58,,89,99,188
011 Brixen,59,,78,91,169
011 Brixen,60,,86,89,175
011 Brixen,61,,89,99,188
011 Brixen,62,,87,72,159
011 Brixen,63,,76,83,159
011 Brixen,64,,80,89,169
011 Brixen,65,,82,100,182
011 Brixen,66,,64,103,167
011 Brixen,67,,69,81,150
011 Brixen,68,,59,103,162
011 Brixen,69,,67,83,150
011 Brixen,70,,60,87,147
011 Brixen,71,,54,94,148
011 Brixen,72,,58,74,132
011 Brixen,73,,55,95,150
011 Brixen,74,,48,91,139
011 Brixen,75,,44,84,128
011 Brixen,76,,38,59,97
011 Brixen,77,,22,38,60
011 Brixen,78,,24,47,71
011 Brixen,79,,18,31,49
011 Brixen,80,,17,49,66
011 Brixen,81,,36,57,93
011 Brixen,82,,19,65,84
011 Brixen,83,,23,60,83
011 Brixen,84,,18,48,66
011 Brixen,85,,17,46,63
011 Brixen,86,,13,32,45
011 Brixen,87,,16,34,50
011 Brixen,88,,6,27,33
011 Brixen,89,,3,26,29
011 Brixen,90,,5,25,30
011 Brixen,91,,1,5,6
011 Brixen,92,,4,6,10
011 Brixen,93,,2,12,14
011 Brixen,94,,1,15,16
011 Brixen,95,,-,11,11
011 Brixen,96,,1,2,3
011 Brixen,97,,1,-,1
011 Brixen,98,,1,1,2
011 Brixen,100,,-,1,1
011 Brixen,101,,-,1,1
011 Brixen,103,,1,1,2
012 Branzoll,0,,11,11,22
012 Branzoll,1,,15,8,23
012 Branzoll,2,,16,16,32
012 Branzoll,3,,14,9,23
012 Branzoll,4,,9,18,27
012 Branzoll,5,,7,17,24
012 Branzoll,6,,11,11,22
012 Branzoll,7,,16,13,29
012 Branzoll,8,,10,7,17
012 Branzoll,9,,8,14,22
012 Branzoll,10,,14,15,29
012 Branzoll,11,,15,11,26
012 Branzoll,12,,13,11,24
012 Branzoll,13,,14,11,25
012 Branzoll,14,,11,13,24
012 Branzoll,15,,7,13,20
012 Branzoll,16,,10,6,16
012 Branzoll,17,,10,11,21
012 Branzoll,18,,10,10,20
012 Branzoll,19,,16,11,27
012 Branzoll,20,,10,9,19
012 Branzoll,21,,14,18,32
012 Branzoll,22,,19,13,32
012 Branzoll,23,,15,10,25
012 Branzoll,24,,16,9,25
012 Branzoll,25,,12,23,35
012 Branzoll,26,,19,15,34
012 Branzoll,27,,19,18,37
012 Branzoll,28,,19,14,33
012 Branzoll,29,,15,18,33
012 Branzoll,30,,19,21,40
012 Branzoll,31,,31,20,51
012 Branzoll,32,,17,17,34
012 Branzoll,33,,19,19,38
012 Branzoll,34,,24,27,51
012 Branzoll,35,,21,21,42
012 Branzoll,36,,13,24,37
012 Branzoll,37,,19,17,36
012 Branzoll,38,,26,17,43
012 Branzoll,39,,15,12,27
012 Branzoll,40,,12,16,28
012 Branzoll,41,,24,16,40
012 Branzoll,42,,13,23,36
012 Branzoll,43,,16,15,31
012 Branzoll,44,,13,12,25
012 Branzoll,45,,19,15,34
012 Branzoll,46,,14,15,29
012 Branzoll,47,,13,15,28
012 Branzoll,48,,13,16,29
012 Branzoll,49,,15,18,33
012 Branzoll,50,,14,6,20
012 Branzoll,51,,10,9,19
012 Branzoll,52,,15,11,26
012 Branzoll,53,,20,7,27
012 Branzoll,54,,20,12,32
012 Branzoll,55,,10,13,23
012 Branzoll,56,,16,13,29
012 Branzoll,57,,10,11,21
012 Branzoll,58,,6,12,18
012 Branzoll,59,,10,11,21
012 Branzoll,60,,9,11,20
012 Branzoll,61,,7,11,18
012 Branzoll,62,,19,12,31
012 Branzoll,63,,10,11,21
012 Branzoll,64,,5,9,14
012 Branzoll,65,,10,17,27
012 Branzoll,66,,7,12,19
012 Branzoll,67,,9,13,22
012 Branzoll,68,,4,9,13
012 Branzoll,69,,12,11,23
012 Branzoll,70,,7,8,15
012 Branzoll,71,,4,10,14
012 Branzoll,72,,10,13,23
012 Branzoll,73,,6,6,12
012 Branzoll,74,,6,12,18
012 Branzoll,75,,1,7,8
012 Branzoll,76,,4,6,10
012 Branzoll,77,,4,5,9
012 Branzoll,78,,-,4,4
012 Branzoll,79,,3,2,5
012 Branzoll,80,,3,3,6
012 Branzoll,81,,1,5,6
012 Branzoll,82,,4,8,12
012 Branzoll,83,,1,5,6
012 Branzoll,84,,4,4,8
012 Branzoll,85,,1,2,3
012 Branzoll,86,,2,5,7
012 Branzoll,87,,1,2,3
012 Branzoll,88,,3,2,5
012 Branzoll,89,,1,-,1
012 Branzoll,90,,-,2,2
012 Branzoll,91,,-,1,1
012 Branzoll,92,,-,1,1
012 Branzoll,93,,-,1,1
012 Branzoll,94,,-,1,1
012 Branzoll,96,,1,-,1
013 Bruneck,0,,61,66,127
013 Bruneck,1,,81,69,150
013 Bruneck,2,,73,67,140
013 Bruneck,3,,83,73,156
013 Bruneck,4,,80,56,136
013 Bruneck,5,,85,70,155
013 Bruneck,6,,74,74,148
013 Bruneck,7,,62,70,132
013 Bruneck,8,,59,61,120
013 Bruneck,9,,101,69,170
013 Bruneck,10,,72,62,134
013 Bruneck,11,,77,72,149
013 Bruneck,12,,67,73,140
013 Bruneck,13,,71,73,144
013 Bruneck,14,,79,86,165
013 Bruneck,15,,98,88,186
013 Bruneck,16,,85,95,180
013 Bruneck,17,,112,84,196
013 Bruneck,18,,100,77,177
013 Bruneck,19,,86,96,182
013 Bruneck,20,,94,109,203
013 Bruneck,21,,113,93,206
013 Bruneck,22,,117,103,220
013 Bruneck,23,,115,107,222
013 Bruneck,24,,127,102,229
013 Bruneck,25,,105,108,213
013 Bruneck,26,,119,106,225
013 Bruneck,27,,106,130,236
013 Bruneck,28,,125,109,234
013 Bruneck,29,,118,98,216
013 Bruneck,30,,141,125,266
013 Bruneck,31,,117,119,236
013 Bruneck,32,,110,114,224
013 Bruneck,33,,114,100,214
013 Bruneck,34,,118,102,220
013 Bruneck,35,,96,114,210
013 Bruneck,36,,104,94,198
013 Bruneck,37,,101,108,209
013 Bruneck,38,,84,97,181
013 Bruneck,39,,84,97,181
013 Bruneck,40,,81,81,162
013 Bruneck,41,,93,85,178
013 Bruneck,42,,71,96,167
013 Bruneck,43,,83,99,182
013 Bruneck,44,,75,92,167
013 Bruneck,45,,86,93,179
013 Bruneck,46,,91,91,182
013 Bruneck,47,,85,109,194
013 Bruneck,48,,98,69,167
013 Bruneck,49,,103,84,187
013 Bruneck,50,,59,67,126
013 Bruneck,51,,92,93,185
013 Bruneck,52,,99,91,190
013 Bruneck,53,,97,91,188
013 Bruneck,54,,85,92,177
013 Bruneck,55,,85,86,171
013 Bruneck,56,,88,86,174
013 Bruneck,57,,64,56,120
013 Bruneck,58,,60,64,124
013 Bruneck,59,,58,55,113
013 Bruneck,60,,49,57,106
013 Bruneck,61,,51,51,102
013 Bruneck,62,,60,61,121
013 Bruneck,63,,63,51,114
013 Bruneck,64,,45,52,97
013 Bruneck,65,,46,71,117
013 Bruneck,66,,48,60,108
013 Bruneck,67,,48,62,110
013 Bruneck,68,,41,52,93
013 Bruneck,69,,38,44,82
013 Bruneck,70,,36,52,88
013 Bruneck,71,,27,66,93
013 Bruneck,72,,44,53,97
013 Bruneck,73,,36,51,87
013 Bruneck,74,,28,34,62
013 Bruneck,75,,24,52,76
013 Bruneck,76,,22,37,59
013 Bruneck,77,,11,26,37
013 Bruneck,78,,9,23,32
013 Bruneck,79,,11,33,44
013 Bruneck,80,,14,25,39
013 Bruneck,81,,15,32,47
013 Bruneck,82,,17,47,64
013 Bruneck,83,,17,31,48
013 Bruneck,84,,9,36,45
013 Bruneck,85,,10,25,35
013 Bruneck,86,,16,19,35
013 Bruneck,87,,10,15,25
013 Bruneck,88,,8,17,25
013 Bruneck,89,,5,15,20
013 Bruneck,90,,3,6,9
013 Bruneck,91,,5,2,7
013 Bruneck,92,,3,7,10
013 Bruneck,93,,-,5,5
013 Bruneck,94,,-,1,1
013 Bruneck,95,,-,3,3
013 Bruneck,96,,1,2,3
013 Bruneck,97,,-,2,2
013 Bruneck,98,,-,1,1
014 Kuens,0,,2,4,6
014 Kuens,1,,1,4,5
014 Kuens,2,,3,3,6
014 Kuens,3,,4,2,6
014 Kuens,4,,2,2,4
014 Kuens,5,,3,3,6
014 Kuens,6,,2,3,5
014 Kuens,7,,1,4,5
014 Kuens,8,,3,1,4
014 Kuens,9,,1,-,1
014 Kuens,11,,1,-,1
014 Kuens,12,,2,2,4
014 Kuens,13,,2,-,2
014 Kuens,14,,2,1,3
014 Kuens,15,,3,2,5
014 Kuens,16,,1,1,2
014 Kuens,17,,2,-,2
014 Kuens,18,,2,3,5
014 Kuens,19,,3,2,5
014 Kuens,20,,3,2,5
014 Kuens,21,,4,5,9
014 Kuens,22,,-,3,3
014 Kuens,23,,4,3,7
014 Kuens,24,,2,4,6
014 Kuens,25,,6,4,10
014 Kuens,26,,4,-,4
014 Kuens,27,,4,5,9
014 Kuens,28,,4,9,13
014 Kuens,29,,3,5,8
014 Kuens,30,,6,1,7
014 Kuens,31,,5,4,9
014 Kuens,32,,10,3,13
014 Kuens,33,,5,3,8
014 Kuens,34,,-,4,4
014 Kuens,35,,-,2,2
014 Kuens,36,,1,-,1
014 Kuens,37,,1,4,5
014 Kuens,38,,5,-,5
014 Kuens,39,,2,-,2
014 Kuens,40,,1,1,2
014 Kuens,42,,1,1,2
014 Kuens,43,,-,1,1
014 Kuens,44,,1,-,1
014 Kuens,45,,1,3,4
014 Kuens,46,,2,2,4
014 Kuens,47,,3,1,4
014 Kuens,48,,1,2,3
014 Kuens,49,,1,2,3
014 Kuens,50,,5,-,5
014 Kuens,52,,-,2,2
014 Kuens,53,,-,4,4
014 Kuens,54,,-,2,2
014 Kuens,55,,-,1,1
014 Kuens,56,,4,3,7
014 Kuens,57,,3,2,5
014 Kuens,58,,1,3,4
014 Kuens,59,,2,3,5
014 Kuens,60,,1,3,4
014 Kuens,61,,-,1,1
014 Kuens,62,,2,1,3
014 Kuens,63,,4,2,6
014 Kuens,64,,3,2,5
014 Kuens,65,,3,2,5
014 Kuens,66,,1,-,1
014 Kuens,67,,1,-,1
014 Kuens,68,,1,2,3
014 Kuens,69,,1,-,1
014 Kuens,70,,1,-,1
014 Kuens,73,,-,2,2
014 Kuens,74,,-,1,1
014 Kuens,76,,-,1,1
014 Kuens,79,,1,1,2
014 Kuens,80,,1,-,1
014 Kuens,82,,-,1,1
014 Kuens,83,,1,-,1
014 Kuens,85,,1,-,1
014 Kuens,87,,-,1,1
014 Kuens,88,,-,1,1
015 Kaltern a.d. Weinstr.,0,,37,36,73
015 Kaltern a.d. Weinstr.,1,,26,36,62
015 Kaltern a.d. Weinstr.,2,,35,38,73
015 Kaltern a.d. Weinstr.,3,,41,37,78
015 Kaltern a.d. Weinstr.,4,,30,40,70
015 Kaltern a.d. Weinstr.,5,,35,37,72
015 Kaltern a.d. Weinstr.,6,,52,27,79
015 Kaltern a.d. Weinstr.,7,,38,33,71
015 Kaltern a.d. Weinstr.,8,,41,32,73
015 Kaltern a.d. Weinstr.,9,,52,41,93
015 Kaltern a.d. Weinstr.,10,,47,35,82
015 Kaltern a.d. Weinstr.,11,,38,33,71
015 Kaltern a.d. Weinstr.,12,,42,37,79
015 Kaltern a.d. Weinstr.,13,,43,43,86
015 Kaltern a.d. Weinstr.,14,,45,34,79
015 Kaltern a.d. Weinstr.,15,,39,41,80
015 Kaltern a.d. Weinstr.,16,,44,38,82
015 Kaltern a.d. Weinstr.,17,,41,29,70
015 Kaltern a.d. Weinstr.,18,,27,37,64
015 Kaltern a.d. Weinstr.,19,,37,42,79
015 Kaltern a.d. Weinstr.,20,,30,41,71
015 Kaltern a.d. Weinstr.,21,,47,42,89
015 Kaltern a.d. Weinstr.,22,,36,47,83
015 Kaltern a.d. Weinstr.,23,,45,48,93
015 Kaltern a.d. Weinstr.,24,,47,38,85
015 Kaltern a.d. Weinstr.,25,,55,59,114
015 Kaltern a.d. Weinstr.,26,,48,62,110
015 Kaltern a.d. Weinstr.,27,,57,64,121
015 Kaltern a.d. Weinstr.,28,,52,57,109
015 Kaltern a.d. Weinstr.,29,,57,63,120
015 Kaltern a.d. Weinstr.,30,,55,58,113
015 Kaltern a.d. Weinstr.,31,,80,53,133
015 Kaltern a.d. Weinstr.,32,,61,55,116
015 Kaltern a.d. Weinstr.,33,,58,65,123
015 Kaltern a.d. Weinstr.,34,,68,62,130
015 Kaltern a.d. Weinstr.,35,,59,62,121
015 Kaltern a.d. Weinstr.,36,,52,53,105
015 Kaltern a.d. Weinstr.,37,,57,58,115
015 Kaltern a.d. Weinstr.,38,,49,51,100
015 Kaltern a.d. Weinstr.,39,,63,45,108
015 Kaltern a.d. Weinstr.,40,,57,37,94
015 Kaltern a.d. Weinstr.,41,,39,49,88
015 Kaltern a.d. Weinstr.,42,,37,38,75
015 Kaltern a.d. Weinstr.,43,,40,51,91
015 Kaltern a.d. Weinstr.,44,,36,35,71
015 Kaltern a.d. Weinstr.,45,,44,35,79
015 Kaltern a.d. Weinstr.,46,,32,39,71
015 Kaltern a.d. Weinstr.,47,,41,38,79
015 Kaltern a.d. Weinstr.,48,,40,56,96
015 Kaltern a.d. Weinstr.,49,,54,39,93
015 Kaltern a.d. Weinstr.,50,,36,38,74
015 Kaltern a.d. Weinstr.,51,,45,45,90
015 Kaltern a.d. Weinstr.,52,,35,37,72
015 Kaltern a.d. Weinstr.,53,,39,45,84
015 Kaltern a.d. Weinstr.,54,,45,44,89
015 Kaltern a.d. Weinstr.,55,,35,39,74
015 Kaltern a.d. Weinstr.,56,,24,33,57
015 Kaltern a.d. Weinstr.,57,,42,44,86
015 Kaltern a.d. Weinstr.,58,,30,33,63
015 Kaltern a.d. Weinstr.,59,,24,24,48
015 Kaltern a.d. Weinstr.,60,,28,25,53
015 Kaltern a.d. Weinstr.,61,,26,26,52
015 Kaltern a.d. Weinstr.,62,,31,37,68
015 Kaltern a.d. Weinstr.,63,,31,32,63
015 Kaltern a.d. Weinstr.,64,,29,40,69
015 Kaltern a.d. Weinstr.,65,,37,44,81
015 Kaltern a.d. Weinstr.,66,,28,33,61
015 Kaltern a.d. Weinstr.,67,,26,35,61
015 Kaltern a.d. Weinstr.,68,,24,41,65
015 Kaltern a.d. Weinstr.,69,,23,34,57
015 Kaltern a.d. Weinstr.,70,,26,40,66
015 Kaltern a.d. Weinstr.,71,,28,37,65
015 Kaltern a.d. Weinstr.,72,,20,35,55
015 Kaltern a.d. Weinstr.,73,,20,34,54
015 Kaltern a.d. Weinstr.,74,,21,41,62
015 Kaltern a.d. Weinstr.,75,,15,31,46
015 Kaltern a.d. Weinstr.,76,,10,20,30
015 Kaltern a.d. Weinstr.,77,,9,12,21
015 Kaltern a.d. Weinstr.,78,,4,16,20
015 Kaltern a.d. Weinstr.,79,,4,11,15
015 Kaltern a.d. Weinstr.,80,,3,21,24
015 Kaltern a.d. Weinstr.,81,,13,21,34
015 Kaltern a.d. Weinstr.,82,,11,22,33
015 Kaltern a.d. Weinstr.,83,,10,31,41
015 Kaltern a.d. Weinstr.,84,,7,15,22
015 Kaltern a.d. Weinstr.,85,,5,12,17
015 Kaltern a.d. Weinstr.,86,,5,17,22
015 Kaltern a.d. Weinstr.,87,,5,7,12
015 Kaltern a.d. Weinstr.,88,,2,12,14
015 Kaltern a.d. Weinstr.,89,,2,7,9
015 Kaltern a.d. Weinstr.,90,,1,4,5
015 Kaltern a.d. Weinstr.,91,,3,8,11
015 Kaltern a.d. Weinstr.,92,,1,5,6
015 Kaltern a.d. Weinstr.,93,,1,1,2
015 Kaltern a.d. Weinstr.,94,,-,1,1
015 Kaltern a.d. Weinstr.,95,,-,1,1
015 Kaltern a.d. Weinstr.,97,,-,1,1
015 Kaltern a.d. Weinstr.,101,,-,1,1
015 Kaltern a.d. Weinstr.,102,,-,1,1
016 Freienfeld,0,,17,12,29
016 Freienfeld,1,,11,7,18
016 Freienfeld,2,,16,10,26
016 Freienfeld,3,,20,23,43
016 Freienfeld,4,,12,14,26
016 Freienfeld,5,,19,19,38
016 Freienfeld,6,,27,21,48
016 Freienfeld,7,,18,14,32
016 Freienfeld,8,,14,15,29
016 Freienfeld,9,,16,15,31
016 Freienfeld,10,,15,14,29
016 Freienfeld,11,,24,15,39
016 Freienfeld,12,,20,19,39
016 Freienfeld,13,,14,18,32
016 Freienfeld,14,,24,23,47
016 Freienfeld,15,,18,15,33
016 Freienfeld,16,,19,22,41
016 Freienfeld,17,,14,18,32
016 Freienfeld,18,,15,19,34
016 Freienfeld,19,,17,10,27
016 Freienfeld,20,,18,23,41
016 Freienfeld,21,,20,18,38
016 Freienfeld,22,,20,16,36
016 Freienfeld,23,,21,22,43
016 Freienfeld,24,,25,24,49
016 Freienfeld,25,,21,21,42
016 Freienfeld,26,,20,18,38
016 Freienfeld,27,,20,26,46
016 Freienfeld,28,,20,30,50
016 Freienfeld,29,,22,20,42
016 Freienfeld,30,,30,15,45
016 Freienfeld,31,,26,23,49
016 Freienfeld,32,,23,15,38
016 Freienfeld,33,,25,31,56
016 Freienfeld,34,,24,20,44
016 Freienfeld,35,,24,22,46
016 Freienfeld,36,,28,14,42
016 Freienfeld,37,,17,21,38
016 Freienfeld,38,,14,17,31
016 Freienfeld,39,,22,15,37
016 Freienfeld,40,,21,10,31
016 Freienfeld,41,,18,19,37
016 Freienfeld,42,,20,10,30
016 Freienfeld,43,,12,20,32
016 Freienfeld,44,,16,13,29
016 Freienfeld,45,,24,11,35
016 Freienfeld,46,,18,12,30
016 Freienfeld,47,,18,12,30
016 Freienfeld,48,,7,14,21
016 Freienfeld,49,,12,16,28
016 Freienfeld,50,,11,2,13
016 Freienfeld,51,,12,6,18
016 Freienfeld,52,,15,12,27
016 Freienfeld,53,,13,10,23
016 Freienfeld,54,,13,12,25
016 Freienfeld,55,,13,4,17
016 Freienfeld,56,,12,10,22
016 Freienfeld,57,,12,12,24
016 Freienfeld,58,,8,11,19
016 Freienfeld,59,,9,15,24
016 Freienfeld,60,,11,12,23
016 Freienfeld,61,,7,7,14
016 Freienfeld,62,,13,8,21
016 Freienfeld,63,,14,10,24
016 Freienfeld,64,,9,8,17
016 Freienfeld,65,,9,9,18
016 Freienfeld,66,,6,7,13
016 Freienfeld,67,,10,8,18
016 Freienfeld,68,,8,9,17
016 Freienfeld,69,,9,16,25
016 Freienfeld,70,,9,11,20
016 Freienfeld,71,,10,9,19
016 Freienfeld,72,,3,18,21
016 Freienfeld,73,,3,10,13
016 Freienfeld,74,,4,3,7
016 Freienfeld,75,,10,5,15
016 Freienfeld,76,,4,5,9
016 Freienfeld,77,,3,5,8
016 Freienfeld,78,,3,4,7
016 Freienfeld,79,,2,4,6
016 Freienfeld,80,,1,5,6
016 Freienfeld,81,,5,10,15
016 Freienfeld,82,,3,3,6
016 Freienfeld,83,,1,3,4
016 Freienfeld,84,,4,4,8
016 Freienfeld,85,,5,1,6
016 Freienfeld,86,,3,2,5
016 Freienfeld,87,,-,5,5
016 Freienfeld,88,,3,4,7
016 Freienfeld,89,,-,3,3
016 Freienfeld,90,,-,3,3
016 Freienfeld,91,,1,1,2
016 Freienfeld,93,,-,2,2
017 Sand in Taufers,0,,34,29,63
017 Sand in Taufers,1,,40,36,76
017 Sand in Taufers,2,,26,31,57
017 Sand in Taufers,3,,31,35,66
017 Sand in Taufers,4,,26,35,61
017 Sand in Taufers,5,,24,30,54
017 Sand in Taufers,6,,26,28,54
017 Sand in Taufers,7,,28,29,57
017 Sand in Taufers,8,,23,23,46
017 Sand in Taufers,9,,22,20,42
017 Sand in Taufers,10,,24,25,49
017 Sand in Taufers,11,,31,25,56
017 Sand in Taufers,12,,35,29,64
017 Sand in Taufers,13,,24,39,63
017 Sand in Taufers,14,,35,33,68
017 Sand in Taufers,15,,31,36,67
017 Sand in Taufers,16,,31,39,70
017 Sand in Taufers,17,,38,34,72
017 Sand in Taufers,18,,37,36,73
017 Sand in Taufers,19,,40,35,75
017 Sand in Taufers,20,,44,42,86
017 Sand in Taufers,21,,59,43,102
017 Sand in Taufers,22,,56,40,96
017 Sand in Taufers,23,,49,54,103
017 Sand in Taufers,24,,44,44,88
017 Sand in Taufers,25,,37,59,96
017 Sand in Taufers,26,,56,42,98
017 Sand in Taufers,27,,48,40,88
017 Sand in Taufers,28,,32,47,79
017 Sand in Taufers,29,,52,33,85
017 Sand in Taufers,30,,50,35,85
017 Sand in Taufers,31,,48,41,89
017 Sand in Taufers,32,,53,48,101
017 Sand in Taufers,33,,35,38,73
017 Sand in Taufers,34,,41,42,83
017 Sand in Taufers,35,,41,35,76
017 Sand in Taufers,36,,40,37,77
017 Sand in Taufers,37,,35,23,58
017 Sand in Taufers,38,,23,37,60
017 Sand in Taufers,39,,30,37,67
017 Sand in Taufers,40,,27,20,47
017 Sand in Taufers,41,,30,27,57
017 Sand in Taufers,42,,34,25,59
017 Sand in Taufers,43,,17,31,48
017 Sand in Taufers,44,,29,25,54
017 Sand in Taufers,45,,33,34,67
017 Sand in Taufers,46,,32,23,55
017 Sand in Taufers,47,,23,25,48
017 Sand in Taufers,48,,25,29,54
017 Sand in Taufers,49,,29,27,56
017 Sand in Taufers,50,,30,9,39
017 Sand in Taufers,51,,21,30,51
017 Sand in Taufers,52,,30,32,62
017 Sand in Taufers,53,,32,35,67
017 Sand in Taufers,54,,27,32,59
017 Sand in Taufers,55,,25,22,47
017 Sand in Taufers,56,,28,31,59
017 Sand in Taufers,57,,17,27,44
017 Sand in Taufers,58,,29,13,42
017 Sand in Taufers,59,,17,26,43
017 Sand in Taufers,60,,33,18,51
017 Sand in Taufers,61,,16,15,31
017 Sand in Taufers,62,,17,17,34
017 Sand in Taufers,63,,13,18,31
017 Sand in Taufers,64,,15,14,29
017 Sand in Taufers,65,,16,19,35
017 Sand in Taufers,66,,19,15,34
017 Sand in Taufers,67,,16,17,33
017 Sand in Taufers,68,,20,15,35
017 Sand in Taufers,69,,14,20,34
017 Sand in Taufers,70,,11,16,27
017 Sand in Taufers,71,,11,19,30
017 Sand in Taufers,72,,14,16,30
017 Sand in Taufers,73,,15,18,33
017 Sand in Taufers,74,,10,21,31
017 Sand in Taufers,75,,10,13,23
017 Sand in Taufers,76,,7,12,19
017 Sand in Taufers,77,,4,9,13
017 Sand in Taufers,78,,4,13,17
017 Sand in Taufers,79,,-,7,7
017 Sand in Taufers,80,,4,10,14
017 Sand in Taufers,81,,8,15,23
017 Sand in Taufers,82,,2,13,15
017 Sand in Taufers,83,,3,8,11
017 Sand in Taufers,84,,3,8,11
017 Sand in Taufers,85,,1,3,4
017 Sand in Taufers,86,,2,10,12
017 Sand in Taufers,87,,2,2,4
017 Sand in Taufers,88,,4,7,11
017 Sand in Taufers,89,,2,2,4
017 Sand in Taufers,90,,1,-,1
017 Sand in Taufers,91,,-,5,5
017 Sand in Taufers,93,,1,1,2
017 Sand in Taufers,94,,2,-,2
017 Sand in Taufers,95,,-,1,1
017 Sand in Taufers,96,,-,2,2
018 Kastelbell-Tschars,0,,16,11,27
018 Kastelbell-Tschars,1,,13,15,28
018 Kastelbell-Tschars,2,,14,16,30
018 Kastelbell-Tschars,3,,16,14,30
018 Kastelbell-Tschars,4,,19,13,32
018 Kastelbell-Tschars,5,,16,10,26
018 Kastelbell-Tschars,6,,16,10,26
018 Kastelbell-Tschars,7,,17,9,26
018 Kastelbell-Tschars,8,,18,15,33
018 Kastelbell-Tschars,9,,18,20,38
018 Kastelbell-Tschars,10,,20,14,34
018 Kastelbell-Tschars,11,,6,10,16
018 Kastelbell-Tschars,12,,13,23,36
018 Kastelbell-Tschars,13,,24,13,37
018 Kastelbell-Tschars,14,,16,24,40
018 Kastelbell-Tschars,15,,18,18,36
018 Kastelbell-Tschars,16,,16,16,32
018 Kastelbell-Tschars,17,,13,27,40
018 Kastelbell-Tschars,18,,10,19,29
018 Kastelbell-Tschars,19,,20,17,37
018 Kastelbell-Tschars,20,,18,14,32
018 Kastelbell-Tschars,21,,19,17,36
018 Kastelbell-Tschars,22,,24,23,47
018 Kastelbell-Tschars,23,,15,15,30
018 Kastelbell-Tschars,24,,16,14,30
018 Kastelbell-Tschars,25,,16,21,37
018 Kastelbell-Tschars,26,,29,26,55
018 Kastelbell-Tschars,27,,18,14,32
018 Kastelbell-Tschars,28,,17,26,43
018 Kastelbell-Tschars,29,,25,13,38
018 Kastelbell-Tschars,30,,22,16,38
018 Kastelbell-Tschars,31,,25,16,41
018 Kastelbell-Tschars,32,,22,21,43
018 Kastelbell-Tschars,33,,8,24,32
018 Kastelbell-Tschars,34,,17,18,35
018 Kastelbell-Tschars,35,,23,19,42
018 Kastelbell-Tschars,36,,23,19,42
018 Kastelbell-Tschars,37,,18,14,32
018 Kastelbell-Tschars,38,,15,11,26
018 Kastelbell-Tschars,39,,12,20,32
018 Kastelbell-Tschars,40,,17,18,35
018 Kastelbell-Tschars,41,,9,13,22
018 Kastelbell-Tschars,42,,10,15,25
018 Kastelbell-Tschars,43,,12,18,30
018 Kastelbell-Tschars,44,,16,13,29
018 Kastelbell-Tschars,45,,13,14,27
018 Kastelbell-Tschars,46,,12,9,21
018 Kastelbell-Tschars,47,,16,9,25
018 Kastelbell-Tschars,48,,10,9,19
018 Kastelbell-Tschars,49,,15,13,28
018 Kastelbell-Tschars,50,,10,4,14
018 Kastelbell-Tschars,51,,11,7,18
018 Kastelbell-Tschars,52,,10,9,19
018 Kastelbell-Tschars,53,,10,12,22
018 Kastelbell-Tschars,54,,10,9,19
018 Kastelbell-Tschars,55,,9,10,19
018 Kastelbell-Tschars,56,,14,15,29
018 Kastelbell-Tschars,57,,9,15,24
018 Kastelbell-Tschars,58,,12,11,23
018 Kastelbell-Tschars,59,,10,17,27
018 Kastelbell-Tschars,60,,12,10,22
018 Kastelbell-Tschars,61,,6,17,23
018 Kastelbell-Tschars,62,,19,13,32
018 Kastelbell-Tschars,63,,8,14,22
018 Kastelbell-Tschars,64,,10,14,24
018 Kastelbell-Tschars,65,,23,17,40
018 Kastelbell-Tschars,66,,11,14,25
018 Kastelbell-Tschars,67,,10,11,21
018 Kastelbell-Tschars,68,,11,9,20
018 Kastelbell-Tschars,69,,16,17,33
018 Kastelbell-Tschars,70,,14,15,29
018 Kastelbell-Tschars,71,,6,12,18
018 Kastelbell-Tschars,72,,13,10,23
018 Kastelbell-Tschars,73,,7,10,17
018 Kastelbell-Tschars,74,,4,9,13
018 Kastelbell-Tschars,75,,5,8,13
018 Kastelbell-Tschars,76,,2,5,7
018 Kastelbell-Tschars,77,,2,5,7
018 Kastelbell-Tschars,78,,3,4,7
018 Kastelbell-Tschars,79,,-,5,5
018 Kastelbell-Tschars,80,,7,5,12
018 Kastelbell-Tschars,81,,4,8,12
018 Kastelbell-Tschars,82,,7,4,11
018 Kastelbell-Tschars,83,,1,8,9
018 Kastelbell-Tschars,84,,5,6,11
018 Kastelbell-Tschars,85,,-,4,4
018 Kastelbell-Tschars,86,,2,2,4
018 Kastelbell-Tschars,87,,1,10,11
018 Kastelbell-Tschars,88,,-,1,1
018 Kastelbell-Tschars,90,,3,-,3
018 Kastelbell-Tschars,91,,2,2,4
018 Kastelbell-Tschars,93,,-,1,1
018 Kastelbell-Tschars,95,,-,1,1
019 Kastelruth,0,,46,40,86
019 Kastelruth,1,,32,33,65
019 Kastelruth,2,,39,31,70
019 Kastelruth,3,,37,50,87
019 Kastelruth,4,,35,39,74
019 Kastelruth,5,,37,37,74
019 Kastelruth,6,,45,39,84
019 Kastelruth,7,,27,24,51
019 Kastelruth,8,,39,41,80
019 Kastelruth,9,,32,24,56
019 Kastelruth,10,,26,32,58
019 Kastelruth,11,,34,29,63
019 Kastelruth,12,,34,44,78
019 Kastelruth,13,,45,32,77
019 Kastelruth,14,,36,40,76
019 Kastelruth,15,,45,37,82
019 Kastelruth,16,,30,44,74
019 Kastelruth,17,,32,40,72
019 Kastelruth,18,,37,38,75
019 Kastelruth,19,,43,42,85
019 Kastelruth,20,,52,35,87
019 Kastelruth,21,,54,49,103
019 Kastelruth,22,,41,65,106
019 Kastelruth,23,,65,46,111
019 Kastelruth,24,,57,47,104
019 Kastelruth,25,,52,73,125
019 Kastelruth,26,,61,66,127
019 Kastelruth,27,,66,56,122
019 Kastelruth,28,,65,67,132
019 Kastelruth,29,,70,48,118
019 Kastelruth,30,,44,72,116
019 Kastelruth,31,,53,43,96
019 Kastelruth,32,,59,34,93
019 Kastelruth,33,,40,47,87
019 Kastelruth,34,,49,43,92
019 Kastelruth,35,,52,41,93
019 Kastelruth,36,,47,45,92
019 Kastelruth,37,,44,44,88
019 Kastelruth,38,,33,38,71
019 Kastelruth,39,,35,31,66
019 Kastelruth,40,,37,36,73
019 Kastelruth,41,,34,30,64
019 Kastelruth,42,,31,30,61
019 Kastelruth,43,,36,27,63
019 Kastelruth,44,,30,27,57
019 Kastelruth,45,,42,18,60
019 Kastelruth,46,,20,34,54
019 Kastelruth,47,,28,38,66
019 Kastelruth,48,,36,33,69
019 Kastelruth,49,,22,39,61
019 Kastelruth,50,,24,21,45
019 Kastelruth,51,,20,45,65
019 Kastelruth,52,,44,36,80
019 Kastelruth,53,,36,30,66
019 Kastelruth,54,,37,46,83
019 Kastelruth,55,,31,37,68
019 Kastelruth,56,,31,27,58
019 Kastelruth,57,,30,27,57
019 Kastelruth,58,,28,24,52
019 Kastelruth,59,,34,21,55
019 Kastelruth,60,,34,31,65
019 Kastelruth,61,,25,23,48
019 Kastelruth,62,,36,32,68
019 Kastelruth,63,,21,37,58
019 Kastelruth,64,,43,28,71
019 Kastelruth,65,,15,28,43
019 Kastelruth,66,,30,27,57
019 Kastelruth,67,,17,22,39
019 Kastelruth,68,,29,33,62
019 Kastelruth,69,,19,28,47
019 Kastelruth,70,,16,25,41
019 Kastelruth,71,,21,24,45
019 Kastelruth,72,,12,24,36
019 Kastelruth,73,,17,17,34
019 Kastelruth,74,,13,25,38
019 Kastelruth,75,,13,20,33
019 Kastelruth,76,,15,10,25
019 Kastelruth,77,,7,13,20
019 Kastelruth,78,,9,7,16
019 Kastelruth,79,,3,5,8
019 Kastelruth,80,,4,15,19
019 Kastelruth,81,,14,12,26
019 Kastelruth,82,,12,13,25
019 Kastelruth,83,,12,15,27
019 Kastelruth,84,,9,13,22
019 Kastelruth,85,,4,11,15
019 Kastelruth,86,,2,9,11
019 Kastelruth,87,,3,4,7
019 Kastelruth,88,,4,9,13
019 Kastelruth,89,,1,9,10
019 Kastelruth,90,,3,5,8
019 Kastelruth,91,,3,2,5
019 Kastelruth,92,,-,4,4
019 Kastelruth,93,,-,3,3
019 Kastelruth,94,,-,3,3
019 Kastelruth,95,,-,2,2
019 Kastelruth,97,,-,1,1
020 Tscherms,0,,8,10,18
020 Tscherms,1,,9,16,25
020 Tscherms,2,,7,9,16
020 Tscherms,3,,10,7,17
020 Tscherms,4,,6,8,14
020 Tscherms,5,,7,6,13
020 Tscherms,6,,5,5,10
020 Tscherms,7,,5,17,22
020 Tscherms,8,,10,5,15
020 Tscherms,9,,10,6,16
020 Tscherms,10,,12,11,23
020 Tscherms,11,,10,5,15
020 Tscherms,12,,9,9,18
020 Tscherms,13,,5,8,13
020 Tscherms,14,,8,8,16
020 Tscherms,15,,5,6,11
020 Tscherms,16,,3,6,9
020 Tscherms,17,,3,7,10
020 Tscherms,18,,7,1,8
020 Tscherms,19,,7,6,13
020 Tscherms,20,,5,5,10
020 Tscherms,21,,6,1,7
020 Tscherms,22,,7,12,19
020 Tscherms,23,,5,4,9
020 Tscherms,24,,10,11,21
020 Tscherms,25,,7,6,13
020 Tscherms,26,,12,16,28
020 Tscherms,27,,13,9,22
020 Tscherms,28,,13,12,25
020 Tscherms,29,,11,7,18
020 Tscherms,30,,12,18,30
020 Tscherms,31,,11,13,24
020 Tscherms,32,,16,10,26
020 Tscherms,33,,14,8,22
020 Tscherms,34,,11,9,20
020 Tscherms,35,,9,12,21
020 Tscherms,36,,6,16,22
020 Tscherms,37,,9,4,13
020 Tscherms,38,,10,7,17
020 Tscherms,39,,9,8,17
020 Tscherms,40,,11,9,20
020 Tscherms,41,,6,9,15
020 Tscherms,42,,8,3,11
020 Tscherms,43,,13,6,19
020 Tscherms,44,,8,10,18
020 Tscherms,45,,8,9,17
020 Tscherms,46,,4,3,7
020 Tscherms,47,,7,4,11
020 Tscherms,48,,10,6,16
020 Tscherms,49,,3,7,10
020 Tscherms,50,,5,8,13
020 Tscherms,51,,5,12,17
020 Tscherms,52,,9,6,15
020 Tscherms,53,,7,3,10
020 Tscherms,54,,11,7,18
020 Tscherms,55,,7,5,12
020 Tscherms,56,,3,4,7
020 Tscherms,57,,6,2,8
020 Tscherms,58,,5,8,13
020 Tscherms,59,,5,6,11
020 Tscherms,60,,5,6,11
020 Tscherms,61,,2,9,11
020 Tscherms,62,,7,2,9
020 Tscherms,63,,5,4,9
020 Tscherms,64,,2,4,6
020 Tscherms,65,,5,6,11
020 Tscherms,66,,3,4,7
020 Tscherms,67,,5,7,12
020 Tscherms,68,,8,5,13
020 Tscherms,69,,4,4,8
020 Tscherms,70,,5,6,11
020 Tscherms,71,,4,7,11
020 Tscherms,72,,1,3,4
020 Tscherms,73,,3,8,11
020 Tscherms,74,,7,4,11
020 Tscherms,75,,7,5,12
020 Tscherms,76,,-,2,2
020 Tscherms,77,,4,2,6
020 Tscherms,78,,1,2,3
020 Tscherms,79,,1,2,3
020 Tscherms,80,,2,2,4
020 Tscherms,81,,5,4,9
020 Tscherms,82,,-,8,8
020 Tscherms,83,,4,1,5
020 Tscherms,84,,1,2,3
020 Tscherms,85,,1,2,3
020 Tscherms,86,,1,1,2
020 Tscherms,87,,-,1,1
020 Tscherms,88,,-,2,2
020 Tscherms,89,,1,1,2
020 Tscherms,90,,-,1,1
020 Tscherms,92,,-,2,2
020 Tscherms,93,,-,2,2
020 Tscherms,94,,-,1,1
021 Kiens,0,,15,23,38
021 Kiens,1,,18,18,36
021 Kiens,2,,18,16,34
021 Kiens,3,,25,16,41
021 Kiens,4,,15,24,39
021 Kiens,5,,13,20,33
021 Kiens,6,,15,18,33
021 Kiens,7,,13,15,28
021 Kiens,8,,12,12,24
021 Kiens,9,,18,12,30
021 Kiens,10,,18,14,32
021 Kiens,11,,16,11,27
021 Kiens,12,,13,19,32
021 Kiens,13,,23,17,40
021 Kiens,14,,15,22,37
021 Kiens,15,,17,21,38
021 Kiens,16,,16,20,36
021 Kiens,17,,28,18,46
021 Kiens,18,,18,15,33
021 Kiens,19,,29,20,49
021 Kiens,20,,20,25,45
021 Kiens,21,,21,22,43
021 Kiens,22,,35,25,60
021 Kiens,23,,29,23,52
021 Kiens,24,,31,37,68
021 Kiens,25,,23,26,49
021 Kiens,26,,35,23,58
021 Kiens,27,,47,21,68
021 Kiens,28,,21,25,46
021 Kiens,29,,25,25,50
021 Kiens,30,,18,20,38
021 Kiens,31,,34,23,57
021 Kiens,32,,19,24,43
021 Kiens,33,,32,18,50
021 Kiens,34,,21,24,45
021 Kiens,35,,19,20,39
021 Kiens,36,,27,18,45
021 Kiens,37,,15,12,27
021 Kiens,38,,12,19,31
021 Kiens,39,,17,11,28
021 Kiens,40,,16,11,27
021 Kiens,41,,11,14,25
021 Kiens,42,,14,23,37
021 Kiens,43,,14,10,24
021 Kiens,44,,13,11,24
021 Kiens,45,,19,11,30
021 Kiens,46,,9,14,23
021 Kiens,47,,11,17,28
021 Kiens,48,,16,15,31
021 Kiens,49,,19,14,33
021 Kiens,50,,8,14,22
021 Kiens,51,,11,15,26
021 Kiens,52,,23,12,35
021 Kiens,53,,20,12,32
021 Kiens,54,,21,11,32
021 Kiens,55,,14,17,31
021 Kiens,56,,15,11,26
021 Kiens,57,,16,14,30
021 Kiens,58,,11,13,24
021 Kiens,59,,11,12,23
021 Kiens,60,,6,19,25
021 Kiens,61,,9,15,24
021 Kiens,62,,13,8,21
021 Kiens,63,,17,13,30
021 Kiens,64,,18,9,27
021 Kiens,65,,11,13,24
021 Kiens,66,,8,9,17
021 Kiens,67,,4,9,13
021 Kiens,68,,9,7,16
021 Kiens,69,,3,5,8
021 Kiens,70,,7,5,12
021 Kiens,71,,6,7,13
021 Kiens,72,,10,6,16
021 Kiens,73,,4,7,11
021 Kiens,74,,2,7,9
021 Kiens,75,,6,4,10
021 Kiens,76,,1,5,6
021 Kiens,77,,4,2,6
021 Kiens,78,,2,4,6
021 Kiens,79,,2,4,6
021 Kiens,80,,2,4,6
021 Kiens,81,,4,6,10
021 Kiens,82,,6,4,10
021 Kiens,83,,2,4,6
021 Kiens,84,,3,3,6
021 Kiens,85,,5,2,7
021 Kiens,86,,3,3,6
021 Kiens,87,,2,4,6
021 Kiens,88,,1,4,5
021 Kiens,89,,4,-,4
021 Kiens,90,,-,1,1
021 Kiens,93,,-,1,1
021 Kiens,94,,2,1,3
022 Klausen,0,,31,23,54
022 Klausen,1,,21,35,56
022 Klausen,2,,31,23,54
022 Klausen,3,,40,27,67
022 Klausen,4,,32,33,65
022 Klausen,5,,34,23,57
022 Klausen,6,,31,27,58
022 Klausen,7,,29,31,60
022 Klausen,8,,18,33,51
022 Klausen,9,,33,30,63
022 Klausen,10,,36,37,73
022 Klausen,11,,33,28,61
022 Klausen,12,,26,37,63
022 Klausen,13,,38,34,72
022 Klausen,14,,36,31,67
022 Klausen,15,,26,35,61
022 Klausen,16,,33,37,70
022 Klausen,17,,39,41,80
022 Klausen,18,,32,29,61
022 Klausen,19,,37,19,56
022 Klausen,20,,34,35,69
022 Klausen,21,,35,23,58
022 Klausen,22,,45,25,70
022 Klausen,23,,35,40,75
022 Klausen,24,,51,36,87
022 Klausen,25,,46,39,85
022 Klausen,26,,46,43,89
022 Klausen,27,,57,38,95
022 Klausen,28,,44,44,88
022 Klausen,29,,57,36,93
022 Klausen,30,,43,39,82
022 Klausen,31,,38,45,83
022 Klausen,32,,40,38,78
022 Klausen,33,,28,40,68
022 Klausen,34,,53,39,92
022 Klausen,35,,37,28,65
022 Klausen,36,,33,37,70
022 Klausen,37,,27,27,54
022 Klausen,38,,29,25,54
022 Klausen,39,,32,24,56
022 Klausen,40,,31,33,64
022 Klausen,41,,31,39,70
022 Klausen,42,,20,29,49
022 Klausen,43,,29,17,46
022 Klausen,44,,33,25,58
022 Klausen,45,,32,23,55
022 Klausen,46,,28,25,53
022 Klausen,47,,29,26,55
022 Klausen,48,,26,20,46
022 Klausen,49,,29,21,50
022 Klausen,50,,12,17,29
022 Klausen,51,,21,17,38
022 Klausen,52,,23,28,51
022 Klausen,53,,23,27,50
022 Klausen,54,,28,18,46
022 Klausen,55,,24,22,46
022 Klausen,56,,28,20,48
022 Klausen,57,,18,20,38
022 Klausen,58,,16,19,35
022 Klausen,59,,21,25,46
022 Klausen,60,,17,22,39
022 Klausen,61,,20,16,36
022 Klausen,62,,24,19,43
022 Klausen,63,,11,21,32
022 Klausen,64,,14,16,30
022 Klausen,65,,13,19,32
022 Klausen,66,,23,23,46
022 Klausen,67,,11,20,31
022 Klausen,68,,12,15,27
022 Klausen,69,,16,15,31
022 Klausen,70,,15,10,25
022 Klausen,71,,15,18,33
022 Klausen,72,,6,19,25
022 Klausen,73,,8,17,25
022 Klausen,74,,7,16,23
022 Klausen,75,,7,17,24
022 Klausen,76,,4,13,17
022 Klausen,77,,6,14,20
022 Klausen,78,,3,12,15
022 Klausen,79,,4,6,10
022 Klausen,80,,7,4,11
022 Klausen,81,,6,10,16
022 Klausen,82,,2,22,24
022 Klausen,83,,3,8,11
022 Klausen,84,,8,9,17
022 Klausen,85,,5,6,11
022 Klausen,86,,4,7,11
022 Klausen,87,,3,9,12
022 Klausen,88,,1,4,5
022 Klausen,89,,2,5,7
022 Klausen,90,,-,4,4
022 Klausen,91,,1,5,6
022 Klausen,92,,-,3,3
022 Klausen,93,,1,2,3
022 Klausen,95,,-,1,1
022 Klausen,97,,-,1,1
023 Karneid,0,,24,19,43
023 Karneid,1,,26,18,44
023 Karneid,2,,21,20,41
023 Karneid,3,,21,16,37
023 Karneid,4,,18,17,35
023 Karneid,5,,22,16,38
023 Karneid,6,,14,15,29
023 Karneid,7,,19,19,38
023 Karneid,8,,12,21,33
023 Karneid,9,,18,20,38
023 Karneid,10,,20,11,31
023 Karneid,11,,25,15,40
023 Karneid,12,,20,10,30
023 Karneid,13,,20,14,34
023 Karneid,14,,29,28,57
023 Karneid,15,,22,19,41
023 Karneid,16,,24,24,48
023 Karneid,17,,25,12,37
023 Karneid,18,,16,17,33
023 Karneid,19,,23,26,49
023 Karneid,20,,19,19,38
023 Karneid,21,,29,22,51
023 Karneid,22,,27,21,48
023 Karneid,23,,26,27,53
023 Karneid,24,,29,30,59
023 Karneid,25,,33,18,51
023 Karneid,26,,23,25,48
023 Karneid,27,,36,29,65
023 Karneid,28,,31,36,67
023 Karneid,29,,29,31,60
023 Karneid,30,,29,25,54
023 Karneid,31,,34,30,64
023 Karneid,32,,35,16,51
023 Karneid,33,,22,33,55
023 Karneid,34,,28,20,48
023 Karneid,35,,31,24,55
023 Karneid,36,,26,17,43
023 Karneid,37,,21,20,41
023 Karneid,38,,19,20,39
023 Karneid,39,,18,18,36
023 Karneid,40,,18,8,26
023 Karneid,41,,14,14,28
023 Karneid,42,,23,14,37
023 Karneid,43,,13,21,34
023 Karneid,44,,18,11,29
023 Karneid,45,,22,15,37
023 Karneid,46,,9,13,22
023 Karneid,47,,17,22,39
023 Karneid,48,,7,17,24
023 Karneid,49,,11,19,30
023 Karneid,50,,11,14,25
023 Karneid,51,,13,13,26
023 Karneid,52,,22,15,37
023 Karneid,53,,16,25,41
023 Karneid,54,,22,15,37
023 Karneid,55,,17,18,35
023 Karneid,56,,17,18,35
023 Karneid,57,,21,11,32
023 Karneid,58,,11,9,20
023 Karneid,59,,11,12,23
023 Karneid,60,,13,16,29
023 Karneid,61,,17,15,32
023 Karneid,62,,11,14,25
023 Karneid,63,,15,5,20
023 Karneid,64,,20,11,31
023 Karneid,65,,7,10,17
023 Karneid,66,,13,9,22
023 Karneid,67,,9,10,19
023 Karneid,68,,4,9,13
023 Karneid,69,,9,9,18
023 Karneid,70,,6,7,13
023 Karneid,71,,9,14,23
023 Karneid,72,,7,5,12
023 Karneid,73,,4,9,13
023 Karneid,74,,2,7,9
023 Karneid,75,,8,11,19
023 Karneid,76,,9,5,14
023 Karneid,77,,1,6,7
023 Karneid,78,,2,4,6
023 Karneid,79,,1,4,5
023 Karneid,80,,4,2,6
023 Karneid,81,,2,5,7
023 Karneid,82,,1,4,5
023 Karneid,83,,1,6,7
023 Karneid,84,,1,5,6
023 Karneid,85,,6,6,12
023 Karneid,86,,2,3,5
023 Karneid,87,,1,7,8
023 Karneid,88,,-,2,2
023 Karneid,89,,1,3,4
023 Karneid,90,,-,1,1
023 Karneid,91,,1,2,3
023 Karneid,93,,-,1,1
023 Karneid,95,,-,1,1
024 Kurtatsch a.d.Weinstr.,0,,18,10,28
024 Kurtatsch a.d.Weinstr.,1,,16,8,24
024 Kurtatsch a.d.Weinstr.,2,,21,16,37
024 Kurtatsch a.d.Weinstr.,3,,20,12,32
024 Kurtatsch a.d.Weinstr.,4,,14,18,32
024 Kurtatsch a.d.Weinstr.,5,,11,8,19
024 Kurtatsch a.d.Weinstr.,6,,10,17,27
024 Kurtatsch a.d.Weinstr.,7,,7,14,21
024 Kurtatsch a.d.Weinstr.,8,,10,12,22
024 Kurtatsch a.d.Weinstr.,9,,9,10,19
024 Kurtatsch a.d.Weinstr.,10,,13,10,23
024 Kurtatsch a.d.Weinstr.,11,,15,9,24
024 Kurtatsch a.d.Weinstr.,12,,13,8,21
024 Kurtatsch a.d.Weinstr.,13,,12,20,32
024 Kurtatsch a.d.Weinstr.,14,,10,10,20
024 Kurtatsch a.d.Weinstr.,15,,7,14,21
024 Kurtatsch a.d.Weinstr.,16,,10,8,18
024 Kurtatsch a.d.Weinstr.,17,,6,14,20
024 Kurtatsch a.d.Weinstr.,18,,10,15,25
024 Kurtatsch a.d.Weinstr.,19,,11,14,25
024 Kurtatsch a.d.Weinstr.,20,,12,10,22
024 Kurtatsch a.d.Weinstr.,21,,9,17,26
024 Kurtatsch a.d.Weinstr.,22,,12,9,21
024 Kurtatsch a.d.Weinstr.,23,,11,16,27
024 Kurtatsch a.d.Weinstr.,24,,15,15,30
024 Kurtatsch a.d.Weinstr.,25,,11,24,35
024 Kurtatsch a.d.Weinstr.,26,,22,13,35
024 Kurtatsch a.d.Weinstr.,27,,22,8,30
024 Kurtatsch a.d.Weinstr.,28,,18,20,38
024 Kurtatsch a.d.Weinstr.,29,,26,17,43
024 Kurtatsch a.d.Weinstr.,30,,24,25,49
024 Kurtatsch a.d.Weinstr.,31,,16,25,41
024 Kurtatsch a.d.Weinstr.,32,,18,22,40
024 Kurtatsch a.d.Weinstr.,33,,23,8,31
024 Kurtatsch a.d.Weinstr.,34,,18,16,34
024 Kurtatsch a.d.Weinstr.,35,,17,20,37
024 Kurtatsch a.d.Weinstr.,36,,19,10,29
024 Kurtatsch a.d.Weinstr.,37,,13,15,28
024 Kurtatsch a.d.Weinstr.,38,,11,12,23
024 Kurtatsch a.d.Weinstr.,39,,9,9,18
024 Kurtatsch a.d.Weinstr.,40,,12,18,30
024 Kurtatsch a.d.Weinstr.,41,,14,8,22
024 Kurtatsch a.d.Weinstr.,42,,16,18,34
024 Kurtatsch a.d.Weinstr.,43,,13,7,20
024 Kurtatsch a.d.Weinstr.,44,,9,14,23
024 Kurtatsch a.d.Weinstr.,45,,14,5,19
024 Kurtatsch a.d.Weinstr.,46,,11,9,20
024 Kurtatsch a.d.Weinstr.,47,,9,6,15
024 Kurtatsch a.d.Weinstr.,48,,10,8,18
024 Kurtatsch a.d.Weinstr.,49,,12,9,21
024 Kurtatsch a.d.Weinstr.,50,,6,8,14
024 Kurtatsch a.d.Weinstr.,51,,5,9,14
024 Kurtatsch a.d.Weinstr.,52,,10,6,16
024 Kurtatsch a.d.Weinstr.,53,,10,12,22
024 Kurtatsch a.d.Weinstr.,54,,7,9,16
024 Kurtatsch a.d.Weinstr.,55,,12,12,24
024 Kurtatsch a.d.Weinstr.,56,,5,15,20
024 Kurtatsch a.d.Weinstr.,57,,9,11,20
024 Kurtatsch a.d.Weinstr.,58,,6,10,16
024 Kurtatsch a.d.Weinstr.,59,,10,7,17
024 Kurtatsch a.d.Weinstr.,60,,7,9,16
024 Kurtatsch a.d.Weinstr.,61,,8,10,18
024 Kurtatsch a.d.Weinstr.,62,,9,5,14
024 Kurtatsch a.d.Weinstr.,63,,12,16,28
024 Kurtatsch a.d.Weinstr.,64,,10,12,22
024 Kurtatsch a.d.Weinstr.,65,,12,16,28
024 Kurtatsch a.d.Weinstr.,66,,9,13,22
024 Kurtatsch a.d.Weinstr.,67,,10,8,18
024 Kurtatsch a.d.Weinstr.,68,,11,7,18
024 Kurtatsch a.d.Weinstr.,69,,9,6,15
024 Kurtatsch a.d.Weinstr.,70,,5,11,16
024 Kurtatsch a.d.Weinstr.,71,,10,12,22
024 Kurtatsch a.d.Weinstr.,72,,8,22,30
024 Kurtatsch a.d.Weinstr.,73,,5,6,11
024 Kurtatsch a.d.Weinstr.,74,,6,7,13
024 Kurtatsch a.d.Weinstr.,75,,7,7,14
024 Kurtatsch a.d.Weinstr.,76,,3,2,5
024 Kurtatsch a.d.Weinstr.,77,,-,1,1
024 Kurtatsch a.d.Weinstr.,78,,-,6,6
024 Kurtatsch a.d.Weinstr.,79,,1,2,3
024 Kurtatsch a.d.Weinstr.,80,,2,2,4
024 Kurtatsch a.d.Weinstr.,81,,3,3,6
024 Kurtatsch a.d.Weinstr.,82,,3,6,9
024 Kurtatsch a.d.Weinstr.,83,,5,6,11
024 Kurtatsch a.d.Weinstr.,84,,2,4,6
024 Kurtatsch a.d.Weinstr.,85,,-,3,3
024 Kurtatsch a.d.Weinstr.,86,,3,5,8
024 Kurtatsch a.d.Weinstr.,87,,1,3,4
024 Kurtatsch a.d.Weinstr.,88,,-,2,2
024 Kurtatsch a.d.Weinstr.,89,,2,3,5
024 Kurtatsch a.d.Weinstr.,90,,2,2,4
024 Kurtatsch a.d.Weinstr.,91,,1,-,1
024 Kurtatsch a.d.Weinstr.,92,,-,1,1
024 Kurtatsch a.d.Weinstr.,93,,1,1,2
024 Kurtatsch a.d.Weinstr.,94,,1,1,2
024 Kurtatsch a.d.Weinstr.,97,,-,1,1
024 Kurtatsch a.d.Weinstr.,100,,-,1,1
025 Kurtinig a.d. Weinstr.,0,,5,2,7
025 Kurtinig a.d. Weinstr.,1,,2,5,7
025 Kurtinig a.d. Weinstr.,2,,4,5,9
025 Kurtinig a.d. Weinstr.,3,,3,4,7
025 Kurtinig a.d. Weinstr.,4,,6,2,8
025 Kurtinig a.d. Weinstr.,5,,3,2,5
025 Kurtinig a.d. Weinstr.,6,,6,4,10
025 Kurtinig a.d. Weinstr.,7,,6,5,11
025 Kurtinig a.d. Weinstr.,8,,5,6,11
025 Kurtinig a.d. Weinstr.,9,,4,5,9
025 Kurtinig a.d. Weinstr.,10,,2,3,5
025 Kurtinig a.d. Weinstr.,11,,3,2,5
025 Kurtinig a.d. Weinstr.,12,,3,4,7
025 Kurtinig a.d. Weinstr.,13,,6,4,10
025 Kurtinig a.d. Weinstr.,14,,5,5,10
025 Kurtinig a.d. Weinstr.,15,,4,2,6
025 Kurtinig a.d. Weinstr.,16,,4,9,13
025 Kurtinig a.d. Weinstr.,17,,2,3,5
025 Kurtinig a.d. Weinstr.,18,,5,-,5
025 Kurtinig a.d. Weinstr.,19,,2,-,2
025 Kurtinig a.d. Weinstr.,20,,1,4,5
025 Kurtinig a.d. Weinstr.,21,,3,1,4
025 Kurtinig a.d. Weinstr.,22,,4,1,5
025 Kurtinig a.d. Weinstr.,23,,2,3,5
025 Kurtinig a.d. Weinstr.,24,,4,1,5
025 Kurtinig a.d. Weinstr.,25,,6,1,7
025 Kurtinig a.d. Weinstr.,26,,5,7,12
025 Kurtinig a.d. Weinstr.,27,,4,5,9
025 Kurtinig a.d. Weinstr.,28,,5,4,9
025 Kurtinig a.d. Weinstr.,29,,2,5,7
025 Kurtinig a.d. Weinstr.,30,,6,5,11
025 Kurtinig a.d. Weinstr.,31,,7,6,13
025 Kurtinig a.d. Weinstr.,32,,5,6,11
025 Kurtinig a.d. Weinstr.,33,,5,5,10
025 Kurtinig a.d. Weinstr.,34,,8,10,18
025 Kurtinig a.d. Weinstr.,35,,5,4,9
025 Kurtinig a.d. Weinstr.,36,,13,7,20
025 Kurtinig a.d. Weinstr.,37,,3,7,10
025 Kurtinig a.d. Weinstr.,38,,9,8,17
025 Kurtinig a.d. Weinstr.,39,,2,3,5
025 Kurtinig a.d. Weinstr.,40,,4,1,5
025 Kurtinig a.d. Weinstr.,41,,6,3,9
025 Kurtinig a.d. Weinstr.,42,,5,4,9
025 Kurtinig a.d. Weinstr.,43,,2,4,6
025 Kurtinig a.d. Weinstr.,44,,2,4,6
025 Kurtinig a.d. Weinstr.,45,,2,3,5
025 Kurtinig a.d. Weinstr.,46,,3,3,6
025 Kurtinig a.d. Weinstr.,47,,4,5,9
025 Kurtinig a.d. Weinstr.,48,,5,1,6
025 Kurtinig a.d. Weinstr.,49,,-,5,5
025 Kurtinig a.d. Weinstr.,50,,3,2,5
025 Kurtinig a.d. Weinstr.,51,,3,2,5
025 Kurtinig a.d. Weinstr.,52,,4,3,7
025 Kurtinig a.d. Weinstr.,53,,2,2,4
025 Kurtinig a.d. Weinstr.,54,,3,1,4
025 Kurtinig a.d. Weinstr.,55,,2,2,4
025 Kurtinig a.d. Weinstr.,56,,5,3,8
025 Kurtinig a.d. Weinstr.,57,,2,2,4
025 Kurtinig a.d. Weinstr.,58,,3,3,6
025 Kurtinig a.d. Weinstr.,59,,6,3,9
025 Kurtinig a.d. Weinstr.,60,,-,6,6
025 Kurtinig a.d. Weinstr.,61,,1,4,5
025 Kurtinig a.d. Weinstr.,62,,1,2,3
025 Kurtinig a.d. Weinstr.,63,,3,3,6
025 Kurtinig a.d. Weinstr.,64,,2,2,4
025 Kurtinig a.d. Weinstr.,65,,3,4,7
025 Kurtinig a.d. Weinstr.,66,,2,3,5
025 Kurtinig a.d. Weinstr.,67,,2,5,7
025 Kurtinig a.d. Weinstr.,68,,2,3,5
025 Kurtinig a.d. Weinstr.,69,,5,1,6
025 Kurtinig a.d. Weinstr.,70,,-,5,5
025 Kurtinig a.d. Weinstr.,71,,2,7,9
025 Kurtinig a.d. Weinstr.,72,,1,1,2
025 Kurtinig a.d. Weinstr.,73,,1,3,4
025 Kurtinig a.d. Weinstr.,74,,2,1,3
025 Kurtinig a.d. Weinstr.,75,,3,1,4
025 Kurtinig a.d. Weinstr.,76,,-,2,2
025 Kurtinig a.d. Weinstr.,77,,1,1,2
025 Kurtinig a.d. Weinstr.,78,,-,1,1
025 Kurtinig a.d. Weinstr.,79,,-,1,1
025 Kurtinig a.d. Weinstr.,80,,-,3,3
025 Kurtinig a.d. Weinstr.,81,,1,2,3
025 Kurtinig a.d. Weinstr.,82,,1,1,2
025 Kurtinig a.d. Weinstr.,83,,1,1,2
025 Kurtinig a.d. Weinstr.,86,,1,3,4
025 Kurtinig a.d. Weinstr.,89,,1,-,1
025 Kurtinig a.d. Weinstr.,90,,-,1,1
025 Kurtinig a.d. Weinstr.,91,,-,3,3
026 Corvara,0,,8,10,18
026 Corvara,1,,5,5,10
026 Corvara,2,,7,3,10
026 Corvara,3,,5,11,16
026 Corvara,4,,3,5,8
026 Corvara,5,,10,4,14
026 Corvara,6,,5,5,10
026 Corvara,7,,6,4,10
026 Corvara,8,,10,7,17
026 Corvara,9,,3,1,4
026 Corvara,10,,6,8,14
026 Corvara,11,,8,3,11
026 Corvara,12,,7,7,14
026 Corvara,13,,9,11,20
026 Corvara,14,,15,2,17
026 Corvara,15,,11,7,18
026 Corvara,16,,11,8,19
026 Corvara,17,,10,3,13
026 Corvara,18,,16,7,23
026 Corvara,19,,12,5,17
026 Corvara,20,,9,19,28
026 Corvara,21,,7,14,21
026 Corvara,22,,12,12,24
026 Corvara,23,,8,7,15
026 Corvara,24,,11,10,21
026 Corvara,25,,13,11,24
026 Corvara,26,,14,13,27
026 Corvara,27,,8,13,21
026 Corvara,28,,15,22,37
026 Corvara,29,,13,17,30
026 Corvara,30,,15,13,28
026 Corvara,31,,8,9,17
026 Corvara,32,,13,13,26
026 Corvara,33,,12,14,26
026 Corvara,34,,9,9,18
026 Corvara,35,,15,14,29
026 Corvara,36,,6,10,16
026 Corvara,37,,12,6,18
026 Corvara,38,,7,5,12
026 Corvara,39,,3,9,12
026 Corvara,40,,15,8,23
026 Corvara,41,,8,8,16
026 Corvara,42,,6,13,19
026 Corvara,43,,5,8,13
026 Corvara,44,,6,8,14
026 Corvara,45,,7,8,15
026 Corvara,46,,3,9,12
026 Corvara,47,,5,6,11
026 Corvara,48,,3,10,13
026 Corvara,49,,14,11,25
026 Corvara,50,,5,6,11
026 Corvara,51,,9,9,18
026 Corvara,52,,7,10,17
026 Corvara,53,,6,9,15
026 Corvara,54,,17,12,29
026 Corvara,55,,9,7,16
026 Corvara,56,,10,5,15
026 Corvara,57,,5,8,13
026 Corvara,58,,5,8,13
026 Corvara,59,,6,8,14
026 Corvara,60,,8,6,14
026 Corvara,61,,8,8,16
026 Corvara,62,,5,4,9
026 Corvara,63,,7,4,11
026 Corvara,64,,7,12,19
026 Corvara,65,,7,4,11
026 Corvara,66,,6,6,12
026 Corvara,67,,3,2,5
026 Corvara,68,,7,4,11
026 Corvara,69,,3,4,7
026 Corvara,70,,2,3,5
026 Corvara,71,,5,1,6
026 Corvara,72,,5,3,8
026 Corvara,73,,3,7,10
026 Corvara,74,,5,1,6
026 Corvara,75,,4,1,5
026 Corvara,76,,2,4,6
026 Corvara,77,,1,1,2
026 Corvara,78,,1,4,5
026 Corvara,79,,-,3,3
026 Corvara,81,,2,3,5
026 Corvara,82,,1,6,7
026 Corvara,83,,2,5,7
026 Corvara,84,,2,-,2
026 Corvara,85,,1,3,4
026 Corvara,86,,-,4,4
026 Corvara,87,,-,3,3
026 Corvara,88,,-,2,2
026 Corvara,89,,1,3,4
026 Corvara,90,,-,1,1
026 Corvara,91,,-,1,1
026 Corvara,92,,1,-,1
027 Graun im Vinschgau,0,,18,20,38
027 Graun im Vinschgau,1,,19,11,30
027 Graun im Vinschgau,2,,19,13,32
027 Graun im Vinschgau,3,,17,15,32
027 Graun im Vinschgau,4,,9,14,23
027 Graun im Vinschgau,5,,17,21,38
027 Graun im Vinschgau,6,,25,18,43
027 Graun im Vinschgau,7,,22,11,33
027 Graun im Vinschgau,8,,16,11,27
027 Graun im Vinschgau,9,,8,8,16
027 Graun im Vinschgau,10,,19,10,29
027 Graun im Vinschgau,11,,18,16,34
027 Graun im Vinschgau,12,,7,16,23
027 Graun im Vinschgau,13,,22,18,40
027 Graun im Vinschgau,14,,22,17,39
027 Graun im Vinschgau,15,,24,13,37
027 Graun im Vinschgau,16,,13,24,37
027 Graun im Vinschgau,17,,18,15,33
027 Graun im Vinschgau,18,,18,21,39
027 Graun im Vinschgau,19,,15,20,35
027 Graun im Vinschgau,20,,23,19,42
027 Graun im Vinschgau,21,,24,11,35
027 Graun im Vinschgau,22,,24,16,40
027 Graun im Vinschgau,23,,22,19,41
027 Graun im Vinschgau,24,,27,12,39
027 Graun im Vinschgau,25,,28,22,50
027 Graun im Vinschgau,26,,32,16,48
027 Graun im Vinschgau,27,,17,22,39
027 Graun im Vinschgau,28,,33,23,56
027 Graun im Vinschgau,29,,21,24,45
027 Graun im Vinschgau,30,,15,23,38
027 Graun im Vinschgau,31,,22,22,44
027 Graun im Vinschgau,32,,23,19,42
027 Graun im Vinschgau,33,,24,24,48
027 Graun im Vinschgau,34,,23,13,36
027 Graun im Vinschgau,35,,21,22,43
027 Graun im Vinschgau,36,,25,12,37
027 Graun im Vinschgau,37,,19,15,34
027 Graun im Vinschgau,38,,16,13,29
027 Graun im Vinschgau,39,,15,11,26
027 Graun im Vinschgau,40,,18,10,28
027 Graun im Vinschgau,41,,17,17,34
027 Graun im Vinschgau,42,,19,8,27
027 Graun im Vinschgau,43,,17,11,28
027 Graun im Vinschgau,44,,13,16,29
027 Graun im Vinschgau,45,,12,12,24
027 Graun im Vinschgau,46,,8,21,29
027 Graun im Vinschgau,47,,13,12,25
027 Graun im Vinschgau,48,,6,10,16
027 Graun im Vinschgau,49,,8,7,15
027 Graun im Vinschgau,50,,9,8,17
027 Graun im Vinschgau,51,,11,9,20
027 Graun im Vinschgau,52,,10,13,23
027 Graun im Vinschgau,53,,10,12,22
027 Graun im Vinschgau,54,,15,9,24
027 Graun im Vinschgau,55,,15,9,24
027 Graun im Vinschgau,56,,12,13,25
027 Graun im Vinschgau,57,,11,12,23
027 Graun im Vinschgau,58,,11,3,14
027 Graun im Vinschgau,59,,14,14,28
027 Graun im Vinschgau,60,,10,9,19
027 Graun im Vinschgau,61,,13,10,23
027 Graun im Vinschgau,62,,9,7,16
027 Graun im Vinschgau,63,,14,8,22
027 Graun im Vinschgau,64,,14,11,25
027 Graun im Vinschgau,65,,7,9,16
027 Graun im Vinschgau,66,,17,15,32
027 Graun im Vinschgau,67,,12,14,26
027 Graun im Vinschgau,68,,6,9,15
027 Graun im Vinschgau,69,,10,15,25
027 Graun im Vinschgau,70,,8,6,14
027 Graun im Vinschgau,71,,10,11,21
027 Graun im Vinschgau,72,,7,15,22
027 Graun im Vinschgau,73,,9,8,17
027 Graun im Vinschgau,74,,9,15,24
027 Graun im Vinschgau,75,,7,4,11
027 Graun im Vinschgau,76,,1,8,9
027 Graun im Vinschgau,77,,3,3,6
027 Graun im Vinschgau,78,,-,5,5
027 Graun im Vinschgau,79,,3,2,5
027 Graun im Vinschgau,80,,4,6,10
027 Graun im Vinschgau,81,,7,7,14
027 Graun im Vinschgau,82,,4,5,9
027 Graun im Vinschgau,83,,1,5,6
027 Graun im Vinschgau,84,,1,7,8
027 Graun im Vinschgau,85,,3,1,4
027 Graun im Vinschgau,86,,2,3,5
027 Graun im Vinschgau,87,,-,4,4
027 Graun im Vinschgau,88,,1,5,6
027 Graun im Vinschgau,89,,-,1,1
027 Graun im Vinschgau,91,,1,-,1
027 Graun im Vinschgau,92,,-,1,1
027 Graun im Vinschgau,93,,-,2,2
027 Graun im Vinschgau,96,,1,-,1
027 Graun im Vinschgau,99,,-,1,1
028 Toblach,0,,17,8,25
028 Toblach,1,,23,17,40
028 Toblach,2,,19,21,40
028 Toblach,3,,16,17,33
028 Toblach,4,,16,27,43
028 Toblach,5,,16,23,39
028 Toblach,6,,11,16,27
028 Toblach,7,,13,25,38
028 Toblach,8,,31,15,46
028 Toblach,9,,15,22,37
028 Toblach,10,,25,23,48
028 Toblach,11,,21,28,49
028 Toblach,12,,22,20,42
028 Toblach,13,,24,28,52
028 Toblach,14,,23,23,46
028 Toblach,15,,23,20,43
028 Toblach,16,,22,27,49
028 Toblach,17,,27,24,51
028 Toblach,18,,16,30,46
028 Toblach,19,,26,26,52
028 Toblach,20,,23,24,47
028 Toblach,21,,27,18,45
028 Toblach,22,,33,25,58
028 Toblach,23,,33,35,68
028 Toblach,24,,36,20,56
028 Toblach,25,,27,26,53
028 Toblach,26,,30,28,58
028 Toblach,27,,37,31,68
028 Toblach,28,,30,24,54
028 Toblach,29,,32,32,64
028 Toblach,30,,32,27,59
028 Toblach,31,,36,33,69
028 Toblach,32,,34,28,62
028 Toblach,33,,36,31,67
028 Toblach,34,,21,31,52
028 Toblach,35,,19,18,37
028 Toblach,36,,40,27,67
028 Toblach,37,,20,14,34
028 Toblach,38,,26,20,46
028 Toblach,39,,18,27,45
028 Toblach,40,,20,25,45
028 Toblach,41,,24,19,43
028 Toblach,42,,19,24,43
028 Toblach,43,,19,17,36
028 Toblach,44,,28,12,40
028 Toblach,45,,17,17,34
028 Toblach,46,,21,14,35
028 Toblach,47,,14,25,39
028 Toblach,48,,21,14,35
028 Toblach,49,,14,16,30
028 Toblach,50,,14,17,31
028 Toblach,51,,20,11,31
028 Toblach,52,,18,18,36
028 Toblach,53,,13,20,33
028 Toblach,54,,15,12,27
028 Toblach,55,,14,14,28
028 Toblach,56,,16,12,28
028 Toblach,57,,16,8,24
028 Toblach,58,,7,10,17
028 Toblach,59,,12,18,30
028 Toblach,60,,10,19,29
028 Toblach,61,,17,17,34
028 Toblach,62,,10,12,22
028 Toblach,63,,14,16,30
028 Toblach,64,,18,16,34
028 Toblach,65,,11,12,23
028 Toblach,66,,12,17,29
028 Toblach,67,,15,14,29
028 Toblach,68,,10,15,25
028 Toblach,69,,10,15,25
028 Toblach,70,,16,9,25
028 Toblach,71,,12,11,23
028 Toblach,72,,10,11,21
028 Toblach,73,,5,18,23
028 Toblach,74,,9,11,20
028 Toblach,75,,4,10,14
028 Toblach,76,,5,16,21
028 Toblach,77,,6,6,12
028 Toblach,78,,6,5,11
028 Toblach,79,,4,6,10
028 Toblach,80,,2,15,17
028 Toblach,81,,2,12,14
028 Toblach,82,,3,8,11
028 Toblach,83,,3,4,7
028 Toblach,84,,2,5,7
028 Toblach,85,,1,5,6
028 Toblach,86,,3,3,6
028 Toblach,87,,6,5,11
028 Toblach,88,,3,4,7
028 Toblach,89,,2,3,5
028 Toblach,90,,1,1,2
028 Toblach,91,,-,1,1
028 Toblach,94,,-,1,1
028 Toblach,95,,-,1,1
028 Toblach,105,,1,-,1
029 Neumarkt,0,,21,24,45
029 Neumarkt,1,,18,19,37
029 Neumarkt,2,,22,32,54
029 Neumarkt,3,,22,24,46
029 Neumarkt,4,,28,17,45
029 Neumarkt,5,,26,24,50
029 Neumarkt,6,,22,31,53
029 Neumarkt,7,,20,23,43
029 Neumarkt,8,,26,29,55
029 Neumarkt,9,,23,17,40
029 Neumarkt,10,,23,16,39
029 Neumarkt,11,,17,22,39
029 Neumarkt,12,,13,23,36
029 Neumarkt,13,,23,23,46
029 Neumarkt,14,,25,20,45
029 Neumarkt,15,,20,20,40
029 Neumarkt,16,,22,15,37
029 Neumarkt,17,,35,19,54
029 Neumarkt,18,,16,13,29
029 Neumarkt,19,,29,30,59
029 Neumarkt,20,,26,21,47
029 Neumarkt,21,,23,34,57
029 Neumarkt,22,,24,25,49
029 Neumarkt,23,,27,31,58
029 Neumarkt,24,,29,39,68
029 Neumarkt,25,,41,27,68
029 Neumarkt,26,,36,29,65
029 Neumarkt,27,,33,39,72
029 Neumarkt,28,,41,36,77
029 Neumarkt,29,,47,37,84
029 Neumarkt,30,,48,36,84
029 Neumarkt,31,,46,39,85
029 Neumarkt,32,,44,39,83
029 Neumarkt,33,,44,35,79
029 Neumarkt,34,,36,35,71
029 Neumarkt,35,,44,46,90
029 Neumarkt,36,,47,38,85
029 Neumarkt,37,,33,35,68
029 Neumarkt,38,,37,32,69
029 Neumarkt,39,,31,25,56
029 Neumarkt,40,,43,40,83
029 Neumarkt,41,,39,25,64
029 Neumarkt,42,,23,19,42
029 Neumarkt,43,,29,23,52
029 Neumarkt,44,,23,22,45
029 Neumarkt,45,,25,22,47
029 Neumarkt,46,,19,27,46
029 Neumarkt,47,,25,23,48
029 Neumarkt,48,,25,30,55
029 Neumarkt,49,,35,30,65
029 Neumarkt,50,,26,26,52
029 Neumarkt,51,,24,16,40
029 Neumarkt,52,,26,22,48
029 Neumarkt,53,,26,25,51
029 Neumarkt,54,,39,24,63
029 Neumarkt,55,,34,34,68
029 Neumarkt,56,,23,28,51
029 Neumarkt,57,,19,19,38
029 Neumarkt,58,,24,23,47
029 Neumarkt,59,,23,20,43
029 Neumarkt,60,,22,21,43
029 Neumarkt,61,,17,23,40
029 Neumarkt,62,,20,19,39
029 Neumarkt,63,,22,24,46
029 Neumarkt,64,,27,29,56
029 Neumarkt,65,,21,28,49
029 Neumarkt,66,,18,19,37
029 Neumarkt,67,,11,21,32
029 Neumarkt,68,,24,20,44
029 Neumarkt,69,,23,21,44
029 Neumarkt,70,,17,23,40
029 Neumarkt,71,,16,18,34
029 Neumarkt,72,,16,31,47
029 Neumarkt,73,,13,21,34
029 Neumarkt,74,,10,28,38
029 Neumarkt,75,,14,22,36
029 Neumarkt,76,,4,14,18
029 Neumarkt,77,,6,7,13
029 Neumarkt,78,,6,8,14
029 Neumarkt,79,,4,7,11
029 Neumarkt,80,,2,10,12
029 Neumarkt,81,,10,16,26
029 Neumarkt,82,,9,8,17
029 Neumarkt,83,,5,10,15
029 Neumarkt,84,,3,11,14
029 Neumarkt,85,,5,10,15
029 Neumarkt,86,,6,6,12
029 Neumarkt,87,,3,7,10
029 Neumarkt,88,,1,3,4
029 Neumarkt,89,,1,5,6
029 Neumarkt,90,,1,1,2
029 Neumarkt,91,,-,2,2
029 Neumarkt,92,,-,2,2
029 Neumarkt,93,,1,-,1
029 Neumarkt,96,,1,-,1
029 Neumarkt,97,,-,1,1
029 Neumarkt,99,,-,1,1
030 Pfalzen,0,,20,16,36
030 Pfalzen,1,,9,13,22
030 Pfalzen,2,,12,16,28
030 Pfalzen,3,,15,21,36
030 Pfalzen,4,,12,22,34
030 Pfalzen,5,,20,9,29
030 Pfalzen,6,,16,21,37
030 Pfalzen,7,,13,9,22
030 Pfalzen,8,,12,23,35
030 Pfalzen,9,,17,17,34
030 Pfalzen,10,,24,13,37
030 Pfalzen,11,,17,11,28
030 Pfalzen,12,,11,11,22
030 Pfalzen,13,,19,19,38
030 Pfalzen,14,,19,19,38
030 Pfalzen,15,,22,17,39
030 Pfalzen,16,,15,20,35
030 Pfalzen,17,,15,20,35
030 Pfalzen,18,,19,18,37
030 Pfalzen,19,,20,10,30
030 Pfalzen,20,,9,15,24
030 Pfalzen,21,,22,19,41
030 Pfalzen,22,,16,18,34
030 Pfalzen,23,,16,16,32
030 Pfalzen,24,,21,19,40
030 Pfalzen,25,,16,18,34
030 Pfalzen,26,,28,16,44
030 Pfalzen,27,,27,31,58
030 Pfalzen,28,,18,23,41
030 Pfalzen,29,,21,21,42
030 Pfalzen,30,,24,26,50
030 Pfalzen,31,,24,16,40
030 Pfalzen,32,,27,18,45
030 Pfalzen,33,,22,29,51
030 Pfalzen,34,,24,16,40
030 Pfalzen,35,,21,12,33
030 Pfalzen,36,,13,14,27
030 Pfalzen,37,,14,20,34
030 Pfalzen,38,,22,19,41
030 Pfalzen,39,,17,15,32
030 Pfalzen,40,,15,12,27
030 Pfalzen,41,,15,13,28
030 Pfalzen,42,,13,12,25
030 Pfalzen,43,,10,10,20
030 Pfalzen,44,,17,17,34
030 Pfalzen,45,,12,11,23
030 Pfalzen,46,,14,6,20
030 Pfalzen,47,,10,10,20
030 Pfalzen,48,,12,4,16
030 Pfalzen,49,,9,10,19
030 Pfalzen,50,,8,9,17
030 Pfalzen,51,,12,6,18
030 Pfalzen,52,,8,12,20
030 Pfalzen,53,,6,14,20
030 Pfalzen,54,,14,8,22
030 Pfalzen,55,,13,9,22
030 Pfalzen,56,,10,6,16
030 Pfalzen,57,,11,11,22
030 Pfalzen,58,,7,5,12
030 Pfalzen,59,,2,9,11
030 Pfalzen,60,,8,5,13
030 Pfalzen,61,,8,12,20
030 Pfalzen,62,,7,8,15
030 Pfalzen,63,,10,9,19
030 Pfalzen,64,,13,7,20
030 Pfalzen,65,,11,12,23
030 Pfalzen,66,,11,6,17
030 Pfalzen,67,,4,6,10
030 Pfalzen,68,,7,5,12
030 Pfalzen,69,,5,4,9
030 Pfalzen,70,,8,5,13
030 Pfalzen,71,,4,11,15
030 Pfalzen,72,,8,10,18
030 Pfalzen,73,,5,3,8
030 Pfalzen,74,,-,8,8
030 Pfalzen,75,,3,7,10
030 Pfalzen,76,,5,4,9
030 Pfalzen,77,,1,2,3
030 Pfalzen,78,,1,2,3
030 Pfalzen,79,,-,2,2
030 Pfalzen,80,,2,-,2
030 Pfalzen,81,,3,6,9
030 Pfalzen,82,,1,5,6
030 Pfalzen,83,,2,1,3
030 Pfalzen,84,,2,4,6
030 Pfalzen,85,,2,4,6
030 Pfalzen,86,,5,2,7
030 Pfalzen,87,,2,1,3
030 Pfalzen,89,,-,1,1
030 Pfalzen,90,,-,1,1
030 Pfalzen,91,,-,1,1
030 Pfalzen,93,,-,1,1
031 Völs am Schlern,0,,23,25,48
031 Völs am Schlern,1,,21,12,33
031 Völs am Schlern,2,,14,18,32
031 Völs am Schlern,3,,20,15,35
031 Völs am Schlern,4,,13,20,33
031 Völs am Schlern,5,,20,19,39
031 Völs am Schlern,6,,18,14,32
031 Völs am Schlern,7,,15,14,29
031 Völs am Schlern,8,,17,15,32
031 Völs am Schlern,9,,23,12,35
031 Völs am Schlern,10,,18,14,32
031 Völs am Schlern,11,,15,7,22
031 Völs am Schlern,12,,11,23,34
031 Völs am Schlern,13,,21,23,44
031 Völs am Schlern,14,,25,18,43
031 Völs am Schlern,15,,29,13,42
031 Völs am Schlern,16,,19,25,44
031 Völs am Schlern,17,,24,18,42
031 Völs am Schlern,18,,21,21,42
031 Völs am Schlern,19,,25,22,47
031 Völs am Schlern,20,,18,24,42
031 Völs am Schlern,21,,27,24,51
031 Völs am Schlern,22,,25,28,53
031 Völs am Schlern,23,,31,27,58
031 Völs am Schlern,24,,34,28,62
031 Völs am Schlern,25,,26,26,52
031 Völs am Schlern,26,,31,33,64
031 Völs am Schlern,27,,36,37,73
031 Völs am Schlern,28,,28,24,52
031 Völs am Schlern,29,,39,22,61
031 Völs am Schlern,30,,28,23,51
031 Völs am Schlern,31,,27,16,43
031 Völs am Schlern,32,,40,29,69
031 Völs am Schlern,33,,26,18,44
031 Völs am Schlern,34,,22,20,42
031 Völs am Schlern,35,,24,21,45
031 Völs am Schlern,36,,20,15,35
031 Völs am Schlern,37,,19,16,35
031 Völs am Schlern,38,,26,19,45
031 Völs am Schlern,39,,19,18,37
031 Völs am Schlern,40,,15,12,27
031 Völs am Schlern,41,,19,23,42
031 Völs am Schlern,42,,18,24,42
031 Völs am Schlern,43,,17,17,34
031 Völs am Schlern,44,,18,19,37
031 Völs am Schlern,45,,22,16,38
031 Völs am Schlern,46,,20,8,28
031 Völs am Schlern,47,,16,14,30
031 Völs am Schlern,48,,16,17,33
031 Völs am Schlern,49,,15,13,28
031 Völs am Schlern,50,,12,13,25
031 Völs am Schlern,51,,15,9,24
031 Völs am Schlern,52,,12,23,35
031 Völs am Schlern,53,,15,13,28
031 Völs am Schlern,54,,23,19,42
031 Völs am Schlern,55,,11,19,30
031 Völs am Schlern,56,,15,8,23
031 Völs am Schlern,57,,13,13,26
031 Völs am Schlern,58,,10,9,19
031 Völs am Schlern,59,,10,21,31
031 Völs am Schlern,60,,16,12,28
031 Völs am Schlern,61,,16,8,24
031 Völs am Schlern,62,,8,13,21
031 Völs am Schlern,63,,16,8,24
031 Völs am Schlern,64,,15,17,32
031 Völs am Schlern,65,,7,15,22
031 Völs am Schlern,66,,6,11,17
031 Völs am Schlern,67,,10,11,21
031 Völs am Schlern,68,,11,11,22
031 Völs am Schlern,69,,12,6,18
031 Völs am Schlern,70,,12,11,23
031 Völs am Schlern,71,,15,13,28
031 Völs am Schlern,72,,7,8,15
031 Völs am Schlern,73,,7,10,17
031 Völs am Schlern,74,,6,12,18
031 Völs am Schlern,75,,3,8,11
031 Völs am Schlern,76,,1,11,12
031 Völs am Schlern,77,,2,5,7
031 Völs am Schlern,78,,2,6,8
031 Völs am Schlern,79,,4,2,6
031 Völs am Schlern,80,,5,5,10
031 Völs am Schlern,81,,7,5,12
031 Völs am Schlern,82,,7,4,11
031 Völs am Schlern,83,,4,4,8
031 Völs am Schlern,84,,2,11,13
031 Völs am Schlern,85,,2,4,6
031 Völs am Schlern,86,,2,5,7
031 Völs am Schlern,87,,2,4,6
031 Völs am Schlern,88,,1,6,7
031 Völs am Schlern,89,,1,1,2
031 Völs am Schlern,90,,1,2,3
031 Völs am Schlern,91,,1,2,3
031 Völs am Schlern,93,,1,-,1
031 Völs am Schlern,94,,1,-,1
032 Franzensfeste,0,,4,2,6
032 Franzensfeste,1,,9,4,13
032 Franzensfeste,2,,5,3,8
032 Franzensfeste,3,,6,10,16
032 Franzensfeste,4,,5,4,9
032 Franzensfeste,5,,2,4,6
032 Franzensfeste,6,,4,6,10
032 Franzensfeste,7,,4,3,7
032 Franzensfeste,8,,4,4,8
032 Franzensfeste,9,,5,2,7
032 Franzensfeste,10,,3,8,11
032 Franzensfeste,11,,3,4,7
032 Franzensfeste,12,,7,5,12
032 Franzensfeste,13,,2,7,9
032 Franzensfeste,14,,7,5,12
032 Franzensfeste,15,,4,13,17
032 Franzensfeste,16,,11,5,16
032 Franzensfeste,17,,5,7,12
032 Franzensfeste,18,,5,2,7
032 Franzensfeste,19,,3,7,10
032 Franzensfeste,20,,7,6,13
032 Franzensfeste,21,,7,5,12
032 Franzensfeste,22,,5,5,10
032 Franzensfeste,23,,3,11,14
032 Franzensfeste,24,,11,7,18
032 Franzensfeste,25,,9,8,17
032 Franzensfeste,26,,6,7,13
032 Franzensfeste,27,,8,8,16
032 Franzensfeste,28,,11,6,17
032 Franzensfeste,29,,9,8,17
032 Franzensfeste,30,,10,10,20
032 Franzensfeste,31,,16,9,25
032 Franzensfeste,32,,9,10,19
032 Franzensfeste,33,,11,2,13
032 Franzensfeste,34,,5,10,15
032 Franzensfeste,35,,7,9,16
032 Franzensfeste,36,,10,8,18
032 Franzensfeste,37,,10,1,11
032 Franzensfeste,38,,7,6,13
032 Franzensfeste,39,,5,8,13
032 Franzensfeste,40,,10,7,17
032 Franzensfeste,41,,4,12,16
032 Franzensfeste,42,,9,7,16
032 Franzensfeste,43,,5,3,8
032 Franzensfeste,44,,7,1,8
032 Franzensfeste,45,,10,3,13
032 Franzensfeste,46,,3,3,6
032 Franzensfeste,47,,4,5,9
032 Franzensfeste,48,,5,4,9
032 Franzensfeste,49,,8,5,13
032 Franzensfeste,50,,4,7,11
032 Franzensfeste,51,,5,9,14
032 Franzensfeste,52,,5,2,7
032 Franzensfeste,53,,5,2,7
032 Franzensfeste,54,,6,3,9
032 Franzensfeste,55,,5,5,10
032 Franzensfeste,56,,8,5,13
032 Franzensfeste,57,,2,3,5
032 Franzensfeste,58,,7,6,13
032 Franzensfeste,59,,6,2,8
032 Franzensfeste,60,,4,3,7
032 Franzensfeste,61,,3,3,6
032 Franzensfeste,62,,3,5,8
032 Franzensfeste,63,,4,6,10
032 Franzensfeste,64,,3,8,11
032 Franzensfeste,65,,7,5,12
032 Franzensfeste,66,,4,8,12
032 Franzensfeste,67,,2,2,4
032 Franzensfeste,68,,4,7,11
032 Franzensfeste,69,,4,10,14
032 Franzensfeste,70,,5,1,6
032 Franzensfeste,71,,6,5,11
032 Franzensfeste,72,,4,8,12
032 Franzensfeste,73,,7,5,12
032 Franzensfeste,74,,2,6,8
032 Franzensfeste,75,,2,4,6
032 Franzensfeste,76,,1,-,1
032 Franzensfeste,77,,-,3,3
032 Franzensfeste,78,,1,-,1
032 Franzensfeste,79,,1,1,2
032 Franzensfeste,80,,1,3,4
032 Franzensfeste,81,,2,3,5
032 Franzensfeste,82,,2,1,3
032 Franzensfeste,83,,1,2,3
032 Franzensfeste,84,,-,1,1
032 Franzensfeste,85,,1,-,1
032 Franzensfeste,86,,-,2,2
032 Franzensfeste,87,,1,2,3
032 Franzensfeste,88,,-,1,1
032 Franzensfeste,89,,2,2,4
032 Franzensfeste,91,,1,1,2
032 Franzensfeste,93,,-,1,1
032 Franzensfeste,94,,-,1,1
032 Franzensfeste,101,,1,1,2
033 Villnöss,0,,19,13,32
033 Villnöss,1,,14,12,26
033 Villnöss,2,,16,11,27
033 Villnöss,3,,12,14,26
033 Villnöss,4,,22,17,39
033 Villnöss,5,,14,12,26
033 Villnöss,6,,13,7,20
033 Villnöss,7,,16,23,39
033 Villnöss,8,,19,18,37
033 Villnöss,9,,10,16,26
033 Villnöss,10,,19,17,36
033 Villnöss,11,,15,13,28
033 Villnöss,12,,16,14,30
033 Villnöss,13,,12,15,27
033 Villnöss,14,,12,18,30
033 Villnöss,15,,20,9,29
033 Villnöss,16,,11,12,23
033 Villnöss,17,,15,13,28
033 Villnöss,18,,16,15,31
033 Villnöss,19,,15,13,28
033 Villnöss,20,,24,15,39
033 Villnöss,21,,21,21,42
033 Villnöss,22,,15,25,40
033 Villnöss,23,,21,25,46
033 Villnöss,24,,29,29,58
033 Villnöss,25,,22,30,52
033 Villnöss,26,,31,20,51
033 Villnöss,27,,32,19,51
033 Villnöss,28,,25,21,46
033 Villnöss,29,,29,24,53
033 Villnöss,30,,33,27,60
033 Villnöss,31,,36,26,62
033 Villnöss,32,,30,20,50
033 Villnöss,33,,22,19,41
033 Villnöss,34,,23,15,38
033 Villnöss,35,,20,12,32
033 Villnöss,36,,11,11,22
033 Villnöss,37,,9,16,25
033 Villnöss,38,,13,12,25
033 Villnöss,39,,12,13,25
033 Villnöss,40,,13,2,15
033 Villnöss,41,,17,13,30
033 Villnöss,42,,13,13,26
033 Villnöss,43,,15,11,26
033 Villnöss,44,,9,9,18
033 Villnöss,45,,7,10,17
033 Villnöss,46,,9,13,22
033 Villnöss,47,,9,9,18
033 Villnöss,48,,10,11,21
033 Villnöss,49,,8,5,13
033 Villnöss,50,,6,5,11
033 Villnöss,51,,10,15,25
033 Villnöss,52,,13,8,21
033 Villnöss,53,,15,18,33
033 Villnöss,54,,14,10,24
033 Villnöss,55,,10,18,28
033 Villnöss,56,,12,13,25
033 Villnöss,57,,13,9,22
033 Villnöss,58,,11,15,26
033 Villnöss,59,,7,17,24
033 Villnöss,60,,7,10,17
033 Villnöss,61,,13,9,22
033 Villnöss,62,,11,12,23
033 Villnöss,63,,16,14,30
033 Villnöss,64,,10,11,21
033 Villnöss,65,,14,11,25
033 Villnöss,66,,13,12,25
033 Villnöss,67,,16,9,25
033 Villnöss,68,,11,11,22
033 Villnöss,69,,8,9,17
033 Villnöss,70,,9,7,16
033 Villnöss,71,,7,15,22
033 Villnöss,72,,7,16,23
033 Villnöss,73,,5,13,18
033 Villnöss,74,,1,9,10
033 Villnöss,75,,1,7,8
033 Villnöss,76,,4,4,8
033 Villnöss,77,,1,3,4
033 Villnöss,78,,5,5,10
033 Villnöss,79,,2,3,5
033 Villnöss,80,,4,4,8
033 Villnöss,81,,5,4,9
033 Villnöss,82,,3,5,8
033 Villnöss,83,,1,7,8
033 Villnöss,84,,1,1,2
033 Villnöss,85,,1,4,5
033 Villnöss,86,,1,4,5
033 Villnöss,87,,-,8,8
033 Villnöss,88,,1,1,2
033 Villnöss,89,,2,3,5
033 Villnöss,90,,-,1,1
033 Villnöss,93,,2,-,2
033 Villnöss,95,,1,2,3
034 Gais,0,,21,17,38
034 Gais,1,,23,22,45
034 Gais,2,,11,21,32
034 Gais,3,,22,27,49
034 Gais,4,,25,28,53
034 Gais,5,,15,21,36
034 Gais,6,,16,16,32
034 Gais,7,,19,17,36
034 Gais,8,,17,19,36
034 Gais,9,,18,16,34
034 Gais,10,,23,15,38
034 Gais,11,,22,13,35
034 Gais,12,,21,18,39
034 Gais,13,,18,18,36
034 Gais,14,,22,19,41
034 Gais,15,,24,20,44
034 Gais,16,,24,14,38
034 Gais,17,,19,18,37
034 Gais,18,,17,21,38
034 Gais,19,,23,21,44
034 Gais,20,,19,20,39
034 Gais,21,,28,26,54
034 Gais,22,,27,25,52
034 Gais,23,,21,39,60
034 Gais,24,,27,26,53
034 Gais,25,,28,27,55
034 Gais,26,,32,33,65
034 Gais,27,,20,27,47
034 Gais,28,,22,24,46
034 Gais,29,,32,17,49
034 Gais,30,,29,26,55
034 Gais,31,,31,31,62
034 Gais,32,,14,16,30
034 Gais,33,,31,18,49
034 Gais,34,,18,26,44
034 Gais,35,,19,13,32
034 Gais,36,,18,22,40
034 Gais,37,,26,18,44
034 Gais,38,,12,14,26
034 Gais,39,,26,18,44
034 Gais,40,,15,13,28
034 Gais,41,,15,11,26
034 Gais,42,,16,13,29
034 Gais,43,,15,14,29
034 Gais,44,,15,19,34
034 Gais,45,,19,20,39
034 Gais,46,,16,11,27
034 Gais,47,,25,15,40
034 Gais,48,,22,13,35
034 Gais,49,,15,16,31
034 Gais,50,,11,9,20
034 Gais,51,,13,15,28
034 Gais,52,,11,16,27
034 Gais,53,,14,13,27
034 Gais,54,,25,15,40
034 Gais,55,,17,14,31
034 Gais,56,,13,15,28
034 Gais,57,,14,15,29
034 Gais,58,,17,16,33
034 Gais,59,,10,16,26
034 Gais,60,,15,12,27
034 Gais,61,,6,6,12
034 Gais,62,,5,10,15
034 Gais,63,,8,10,18
034 Gais,64,,13,10,23
034 Gais,65,,9,13,22
034 Gais,66,,6,5,11
034 Gais,67,,10,8,18
034 Gais,68,,7,11,18
034 Gais,69,,15,11,26
034 Gais,70,,7,6,13
034 Gais,71,,5,9,14
034 Gais,72,,8,12,20
034 Gais,73,,3,6,9
034 Gais,74,,4,8,12
034 Gais,75,,3,4,7
034 Gais,76,,1,7,8
034 Gais,77,,3,7,10
034 Gais,78,,2,5,7
034 Gais,79,,-,5,5
034 Gais,80,,1,8,9
034 Gais,81,,1,5,6
034 Gais,82,,5,4,9
034 Gais,83,,-,4,4
034 Gais,84,,2,3,5
034 Gais,85,,2,1,3
034 Gais,86,,1,2,3
034 Gais,87,,1,3,4
034 Gais,88,,-,1,1
034 Gais,90,,-,1,1
034 Gais,92,,-,1,1
034 Gais,93,,-,1,1
034 Gais,95,,-,1,1
035 Gargazon,0,,6,3,9
035 Gargazon,1,,2,6,8
035 Gargazon,2,,7,4,11
035 Gargazon,3,,8,6,14
035 Gargazon,4,,15,9,24
035 Gargazon,5,,4,10,14
035 Gargazon,6,,10,6,16
035 Gargazon,7,,9,4,13
035 Gargazon,8,,6,8,14
035 Gargazon,9,,6,9,15
035 Gargazon,10,,10,3,13
035 Gargazon,11,,11,4,15
035 Gargazon,12,,4,7,11
035 Gargazon,13,,5,7,12
035 Gargazon,14,,10,6,16
035 Gargazon,15,,5,11,16
035 Gargazon,16,,6,7,13
035 Gargazon,17,,2,8,10
035 Gargazon,18,,4,4,8
035 Gargazon,19,,5,3,8
035 Gargazon,20,,7,2,9
035 Gargazon,21,,6,11,17
035 Gargazon,22,,8,7,15
035 Gargazon,23,,6,8,14
035 Gargazon,24,,10,9,19
035 Gargazon,25,,9,7,16
035 Gargazon,26,,11,10,21
035 Gargazon,27,,14,13,27
035 Gargazon,28,,14,17,31
035 Gargazon,29,,9,7,16
035 Gargazon,30,,11,9,20
035 Gargazon,31,,10,12,22
035 Gargazon,32,,11,16,27
035 Gargazon,33,,12,10,22
035 Gargazon,34,,7,11,18
035 Gargazon,35,,9,11,20
035 Gargazon,36,,15,11,26
035 Gargazon,37,,8,8,16
035 Gargazon,38,,16,9,25
035 Gargazon,39,,11,6,17
035 Gargazon,40,,8,2,10
035 Gargazon,41,,9,9,18
035 Gargazon,42,,15,8,23
035 Gargazon,43,,3,4,7
035 Gargazon,44,,11,7,18
035 Gargazon,45,,6,7,13
035 Gargazon,46,,4,9,13
035 Gargazon,47,,8,8,16
035 Gargazon,48,,6,10,16
035 Gargazon,49,,7,13,20
035 Gargazon,50,,8,5,13
035 Gargazon,51,,2,5,7
035 Gargazon,52,,3,7,10
035 Gargazon,53,,8,10,18
035 Gargazon,54,,10,10,20
035 Gargazon,55,,5,14,19
035 Gargazon,56,,12,5,17
035 Gargazon,57,,12,7,19
035 Gargazon,58,,8,11,19
035 Gargazon,59,,5,4,9
035 Gargazon,60,,15,2,17
035 Gargazon,61,,9,7,16
035 Gargazon,62,,5,11,16
035 Gargazon,63,,7,2,9
035 Gargazon,64,,5,7,12
035 Gargazon,65,,6,6,12
035 Gargazon,66,,3,10,13
035 Gargazon,67,,4,5,9
035 Gargazon,68,,5,5,10
035 Gargazon,69,,6,4,10
035 Gargazon,70,,5,6,11
035 Gargazon,71,,4,4,8
035 Gargazon,72,,5,6,11
035 Gargazon,73,,3,8,11
035 Gargazon,74,,7,6,13
035 Gargazon,75,,4,5,9
035 Gargazon,76,,2,3,5
035 Gargazon,77,,1,2,3
035 Gargazon,78,,-,3,3
035 Gargazon,79,,-,1,1
035 Gargazon,80,,2,2,4
035 Gargazon,81,,2,1,3
035 Gargazon,82,,2,7,9
035 Gargazon,83,,2,4,6
035 Gargazon,84,,-,1,1
035 Gargazon,85,,1,-,1
035 Gargazon,86,,-,3,3
035 Gargazon,87,,-,1,1
035 Gargazon,88,,1,1,2
035 Gargazon,89,,1,1,2
035 Gargazon,91,,-,2,2
036 Glurns,0,,8,5,13
036 Glurns,1,,1,5,6
036 Glurns,2,,8,6,14
036 Glurns,3,,4,8,12
036 Glurns,4,,6,3,9
036 Glurns,5,,11,5,16
036 Glurns,6,,4,4,8
036 Glurns,7,,6,9,15
036 Glurns,8,,7,6,13
036 Glurns,9,,6,8,14
036 Glurns,10,,3,3,6
036 Glurns,11,,7,7,14
036 Glurns,12,,9,6,15
036 Glurns,13,,10,9,19
036 Glurns,14,,6,7,13
036 Glurns,15,,13,7,20
036 Glurns,16,,6,8,14
036 Glurns,17,,5,8,13
036 Glurns,18,,5,5,10
036 Glurns,19,,10,4,14
036 Glurns,20,,6,7,13
036 Glurns,21,,7,7,14
036 Glurns,22,,3,2,5
036 Glurns,23,,3,9,12
036 Glurns,24,,3,7,10
036 Glurns,25,,2,2,4
036 Glurns,26,,4,7,11
036 Glurns,27,,6,5,11
036 Glurns,28,,5,9,14
036 Glurns,29,,3,5,8
036 Glurns,30,,2,6,8
036 Glurns,31,,10,4,14
036 Glurns,32,,6,12,18
036 Glurns,33,,4,6,10
036 Glurns,34,,5,7,12
036 Glurns,35,,8,8,16
036 Glurns,36,,12,7,19
036 Glurns,37,,4,10,14
036 Glurns,38,,6,12,18
036 Glurns,39,,8,5,13
036 Glurns,40,,9,7,16
036 Glurns,41,,12,4,16
036 Glurns,42,,9,9,18
036 Glurns,43,,5,10,15
036 Glurns,44,,8,9,17
036 Glurns,45,,6,5,11
036 Glurns,46,,6,3,9
036 Glurns,47,,7,4,11
036 Glurns,48,,10,6,16
036 Glurns,49,,9,2,11
036 Glurns,50,,7,1,8
036 Glurns,51,,5,4,9
036 Glurns,52,,1,4,5
036 Glurns,53,,5,5,10
036 Glurns,54,,5,1,6
036 Glurns,55,,4,1,5
036 Glurns,56,,1,3,4
036 Glurns,57,,3,4,7
036 Glurns,58,,5,5,10
036 Glurns,59,,-,1,1
036 Glurns,60,,2,4,6
036 Glurns,61,,1,6,7
036 Glurns,62,,1,1,2
036 Glurns,63,,7,3,10
036 Glurns,64,,4,2,6
036 Glurns,65,,7,2,9
036 Glurns,66,,5,7,12
036 Glurns,67,,1,3,4
036 Glurns,68,,1,3,4
036 Glurns,69,,1,2,3
036 Glurns,70,,1,6,7
036 Glurns,71,,4,2,6
036 Glurns,72,,-,1,1
036 Glurns,73,,2,-,2
036 Glurns,74,,2,3,5
036 Glurns,75,,2,3,5
036 Glurns,76,,2,3,5
036 Glurns,77,,-,3,3
036 Glurns,78,,1,2,3
036 Glurns,80,,-,6,6
036 Glurns,81,,-,7,7
036 Glurns,82,,2,6,8
036 Glurns,83,,1,4,5
036 Glurns,84,,1,3,4
036 Glurns,85,,-,2,2
036 Glurns,86,,-,2,2
036 Glurns,87,,-,1,1
036 Glurns,88,,-,1,1
036 Glurns,91,,-,1,1
037 Latsch,0,,41,33,74
037 Latsch,1,,35,24,59
037 Latsch,2,,34,28,62
037 Latsch,3,,34,35,69
037 Latsch,4,,28,35,63
037 Latsch,5,,35,50,85
037 Latsch,6,,35,30,65
037 Latsch,7,,42,33,75
037 Latsch,8,,30,34,64
037 Latsch,9,,35,25,60
037 Latsch,10,,29,34,63
037 Latsch,11,,35,34,69
037 Latsch,12,,26,30,56
037 Latsch,13,,29,46,75
037 Latsch,14,,27,35,62
037 Latsch,15,,26,34,60
037 Latsch,16,,32,26,58
037 Latsch,17,,26,22,48
037 Latsch,18,,25,33,58
037 Latsch,19,,21,22,43
037 Latsch,20,,33,32,65
037 Latsch,21,,26,27,53
037 Latsch,22,,29,32,61
037 Latsch,23,,28,38,66
037 Latsch,24,,37,36,73
037 Latsch,25,,37,37,74
037 Latsch,26,,31,38,69
037 Latsch,27,,39,53,92
037 Latsch,28,,41,47,88
037 Latsch,29,,27,47,74
037 Latsch,30,,54,47,101
037 Latsch,31,,57,35,92
037 Latsch,32,,52,46,98
037 Latsch,33,,41,45,86
037 Latsch,34,,45,39,84
037 Latsch,35,,42,51,93
037 Latsch,36,,44,44,88
037 Latsch,37,,37,28,65
037 Latsch,38,,27,29,56
037 Latsch,39,,32,32,64
037 Latsch,40,,35,26,61
037 Latsch,41,,32,21,53
037 Latsch,42,,29,18,47
037 Latsch,43,,38,18,56
037 Latsch,44,,18,36,54
037 Latsch,45,,30,14,44
037 Latsch,46,,15,22,37
037 Latsch,47,,18,22,40
037 Latsch,48,,19,16,35
037 Latsch,49,,20,20,40
037 Latsch,50,,19,18,37
037 Latsch,51,,24,11,35
037 Latsch,52,,27,22,49
037 Latsch,53,,33,24,57
037 Latsch,54,,18,26,44
037 Latsch,55,,20,24,44
037 Latsch,56,,17,20,37
037 Latsch,57,,21,28,49
037 Latsch,58,,15,29,44
037 Latsch,59,,23,14,37
037 Latsch,60,,29,15,44
037 Latsch,61,,21,27,48
037 Latsch,62,,21,22,43
037 Latsch,63,,25,23,48
037 Latsch,64,,19,18,37
037 Latsch,65,,22,20,42
037 Latsch,66,,19,16,35
037 Latsch,67,,19,20,39
037 Latsch,68,,18,32,50
037 Latsch,69,,23,16,39
037 Latsch,70,,21,22,43
037 Latsch,71,,13,17,30
037 Latsch,72,,16,25,41
037 Latsch,73,,12,25,37
037 Latsch,74,,17,21,38
037 Latsch,75,,14,13,27
037 Latsch,76,,7,16,23
037 Latsch,77,,3,5,8
037 Latsch,78,,4,9,13
037 Latsch,79,,4,6,10
037 Latsch,80,,7,7,14
037 Latsch,81,,5,13,18
037 Latsch,82,,6,15,21
037 Latsch,83,,7,4,11
037 Latsch,84,,3,7,10
037 Latsch,85,,4,5,9
037 Latsch,86,,3,10,13
037 Latsch,87,,4,9,13
037 Latsch,88,,4,2,6
037 Latsch,89,,1,10,11
037 Latsch,90,,3,4,7
037 Latsch,91,,1,3,4
037 Latsch,92,,-,3,3
037 Latsch,93,,1,-,1
037 Latsch,95,,-,2,2
037 Latsch,96,,1,-,1
038 Algund,0,,25,21,46
038 Algund,1,,30,14,44
038 Algund,2,,22,20,42
038 Algund,3,,27,18,45
038 Algund,4,,23,20,43
038 Algund,5,,31,15,46
038 Algund,6,,20,32,52
038 Algund,7,,19,23,42
038 Algund,8,,27,19,46
038 Algund,9,,19,31,50
038 Algund,10,,27,18,45
038 Algund,11,,22,18,40
038 Algund,12,,24,27,51
038 Algund,13,,27,21,48
038 Algund,14,,24,20,44
038 Algund,15,,26,27,53
038 Algund,16,,18,21,39
038 Algund,17,,14,27,41
038 Algund,18,,17,25,42
038 Algund,19,,21,21,42
038 Algund,20,,23,19,42
038 Algund,21,,19,25,44
038 Algund,22,,30,22,52
038 Algund,23,,34,36,70
038 Algund,24,,22,29,51
038 Algund,25,,46,32,78
038 Algund,26,,42,27,69
038 Algund,27,,39,27,66
038 Algund,28,,28,38,66
038 Algund,29,,33,43,76
038 Algund,30,,35,41,76
038 Algund,31,,43,29,72
038 Algund,32,,41,37,78
038 Algund,33,,30,38,68
038 Algund,34,,29,44,73
038 Algund,35,,32,41,73
038 Algund,36,,38,29,67
038 Algund,37,,38,33,71
038 Algund,38,,27,29,56
038 Algund,39,,31,29,60
038 Algund,40,,24,26,50
038 Algund,41,,32,21,53
038 Algund,42,,17,31,48
038 Algund,43,,25,24,49
038 Algund,44,,22,27,49
038 Algund,45,,22,26,48
038 Algund,46,,28,27,55
038 Algund,47,,29,21,50
038 Algund,48,,20,18,38
038 Algund,49,,34,28,62
038 Algund,50,,26,23,49
038 Algund,51,,24,31,55
038 Algund,52,,27,23,50
038 Algund,53,,22,36,58
038 Algund,54,,24,25,49
038 Algund,55,,18,24,42
038 Algund,56,,30,31,61
038 Algund,57,,26,24,50
038 Algund,58,,16,12,28
038 Algund,59,,19,31,50
038 Algund,60,,17,21,38
038 Algund,61,,23,27,50
038 Algund,62,,24,23,47
038 Algund,63,,20,23,43
038 Algund,64,,16,24,40
038 Algund,65,,16,28,44
038 Algund,66,,15,24,39
038 Algund,67,,15,22,37
038 Algund,68,,13,23,36
038 Algund,69,,18,21,39
038 Algund,70,,13,16,29
038 Algund,71,,10,19,29
038 Algund,72,,10,12,22
038 Algund,73,,15,24,39
038 Algund,74,,16,18,34
038 Algund,75,,18,16,34
038 Algund,76,,11,18,29
038 Algund,77,,8,9,17
038 Algund,78,,5,7,12
038 Algund,79,,4,8,12
038 Algund,80,,9,8,17
038 Algund,81,,9,10,19
038 Algund,82,,2,12,14
038 Algund,83,,6,15,21
038 Algund,84,,4,13,17
038 Algund,85,,9,14,23
038 Algund,86,,4,4,8
038 Algund,87,,5,6,11
038 Algund,88,,3,5,8
038 Algund,89,,2,6,8
038 Algund,90,,3,5,8
038 Algund,91,,-,3,3
038 Algund,92,,1,-,1
038 Algund,93,,2,5,7
038 Algund,94,,-,2,2
039 Lajen,0,,9,12,21
039 Lajen,1,,9,11,20
039 Lajen,2,,13,11,24
039 Lajen,3,,14,12,26
039 Lajen,4,,19,15,34
039 Lajen,5,,8,9,17
039 Lajen,6,,17,14,31
039 Lajen,7,,12,9,21
039 Lajen,8,,13,6,19
039 Lajen,9,,18,13,31
039 Lajen,10,,19,11,30
039 Lajen,11,,10,13,23
039 Lajen,12,,9,18,27
039 Lajen,13,,20,15,35
039 Lajen,14,,11,22,33
039 Lajen,15,,20,17,37
039 Lajen,16,,18,12,30
039 Lajen,17,,23,17,40
039 Lajen,18,,17,9,26
039 Lajen,19,,17,12,29
039 Lajen,20,,17,24,41
039 Lajen,21,,26,17,43
039 Lajen,22,,15,14,29
039 Lajen,23,,18,20,38
039 Lajen,24,,18,20,38
039 Lajen,25,,20,21,41
039 Lajen,26,,27,21,48
039 Lajen,27,,20,19,39
039 Lajen,28,,25,17,42
039 Lajen,29,,18,17,35
039 Lajen,30,,28,15,43
039 Lajen,31,,21,15,36
039 Lajen,32,,16,9,25
039 Lajen,33,,26,14,40
039 Lajen,34,,14,24,38
039 Lajen,35,,12,10,22
039 Lajen,36,,15,21,36
039 Lajen,37,,20,11,31
039 Lajen,38,,13,11,24
039 Lajen,39,,10,13,23
039 Lajen,40,,13,10,23
039 Lajen,41,,6,13,19
039 Lajen,42,,8,9,17
039 Lajen,43,,8,8,16
039 Lajen,44,,8,13,21
039 Lajen,45,,13,14,27
039 Lajen,46,,4,13,17
039 Lajen,47,,11,14,25
039 Lajen,48,,14,6,20
039 Lajen,49,,13,11,24
039 Lajen,50,,13,10,23
039 Lajen,51,,10,8,18
039 Lajen,52,,12,13,25
039 Lajen,53,,21,12,33
039 Lajen,54,,17,16,33
039 Lajen,55,,15,11,26
039 Lajen,56,,17,10,27
039 Lajen,57,,7,14,21
039 Lajen,58,,7,8,15
039 Lajen,59,,8,7,15
039 Lajen,60,,9,9,18
039 Lajen,61,,8,8,16
039 Lajen,62,,5,12,17
039 Lajen,63,,9,4,13
039 Lajen,64,,5,8,13
039 Lajen,65,,9,5,14
039 Lajen,66,,8,6,14
039 Lajen,67,,8,10,18
039 Lajen,68,,8,12,20
039 Lajen,69,,11,7,18
039 Lajen,70,,7,10,17
039 Lajen,71,,7,7,14
039 Lajen,72,,8,9,17
039 Lajen,73,,5,6,11
039 Lajen,74,,5,10,15
039 Lajen,75,,3,5,8
039 Lajen,76,,3,5,8
039 Lajen,77,,2,4,6
039 Lajen,78,,1,2,3
039 Lajen,79,,-,3,3
039 Lajen,80,,4,3,7
039 Lajen,81,,2,4,6
039 Lajen,82,,3,4,7
039 Lajen,83,,2,5,7
039 Lajen,84,,3,-,3
039 Lajen,85,,2,4,6
039 Lajen,86,,2,6,8
039 Lajen,87,,4,5,9
039 Lajen,88,,-,5,5
039 Lajen,89,,1,3,4
039 Lajen,90,,-,1,1
039 Lajen,91,,1,-,1
039 Lajen,92,,-,3,3
039 Lajen,93,,-,2,2
039 Lajen,97,,1,-,1
039 Lajen,99,,1,-,1
040 Leifers,0,,97,99,196
040 Leifers,1,,89,92,181
040 Leifers,2,,78,69,147
040 Leifers,3,,88,71,159
040 Leifers,4,,89,86,175
040 Leifers,5,,95,74,169
040 Leifers,6,,66,81,147
040 Leifers,7,,66,82,148
040 Leifers,8,,60,72,132
040 Leifers,9,,76,84,160
040 Leifers,10,,75,63,138
040 Leifers,11,,73,76,149
040 Leifers,12,,73,94,167
040 Leifers,13,,59,62,121
040 Leifers,14,,67,60,127
040 Leifers,15,,70,67,137
040 Leifers,16,,66,80,146
040 Leifers,17,,68,69,137
040 Leifers,18,,77,92,169
040 Leifers,19,,77,76,153
040 Leifers,20,,90,106,196
040 Leifers,21,,109,111,220
040 Leifers,22,,113,104,217
040 Leifers,23,,124,107,231
040 Leifers,24,,132,115,247
040 Leifers,25,,118,126,244
040 Leifers,26,,135,115,250
040 Leifers,27,,141,154,295
040 Leifers,28,,140,140,280
040 Leifers,29,,159,140,299
040 Leifers,30,,163,142,305
040 Leifers,31,,173,153,326
040 Leifers,32,,137,154,291
040 Leifers,33,,139,121,260
040 Leifers,34,,142,152,294
040 Leifers,35,,137,124,261
040 Leifers,36,,121,103,224
040 Leifers,37,,100,112,212
040 Leifers,38,,102,116,218
040 Leifers,39,,140,139,279
040 Leifers,40,,110,126,236
040 Leifers,41,,97,107,204
040 Leifers,42,,120,116,236
040 Leifers,43,,106,99,205
040 Leifers,44,,111,94,205
040 Leifers,45,,94,89,183
040 Leifers,46,,100,100,200
040 Leifers,47,,115,106,221
040 Leifers,48,,107,99,206
040 Leifers,49,,132,151,283
040 Leifers,50,,80,88,168
040 Leifers,51,,105,95,200
040 Leifers,52,,99,98,197
040 Leifers,53,,95,98,193
040 Leifers,54,,93,87,180
040 Leifers,55,,104,93,197
040 Leifers,56,,102,99,201
040 Leifers,57,,98,81,179
040 Leifers,58,,71,86,157
040 Leifers,59,,70,67,137
040 Leifers,60,,58,74,132
040 Leifers,61,,73,65,138
040 Leifers,62,,71,67,138
040 Leifers,63,,74,82,156
040 Leifers,64,,59,73,132
040 Leifers,65,,65,68,133
040 Leifers,66,,56,64,120
040 Leifers,67,,57,47,104
040 Leifers,68,,45,70,115
040 Leifers,69,,39,61,100
040 Leifers,70,,35,57,92
040 Leifers,71,,36,62,98
040 Leifers,72,,37,42,79
040 Leifers,73,,35,48,83
040 Leifers,74,,30,34,64
040 Leifers,75,,27,30,57
040 Leifers,76,,15,39,54
040 Leifers,77,,12,24,36
040 Leifers,78,,5,15,20
040 Leifers,79,,10,21,31
040 Leifers,80,,8,24,32
040 Leifers,81,,11,30,41
040 Leifers,82,,20,32,52
040 Leifers,83,,13,35,48
040 Leifers,84,,10,30,40
040 Leifers,85,,4,23,27
040 Leifers,86,,9,16,25
040 Leifers,87,,4,13,17
040 Leifers,88,,5,14,19
040 Leifers,89,,1,10,11
040 Leifers,90,,4,5,9
040 Leifers,91,,1,8,9
040 Leifers,92,,1,6,7
040 Leifers,93,,-,2,2
040 Leifers,94,,1,3,4
040 Leifers,95,,-,4,4
040 Leifers,97,,-,1,1
040 Leifers,99,,-,1,1
040 Leifers,100,,-,1,1
041 Lana,0,,51,53,104
041 Lana,1,,57,60,117
041 Lana,2,,52,52,104
041 Lana,3,,51,56,107
041 Lana,4,,51,59,110
041 Lana,5,,42,61,103
041 Lana,6,,40,72,112
041 Lana,7,,55,48,103
041 Lana,8,,66,45,111
041 Lana,9,,55,48,103
041 Lana,10,,56,55,111
041 Lana,11,,59,48,107
041 Lana,12,,64,58,122
041 Lana,13,,64,50,114
041 Lana,14,,46,60,106
041 Lana,15,,49,49,98
041 Lana,16,,53,64,117
041 Lana,17,,59,50,109
041 Lana,18,,66,50,116
041 Lana,19,,55,47,102
041 Lana,20,,55,57,112
041 Lana,21,,63,54,117
041 Lana,22,,66,72,138
041 Lana,23,,84,66,150
041 Lana,24,,71,73,144
041 Lana,25,,65,85,150
041 Lana,26,,108,64,172
041 Lana,27,,64,76,140
041 Lana,28,,86,87,173
041 Lana,29,,75,99,174
041 Lana,30,,89,83,172
041 Lana,31,,84,90,174
041 Lana,32,,97,82,179
041 Lana,33,,80,78,158
041 Lana,34,,76,79,155
041 Lana,35,,78,72,150
041 Lana,36,,84,73,157
041 Lana,37,,73,82,155
041 Lana,38,,77,69,146
041 Lana,39,,58,63,121
041 Lana,40,,57,65,122
041 Lana,41,,60,58,118
041 Lana,42,,62,61,123
041 Lana,43,,47,56,103
041 Lana,44,,58,60,118
041 Lana,45,,50,54,104
041 Lana,46,,52,55,107
041 Lana,47,,59,63,122
041 Lana,48,,55,44,99
041 Lana,49,,66,64,130
041 Lana,50,,43,47,90
041 Lana,51,,50,55,105
041 Lana,52,,60,58,118
041 Lana,53,,62,63,125
041 Lana,54,,51,51,102
041 Lana,55,,41,46,87
041 Lana,56,,55,51,106
041 Lana,57,,47,60,107
041 Lana,58,,37,41,78
041 Lana,59,,45,51,96
041 Lana,60,,42,41,83
041 Lana,61,,42,45,87
041 Lana,62,,35,45,80
041 Lana,63,,35,35,70
041 Lana,64,,30,45,75
041 Lana,65,,30,40,70
041 Lana,66,,27,40,67
041 Lana,67,,41,35,76
041 Lana,68,,35,39,74
041 Lana,69,,31,42,73
041 Lana,70,,35,47,82
041 Lana,71,,17,26,43
041 Lana,72,,22,36,58
041 Lana,73,,30,40,70
041 Lana,74,,22,40,62
041 Lana,75,,26,44,70
041 Lana,76,,14,31,45
041 Lana,77,,5,12,17
041 Lana,78,,8,22,30
041 Lana,79,,5,8,13
041 Lana,80,,17,27,44
041 Lana,81,,17,16,33
041 Lana,82,,12,30,42
041 Lana,83,,9,19,28
041 Lana,84,,11,30,41
041 Lana,85,,9,18,27
041 Lana,86,,8,13,21
041 Lana,87,,6,15,21
041 Lana,88,,3,11,14
041 Lana,89,,4,13,17
041 Lana,90,,2,6,8
041 Lana,91,,2,8,10
041 Lana,92,,1,3,4
041 Lana,93,,-,4,4
041 Lana,94,,1,6,7
041 Lana,95,,1,3,4
041 Lana,96,,1,-,1
042 Laas,0,,30,22,52
042 Laas,1,,26,27,53
042 Laas,2,,22,20,42
042 Laas,3,,15,25,40
042 Laas,4,,24,20,44
042 Laas,5,,23,24,47
042 Laas,6,,20,22,42
042 Laas,7,,22,18,40
042 Laas,8,,28,22,50
042 Laas,9,,31,22,53
042 Laas,10,,27,27,54
042 Laas,11,,28,25,53
042 Laas,12,,22,37,59
042 Laas,13,,35,24,59
042 Laas,14,,26,28,54
042 Laas,15,,17,23,40
042 Laas,16,,31,32,63
042 Laas,17,,31,18,49
042 Laas,18,,24,20,44
042 Laas,19,,25,27,52
042 Laas,20,,29,26,55
042 Laas,21,,34,21,55
042 Laas,22,,30,36,66
042 Laas,23,,28,26,54
042 Laas,24,,31,27,58
042 Laas,25,,42,24,66
042 Laas,26,,38,46,84
042 Laas,27,,41,19,60
042 Laas,28,,30,28,58
042 Laas,29,,37,27,64
042 Laas,30,,41,30,71
042 Laas,31,,31,34,65
042 Laas,32,,31,26,57
042 Laas,33,,36,28,64
042 Laas,34,,29,28,57
042 Laas,35,,34,21,55
042 Laas,36,,35,30,65
042 Laas,37,,27,25,52
042 Laas,38,,19,25,44
042 Laas,39,,24,17,41
042 Laas,40,,16,14,30
042 Laas,41,,16,24,40
042 Laas,42,,25,12,37
042 Laas,43,,28,25,53
042 Laas,44,,16,17,33
042 Laas,45,,25,26,51
042 Laas,46,,20,20,40
042 Laas,47,,16,20,36
042 Laas,48,,27,13,40
042 Laas,49,,14,15,29
042 Laas,50,,16,12,28
042 Laas,51,,13,14,27
042 Laas,52,,13,16,29
042 Laas,53,,16,20,36
042 Laas,54,,16,21,37
042 Laas,55,,24,24,48
042 Laas,56,,15,25,40
042 Laas,57,,21,14,35
042 Laas,58,,16,14,30
042 Laas,59,,24,14,38
042 Laas,60,,20,21,41
042 Laas,61,,13,21,34
042 Laas,62,,22,12,34
042 Laas,63,,17,18,35
042 Laas,64,,21,23,44
042 Laas,65,,20,22,42
042 Laas,66,,20,15,35
042 Laas,67,,15,13,28
042 Laas,68,,15,19,34
042 Laas,69,,18,13,31
042 Laas,70,,11,16,27
042 Laas,71,,13,20,33
042 Laas,72,,18,11,29
042 Laas,73,,13,21,34
042 Laas,74,,7,12,19
042 Laas,75,,12,13,25
042 Laas,76,,5,12,17
042 Laas,77,,8,6,14
042 Laas,78,,3,5,8
042 Laas,79,,4,5,9
042 Laas,80,,1,5,6
042 Laas,81,,2,9,11
042 Laas,82,,4,11,15
042 Laas,83,,5,9,14
042 Laas,84,,2,3,5
042 Laas,85,,6,7,13
042 Laas,86,,5,6,11
042 Laas,87,,1,5,6
042 Laas,88,,1,5,6
042 Laas,89,,-,3,3
042 Laas,90,,-,4,4
042 Laas,91,,1,2,3
042 Laas,93,,-,3,3
042 Laas,94,,-,1,1
042 Laas,95,,-,1,1
043 Laurein,0,,3,3,6
043 Laurein,1,,2,4,6
043 Laurein,2,,1,5,6
043 Laurein,3,,1,1,2
043 Laurein,4,,1,1,2
043 Laurein,5,,4,-,4
043 Laurein,6,,3,2,5
043 Laurein,7,,1,-,1
043 Laurein,8,,2,2,4
043 Laurein,9,,4,2,6
043 Laurein,10,,2,3,5
043 Laurein,11,,1,2,3
043 Laurein,12,,1,-,1
043 Laurein,13,,2,2,4
043 Laurein,14,,3,1,4
043 Laurein,15,,2,-,2
043 Laurein,16,,2,-,2
043 Laurein,17,,2,5,7
043 Laurein,18,,1,2,3
043 Laurein,19,,4,-,4
043 Laurein,20,,-,5,5
043 Laurein,21,,-,5,5
043 Laurein,22,,5,1,6
043 Laurein,23,,1,2,3
043 Laurein,24,,6,5,11
043 Laurein,25,,5,5,10
043 Laurein,26,,5,5,10
043 Laurein,27,,-,2,2
043 Laurein,28,,6,7,13
043 Laurein,29,,6,2,8
043 Laurein,30,,5,2,7
043 Laurein,31,,3,3,6
043 Laurein,32,,1,2,3
043 Laurein,33,,2,2,4
043 Laurein,34,,5,6,11
043 Laurein,35,,2,1,3
043 Laurein,36,,4,4,8
043 Laurein,37,,3,2,5
043 Laurein,38,,7,-,7
043 Laurein,40,,3,-,3
043 Laurein,41,,3,1,4
043 Laurein,42,,2,1,3
043 Laurein,43,,2,1,3
043 Laurein,45,,2,1,3
043 Laurein,46,,3,2,5
043 Laurein,47,,2,-,2
043 Laurein,48,,2,3,5
043 Laurein,49,,-,1,1
043 Laurein,50,,-,1,1
043 Laurein,51,,-,1,1
043 Laurein,52,,1,-,1
043 Laurein,53,,2,-,2
043 Laurein,55,,4,2,6
043 Laurein,56,,3,3,6
043 Laurein,57,,1,1,2
043 Laurein,58,,2,1,3
043 Laurein,59,,1,2,3
043 Laurein,60,,1,3,4
043 Laurein,61,,2,5,7
043 Laurein,62,,1,3,4
043 Laurein,63,,4,2,6
043 Laurein,64,,1,3,4
043 Laurein,65,,3,5,8
043 Laurein,66,,3,-,3
043 Laurein,67,,5,1,6
043 Laurein,68,,8,1,9
043 Laurein,69,,2,2,4
043 Laurein,70,,4,2,6
043 Laurein,71,,-,2,2
043 Laurein,72,,1,-,1
043 Laurein,73,,-,3,3
043 Laurein,74,,1,-,1
043 Laurein,75,,3,3,6
043 Laurein,76,,-,1,1
043 Laurein,79,,1,1,2
043 Laurein,80,,1,-,1
043 Laurein,81,,-,3,3
043 Laurein,82,,1,2,3
043 Laurein,83,,1,-,1
043 Laurein,84,,-,1,1
043 Laurein,85,,1,2,3
043 Laurein,87,,1,-,1
043 Laurein,88,,1,1,2
043 Laurein,89,,-,1,1
044 Lüsen,0,,9,12,21
044 Lüsen,1,,14,14,28
044 Lüsen,2,,10,8,18
044 Lüsen,3,,10,11,21
044 Lüsen,4,,8,10,18
044 Lüsen,5,,6,11,17
044 Lüsen,6,,17,7,24
044 Lüsen,7,,10,9,19
044 Lüsen,8,,7,7,14
044 Lüsen,9,,12,12,24
044 Lüsen,10,,3,3,6
044 Lüsen,11,,9,18,27
044 Lüsen,12,,6,11,17
044 Lüsen,13,,15,10,25
044 Lüsen,14,,11,13,24
044 Lüsen,15,,15,13,28
044 Lüsen,16,,8,10,18
044 Lüsen,17,,16,18,34
044 Lüsen,18,,6,10,16
044 Lüsen,19,,15,9,24
044 Lüsen,20,,12,10,22
044 Lüsen,21,,19,12,31
044 Lüsen,22,,10,7,17
044 Lüsen,23,,12,12,24
044 Lüsen,24,,16,13,29
044 Lüsen,25,,18,16,34
044 Lüsen,26,,8,15,23
044 Lüsen,27,,14,18,32
044 Lüsen,28,,12,23,35
044 Lüsen,29,,11,15,26
044 Lüsen,30,,18,13,31
044 Lüsen,31,,15,9,24
044 Lüsen,32,,14,8,22
044 Lüsen,33,,9,13,22
044 Lüsen,34,,12,9,21
044 Lüsen,35,,9,13,22
044 Lüsen,36,,7,4,11
044 Lüsen,37,,11,13,24
044 Lüsen,38,,10,11,21
044 Lüsen,39,,10,9,19
044 Lüsen,40,,7,6,13
044 Lüsen,41,,14,5,19
044 Lüsen,42,,8,10,18
044 Lüsen,43,,10,4,14
044 Lüsen,44,,5,7,12
044 Lüsen,45,,5,7,12
044 Lüsen,46,,8,12,20
044 Lüsen,47,,8,2,10
044 Lüsen,48,,7,4,11
044 Lüsen,49,,10,5,15
044 Lüsen,50,,4,8,12
044 Lüsen,51,,5,7,12
044 Lüsen,52,,7,6,13
044 Lüsen,53,,2,6,8
044 Lüsen,54,,7,4,11
044 Lüsen,55,,6,9,15
044 Lüsen,56,,9,7,16
044 Lüsen,57,,8,4,12
044 Lüsen,58,,9,6,15
044 Lüsen,59,,6,9,15
044 Lüsen,60,,8,5,13
044 Lüsen,61,,4,6,10
044 Lüsen,62,,8,5,13
044 Lüsen,63,,5,12,17
044 Lüsen,64,,8,5,13
044 Lüsen,65,,4,6,10
044 Lüsen,66,,6,8,14
044 Lüsen,67,,8,9,17
044 Lüsen,68,,8,4,12
044 Lüsen,69,,5,9,14
044 Lüsen,70,,4,7,11
044 Lüsen,71,,5,3,8
044 Lüsen,72,,6,5,11
044 Lüsen,73,,2,4,6
044 Lüsen,74,,2,7,9
044 Lüsen,75,,3,6,9
044 Lüsen,76,,3,2,5
044 Lüsen,77,,-,4,4
044 Lüsen,78,,1,3,4
044 Lüsen,79,,-,3,3
044 Lüsen,80,,-,4,4
044 Lüsen,81,,3,4,7
044 Lüsen,82,,6,4,10
044 Lüsen,83,,3,3,6
044 Lüsen,84,,1,2,3
044 Lüsen,85,,-,1,1
044 Lüsen,86,,1,2,3
044 Lüsen,87,,2,1,3
044 Lüsen,89,,1,-,1
044 Lüsen,91,,1,-,1
044 Lüsen,92,,1,-,1
044 Lüsen,95,,-,1,1
045 Margreid a.d. Weinstr.,0,,1,8,9
045 Margreid a.d. Weinstr.,1,,7,7,14
045 Margreid a.d. Weinstr.,2,,4,14,18
045 Margreid a.d. Weinstr.,3,,3,2,5
045 Margreid a.d. Weinstr.,4,,7,8,15
045 Margreid a.d. Weinstr.,5,,6,10,16
045 Margreid a.d. Weinstr.,6,,7,6,13
045 Margreid a.d. Weinstr.,7,,9,6,15
045 Margreid a.d. Weinstr.,8,,9,5,14
045 Margreid a.d. Weinstr.,9,,6,10,16
045 Margreid a.d. Weinstr.,10,,11,-,11
045 Margreid a.d. Weinstr.,11,,5,11,16
045 Margreid a.d. Weinstr.,12,,6,9,15
045 Margreid a.d. Weinstr.,13,,8,9,17
045 Margreid a.d. Weinstr.,14,,13,2,15
045 Margreid a.d. Weinstr.,15,,2,1,3
045 Margreid a.d. Weinstr.,16,,8,4,12
045 Margreid a.d. Weinstr.,17,,7,4,11
045 Margreid a.d. Weinstr.,18,,8,6,14
045 Margreid a.d. Weinstr.,19,,8,6,14
045 Margreid a.d. Weinstr.,20,,7,4,11
045 Margreid a.d. Weinstr.,21,,5,11,16
045 Margreid a.d. Weinstr.,22,,9,9,18
045 Margreid a.d. Weinstr.,23,,9,7,16
045 Margreid a.d. Weinstr.,24,,9,8,17
045 Margreid a.d. Weinstr.,25,,8,8,16
045 Margreid a.d. Weinstr.,26,,16,10,26
045 Margreid a.d. Weinstr.,27,,20,14,34
045 Margreid a.d. Weinstr.,28,,11,11,22
045 Margreid a.d. Weinstr.,29,,20,13,33
045 Margreid a.d. Weinstr.,30,,12,7,19
045 Margreid a.d. Weinstr.,31,,5,6,11
045 Margreid a.d. Weinstr.,32,,13,12,25
045 Margreid a.d. Weinstr.,33,,8,13,21
045 Margreid a.d. Weinstr.,34,,15,12,27
045 Margreid a.d. Weinstr.,35,,16,8,24
045 Margreid a.d. Weinstr.,36,,9,13,22
045 Margreid a.d. Weinstr.,37,,6,6,12
045 Margreid a.d. Weinstr.,38,,8,4,12
045 Margreid a.d. Weinstr.,39,,12,5,17
045 Margreid a.d. Weinstr.,40,,8,5,13
045 Margreid a.d. Weinstr.,41,,5,4,9
045 Margreid a.d. Weinstr.,42,,9,6,15
045 Margreid a.d. Weinstr.,43,,7,9,16
045 Margreid a.d. Weinstr.,44,,3,8,11
045 Margreid a.d. Weinstr.,45,,5,6,11
045 Margreid a.d. Weinstr.,46,,9,5,14
045 Margreid a.d. Weinstr.,47,,6,10,16
045 Margreid a.d. Weinstr.,48,,8,7,15
045 Margreid a.d. Weinstr.,49,,5,5,10
045 Margreid a.d. Weinstr.,50,,7,7,14
045 Margreid a.d. Weinstr.,51,,4,6,10
045 Margreid a.d. Weinstr.,52,,7,3,10
045 Margreid a.d. Weinstr.,53,,11,5,16
045 Margreid a.d. Weinstr.,54,,7,7,14
045 Margreid a.d. Weinstr.,55,,5,3,8
045 Margreid a.d. Weinstr.,56,,4,5,9
045 Margreid a.d. Weinstr.,57,,5,7,12
045 Margreid a.d. Weinstr.,58,,6,4,10
045 Margreid a.d. Weinstr.,59,,7,6,13
045 Margreid a.d. Weinstr.,60,,2,7,9
045 Margreid a.d. Weinstr.,61,,5,3,8
045 Margreid a.d. Weinstr.,62,,4,6,10
045 Margreid a.d. Weinstr.,63,,4,7,11
045 Margreid a.d. Weinstr.,64,,7,6,13
045 Margreid a.d. Weinstr.,65,,7,4,11
045 Margreid a.d. Weinstr.,66,,2,4,6
045 Margreid a.d. Weinstr.,67,,7,4,11
045 Margreid a.d. Weinstr.,68,,4,6,10
045 Margreid a.d. Weinstr.,69,,5,7,12
045 Margreid a.d. Weinstr.,70,,3,4,7
045 Margreid a.d. Weinstr.,71,,2,5,7
045 Margreid a.d. Weinstr.,72,,5,7,12
045 Margreid a.d. Weinstr.,73,,1,3,4
045 Margreid a.d. Weinstr.,74,,1,4,5
045 Margreid a.d. Weinstr.,75,,1,3,4
045 Margreid a.d. Weinstr.,76,,3,6,9
045 Margreid a.d. Weinstr.,77,,1,2,3
045 Margreid a.d. Weinstr.,78,,-,1,1
045 Margreid a.d. Weinstr.,79,,2,4,6
045 Margreid a.d. Weinstr.,80,,1,2,3
045 Margreid a.d. Weinstr.,81,,1,2,3
045 Margreid a.d. Weinstr.,82,,2,2,4
045 Margreid a.d. Weinstr.,83,,1,3,4
045 Margreid a.d. Weinstr.,84,,1,7,8
045 Margreid a.d. Weinstr.,85,,1,2,3
045 Margreid a.d. Weinstr.,86,,2,1,3
045 Margreid a.d. Weinstr.,87,,1,1,2
045 Margreid a.d. Weinstr.,88,,-,2,2
045 Margreid a.d. Weinstr.,89,,-,2,2
045 Margreid a.d. Weinstr.,90,,-,3,3
045 Margreid a.d. Weinstr.,94,,1,1,2
045 Margreid a.d. Weinstr.,99,,-,1,1
046 Mals,0,,36,38,74
046 Mals,1,,33,30,63
046 Mals,2,,30,31,61
046 Mals,3,,35,27,62
046 Mals,4,,33,33,66
046 Mals,5,,36,24,60
046 Mals,6,,38,34,72
046 Mals,7,,31,26,57
046 Mals,8,,30,27,57
046 Mals,9,,31,33,64
046 Mals,10,,39,35,74
046 Mals,11,,39,34,73
046 Mals,12,,31,32,63
046 Mals,13,,35,33,68
046 Mals,14,,35,38,73
046 Mals,15,,35,33,68
046 Mals,16,,30,31,61
046 Mals,17,,44,35,79
046 Mals,18,,32,23,55
046 Mals,19,,39,24,63
046 Mals,20,,39,36,75
046 Mals,21,,46,29,75
046 Mals,22,,30,39,69
046 Mals,23,,41,51,92
046 Mals,24,,42,49,91
046 Mals,25,,50,38,88
046 Mals,26,,50,42,92
046 Mals,27,,62,47,109
046 Mals,28,,50,29,79
046 Mals,29,,62,43,105
046 Mals,30,,49,36,85
046 Mals,31,,47,44,91
046 Mals,32,,49,53,102
046 Mals,33,,39,26,65
046 Mals,34,,53,38,91
046 Mals,35,,31,39,70
046 Mals,36,,30,35,65
046 Mals,37,,31,24,55
046 Mals,38,,42,35,77
046 Mals,39,,37,27,64
046 Mals,40,,30,26,56
046 Mals,41,,19,20,39
046 Mals,42,,30,32,62
046 Mals,43,,31,21,52
046 Mals,44,,33,22,55
046 Mals,45,,35,19,54
046 Mals,46,,18,27,45
046 Mals,47,,27,14,41
046 Mals,48,,23,19,42
046 Mals,49,,25,28,53
046 Mals,50,,14,18,32
046 Mals,51,,30,13,43
046 Mals,52,,27,19,46
046 Mals,53,,24,26,50
046 Mals,54,,21,18,39
046 Mals,55,,23,27,50
046 Mals,56,,28,25,53
046 Mals,57,,23,21,44
046 Mals,58,,17,32,49
046 Mals,59,,22,16,38
046 Mals,60,,16,21,37
046 Mals,61,,17,19,36
046 Mals,62,,18,25,43
046 Mals,63,,20,15,35
046 Mals,64,,17,18,35
046 Mals,65,,27,19,46
046 Mals,66,,25,19,44
046 Mals,67,,24,16,40
046 Mals,68,,23,17,40
046 Mals,69,,14,24,38
046 Mals,70,,15,21,36
046 Mals,71,,13,20,33
046 Mals,72,,10,17,27
046 Mals,73,,16,18,34
046 Mals,74,,16,15,31
046 Mals,75,,9,24,33
046 Mals,76,,7,23,30
046 Mals,77,,3,9,12
046 Mals,78,,6,6,12
046 Mals,79,,3,8,11
046 Mals,80,,9,13,22
046 Mals,81,,7,12,19
046 Mals,82,,15,26,41
046 Mals,83,,7,7,14
046 Mals,84,,3,11,14
046 Mals,85,,2,11,13
046 Mals,86,,2,4,6
046 Mals,87,,4,7,11
046 Mals,88,,2,5,7
046 Mals,89,,2,2,4
046 Mals,91,,-,3,3
046 Mals,92,,-,4,4
046 Mals,94,,1,2,3
046 Mals,95,,-,2,2
046 Mals,96,,-,2,2
046 Mals,97,,-,2,2
047 Enneberg,0,,20,8,28
047 Enneberg,1,,19,14,33
047 Enneberg,2,,19,19,38
047 Enneberg,3,,15,14,29
047 Enneberg,4,,17,23,40
047 Enneberg,5,,15,18,33
047 Enneberg,6,,20,15,35
047 Enneberg,7,,21,14,35
047 Enneberg,8,,16,13,29
047 Enneberg,9,,18,10,28
047 Enneberg,10,,23,16,39
047 Enneberg,11,,19,19,38
047 Enneberg,12,,12,16,28
047 Enneberg,13,,24,19,43
047 Enneberg,14,,22,20,42
047 Enneberg,15,,25,18,43
047 Enneberg,16,,11,21,32
047 Enneberg,17,,13,25,38
047 Enneberg,18,,19,21,40
047 Enneberg,19,,12,17,29
047 Enneberg,20,,12,26,38
047 Enneberg,21,,25,33,58
047 Enneberg,22,,21,23,44
047 Enneberg,23,,23,26,49
047 Enneberg,24,,33,31,64
047 Enneberg,25,,26,24,50
047 Enneberg,26,,28,20,48
047 Enneberg,27,,24,23,47
047 Enneberg,28,,24,26,50
047 Enneberg,29,,21,25,46
047 Enneberg,30,,29,24,53
047 Enneberg,31,,23,23,46
047 Enneberg,32,,25,20,45
047 Enneberg,33,,17,13,30
047 Enneberg,34,,18,17,35
047 Enneberg,35,,14,20,34
047 Enneberg,36,,23,14,37
047 Enneberg,37,,20,8,28
047 Enneberg,38,,16,15,31
047 Enneberg,39,,16,16,32
047 Enneberg,40,,12,13,25
047 Enneberg,41,,13,12,25
047 Enneberg,42,,18,20,38
047 Enneberg,43,,13,17,30
047 Enneberg,44,,15,11,26
047 Enneberg,45,,12,16,28
047 Enneberg,46,,18,8,26
047 Enneberg,47,,15,13,28
047 Enneberg,48,,9,11,20
047 Enneberg,49,,15,17,32
047 Enneberg,50,,10,13,23
047 Enneberg,51,,20,15,35
047 Enneberg,52,,19,12,31
047 Enneberg,53,,12,21,33
047 Enneberg,54,,14,11,25
047 Enneberg,55,,14,9,23
047 Enneberg,56,,18,11,29
047 Enneberg,57,,15,20,35
047 Enneberg,58,,18,13,31
047 Enneberg,59,,15,14,29
047 Enneberg,60,,16,16,32
047 Enneberg,61,,9,12,21
047 Enneberg,62,,12,9,21
047 Enneberg,63,,9,18,27
047 Enneberg,64,,14,12,26
047 Enneberg,65,,16,16,32
047 Enneberg,66,,10,7,17
047 Enneberg,67,,10,15,25
047 Enneberg,68,,14,9,23
047 Enneberg,69,,9,9,18
047 Enneberg,70,,12,7,19
047 Enneberg,71,,6,11,17
047 Enneberg,72,,8,13,21
047 Enneberg,73,,8,8,16
047 Enneberg,74,,5,13,18
047 Enneberg,75,,7,4,11
047 Enneberg,76,,4,8,12
047 Enneberg,77,,5,4,9
047 Enneberg,78,,1,9,10
047 Enneberg,79,,1,11,12
047 Enneberg,80,,4,8,12
047 Enneberg,81,,4,5,9
047 Enneberg,82,,4,6,10
047 Enneberg,83,,4,6,10
047 Enneberg,84,,4,7,11
047 Enneberg,85,,7,6,13
047 Enneberg,86,,4,2,6
047 Enneberg,87,,-,9,9
047 Enneberg,88,,2,2,4
047 Enneberg,89,,2,-,2
047 Enneberg,90,,1,2,3
047 Enneberg,91,,1,3,4
047 Enneberg,92,,-,1,1
047 Enneberg,97,,1,-,1
048 Marling,0,,19,12,31
048 Marling,1,,9,9,18
048 Marling,2,,14,7,21
048 Marling,3,,18,15,33
048 Marling,4,,12,10,22
048 Marling,5,,11,15,26
048 Marling,6,,11,16,27
048 Marling,7,,11,13,24
048 Marling,8,,6,9,15
048 Marling,9,,13,9,22
048 Marling,10,,11,15,26
048 Marling,11,,11,6,17
048 Marling,12,,10,10,20
048 Marling,13,,10,8,18
048 Marling,14,,14,11,25
048 Marling,15,,12,9,21
048 Marling,16,,16,16,32
048 Marling,17,,16,13,29
048 Marling,18,,11,16,27
048 Marling,19,,16,16,32
048 Marling,20,,14,13,27
048 Marling,21,,11,12,23
048 Marling,22,,15,16,31
048 Marling,23,,13,15,28
048 Marling,24,,24,16,40
048 Marling,25,,18,15,33
048 Marling,26,,25,21,46
048 Marling,27,,25,18,43
048 Marling,28,,19,24,43
048 Marling,29,,17,24,41
048 Marling,30,,22,21,43
048 Marling,31,,20,15,35
048 Marling,32,,32,31,63
048 Marling,33,,23,17,40
048 Marling,34,,23,12,35
048 Marling,35,,18,17,35
048 Marling,36,,17,15,32
048 Marling,37,,19,11,30
048 Marling,38,,9,11,20
048 Marling,39,,10,12,22
048 Marling,40,,9,7,16
048 Marling,41,,17,12,29
048 Marling,42,,11,16,27
048 Marling,43,,15,14,29
048 Marling,44,,6,13,19
048 Marling,45,,19,17,36
048 Marling,46,,19,18,37
048 Marling,47,,10,19,29
048 Marling,48,,18,13,31
048 Marling,49,,16,15,31
048 Marling,50,,18,10,28
048 Marling,51,,16,13,29
048 Marling,52,,11,17,28
048 Marling,53,,12,11,23
048 Marling,54,,24,18,42
048 Marling,55,,14,13,27
048 Marling,56,,15,19,34
048 Marling,57,,15,13,28
048 Marling,58,,12,19,31
048 Marling,59,,15,8,23
048 Marling,60,,7,15,22
048 Marling,61,,15,10,25
048 Marling,62,,9,11,20
048 Marling,63,,11,10,21
048 Marling,64,,13,10,23
048 Marling,65,,8,11,19
048 Marling,66,,9,10,19
048 Marling,67,,10,5,15
048 Marling,68,,12,10,22
048 Marling,69,,7,13,20
048 Marling,70,,6,18,24
048 Marling,71,,4,8,12
048 Marling,72,,7,8,15
048 Marling,73,,4,6,10
048 Marling,74,,5,10,15
048 Marling,75,,-,3,3
048 Marling,76,,5,7,12
048 Marling,77,,1,6,7
048 Marling,78,,5,2,7
048 Marling,79,,2,4,6
048 Marling,80,,3,4,7
048 Marling,81,,2,6,8
048 Marling,82,,3,7,10
048 Marling,83,,3,8,11
048 Marling,84,,-,2,2
048 Marling,85,,1,5,6
048 Marling,86,,4,3,7
048 Marling,87,,4,3,7
048 Marling,88,,-,5,5
048 Marling,89,,1,-,1
048 Marling,90,,-,5,5
048 Marling,91,,1,1,2
049 Martell,0,,6,7,13
049 Martell,1,,6,9,15
049 Martell,2,,7,8,15
049 Martell,3,,5,4,9
049 Martell,4,,8,6,14
049 Martell,5,,6,5,11
049 Martell,6,,10,3,13
049 Martell,7,,4,1,5
049 Martell,8,,8,4,12
049 Martell,9,,-,4,4
049 Martell,10,,5,7,12
049 Martell,11,,6,4,10
049 Martell,12,,9,4,13
049 Martell,13,,6,6,12
049 Martell,14,,8,5,13
049 Martell,15,,9,5,14
049 Martell,16,,9,7,16
049 Martell,17,,3,6,9
049 Martell,18,,7,4,11
049 Martell,19,,6,7,13
049 Martell,20,,2,6,8
049 Martell,21,,6,9,15
049 Martell,22,,10,7,17
049 Martell,23,,6,7,13
049 Martell,24,,12,6,18
049 Martell,25,,6,5,11
049 Martell,26,,7,15,22
049 Martell,27,,11,8,19
049 Martell,28,,7,8,15
049 Martell,29,,16,6,22
049 Martell,30,,18,8,26
049 Martell,31,,9,9,18
049 Martell,32,,16,2,18
049 Martell,33,,13,9,22
049 Martell,34,,7,5,12
049 Martell,35,,10,3,13
049 Martell,36,,8,7,15
049 Martell,37,,7,6,13
049 Martell,38,,8,3,11
049 Martell,39,,4,3,7
049 Martell,40,,7,2,9
049 Martell,41,,7,6,13
049 Martell,42,,5,4,9
049 Martell,43,,6,4,10
049 Martell,44,,6,8,14
049 Martell,45,,3,4,7
049 Martell,46,,4,2,6
049 Martell,47,,6,4,10
049 Martell,48,,5,3,8
049 Martell,49,,3,-,3
049 Martell,50,,6,1,7
049 Martell,51,,1,3,4
049 Martell,52,,2,3,5
049 Martell,53,,5,6,11
049 Martell,54,,4,4,8
049 Martell,55,,6,2,8
049 Martell,56,,2,5,7
049 Martell,57,,1,6,7
049 Martell,58,,3,5,8
049 Martell,59,,3,4,7
049 Martell,60,,4,9,13
049 Martell,61,,9,1,10
049 Martell,62,,5,5,10
049 Martell,63,,2,4,6
049 Martell,64,,6,1,7
049 Martell,65,,7,4,11
049 Martell,66,,5,4,9
049 Martell,67,,3,6,9
049 Martell,68,,3,3,6
049 Martell,69,,3,9,12
049 Martell,70,,3,3,6
049 Martell,71,,5,7,12
049 Martell,72,,1,7,8
049 Martell,73,,2,3,5
049 Martell,74,,1,2,3
049 Martell,75,,-,2,2
049 Martell,76,,1,1,2
049 Martell,77,,2,3,5
049 Martell,78,,1,-,1
049 Martell,79,,1,2,3
049 Martell,80,,4,4,8
049 Martell,81,,1,1,2
049 Martell,82,,1,-,1
049 Martell,83,,1,-,1
049 Martell,84,,3,3,6
049 Martell,85,,-,1,1
049 Martell,86,,1,1,2
049 Martell,87,,-,1,1
049 Martell,88,,-,1,1
049 Martell,89,,1,-,1
049 Martell,90,,1,-,1
049 Martell,92,,-,1,1
050 Mölten,0,,11,10,21
050 Mölten,1,,11,5,16
050 Mölten,2,,12,11,23
050 Mölten,3,,7,15,22
050 Mölten,4,,12,6,18
050 Mölten,5,,12,5,17
050 Mölten,6,,12,5,17
050 Mölten,7,,7,8,15
050 Mölten,8,,9,8,17
050 Mölten,9,,10,6,16
050 Mölten,10,,8,13,21
050 Mölten,11,,6,3,9
050 Mölten,12,,7,15,22
050 Mölten,13,,9,6,15
050 Mölten,14,,12,6,18
050 Mölten,15,,12,9,21
050 Mölten,16,,11,9,20
050 Mölten,17,,10,7,17
050 Mölten,18,,6,12,18
050 Mölten,19,,7,19,26
050 Mölten,20,,15,9,24
050 Mölten,21,,13,10,23
050 Mölten,22,,12,12,24
050 Mölten,23,,12,9,21
050 Mölten,24,,16,10,26
050 Mölten,25,,15,10,25
050 Mölten,26,,18,17,35
050 Mölten,27,,14,16,30
050 Mölten,28,,18,13,31
050 Mölten,29,,15,14,29
050 Mölten,30,,9,14,23
050 Mölten,31,,23,11,34
050 Mölten,32,,14,9,23
050 Mölten,33,,12,11,23
050 Mölten,34,,17,9,26
050 Mölten,35,,7,7,14
050 Mölten,36,,13,4,17
050 Mölten,37,,2,11,13
050 Mölten,38,,5,2,7
050 Mölten,39,,4,8,12
050 Mölten,40,,15,7,22
050 Mölten,41,,7,5,12
050 Mölten,42,,5,6,11
050 Mölten,43,,5,4,9
050 Mölten,44,,5,3,8
050 Mölten,45,,8,9,17
050 Mölten,46,,6,4,10
050 Mölten,47,,4,4,8
050 Mölten,48,,4,7,11
050 Mölten,49,,10,2,12
050 Mölten,50,,5,5,10
050 Mölten,51,,4,6,10
050 Mölten,52,,14,8,22
050 Mölten,53,,6,10,16
050 Mölten,54,,10,3,13
050 Mölten,55,,7,7,14
050 Mölten,56,,5,7,12
050 Mölten,57,,2,3,5
050 Mölten,58,,5,6,11
050 Mölten,59,,5,5,10
050 Mölten,60,,9,7,16
050 Mölten,61,,10,5,15
050 Mölten,62,,11,10,21
050 Mölten,63,,3,6,9
050 Mölten,64,,11,2,13
050 Mölten,65,,6,5,11
050 Mölten,66,,3,7,10
050 Mölten,67,,3,6,9
050 Mölten,68,,5,4,9
050 Mölten,69,,3,7,10
050 Mölten,70,,2,4,6
050 Mölten,71,,2,4,6
050 Mölten,72,,8,7,15
050 Mölten,73,,4,2,6
050 Mölten,74,,1,7,8
050 Mölten,75,,3,7,10
050 Mölten,76,,-,5,5
050 Mölten,77,,2,3,5
050 Mölten,78,,1,1,2
050 Mölten,79,,2,2,4
050 Mölten,80,,-,2,2
050 Mölten,81,,-,8,8
050 Mölten,82,,4,1,5
050 Mölten,83,,1,2,3
050 Mölten,84,,-,1,1
050 Mölten,85,,1,3,4
050 Mölten,86,,-,3,3
050 Mölten,87,,1,-,1
050 Mölten,88,,-,1,1
050 Mölten,89,,1,1,2
050 Mölten,91,,-,1,1
050 Mölten,92,,-,1,1
050 Mölten,93,,1,-,1
051 Meran,0,,158,133,291
051 Meran,1,,150,151,301
051 Meran,2,,126,130,256
051 Meran,3,,153,137,290
051 Meran,4,,136,149,285
051 Meran,5,,147,151,298
051 Meran,6,,156,139,295
051 Meran,7,,159,109,268
051 Meran,8,,152,140,292
051 Meran,9,,148,110,258
051 Meran,10,,123,168,291
051 Meran,11,,148,139,287
051 Meran,12,,141,149,290
051 Meran,13,,142,143,285
051 Meran,14,,158,147,305
051 Meran,15,,159,133,292
051 Meran,16,,137,151,288
051 Meran,17,,169,155,324
051 Meran,18,,159,181,340
051 Meran,19,,177,196,373
051 Meran,20,,190,193,383
051 Meran,21,,253,227,480
051 Meran,22,,215,218,433
051 Meran,23,,246,231,477
051 Meran,24,,252,249,501
051 Meran,25,,248,262,510
051 Meran,26,,283,276,559
051 Meran,27,,298,290,588
051 Meran,28,,296,281,577
051 Meran,29,,316,285,601
051 Meran,30,,342,307,649
051 Meran,31,,337,300,637
051 Meran,32,,331,273,604
051 Meran,33,,255,271,526
051 Meran,34,,304,282,586
051 Meran,35,,297,257,554
051 Meran,36,,266,242,508
051 Meran,37,,263,234,497
051 Meran,38,,239,237,476
051 Meran,39,,231,206,437
051 Meran,40,,201,217,418
051 Meran,41,,184,223,407
051 Meran,42,,198,225,423
051 Meran,43,,231,229,460
051 Meran,44,,223,212,435
051 Meran,45,,209,231,440
051 Meran,46,,225,252,477
051 Meran,47,,233,261,494
051 Meran,48,,236,285,521
051 Meran,49,,248,312,560
051 Meran,50,,227,229,456
051 Meran,51,,235,239,474
051 Meran,52,,282,257,539
051 Meran,53,,280,306,586
051 Meran,54,,247,287,534
051 Meran,55,,213,223,436
051 Meran,56,,227,261,488
051 Meran,57,,209,239,448
051 Meran,58,,210,245,455
051 Meran,59,,194,212,406
051 Meran,60,,199,219,418
051 Meran,61,,187,198,385
051 Meran,62,,177,190,367
051 Meran,63,,152,220,372
051 Meran,64,,153,201,354
051 Meran,65,,165,204,369
051 Meran,66,,152,158,310
051 Meran,67,,152,214,366
051 Meran,68,,139,177,316
051 Meran,69,,144,213,357
051 Meran,70,,115,191,306
051 Meran,71,,111,205,316
051 Meran,72,,113,211,324
051 Meran,73,,117,218,335
051 Meran,74,,89,218,307
051 Meran,75,,110,206,316
051 Meran,76,,78,156,234
051 Meran,77,,64,114,178
051 Meran,78,,56,103,159
051 Meran,79,,45,106,151
051 Meran,80,,74,134,208
051 Meran,81,,76,161,237
051 Meran,82,,66,139,205
051 Meran,83,,65,148,213
051 Meran,84,,48,128,176
051 Meran,85,,45,127,172
051 Meran,86,,49,100,149
051 Meran,87,,43,82,125
051 Meran,88,,26,65,91
051 Meran,89,,26,64,90
051 Meran,90,,10,36,46
051 Meran,91,,10,40,50
051 Meran,92,,7,31,38
051 Meran,93,,5,18,23
051 Meran,94,,5,14,19
051 Meran,95,,1,6,7
051 Meran,96,,4,6,10
051 Meran,97,,2,8,10
051 Meran,98,,-,2,2
051 Meran,99,,1,-,1
051 Meran,101,,1,3,4
051 Meran,102,,-,1,1
051 Meran,103,,-,1,1
051 Meran,106,,-,1,1
052 Welsberg-Taisten,0,,15,13,28
052 Welsberg-Taisten,1,,12,15,27
052 Welsberg-Taisten,2,,15,18,33
052 Welsberg-Taisten,3,,11,10,21
052 Welsberg-Taisten,4,,20,19,39
052 Welsberg-Taisten,5,,12,17,29
052 Welsberg-Taisten,6,,7,17,24
052 Welsberg-Taisten,7,,15,16,31
052 Welsberg-Taisten,8,,15,13,28
052 Welsberg-Taisten,9,,10,12,22
052 Welsberg-Taisten,10,,9,14,23
052 Welsberg-Taisten,11,,24,14,38
052 Welsberg-Taisten,12,,20,18,38
052 Welsberg-Taisten,13,,19,14,33
052 Welsberg-Taisten,14,,10,12,22
052 Welsberg-Taisten,15,,19,17,36
052 Welsberg-Taisten,16,,24,15,39
052 Welsberg-Taisten,17,,19,15,34
052 Welsberg-Taisten,18,,12,19,31
052 Welsberg-Taisten,19,,17,14,31
052 Welsberg-Taisten,20,,15,20,35
052 Welsberg-Taisten,21,,26,21,47
052 Welsberg-Taisten,22,,25,8,33
052 Welsberg-Taisten,23,,18,25,43
052 Welsberg-Taisten,24,,32,20,52
052 Welsberg-Taisten,25,,25,19,44
052 Welsberg-Taisten,26,,19,23,42
052 Welsberg-Taisten,27,,25,11,36
052 Welsberg-Taisten,28,,29,23,52
052 Welsberg-Taisten,29,,22,25,47
052 Welsberg-Taisten,30,,22,19,41
052 Welsberg-Taisten,31,,33,21,54
052 Welsberg-Taisten,32,,26,24,50
052 Welsberg-Taisten,33,,19,24,43
052 Welsberg-Taisten,34,,21,19,40
052 Welsberg-Taisten,35,,14,16,30
052 Welsberg-Taisten,36,,24,22,46
052 Welsberg-Taisten,37,,27,17,44
052 Welsberg-Taisten,38,,11,19,30
052 Welsberg-Taisten,39,,19,22,41
052 Welsberg-Taisten,40,,20,13,33
052 Welsberg-Taisten,41,,17,13,30
052 Welsberg-Taisten,42,,19,12,31
052 Welsberg-Taisten,43,,19,13,32
052 Welsberg-Taisten,44,,17,8,25
052 Welsberg-Taisten,45,,18,15,33
052 Welsberg-Taisten,46,,16,12,28
052 Welsberg-Taisten,47,,17,17,34
052 Welsberg-Taisten,48,,11,10,21
052 Welsberg-Taisten,49,,13,14,27
052 Welsberg-Taisten,50,,9,13,22
052 Welsberg-Taisten,51,,13,11,24
052 Welsberg-Taisten,52,,15,13,28
052 Welsberg-Taisten,53,,10,13,23
052 Welsberg-Taisten,54,,18,21,39
052 Welsberg-Taisten,55,,9,13,22
052 Welsberg-Taisten,56,,15,13,28
052 Welsberg-Taisten,57,,14,11,25
052 Welsberg-Taisten,58,,10,8,18
052 Welsberg-Taisten,59,,11,9,20
052 Welsberg-Taisten,60,,4,17,21
052 Welsberg-Taisten,61,,18,16,34
052 Welsberg-Taisten,62,,12,9,21
052 Welsberg-Taisten,63,,12,15,27
052 Welsberg-Taisten,64,,8,12,20
052 Welsberg-Taisten,65,,12,9,21
052 Welsberg-Taisten,66,,11,12,23
052 Welsberg-Taisten,67,,7,23,30
052 Welsberg-Taisten,68,,13,13,26
052 Welsberg-Taisten,69,,8,7,15
052 Welsberg-Taisten,70,,1,9,10
052 Welsberg-Taisten,71,,9,13,22
052 Welsberg-Taisten,72,,9,14,23
052 Welsberg-Taisten,73,,7,8,15
052 Welsberg-Taisten,74,,8,12,20
052 Welsberg-Taisten,75,,7,11,18
052 Welsberg-Taisten,76,,1,8,9
052 Welsberg-Taisten,77,,4,1,5
052 Welsberg-Taisten,78,,3,4,7
052 Welsberg-Taisten,79,,3,1,4
052 Welsberg-Taisten,80,,5,8,13
052 Welsberg-Taisten,81,,5,4,9
052 Welsberg-Taisten,82,,1,7,8
052 Welsberg-Taisten,83,,3,8,11
052 Welsberg-Taisten,84,,-,8,8
052 Welsberg-Taisten,85,,2,7,9
052 Welsberg-Taisten,86,,1,8,9
052 Welsberg-Taisten,87,,-,3,3
052 Welsberg-Taisten,88,,1,2,3
052 Welsberg-Taisten,89,,-,1,1
052 Welsberg-Taisten,90,,-,2,2
052 Welsberg-Taisten,91,,-,2,2
052 Welsberg-Taisten,93,,-,1,1
052 Welsberg-Taisten,94,,-,1,1
052 Welsberg-Taisten,95,,1,-,1
052 Welsberg-Taisten,97,,-,1,1
052 Welsberg-Taisten,98,,-,1,1
052 Welsberg-Taisten,107,,-,1,1
053 Montan,0,,13,16,29
053 Montan,1,,9,5,14
053 Montan,2,,8,9,17
053 Montan,3,,9,9,18
053 Montan,4,,14,9,23
053 Montan,5,,10,10,20
053 Montan,6,,9,11,20
053 Montan,7,,12,13,25
053 Montan,8,,9,15,24
053 Montan,9,,13,4,17
053 Montan,10,,9,9,18
053 Montan,11,,6,3,9
053 Montan,12,,11,5,16
053 Montan,13,,9,8,17
053 Montan,14,,9,7,16
053 Montan,15,,4,4,8
053 Montan,16,,10,9,19
053 Montan,17,,9,6,15
053 Montan,18,,7,4,11
053 Montan,19,,5,5,10
053 Montan,20,,10,9,19
053 Montan,21,,8,7,15
053 Montan,22,,11,4,15
053 Montan,23,,10,8,18
053 Montan,24,,15,6,21
053 Montan,25,,12,12,24
053 Montan,26,,10,13,23
053 Montan,27,,13,16,29
053 Montan,28,,14,12,26
053 Montan,29,,10,14,24
053 Montan,30,,23,12,35
053 Montan,31,,15,13,28
053 Montan,32,,11,16,27
053 Montan,33,,12,17,29
053 Montan,34,,18,12,30
053 Montan,35,,13,11,24
053 Montan,36,,11,10,21
053 Montan,37,,13,8,21
053 Montan,38,,15,11,26
053 Montan,39,,6,14,20
053 Montan,40,,8,13,21
053 Montan,41,,13,12,25
053 Montan,42,,12,8,20
053 Montan,43,,13,3,16
053 Montan,44,,7,6,13
053 Montan,45,,4,5,9
053 Montan,46,,8,3,11
053 Montan,47,,4,6,10
053 Montan,48,,7,10,17
053 Montan,49,,5,2,7
053 Montan,50,,3,4,7
053 Montan,51,,4,5,9
053 Montan,52,,6,7,13
053 Montan,53,,6,6,12
053 Montan,54,,8,4,12
053 Montan,55,,8,7,15
053 Montan,56,,8,9,17
053 Montan,57,,9,9,18
053 Montan,58,,3,7,10
053 Montan,59,,7,11,18
053 Montan,60,,1,9,10
053 Montan,61,,4,6,10
053 Montan,62,,17,5,22
053 Montan,63,,6,8,14
053 Montan,64,,8,11,19
053 Montan,65,,11,12,23
053 Montan,66,,8,10,18
053 Montan,67,,9,4,13
053 Montan,68,,9,7,16
053 Montan,69,,9,10,19
053 Montan,70,,6,8,14
053 Montan,71,,4,7,11
053 Montan,72,,6,11,17
053 Montan,73,,6,10,16
053 Montan,74,,9,4,13
053 Montan,75,,2,7,9
053 Montan,76,,2,5,7
053 Montan,77,,2,3,5
053 Montan,78,,2,6,8
053 Montan,79,,-,3,3
053 Montan,80,,1,9,10
053 Montan,81,,3,5,8
053 Montan,82,,1,6,7
053 Montan,83,,3,5,8
053 Montan,84,,2,2,4
053 Montan,85,,3,-,3
053 Montan,86,,-,3,3
053 Montan,87,,1,4,5
053 Montan,88,,1,1,2
053 Montan,89,,1,-,1
053 Montan,90,,1,1,2
053 Montan,91,,-,1,1
053 Montan,92,,-,1,1
053 Montan,94,,-,1,1
054 Moos in Passeier,0,,10,12,22
054 Moos in Passeier,1,,15,19,34
054 Moos in Passeier,2,,21,15,36
054 Moos in Passeier,3,,19,17,36
054 Moos in Passeier,4,,17,20,37
054 Moos in Passeier,5,,16,12,28
054 Moos in Passeier,6,,18,19,37
054 Moos in Passeier,7,,15,20,35
054 Moos in Passeier,8,,16,15,31
054 Moos in Passeier,9,,17,15,32
054 Moos in Passeier,10,,19,13,32
054 Moos in Passeier,11,,23,21,44
054 Moos in Passeier,12,,15,14,29
054 Moos in Passeier,13,,17,22,39
054 Moos in Passeier,14,,20,19,39
054 Moos in Passeier,15,,21,23,44
054 Moos in Passeier,16,,21,16,37
054 Moos in Passeier,17,,26,19,45
054 Moos in Passeier,18,,21,22,43
054 Moos in Passeier,19,,15,17,32
054 Moos in Passeier,20,,28,19,47
054 Moos in Passeier,21,,26,17,43
054 Moos in Passeier,22,,16,27,43
054 Moos in Passeier,23,,22,16,38
054 Moos in Passeier,24,,25,19,44
054 Moos in Passeier,25,,27,17,44
054 Moos in Passeier,26,,23,19,42
054 Moos in Passeier,27,,22,27,49
054 Moos in Passeier,28,,25,21,46
054 Moos in Passeier,29,,26,21,47
054 Moos in Passeier,30,,24,13,37
054 Moos in Passeier,31,,27,11,38
054 Moos in Passeier,32,,17,17,34
054 Moos in Passeier,33,,11,21,32
054 Moos in Passeier,34,,11,9,20
054 Moos in Passeier,35,,17,19,36
054 Moos in Passeier,36,,19,17,36
054 Moos in Passeier,37,,16,15,31
054 Moos in Passeier,38,,22,8,30
054 Moos in Passeier,39,,10,8,18
054 Moos in Passeier,40,,10,9,19
054 Moos in Passeier,41,,17,9,26
054 Moos in Passeier,42,,8,9,17
054 Moos in Passeier,43,,10,6,16
054 Moos in Passeier,44,,12,9,21
054 Moos in Passeier,45,,10,9,19
054 Moos in Passeier,46,,18,9,27
054 Moos in Passeier,47,,6,7,13
054 Moos in Passeier,48,,22,11,33
054 Moos in Passeier,49,,9,8,17
054 Moos in Passeier,50,,8,6,14
054 Moos in Passeier,51,,9,9,18
054 Moos in Passeier,52,,15,12,27
054 Moos in Passeier,53,,6,12,18
054 Moos in Passeier,54,,11,16,27
054 Moos in Passeier,55,,8,10,18
054 Moos in Passeier,56,,6,7,13
054 Moos in Passeier,57,,12,10,22
054 Moos in Passeier,58,,5,7,12
054 Moos in Passeier,59,,8,8,16
054 Moos in Passeier,60,,9,8,17
054 Moos in Passeier,61,,10,14,24
054 Moos in Passeier,62,,10,11,21
054 Moos in Passeier,63,,9,4,13
054 Moos in Passeier,64,,11,8,19
054 Moos in Passeier,65,,11,8,19
054 Moos in Passeier,66,,9,13,22
054 Moos in Passeier,67,,4,10,14
054 Moos in Passeier,68,,8,7,15
054 Moos in Passeier,69,,12,4,16
054 Moos in Passeier,70,,9,8,17
054 Moos in Passeier,71,,5,8,13
054 Moos in Passeier,72,,4,3,7
054 Moos in Passeier,73,,3,6,9
054 Moos in Passeier,74,,2,4,6
054 Moos in Passeier,75,,2,5,7
054 Moos in Passeier,76,,1,4,5
054 Moos in Passeier,77,,3,3,6
054 Moos in Passeier,78,,3,2,5
054 Moos in Passeier,79,,1,4,5
054 Moos in Passeier,80,,3,2,5
054 Moos in Passeier,81,,1,8,9
054 Moos in Passeier,82,,1,3,4
054 Moos in Passeier,83,,-,4,4
054 Moos in Passeier,84,,1,3,4
054 Moos in Passeier,85,,1,2,3
054 Moos in Passeier,86,,-,2,2
054 Moos in Passeier,87,,1,1,2
054 Moos in Passeier,89,,1,1,2
054 Moos in Passeier,94,,-,1,1
055 Nals,0,,6,5,11
055 Nals,1,,12,9,21
055 Nals,2,,10,12,22
055 Nals,3,,14,10,24
055 Nals,4,,8,14,22
055 Nals,5,,10,8,18
055 Nals,6,,10,9,19
055 Nals,7,,8,13,21
055 Nals,8,,10,10,20
055 Nals,9,,5,2,7
055 Nals,10,,12,5,17
055 Nals,11,,8,9,17
055 Nals,12,,6,8,14
055 Nals,13,,7,13,20
055 Nals,14,,10,9,19
055 Nals,15,,14,8,22
055 Nals,16,,9,6,15
055 Nals,17,,10,7,17
055 Nals,18,,6,3,9
055 Nals,19,,10,13,23
055 Nals,20,,3,7,10
055 Nals,21,,17,13,30
055 Nals,22,,7,6,13
055 Nals,23,,9,17,26
055 Nals,24,,13,12,25
055 Nals,25,,14,14,28
055 Nals,26,,10,12,22
055 Nals,27,,14,21,35
055 Nals,28,,15,10,25
055 Nals,29,,18,9,27
055 Nals,30,,17,16,33
055 Nals,31,,20,17,37
055 Nals,32,,10,21,31
055 Nals,33,,20,11,31
055 Nals,34,,16,16,32
055 Nals,35,,12,9,21
055 Nals,36,,17,13,30
055 Nals,37,,17,15,32
055 Nals,38,,10,10,20
055 Nals,39,,7,9,16
055 Nals,40,,18,15,33
055 Nals,41,,7,7,14
055 Nals,42,,8,6,14
055 Nals,43,,8,8,16
055 Nals,44,,4,13,17
055 Nals,45,,9,9,18
055 Nals,46,,9,9,18
055 Nals,47,,10,11,21
055 Nals,48,,12,5,17
055 Nals,49,,6,13,19
055 Nals,50,,7,11,18
055 Nals,51,,6,11,17
055 Nals,52,,13,7,20
055 Nals,53,,5,8,13
055 Nals,54,,14,5,19
055 Nals,55,,7,11,18
055 Nals,56,,10,11,21
055 Nals,57,,7,9,16
055 Nals,58,,3,13,16
055 Nals,59,,5,4,9
055 Nals,60,,7,6,13
055 Nals,61,,6,6,12
055 Nals,62,,10,11,21
055 Nals,63,,6,5,11
055 Nals,64,,3,7,10
055 Nals,65,,5,6,11
055 Nals,66,,10,8,18
055 Nals,67,,7,10,17
055 Nals,68,,6,7,13
055 Nals,69,,8,7,15
055 Nals,70,,7,5,12
055 Nals,71,,4,3,7
055 Nals,72,,1,6,7
055 Nals,73,,3,7,10
055 Nals,74,,2,10,12
055 Nals,75,,1,2,3
055 Nals,76,,1,5,6
055 Nals,77,,2,-,2
055 Nals,78,,3,-,3
055 Nals,79,,-,3,3
055 Nals,80,,5,3,8
055 Nals,81,,-,5,5
055 Nals,82,,1,1,2
055 Nals,83,,2,3,5
055 Nals,84,,1,3,4
055 Nals,85,,1,2,3
055 Nals,86,,-,2,2
055 Nals,87,,1,4,5
055 Nals,89,,2,2,4
055 Nals,90,,-,1,1
055 Nals,92,,1,-,1
055 Nals,93,,-,1,1
056 Naturns,0,,48,31,79
056 Naturns,1,,33,35,68
056 Naturns,2,,34,40,74
056 Naturns,3,,32,36,68
056 Naturns,4,,43,39,82
056 Naturns,5,,36,31,67
056 Naturns,6,,39,28,67
056 Naturns,7,,43,34,77
056 Naturns,8,,32,19,51
056 Naturns,9,,29,27,56
056 Naturns,10,,40,23,63
056 Naturns,11,,37,20,57
056 Naturns,12,,30,35,65
056 Naturns,13,,36,30,66
056 Naturns,14,,36,48,84
056 Naturns,15,,33,28,61
056 Naturns,16,,41,36,77
056 Naturns,17,,38,40,78
056 Naturns,18,,30,32,62
056 Naturns,19,,34,38,72
056 Naturns,20,,29,36,65
056 Naturns,21,,39,36,75
056 Naturns,22,,41,34,75
056 Naturns,23,,42,42,84
056 Naturns,24,,35,44,79
056 Naturns,25,,43,39,82
056 Naturns,26,,40,47,87
056 Naturns,27,,49,43,92
056 Naturns,28,,46,50,96
056 Naturns,29,,54,43,97
056 Naturns,30,,42,54,96
056 Naturns,31,,49,39,88
056 Naturns,32,,43,48,91
056 Naturns,33,,43,46,89
056 Naturns,34,,39,41,80
056 Naturns,35,,58,40,98
056 Naturns,36,,40,39,79
056 Naturns,37,,30,34,64
056 Naturns,38,,33,33,66
056 Naturns,39,,41,35,76
056 Naturns,40,,33,34,67
056 Naturns,41,,44,32,76
056 Naturns,42,,32,28,60
056 Naturns,43,,35,34,69
056 Naturns,44,,37,36,73
056 Naturns,45,,27,35,62
056 Naturns,46,,28,19,47
056 Naturns,47,,30,26,56
056 Naturns,48,,18,20,38
056 Naturns,49,,26,28,54
056 Naturns,50,,26,18,44
056 Naturns,51,,19,22,41
056 Naturns,52,,29,34,63
056 Naturns,53,,35,34,69
056 Naturns,54,,41,34,75
056 Naturns,55,,22,18,40
056 Naturns,56,,22,20,42
056 Naturns,57,,28,16,44
056 Naturns,58,,22,23,45
056 Naturns,59,,22,19,41
056 Naturns,60,,24,12,36
056 Naturns,61,,21,20,41
056 Naturns,62,,17,15,32
056 Naturns,63,,17,20,37
056 Naturns,64,,12,26,38
056 Naturns,65,,21,24,45
056 Naturns,66,,19,20,39
056 Naturns,67,,19,17,36
056 Naturns,68,,14,20,34
056 Naturns,69,,14,20,34
056 Naturns,70,,18,19,37
056 Naturns,71,,18,17,35
056 Naturns,72,,20,14,34
056 Naturns,73,,7,17,24
056 Naturns,74,,14,20,34
056 Naturns,75,,4,11,15
056 Naturns,76,,4,15,19
056 Naturns,77,,4,7,11
056 Naturns,78,,4,3,7
056 Naturns,79,,4,5,9
056 Naturns,80,,3,11,14
056 Naturns,81,,6,15,21
056 Naturns,82,,6,19,25
056 Naturns,83,,4,8,12
056 Naturns,84,,7,10,17
056 Naturns,85,,10,6,16
056 Naturns,86,,4,10,14
056 Naturns,87,,-,5,5
056 Naturns,88,,2,9,11
056 Naturns,89,,3,3,6
056 Naturns,90,,2,2,4
056 Naturns,91,,2,7,9
056 Naturns,92,,1,2,3
056 Naturns,94,,-,1,1
056 Naturns,95,,1,1,2
056 Naturns,97,,1,-,1
056 Naturns,98,,1,-,1
057 Natz-Schabs,0,,15,13,28
057 Natz-Schabs,1,,18,16,34
057 Natz-Schabs,2,,15,16,31
057 Natz-Schabs,3,,19,14,33
057 Natz-Schabs,4,,22,21,43
057 Natz-Schabs,5,,14,25,39
057 Natz-Schabs,6,,14,24,38
057 Natz-Schabs,7,,22,17,39
057 Natz-Schabs,8,,20,20,40
057 Natz-Schabs,9,,17,21,38
057 Natz-Schabs,10,,20,21,41
057 Natz-Schabs,11,,18,18,36
057 Natz-Schabs,12,,21,19,40
057 Natz-Schabs,13,,10,19,29
057 Natz-Schabs,14,,19,22,41
057 Natz-Schabs,15,,22,12,34
057 Natz-Schabs,16,,12,14,26
057 Natz-Schabs,17,,12,11,23
057 Natz-Schabs,18,,11,9,20
057 Natz-Schabs,19,,10,11,21
057 Natz-Schabs,20,,13,17,30
057 Natz-Schabs,21,,14,20,34
057 Natz-Schabs,22,,12,20,32
057 Natz-Schabs,23,,16,15,31
057 Natz-Schabs,24,,17,16,33
057 Natz-Schabs,25,,22,21,43
057 Natz-Schabs,26,,24,21,45
057 Natz-Schabs,27,,22,11,33
057 Natz-Schabs,28,,27,24,51
057 Natz-Schabs,29,,28,16,44
057 Natz-Schabs,30,,32,26,58
057 Natz-Schabs,31,,25,23,48
057 Natz-Schabs,32,,22,20,42
057 Natz-Schabs,33,,17,22,39
057 Natz-Schabs,34,,17,17,34
057 Natz-Schabs,35,,24,24,48
057 Natz-Schabs,36,,22,19,41
057 Natz-Schabs,37,,21,16,37
057 Natz-Schabs,38,,17,20,37
057 Natz-Schabs,39,,19,23,42
057 Natz-Schabs,40,,20,17,37
057 Natz-Schabs,41,,13,12,25
057 Natz-Schabs,42,,17,13,30
057 Natz-Schabs,43,,16,9,25
057 Natz-Schabs,44,,13,8,21
057 Natz-Schabs,45,,20,15,35
057 Natz-Schabs,46,,21,14,35
057 Natz-Schabs,47,,11,14,25
057 Natz-Schabs,48,,11,13,24
057 Natz-Schabs,49,,15,11,26
057 Natz-Schabs,50,,10,10,20
057 Natz-Schabs,51,,14,12,26
057 Natz-Schabs,52,,8,9,17
057 Natz-Schabs,53,,13,7,20
057 Natz-Schabs,54,,14,10,24
057 Natz-Schabs,55,,4,8,12
057 Natz-Schabs,56,,4,5,9
057 Natz-Schabs,57,,4,6,10
057 Natz-Schabs,58,,12,9,21
057 Natz-Schabs,59,,9,5,14
057 Natz-Schabs,60,,7,7,14
057 Natz-Schabs,61,,7,3,10
057 Natz-Schabs,62,,9,12,21
057 Natz-Schabs,63,,7,8,15
057 Natz-Schabs,64,,8,6,14
057 Natz-Schabs,65,,6,7,13
057 Natz-Schabs,66,,11,3,14
057 Natz-Schabs,67,,5,11,16
057 Natz-Schabs,68,,2,5,7
057 Natz-Schabs,69,,4,8,12
057 Natz-Schabs,70,,4,6,10
057 Natz-Schabs,71,,2,7,9
057 Natz-Schabs,72,,2,10,12
057 Natz-Schabs,73,,7,4,11
057 Natz-Schabs,74,,5,6,11
057 Natz-Schabs,75,,3,10,13
057 Natz-Schabs,76,,-,2,2
057 Natz-Schabs,77,,1,5,6
057 Natz-Schabs,78,,2,2,4
057 Natz-Schabs,79,,3,-,3
057 Natz-Schabs,80,,3,3,6
057 Natz-Schabs,81,,1,1,2
057 Natz-Schabs,82,,2,-,2
057 Natz-Schabs,83,,1,3,4
057 Natz-Schabs,84,,2,2,4
057 Natz-Schabs,85,,-,2,2
057 Natz-Schabs,86,,2,1,3
057 Natz-Schabs,87,,2,1,3
057 Natz-Schabs,88,,-,1,1
057 Natz-Schabs,89,,2,1,3
058 Welschnofen,0,,13,11,24
058 Welschnofen,1,,12,12,24
058 Welschnofen,2,,10,7,17
058 Welschnofen,3,,13,13,26
058 Welschnofen,4,,13,11,24
058 Welschnofen,5,,11,13,24
058 Welschnofen,6,,14,8,22
058 Welschnofen,7,,13,16,29
058 Welschnofen,8,,9,8,17
058 Welschnofen,9,,7,12,19
058 Welschnofen,10,,12,7,19
058 Welschnofen,11,,7,8,15
058 Welschnofen,12,,9,12,21
058 Welschnofen,13,,10,17,27
058 Welschnofen,14,,12,10,22
058 Welschnofen,15,,12,6,18
058 Welschnofen,16,,11,3,14
058 Welschnofen,17,,13,10,23
058 Welschnofen,18,,10,16,26
058 Welschnofen,19,,16,9,25
058 Welschnofen,20,,15,13,28
058 Welschnofen,21,,14,17,31
058 Welschnofen,22,,14,13,27
058 Welschnofen,23,,10,12,22
058 Welschnofen,24,,10,13,23
058 Welschnofen,25,,12,14,26
058 Welschnofen,26,,16,14,30
058 Welschnofen,27,,18,18,36
058 Welschnofen,28,,14,14,28
058 Welschnofen,29,,23,14,37
058 Welschnofen,30,,21,15,36
058 Welschnofen,31,,15,10,25
058 Welschnofen,32,,19,17,36
058 Welschnofen,33,,11,15,26
058 Welschnofen,34,,15,17,32
058 Welschnofen,35,,22,8,30
058 Welschnofen,36,,12,12,24
058 Welschnofen,37,,18,9,27
058 Welschnofen,38,,10,13,23
058 Welschnofen,39,,10,12,22
058 Welschnofen,40,,16,13,29
058 Welschnofen,41,,15,12,27
058 Welschnofen,42,,10,13,23
058 Welschnofen,43,,12,9,21
058 Welschnofen,44,,18,6,24
058 Welschnofen,45,,7,7,14
058 Welschnofen,46,,12,12,24
058 Welschnofen,47,,9,11,20
058 Welschnofen,48,,9,7,16
058 Welschnofen,49,,10,11,21
058 Welschnofen,50,,8,6,14
058 Welschnofen,51,,7,12,19
058 Welschnofen,52,,13,12,25
058 Welschnofen,53,,14,13,27
058 Welschnofen,54,,12,7,19
058 Welschnofen,55,,9,7,16
058 Welschnofen,56,,11,7,18
058 Welschnofen,57,,7,6,13
058 Welschnofen,58,,9,4,13
058 Welschnofen,59,,5,12,17
058 Welschnofen,60,,7,6,13
058 Welschnofen,61,,12,11,23
058 Welschnofen,62,,10,14,24
058 Welschnofen,63,,8,7,15
058 Welschnofen,64,,7,8,15
058 Welschnofen,65,,8,10,18
058 Welschnofen,66,,11,12,23
058 Welschnofen,67,,7,6,13
058 Welschnofen,68,,4,4,8
058 Welschnofen,69,,7,8,15
058 Welschnofen,70,,9,7,16
058 Welschnofen,71,,6,15,21
058 Welschnofen,72,,7,10,17
058 Welschnofen,73,,6,6,12
058 Welschnofen,74,,5,11,16
058 Welschnofen,75,,3,9,12
058 Welschnofen,76,,2,6,8
058 Welschnofen,77,,3,2,5
058 Welschnofen,78,,1,2,3
058 Welschnofen,79,,2,5,7
058 Welschnofen,80,,1,4,5
058 Welschnofen,81,,3,6,9
058 Welschnofen,82,,1,10,11
058 Welschnofen,83,,5,7,12
058 Welschnofen,84,,2,3,5
058 Welschnofen,85,,3,6,9
058 Welschnofen,86,,3,3,6
058 Welschnofen,87,,2,1,3
058 Welschnofen,88,,1,2,3
058 Welschnofen,89,,-,2,2
058 Welschnofen,90,,1,1,2
058 Welschnofen,91,,1,1,2
058 Welschnofen,93,,1,2,3
058 Welschnofen,94,,-,1,1
058 Welschnofen,95,,-,1,1
058 Welschnofen,96,,-,1,1
059 Deutschnofen,0,,24,27,51
059 Deutschnofen,1,,27,16,43
059 Deutschnofen,2,,23,28,51
059 Deutschnofen,3,,31,28,59
059 Deutschnofen,4,,20,20,40
059 Deutschnofen,5,,33,30,63
059 Deutschnofen,6,,21,22,43
059 Deutschnofen,7,,20,33,53
059 Deutschnofen,8,,20,25,45
059 Deutschnofen,9,,27,17,44
059 Deutschnofen,10,,26,19,45
059 Deutschnofen,11,,35,27,62
059 Deutschnofen,12,,22,22,44
059 Deutschnofen,13,,20,32,52
059 Deutschnofen,14,,20,17,37
059 Deutschnofen,15,,28,18,46
059 Deutschnofen,16,,22,26,48
059 Deutschnofen,17,,23,19,42
059 Deutschnofen,18,,32,23,55
059 Deutschnofen,19,,10,21,31
059 Deutschnofen,20,,20,25,45
059 Deutschnofen,21,,28,30,58
059 Deutschnofen,22,,16,29,45
059 Deutschnofen,23,,19,31,50
059 Deutschnofen,24,,26,21,47
059 Deutschnofen,25,,29,24,53
059 Deutschnofen,26,,37,31,68
059 Deutschnofen,27,,23,28,51
059 Deutschnofen,28,,31,30,61
059 Deutschnofen,29,,29,33,62
059 Deutschnofen,30,,38,22,60
059 Deutschnofen,31,,35,29,64
059 Deutschnofen,32,,30,23,53
059 Deutschnofen,33,,24,30,54
059 Deutschnofen,34,,36,23,59
059 Deutschnofen,35,,42,21,63
059 Deutschnofen,36,,24,22,46
059 Deutschnofen,37,,24,31,55
059 Deutschnofen,38,,22,26,48
059 Deutschnofen,39,,32,26,58
059 Deutschnofen,40,,27,24,51
059 Deutschnofen,41,,24,19,43
059 Deutschnofen,42,,23,17,40
059 Deutschnofen,43,,24,23,47
059 Deutschnofen,44,,22,14,36
059 Deutschnofen,45,,17,20,37
059 Deutschnofen,46,,24,14,38
059 Deutschnofen,47,,27,16,43
059 Deutschnofen,48,,13,13,26
059 Deutschnofen,49,,16,22,38
059 Deutschnofen,50,,19,14,33
059 Deutschnofen,51,,16,18,34
059 Deutschnofen,52,,24,20,44
059 Deutschnofen,53,,18,15,33
059 Deutschnofen,54,,13,25,38
059 Deutschnofen,55,,14,18,32
059 Deutschnofen,56,,24,14,38
059 Deutschnofen,57,,16,23,39
059 Deutschnofen,58,,11,8,19
059 Deutschnofen,59,,15,10,25
059 Deutschnofen,60,,12,13,25
059 Deutschnofen,61,,15,13,28
059 Deutschnofen,62,,9,15,24
059 Deutschnofen,63,,18,14,32
059 Deutschnofen,64,,16,9,25
059 Deutschnofen,65,,14,12,26
059 Deutschnofen,66,,11,11,22
059 Deutschnofen,67,,12,24,36
059 Deutschnofen,68,,10,15,25
059 Deutschnofen,69,,18,11,29
059 Deutschnofen,70,,11,23,34
059 Deutschnofen,71,,9,13,22
059 Deutschnofen,72,,10,12,22
059 Deutschnofen,73,,11,21,32
059 Deutschnofen,74,,7,18,25
059 Deutschnofen,75,,5,13,18
059 Deutschnofen,76,,3,6,9
059 Deutschnofen,77,,4,7,11
059 Deutschnofen,78,,1,5,6
059 Deutschnofen,79,,4,4,8
059 Deutschnofen,80,,6,10,16
059 Deutschnofen,81,,4,12,16
059 Deutschnofen,82,,8,12,20
059 Deutschnofen,83,,4,8,12
059 Deutschnofen,84,,2,8,10
059 Deutschnofen,85,,4,8,12
059 Deutschnofen,86,,3,5,8
059 Deutschnofen,87,,5,3,8
059 Deutschnofen,88,,2,-,2
059 Deutschnofen,89,,2,3,5
059 Deutschnofen,90,,-,3,3
059 Deutschnofen,91,,1,3,4
059 Deutschnofen,92,,1,-,1
059 Deutschnofen,93,,-,1,1
059 Deutschnofen,94,,1,2,3
060 Auer,0,,21,17,38
060 Auer,1,,20,15,35
060 Auer,2,,12,21,33
060 Auer,3,,15,21,36
060 Auer,4,,23,11,34
060 Auer,5,,18,15,33
060 Auer,6,,18,18,36
060 Auer,7,,17,25,42
060 Auer,8,,21,15,36
060 Auer,9,,15,15,30
060 Auer,10,,23,17,40
060 Auer,11,,14,8,22
060 Auer,12,,18,15,33
060 Auer,13,,18,23,41
060 Auer,14,,12,15,27
060 Auer,15,,15,10,25
060 Auer,16,,18,20,38
060 Auer,17,,11,8,19
060 Auer,18,,13,18,31
060 Auer,19,,17,24,41
060 Auer,20,,13,16,29
060 Auer,21,,22,23,45
060 Auer,22,,24,11,35
060 Auer,23,,14,25,39
060 Auer,24,,26,18,44
060 Auer,25,,25,19,44
060 Auer,26,,16,22,38
060 Auer,27,,25,33,58
060 Auer,28,,24,20,44
060 Auer,29,,25,33,58
060 Auer,30,,30,27,57
060 Auer,31,,31,22,53
060 Auer,32,,29,33,62
060 Auer,33,,24,22,46
060 Auer,34,,35,29,64
060 Auer,35,,20,31,51
060 Auer,36,,31,26,57
060 Auer,37,,32,18,50
060 Auer,38,,25,26,51
060 Auer,39,,29,26,55
060 Auer,40,,16,21,37
060 Auer,41,,17,13,30
060 Auer,42,,15,22,37
060 Auer,43,,20,20,40
060 Auer,44,,16,21,37
060 Auer,45,,14,24,38
060 Auer,46,,12,14,26
060 Auer,47,,25,15,40
060 Auer,48,,16,21,37
060 Auer,49,,17,23,40
060 Auer,50,,16,12,28
060 Auer,51,,23,17,40
060 Auer,52,,16,20,36
060 Auer,53,,17,18,35
060 Auer,54,,23,17,40
060 Auer,55,,15,9,24
060 Auer,56,,14,18,32
060 Auer,57,,18,18,36
060 Auer,58,,11,13,24
060 Auer,59,,9,12,21
060 Auer,60,,10,15,25
060 Auer,61,,20,18,38
060 Auer,62,,4,10,14
060 Auer,63,,4,19,23
060 Auer,64,,13,11,24
060 Auer,65,,13,10,23
060 Auer,66,,14,15,29
060 Auer,67,,12,13,25
060 Auer,68,,10,14,24
060 Auer,69,,8,17,25
060 Auer,70,,17,12,29
060 Auer,71,,14,10,24
060 Auer,72,,10,14,24
060 Auer,73,,7,18,25
060 Auer,74,,5,13,18
060 Auer,75,,6,14,20
060 Auer,76,,6,3,9
060 Auer,77,,3,9,12
060 Auer,78,,4,8,12
060 Auer,79,,2,3,5
060 Auer,80,,2,5,7
060 Auer,81,,1,4,5
060 Auer,82,,5,9,14
060 Auer,83,,2,8,10
060 Auer,84,,1,6,7
060 Auer,85,,2,1,3
060 Auer,86,,2,3,5
060 Auer,87,,3,2,5
060 Auer,88,,2,3,5
060 Auer,89,,-,4,4
060 Auer,91,,-,2,2
060 Auer,92,,-,4,4
060 Auer,93,,-,1,1
060 Auer,100,,-,1,1
061 St.Ulrich,0,,36,31,67
061 St.Ulrich,1,,27,31,58
061 St.Ulrich,2,,22,30,52
061 St.Ulrich,3,,35,33,68
061 St.Ulrich,4,,31,33,64
061 St.Ulrich,5,,29,22,51
061 St.Ulrich,6,,17,25,42
061 St.Ulrich,7,,20,23,43
061 St.Ulrich,8,,28,18,46
061 St.Ulrich,9,,18,18,36
061 St.Ulrich,10,,24,21,45
061 St.Ulrich,11,,23,19,42
061 St.Ulrich,12,,20,20,40
061 St.Ulrich,13,,24,26,50
061 St.Ulrich,14,,21,24,45
061 St.Ulrich,15,,24,29,53
061 St.Ulrich,16,,30,22,52
061 St.Ulrich,17,,22,25,47
061 St.Ulrich,18,,25,23,48
061 St.Ulrich,19,,33,34,67
061 St.Ulrich,20,,36,29,65
061 St.Ulrich,21,,37,29,66
061 St.Ulrich,22,,41,26,67
061 St.Ulrich,23,,46,42,88
061 St.Ulrich,24,,38,39,77
061 St.Ulrich,25,,39,35,74
061 St.Ulrich,26,,50,43,93
061 St.Ulrich,27,,44,42,86
061 St.Ulrich,28,,36,38,74
061 St.Ulrich,29,,43,32,75
061 St.Ulrich,30,,34,36,70
061 St.Ulrich,31,,43,46,89
061 St.Ulrich,32,,40,34,74
061 St.Ulrich,33,,32,37,69
061 St.Ulrich,34,,33,25,58
061 St.Ulrich,35,,36,28,64
061 St.Ulrich,36,,40,25,65
061 St.Ulrich,37,,24,18,42
061 St.Ulrich,38,,26,36,62
061 St.Ulrich,39,,19,29,48
061 St.Ulrich,40,,28,38,66
061 St.Ulrich,41,,26,34,60
061 St.Ulrich,42,,30,17,47
061 St.Ulrich,43,,16,27,43
061 St.Ulrich,44,,27,24,51
061 St.Ulrich,45,,24,23,47
061 St.Ulrich,46,,22,28,50
061 St.Ulrich,47,,32,31,63
061 St.Ulrich,48,,24,23,47
061 St.Ulrich,49,,39,26,65
061 St.Ulrich,50,,20,19,39
061 St.Ulrich,51,,31,32,63
061 St.Ulrich,52,,42,38,80
061 St.Ulrich,53,,34,37,71
061 St.Ulrich,54,,43,45,88
061 St.Ulrich,55,,34,29,63
061 St.Ulrich,56,,20,20,40
061 St.Ulrich,57,,27,28,55
061 St.Ulrich,58,,24,27,51
061 St.Ulrich,59,,28,16,44
061 St.Ulrich,60,,16,23,39
061 St.Ulrich,61,,21,13,34
061 St.Ulrich,62,,21,14,35
061 St.Ulrich,63,,16,23,39
061 St.Ulrich,64,,24,18,42
061 St.Ulrich,65,,21,11,32
061 St.Ulrich,66,,20,7,27
061 St.Ulrich,67,,18,13,31
061 St.Ulrich,68,,18,21,39
061 St.Ulrich,69,,11,16,27
061 St.Ulrich,70,,15,12,27
061 St.Ulrich,71,,11,23,34
061 St.Ulrich,72,,12,26,38
061 St.Ulrich,73,,6,22,28
061 St.Ulrich,74,,10,19,29
061 St.Ulrich,75,,14,20,34
061 St.Ulrich,76,,8,13,21
061 St.Ulrich,77,,8,11,19
061 St.Ulrich,78,,2,8,10
061 St.Ulrich,79,,6,7,13
061 St.Ulrich,80,,4,11,15
061 St.Ulrich,81,,13,14,27
061 St.Ulrich,82,,11,23,34
061 St.Ulrich,83,,10,18,28
061 St.Ulrich,84,,1,12,13
061 St.Ulrich,85,,8,8,16
061 St.Ulrich,86,,9,3,12
061 St.Ulrich,87,,3,1,4
061 St.Ulrich,88,,1,9,10
061 St.Ulrich,89,,1,7,8
061 St.Ulrich,90,,3,3,6
061 St.Ulrich,91,,2,6,8
061 St.Ulrich,92,,3,-,3
061 St.Ulrich,93,,-,1,1
061 St.Ulrich,94,,-,1,1
061 St.Ulrich,95,,-,1,1
061 St.Ulrich,96,,-,1,1
062 Partschins,0,,23,14,37
062 Partschins,1,,23,20,43
062 Partschins,2,,24,18,42
062 Partschins,3,,21,17,38
062 Partschins,4,,21,26,47
062 Partschins,5,,23,21,44
062 Partschins,6,,12,23,35
062 Partschins,7,,19,26,45
062 Partschins,8,,18,13,31
062 Partschins,9,,24,20,44
062 Partschins,10,,12,14,26
062 Partschins,11,,20,21,41
062 Partschins,12,,16,22,38
062 Partschins,13,,19,21,40
062 Partschins,14,,20,28,48
062 Partschins,15,,25,17,42
062 Partschins,16,,14,14,28
062 Partschins,17,,17,22,39
062 Partschins,18,,28,17,45
062 Partschins,19,,17,15,32
062 Partschins,20,,28,22,50
062 Partschins,21,,21,13,34
062 Partschins,22,,28,18,46
062 Partschins,23,,21,24,45
062 Partschins,24,,23,22,45
062 Partschins,25,,24,25,49
062 Partschins,26,,30,30,60
062 Partschins,27,,22,31,53
062 Partschins,28,,34,20,54
062 Partschins,29,,35,31,66
062 Partschins,30,,31,34,65
062 Partschins,31,,28,41,69
062 Partschins,32,,36,24,60
062 Partschins,33,,35,24,59
062 Partschins,34,,20,26,46
062 Partschins,35,,23,39,62
062 Partschins,36,,27,18,45
062 Partschins,37,,21,17,38
062 Partschins,38,,24,26,50
062 Partschins,39,,26,18,44
062 Partschins,40,,24,26,50
062 Partschins,41,,9,27,36
062 Partschins,42,,24,14,38
062 Partschins,43,,16,13,29
062 Partschins,44,,19,14,33
062 Partschins,45,,14,21,35
062 Partschins,46,,10,11,21
062 Partschins,47,,16,17,33
062 Partschins,48,,20,17,37
062 Partschins,49,,32,28,60
062 Partschins,50,,13,15,28
062 Partschins,51,,15,19,34
062 Partschins,52,,24,26,50
062 Partschins,53,,14,18,32
062 Partschins,54,,23,30,53
062 Partschins,55,,14,14,28
062 Partschins,56,,12,16,28
062 Partschins,57,,21,15,36
062 Partschins,58,,13,16,29
062 Partschins,59,,14,19,33
062 Partschins,60,,11,9,20
062 Partschins,61,,12,17,29
062 Partschins,62,,15,17,32
062 Partschins,63,,16,11,27
062 Partschins,64,,16,22,38
062 Partschins,65,,15,12,27
062 Partschins,66,,14,11,25
062 Partschins,67,,15,15,30
062 Partschins,68,,12,13,25
062 Partschins,69,,11,10,21
062 Partschins,70,,10,12,22
062 Partschins,71,,5,15,20
062 Partschins,72,,10,12,22
062 Partschins,73,,8,9,17
062 Partschins,74,,17,11,28
062 Partschins,75,,7,9,16
062 Partschins,76,,6,10,16
062 Partschins,77,,3,3,6
062 Partschins,78,,2,6,8
062 Partschins,79,,2,4,6
062 Partschins,80,,4,1,5
062 Partschins,81,,6,8,14
062 Partschins,82,,2,13,15
062 Partschins,83,,1,9,10
062 Partschins,84,,8,3,11
062 Partschins,85,,3,10,13
062 Partschins,86,,-,3,3
062 Partschins,87,,3,3,6
062 Partschins,88,,-,1,1
062 Partschins,89,,5,4,9
062 Partschins,90,,1,3,4
062 Partschins,91,,1,1,2
062 Partschins,92,,1,1,2
062 Partschins,93,,-,2,2
062 Partschins,94,,-,1,1
062 Partschins,95,,-,1,1
063 Percha,0,,6,7,13
063 Percha,1,,10,9,19
063 Percha,2,,8,10,18
063 Percha,3,,14,5,19
063 Percha,4,,9,9,18
063 Percha,5,,9,5,14
063 Percha,6,,7,8,15
063 Percha,7,,6,5,11
063 Percha,8,,9,16,25
063 Percha,9,,5,7,12
063 Percha,10,,8,13,21
063 Percha,11,,17,9,26
063 Percha,12,,14,9,23
063 Percha,13,,6,11,17
063 Percha,14,,9,6,15
063 Percha,15,,11,5,16
063 Percha,16,,5,12,17
063 Percha,17,,8,10,18
063 Percha,18,,8,10,18
063 Percha,19,,15,11,26
063 Percha,20,,10,6,16
063 Percha,21,,5,11,16
063 Percha,22,,11,6,17
063 Percha,23,,11,19,30
063 Percha,24,,16,9,25
063 Percha,25,,7,13,20
063 Percha,26,,18,14,32
063 Percha,27,,14,13,27
063 Percha,28,,12,14,26
063 Percha,29,,22,7,29
063 Percha,30,,12,16,28
063 Percha,31,,17,12,29
063 Percha,32,,10,15,25
063 Percha,33,,14,10,24
063 Percha,34,,13,10,23
063 Percha,35,,10,7,17
063 Percha,36,,6,9,15
063 Percha,37,,10,7,17
063 Percha,38,,8,5,13
063 Percha,39,,6,11,17
063 Percha,40,,13,11,24
063 Percha,41,,5,4,9
063 Percha,42,,7,7,14
063 Percha,43,,5,8,13
063 Percha,44,,6,7,13
063 Percha,45,,6,8,14
063 Percha,46,,10,5,15
063 Percha,47,,6,4,10
063 Percha,48,,5,7,12
063 Percha,49,,8,9,17
063 Percha,50,,8,5,13
063 Percha,51,,12,4,16
063 Percha,52,,8,7,15
063 Percha,53,,10,7,17
063 Percha,54,,9,6,15
063 Percha,55,,5,5,10
063 Percha,56,,7,6,13
063 Percha,57,,5,10,15
063 Percha,58,,1,5,6
063 Percha,59,,4,5,9
063 Percha,60,,4,5,9
063 Percha,61,,4,6,10
063 Percha,62,,5,5,10
063 Percha,63,,6,3,9
063 Percha,64,,7,3,10
063 Percha,65,,11,4,15
063 Percha,66,,5,5,10
063 Percha,67,,4,4,8
063 Percha,68,,6,4,10
063 Percha,69,,3,7,10
063 Percha,70,,4,6,10
063 Percha,71,,2,3,5
063 Percha,72,,3,5,8
063 Percha,73,,4,2,6
063 Percha,74,,1,2,3
063 Percha,75,,1,4,5
063 Percha,76,,1,1,2
063 Percha,77,,2,1,3
063 Percha,79,,1,1,2
063 Percha,80,,1,1,2
063 Percha,81,,-,5,5
063 Percha,83,,-,5,5
063 Percha,85,,1,-,1
063 Percha,86,,1,-,1
063 Percha,88,,-,1,1
063 Percha,100,,-,1,1
064 Plaus,0,,2,3,5
064 Plaus,1,,3,4,7
064 Plaus,2,,6,4,10
064 Plaus,3,,5,5,10
064 Plaus,4,,3,9,12
064 Plaus,5,,4,2,6
064 Plaus,6,,2,5,7
064 Plaus,7,,4,2,6
064 Plaus,8,,4,2,6
064 Plaus,9,,-,4,4
064 Plaus,10,,2,4,6
064 Plaus,11,,4,1,5
064 Plaus,12,,2,1,3
064 Plaus,13,,-,4,4
064 Plaus,14,,2,2,4
064 Plaus,15,,-,5,5
064 Plaus,16,,1,3,4
064 Plaus,17,,3,5,8
064 Plaus,18,,1,3,4
064 Plaus,19,,3,1,4
064 Plaus,20,,6,-,6
064 Plaus,21,,4,1,5
064 Plaus,22,,4,1,5
064 Plaus,23,,4,6,10
064 Plaus,24,,4,4,8
064 Plaus,25,,5,5,10
064 Plaus,26,,6,6,12
064 Plaus,27,,2,5,7
064 Plaus,28,,9,4,13
064 Plaus,29,,2,6,8
064 Plaus,30,,8,4,12
064 Plaus,31,,7,7,14
064 Plaus,32,,2,8,10
064 Plaus,33,,7,4,11
064 Plaus,34,,4,2,6
064 Plaus,35,,1,6,7
064 Plaus,36,,8,1,9
064 Plaus,37,,3,3,6
064 Plaus,38,,2,2,4
064 Plaus,39,,5,1,6
064 Plaus,40,,3,3,6
064 Plaus,41,,1,1,2
064 Plaus,42,,3,4,7
064 Plaus,43,,6,2,8
064 Plaus,44,,4,3,7
064 Plaus,45,,1,2,3
064 Plaus,46,,2,2,4
064 Plaus,47,,1,3,4
064 Plaus,48,,2,4,6
064 Plaus,49,,4,3,7
064 Plaus,50,,2,1,3
064 Plaus,51,,2,3,5
064 Plaus,52,,4,1,5
064 Plaus,53,,-,5,5
064 Plaus,54,,3,3,6
064 Plaus,55,,3,3,6
064 Plaus,56,,3,2,5
064 Plaus,57,,1,1,2
064 Plaus,58,,4,4,8
064 Plaus,60,,2,2,4
064 Plaus,61,,4,3,7
064 Plaus,62,,-,3,3
064 Plaus,63,,1,3,4
064 Plaus,64,,2,1,3
064 Plaus,65,,-,1,1
064 Plaus,66,,1,1,2
064 Plaus,67,,1,-,1
064 Plaus,68,,1,1,2
064 Plaus,69,,1,2,3
064 Plaus,70,,1,-,1
064 Plaus,71,,-,4,4
064 Plaus,72,,-,5,5
064 Plaus,73,,1,2,3
064 Plaus,74,,1,1,2
064 Plaus,75,,2,1,3
064 Plaus,76,,-,2,2
064 Plaus,77,,-,2,2
064 Plaus,79,,-,1,1
064 Plaus,81,,-,1,1
064 Plaus,82,,1,1,2
064 Plaus,83,,1,1,2
064 Plaus,84,,-,1,1
064 Plaus,87,,3,-,3
064 Plaus,93,,1,-,1
065 Waidbruck,0,,2,2,4
065 Waidbruck,1,,3,3,6
065 Waidbruck,2,,1,1,2
065 Waidbruck,3,,-,1,1
065 Waidbruck,4,,2,1,3
065 Waidbruck,5,,2,1,3
065 Waidbruck,6,,-,1,1
065 Waidbruck,7,,-,3,3
065 Waidbruck,8,,-,1,1
065 Waidbruck,9,,1,2,3
065 Waidbruck,11,,2,1,3
065 Waidbruck,12,,2,-,2
065 Waidbruck,14,,-,3,3
065 Waidbruck,15,,3,-,3
065 Waidbruck,16,,1,-,1
065 Waidbruck,17,,2,-,2
065 Waidbruck,18,,-,1,1
065 Waidbruck,19,,1,1,2
065 Waidbruck,21,,3,-,3
065 Waidbruck,22,,2,1,3
065 Waidbruck,23,,-,1,1
065 Waidbruck,24,,2,1,3
065 Waidbruck,25,,3,3,6
065 Waidbruck,26,,1,5,6
065 Waidbruck,27,,2,-,2
065 Waidbruck,28,,2,4,6
065 Waidbruck,29,,1,5,6
065 Waidbruck,30,,4,-,4
065 Waidbruck,31,,6,1,7
065 Waidbruck,32,,-,1,1
065 Waidbruck,33,,3,1,4
065 Waidbruck,34,,-,1,1
065 Waidbruck,35,,2,1,3
065 Waidbruck,36,,2,4,6
065 Waidbruck,37,,-,1,1
065 Waidbruck,38,,1,1,2
065 Waidbruck,39,,1,-,1
065 Waidbruck,40,,2,1,3
065 Waidbruck,41,,-,1,1
065 Waidbruck,42,,1,1,2
065 Waidbruck,43,,1,1,2
065 Waidbruck,44,,-,1,1
065 Waidbruck,49,,-,3,3
065 Waidbruck,50,,1,1,2
065 Waidbruck,51,,1,3,4
065 Waidbruck,52,,1,-,1
065 Waidbruck,53,,1,-,1
065 Waidbruck,54,,1,3,4
065 Waidbruck,55,,-,2,2
065 Waidbruck,56,,1,-,1
065 Waidbruck,57,,-,3,3
065 Waidbruck,58,,3,1,4
065 Waidbruck,59,,2,1,3
065 Waidbruck,60,,-,4,4
065 Waidbruck,61,,3,1,4
065 Waidbruck,62,,3,1,4
065 Waidbruck,63,,1,4,5
065 Waidbruck,64,,3,-,3
065 Waidbruck,65,,2,-,2
065 Waidbruck,66,,1,1,2
065 Waidbruck,67,,1,-,1
065 Waidbruck,68,,3,1,4
065 Waidbruck,69,,-,1,1
065 Waidbruck,70,,1,1,2
065 Waidbruck,72,,-,2,2
065 Waidbruck,73,,1,1,2
065 Waidbruck,75,,1,3,4
065 Waidbruck,76,,-,2,2
065 Waidbruck,77,,-,1,1
065 Waidbruck,80,,2,-,2
065 Waidbruck,81,,-,1,1
065 Waidbruck,83,,1,-,1
065 Waidbruck,84,,1,-,1
065 Waidbruck,87,,-,1,1
065 Waidbruck,90,,-,1,1
066 Burgstall,0,,9,5,14
066 Burgstall,1,,5,7,12
066 Burgstall,2,,3,11,14
066 Burgstall,3,,8,4,12
066 Burgstall,4,,4,12,16
066 Burgstall,5,,11,8,19
066 Burgstall,6,,8,4,12
066 Burgstall,7,,5,5,10
066 Burgstall,8,,8,9,17
066 Burgstall,9,,10,4,14
066 Burgstall,10,,6,10,16
066 Burgstall,11,,8,12,20
066 Burgstall,12,,7,6,13
066 Burgstall,13,,12,7,19
066 Burgstall,14,,6,7,13
066 Burgstall,15,,11,5,16
066 Burgstall,16,,5,7,12
066 Burgstall,17,,7,5,12
066 Burgstall,18,,2,11,13
066 Burgstall,19,,9,6,15
066 Burgstall,20,,14,5,19
066 Burgstall,21,,6,10,16
066 Burgstall,22,,10,9,19
066 Burgstall,23,,10,14,24
066 Burgstall,24,,15,5,20
066 Burgstall,25,,11,10,21
066 Burgstall,26,,10,10,20
066 Burgstall,27,,13,12,25
066 Burgstall,28,,11,17,28
066 Burgstall,29,,20,11,31
066 Burgstall,30,,17,12,29
066 Burgstall,31,,13,10,23
066 Burgstall,32,,16,10,26
066 Burgstall,33,,16,9,25
066 Burgstall,34,,10,14,24
066 Burgstall,35,,9,9,18
066 Burgstall,36,,5,9,14
066 Burgstall,37,,11,9,20
066 Burgstall,38,,9,8,17
066 Burgstall,39,,14,9,23
066 Burgstall,40,,7,7,14
066 Burgstall,41,,10,12,22
066 Burgstall,42,,8,10,18
066 Burgstall,43,,8,13,21
066 Burgstall,44,,11,7,18
066 Burgstall,45,,10,11,21
066 Burgstall,46,,8,7,15
066 Burgstall,47,,6,12,18
066 Burgstall,48,,7,9,16
066 Burgstall,49,,9,8,17
066 Burgstall,50,,6,11,17
066 Burgstall,51,,12,8,20
066 Burgstall,52,,9,7,16
066 Burgstall,53,,6,7,13
066 Burgstall,54,,8,4,12
066 Burgstall,55,,5,13,18
066 Burgstall,56,,5,11,16
066 Burgstall,57,,11,13,24
066 Burgstall,58,,5,9,14
066 Burgstall,59,,5,6,11
066 Burgstall,60,,7,4,11
066 Burgstall,61,,11,7,18
066 Burgstall,62,,9,4,13
066 Burgstall,63,,5,10,15
066 Burgstall,64,,6,3,9
066 Burgstall,65,,6,7,13
066 Burgstall,66,,4,4,8
066 Burgstall,67,,4,10,14
066 Burgstall,68,,3,12,15
066 Burgstall,69,,5,9,14
066 Burgstall,70,,7,5,12
066 Burgstall,71,,1,9,10
066 Burgstall,72,,6,3,9
066 Burgstall,73,,8,5,13
066 Burgstall,74,,3,3,6
066 Burgstall,75,,4,4,8
066 Burgstall,76,,1,5,6
066 Burgstall,77,,-,1,1
066 Burgstall,78,,3,1,4
066 Burgstall,79,,3,3,6
066 Burgstall,80,,4,4,8
066 Burgstall,81,,3,5,8
066 Burgstall,82,,2,5,7
066 Burgstall,83,,-,5,5
066 Burgstall,84,,2,5,7
066 Burgstall,85,,1,2,3
066 Burgstall,86,,-,3,3
066 Burgstall,87,,1,-,1
066 Burgstall,88,,1,-,1
066 Burgstall,89,,1,-,1
066 Burgstall,92,,-,1,1
066 Burgstall,93,,-,1,1
066 Burgstall,94,,1,-,1
067 Prad am Stilfser Joch,0,,19,12,31
067 Prad am Stilfser Joch,1,,20,25,45
067 Prad am Stilfser Joch,2,,25,27,52
067 Prad am Stilfser Joch,3,,16,18,34
067 Prad am Stilfser Joch,4,,17,11,28
067 Prad am Stilfser Joch,5,,19,19,38
067 Prad am Stilfser Joch,6,,20,22,42
067 Prad am Stilfser Joch,7,,29,16,45
067 Prad am Stilfser Joch,8,,11,19,30
067 Prad am Stilfser Joch,9,,27,26,53
067 Prad am Stilfser Joch,10,,29,22,51
067 Prad am Stilfser Joch,11,,31,29,60
067 Prad am Stilfser Joch,12,,28,26,54
067 Prad am Stilfser Joch,13,,29,22,51
067 Prad am Stilfser Joch,14,,24,23,47
067 Prad am Stilfser Joch,15,,26,23,49
067 Prad am Stilfser Joch,16,,19,9,28
067 Prad am Stilfser Joch,17,,21,19,40
067 Prad am Stilfser Joch,18,,19,36,55
067 Prad am Stilfser Joch,19,,21,22,43
067 Prad am Stilfser Joch,20,,23,17,40
067 Prad am Stilfser Joch,21,,28,25,53
067 Prad am Stilfser Joch,22,,22,30,52
067 Prad am Stilfser Joch,23,,34,19,53
067 Prad am Stilfser Joch,24,,34,20,54
067 Prad am Stilfser Joch,25,,32,24,56
067 Prad am Stilfser Joch,26,,27,28,55
067 Prad am Stilfser Joch,27,,31,33,64
067 Prad am Stilfser Joch,28,,25,23,48
067 Prad am Stilfser Joch,29,,34,31,65
067 Prad am Stilfser Joch,30,,32,25,57
067 Prad am Stilfser Joch,31,,27,29,56
067 Prad am Stilfser Joch,32,,28,11,39
067 Prad am Stilfser Joch,33,,28,30,58
067 Prad am Stilfser Joch,34,,20,27,47
067 Prad am Stilfser Joch,35,,20,28,48
067 Prad am Stilfser Joch,36,,32,13,45
067 Prad am Stilfser Joch,37,,22,30,52
067 Prad am Stilfser Joch,38,,24,25,49
067 Prad am Stilfser Joch,39,,23,23,46
067 Prad am Stilfser Joch,40,,29,16,45
067 Prad am Stilfser Joch,41,,30,18,48
067 Prad am Stilfser Joch,42,,28,17,45
067 Prad am Stilfser Joch,43,,14,22,36
067 Prad am Stilfser Joch,44,,20,21,41
067 Prad am Stilfser Joch,45,,23,18,41
067 Prad am Stilfser Joch,46,,25,21,46
067 Prad am Stilfser Joch,47,,19,12,31
067 Prad am Stilfser Joch,48,,16,13,29
067 Prad am Stilfser Joch,49,,18,16,34
067 Prad am Stilfser Joch,50,,19,12,31
067 Prad am Stilfser Joch,51,,13,15,28
067 Prad am Stilfser Joch,52,,25,18,43
067 Prad am Stilfser Joch,53,,19,17,36
067 Prad am Stilfser Joch,54,,24,12,36
067 Prad am Stilfser Joch,55,,10,16,26
067 Prad am Stilfser Joch,56,,14,13,27
067 Prad am Stilfser Joch,57,,19,14,33
067 Prad am Stilfser Joch,58,,14,12,26
067 Prad am Stilfser Joch,59,,12,11,23
067 Prad am Stilfser Joch,60,,16,15,31
067 Prad am Stilfser Joch,61,,9,25,34
067 Prad am Stilfser Joch,62,,12,9,21
067 Prad am Stilfser Joch,63,,15,19,34
067 Prad am Stilfser Joch,64,,8,16,24
067 Prad am Stilfser Joch,65,,12,13,25
067 Prad am Stilfser Joch,66,,10,11,21
067 Prad am Stilfser Joch,67,,8,9,17
067 Prad am Stilfser Joch,68,,11,10,21
067 Prad am Stilfser Joch,69,,12,14,26
067 Prad am Stilfser Joch,70,,12,10,22
067 Prad am Stilfser Joch,71,,9,13,22
067 Prad am Stilfser Joch,72,,4,14,18
067 Prad am Stilfser Joch,73,,5,13,18
067 Prad am Stilfser Joch,74,,8,8,16
067 Prad am Stilfser Joch,75,,8,7,15
067 Prad am Stilfser Joch,76,,8,4,12
067 Prad am Stilfser Joch,77,,2,6,8
067 Prad am Stilfser Joch,78,,-,7,7
067 Prad am Stilfser Joch,79,,3,5,8
067 Prad am Stilfser Joch,80,,6,4,10
067 Prad am Stilfser Joch,81,,4,11,15
067 Prad am Stilfser Joch,82,,1,5,6
067 Prad am Stilfser Joch,83,,5,10,15
067 Prad am Stilfser Joch,84,,3,4,7
067 Prad am Stilfser Joch,85,,2,9,11
067 Prad am Stilfser Joch,86,,3,5,8
067 Prad am Stilfser Joch,87,,2,5,7
067 Prad am Stilfser Joch,88,,4,5,9
067 Prad am Stilfser Joch,89,,1,2,3
067 Prad am Stilfser Joch,90,,1,3,4
067 Prad am Stilfser Joch,91,,-,2,2
067 Prad am Stilfser Joch,92,,1,2,3
067 Prad am Stilfser Joch,94,,1,2,3
067 Prad am Stilfser Joch,95,,-,1,1
068 Prettau,0,,6,6,12
068 Prettau,1,,5,8,13
068 Prettau,2,,4,8,12
068 Prettau,3,,3,3,6
068 Prettau,4,,1,5,6
068 Prettau,5,,1,7,8
068 Prettau,6,,-,4,4
068 Prettau,7,,5,3,8
068 Prettau,8,,5,1,6
068 Prettau,9,,2,2,4
068 Prettau,10,,2,2,4
068 Prettau,11,,3,6,9
068 Prettau,12,,4,2,6
068 Prettau,13,,2,2,4
068 Prettau,14,,2,1,3
068 Prettau,15,,4,2,6
068 Prettau,16,,5,2,7
068 Prettau,17,,1,-,1
068 Prettau,18,,5,4,9
068 Prettau,19,,1,1,2
068 Prettau,20,,6,4,10
068 Prettau,21,,6,1,7
068 Prettau,22,,8,8,16
068 Prettau,23,,10,6,16
068 Prettau,24,,5,4,9
068 Prettau,25,,5,8,13
068 Prettau,26,,9,8,17
068 Prettau,27,,6,6,12
068 Prettau,28,,8,9,17
068 Prettau,29,,5,3,8
068 Prettau,30,,5,12,17
068 Prettau,31,,10,6,16
068 Prettau,32,,6,8,14
068 Prettau,33,,3,6,9
068 Prettau,34,,6,5,11
068 Prettau,35,,9,4,13
068 Prettau,36,,5,2,7
068 Prettau,37,,7,-,7
068 Prettau,38,,2,1,3
068 Prettau,39,,6,5,11
068 Prettau,40,,6,5,11
068 Prettau,41,,6,2,8
068 Prettau,42,,4,3,7
068 Prettau,43,,4,3,7
068 Prettau,44,,2,2,4
068 Prettau,45,,2,2,4
068 Prettau,46,,2,3,5
068 Prettau,47,,3,1,4
068 Prettau,48,,4,5,9
068 Prettau,49,,9,4,13
068 Prettau,50,,2,3,5
068 Prettau,51,,7,6,13
068 Prettau,52,,4,2,6
068 Prettau,53,,2,2,4
068 Prettau,54,,3,3,6
068 Prettau,55,,4,5,9
068 Prettau,56,,4,4,8
068 Prettau,57,,5,7,12
068 Prettau,58,,3,6,9
068 Prettau,59,,4,3,7
068 Prettau,60,,6,3,9
068 Prettau,61,,1,3,4
068 Prettau,62,,4,3,7
068 Prettau,63,,4,-,4
068 Prettau,64,,2,1,3
068 Prettau,65,,5,4,9
068 Prettau,66,,4,6,10
068 Prettau,67,,-,3,3
068 Prettau,68,,4,1,5
068 Prettau,69,,1,8,9
068 Prettau,70,,1,3,4
068 Prettau,71,,4,1,5
068 Prettau,72,,1,5,6
068 Prettau,73,,2,1,3
068 Prettau,74,,1,2,3
068 Prettau,75,,4,4,8
068 Prettau,76,,3,2,5
068 Prettau,77,,1,3,4
068 Prettau,78,,1,1,2
068 Prettau,79,,2,3,5
068 Prettau,80,,-,2,2
068 Prettau,81,,-,5,5
068 Prettau,82,,1,6,7
068 Prettau,83,,-,2,2
068 Prettau,84,,-,6,6
068 Prettau,86,,-,1,1
068 Prettau,87,,1,1,2
068 Prettau,89,,-,2,2
068 Prettau,90,,-,2,2
068 Prettau,95,,-,1,1
069 Proveis,0,,-,4,4
069 Proveis,1,,3,-,3
069 Proveis,2,,2,1,3
069 Proveis,3,,3,1,4
069 Proveis,4,,3,2,5
069 Proveis,6,,1,1,2
069 Proveis,7,,2,3,5
069 Proveis,8,,2,2,4
069 Proveis,9,,3,1,4
069 Proveis,10,,5,-,5
069 Proveis,11,,3,3,6
069 Proveis,12,,3,3,6
069 Proveis,13,,1,-,1
069 Proveis,14,,2,3,5
069 Proveis,16,,3,1,4
069 Proveis,17,,3,2,5
069 Proveis,18,,2,2,4
069 Proveis,19,,1,3,4
069 Proveis,20,,2,3,5
069 Proveis,21,,6,2,8
069 Proveis,22,,2,-,2
069 Proveis,23,,-,4,4
069 Proveis,24,,1,1,2
069 Proveis,25,,4,3,7
069 Proveis,26,,5,3,8
069 Proveis,27,,5,2,7
069 Proveis,28,,2,1,3
069 Proveis,29,,2,1,3
069 Proveis,30,,1,1,2
069 Proveis,31,,3,-,3
069 Proveis,32,,4,2,6
069 Proveis,33,,4,3,7
069 Proveis,34,,4,1,5
069 Proveis,35,,1,4,5
069 Proveis,36,,4,-,4
069 Proveis,37,,1,3,4
069 Proveis,38,,2,3,5
069 Proveis,39,,4,1,5
069 Proveis,40,,3,4,7
069 Proveis,41,,3,2,5
069 Proveis,42,,2,1,3
069 Proveis,43,,2,3,5
069 Proveis,44,,2,-,2
069 Proveis,45,,-,2,2
069 Proveis,46,,1,-,1
069 Proveis,47,,2,1,3
069 Proveis,48,,1,2,3
069 Proveis,49,,3,-,3
069 Proveis,50,,1,1,2
069 Proveis,51,,2,-,2
069 Proveis,52,,2,1,3
069 Proveis,53,,2,1,3
069 Proveis,54,,1,1,2
069 Proveis,55,,3,-,3
069 Proveis,56,,1,3,4
069 Proveis,57,,-,2,2
069 Proveis,58,,2,1,3
069 Proveis,59,,2,1,3
069 Proveis,60,,1,1,2
069 Proveis,61,,-,1,1
069 Proveis,62,,-,2,2
069 Proveis,63,,1,1,2
069 Proveis,64,,3,1,4
069 Proveis,65,,-,1,1
069 Proveis,66,,3,4,7
069 Proveis,67,,4,1,5
069 Proveis,68,,2,2,4
069 Proveis,69,,1,1,2
069 Proveis,70,,-,3,3
069 Proveis,71,,3,-,3
069 Proveis,72,,2,-,2
069 Proveis,73,,2,2,4
069 Proveis,74,,-,6,6
069 Proveis,75,,1,1,2
069 Proveis,78,,-,1,1
069 Proveis,80,,-,1,1
069 Proveis,81,,-,2,2
069 Proveis,82,,-,1,1
069 Proveis,83,,-,1,1
069 Proveis,86,,1,1,2
069 Proveis,88,,1,-,1
070 Ratschings,0,,26,27,53
070 Ratschings,1,,21,30,51
070 Ratschings,2,,30,20,50
070 Ratschings,3,,37,32,69
070 Ratschings,4,,25,18,43
070 Ratschings,5,,32,29,61
070 Ratschings,6,,24,19,43
070 Ratschings,7,,36,26,62
070 Ratschings,8,,28,33,61
070 Ratschings,9,,30,26,56
070 Ratschings,10,,29,32,61
070 Ratschings,11,,29,19,48
070 Ratschings,12,,31,21,52
070 Ratschings,13,,34,24,58
070 Ratschings,14,,28,33,61
070 Ratschings,15,,22,23,45
070 Ratschings,16,,33,22,55
070 Ratschings,17,,31,22,53
070 Ratschings,18,,34,22,56
070 Ratschings,19,,25,29,54
070 Ratschings,20,,32,29,61
070 Ratschings,21,,35,24,59
070 Ratschings,22,,27,34,61
070 Ratschings,23,,31,35,66
070 Ratschings,24,,36,41,77
070 Ratschings,25,,31,30,61
070 Ratschings,26,,34,43,77
070 Ratschings,27,,46,36,82
070 Ratschings,28,,34,38,72
070 Ratschings,29,,40,36,76
070 Ratschings,30,,31,50,81
070 Ratschings,31,,48,40,88
070 Ratschings,32,,46,23,69
070 Ratschings,33,,35,37,72
070 Ratschings,34,,32,27,59
070 Ratschings,35,,39,23,62
070 Ratschings,36,,40,25,65
070 Ratschings,37,,30,20,50
070 Ratschings,38,,33,17,50
070 Ratschings,39,,37,20,57
070 Ratschings,40,,16,33,49
070 Ratschings,41,,28,15,43
070 Ratschings,42,,21,24,45
070 Ratschings,43,,21,19,40
070 Ratschings,44,,15,14,29
070 Ratschings,45,,23,20,43
070 Ratschings,46,,23,23,46
070 Ratschings,47,,33,20,53
070 Ratschings,48,,19,15,34
070 Ratschings,49,,24,7,31
070 Ratschings,50,,17,20,37
070 Ratschings,51,,21,11,32
070 Ratschings,52,,15,14,29
070 Ratschings,53,,21,21,42
070 Ratschings,54,,24,22,46
070 Ratschings,55,,20,16,36
070 Ratschings,56,,20,19,39
070 Ratschings,57,,15,21,36
070 Ratschings,58,,20,10,30
070 Ratschings,59,,16,13,29
070 Ratschings,60,,19,17,36
070 Ratschings,61,,13,12,25
070 Ratschings,62,,16,19,35
070 Ratschings,63,,16,14,30
070 Ratschings,64,,13,13,26
070 Ratschings,65,,13,18,31
070 Ratschings,66,,12,23,35
070 Ratschings,67,,11,15,26
070 Ratschings,68,,21,15,36
070 Ratschings,69,,15,17,32
070 Ratschings,70,,15,9,24
070 Ratschings,71,,14,15,29
070 Ratschings,72,,13,11,24
070 Ratschings,73,,9,13,22
070 Ratschings,74,,9,16,25
070 Ratschings,75,,5,14,19
070 Ratschings,76,,5,5,10
070 Ratschings,77,,1,11,12
070 Ratschings,78,,1,1,2
070 Ratschings,79,,4,5,9
070 Ratschings,80,,4,10,14
070 Ratschings,81,,4,6,10
070 Ratschings,82,,6,6,12
070 Ratschings,83,,5,9,14
070 Ratschings,84,,3,4,7
070 Ratschings,85,,1,2,3
070 Ratschings,86,,1,3,4
070 Ratschings,87,,3,3,6
070 Ratschings,89,,-,3,3
070 Ratschings,90,,3,1,4
070 Ratschings,91,,-,1,1
070 Ratschings,94,,-,1,1
071 Rasen-Antholz,0,,9,14,23
071 Rasen-Antholz,1,,20,10,30
071 Rasen-Antholz,2,,20,17,37
071 Rasen-Antholz,3,,29,20,49
071 Rasen-Antholz,4,,18,16,34
071 Rasen-Antholz,5,,13,26,39
071 Rasen-Antholz,6,,19,18,37
071 Rasen-Antholz,7,,20,16,36
071 Rasen-Antholz,8,,27,10,37
071 Rasen-Antholz,9,,17,21,38
071 Rasen-Antholz,10,,22,14,36
071 Rasen-Antholz,11,,18,18,36
071 Rasen-Antholz,12,,14,18,32
071 Rasen-Antholz,13,,20,24,44
071 Rasen-Antholz,14,,15,15,30
071 Rasen-Antholz,15,,19,12,31
071 Rasen-Antholz,16,,17,19,36
071 Rasen-Antholz,17,,16,17,33
071 Rasen-Antholz,18,,16,21,37
071 Rasen-Antholz,19,,20,22,42
071 Rasen-Antholz,20,,23,29,52
071 Rasen-Antholz,21,,32,25,57
071 Rasen-Antholz,22,,35,24,59
071 Rasen-Antholz,23,,36,15,51
071 Rasen-Antholz,24,,29,25,54
071 Rasen-Antholz,25,,29,34,63
071 Rasen-Antholz,26,,33,34,67
071 Rasen-Antholz,27,,29,29,58
071 Rasen-Antholz,28,,30,24,54
071 Rasen-Antholz,29,,29,19,48
071 Rasen-Antholz,30,,35,28,63
071 Rasen-Antholz,31,,29,18,47
071 Rasen-Antholz,32,,24,20,44
071 Rasen-Antholz,33,,30,21,51
071 Rasen-Antholz,34,,20,25,45
071 Rasen-Antholz,35,,20,23,43
071 Rasen-Antholz,36,,26,22,48
071 Rasen-Antholz,37,,24,15,39
071 Rasen-Antholz,38,,22,14,36
071 Rasen-Antholz,39,,19,17,36
071 Rasen-Antholz,40,,18,15,33
071 Rasen-Antholz,41,,14,12,26
071 Rasen-Antholz,42,,18,11,29
071 Rasen-Antholz,43,,12,14,26
071 Rasen-Antholz,44,,14,12,26
071 Rasen-Antholz,45,,17,9,26
071 Rasen-Antholz,46,,14,9,23
071 Rasen-Antholz,47,,15,9,24
071 Rasen-Antholz,48,,10,13,23
071 Rasen-Antholz,49,,11,13,24
071 Rasen-Antholz,50,,11,9,20
071 Rasen-Antholz,51,,9,9,18
071 Rasen-Antholz,52,,14,14,28
071 Rasen-Antholz,53,,11,14,25
071 Rasen-Antholz,54,,14,13,27
071 Rasen-Antholz,55,,11,17,28
071 Rasen-Antholz,56,,17,13,30
071 Rasen-Antholz,57,,15,9,24
071 Rasen-Antholz,58,,10,12,22
071 Rasen-Antholz,59,,10,12,22
071 Rasen-Antholz,60,,11,9,20
071 Rasen-Antholz,61,,12,10,22
071 Rasen-Antholz,62,,13,15,28
071 Rasen-Antholz,63,,18,12,30
071 Rasen-Antholz,64,,14,14,28
071 Rasen-Antholz,65,,6,11,17
071 Rasen-Antholz,66,,13,4,17
071 Rasen-Antholz,67,,6,4,10
071 Rasen-Antholz,68,,15,11,26
071 Rasen-Antholz,69,,9,6,15
071 Rasen-Antholz,70,,7,12,19
071 Rasen-Antholz,71,,9,13,22
071 Rasen-Antholz,72,,4,12,16
071 Rasen-Antholz,73,,5,7,12
071 Rasen-Antholz,74,,12,6,18
071 Rasen-Antholz,75,,4,6,10
071 Rasen-Antholz,76,,6,7,13
071 Rasen-Antholz,77,,2,3,5
071 Rasen-Antholz,78,,4,4,8
071 Rasen-Antholz,79,,-,6,6
071 Rasen-Antholz,80,,3,4,7
071 Rasen-Antholz,81,,2,5,7
071 Rasen-Antholz,82,,2,4,6
071 Rasen-Antholz,83,,2,6,8
071 Rasen-Antholz,84,,4,4,8
071 Rasen-Antholz,85,,-,4,4
071 Rasen-Antholz,86,,2,6,8
071 Rasen-Antholz,87,,1,4,5
071 Rasen-Antholz,88,,1,2,3
071 Rasen-Antholz,89,,-,2,2
071 Rasen-Antholz,90,,-,1,1
071 Rasen-Antholz,93,,1,-,1
072 Ritten,0,,56,52,108
072 Ritten,1,,56,46,102
072 Ritten,2,,58,50,108
072 Ritten,3,,48,68,116
072 Ritten,4,,63,47,110
072 Ritten,5,,59,45,104
072 Ritten,6,,54,47,101
072 Ritten,7,,55,48,103
072 Ritten,8,,49,44,93
072 Ritten,9,,47,42,89
072 Ritten,10,,45,47,92
072 Ritten,11,,46,29,75
072 Ritten,12,,51,41,92
072 Ritten,13,,38,46,84
072 Ritten,14,,45,46,91
072 Ritten,15,,46,33,79
072 Ritten,16,,47,42,89
072 Ritten,17,,42,36,78
072 Ritten,18,,59,39,98
072 Ritten,19,,41,41,82
072 Ritten,20,,56,38,94
072 Ritten,21,,64,55,119
072 Ritten,22,,47,58,105
072 Ritten,23,,53,46,99
072 Ritten,24,,53,73,126
072 Ritten,25,,46,73,119
072 Ritten,26,,45,59,104
072 Ritten,27,,63,65,128
072 Ritten,28,,71,52,123
072 Ritten,29,,55,50,105
072 Ritten,30,,72,47,119
072 Ritten,31,,63,56,119
072 Ritten,32,,57,57,114
072 Ritten,33,,59,64,123
072 Ritten,34,,52,64,116
072 Ritten,35,,63,56,119
072 Ritten,36,,61,53,114
072 Ritten,37,,36,42,78
072 Ritten,38,,46,37,83
072 Ritten,39,,49,43,92
072 Ritten,40,,51,39,90
072 Ritten,41,,37,31,68
072 Ritten,42,,47,31,78
072 Ritten,43,,42,44,86
072 Ritten,44,,43,36,79
072 Ritten,45,,35,42,77
072 Ritten,46,,32,41,73
072 Ritten,47,,51,32,83
072 Ritten,48,,32,25,57
072 Ritten,49,,31,36,67
072 Ritten,50,,22,24,46
072 Ritten,51,,33,42,75
072 Ritten,52,,40,41,81
072 Ritten,53,,46,36,82
072 Ritten,54,,35,36,71
072 Ritten,55,,42,24,66
072 Ritten,56,,40,32,72
072 Ritten,57,,33,35,68
072 Ritten,58,,31,24,55
072 Ritten,59,,26,25,51
072 Ritten,60,,26,34,60
072 Ritten,61,,26,28,54
072 Ritten,62,,22,27,49
072 Ritten,63,,29,24,53
072 Ritten,64,,19,32,51
072 Ritten,65,,19,22,41
072 Ritten,66,,28,20,48
072 Ritten,67,,22,11,33
072 Ritten,68,,24,19,43
072 Ritten,69,,19,21,40
072 Ritten,70,,21,39,60
072 Ritten,71,,21,32,53
072 Ritten,72,,24,25,49
072 Ritten,73,,6,30,36
072 Ritten,74,,16,23,39
072 Ritten,75,,13,28,41
072 Ritten,76,,6,16,22
072 Ritten,77,,4,10,14
072 Ritten,78,,5,13,18
072 Ritten,79,,2,6,8
072 Ritten,80,,10,9,19
072 Ritten,81,,11,15,26
072 Ritten,82,,10,21,31
072 Ritten,83,,7,18,25
072 Ritten,84,,6,12,18
072 Ritten,85,,10,9,19
072 Ritten,86,,7,8,15
072 Ritten,87,,1,7,8
072 Ritten,88,,4,5,9
072 Ritten,89,,-,4,4
072 Ritten,90,,2,2,4
072 Ritten,91,,1,1,2
072 Ritten,92,,2,4,6
072 Ritten,93,,1,1,2
072 Ritten,96,,-,2,2
072 Ritten,98,,1,-,1
073 Riffian,0,,6,10,16
073 Riffian,1,,7,6,13
073 Riffian,2,,7,6,13
073 Riffian,3,,10,11,21
073 Riffian,4,,9,11,20
073 Riffian,5,,7,8,15
073 Riffian,6,,11,5,16
073 Riffian,7,,5,12,17
073 Riffian,8,,6,8,14
073 Riffian,9,,7,6,13
073 Riffian,10,,8,2,10
073 Riffian,11,,8,6,14
073 Riffian,12,,9,7,16
073 Riffian,13,,9,10,19
073 Riffian,14,,9,8,17
073 Riffian,15,,6,4,10
073 Riffian,16,,7,8,15
073 Riffian,17,,9,4,13
073 Riffian,18,,11,9,20
073 Riffian,19,,9,2,11
073 Riffian,20,,6,13,19
073 Riffian,21,,9,4,13
073 Riffian,22,,12,10,22
073 Riffian,23,,11,17,28
073 Riffian,24,,11,19,30
073 Riffian,25,,7,7,14
073 Riffian,26,,11,15,26
073 Riffian,27,,12,16,28
073 Riffian,28,,11,15,26
073 Riffian,29,,10,8,18
073 Riffian,30,,15,6,21
073 Riffian,31,,11,10,21
073 Riffian,32,,15,9,24
073 Riffian,33,,11,8,19
073 Riffian,34,,9,7,16
073 Riffian,35,,14,4,18
073 Riffian,36,,7,15,22
073 Riffian,37,,8,6,14
073 Riffian,38,,6,11,17
073 Riffian,39,,12,4,16
073 Riffian,40,,5,10,15
073 Riffian,41,,10,6,16
073 Riffian,42,,10,4,14
073 Riffian,43,,7,3,10
073 Riffian,44,,7,10,17
073 Riffian,45,,4,3,7
073 Riffian,46,,6,6,12
073 Riffian,47,,6,6,12
073 Riffian,48,,4,4,8
073 Riffian,49,,2,6,8
073 Riffian,50,,6,4,10
073 Riffian,51,,8,8,16
073 Riffian,52,,7,7,14
073 Riffian,53,,11,6,17
073 Riffian,54,,9,4,13
073 Riffian,55,,4,3,7
073 Riffian,56,,4,9,13
073 Riffian,57,,10,4,14
073 Riffian,58,,5,6,11
073 Riffian,59,,2,4,6
073 Riffian,60,,1,3,4
073 Riffian,61,,1,4,5
073 Riffian,62,,7,5,12
073 Riffian,63,,4,4,8
073 Riffian,64,,5,9,14
073 Riffian,65,,5,3,8
073 Riffian,66,,3,7,10
073 Riffian,67,,2,3,5
073 Riffian,68,,5,5,10
073 Riffian,69,,6,2,8
073 Riffian,70,,5,4,9
073 Riffian,71,,5,7,12
073 Riffian,72,,5,7,12
073 Riffian,73,,3,3,6
073 Riffian,74,,2,4,6
073 Riffian,75,,4,3,7
073 Riffian,76,,-,1,1
073 Riffian,77,,1,1,2
073 Riffian,78,,1,3,4
073 Riffian,79,,1,-,1
073 Riffian,80,,1,2,3
073 Riffian,81,,1,7,8
073 Riffian,82,,2,5,7
073 Riffian,83,,1,2,3
073 Riffian,84,,1,-,1
073 Riffian,85,,2,-,2
073 Riffian,86,,-,1,1
073 Riffian,87,,2,3,5
073 Riffian,89,,2,-,2
073 Riffian,91,,-,1,1
073 Riffian,93,,1,-,1
073 Riffian,95,,-,1,1
074 Mühlbach,0,,10,17,27
074 Mühlbach,1,,22,12,34
074 Mühlbach,2,,15,17,32
074 Mühlbach,3,,13,22,35
074 Mühlbach,4,,12,18,30
074 Mühlbach,5,,12,14,26
074 Mühlbach,6,,13,18,31
074 Mühlbach,7,,19,15,34
074 Mühlbach,8,,22,12,34
074 Mühlbach,9,,18,8,26
074 Mühlbach,10,,16,16,32
074 Mühlbach,11,,15,22,37
074 Mühlbach,12,,17,17,34
074 Mühlbach,13,,24,24,48
074 Mühlbach,14,,23,17,40
074 Mühlbach,15,,17,15,32
074 Mühlbach,16,,20,11,31
074 Mühlbach,17,,23,22,45
074 Mühlbach,18,,21,13,34
074 Mühlbach,19,,17,34,51
074 Mühlbach,20,,18,22,40
074 Mühlbach,21,,17,17,34
074 Mühlbach,22,,28,15,43
074 Mühlbach,23,,21,19,40
074 Mühlbach,24,,23,20,43
074 Mühlbach,25,,25,14,39
074 Mühlbach,26,,22,35,57
074 Mühlbach,27,,33,22,55
074 Mühlbach,28,,19,21,40
074 Mühlbach,29,,28,16,44
074 Mühlbach,30,,19,28,47
074 Mühlbach,31,,16,21,37
074 Mühlbach,32,,21,18,39
074 Mühlbach,33,,23,13,36
074 Mühlbach,34,,21,20,41
074 Mühlbach,35,,20,14,34
074 Mühlbach,36,,22,21,43
074 Mühlbach,37,,16,12,28
074 Mühlbach,38,,18,18,36
074 Mühlbach,39,,20,22,42
074 Mühlbach,40,,17,18,35
074 Mühlbach,41,,15,17,32
074 Mühlbach,42,,22,17,39
074 Mühlbach,43,,15,23,38
074 Mühlbach,44,,13,22,35
074 Mühlbach,45,,19,16,35
074 Mühlbach,46,,12,13,25
074 Mühlbach,47,,17,12,29
074 Mühlbach,48,,11,17,28
074 Mühlbach,49,,25,13,38
074 Mühlbach,50,,10,9,19
074 Mühlbach,51,,15,13,28
074 Mühlbach,52,,12,11,23
074 Mühlbach,53,,15,12,27
074 Mühlbach,54,,17,16,33
074 Mühlbach,55,,14,11,25
074 Mühlbach,56,,13,15,28
074 Mühlbach,57,,15,8,23
074 Mühlbach,58,,5,12,17
074 Mühlbach,59,,8,7,15
074 Mühlbach,60,,8,11,19
074 Mühlbach,61,,14,12,26
074 Mühlbach,62,,11,11,22
074 Mühlbach,63,,8,10,18
074 Mühlbach,64,,8,13,21
074 Mühlbach,65,,18,9,27
074 Mühlbach,66,,9,4,13
074 Mühlbach,67,,15,20,35
074 Mühlbach,68,,8,8,16
074 Mühlbach,69,,12,12,24
074 Mühlbach,70,,7,7,14
074 Mühlbach,71,,6,6,12
074 Mühlbach,72,,6,11,17
074 Mühlbach,73,,7,13,20
074 Mühlbach,74,,5,5,10
074 Mühlbach,75,,6,10,16
074 Mühlbach,76,,2,11,13
074 Mühlbach,77,,1,4,5
074 Mühlbach,78,,3,4,7
074 Mühlbach,79,,2,1,3
074 Mühlbach,80,,2,3,5
074 Mühlbach,81,,5,9,14
074 Mühlbach,82,,3,9,12
074 Mühlbach,83,,-,4,4
074 Mühlbach,84,,1,7,8
074 Mühlbach,85,,2,6,8
074 Mühlbach,86,,1,2,3
074 Mühlbach,87,,-,1,1
074 Mühlbach,88,,3,3,6
074 Mühlbach,89,,1,3,4
074 Mühlbach,90,,1,2,3
074 Mühlbach,92,,-,1,1
075 Rodeneck,0,,6,11,17
075 Rodeneck,1,,8,11,19
075 Rodeneck,2,,7,7,14
075 Rodeneck,3,,8,10,18
075 Rodeneck,4,,6,8,14
075 Rodeneck,5,,11,8,19
075 Rodeneck,6,,7,6,13
075 Rodeneck,7,,13,8,21
075 Rodeneck,8,,6,5,11
075 Rodeneck,9,,9,12,21
075 Rodeneck,10,,12,9,21
075 Rodeneck,11,,16,11,27
075 Rodeneck,12,,11,7,18
075 Rodeneck,13,,7,6,13
075 Rodeneck,14,,10,8,18
075 Rodeneck,15,,6,9,15
075 Rodeneck,16,,8,7,15
075 Rodeneck,17,,6,8,14
075 Rodeneck,18,,8,8,16
075 Rodeneck,19,,7,5,12
075 Rodeneck,20,,9,6,15
075 Rodeneck,21,,7,5,12
075 Rodeneck,22,,16,9,25
075 Rodeneck,23,,9,10,19
075 Rodeneck,24,,13,7,20
075 Rodeneck,25,,9,13,22
075 Rodeneck,26,,15,8,23
075 Rodeneck,27,,9,10,19
075 Rodeneck,28,,12,8,20
075 Rodeneck,29,,13,8,21
075 Rodeneck,30,,8,8,16
075 Rodeneck,31,,12,11,23
075 Rodeneck,32,,10,11,21
075 Rodeneck,33,,10,16,26
075 Rodeneck,34,,10,13,23
075 Rodeneck,35,,6,11,17
075 Rodeneck,36,,11,5,16
075 Rodeneck,37,,8,5,13
075 Rodeneck,38,,6,8,14
075 Rodeneck,39,,10,5,15
075 Rodeneck,40,,6,6,12
075 Rodeneck,41,,11,4,15
075 Rodeneck,42,,5,2,7
075 Rodeneck,43,,8,5,13
075 Rodeneck,44,,5,2,7
075 Rodeneck,45,,1,7,8
075 Rodeneck,46,,4,8,12
075 Rodeneck,47,,4,7,11
075 Rodeneck,48,,6,4,10
075 Rodeneck,49,,10,5,15
075 Rodeneck,50,,-,4,4
075 Rodeneck,51,,5,5,10
075 Rodeneck,52,,3,2,5
075 Rodeneck,53,,3,6,9
075 Rodeneck,54,,10,4,14
075 Rodeneck,55,,6,4,10
075 Rodeneck,56,,3,9,12
075 Rodeneck,57,,4,3,7
075 Rodeneck,58,,3,4,7
075 Rodeneck,59,,5,5,10
075 Rodeneck,60,,5,2,7
075 Rodeneck,61,,1,12,13
075 Rodeneck,62,,3,2,5
075 Rodeneck,63,,5,5,10
075 Rodeneck,64,,7,5,12
075 Rodeneck,65,,5,3,8
075 Rodeneck,66,,7,3,10
075 Rodeneck,67,,6,5,11
075 Rodeneck,68,,5,6,11
075 Rodeneck,69,,4,6,10
075 Rodeneck,70,,4,9,13
075 Rodeneck,71,,5,5,10
075 Rodeneck,72,,2,4,6
075 Rodeneck,73,,4,3,7
075 Rodeneck,74,,3,1,4
075 Rodeneck,75,,2,2,4
075 Rodeneck,76,,5,2,7
075 Rodeneck,77,,1,3,4
075 Rodeneck,78,,-,1,1
075 Rodeneck,79,,1,1,2
075 Rodeneck,80,,1,3,4
075 Rodeneck,81,,2,1,3
075 Rodeneck,82,,1,1,2
075 Rodeneck,83,,2,3,5
075 Rodeneck,84,,1,2,3
075 Rodeneck,85,,3,-,3
075 Rodeneck,86,,1,1,2
075 Rodeneck,87,,-,1,1
075 Rodeneck,88,,-,1,1
075 Rodeneck,92,,1,-,1
076 Salurn,0,,23,10,33
076 Salurn,1,,20,19,39
076 Salurn,2,,16,12,28
076 Salurn,3,,24,16,40
076 Salurn,4,,9,11,20
076 Salurn,5,,10,9,19
076 Salurn,6,,18,14,32
076 Salurn,7,,14,18,32
076 Salurn,8,,19,12,31
076 Salurn,9,,13,17,30
076 Salurn,10,,20,16,36
076 Salurn,11,,12,15,27
076 Salurn,12,,12,16,28
076 Salurn,13,,18,12,30
076 Salurn,14,,16,13,29
076 Salurn,15,,20,15,35
076 Salurn,16,,10,13,23
076 Salurn,17,,14,10,24
076 Salurn,18,,19,14,33
076 Salurn,19,,9,17,26
076 Salurn,20,,12,21,33
076 Salurn,21,,15,19,34
076 Salurn,22,,16,15,31
076 Salurn,23,,16,28,44
076 Salurn,24,,28,15,43
076 Salurn,25,,23,23,46
076 Salurn,26,,23,21,44
076 Salurn,27,,24,14,38
076 Salurn,28,,20,25,45
076 Salurn,29,,25,21,46
076 Salurn,30,,24,26,50
076 Salurn,31,,28,24,52
076 Salurn,32,,37,23,60
076 Salurn,33,,32,18,50
076 Salurn,34,,30,26,56
076 Salurn,35,,21,29,50
076 Salurn,36,,22,24,46
076 Salurn,37,,25,19,44
076 Salurn,38,,15,22,37
076 Salurn,39,,21,14,35
076 Salurn,40,,17,20,37
076 Salurn,41,,26,19,45
076 Salurn,42,,19,16,35
076 Salurn,43,,28,18,46
076 Salurn,44,,31,19,50
076 Salurn,45,,25,20,45
076 Salurn,46,,26,11,37
076 Salurn,47,,15,23,38
076 Salurn,48,,19,16,35
076 Salurn,49,,19,18,37
076 Salurn,50,,16,10,26
076 Salurn,51,,20,21,41
076 Salurn,52,,18,17,35
076 Salurn,53,,19,16,35
076 Salurn,54,,15,17,32
076 Salurn,55,,14,9,23
076 Salurn,56,,11,11,22
076 Salurn,57,,8,13,21
076 Salurn,58,,10,9,19
076 Salurn,59,,13,22,35
076 Salurn,60,,20,16,36
076 Salurn,61,,13,6,19
076 Salurn,62,,14,10,24
076 Salurn,63,,11,22,33
076 Salurn,64,,6,13,19
076 Salurn,65,,15,11,26
076 Salurn,66,,25,13,38
076 Salurn,67,,11,24,35
076 Salurn,68,,9,24,33
076 Salurn,69,,9,16,25
076 Salurn,70,,8,24,32
076 Salurn,71,,13,16,29
076 Salurn,72,,10,10,20
076 Salurn,73,,15,22,37
076 Salurn,74,,8,16,24
076 Salurn,75,,14,13,27
076 Salurn,76,,7,15,22
076 Salurn,77,,6,4,10
076 Salurn,78,,2,6,8
076 Salurn,79,,5,10,15
076 Salurn,80,,7,9,16
076 Salurn,81,,7,12,19
076 Salurn,82,,3,8,11
076 Salurn,83,,4,9,13
076 Salurn,84,,3,7,10
076 Salurn,85,,5,5,10
076 Salurn,86,,4,6,10
076 Salurn,87,,2,5,7
076 Salurn,88,,1,6,7
076 Salurn,89,,1,3,4
076 Salurn,90,,2,1,3
076 Salurn,91,,1,2,3
076 Salurn,92,,-,3,3
076 Salurn,93,,-,1,1
076 Salurn,96,,-,1,1
077 Innichen,0,,21,13,34
077 Innichen,1,,15,18,33
077 Innichen,2,,22,19,41
077 Innichen,3,,23,18,41
077 Innichen,4,,21,24,45
077 Innichen,5,,17,14,31
077 Innichen,6,,18,22,40
077 Innichen,7,,29,20,49
077 Innichen,8,,21,19,40
077 Innichen,9,,22,17,39
077 Innichen,10,,20,20,40
077 Innichen,11,,20,21,41
077 Innichen,12,,22,16,38
077 Innichen,13,,18,22,40
077 Innichen,14,,16,19,35
077 Innichen,15,,22,17,39
077 Innichen,16,,25,21,46
077 Innichen,17,,9,16,25
077 Innichen,18,,14,20,34
077 Innichen,19,,18,26,44
077 Innichen,20,,24,5,29
077 Innichen,21,,25,23,48
077 Innichen,22,,29,24,53
077 Innichen,23,,29,24,53
077 Innichen,24,,25,22,47
077 Innichen,25,,30,30,60
077 Innichen,26,,30,30,60
077 Innichen,27,,34,32,66
077 Innichen,28,,19,26,45
077 Innichen,29,,31,27,58
077 Innichen,30,,33,33,66
077 Innichen,31,,32,33,65
077 Innichen,32,,35,28,63
077 Innichen,33,,33,26,59
077 Innichen,34,,27,31,58
077 Innichen,35,,39,19,58
077 Innichen,36,,27,25,52
077 Innichen,37,,23,26,49
077 Innichen,38,,21,25,46
077 Innichen,39,,27,14,41
077 Innichen,40,,26,18,44
077 Innichen,41,,23,13,36
077 Innichen,42,,24,19,43
077 Innichen,43,,13,26,39
077 Innichen,44,,12,18,30
077 Innichen,45,,18,20,38
077 Innichen,46,,21,17,38
077 Innichen,47,,19,12,31
077 Innichen,48,,14,15,29
077 Innichen,49,,16,15,31
077 Innichen,50,,13,9,22
077 Innichen,51,,8,13,21
077 Innichen,52,,23,11,34
077 Innichen,53,,16,18,34
077 Innichen,54,,15,16,31
077 Innichen,55,,10,23,33
077 Innichen,56,,12,13,25
077 Innichen,57,,8,11,19
077 Innichen,58,,11,13,24
077 Innichen,59,,11,17,28
077 Innichen,60,,8,20,28
077 Innichen,61,,12,14,26
077 Innichen,62,,12,10,22
077 Innichen,63,,21,16,37
077 Innichen,64,,15,20,35
077 Innichen,65,,17,11,28
077 Innichen,66,,15,17,32
077 Innichen,67,,13,21,34
077 Innichen,68,,9,12,21
077 Innichen,69,,20,14,34
077 Innichen,70,,10,23,33
077 Innichen,71,,12,6,18
077 Innichen,72,,10,14,24
077 Innichen,73,,8,16,24
077 Innichen,74,,8,15,23
077 Innichen,75,,8,13,21
077 Innichen,76,,5,5,10
077 Innichen,77,,2,6,8
077 Innichen,78,,4,4,8
077 Innichen,79,,3,5,8
077 Innichen,80,,5,6,11
077 Innichen,81,,5,6,11
077 Innichen,82,,6,9,15
077 Innichen,83,,2,7,9
077 Innichen,84,,1,2,3
077 Innichen,85,,1,6,7
077 Innichen,86,,4,3,7
077 Innichen,87,,3,5,8
077 Innichen,88,,2,3,5
077 Innichen,89,,1,1,2
077 Innichen,90,,-,2,2
077 Innichen,91,,-,2,2
077 Innichen,92,,-,2,2
077 Innichen,93,,1,3,4
077 Innichen,94,,-,3,3
079 Jenesien,0,,27,17,44
079 Jenesien,1,,22,23,45
079 Jenesien,2,,15,21,36
079 Jenesien,3,,26,21,47
079 Jenesien,4,,18,19,37
079 Jenesien,5,,18,15,33
079 Jenesien,6,,19,12,31
079 Jenesien,7,,23,16,39
079 Jenesien,8,,13,19,32
079 Jenesien,9,,17,16,33
079 Jenesien,10,,13,5,18
079 Jenesien,11,,17,15,32
079 Jenesien,12,,16,19,35
079 Jenesien,13,,14,24,38
079 Jenesien,14,,8,20,28
079 Jenesien,15,,15,21,36
079 Jenesien,16,,21,20,41
079 Jenesien,17,,12,13,25
079 Jenesien,18,,18,23,41
079 Jenesien,19,,13,13,26
079 Jenesien,20,,9,13,22
079 Jenesien,21,,17,18,35
079 Jenesien,22,,18,22,40
079 Jenesien,23,,17,22,39
079 Jenesien,24,,28,19,47
079 Jenesien,25,,29,24,53
079 Jenesien,26,,31,16,47
079 Jenesien,27,,22,28,50
079 Jenesien,28,,17,19,36
079 Jenesien,29,,28,30,58
079 Jenesien,30,,30,29,59
079 Jenesien,31,,36,34,70
079 Jenesien,32,,30,22,52
079 Jenesien,33,,27,20,47
079 Jenesien,34,,26,20,46
079 Jenesien,35,,23,12,35
079 Jenesien,36,,22,13,35
079 Jenesien,37,,26,9,35
079 Jenesien,38,,13,16,29
079 Jenesien,39,,19,15,34
079 Jenesien,40,,9,10,19
079 Jenesien,41,,16,16,32
079 Jenesien,42,,16,9,25
079 Jenesien,43,,15,20,35
079 Jenesien,44,,10,9,19
079 Jenesien,45,,11,20,31
079 Jenesien,46,,12,14,26
079 Jenesien,47,,12,7,19
079 Jenesien,48,,13,12,25
079 Jenesien,49,,9,11,20
079 Jenesien,50,,7,15,22
079 Jenesien,51,,13,14,27
079 Jenesien,52,,18,10,28
079 Jenesien,53,,16,10,26
079 Jenesien,54,,16,18,34
079 Jenesien,55,,16,11,27
079 Jenesien,56,,15,18,33
079 Jenesien,57,,22,9,31
079 Jenesien,58,,11,16,27
079 Jenesien,59,,8,18,26
079 Jenesien,60,,6,5,11
079 Jenesien,61,,9,7,16
079 Jenesien,62,,18,12,30
079 Jenesien,63,,8,11,19
079 Jenesien,64,,12,9,21
079 Jenesien,65,,7,17,24
079 Jenesien,66,,12,16,28
079 Jenesien,67,,15,10,25
079 Jenesien,68,,8,10,18
079 Jenesien,69,,11,14,25
079 Jenesien,70,,4,14,18
079 Jenesien,71,,8,11,19
079 Jenesien,72,,10,10,20
079 Jenesien,73,,6,12,18
079 Jenesien,74,,4,7,11
079 Jenesien,75,,3,10,13
079 Jenesien,76,,2,5,7
079 Jenesien,77,,-,1,1
079 Jenesien,78,,3,-,3
079 Jenesien,79,,2,2,4
079 Jenesien,80,,2,6,8
079 Jenesien,81,,4,5,9
079 Jenesien,82,,1,8,9
079 Jenesien,83,,1,5,6
079 Jenesien,84,,3,7,10
079 Jenesien,85,,-,4,4
079 Jenesien,86,,3,2,5
079 Jenesien,87,,3,4,7
079 Jenesien,88,,-,1,1
079 Jenesien,89,,2,3,5
079 Jenesien,90,,-,3,3
079 Jenesien,91,,1,2,3
079 Jenesien,92,,3,-,3
080 St.Leonhard in Pass.,0,,23,13,36
080 St.Leonhard in Pass.,1,,27,20,47
080 St.Leonhard in Pass.,2,,25,21,46
080 St.Leonhard in Pass.,3,,24,20,44
080 St.Leonhard in Pass.,4,,24,21,45
080 St.Leonhard in Pass.,5,,24,22,46
080 St.Leonhard in Pass.,6,,36,31,67
080 St.Leonhard in Pass.,7,,23,25,48
080 St.Leonhard in Pass.,8,,31,25,56
080 St.Leonhard in Pass.,9,,34,35,69
080 St.Leonhard in Pass.,10,,23,27,50
080 St.Leonhard in Pass.,11,,30,26,56
080 St.Leonhard in Pass.,12,,29,28,57
080 St.Leonhard in Pass.,13,,31,22,53
080 St.Leonhard in Pass.,14,,23,30,53
080 St.Leonhard in Pass.,15,,29,35,64
080 St.Leonhard in Pass.,16,,26,24,50
080 St.Leonhard in Pass.,17,,31,21,52
080 St.Leonhard in Pass.,18,,37,29,66
080 St.Leonhard in Pass.,19,,20,27,47
080 St.Leonhard in Pass.,20,,28,15,43
080 St.Leonhard in Pass.,21,,34,35,69
080 St.Leonhard in Pass.,22,,34,37,71
080 St.Leonhard in Pass.,23,,37,30,67
080 St.Leonhard in Pass.,24,,31,22,53
080 St.Leonhard in Pass.,25,,28,31,59
080 St.Leonhard in Pass.,26,,28,31,59
080 St.Leonhard in Pass.,27,,32,29,61
080 St.Leonhard in Pass.,28,,30,24,54
080 St.Leonhard in Pass.,29,,39,39,78
080 St.Leonhard in Pass.,30,,29,32,61
080 St.Leonhard in Pass.,31,,23,31,54
080 St.Leonhard in Pass.,32,,28,31,59
080 St.Leonhard in Pass.,33,,25,33,58
080 St.Leonhard in Pass.,34,,30,24,54
080 St.Leonhard in Pass.,35,,30,21,51
080 St.Leonhard in Pass.,36,,24,26,50
080 St.Leonhard in Pass.,37,,21,22,43
080 St.Leonhard in Pass.,38,,22,27,49
080 St.Leonhard in Pass.,39,,25,16,41
080 St.Leonhard in Pass.,40,,25,19,44
080 St.Leonhard in Pass.,41,,22,16,38
080 St.Leonhard in Pass.,42,,30,26,56
080 St.Leonhard in Pass.,43,,21,26,47
080 St.Leonhard in Pass.,44,,27,16,43
080 St.Leonhard in Pass.,45,,19,15,34
080 St.Leonhard in Pass.,46,,26,12,38
080 St.Leonhard in Pass.,47,,22,15,37
080 St.Leonhard in Pass.,48,,20,17,37
080 St.Leonhard in Pass.,49,,17,19,36
080 St.Leonhard in Pass.,50,,10,11,21
080 St.Leonhard in Pass.,51,,18,14,32
080 St.Leonhard in Pass.,52,,11,26,37
080 St.Leonhard in Pass.,53,,10,16,26
080 St.Leonhard in Pass.,54,,15,15,30
080 St.Leonhard in Pass.,55,,24,14,38
080 St.Leonhard in Pass.,56,,21,19,40
080 St.Leonhard in Pass.,57,,14,14,28
080 St.Leonhard in Pass.,58,,20,9,29
080 St.Leonhard in Pass.,59,,20,11,31
080 St.Leonhard in Pass.,60,,14,14,28
080 St.Leonhard in Pass.,61,,11,14,25
080 St.Leonhard in Pass.,62,,13,16,29
080 St.Leonhard in Pass.,63,,16,16,32
080 St.Leonhard in Pass.,64,,11,15,26
080 St.Leonhard in Pass.,65,,9,10,19
080 St.Leonhard in Pass.,66,,13,10,23
080 St.Leonhard in Pass.,67,,10,14,24
080 St.Leonhard in Pass.,68,,9,15,24
080 St.Leonhard in Pass.,69,,11,13,24
080 St.Leonhard in Pass.,70,,9,12,21
080 St.Leonhard in Pass.,71,,8,11,19
080 St.Leonhard in Pass.,72,,8,14,22
080 St.Leonhard in Pass.,73,,9,11,20
080 St.Leonhard in Pass.,74,,3,8,11
080 St.Leonhard in Pass.,75,,5,10,15
080 St.Leonhard in Pass.,76,,6,3,9
080 St.Leonhard in Pass.,77,,3,5,8
080 St.Leonhard in Pass.,78,,1,6,7
080 St.Leonhard in Pass.,79,,2,1,3
080 St.Leonhard in Pass.,80,,2,6,8
080 St.Leonhard in Pass.,81,,4,11,15
080 St.Leonhard in Pass.,82,,-,5,5
080 St.Leonhard in Pass.,83,,4,11,15
080 St.Leonhard in Pass.,84,,4,7,11
080 St.Leonhard in Pass.,85,,-,2,2
080 St.Leonhard in Pass.,86,,2,4,6
080 St.Leonhard in Pass.,87,,3,2,5
080 St.Leonhard in Pass.,88,,2,7,9
080 St.Leonhard in Pass.,89,,2,1,3
080 St.Leonhard in Pass.,90,,1,3,4
080 St.Leonhard in Pass.,91,,-,4,4
080 St.Leonhard in Pass.,92,,1,1,2
080 St.Leonhard in Pass.,93,,-,1,1
080 St.Leonhard in Pass.,94,,1,-,1
081 St.Lorenzen,0,,23,13,36
081 St.Lorenzen,1,,30,21,51
081 St.Lorenzen,2,,22,30,52
081 St.Lorenzen,3,,26,19,45
081 St.Lorenzen,4,,22,15,37
081 St.Lorenzen,5,,24,21,45
081 St.Lorenzen,6,,19,17,36
081 St.Lorenzen,7,,19,26,45
081 St.Lorenzen,8,,19,22,41
081 St.Lorenzen,9,,22,21,43
081 St.Lorenzen,10,,24,22,46
081 St.Lorenzen,11,,25,26,51
081 St.Lorenzen,12,,21,19,40
081 St.Lorenzen,13,,30,18,48
081 St.Lorenzen,14,,19,19,38
081 St.Lorenzen,15,,13,17,30
081 St.Lorenzen,16,,24,26,50
081 St.Lorenzen,17,,22,25,47
081 St.Lorenzen,18,,27,21,48
081 St.Lorenzen,19,,24,22,46
081 St.Lorenzen,20,,22,22,44
081 St.Lorenzen,21,,18,25,43
081 St.Lorenzen,22,,35,22,57
081 St.Lorenzen,23,,33,23,56
081 St.Lorenzen,24,,30,21,51
081 St.Lorenzen,25,,23,27,50
081 St.Lorenzen,26,,26,27,53
081 St.Lorenzen,27,,41,38,79
081 St.Lorenzen,28,,38,30,68
081 St.Lorenzen,29,,34,37,71
081 St.Lorenzen,30,,36,24,60
081 St.Lorenzen,31,,30,23,53
081 St.Lorenzen,32,,36,32,68
081 St.Lorenzen,33,,28,34,62
081 St.Lorenzen,34,,22,37,59
081 St.Lorenzen,35,,33,22,55
081 St.Lorenzen,36,,28,26,54
081 St.Lorenzen,37,,26,30,56
081 St.Lorenzen,38,,27,26,53
081 St.Lorenzen,39,,26,27,53
081 St.Lorenzen,40,,18,17,35
081 St.Lorenzen,41,,18,20,38
081 St.Lorenzen,42,,23,16,39
081 St.Lorenzen,43,,18,12,30
081 St.Lorenzen,44,,18,15,33
081 St.Lorenzen,45,,14,18,32
081 St.Lorenzen,46,,11,21,32
081 St.Lorenzen,47,,14,12,26
081 St.Lorenzen,48,,21,8,29
081 St.Lorenzen,49,,22,8,30
081 St.Lorenzen,50,,14,20,34
081 St.Lorenzen,51,,16,15,31
081 St.Lorenzen,52,,16,15,31
081 St.Lorenzen,53,,19,24,43
081 St.Lorenzen,54,,22,19,41
081 St.Lorenzen,55,,13,14,27
081 St.Lorenzen,56,,15,18,33
081 St.Lorenzen,57,,15,13,28
081 St.Lorenzen,58,,17,17,34
081 St.Lorenzen,59,,13,16,29
081 St.Lorenzen,60,,14,17,31
081 St.Lorenzen,61,,17,14,31
081 St.Lorenzen,62,,15,15,30
081 St.Lorenzen,63,,16,13,29
081 St.Lorenzen,64,,10,16,26
081 St.Lorenzen,65,,13,11,24
081 St.Lorenzen,66,,12,20,32
081 St.Lorenzen,67,,21,17,38
081 St.Lorenzen,68,,12,7,19
081 St.Lorenzen,69,,11,13,24
081 St.Lorenzen,70,,12,20,32
081 St.Lorenzen,71,,5,12,17
081 St.Lorenzen,72,,12,12,24
081 St.Lorenzen,73,,8,10,18
081 St.Lorenzen,74,,7,6,13
081 St.Lorenzen,75,,4,10,14
081 St.Lorenzen,76,,8,11,19
081 St.Lorenzen,77,,3,8,11
081 St.Lorenzen,78,,-,6,6
081 St.Lorenzen,79,,2,5,7
081 St.Lorenzen,80,,3,4,7
081 St.Lorenzen,81,,7,6,13
081 St.Lorenzen,82,,2,4,6
081 St.Lorenzen,83,,4,6,10
081 St.Lorenzen,84,,4,3,7
081 St.Lorenzen,85,,2,6,8
081 St.Lorenzen,86,,2,2,4
081 St.Lorenzen,87,,-,5,5
081 St.Lorenzen,88,,1,5,6
081 St.Lorenzen,89,,-,1,1
081 St.Lorenzen,90,,-,2,2
081 St.Lorenzen,91,,1,3,4
081 St.Lorenzen,92,,-,3,3
081 St.Lorenzen,95,,-,2,2
082 St.Martin in Thurn,0,,14,13,27
082 St.Martin in Thurn,1,,14,8,22
082 St.Martin in Thurn,2,,8,8,16
082 St.Martin in Thurn,3,,16,14,30
082 St.Martin in Thurn,4,,11,10,21
082 St.Martin in Thurn,5,,6,16,22
082 St.Martin in Thurn,6,,17,15,32
082 St.Martin in Thurn,7,,8,6,14
082 St.Martin in Thurn,8,,14,12,26
082 St.Martin in Thurn,9,,13,10,23
082 St.Martin in Thurn,10,,12,14,26
082 St.Martin in Thurn,11,,8,6,14
082 St.Martin in Thurn,12,,15,9,24
082 St.Martin in Thurn,13,,14,12,26
082 St.Martin in Thurn,14,,17,8,25
082 St.Martin in Thurn,15,,8,13,21
082 St.Martin in Thurn,16,,9,11,20
082 St.Martin in Thurn,17,,18,9,27
082 St.Martin in Thurn,18,,14,13,27
082 St.Martin in Thurn,19,,12,11,23
082 St.Martin in Thurn,20,,8,15,23
082 St.Martin in Thurn,21,,6,10,16
082 St.Martin in Thurn,22,,12,10,22
082 St.Martin in Thurn,23,,11,12,23
082 St.Martin in Thurn,24,,13,14,27
082 St.Martin in Thurn,25,,14,11,25
082 St.Martin in Thurn,26,,15,13,28
082 St.Martin in Thurn,27,,13,20,33
082 St.Martin in Thurn,28,,12,9,21
082 St.Martin in Thurn,29,,16,23,39
082 St.Martin in Thurn,30,,15,19,34
082 St.Martin in Thurn,31,,12,13,25
082 St.Martin in Thurn,32,,14,13,27
082 St.Martin in Thurn,33,,14,14,28
082 St.Martin in Thurn,34,,15,21,36
082 St.Martin in Thurn,35,,15,6,21
082 St.Martin in Thurn,36,,11,12,23
082 St.Martin in Thurn,37,,13,8,21
082 St.Martin in Thurn,38,,12,10,22
082 St.Martin in Thurn,39,,7,8,15
082 St.Martin in Thurn,40,,13,9,22
082 St.Martin in Thurn,41,,8,8,16
082 St.Martin in Thurn,42,,8,11,19
082 St.Martin in Thurn,43,,3,4,7
082 St.Martin in Thurn,44,,8,8,16
082 St.Martin in Thurn,45,,12,7,19
082 St.Martin in Thurn,46,,4,7,11
082 St.Martin in Thurn,47,,9,7,16
082 St.Martin in Thurn,48,,9,6,15
082 St.Martin in Thurn,49,,9,7,16
082 St.Martin in Thurn,50,,8,4,12
082 St.Martin in Thurn,51,,11,8,19
082 St.Martin in Thurn,52,,4,9,13
082 St.Martin in Thurn,53,,8,6,14
082 St.Martin in Thurn,54,,7,8,15
082 St.Martin in Thurn,55,,4,5,9
082 St.Martin in Thurn,56,,5,7,12
082 St.Martin in Thurn,57,,10,7,17
082 St.Martin in Thurn,58,,7,14,21
082 St.Martin in Thurn,59,,4,6,10
082 St.Martin in Thurn,60,,7,5,12
082 St.Martin in Thurn,61,,8,4,12
082 St.Martin in Thurn,62,,2,11,13
082 St.Martin in Thurn,63,,9,7,16
082 St.Martin in Thurn,64,,11,7,18
082 St.Martin in Thurn,65,,7,7,14
082 St.Martin in Thurn,66,,6,7,13
082 St.Martin in Thurn,67,,3,7,10
082 St.Martin in Thurn,68,,6,6,12
082 St.Martin in Thurn,69,,9,8,17
082 St.Martin in Thurn,70,,8,4,12
082 St.Martin in Thurn,71,,8,9,17
082 St.Martin in Thurn,72,,4,8,12
082 St.Martin in Thurn,73,,10,5,15
082 St.Martin in Thurn,74,,7,5,12
082 St.Martin in Thurn,75,,7,8,15
082 St.Martin in Thurn,76,,2,4,6
082 St.Martin in Thurn,77,,2,-,2
082 St.Martin in Thurn,78,,5,2,7
082 St.Martin in Thurn,79,,1,1,2
082 St.Martin in Thurn,80,,1,2,3
082 St.Martin in Thurn,81,,2,3,5
082 St.Martin in Thurn,82,,1,2,3
082 St.Martin in Thurn,83,,1,2,3
082 St.Martin in Thurn,84,,4,2,6
082 St.Martin in Thurn,85,,3,3,6
082 St.Martin in Thurn,86,,1,3,4
082 St.Martin in Thurn,87,,3,1,4
082 St.Martin in Thurn,88,,-,2,2
082 St.Martin in Thurn,89,,-,1,1
082 St.Martin in Thurn,90,,1,-,1
082 St.Martin in Thurn,91,,2,2,4
082 St.Martin in Thurn,92,,-,1,1
082 St.Martin in Thurn,99,,-,1,1
083 St.Martin in Passeier,0,,21,17,38
083 St.Martin in Passeier,1,,21,23,44
083 St.Martin in Passeier,2,,19,22,41
083 St.Martin in Passeier,3,,27,16,43
083 St.Martin in Passeier,4,,23,21,44
083 St.Martin in Passeier,5,,19,26,45
083 St.Martin in Passeier,6,,19,19,38
083 St.Martin in Passeier,7,,17,15,32
083 St.Martin in Passeier,8,,18,22,40
083 St.Martin in Passeier,9,,22,23,45
083 St.Martin in Passeier,10,,16,21,37
083 St.Martin in Passeier,11,,15,23,38
083 St.Martin in Passeier,12,,17,9,26
083 St.Martin in Passeier,13,,20,20,40
083 St.Martin in Passeier,14,,23,20,43
083 St.Martin in Passeier,15,,19,21,40
083 St.Martin in Passeier,16,,21,12,33
083 St.Martin in Passeier,17,,32,17,49
083 St.Martin in Passeier,18,,20,21,41
083 St.Martin in Passeier,19,,22,22,44
083 St.Martin in Passeier,20,,25,21,46
083 St.Martin in Passeier,21,,20,28,48
083 St.Martin in Passeier,22,,22,31,53
083 St.Martin in Passeier,23,,28,26,54
083 St.Martin in Passeier,24,,31,25,56
083 St.Martin in Passeier,25,,27,28,55
083 St.Martin in Passeier,26,,27,34,61
083 St.Martin in Passeier,27,,23,26,49
083 St.Martin in Passeier,28,,18,28,46
083 St.Martin in Passeier,29,,30,31,61
083 St.Martin in Passeier,30,,33,28,61
083 St.Martin in Passeier,31,,23,23,46
083 St.Martin in Passeier,32,,37,18,55
083 St.Martin in Passeier,33,,20,30,50
083 St.Martin in Passeier,34,,36,22,58
083 St.Martin in Passeier,35,,20,26,46
083 St.Martin in Passeier,36,,28,21,49
083 St.Martin in Passeier,37,,25,21,46
083 St.Martin in Passeier,38,,28,11,39
083 St.Martin in Passeier,39,,21,16,37
083 St.Martin in Passeier,40,,34,14,48
083 St.Martin in Passeier,41,,16,8,24
083 St.Martin in Passeier,42,,23,18,41
083 St.Martin in Passeier,43,,6,21,27
083 St.Martin in Passeier,44,,22,14,36
083 St.Martin in Passeier,45,,12,16,28
083 St.Martin in Passeier,46,,12,8,20
083 St.Martin in Passeier,47,,15,10,25
083 St.Martin in Passeier,48,,16,13,29
083 St.Martin in Passeier,49,,15,11,26
083 St.Martin in Passeier,50,,12,13,25
083 St.Martin in Passeier,51,,18,12,30
083 St.Martin in Passeier,52,,15,11,26
083 St.Martin in Passeier,53,,15,14,29
083 St.Martin in Passeier,54,,11,14,25
083 St.Martin in Passeier,55,,6,13,19
083 St.Martin in Passeier,56,,6,14,20
083 St.Martin in Passeier,57,,14,8,22
083 St.Martin in Passeier,58,,15,18,33
083 St.Martin in Passeier,59,,15,14,29
083 St.Martin in Passeier,60,,6,14,20
083 St.Martin in Passeier,61,,19,8,27
083 St.Martin in Passeier,62,,14,9,23
083 St.Martin in Passeier,63,,11,13,24
083 St.Martin in Passeier,64,,7,13,20
083 St.Martin in Passeier,65,,11,14,25
083 St.Martin in Passeier,66,,13,10,23
083 St.Martin in Passeier,67,,9,8,17
083 St.Martin in Passeier,68,,13,6,19
083 St.Martin in Passeier,69,,5,13,18
083 St.Martin in Passeier,70,,10,9,19
083 St.Martin in Passeier,71,,7,15,22
083 St.Martin in Passeier,72,,4,11,15
083 St.Martin in Passeier,73,,8,7,15
083 St.Martin in Passeier,74,,8,13,21
083 St.Martin in Passeier,75,,3,5,8
083 St.Martin in Passeier,76,,2,5,7
083 St.Martin in Passeier,77,,1,3,4
083 St.Martin in Passeier,78,,4,5,9
083 St.Martin in Passeier,79,,1,2,3
083 St.Martin in Passeier,80,,4,1,5
083 St.Martin in Passeier,81,,1,8,9
083 St.Martin in Passeier,82,,4,7,11
083 St.Martin in Passeier,83,,3,5,8
083 St.Martin in Passeier,84,,3,2,5
083 St.Martin in Passeier,85,,3,2,5
083 St.Martin in Passeier,86,,1,-,1
083 St.Martin in Passeier,87,,2,2,4
083 St.Martin in Passeier,88,,-,1,1
083 St.Martin in Passeier,89,,2,3,5
084 St.Pankraz,0,,6,5,11
084 St.Pankraz,1,,10,6,16
084 St.Pankraz,2,,5,9,14
084 St.Pankraz,3,,6,6,12
084 St.Pankraz,4,,11,11,22
084 St.Pankraz,5,,8,4,12
084 St.Pankraz,6,,13,14,27
084 St.Pankraz,7,,14,8,22
084 St.Pankraz,8,,10,6,16
084 St.Pankraz,9,,10,7,17
084 St.Pankraz,10,,9,8,17
084 St.Pankraz,11,,9,5,14
084 St.Pankraz,12,,11,7,18
084 St.Pankraz,13,,13,9,22
084 St.Pankraz,14,,8,13,21
084 St.Pankraz,15,,12,9,21
084 St.Pankraz,16,,6,8,14
084 St.Pankraz,17,,15,10,25
084 St.Pankraz,18,,8,16,24
084 St.Pankraz,19,,6,8,14
084 St.Pankraz,20,,11,9,20
084 St.Pankraz,21,,14,15,29
084 St.Pankraz,22,,14,12,26
084 St.Pankraz,23,,12,10,22
084 St.Pankraz,24,,17,11,28
084 St.Pankraz,25,,11,10,21
084 St.Pankraz,26,,17,15,32
084 St.Pankraz,27,,23,19,42
084 St.Pankraz,28,,10,16,26
084 St.Pankraz,29,,19,9,28
084 St.Pankraz,30,,24,15,39
084 St.Pankraz,31,,15,13,28
084 St.Pankraz,32,,12,11,23
084 St.Pankraz,33,,18,10,28
084 St.Pankraz,34,,12,15,27
084 St.Pankraz,35,,12,5,17
084 St.Pankraz,36,,17,13,30
084 St.Pankraz,37,,8,9,17
084 St.Pankraz,38,,14,9,23
084 St.Pankraz,39,,9,17,26
084 St.Pankraz,40,,9,5,14
084 St.Pankraz,41,,10,9,19
084 St.Pankraz,42,,10,10,20
084 St.Pankraz,43,,16,9,25
084 St.Pankraz,44,,5,3,8
084 St.Pankraz,45,,9,6,15
084 St.Pankraz,46,,7,6,13
084 St.Pankraz,47,,7,4,11
084 St.Pankraz,48,,8,8,16
084 St.Pankraz,49,,6,9,15
084 St.Pankraz,50,,3,6,9
084 St.Pankraz,51,,5,8,13
084 St.Pankraz,52,,11,14,25
084 St.Pankraz,53,,9,14,23
084 St.Pankraz,54,,8,11,19
084 St.Pankraz,55,,8,8,16
084 St.Pankraz,56,,10,7,17
084 St.Pankraz,57,,5,11,16
084 St.Pankraz,58,,8,11,19
084 St.Pankraz,59,,7,5,12
084 St.Pankraz,60,,6,9,15
084 St.Pankraz,61,,8,6,14
084 St.Pankraz,62,,8,3,11
084 St.Pankraz,63,,8,10,18
084 St.Pankraz,64,,10,6,16
084 St.Pankraz,65,,8,7,15
084 St.Pankraz,66,,12,8,20
084 St.Pankraz,67,,9,12,21
084 St.Pankraz,68,,7,6,13
084 St.Pankraz,69,,11,7,18
084 St.Pankraz,70,,8,7,15
084 St.Pankraz,71,,8,11,19
084 St.Pankraz,72,,12,4,16
084 St.Pankraz,73,,10,10,20
084 St.Pankraz,74,,3,12,15
084 St.Pankraz,75,,3,10,13
084 St.Pankraz,76,,4,5,9
084 St.Pankraz,77,,3,5,8
084 St.Pankraz,78,,1,3,4
084 St.Pankraz,79,,3,-,3
084 St.Pankraz,80,,3,4,7
084 St.Pankraz,81,,2,6,8
084 St.Pankraz,82,,2,2,4
084 St.Pankraz,83,,4,3,7
084 St.Pankraz,84,,2,2,4
084 St.Pankraz,85,,2,4,6
084 St.Pankraz,86,,3,6,9
084 St.Pankraz,87,,-,3,3
084 St.Pankraz,88,,1,-,1
084 St.Pankraz,89,,2,2,4
084 St.Pankraz,90,,1,1,2
084 St.Pankraz,91,,1,2,3
084 St.Pankraz,92,,1,-,1
084 St.Pankraz,97,,-,2,2
085 St.Christina in Gröden,0,,14,10,24
085 St.Christina in Gröden,1,,9,13,22
085 St.Christina in Gröden,2,,13,13,26
085 St.Christina in Gröden,3,,14,14,28
085 St.Christina in Gröden,4,,12,16,28
085 St.Christina in Gröden,5,,7,16,23
085 St.Christina in Gröden,6,,5,6,11
085 St.Christina in Gröden,7,,11,8,19
085 St.Christina in Gröden,8,,11,6,17
085 St.Christina in Gröden,9,,11,8,19
085 St.Christina in Gröden,10,,6,11,17
085 St.Christina in Gröden,11,,10,5,15
085 St.Christina in Gröden,12,,18,13,31
085 St.Christina in Gröden,13,,12,5,17
085 St.Christina in Gröden,14,,9,13,22
085 St.Christina in Gröden,15,,10,12,22
085 St.Christina in Gröden,16,,12,10,22
085 St.Christina in Gröden,17,,5,8,13
085 St.Christina in Gröden,18,,3,7,10
085 St.Christina in Gröden,19,,13,12,25
085 St.Christina in Gröden,20,,11,8,19
085 St.Christina in Gröden,21,,5,18,23
085 St.Christina in Gröden,22,,6,12,18
085 St.Christina in Gröden,23,,19,8,27
085 St.Christina in Gröden,24,,8,14,22
085 St.Christina in Gröden,25,,19,15,34
085 St.Christina in Gröden,26,,16,12,28
085 St.Christina in Gröden,27,,18,20,38
085 St.Christina in Gröden,28,,16,16,32
085 St.Christina in Gröden,29,,17,15,32
085 St.Christina in Gröden,30,,14,18,32
085 St.Christina in Gröden,31,,12,22,34
085 St.Christina in Gröden,32,,13,18,31
085 St.Christina in Gröden,33,,20,18,38
085 St.Christina in Gröden,34,,18,12,30
085 St.Christina in Gröden,35,,18,19,37
085 St.Christina in Gröden,36,,11,9,20
085 St.Christina in Gröden,37,,7,14,21
085 St.Christina in Gröden,38,,16,10,26
085 St.Christina in Gröden,39,,11,10,21
085 St.Christina in Gröden,40,,9,10,19
085 St.Christina in Gröden,41,,16,14,30
085 St.Christina in Gröden,42,,9,9,18
085 St.Christina in Gröden,43,,6,5,11
085 St.Christina in Gröden,44,,11,6,17
085 St.Christina in Gröden,45,,8,6,14
085 St.Christina in Gröden,46,,6,12,18
085 St.Christina in Gröden,47,,8,6,14
085 St.Christina in Gröden,48,,6,9,15
085 St.Christina in Gröden,49,,9,13,22
085 St.Christina in Gröden,50,,6,6,12
085 St.Christina in Gröden,51,,6,11,17
085 St.Christina in Gröden,52,,13,17,30
085 St.Christina in Gröden,53,,10,6,16
085 St.Christina in Gröden,54,,13,7,20
085 St.Christina in Gröden,55,,10,11,21
085 St.Christina in Gröden,56,,11,11,22
085 St.Christina in Gröden,57,,7,8,15
085 St.Christina in Gröden,58,,9,7,16
085 St.Christina in Gröden,59,,15,10,25
085 St.Christina in Gröden,60,,14,5,19
085 St.Christina in Gröden,61,,8,12,20
085 St.Christina in Gröden,62,,6,14,20
085 St.Christina in Gröden,63,,9,10,19
085 St.Christina in Gröden,64,,6,9,15
085 St.Christina in Gröden,65,,15,5,20
085 St.Christina in Gröden,66,,5,10,15
085 St.Christina in Gröden,67,,6,5,11
085 St.Christina in Gröden,68,,5,7,12
085 St.Christina in Gröden,69,,9,7,16
085 St.Christina in Gröden,70,,8,10,18
085 St.Christina in Gröden,71,,3,5,8
085 St.Christina in Gröden,72,,6,4,10
085 St.Christina in Gröden,73,,1,10,11
085 St.Christina in Gröden,74,,4,4,8
085 St.Christina in Gröden,75,,7,6,13
085 St.Christina in Gröden,76,,4,1,5
085 St.Christina in Gröden,77,,-,1,1
085 St.Christina in Gröden,78,,1,2,3
085 St.Christina in Gröden,79,,1,3,4
085 St.Christina in Gröden,80,,6,1,7
085 St.Christina in Gröden,81,,3,4,7
085 St.Christina in Gröden,82,,4,1,5
085 St.Christina in Gröden,83,,4,2,6
085 St.Christina in Gröden,84,,-,3,3
085 St.Christina in Gröden,85,,2,3,5
085 St.Christina in Gröden,86,,2,3,5
085 St.Christina in Gröden,87,,-,2,2
085 St.Christina in Gröden,88,,1,2,3
085 St.Christina in Gröden,89,,-,1,1
085 St.Christina in Gröden,91,,1,1,2
085 St.Christina in Gröden,93,,-,1,1
086 Sarntal,0,,44,40,84
086 Sarntal,1,,34,43,77
086 Sarntal,2,,32,40,72
086 Sarntal,3,,45,38,83
086 Sarntal,4,,43,42,85
086 Sarntal,5,,46,30,76
086 Sarntal,6,,55,37,92
086 Sarntal,7,,47,41,88
086 Sarntal,8,,36,32,68
086 Sarntal,9,,40,44,84
086 Sarntal,10,,44,39,83
086 Sarntal,11,,39,41,80
086 Sarntal,12,,50,42,92
086 Sarntal,13,,63,51,114
086 Sarntal,14,,43,58,101
086 Sarntal,15,,60,50,110
086 Sarntal,16,,56,48,104
086 Sarntal,17,,55,51,106
086 Sarntal,18,,59,47,106
086 Sarntal,19,,49,40,89
086 Sarntal,20,,65,54,119
086 Sarntal,21,,51,67,118
086 Sarntal,22,,62,58,120
086 Sarntal,23,,71,48,119
086 Sarntal,24,,53,53,106
086 Sarntal,25,,68,62,130
086 Sarntal,26,,63,61,124
086 Sarntal,27,,50,47,97
086 Sarntal,28,,50,52,102
086 Sarntal,29,,54,57,111
086 Sarntal,30,,64,57,121
086 Sarntal,31,,65,61,126
086 Sarntal,32,,47,51,98
086 Sarntal,33,,64,34,98
086 Sarntal,34,,43,52,95
086 Sarntal,35,,67,46,113
086 Sarntal,36,,45,38,83
086 Sarntal,37,,55,42,97
086 Sarntal,38,,38,45,83
086 Sarntal,39,,41,31,72
086 Sarntal,40,,41,37,78
086 Sarntal,41,,37,28,65
086 Sarntal,42,,41,32,73
086 Sarntal,43,,37,41,78
086 Sarntal,44,,44,34,78
086 Sarntal,45,,39,36,75
086 Sarntal,46,,52,25,77
086 Sarntal,47,,40,38,78
086 Sarntal,48,,41,28,69
086 Sarntal,49,,38,36,74
086 Sarntal,50,,30,31,61
086 Sarntal,51,,27,30,57
086 Sarntal,52,,40,40,80
086 Sarntal,53,,43,40,83
086 Sarntal,54,,33,34,67
086 Sarntal,55,,31,46,77
086 Sarntal,56,,40,32,72
086 Sarntal,57,,35,29,64
086 Sarntal,58,,27,34,61
086 Sarntal,59,,24,26,50
086 Sarntal,60,,25,25,50
086 Sarntal,61,,28,22,50
086 Sarntal,62,,25,24,49
086 Sarntal,63,,33,27,60
086 Sarntal,64,,22,26,48
086 Sarntal,65,,23,26,49
086 Sarntal,66,,21,30,51
086 Sarntal,67,,26,30,56
086 Sarntal,68,,22,34,56
086 Sarntal,69,,27,17,44
086 Sarntal,70,,24,27,51
086 Sarntal,71,,17,30,47
086 Sarntal,72,,18,29,47
086 Sarntal,73,,21,35,56
086 Sarntal,74,,13,19,32
086 Sarntal,75,,17,20,37
086 Sarntal,76,,9,20,29
086 Sarntal,77,,6,14,20
086 Sarntal,78,,3,12,15
086 Sarntal,79,,4,10,14
086 Sarntal,80,,6,10,16
086 Sarntal,81,,12,13,25
086 Sarntal,82,,12,18,30
086 Sarntal,83,,9,17,26
086 Sarntal,84,,8,13,21
086 Sarntal,85,,5,15,20
086 Sarntal,86,,5,8,13
086 Sarntal,87,,2,6,8
086 Sarntal,88,,3,8,11
086 Sarntal,89,,6,4,10
086 Sarntal,90,,6,1,7
086 Sarntal,91,,1,3,4
086 Sarntal,92,,-,2,2
086 Sarntal,93,,1,5,6
086 Sarntal,94,,-,3,3
086 Sarntal,97,,-,1,1
087 Schenna,0,,18,18,36
087 Schenna,1,,21,18,39
087 Schenna,2,,14,7,21
087 Schenna,3,,15,17,32
087 Schenna,4,,12,20,32
087 Schenna,5,,19,15,34
087 Schenna,6,,21,10,31
087 Schenna,7,,20,20,40
087 Schenna,8,,21,16,37
087 Schenna,9,,18,12,30
087 Schenna,10,,15,16,31
087 Schenna,11,,17,14,31
087 Schenna,12,,17,14,31
087 Schenna,13,,11,17,28
087 Schenna,14,,23,9,32
087 Schenna,15,,18,17,35
087 Schenna,16,,23,21,44
087 Schenna,17,,15,21,36
087 Schenna,18,,20,19,39
087 Schenna,19,,24,20,44
087 Schenna,20,,16,25,41
087 Schenna,21,,31,29,60
087 Schenna,22,,28,24,52
087 Schenna,23,,25,19,44
087 Schenna,24,,30,26,56
087 Schenna,25,,21,21,42
087 Schenna,26,,29,19,48
087 Schenna,27,,23,20,43
087 Schenna,28,,33,21,54
087 Schenna,29,,12,22,34
087 Schenna,30,,25,31,56
087 Schenna,31,,23,24,47
087 Schenna,32,,28,20,48
087 Schenna,33,,27,14,41
087 Schenna,34,,28,23,51
087 Schenna,35,,33,24,57
087 Schenna,36,,17,13,30
087 Schenna,37,,21,19,40
087 Schenna,38,,11,20,31
087 Schenna,39,,18,16,34
087 Schenna,40,,14,17,31
087 Schenna,41,,14,18,32
087 Schenna,42,,14,16,30
087 Schenna,43,,15,16,31
087 Schenna,44,,18,12,30
087 Schenna,45,,19,15,34
087 Schenna,46,,21,20,41
087 Schenna,47,,15,15,30
087 Schenna,48,,15,18,33
087 Schenna,49,,18,23,41
087 Schenna,50,,15,13,28
087 Schenna,51,,17,10,27
087 Schenna,52,,25,10,35
087 Schenna,53,,12,20,32
087 Schenna,54,,15,13,28
087 Schenna,55,,10,9,19
087 Schenna,56,,15,15,30
087 Schenna,57,,16,20,36
087 Schenna,58,,9,10,19
087 Schenna,59,,10,11,21
087 Schenna,60,,15,9,24
087 Schenna,61,,13,15,28
087 Schenna,62,,7,10,17
087 Schenna,63,,11,15,26
087 Schenna,64,,14,13,27
087 Schenna,65,,12,10,22
087 Schenna,66,,9,12,21
087 Schenna,67,,7,11,18
087 Schenna,68,,5,15,20
087 Schenna,69,,9,7,16
087 Schenna,70,,6,13,19
087 Schenna,71,,11,9,20
087 Schenna,72,,8,5,13
087 Schenna,73,,10,6,16
087 Schenna,74,,8,16,24
087 Schenna,75,,9,5,14
087 Schenna,76,,3,7,10
087 Schenna,77,,3,4,7
087 Schenna,78,,2,6,8
087 Schenna,79,,4,1,5
087 Schenna,80,,4,7,11
087 Schenna,81,,5,6,11
087 Schenna,82,,2,3,5
087 Schenna,83,,8,5,13
087 Schenna,84,,-,2,2
087 Schenna,85,,1,5,6
087 Schenna,86,,4,4,8
087 Schenna,87,,-,3,3
087 Schenna,88,,2,2,4
087 Schenna,89,,-,2,2
087 Schenna,92,,-,1,1
087 Schenna,93,,-,3,3
087 Schenna,95,,-,1,1
088 Mühlwald,0,,15,4,19
088 Mühlwald,1,,9,5,14
088 Mühlwald,2,,13,11,24
088 Mühlwald,3,,5,6,11
088 Mühlwald,4,,10,7,17
088 Mühlwald,5,,9,7,16
088 Mühlwald,6,,16,8,24
088 Mühlwald,7,,7,3,10
088 Mühlwald,8,,9,14,23
088 Mühlwald,9,,6,7,13
088 Mühlwald,10,,11,18,29
088 Mühlwald,11,,11,19,30
088 Mühlwald,12,,12,11,23
088 Mühlwald,13,,8,17,25
088 Mühlwald,14,,16,15,31
088 Mühlwald,15,,21,7,28
088 Mühlwald,16,,8,19,27
088 Mühlwald,17,,12,13,25
088 Mühlwald,18,,8,8,16
088 Mühlwald,19,,15,14,29
088 Mühlwald,20,,11,10,21
088 Mühlwald,21,,10,8,18
088 Mühlwald,22,,17,10,27
088 Mühlwald,23,,11,13,24
088 Mühlwald,24,,22,16,38
088 Mühlwald,25,,10,11,21
088 Mühlwald,26,,16,17,33
088 Mühlwald,27,,20,12,32
088 Mühlwald,28,,18,13,31
088 Mühlwald,29,,16,9,25
088 Mühlwald,30,,19,13,32
088 Mühlwald,31,,15,9,24
088 Mühlwald,32,,12,11,23
088 Mühlwald,33,,10,13,23
088 Mühlwald,34,,6,8,14
088 Mühlwald,35,,16,9,25
088 Mühlwald,36,,14,6,20
088 Mühlwald,37,,11,7,18
088 Mühlwald,38,,14,10,24
088 Mühlwald,39,,7,8,15
088 Mühlwald,40,,8,8,16
088 Mühlwald,41,,10,4,14
088 Mühlwald,42,,13,8,21
088 Mühlwald,43,,10,7,17
088 Mühlwald,44,,11,4,15
088 Mühlwald,45,,5,10,15
088 Mühlwald,46,,9,4,13
088 Mühlwald,47,,12,5,17
088 Mühlwald,48,,10,7,17
088 Mühlwald,49,,9,3,12
088 Mühlwald,50,,6,4,10
088 Mühlwald,51,,8,4,12
088 Mühlwald,52,,13,3,16
088 Mühlwald,53,,6,7,13
088 Mühlwald,54,,4,8,12
088 Mühlwald,55,,3,8,11
088 Mühlwald,56,,7,11,18
088 Mühlwald,57,,10,4,14
088 Mühlwald,58,,12,3,15
088 Mühlwald,59,,6,4,10
088 Mühlwald,60,,6,4,10
088 Mühlwald,61,,3,11,14
088 Mühlwald,62,,4,11,15
088 Mühlwald,63,,1,3,4
088 Mühlwald,64,,8,6,14
088 Mühlwald,65,,5,7,12
088 Mühlwald,66,,12,11,23
088 Mühlwald,67,,4,4,8
088 Mühlwald,68,,10,4,14
088 Mühlwald,69,,6,6,12
088 Mühlwald,70,,5,4,9
088 Mühlwald,71,,7,6,13
088 Mühlwald,72,,1,6,7
088 Mühlwald,73,,-,6,6
088 Mühlwald,74,,-,6,6
088 Mühlwald,75,,2,3,5
088 Mühlwald,76,,3,2,5
088 Mühlwald,77,,2,4,6
088 Mühlwald,78,,5,2,7
088 Mühlwald,79,,-,2,2
088 Mühlwald,80,,-,3,3
088 Mühlwald,81,,1,3,4
088 Mühlwald,82,,1,4,5
088 Mühlwald,84,,1,2,3
088 Mühlwald,85,,-,1,1
088 Mühlwald,86,,-,1,1
088 Mühlwald,87,,1,-,1
088 Mühlwald,88,,1,-,1
088 Mühlwald,89,,-,2,2
088 Mühlwald,90,,-,1,1
088 Mühlwald,91,,-,1,1
088 Mühlwald,93,,1,-,1
089 Wolkenstein in Gröden,0,,18,13,31
089 Wolkenstein in Gröden,1,,15,18,33
089 Wolkenstein in Gröden,2,,13,13,26
089 Wolkenstein in Gröden,3,,19,14,33
089 Wolkenstein in Gröden,4,,19,15,34
089 Wolkenstein in Gröden,5,,12,12,24
089 Wolkenstein in Gröden,6,,17,14,31
089 Wolkenstein in Gröden,7,,16,16,32
089 Wolkenstein in Gröden,8,,11,19,30
089 Wolkenstein in Gröden,9,,16,13,29
089 Wolkenstein in Gröden,10,,16,10,26
089 Wolkenstein in Gröden,11,,13,11,24
089 Wolkenstein in Gröden,12,,17,9,26
089 Wolkenstein in Gröden,13,,11,17,28
089 Wolkenstein in Gröden,14,,15,12,27
089 Wolkenstein in Gröden,15,,15,17,32
089 Wolkenstein in Gröden,16,,7,15,22
089 Wolkenstein in Gröden,17,,9,11,20
089 Wolkenstein in Gröden,18,,12,12,24
089 Wolkenstein in Gröden,19,,18,19,37
089 Wolkenstein in Gröden,20,,22,22,44
089 Wolkenstein in Gröden,21,,12,16,28
089 Wolkenstein in Gröden,22,,27,26,53
089 Wolkenstein in Gröden,23,,13,17,30
089 Wolkenstein in Gröden,24,,21,24,45
089 Wolkenstein in Gröden,25,,19,28,47
089 Wolkenstein in Gröden,26,,27,19,46
089 Wolkenstein in Gröden,27,,33,25,58
089 Wolkenstein in Gröden,28,,29,25,54
089 Wolkenstein in Gröden,29,,28,23,51
089 Wolkenstein in Gröden,30,,24,29,53
089 Wolkenstein in Gröden,31,,32,22,54
089 Wolkenstein in Gröden,32,,23,18,41
089 Wolkenstein in Gröden,33,,19,23,42
089 Wolkenstein in Gröden,34,,25,28,53
089 Wolkenstein in Gröden,35,,23,24,47
089 Wolkenstein in Gröden,36,,17,16,33
089 Wolkenstein in Gröden,37,,19,18,37
089 Wolkenstein in Gröden,38,,20,18,38
089 Wolkenstein in Gröden,39,,12,13,25
089 Wolkenstein in Gröden,40,,15,11,26
089 Wolkenstein in Gröden,41,,17,10,27
089 Wolkenstein in Gröden,42,,8,15,23
089 Wolkenstein in Gröden,43,,13,7,20
089 Wolkenstein in Gröden,44,,15,11,26
089 Wolkenstein in Gröden,45,,7,18,25
089 Wolkenstein in Gröden,46,,17,13,30
089 Wolkenstein in Gröden,47,,15,14,29
089 Wolkenstein in Gröden,48,,12,18,30
089 Wolkenstein in Gröden,49,,16,19,35
089 Wolkenstein in Gröden,50,,6,13,19
089 Wolkenstein in Gröden,51,,15,11,26
089 Wolkenstein in Gröden,52,,21,15,36
089 Wolkenstein in Gröden,53,,15,14,29
089 Wolkenstein in Gröden,54,,17,19,36
089 Wolkenstein in Gröden,55,,18,18,36
089 Wolkenstein in Gröden,56,,20,17,37
089 Wolkenstein in Gröden,57,,22,8,30
089 Wolkenstein in Gröden,58,,13,18,31
089 Wolkenstein in Gröden,59,,11,15,26
089 Wolkenstein in Gröden,60,,15,10,25
089 Wolkenstein in Gröden,61,,18,10,28
089 Wolkenstein in Gröden,62,,8,12,20
089 Wolkenstein in Gröden,63,,6,10,16
089 Wolkenstein in Gröden,64,,13,10,23
089 Wolkenstein in Gröden,65,,10,12,22
089 Wolkenstein in Gröden,66,,10,8,18
089 Wolkenstein in Gröden,67,,8,13,21
089 Wolkenstein in Gröden,68,,12,8,20
089 Wolkenstein in Gröden,69,,10,6,16
089 Wolkenstein in Gröden,70,,8,7,15
089 Wolkenstein in Gröden,71,,4,12,16
089 Wolkenstein in Gröden,72,,7,6,13
089 Wolkenstein in Gröden,73,,7,11,18
089 Wolkenstein in Gröden,74,,2,6,8
089 Wolkenstein in Gröden,75,,5,5,10
089 Wolkenstein in Gröden,76,,1,3,4
089 Wolkenstein in Gröden,77,,-,3,3
089 Wolkenstein in Gröden,78,,1,6,7
089 Wolkenstein in Gröden,79,,-,3,3
089 Wolkenstein in Gröden,80,,1,6,7
089 Wolkenstein in Gröden,81,,6,5,11
089 Wolkenstein in Gröden,82,,2,2,4
089 Wolkenstein in Gröden,83,,1,6,7
089 Wolkenstein in Gröden,84,,1,6,7
089 Wolkenstein in Gröden,85,,3,4,7
089 Wolkenstein in Gröden,86,,2,2,4
089 Wolkenstein in Gröden,87,,2,4,6
089 Wolkenstein in Gröden,88,,-,4,4
089 Wolkenstein in Gröden,90,,1,2,3
089 Wolkenstein in Gröden,91,,-,2,2
089 Wolkenstein in Gröden,92,,-,1,1
089 Wolkenstein in Gröden,93,,-,1,1
089 Wolkenstein in Gröden,94,,-,1,1
089 Wolkenstein in Gröden,96,,-,1,1
091 Schnals,0,,6,9,15
091 Schnals,1,,5,9,14
091 Schnals,2,,11,4,15
091 Schnals,3,,14,12,26
091 Schnals,4,,14,8,22
091 Schnals,5,,5,7,12
091 Schnals,6,,21,9,30
091 Schnals,7,,10,5,15
091 Schnals,8,,12,10,22
091 Schnals,9,,10,10,20
091 Schnals,10,,7,11,18
091 Schnals,11,,12,16,28
091 Schnals,12,,10,10,20
091 Schnals,13,,12,8,20
091 Schnals,14,,16,10,26
091 Schnals,15,,14,12,26
091 Schnals,16,,12,10,22
091 Schnals,17,,12,9,21
091 Schnals,18,,8,10,18
091 Schnals,19,,12,4,16
091 Schnals,20,,7,11,18
091 Schnals,21,,14,8,22
091 Schnals,22,,8,12,20
091 Schnals,23,,10,11,21
091 Schnals,24,,13,13,26
091 Schnals,25,,11,10,21
091 Schnals,26,,14,13,27
091 Schnals,27,,10,13,23
091 Schnals,28,,16,12,28
091 Schnals,29,,16,17,33
091 Schnals,30,,18,9,27
091 Schnals,31,,8,10,18
091 Schnals,32,,11,15,26
091 Schnals,33,,17,8,25
091 Schnals,34,,12,14,26
091 Schnals,35,,10,8,18
091 Schnals,36,,16,12,28
091 Schnals,37,,14,12,26
091 Schnals,38,,12,6,18
091 Schnals,39,,14,7,21
091 Schnals,40,,12,6,18
091 Schnals,41,,10,9,19
091 Schnals,42,,12,8,20
091 Schnals,43,,15,8,23
091 Schnals,44,,13,8,21
091 Schnals,45,,12,6,18
091 Schnals,46,,11,10,21
091 Schnals,47,,3,2,5
091 Schnals,48,,11,8,19
091 Schnals,49,,6,7,13
091 Schnals,50,,9,4,13
091 Schnals,51,,5,7,12
091 Schnals,52,,7,10,17
091 Schnals,53,,4,5,9
091 Schnals,54,,5,5,10
091 Schnals,55,,8,7,15
091 Schnals,56,,7,7,14
091 Schnals,57,,3,11,14
091 Schnals,58,,7,5,12
091 Schnals,59,,7,7,14
091 Schnals,60,,5,5,10
091 Schnals,61,,3,4,7
091 Schnals,62,,7,5,12
091 Schnals,63,,3,10,13
091 Schnals,64,,4,5,9
091 Schnals,65,,4,5,9
091 Schnals,66,,9,6,15
091 Schnals,67,,2,7,9
091 Schnals,68,,6,7,13
091 Schnals,69,,10,4,14
091 Schnals,70,,6,10,16
091 Schnals,71,,4,7,11
091 Schnals,72,,1,1,2
091 Schnals,73,,8,4,12
091 Schnals,74,,1,6,7
091 Schnals,75,,4,8,12
091 Schnals,76,,2,1,3
091 Schnals,77,,3,3,6
091 Schnals,78,,-,4,4
091 Schnals,79,,1,3,4
091 Schnals,80,,4,3,7
091 Schnals,81,,2,2,4
091 Schnals,82,,-,2,2
091 Schnals,83,,3,4,7
091 Schnals,84,,1,2,3
091 Schnals,85,,-,2,2
091 Schnals,86,,-,2,2
091 Schnals,87,,-,2,2
091 Schnals,88,,-,1,1
091 Schnals,89,,1,-,1
091 Schnals,90,,-,2,2
091 Schnals,92,,1,1,2
091 Schnals,93,,1,-,1
092 Sexten,0,,13,16,29
092 Sexten,1,,15,11,26
092 Sexten,2,,8,3,11
092 Sexten,3,,14,9,23
092 Sexten,4,,14,11,25
092 Sexten,5,,9,21,30
092 Sexten,6,,9,9,18
092 Sexten,7,,9,6,15
092 Sexten,8,,11,10,21
092 Sexten,9,,7,10,17
092 Sexten,10,,12,11,23
092 Sexten,11,,7,11,18
092 Sexten,12,,11,9,20
092 Sexten,13,,10,19,29
092 Sexten,14,,14,13,27
092 Sexten,15,,16,8,24
092 Sexten,16,,11,18,29
092 Sexten,17,,9,15,24
092 Sexten,18,,10,7,17
092 Sexten,19,,18,12,30
092 Sexten,20,,9,11,20
092 Sexten,21,,8,7,15
092 Sexten,22,,10,11,21
092 Sexten,23,,16,15,31
092 Sexten,24,,13,20,33
092 Sexten,25,,13,21,34
092 Sexten,26,,25,14,39
092 Sexten,27,,13,17,30
092 Sexten,28,,23,17,40
092 Sexten,29,,20,20,40
092 Sexten,30,,21,20,41
092 Sexten,31,,22,17,39
092 Sexten,32,,31,19,50
092 Sexten,33,,16,15,31
092 Sexten,34,,23,14,37
092 Sexten,35,,21,8,29
092 Sexten,36,,15,16,31
092 Sexten,37,,22,17,39
092 Sexten,38,,18,13,31
092 Sexten,39,,14,15,29
092 Sexten,40,,13,14,27
092 Sexten,41,,11,11,22
092 Sexten,42,,6,11,17
092 Sexten,43,,6,11,17
092 Sexten,44,,7,8,15
092 Sexten,45,,13,7,20
092 Sexten,46,,9,6,15
092 Sexten,47,,10,6,16
092 Sexten,48,,13,4,17
092 Sexten,49,,6,9,15
092 Sexten,50,,10,4,14
092 Sexten,51,,7,12,19
092 Sexten,52,,8,6,14
092 Sexten,53,,6,7,13
092 Sexten,54,,10,15,25
092 Sexten,55,,8,13,21
092 Sexten,56,,7,10,17
092 Sexten,57,,17,12,29
092 Sexten,58,,12,9,21
092 Sexten,59,,9,11,20
092 Sexten,60,,13,15,28
092 Sexten,61,,12,7,19
092 Sexten,62,,6,12,18
092 Sexten,63,,6,7,13
092 Sexten,64,,13,13,26
092 Sexten,65,,11,12,23
092 Sexten,66,,8,13,21
092 Sexten,67,,11,13,24
092 Sexten,68,,13,18,31
092 Sexten,69,,8,4,12
092 Sexten,70,,10,14,24
092 Sexten,71,,7,11,18
092 Sexten,72,,9,11,20
092 Sexten,73,,9,14,23
092 Sexten,74,,4,10,14
092 Sexten,75,,3,5,8
092 Sexten,76,,4,4,8
092 Sexten,77,,-,2,2
092 Sexten,78,,2,2,4
092 Sexten,79,,3,2,5
092 Sexten,80,,3,-,3
092 Sexten,81,,2,2,4
092 Sexten,82,,-,6,6
092 Sexten,83,,3,5,8
092 Sexten,84,,-,2,2
092 Sexten,85,,-,1,1
092 Sexten,86,,-,1,1
092 Sexten,87,,-,4,4
092 Sexten,88,,2,1,3
092 Sexten,89,,1,2,3
092 Sexten,90,,-,2,2
092 Sexten,91,,-,1,1
092 Sexten,92,,-,1,1
092 Sexten,97,,-,1,1
092 Sexten,102,,-,1,1
093 Schlanders,0,,37,28,65
093 Schlanders,1,,40,37,77
093 Schlanders,2,,40,44,84
093 Schlanders,3,,36,39,75
093 Schlanders,4,,39,36,75
093 Schlanders,5,,46,44,90
093 Schlanders,6,,37,36,73
093 Schlanders,7,,31,43,74
093 Schlanders,8,,36,34,70
093 Schlanders,9,,36,32,68
093 Schlanders,10,,41,38,79
093 Schlanders,11,,35,37,72
093 Schlanders,12,,33,35,68
093 Schlanders,13,,52,41,93
093 Schlanders,14,,46,36,82
093 Schlanders,15,,36,35,71
093 Schlanders,16,,35,38,73
093 Schlanders,17,,52,30,82
093 Schlanders,18,,34,35,69
093 Schlanders,19,,36,28,64
093 Schlanders,20,,41,40,81
093 Schlanders,21,,50,42,92
093 Schlanders,22,,52,37,89
093 Schlanders,23,,49,39,88
093 Schlanders,24,,52,42,94
093 Schlanders,25,,39,43,82
093 Schlanders,26,,61,38,99
093 Schlanders,27,,52,37,89
093 Schlanders,28,,59,48,107
093 Schlanders,29,,53,52,105
093 Schlanders,30,,51,50,101
093 Schlanders,31,,45,45,90
093 Schlanders,32,,58,59,117
093 Schlanders,33,,53,44,97
093 Schlanders,34,,46,52,98
093 Schlanders,35,,50,46,96
093 Schlanders,36,,44,39,83
093 Schlanders,37,,56,55,111
093 Schlanders,38,,43,39,82
093 Schlanders,39,,28,35,63
093 Schlanders,40,,37,39,76
093 Schlanders,41,,33,34,67
093 Schlanders,42,,34,35,69
093 Schlanders,43,,31,28,59
093 Schlanders,44,,32,32,64
093 Schlanders,45,,27,32,59
093 Schlanders,46,,30,36,66
093 Schlanders,47,,35,28,63
093 Schlanders,48,,25,25,50
093 Schlanders,49,,31,21,52
093 Schlanders,50,,33,18,51
093 Schlanders,51,,28,36,64
093 Schlanders,52,,30,31,61
093 Schlanders,53,,36,34,70
093 Schlanders,54,,38,37,75
093 Schlanders,55,,31,31,62
093 Schlanders,56,,31,34,65
093 Schlanders,57,,22,21,43
093 Schlanders,58,,26,26,52
093 Schlanders,59,,24,24,48
093 Schlanders,60,,19,28,47
093 Schlanders,61,,26,27,53
093 Schlanders,62,,24,34,58
093 Schlanders,63,,24,22,46
093 Schlanders,64,,26,22,48
093 Schlanders,65,,29,30,59
093 Schlanders,66,,14,20,34
093 Schlanders,67,,20,26,46
093 Schlanders,68,,20,28,48
093 Schlanders,69,,19,28,47
093 Schlanders,70,,14,23,37
093 Schlanders,71,,19,24,43
093 Schlanders,72,,13,19,32
093 Schlanders,73,,14,21,35
093 Schlanders,74,,10,11,21
093 Schlanders,75,,6,23,29
093 Schlanders,76,,9,17,26
093 Schlanders,77,,10,19,29
093 Schlanders,78,,12,3,15
093 Schlanders,79,,8,13,21
093 Schlanders,80,,6,6,12
093 Schlanders,81,,9,20,29
093 Schlanders,82,,8,12,20
093 Schlanders,83,,7,17,24
093 Schlanders,84,,6,18,24
093 Schlanders,85,,4,15,19
093 Schlanders,86,,4,8,12
093 Schlanders,87,,3,8,11
093 Schlanders,88,,3,2,5
093 Schlanders,89,,3,8,11
093 Schlanders,90,,1,2,3
093 Schlanders,91,,3,3,6
093 Schlanders,92,,-,6,6
093 Schlanders,93,,-,2,2
093 Schlanders,94,,-,1,1
093 Schlanders,95,,-,1,1
093 Schlanders,96,,1,-,1
093 Schlanders,97,,-,1,1
093 Schlanders,101,,-,1,1
094 Schluderns,0,,8,14,22
094 Schluderns,1,,18,17,35
094 Schluderns,2,,19,7,26
094 Schluderns,3,,8,8,16
094 Schluderns,4,,8,10,18
094 Schluderns,5,,20,8,28
094 Schluderns,6,,15,11,26
094 Schluderns,7,,11,13,24
094 Schluderns,8,,6,11,17
094 Schluderns,9,,14,21,35
094 Schluderns,10,,18,11,29
094 Schluderns,11,,16,14,30
094 Schluderns,12,,13,8,21
094 Schluderns,13,,10,11,21
094 Schluderns,14,,20,13,33
094 Schluderns,15,,8,10,18
094 Schluderns,16,,7,19,26
094 Schluderns,17,,12,13,25
094 Schluderns,18,,12,15,27
094 Schluderns,19,,9,14,23
094 Schluderns,20,,13,6,19
094 Schluderns,21,,19,11,30
094 Schluderns,22,,23,16,39
094 Schluderns,23,,15,13,28
094 Schluderns,24,,14,20,34
094 Schluderns,25,,10,18,28
094 Schluderns,26,,20,10,30
094 Schluderns,27,,18,13,31
094 Schluderns,28,,19,12,31
094 Schluderns,29,,20,21,41
094 Schluderns,30,,25,10,35
094 Schluderns,31,,24,11,35
094 Schluderns,32,,15,22,37
094 Schluderns,33,,14,20,34
094 Schluderns,34,,19,19,38
094 Schluderns,35,,13,7,20
094 Schluderns,36,,12,23,35
094 Schluderns,37,,10,11,21
094 Schluderns,38,,15,6,21
094 Schluderns,39,,13,19,32
094 Schluderns,40,,20,9,29
094 Schluderns,41,,12,6,18
094 Schluderns,42,,10,6,16
094 Schluderns,43,,9,6,15
094 Schluderns,44,,11,3,14
094 Schluderns,45,,6,14,20
094 Schluderns,46,,12,9,21
094 Schluderns,47,,12,8,20
094 Schluderns,48,,6,4,10
094 Schluderns,49,,8,9,17
094 Schluderns,50,,6,4,10
094 Schluderns,51,,4,12,16
094 Schluderns,52,,3,8,11
094 Schluderns,53,,8,8,16
094 Schluderns,54,,12,14,26
094 Schluderns,55,,8,7,15
094 Schluderns,56,,12,8,20
094 Schluderns,57,,12,10,22
094 Schluderns,58,,8,8,16
094 Schluderns,59,,4,7,11
094 Schluderns,60,,6,10,16
094 Schluderns,61,,12,12,24
094 Schluderns,62,,5,10,15
094 Schluderns,63,,11,9,20
094 Schluderns,64,,4,7,11
094 Schluderns,65,,8,10,18
094 Schluderns,66,,11,7,18
094 Schluderns,67,,7,10,17
094 Schluderns,68,,9,1,10
094 Schluderns,69,,6,16,22
094 Schluderns,70,,3,6,9
094 Schluderns,71,,5,6,11
094 Schluderns,72,,2,5,7
094 Schluderns,73,,8,6,14
094 Schluderns,74,,4,9,13
094 Schluderns,75,,1,4,5
094 Schluderns,76,,3,7,10
094 Schluderns,77,,4,2,6
094 Schluderns,78,,3,3,6
094 Schluderns,79,,5,5,10
094 Schluderns,80,,1,3,4
094 Schluderns,81,,2,6,8
094 Schluderns,82,,2,2,4
094 Schluderns,83,,2,7,9
094 Schluderns,84,,2,4,6
094 Schluderns,85,,1,1,2
094 Schluderns,86,,2,3,5
094 Schluderns,87,,1,2,3
094 Schluderns,88,,-,3,3
094 Schluderns,89,,2,1,3
094 Schluderns,90,,-,3,3
094 Schluderns,93,,-,1,1
094 Schluderns,94,,-,1,1
094 Schluderns,95,,-,1,1
095 Stilfs,0,,7,7,14
095 Stilfs,1,,10,7,17
095 Stilfs,2,,5,16,21
095 Stilfs,3,,4,10,14
095 Stilfs,4,,13,5,18
095 Stilfs,5,,16,7,23
095 Stilfs,6,,9,6,15
095 Stilfs,7,,6,4,10
095 Stilfs,8,,6,6,12
095 Stilfs,9,,9,8,17
095 Stilfs,10,,13,5,18
095 Stilfs,11,,15,5,20
095 Stilfs,12,,8,7,15
095 Stilfs,13,,12,5,17
095 Stilfs,14,,10,3,13
095 Stilfs,15,,8,4,12
095 Stilfs,16,,6,9,15
095 Stilfs,17,,10,7,17
095 Stilfs,18,,10,13,23
095 Stilfs,19,,14,4,18
095 Stilfs,20,,10,10,20
095 Stilfs,21,,12,9,21
095 Stilfs,22,,6,20,26
095 Stilfs,23,,15,8,23
095 Stilfs,24,,13,16,29
095 Stilfs,25,,14,15,29
095 Stilfs,26,,10,15,25
095 Stilfs,27,,12,11,23
095 Stilfs,28,,12,9,21
095 Stilfs,29,,19,10,29
095 Stilfs,30,,10,11,21
095 Stilfs,31,,13,5,18
095 Stilfs,32,,9,5,14
095 Stilfs,33,,10,14,24
095 Stilfs,34,,11,3,14
095 Stilfs,35,,10,8,18
095 Stilfs,36,,10,8,18
095 Stilfs,37,,4,12,16
095 Stilfs,38,,11,6,17
095 Stilfs,39,,4,11,15
095 Stilfs,40,,6,4,10
095 Stilfs,41,,13,9,22
095 Stilfs,42,,12,5,17
095 Stilfs,43,,11,5,16
095 Stilfs,44,,14,10,24
095 Stilfs,45,,4,10,14
095 Stilfs,46,,7,3,10
095 Stilfs,47,,10,10,20
095 Stilfs,48,,5,5,10
095 Stilfs,49,,10,10,20
095 Stilfs,50,,2,4,6
095 Stilfs,51,,14,7,21
095 Stilfs,52,,9,8,17
095 Stilfs,53,,7,13,20
095 Stilfs,54,,9,4,13
095 Stilfs,55,,8,12,20
095 Stilfs,56,,7,12,19
095 Stilfs,57,,6,6,12
095 Stilfs,58,,8,7,15
095 Stilfs,59,,3,11,14
095 Stilfs,60,,5,9,14
095 Stilfs,61,,5,4,9
095 Stilfs,62,,6,6,12
095 Stilfs,63,,8,7,15
095 Stilfs,64,,5,4,9
095 Stilfs,65,,7,9,16
095 Stilfs,66,,7,1,8
095 Stilfs,67,,4,11,15
095 Stilfs,68,,6,10,16
095 Stilfs,69,,7,5,12
095 Stilfs,70,,8,3,11
095 Stilfs,71,,2,12,14
095 Stilfs,72,,5,5,10
095 Stilfs,73,,4,7,11
095 Stilfs,74,,2,7,9
095 Stilfs,75,,4,10,14
095 Stilfs,76,,5,1,6
095 Stilfs,77,,3,3,6
095 Stilfs,78,,-,3,3
095 Stilfs,79,,2,4,6
095 Stilfs,80,,1,3,4
095 Stilfs,81,,3,6,9
095 Stilfs,82,,1,1,2
095 Stilfs,83,,2,7,9
095 Stilfs,84,,1,5,6
095 Stilfs,85,,2,4,6
095 Stilfs,86,,2,5,7
095 Stilfs,87,,1,2,3
095 Stilfs,88,,1,2,3
095 Stilfs,89,,-,2,2
095 Stilfs,91,,1,-,1
095 Stilfs,93,,1,-,1
095 Stilfs,96,,2,-,2
096 Terenten,0,,8,8,16
096 Terenten,1,,15,17,32
096 Terenten,2,,8,14,22
096 Terenten,3,,10,9,19
096 Terenten,4,,8,17,25
096 Terenten,5,,13,19,32
096 Terenten,6,,15,7,22
096 Terenten,7,,10,8,18
096 Terenten,8,,17,6,23
096 Terenten,9,,10,10,20
096 Terenten,10,,11,14,25
096 Terenten,11,,13,12,25
096 Terenten,12,,13,16,29
096 Terenten,13,,12,9,21
096 Terenten,14,,13,6,19
096 Terenten,15,,11,13,24
096 Terenten,16,,10,9,19
096 Terenten,17,,16,15,31
096 Terenten,18,,11,10,21
096 Terenten,19,,16,9,25
096 Terenten,20,,17,9,26
096 Terenten,21,,16,15,31
096 Terenten,22,,4,17,21
096 Terenten,23,,16,11,27
096 Terenten,24,,16,10,26
096 Terenten,25,,21,16,37
096 Terenten,26,,15,12,27
096 Terenten,27,,11,17,28
096 Terenten,28,,14,17,31
096 Terenten,29,,13,16,29
096 Terenten,30,,17,12,29
096 Terenten,31,,17,16,33
096 Terenten,32,,24,16,40
096 Terenten,33,,19,12,31
096 Terenten,34,,11,15,26
096 Terenten,35,,11,11,22
096 Terenten,36,,13,11,24
096 Terenten,37,,13,8,21
096 Terenten,38,,13,8,21
096 Terenten,39,,11,12,23
096 Terenten,40,,13,10,23
096 Terenten,41,,16,11,27
096 Terenten,42,,8,6,14
096 Terenten,43,,7,7,14
096 Terenten,44,,5,6,11
096 Terenten,45,,10,7,17
096 Terenten,46,,10,4,14
096 Terenten,47,,10,8,18
096 Terenten,48,,7,3,10
096 Terenten,49,,7,4,11
096 Terenten,50,,7,3,10
096 Terenten,51,,3,6,9
096 Terenten,52,,8,4,12
096 Terenten,53,,4,5,9
096 Terenten,54,,7,4,11
096 Terenten,55,,7,5,12
096 Terenten,56,,2,6,8
096 Terenten,57,,7,10,17
096 Terenten,58,,7,5,12
096 Terenten,59,,5,9,14
096 Terenten,60,,8,5,13
096 Terenten,61,,1,5,6
096 Terenten,62,,6,4,10
096 Terenten,63,,4,4,8
096 Terenten,64,,7,11,18
096 Terenten,65,,7,7,14
096 Terenten,66,,7,4,11
096 Terenten,67,,8,7,15
096 Terenten,68,,2,4,6
096 Terenten,69,,3,10,13
096 Terenten,70,,7,4,11
096 Terenten,71,,1,7,8
096 Terenten,72,,5,4,9
096 Terenten,73,,4,1,5
096 Terenten,74,,3,5,8
096 Terenten,75,,5,5,10
096 Terenten,76,,1,3,4
096 Terenten,77,,2,3,5
096 Terenten,78,,2,1,3
096 Terenten,79,,1,2,3
096 Terenten,80,,1,1,2
096 Terenten,81,,3,4,7
096 Terenten,82,,1,2,3
096 Terenten,83,,-,1,1
096 Terenten,84,,1,-,1
096 Terenten,85,,1,2,3
096 Terenten,86,,-,1,1
096 Terenten,87,,-,2,2
096 Terenten,88,,-,1,1
096 Terenten,89,,1,-,1
096 Terenten,90,,1,-,1
096 Terenten,95,,1,-,1
097 Terlan,0,,30,22,52
097 Terlan,1,,18,18,36
097 Terlan,2,,22,20,42
097 Terlan,3,,27,29,56
097 Terlan,4,,24,19,43
097 Terlan,5,,11,22,33
097 Terlan,6,,23,25,48
097 Terlan,7,,21,15,36
097 Terlan,8,,23,13,36
097 Terlan,9,,16,22,38
097 Terlan,10,,27,18,45
097 Terlan,11,,12,10,22
097 Terlan,12,,24,16,40
097 Terlan,13,,21,17,38
097 Terlan,14,,15,14,29
097 Terlan,15,,24,23,47
097 Terlan,16,,16,26,42
097 Terlan,17,,14,15,29
097 Terlan,18,,26,19,45
097 Terlan,19,,26,21,47
097 Terlan,20,,23,14,37
097 Terlan,21,,28,25,53
097 Terlan,22,,18,23,41
097 Terlan,23,,38,20,58
097 Terlan,24,,20,21,41
097 Terlan,25,,27,37,64
097 Terlan,26,,31,30,61
097 Terlan,27,,33,28,61
097 Terlan,28,,26,29,55
097 Terlan,29,,31,22,53
097 Terlan,30,,30,28,58
097 Terlan,31,,28,30,58
097 Terlan,32,,26,32,58
097 Terlan,33,,31,34,65
097 Terlan,34,,39,20,59
097 Terlan,35,,25,31,56
097 Terlan,36,,19,21,40
097 Terlan,37,,32,27,59
097 Terlan,38,,16,25,41
097 Terlan,39,,26,29,55
097 Terlan,40,,25,24,49
097 Terlan,41,,23,18,41
097 Terlan,42,,18,22,40
097 Terlan,43,,21,21,42
097 Terlan,44,,18,19,37
097 Terlan,45,,21,22,43
097 Terlan,46,,22,15,37
097 Terlan,47,,21,24,45
097 Terlan,48,,16,19,35
097 Terlan,49,,15,26,41
097 Terlan,50,,22,20,42
097 Terlan,51,,24,26,50
097 Terlan,52,,19,29,48
097 Terlan,53,,36,19,55
097 Terlan,54,,18,27,45
097 Terlan,55,,22,15,37
097 Terlan,56,,18,20,38
097 Terlan,57,,22,19,41
097 Terlan,58,,17,17,34
097 Terlan,59,,10,15,25
097 Terlan,60,,16,23,39
097 Terlan,61,,7,24,31
097 Terlan,62,,17,16,33
097 Terlan,63,,17,11,28
097 Terlan,64,,22,15,37
097 Terlan,65,,15,16,31
097 Terlan,66,,14,15,29
097 Terlan,67,,16,13,29
097 Terlan,68,,15,13,28
097 Terlan,69,,13,25,38
097 Terlan,70,,12,15,27
097 Terlan,71,,10,16,26
097 Terlan,72,,9,24,33
097 Terlan,73,,12,14,26
097 Terlan,74,,11,16,27
097 Terlan,75,,2,12,14
097 Terlan,76,,1,12,13
097 Terlan,77,,6,3,9
097 Terlan,78,,1,4,5
097 Terlan,79,,-,7,7
097 Terlan,80,,5,7,12
097 Terlan,81,,2,12,14
097 Terlan,82,,6,11,17
097 Terlan,83,,3,8,11
097 Terlan,84,,3,13,16
097 Terlan,85,,3,6,9
097 Terlan,86,,6,3,9
097 Terlan,87,,1,2,3
097 Terlan,88,,-,6,6
097 Terlan,89,,2,2,4
097 Terlan,90,,1,1,2
097 Terlan,91,,2,3,5
097 Terlan,92,,1,1,2
098 Tramin a.d. Weinstr.,0,,18,17,35
098 Tramin a.d. Weinstr.,1,,21,26,47
098 Tramin a.d. Weinstr.,2,,16,16,32
098 Tramin a.d. Weinstr.,3,,20,23,43
098 Tramin a.d. Weinstr.,4,,17,12,29
098 Tramin a.d. Weinstr.,5,,26,20,46
098 Tramin a.d. Weinstr.,6,,12,31,43
098 Tramin a.d. Weinstr.,7,,13,26,39
098 Tramin a.d. Weinstr.,8,,18,24,42
098 Tramin a.d. Weinstr.,9,,11,16,27
098 Tramin a.d. Weinstr.,10,,19,22,41
098 Tramin a.d. Weinstr.,11,,20,16,36
098 Tramin a.d. Weinstr.,12,,15,14,29
098 Tramin a.d. Weinstr.,13,,25,17,42
098 Tramin a.d. Weinstr.,14,,28,19,47
098 Tramin a.d. Weinstr.,15,,19,13,32
098 Tramin a.d. Weinstr.,16,,14,16,30
098 Tramin a.d. Weinstr.,17,,12,19,31
098 Tramin a.d. Weinstr.,18,,17,21,38
098 Tramin a.d. Weinstr.,19,,20,19,39
098 Tramin a.d. Weinstr.,20,,21,17,38
098 Tramin a.d. Weinstr.,21,,21,14,35
098 Tramin a.d. Weinstr.,22,,21,15,36
098 Tramin a.d. Weinstr.,23,,16,25,41
098 Tramin a.d. Weinstr.,24,,27,35,62
098 Tramin a.d. Weinstr.,25,,24,21,45
098 Tramin a.d. Weinstr.,26,,34,24,58
098 Tramin a.d. Weinstr.,27,,25,25,50
098 Tramin a.d. Weinstr.,28,,24,26,50
098 Tramin a.d. Weinstr.,29,,31,31,62
098 Tramin a.d. Weinstr.,30,,31,29,60
098 Tramin a.d. Weinstr.,31,,24,24,48
098 Tramin a.d. Weinstr.,32,,24,27,51
098 Tramin a.d. Weinstr.,33,,21,14,35
098 Tramin a.d. Weinstr.,34,,34,25,59
098 Tramin a.d. Weinstr.,35,,32,31,63
098 Tramin a.d. Weinstr.,36,,18,31,49
098 Tramin a.d. Weinstr.,37,,26,22,48
098 Tramin a.d. Weinstr.,38,,18,18,36
098 Tramin a.d. Weinstr.,39,,23,19,42
098 Tramin a.d. Weinstr.,40,,17,19,36
098 Tramin a.d. Weinstr.,41,,17,18,35
098 Tramin a.d. Weinstr.,42,,17,16,33
098 Tramin a.d. Weinstr.,43,,20,19,39
098 Tramin a.d. Weinstr.,44,,10,13,23
098 Tramin a.d. Weinstr.,45,,16,16,32
098 Tramin a.d. Weinstr.,46,,16,15,31
098 Tramin a.d. Weinstr.,47,,18,18,36
098 Tramin a.d. Weinstr.,48,,14,22,36
098 Tramin a.d. Weinstr.,49,,27,18,45
098 Tramin a.d. Weinstr.,50,,10,10,20
098 Tramin a.d. Weinstr.,51,,25,24,49
098 Tramin a.d. Weinstr.,52,,18,21,39
098 Tramin a.d. Weinstr.,53,,21,18,39
098 Tramin a.d. Weinstr.,54,,14,23,37
098 Tramin a.d. Weinstr.,55,,22,17,39
098 Tramin a.d. Weinstr.,56,,13,15,28
098 Tramin a.d. Weinstr.,57,,10,21,31
098 Tramin a.d. Weinstr.,58,,16,13,29
098 Tramin a.d. Weinstr.,59,,15,15,30
098 Tramin a.d. Weinstr.,60,,16,15,31
098 Tramin a.d. Weinstr.,61,,13,13,26
098 Tramin a.d. Weinstr.,62,,12,16,28
098 Tramin a.d. Weinstr.,63,,13,20,33
098 Tramin a.d. Weinstr.,64,,10,21,31
098 Tramin a.d. Weinstr.,65,,25,17,42
098 Tramin a.d. Weinstr.,66,,14,15,29
098 Tramin a.d. Weinstr.,67,,19,18,37
098 Tramin a.d. Weinstr.,68,,19,16,35
098 Tramin a.d. Weinstr.,69,,20,20,40
098 Tramin a.d. Weinstr.,70,,13,23,36
098 Tramin a.d. Weinstr.,71,,8,16,24
098 Tramin a.d. Weinstr.,72,,12,19,31
098 Tramin a.d. Weinstr.,73,,10,17,27
098 Tramin a.d. Weinstr.,74,,16,13,29
098 Tramin a.d. Weinstr.,75,,9,18,27
098 Tramin a.d. Weinstr.,76,,6,14,20
098 Tramin a.d. Weinstr.,77,,4,3,7
098 Tramin a.d. Weinstr.,78,,1,8,9
098 Tramin a.d. Weinstr.,79,,4,3,7
098 Tramin a.d. Weinstr.,80,,2,6,8
098 Tramin a.d. Weinstr.,81,,8,10,18
098 Tramin a.d. Weinstr.,82,,5,5,10
098 Tramin a.d. Weinstr.,83,,4,5,9
098 Tramin a.d. Weinstr.,84,,-,11,11
098 Tramin a.d. Weinstr.,85,,3,9,12
098 Tramin a.d. Weinstr.,86,,-,7,7
098 Tramin a.d. Weinstr.,87,,2,8,10
098 Tramin a.d. Weinstr.,88,,-,10,10
098 Tramin a.d. Weinstr.,89,,-,2,2
098 Tramin a.d. Weinstr.,90,,-,2,2
098 Tramin a.d. Weinstr.,91,,-,7,7
098 Tramin a.d. Weinstr.,94,,-,1,1
098 Tramin a.d. Weinstr.,95,,-,2,2
099 Tisens,0,,11,6,17
099 Tisens,1,,10,12,22
099 Tisens,2,,6,8,14
099 Tisens,3,,6,15,21
099 Tisens,4,,17,7,24
099 Tisens,5,,10,13,23
099 Tisens,6,,12,10,22
099 Tisens,7,,9,11,20
099 Tisens,8,,12,8,20
099 Tisens,9,,14,8,22
099 Tisens,10,,8,7,15
099 Tisens,11,,13,13,26
099 Tisens,12,,18,5,23
099 Tisens,13,,10,15,25
099 Tisens,14,,4,18,22
099 Tisens,15,,15,12,27
099 Tisens,16,,9,7,16
099 Tisens,17,,13,11,24
099 Tisens,18,,12,7,19
099 Tisens,19,,9,4,13
099 Tisens,20,,16,12,28
099 Tisens,21,,10,10,20
099 Tisens,22,,10,8,18
099 Tisens,23,,8,11,19
099 Tisens,24,,16,11,27
099 Tisens,25,,17,15,32
099 Tisens,26,,15,16,31
099 Tisens,27,,19,17,36
099 Tisens,28,,15,21,36
099 Tisens,29,,22,14,36
099 Tisens,30,,15,23,38
099 Tisens,31,,17,5,22
099 Tisens,32,,19,16,35
099 Tisens,33,,22,4,26
099 Tisens,34,,16,12,28
099 Tisens,35,,17,7,24
099 Tisens,36,,12,8,20
099 Tisens,37,,7,11,18
099 Tisens,38,,18,20,38
099 Tisens,39,,9,13,22
099 Tisens,40,,16,9,25
099 Tisens,41,,8,8,16
099 Tisens,42,,12,9,21
099 Tisens,43,,7,12,19
099 Tisens,44,,9,10,19
099 Tisens,45,,10,5,15
099 Tisens,46,,5,7,12
099 Tisens,47,,13,8,21
099 Tisens,48,,7,8,15
099 Tisens,49,,8,7,15
099 Tisens,50,,4,7,11
099 Tisens,51,,10,10,20
099 Tisens,52,,11,10,21
099 Tisens,53,,10,8,18
099 Tisens,54,,9,14,23
099 Tisens,55,,6,8,14
099 Tisens,56,,13,10,23
099 Tisens,57,,7,12,19
099 Tisens,58,,5,5,10
099 Tisens,59,,7,8,15
099 Tisens,60,,6,11,17
099 Tisens,61,,9,7,16
099 Tisens,62,,2,12,14
099 Tisens,63,,9,10,19
099 Tisens,64,,9,10,19
099 Tisens,65,,6,15,21
099 Tisens,66,,10,12,22
099 Tisens,67,,14,14,28
099 Tisens,68,,16,10,26
099 Tisens,69,,6,9,15
099 Tisens,70,,5,6,11
099 Tisens,71,,3,7,10
099 Tisens,72,,4,11,15
099 Tisens,73,,7,7,14
099 Tisens,74,,8,8,16
099 Tisens,75,,5,8,13
099 Tisens,76,,3,9,12
099 Tisens,77,,4,6,10
099 Tisens,78,,4,5,9
099 Tisens,79,,1,5,6
099 Tisens,80,,2,5,7
099 Tisens,81,,3,9,12
099 Tisens,82,,5,4,9
099 Tisens,83,,3,5,8
099 Tisens,84,,3,5,8
099 Tisens,85,,1,5,6
099 Tisens,86,,3,-,3
099 Tisens,87,,-,5,5
099 Tisens,88,,1,2,3
099 Tisens,89,,1,-,1
099 Tisens,90,,-,3,3
099 Tisens,91,,1,1,2
099 Tisens,92,,-,1,1
099 Tisens,93,,1,1,2
099 Tisens,94,,-,1,1
099 Tisens,95,,1,1,2
099 Tisens,100,,1,-,1
100 Tiers,0,,7,10,17
100 Tiers,1,,7,6,13
100 Tiers,2,,6,-,6
100 Tiers,3,,6,4,10
100 Tiers,4,,4,4,8
100 Tiers,5,,6,5,11
100 Tiers,6,,5,6,11
100 Tiers,7,,7,8,15
100 Tiers,8,,5,4,9
100 Tiers,9,,9,4,13
100 Tiers,10,,5,6,11
100 Tiers,11,,3,8,11
100 Tiers,12,,7,6,13
100 Tiers,13,,6,6,12
100 Tiers,14,,5,4,9
100 Tiers,15,,2,4,6
100 Tiers,16,,1,9,10
100 Tiers,17,,8,7,15
100 Tiers,18,,5,3,8
100 Tiers,19,,-,3,3
100 Tiers,20,,7,2,9
100 Tiers,21,,4,4,8
100 Tiers,22,,8,7,15
100 Tiers,23,,9,9,18
100 Tiers,24,,5,7,12
100 Tiers,25,,8,10,18
100 Tiers,26,,12,8,20
100 Tiers,27,,4,3,7
100 Tiers,28,,10,13,23
100 Tiers,29,,11,7,18
100 Tiers,30,,4,8,12
100 Tiers,31,,7,3,10
100 Tiers,32,,7,12,19
100 Tiers,33,,4,9,13
100 Tiers,34,,7,4,11
100 Tiers,35,,3,6,9
100 Tiers,36,,9,4,13
100 Tiers,37,,8,4,12
100 Tiers,38,,4,7,11
100 Tiers,39,,11,6,17
100 Tiers,40,,5,4,9
100 Tiers,41,,8,6,14
100 Tiers,42,,6,4,10
100 Tiers,43,,3,4,7
100 Tiers,44,,2,3,5
100 Tiers,45,,7,5,12
100 Tiers,46,,3,4,7
100 Tiers,47,,5,5,10
100 Tiers,48,,2,2,4
100 Tiers,49,,5,4,9
100 Tiers,50,,11,3,14
100 Tiers,51,,-,4,4
100 Tiers,52,,8,10,18
100 Tiers,53,,2,5,7
100 Tiers,54,,5,8,13
100 Tiers,55,,2,4,6
100 Tiers,56,,5,7,12
100 Tiers,57,,6,5,11
100 Tiers,58,,8,6,14
100 Tiers,59,,6,7,13
100 Tiers,60,,6,2,8
100 Tiers,61,,2,5,7
100 Tiers,62,,7,3,10
100 Tiers,63,,4,5,9
100 Tiers,64,,8,3,11
100 Tiers,65,,5,1,6
100 Tiers,66,,3,3,6
100 Tiers,67,,4,3,7
100 Tiers,68,,4,4,8
100 Tiers,69,,4,2,6
100 Tiers,70,,5,6,11
100 Tiers,71,,3,7,10
100 Tiers,72,,3,3,6
100 Tiers,73,,3,3,6
100 Tiers,74,,2,10,12
100 Tiers,75,,2,4,6
100 Tiers,76,,3,2,5
100 Tiers,77,,1,2,3
100 Tiers,78,,3,2,5
100 Tiers,80,,1,2,3
100 Tiers,81,,2,1,3
100 Tiers,82,,2,3,5
100 Tiers,83,,2,3,5
100 Tiers,84,,1,3,4
100 Tiers,85,,5,4,9
100 Tiers,86,,2,1,3
100 Tiers,87,,1,1,2
100 Tiers,88,,-,1,1
100 Tiers,89,,2,1,3
100 Tiers,91,,1,-,1
100 Tiers,92,,1,-,1
100 Tiers,93,,-,1,1
101 Tirol,0,,9,17,26
101 Tirol,1,,13,17,30
101 Tirol,2,,22,8,30
101 Tirol,3,,10,12,22
101 Tirol,4,,8,9,17
101 Tirol,5,,13,11,24
101 Tirol,6,,11,19,30
101 Tirol,7,,11,18,29
101 Tirol,8,,17,10,27
101 Tirol,9,,10,12,22
101 Tirol,10,,11,18,29
101 Tirol,11,,16,12,28
101 Tirol,12,,18,17,35
101 Tirol,13,,13,13,26
101 Tirol,14,,18,24,42
101 Tirol,15,,19,9,28
101 Tirol,16,,20,7,27
101 Tirol,17,,11,13,24
101 Tirol,18,,15,17,32
101 Tirol,19,,14,11,25
101 Tirol,20,,17,24,41
101 Tirol,21,,17,17,34
101 Tirol,22,,21,18,39
101 Tirol,23,,21,19,40
101 Tirol,24,,24,11,35
101 Tirol,25,,17,15,32
101 Tirol,26,,20,26,46
101 Tirol,27,,26,21,47
101 Tirol,28,,25,26,51
101 Tirol,29,,20,19,39
101 Tirol,30,,23,20,43
101 Tirol,31,,27,21,48
101 Tirol,32,,23,13,36
101 Tirol,33,,23,19,42
101 Tirol,34,,16,26,42
101 Tirol,35,,25,15,40
101 Tirol,36,,17,11,28
101 Tirol,37,,16,18,34
101 Tirol,38,,22,16,38
101 Tirol,39,,10,16,26
101 Tirol,40,,13,14,27
101 Tirol,41,,15,16,31
101 Tirol,42,,19,19,38
101 Tirol,43,,15,10,25
101 Tirol,44,,14,18,32
101 Tirol,45,,16,13,29
101 Tirol,46,,21,17,38
101 Tirol,47,,20,15,35
101 Tirol,48,,9,16,25
101 Tirol,49,,13,9,22
101 Tirol,50,,13,14,27
101 Tirol,51,,19,18,37
101 Tirol,52,,13,12,25
101 Tirol,53,,12,23,35
101 Tirol,54,,15,19,34
101 Tirol,55,,11,14,25
101 Tirol,56,,16,14,30
101 Tirol,57,,9,9,18
101 Tirol,58,,11,16,27
101 Tirol,59,,9,12,21
101 Tirol,60,,13,12,25
101 Tirol,61,,15,6,21
101 Tirol,62,,8,13,21
101 Tirol,63,,8,10,18
101 Tirol,64,,9,8,17
101 Tirol,65,,6,9,15
101 Tirol,66,,13,15,28
101 Tirol,67,,10,9,19
101 Tirol,68,,11,8,19
101 Tirol,69,,6,15,21
101 Tirol,70,,9,10,19
101 Tirol,71,,9,14,23
101 Tirol,72,,5,6,11
101 Tirol,73,,5,7,12
101 Tirol,74,,8,11,19
101 Tirol,75,,6,9,15
101 Tirol,76,,3,6,9
101 Tirol,77,,3,6,9
101 Tirol,78,,2,1,3
101 Tirol,79,,2,6,8
101 Tirol,80,,3,7,10
101 Tirol,81,,6,8,14
101 Tirol,82,,6,7,13
101 Tirol,83,,1,5,6
101 Tirol,84,,3,7,10
101 Tirol,85,,2,4,6
101 Tirol,86,,3,8,11
101 Tirol,87,,1,3,4
101 Tirol,88,,1,2,3
101 Tirol,89,,3,2,5
101 Tirol,90,,1,1,2
101 Tirol,91,,2,2,4
101 Tirol,92,,-,1,1
101 Tirol,93,,-,1,1
101 Tirol,100,,-,1,1
102 Truden im Naturpark,0,,5,6,11
102 Truden im Naturpark,1,,5,6,11
102 Truden im Naturpark,2,,9,2,11
102 Truden im Naturpark,3,,8,6,14
102 Truden im Naturpark,4,,4,6,10
102 Truden im Naturpark,5,,5,5,10
102 Truden im Naturpark,6,,10,7,17
102 Truden im Naturpark,7,,9,8,17
102 Truden im Naturpark,8,,6,4,10
102 Truden im Naturpark,9,,1,5,6
102 Truden im Naturpark,10,,8,6,14
102 Truden im Naturpark,11,,11,4,15
102 Truden im Naturpark,12,,6,5,11
102 Truden im Naturpark,13,,12,3,15
102 Truden im Naturpark,14,,4,8,12
102 Truden im Naturpark,15,,4,4,8
102 Truden im Naturpark,16,,7,5,12
102 Truden im Naturpark,17,,7,6,13
102 Truden im Naturpark,18,,4,4,8
102 Truden im Naturpark,19,,12,9,21
102 Truden im Naturpark,20,,8,5,13
102 Truden im Naturpark,21,,4,6,10
102 Truden im Naturpark,22,,7,10,17
102 Truden im Naturpark,23,,5,7,12
102 Truden im Naturpark,24,,3,7,10
102 Truden im Naturpark,25,,2,5,7
102 Truden im Naturpark,26,,7,13,20
102 Truden im Naturpark,27,,9,10,19
102 Truden im Naturpark,28,,10,8,18
102 Truden im Naturpark,29,,6,6,12
102 Truden im Naturpark,30,,6,4,10
102 Truden im Naturpark,31,,9,8,17
102 Truden im Naturpark,32,,9,6,15
102 Truden im Naturpark,33,,8,7,15
102 Truden im Naturpark,34,,7,8,15
102 Truden im Naturpark,35,,10,12,22
102 Truden im Naturpark,36,,8,10,18
102 Truden im Naturpark,37,,5,8,13
102 Truden im Naturpark,38,,6,10,16
102 Truden im Naturpark,39,,7,5,12
102 Truden im Naturpark,40,,7,12,19
102 Truden im Naturpark,41,,6,5,11
102 Truden im Naturpark,42,,8,5,13
102 Truden im Naturpark,43,,6,7,13
102 Truden im Naturpark,44,,9,6,15
102 Truden im Naturpark,45,,2,2,4
102 Truden im Naturpark,46,,5,3,8
102 Truden im Naturpark,47,,2,7,9
102 Truden im Naturpark,48,,6,1,7
102 Truden im Naturpark,49,,7,5,12
102 Truden im Naturpark,50,,4,2,6
102 Truden im Naturpark,51,,4,5,9
102 Truden im Naturpark,52,,5,4,9
102 Truden im Naturpark,53,,6,3,9
102 Truden im Naturpark,54,,5,6,11
102 Truden im Naturpark,55,,3,4,7
102 Truden im Naturpark,56,,8,3,11
102 Truden im Naturpark,57,,7,9,16
102 Truden im Naturpark,58,,3,4,7
102 Truden im Naturpark,59,,5,4,9
102 Truden im Naturpark,60,,5,3,8
102 Truden im Naturpark,61,,5,1,6
102 Truden im Naturpark,62,,7,7,14
102 Truden im Naturpark,63,,4,4,8
102 Truden im Naturpark,64,,7,4,11
102 Truden im Naturpark,65,,6,10,16
102 Truden im Naturpark,66,,-,8,8
102 Truden im Naturpark,67,,3,6,9
102 Truden im Naturpark,68,,8,6,14
102 Truden im Naturpark,69,,3,8,11
102 Truden im Naturpark,70,,2,8,10
102 Truden im Naturpark,71,,-,9,9
102 Truden im Naturpark,72,,5,8,13
102 Truden im Naturpark,73,,6,4,10
102 Truden im Naturpark,74,,4,7,11
102 Truden im Naturpark,75,,-,10,10
102 Truden im Naturpark,76,,1,3,4
102 Truden im Naturpark,77,,2,3,5
102 Truden im Naturpark,78,,1,1,2
102 Truden im Naturpark,80,,2,1,3
102 Truden im Naturpark,81,,-,5,5
102 Truden im Naturpark,82,,-,2,2
102 Truden im Naturpark,83,,1,1,2
102 Truden im Naturpark,84,,-,4,4
102 Truden im Naturpark,85,,2,3,5
102 Truden im Naturpark,86,,-,2,2
102 Truden im Naturpark,89,,2,3,5
102 Truden im Naturpark,92,,-,1,1
102 Truden im Naturpark,93,,-,1,1
102 Truden im Naturpark,97,,-,1,1
103 Taufers im Münstertal,0,,8,10,18
103 Taufers im Münstertal,1,,5,9,14
103 Taufers im Münstertal,2,,4,5,9
103 Taufers im Münstertal,3,,8,8,16
103 Taufers im Münstertal,4,,6,12,18
103 Taufers im Münstertal,5,,6,7,13
103 Taufers im Münstertal,6,,6,3,9
103 Taufers im Münstertal,7,,6,7,13
103 Taufers im Münstertal,8,,4,6,10
103 Taufers im Münstertal,9,,4,4,8
103 Taufers im Münstertal,10,,4,2,6
103 Taufers im Münstertal,11,,5,7,12
103 Taufers im Münstertal,12,,5,5,10
103 Taufers im Münstertal,13,,5,11,16
103 Taufers im Münstertal,14,,9,2,11
103 Taufers im Münstertal,15,,8,5,13
103 Taufers im Münstertal,16,,6,2,8
103 Taufers im Münstertal,17,,8,5,13
103 Taufers im Münstertal,18,,5,5,10
103 Taufers im Münstertal,19,,2,4,6
103 Taufers im Münstertal,20,,11,1,12
103 Taufers im Münstertal,21,,7,8,15
103 Taufers im Münstertal,22,,7,7,14
103 Taufers im Münstertal,23,,6,6,12
103 Taufers im Münstertal,24,,14,12,26
103 Taufers im Münstertal,25,,9,6,15
103 Taufers im Münstertal,26,,13,12,25
103 Taufers im Münstertal,27,,9,9,18
103 Taufers im Münstertal,28,,7,6,13
103 Taufers im Münstertal,29,,9,10,19
103 Taufers im Münstertal,30,,17,10,27
103 Taufers im Münstertal,31,,8,11,19
103 Taufers im Münstertal,32,,13,10,23
103 Taufers im Münstertal,33,,11,8,19
103 Taufers im Münstertal,34,,9,7,16
103 Taufers im Münstertal,35,,14,7,21
103 Taufers im Münstertal,36,,6,9,15
103 Taufers im Münstertal,37,,6,6,12
103 Taufers im Münstertal,38,,10,6,16
103 Taufers im Münstertal,39,,11,9,20
103 Taufers im Münstertal,40,,3,3,6
103 Taufers im Münstertal,41,,3,7,10
103 Taufers im Münstertal,42,,5,3,8
103 Taufers im Münstertal,43,,6,2,8
103 Taufers im Münstertal,44,,5,4,9
103 Taufers im Münstertal,45,,7,1,8
103 Taufers im Münstertal,46,,5,1,6
103 Taufers im Münstertal,47,,6,1,7
103 Taufers im Münstertal,48,,3,7,10
103 Taufers im Münstertal,49,,4,3,7
103 Taufers im Münstertal,50,,3,3,6
103 Taufers im Münstertal,51,,1,1,2
103 Taufers im Münstertal,52,,7,5,12
103 Taufers im Münstertal,53,,5,5,10
103 Taufers im Münstertal,54,,4,6,10
103 Taufers im Münstertal,55,,4,3,7
103 Taufers im Münstertal,56,,4,4,8
103 Taufers im Münstertal,57,,8,10,18
103 Taufers im Münstertal,58,,4,5,9
103 Taufers im Münstertal,59,,3,8,11
103 Taufers im Münstertal,60,,7,2,9
103 Taufers im Münstertal,61,,4,8,12
103 Taufers im Münstertal,62,,6,5,11
103 Taufers im Münstertal,63,,6,3,9
103 Taufers im Münstertal,64,,10,4,14
103 Taufers im Münstertal,65,,5,4,9
103 Taufers im Münstertal,66,,4,6,10
103 Taufers im Münstertal,67,,5,5,10
103 Taufers im Münstertal,68,,3,3,6
103 Taufers im Münstertal,69,,4,6,10
103 Taufers im Münstertal,70,,1,7,8
103 Taufers im Münstertal,71,,3,7,10
103 Taufers im Münstertal,72,,4,7,11
103 Taufers im Münstertal,73,,3,3,6
103 Taufers im Münstertal,74,,6,-,6
103 Taufers im Münstertal,75,,4,3,7
103 Taufers im Münstertal,76,,3,5,8
103 Taufers im Münstertal,77,,-,1,1
103 Taufers im Münstertal,78,,2,5,7
103 Taufers im Münstertal,79,,1,2,3
103 Taufers im Münstertal,80,,2,3,5
103 Taufers im Münstertal,81,,1,1,2
103 Taufers im Münstertal,82,,-,3,3
103 Taufers im Münstertal,83,,1,3,4
103 Taufers im Münstertal,84,,1,-,1
103 Taufers im Münstertal,85,,1,1,2
103 Taufers im Münstertal,86,,-,3,3
103 Taufers im Münstertal,87,,-,5,5
103 Taufers im Münstertal,88,,-,1,1
103 Taufers im Münstertal,90,,-,1,1
103 Taufers im Münstertal,91,,-,2,2
103 Taufers im Münstertal,94,,-,1,1
103 Taufers im Münstertal,97,,-,1,1
104 Ulten,0,,13,17,30
104 Ulten,1,,20,16,36
104 Ulten,2,,24,15,39
104 Ulten,3,,17,17,34
104 Ulten,4,,26,32,58
104 Ulten,5,,17,18,35
104 Ulten,6,,18,30,48
104 Ulten,7,,18,17,35
104 Ulten,8,,20,19,39
104 Ulten,9,,23,13,36
104 Ulten,10,,14,17,31
104 Ulten,11,,22,20,42
104 Ulten,12,,22,20,42
104 Ulten,13,,15,27,42
104 Ulten,14,,19,18,37
104 Ulten,15,,22,21,43
104 Ulten,16,,18,20,38
104 Ulten,17,,21,17,38
104 Ulten,18,,24,13,37
104 Ulten,19,,17,24,41
104 Ulten,20,,25,26,51
104 Ulten,21,,21,30,51
104 Ulten,22,,29,23,52
104 Ulten,23,,26,29,55
104 Ulten,24,,29,25,54
104 Ulten,25,,28,35,63
104 Ulten,26,,32,18,50
104 Ulten,27,,32,27,59
104 Ulten,28,,16,24,40
104 Ulten,29,,20,17,37
104 Ulten,30,,29,22,51
104 Ulten,31,,29,24,53
104 Ulten,32,,28,27,55
104 Ulten,33,,33,25,58
104 Ulten,34,,32,17,49
104 Ulten,35,,30,21,51
104 Ulten,36,,24,22,46
104 Ulten,37,,28,17,45
104 Ulten,38,,35,24,59
104 Ulten,39,,18,14,32
104 Ulten,40,,14,12,26
104 Ulten,41,,20,18,38
104 Ulten,42,,25,15,40
104 Ulten,43,,19,14,33
104 Ulten,44,,18,18,36
104 Ulten,45,,21,14,35
104 Ulten,46,,18,11,29
104 Ulten,47,,15,13,28
104 Ulten,48,,18,8,26
104 Ulten,49,,18,15,33
104 Ulten,50,,10,12,22
104 Ulten,51,,14,22,36
104 Ulten,52,,18,15,33
104 Ulten,53,,12,19,31
104 Ulten,54,,17,12,29
104 Ulten,55,,18,11,29
104 Ulten,56,,22,16,38
104 Ulten,57,,8,12,20
104 Ulten,58,,9,11,20
104 Ulten,59,,9,11,20
104 Ulten,60,,12,13,25
104 Ulten,61,,14,13,27
104 Ulten,62,,6,13,19
104 Ulten,63,,14,8,22
104 Ulten,64,,13,10,23
104 Ulten,65,,16,18,34
104 Ulten,66,,8,16,24
104 Ulten,67,,11,17,28
104 Ulten,68,,15,19,34
104 Ulten,69,,11,18,29
104 Ulten,70,,18,18,36
104 Ulten,71,,14,13,27
104 Ulten,72,,15,26,41
104 Ulten,73,,14,13,27
104 Ulten,74,,12,16,28
104 Ulten,75,,11,17,28
104 Ulten,76,,5,15,20
104 Ulten,77,,3,6,9
104 Ulten,78,,1,4,5
104 Ulten,79,,1,5,6
104 Ulten,80,,4,1,5
104 Ulten,81,,6,11,17
104 Ulten,82,,7,9,16
104 Ulten,83,,6,8,14
104 Ulten,84,,3,9,12
104 Ulten,85,,6,8,14
104 Ulten,86,,3,6,9
104 Ulten,87,,5,6,11
104 Ulten,88,,3,1,4
104 Ulten,89,,4,2,6
104 Ulten,90,,3,2,5
104 Ulten,91,,1,-,1
104 Ulten,92,,-,1,1
104 Ulten,96,,-,1,1
104 Ulten,97,,-,1,1
104 Ulten,99,,1,-,1
105 Pfatten,0,,3,1,4
105 Pfatten,1,,8,10,18
105 Pfatten,2,,2,5,7
105 Pfatten,3,,6,5,11
105 Pfatten,4,,6,6,12
105 Pfatten,5,,8,8,16
105 Pfatten,6,,5,7,12
105 Pfatten,7,,3,6,9
105 Pfatten,8,,5,4,9
105 Pfatten,9,,6,7,13
105 Pfatten,10,,5,5,10
105 Pfatten,11,,3,4,7
105 Pfatten,12,,4,4,8
105 Pfatten,13,,5,2,7
105 Pfatten,14,,7,3,10
105 Pfatten,15,,1,5,6
105 Pfatten,16,,2,3,5
105 Pfatten,17,,5,4,9
105 Pfatten,18,,1,5,6
105 Pfatten,19,,7,2,9
105 Pfatten,20,,-,2,2
105 Pfatten,21,,7,7,14
105 Pfatten,22,,6,5,11
105 Pfatten,23,,6,4,10
105 Pfatten,24,,5,3,8
105 Pfatten,25,,5,9,14
105 Pfatten,26,,4,4,8
105 Pfatten,27,,4,8,12
105 Pfatten,28,,13,4,17
105 Pfatten,29,,10,6,16
105 Pfatten,30,,12,10,22
105 Pfatten,31,,10,8,18
105 Pfatten,32,,10,10,20
105 Pfatten,33,,9,13,22
105 Pfatten,34,,8,10,18
105 Pfatten,35,,7,10,17
105 Pfatten,36,,6,14,20
105 Pfatten,37,,7,9,16
105 Pfatten,38,,16,4,20
105 Pfatten,39,,8,7,15
105 Pfatten,40,,8,4,12
105 Pfatten,41,,9,3,12
105 Pfatten,42,,8,5,13
105 Pfatten,43,,4,6,10
105 Pfatten,44,,4,4,8
105 Pfatten,45,,5,7,12
105 Pfatten,46,,4,2,6
105 Pfatten,47,,5,2,7
105 Pfatten,48,,7,8,15
105 Pfatten,49,,6,6,12
105 Pfatten,50,,4,5,9
105 Pfatten,51,,4,2,6
105 Pfatten,52,,4,2,6
105 Pfatten,53,,5,3,8
105 Pfatten,54,,4,7,11
105 Pfatten,55,,5,5,10
105 Pfatten,56,,3,-,3
105 Pfatten,57,,6,5,11
105 Pfatten,58,,6,2,8
105 Pfatten,59,,3,6,9
105 Pfatten,60,,10,2,12
105 Pfatten,61,,5,6,11
105 Pfatten,62,,2,3,5
105 Pfatten,63,,1,4,5
105 Pfatten,64,,3,4,7
105 Pfatten,65,,3,3,6
105 Pfatten,66,,-,6,6
105 Pfatten,67,,3,1,4
105 Pfatten,68,,3,2,5
105 Pfatten,69,,4,5,9
105 Pfatten,70,,4,5,9
105 Pfatten,71,,2,5,7
105 Pfatten,72,,3,2,5
105 Pfatten,73,,3,1,4
105 Pfatten,74,,1,1,2
105 Pfatten,75,,2,1,3
105 Pfatten,76,,1,-,1
105 Pfatten,77,,-,1,1
105 Pfatten,78,,1,1,2
105 Pfatten,79,,-,2,2
105 Pfatten,80,,1,3,4
105 Pfatten,81,,1,1,2
105 Pfatten,82,,3,2,5
105 Pfatten,83,,-,2,2
105 Pfatten,85,,1,-,1
105 Pfatten,86,,1,1,2
105 Pfatten,88,,-,2,2
105 Pfatten,93,,-,1,1
106 Olang,0,,19,10,29
106 Olang,1,,18,12,30
106 Olang,2,,18,24,42
106 Olang,3,,13,14,27
106 Olang,4,,24,16,40
106 Olang,5,,22,24,46
106 Olang,6,,17,19,36
106 Olang,7,,14,17,31
106 Olang,8,,23,18,41
106 Olang,9,,17,17,34
106 Olang,10,,12,22,34
106 Olang,11,,21,14,35
106 Olang,12,,18,22,40
106 Olang,13,,21,23,44
106 Olang,14,,17,23,40
106 Olang,15,,22,28,50
106 Olang,16,,21,16,37
106 Olang,17,,22,16,38
106 Olang,18,,29,23,52
106 Olang,19,,19,21,40
106 Olang,20,,24,20,44
106 Olang,21,,17,24,41
106 Olang,22,,32,24,56
106 Olang,23,,23,22,45
106 Olang,24,,29,17,46
106 Olang,25,,24,24,48
106 Olang,26,,24,24,48
106 Olang,27,,26,25,51
106 Olang,28,,27,26,53
106 Olang,29,,27,23,50
106 Olang,30,,17,25,42
106 Olang,31,,16,34,50
106 Olang,32,,26,23,49
106 Olang,33,,24,13,37
106 Olang,34,,17,27,44
106 Olang,35,,23,23,46
106 Olang,36,,21,17,38
106 Olang,37,,21,13,34
106 Olang,38,,26,13,39
106 Olang,39,,14,28,42
106 Olang,40,,15,18,33
106 Olang,41,,14,19,33
106 Olang,42,,15,19,34
106 Olang,43,,19,13,32
106 Olang,44,,11,12,23
106 Olang,45,,31,17,48
106 Olang,46,,25,13,38
106 Olang,47,,19,21,40
106 Olang,48,,15,24,39
106 Olang,49,,17,14,31
106 Olang,50,,17,12,29
106 Olang,51,,18,6,24
106 Olang,52,,10,16,26
106 Olang,53,,14,15,29
106 Olang,54,,16,12,28
106 Olang,55,,18,11,29
106 Olang,56,,11,9,20
106 Olang,57,,8,14,22
106 Olang,58,,12,9,21
106 Olang,59,,10,8,18
106 Olang,60,,9,14,23
106 Olang,61,,12,11,23
106 Olang,62,,10,14,24
106 Olang,63,,10,13,23
106 Olang,64,,7,6,13
106 Olang,65,,16,9,25
106 Olang,66,,13,14,27
106 Olang,67,,7,13,20
106 Olang,68,,9,11,20
106 Olang,69,,8,13,21
106 Olang,70,,6,7,13
106 Olang,71,,5,8,13
106 Olang,72,,9,5,14
106 Olang,73,,7,6,13
106 Olang,74,,9,6,15
106 Olang,75,,6,7,13
106 Olang,76,,2,5,7
106 Olang,77,,1,5,6
106 Olang,78,,1,5,6
106 Olang,79,,2,1,3
106 Olang,80,,4,9,13
106 Olang,81,,2,9,11
106 Olang,82,,3,6,9
106 Olang,83,,2,7,9
106 Olang,84,,3,5,8
106 Olang,85,,1,4,5
106 Olang,86,,1,3,4
106 Olang,87,,1,1,2
106 Olang,88,,3,2,5
106 Olang,89,,1,1,2
106 Olang,90,,1,1,2
106 Olang,91,,-,1,1
106 Olang,92,,-,2,2
106 Olang,93,,1,1,2
106 Olang,94,,-,1,1
107 Pfitsch,0,,14,12,26
107 Pfitsch,1,,15,18,33
107 Pfitsch,2,,16,11,27
107 Pfitsch,3,,15,15,30
107 Pfitsch,4,,18,15,33
107 Pfitsch,5,,17,17,34
107 Pfitsch,6,,10,19,29
107 Pfitsch,7,,17,16,33
107 Pfitsch,8,,14,18,32
107 Pfitsch,9,,16,8,24
107 Pfitsch,10,,18,14,32
107 Pfitsch,11,,24,13,37
107 Pfitsch,12,,19,21,40
107 Pfitsch,13,,28,16,44
107 Pfitsch,14,,24,18,42
107 Pfitsch,15,,21,24,45
107 Pfitsch,16,,28,21,49
107 Pfitsch,17,,25,15,40
107 Pfitsch,18,,17,22,39
107 Pfitsch,19,,23,20,43
107 Pfitsch,20,,13,18,31
107 Pfitsch,21,,14,21,35
107 Pfitsch,22,,21,11,32
107 Pfitsch,23,,14,22,36
107 Pfitsch,24,,23,21,44
107 Pfitsch,25,,24,19,43
107 Pfitsch,26,,25,17,42
107 Pfitsch,27,,22,21,43
107 Pfitsch,28,,18,20,38
107 Pfitsch,29,,25,20,45
107 Pfitsch,30,,22,18,40
107 Pfitsch,31,,14,27,41
107 Pfitsch,32,,16,20,36
107 Pfitsch,33,,27,21,48
107 Pfitsch,34,,20,18,38
107 Pfitsch,35,,20,27,47
107 Pfitsch,36,,14,19,33
107 Pfitsch,37,,24,19,43
107 Pfitsch,38,,24,22,46
107 Pfitsch,39,,18,18,36
107 Pfitsch,40,,15,15,30
107 Pfitsch,41,,23,22,45
107 Pfitsch,42,,22,15,37
107 Pfitsch,43,,21,24,45
107 Pfitsch,44,,21,13,34
107 Pfitsch,45,,24,19,43
107 Pfitsch,46,,16,22,38
107 Pfitsch,47,,11,10,21
107 Pfitsch,48,,12,13,25
107 Pfitsch,49,,15,15,30
107 Pfitsch,50,,13,12,25
107 Pfitsch,51,,15,17,32
107 Pfitsch,52,,22,11,33
107 Pfitsch,53,,25,14,39
107 Pfitsch,54,,16,19,35
107 Pfitsch,55,,13,17,30
107 Pfitsch,56,,17,10,27
107 Pfitsch,57,,5,13,18
107 Pfitsch,58,,10,9,19
107 Pfitsch,59,,9,13,22
107 Pfitsch,60,,9,8,17
107 Pfitsch,61,,13,5,18
107 Pfitsch,62,,12,14,26
107 Pfitsch,63,,4,17,21
107 Pfitsch,64,,10,14,24
107 Pfitsch,65,,9,18,27
107 Pfitsch,66,,17,12,29
107 Pfitsch,67,,8,14,22
107 Pfitsch,68,,12,14,26
107 Pfitsch,69,,9,14,23
107 Pfitsch,70,,13,11,24
107 Pfitsch,71,,8,19,27
107 Pfitsch,72,,9,14,23
107 Pfitsch,73,,10,8,18
107 Pfitsch,74,,9,10,19
107 Pfitsch,75,,1,9,10
107 Pfitsch,76,,6,9,15
107 Pfitsch,77,,-,5,5
107 Pfitsch,78,,3,5,8
107 Pfitsch,79,,3,3,6
107 Pfitsch,80,,3,8,11
107 Pfitsch,81,,2,6,8
107 Pfitsch,82,,3,5,8
107 Pfitsch,83,,4,4,8
107 Pfitsch,84,,2,5,7
107 Pfitsch,85,,3,1,4
107 Pfitsch,86,,4,5,9
107 Pfitsch,87,,-,8,8
107 Pfitsch,88,,4,1,5
107 Pfitsch,89,,-,1,1
107 Pfitsch,90,,-,4,4
107 Pfitsch,91,,-,1,1
107 Pfitsch,92,,-,1,1
107 Pfitsch,94,,1,1,2
107 Pfitsch,100,,-,1,1
108 Ahrntal,0,,33,28,61
108 Ahrntal,1,,25,29,54
108 Ahrntal,2,,41,41,82
108 Ahrntal,3,,44,34,78
108 Ahrntal,4,,31,34,65
108 Ahrntal,5,,39,32,71
108 Ahrntal,6,,42,33,75
108 Ahrntal,7,,29,33,62
108 Ahrntal,8,,37,39,76
108 Ahrntal,9,,39,51,90
108 Ahrntal,10,,35,45,80
108 Ahrntal,11,,41,33,74
108 Ahrntal,12,,44,48,92
108 Ahrntal,13,,39,45,84
108 Ahrntal,14,,49,40,89
108 Ahrntal,15,,41,39,80
108 Ahrntal,16,,45,40,85
108 Ahrntal,17,,34,45,79
108 Ahrntal,18,,46,48,94
108 Ahrntal,19,,44,51,95
108 Ahrntal,20,,47,51,98
108 Ahrntal,21,,44,53,97
108 Ahrntal,22,,48,56,104
108 Ahrntal,23,,60,60,120
108 Ahrntal,24,,76,42,118
108 Ahrntal,25,,58,51,109
108 Ahrntal,26,,51,56,107
108 Ahrntal,27,,60,54,114
108 Ahrntal,28,,49,51,100
108 Ahrntal,29,,63,46,109
108 Ahrntal,30,,56,45,101
108 Ahrntal,31,,57,45,102
108 Ahrntal,32,,48,46,94
108 Ahrntal,33,,39,44,83
108 Ahrntal,34,,38,38,76
108 Ahrntal,35,,41,33,74
108 Ahrntal,36,,44,38,82
108 Ahrntal,37,,50,26,76
108 Ahrntal,38,,27,41,68
108 Ahrntal,39,,36,21,57
108 Ahrntal,40,,38,25,63
108 Ahrntal,41,,32,24,56
108 Ahrntal,42,,29,31,60
108 Ahrntal,43,,29,31,60
108 Ahrntal,44,,36,26,62
108 Ahrntal,45,,31,23,54
108 Ahrntal,46,,34,31,65
108 Ahrntal,47,,30,29,59
108 Ahrntal,48,,26,15,41
108 Ahrntal,49,,17,21,38
108 Ahrntal,50,,20,14,34
108 Ahrntal,51,,21,19,40
108 Ahrntal,52,,23,32,55
108 Ahrntal,53,,31,31,62
108 Ahrntal,54,,32,32,64
108 Ahrntal,55,,31,24,55
108 Ahrntal,56,,28,25,53
108 Ahrntal,57,,38,31,69
108 Ahrntal,58,,26,23,49
108 Ahrntal,59,,23,16,39
108 Ahrntal,60,,26,36,62
108 Ahrntal,61,,23,21,44
108 Ahrntal,62,,20,19,39
108 Ahrntal,63,,22,27,49
108 Ahrntal,64,,36,25,61
108 Ahrntal,65,,23,24,47
108 Ahrntal,66,,21,19,40
108 Ahrntal,67,,16,27,43
108 Ahrntal,68,,21,19,40
108 Ahrntal,69,,26,15,41
108 Ahrntal,70,,15,19,34
108 Ahrntal,71,,16,18,34
108 Ahrntal,72,,11,15,26
108 Ahrntal,73,,14,21,35
108 Ahrntal,74,,8,11,19
108 Ahrntal,75,,7,10,17
108 Ahrntal,76,,12,7,19
108 Ahrntal,77,,3,10,13
108 Ahrntal,78,,3,7,10
108 Ahrntal,79,,-,3,3
108 Ahrntal,80,,4,11,15
108 Ahrntal,81,,11,10,21
108 Ahrntal,82,,5,6,11
108 Ahrntal,83,,7,12,19
108 Ahrntal,84,,5,15,20
108 Ahrntal,85,,7,5,12
108 Ahrntal,86,,5,8,13
108 Ahrntal,87,,-,9,9
108 Ahrntal,88,,-,7,7
108 Ahrntal,89,,2,5,7
108 Ahrntal,90,,2,3,5
108 Ahrntal,91,,2,1,3
108 Ahrntal,92,,1,2,3
108 Ahrntal,93,,1,1,2
108 Ahrntal,94,,-,1,1
108 Ahrntal,99,,1,-,1
109 Gsies,0,,14,17,31
109 Gsies,1,,11,17,28
109 Gsies,2,,17,21,38
109 Gsies,3,,15,9,24
109 Gsies,4,,16,24,40
109 Gsies,5,,16,11,27
109 Gsies,6,,8,12,20
109 Gsies,7,,7,14,21
109 Gsies,8,,18,18,36
109 Gsies,9,,12,16,28
109 Gsies,10,,17,15,32
109 Gsies,11,,12,8,20
109 Gsies,12,,18,10,28
109 Gsies,13,,18,19,37
109 Gsies,14,,15,18,33
109 Gsies,15,,24,21,45
109 Gsies,16,,10,16,26
109 Gsies,17,,14,16,30
109 Gsies,18,,17,21,38
109 Gsies,19,,16,19,35
109 Gsies,20,,20,31,51
109 Gsies,21,,21,18,39
109 Gsies,22,,19,19,38
109 Gsies,23,,11,18,29
109 Gsies,24,,24,27,51
109 Gsies,25,,31,13,44
109 Gsies,26,,25,11,36
109 Gsies,27,,17,19,36
109 Gsies,28,,17,13,30
109 Gsies,29,,14,22,36
109 Gsies,30,,24,6,30
109 Gsies,31,,14,19,33
109 Gsies,32,,15,18,33
109 Gsies,33,,21,10,31
109 Gsies,34,,10,12,22
109 Gsies,35,,16,16,32
109 Gsies,36,,14,13,27
109 Gsies,37,,16,15,31
109 Gsies,38,,13,14,27
109 Gsies,39,,17,7,24
109 Gsies,40,,17,11,28
109 Gsies,41,,16,6,22
109 Gsies,42,,17,6,23
109 Gsies,43,,17,11,28
109 Gsies,44,,16,13,29
109 Gsies,45,,8,8,16
109 Gsies,46,,15,15,30
109 Gsies,47,,9,10,19
109 Gsies,48,,20,7,27
109 Gsies,49,,16,10,26
109 Gsies,50,,4,11,15
109 Gsies,51,,9,13,22
109 Gsies,52,,10,8,18
109 Gsies,53,,6,13,19
109 Gsies,54,,6,11,17
109 Gsies,55,,9,10,19
109 Gsies,56,,6,9,15
109 Gsies,57,,7,9,16
109 Gsies,58,,10,9,19
109 Gsies,59,,4,10,14
109 Gsies,60,,5,9,14
109 Gsies,61,,5,9,14
109 Gsies,62,,7,5,12
109 Gsies,63,,10,6,16
109 Gsies,64,,9,10,19
109 Gsies,65,,13,6,19
109 Gsies,66,,5,6,11
109 Gsies,67,,8,9,17
109 Gsies,68,,4,12,16
109 Gsies,69,,5,4,9
109 Gsies,70,,9,7,16
109 Gsies,71,,6,9,15
109 Gsies,72,,6,9,15
109 Gsies,73,,11,8,19
109 Gsies,74,,2,12,14
109 Gsies,75,,4,4,8
109 Gsies,76,,4,4,8
109 Gsies,77,,1,4,5
109 Gsies,78,,1,3,4
109 Gsies,79,,2,3,5
109 Gsies,80,,3,1,4
109 Gsies,81,,3,4,7
109 Gsies,82,,2,6,8
109 Gsies,83,,5,8,13
109 Gsies,84,,2,7,9
109 Gsies,85,,1,4,5
109 Gsies,86,,3,3,6
109 Gsies,87,,3,8,11
109 Gsies,88,,1,3,4
109 Gsies,89,,1,-,1
109 Gsies,90,,1,1,2
109 Gsies,91,,-,1,1
109 Gsies,95,,-,1,1
110 Vintl,0,,36,27,63
110 Vintl,1,,20,18,38
110 Vintl,2,,23,19,42
110 Vintl,3,,32,21,53
110 Vintl,4,,22,29,51
110 Vintl,5,,28,22,50
110 Vintl,6,,26,17,43
110 Vintl,7,,21,19,40
110 Vintl,8,,21,23,44
110 Vintl,9,,21,18,39
110 Vintl,10,,10,15,25
110 Vintl,11,,27,10,37
110 Vintl,12,,26,17,43
110 Vintl,13,,20,21,41
110 Vintl,14,,20,25,45
110 Vintl,15,,33,19,52
110 Vintl,16,,32,17,49
110 Vintl,17,,21,33,54
110 Vintl,18,,19,26,45
110 Vintl,19,,21,28,49
110 Vintl,20,,26,23,49
110 Vintl,21,,29,32,61
110 Vintl,22,,19,23,42
110 Vintl,23,,34,21,55
110 Vintl,24,,33,38,71
110 Vintl,25,,25,22,47
110 Vintl,26,,31,29,60
110 Vintl,27,,23,23,46
110 Vintl,28,,33,39,72
110 Vintl,29,,33,32,65
110 Vintl,30,,35,36,71
110 Vintl,31,,36,28,64
110 Vintl,32,,31,25,56
110 Vintl,33,,31,27,58
110 Vintl,34,,27,30,57
110 Vintl,35,,20,21,41
110 Vintl,36,,26,21,47
110 Vintl,37,,19,12,31
110 Vintl,38,,24,30,54
110 Vintl,39,,28,21,49
110 Vintl,40,,20,16,36
110 Vintl,41,,20,21,41
110 Vintl,42,,22,9,31
110 Vintl,43,,18,18,36
110 Vintl,44,,21,17,38
110 Vintl,45,,26,17,43
110 Vintl,46,,20,18,38
110 Vintl,47,,13,13,26
110 Vintl,48,,21,15,36
110 Vintl,49,,17,13,30
110 Vintl,50,,18,18,36
110 Vintl,51,,13,6,19
110 Vintl,52,,21,12,33
110 Vintl,53,,11,13,24
110 Vintl,54,,6,15,21
110 Vintl,55,,8,20,28
110 Vintl,56,,18,16,34
110 Vintl,57,,12,6,18
110 Vintl,58,,11,9,20
110 Vintl,59,,14,9,23
110 Vintl,60,,9,12,21
110 Vintl,61,,17,9,26
110 Vintl,62,,8,18,26
110 Vintl,63,,12,16,28
110 Vintl,64,,15,13,28
110 Vintl,65,,9,15,24
110 Vintl,66,,11,20,31
110 Vintl,67,,17,10,27
110 Vintl,68,,14,17,31
110 Vintl,69,,20,9,29
110 Vintl,70,,9,11,20
110 Vintl,71,,10,13,23
110 Vintl,72,,15,13,28
110 Vintl,73,,9,8,17
110 Vintl,74,,11,9,20
110 Vintl,75,,3,10,13
110 Vintl,76,,7,7,14
110 Vintl,77,,1,3,4
110 Vintl,78,,4,5,9
110 Vintl,79,,2,4,6
110 Vintl,80,,5,6,11
110 Vintl,81,,2,9,11
110 Vintl,82,,1,11,12
110 Vintl,83,,1,3,4
110 Vintl,84,,-,9,9
110 Vintl,85,,2,3,5
110 Vintl,86,,2,2,4
110 Vintl,87,,2,3,5
110 Vintl,88,,2,2,4
110 Vintl,89,,-,1,1
110 Vintl,90,,-,1,1
110 Vintl,91,,-,1,1
111 Vahrn,0,,17,18,35
111 Vahrn,1,,20,23,43
111 Vahrn,2,,22,20,42
111 Vahrn,3,,21,22,43
111 Vahrn,4,,18,19,37
111 Vahrn,5,,13,26,39
111 Vahrn,6,,28,20,48
111 Vahrn,7,,21,20,41
111 Vahrn,8,,20,18,38
111 Vahrn,9,,19,15,34
111 Vahrn,10,,25,26,51
111 Vahrn,11,,18,21,39
111 Vahrn,12,,25,25,50
111 Vahrn,13,,25,25,50
111 Vahrn,14,,27,18,45
111 Vahrn,15,,18,23,41
111 Vahrn,16,,18,25,43
111 Vahrn,17,,19,20,39
111 Vahrn,18,,16,20,36
111 Vahrn,19,,34,19,53
111 Vahrn,20,,28,22,50
111 Vahrn,21,,22,31,53
111 Vahrn,22,,27,28,55
111 Vahrn,23,,23,25,48
111 Vahrn,24,,28,36,64
111 Vahrn,25,,30,26,56
111 Vahrn,26,,29,41,70
111 Vahrn,27,,29,31,60
111 Vahrn,28,,47,25,72
111 Vahrn,29,,33,31,64
111 Vahrn,30,,39,33,72
111 Vahrn,31,,38,36,74
111 Vahrn,32,,30,31,61
111 Vahrn,33,,31,38,69
111 Vahrn,34,,23,22,45
111 Vahrn,35,,33,28,61
111 Vahrn,36,,32,23,55
111 Vahrn,37,,19,21,40
111 Vahrn,38,,30,33,63
111 Vahrn,39,,21,20,41
111 Vahrn,40,,33,27,60
111 Vahrn,41,,22,31,53
111 Vahrn,42,,23,27,50
111 Vahrn,43,,20,20,40
111 Vahrn,44,,21,11,32
111 Vahrn,45,,17,17,34
111 Vahrn,46,,25,26,51
111 Vahrn,47,,19,15,34
111 Vahrn,48,,14,22,36
111 Vahrn,49,,18,23,41
111 Vahrn,50,,9,16,25
111 Vahrn,51,,22,19,41
111 Vahrn,52,,23,21,44
111 Vahrn,53,,21,22,43
111 Vahrn,54,,21,27,48
111 Vahrn,55,,22,14,36
111 Vahrn,56,,19,20,39
111 Vahrn,57,,17,10,27
111 Vahrn,58,,21,19,40
111 Vahrn,59,,13,17,30
111 Vahrn,60,,14,16,30
111 Vahrn,61,,14,18,32
111 Vahrn,62,,10,14,24
111 Vahrn,63,,16,13,29
111 Vahrn,64,,16,16,32
111 Vahrn,65,,15,18,33
111 Vahrn,66,,10,20,30
111 Vahrn,67,,9,13,22
111 Vahrn,68,,14,21,35
111 Vahrn,69,,11,8,19
111 Vahrn,70,,8,18,26
111 Vahrn,71,,11,19,30
111 Vahrn,72,,10,12,22
111 Vahrn,73,,6,16,22
111 Vahrn,74,,8,10,18
111 Vahrn,75,,5,4,9
111 Vahrn,76,,4,5,9
111 Vahrn,77,,6,5,11
111 Vahrn,78,,5,7,12
111 Vahrn,79,,2,2,4
111 Vahrn,80,,-,8,8
111 Vahrn,81,,5,6,11
111 Vahrn,82,,2,5,7
111 Vahrn,83,,1,9,10
111 Vahrn,84,,1,5,6
111 Vahrn,85,,2,5,7
111 Vahrn,86,,-,4,4
111 Vahrn,87,,-,2,2
111 Vahrn,88,,-,2,2
111 Vahrn,89,,-,3,3
111 Vahrn,90,,1,4,5
111 Vahrn,91,,1,2,3
111 Vahrn,92,,-,1,1
111 Vahrn,93,,1,-,1
111 Vahrn,94,,-,1,1
112 Vöran,0,,5,10,15
112 Vöran,1,,5,8,13
112 Vöran,2,,7,6,13
112 Vöran,3,,7,4,11
112 Vöran,4,,7,2,9
112 Vöran,5,,6,8,14
112 Vöran,6,,12,5,17
112 Vöran,7,,8,7,15
112 Vöran,8,,12,7,19
112 Vöran,9,,6,7,13
112 Vöran,10,,9,12,21
112 Vöran,11,,10,4,14
112 Vöran,12,,6,6,12
112 Vöran,13,,7,9,16
112 Vöran,14,,10,10,20
112 Vöran,15,,4,5,9
112 Vöran,16,,3,5,8
112 Vöran,17,,10,9,19
112 Vöran,18,,12,6,18
112 Vöran,19,,6,6,12
112 Vöran,20,,6,7,13
112 Vöran,21,,11,7,18
112 Vöran,22,,6,6,12
112 Vöran,23,,9,11,20
112 Vöran,24,,7,11,18
112 Vöran,25,,11,5,16
112 Vöran,26,,6,4,10
112 Vöran,27,,16,3,19
112 Vöran,28,,7,7,14
112 Vöran,29,,9,7,16
112 Vöran,30,,4,4,8
112 Vöran,31,,10,5,15
112 Vöran,32,,8,6,14
112 Vöran,33,,12,14,26
112 Vöran,34,,5,7,12
112 Vöran,35,,7,6,13
112 Vöran,36,,5,8,13
112 Vöran,37,,9,5,14
112 Vöran,38,,4,9,13
112 Vöran,39,,2,2,4
112 Vöran,40,,5,2,7
112 Vöran,41,,6,7,13
112 Vöran,42,,5,5,10
112 Vöran,43,,9,3,12
112 Vöran,44,,2,-,2
112 Vöran,45,,7,4,11
112 Vöran,46,,6,4,10
112 Vöran,47,,3,4,7
112 Vöran,48,,5,4,9
112 Vöran,49,,4,2,6
112 Vöran,50,,-,4,4
112 Vöran,51,,4,3,7
112 Vöran,52,,3,5,8
112 Vöran,53,,7,4,11
112 Vöran,54,,4,6,10
112 Vöran,55,,2,5,7
112 Vöran,56,,3,3,6
112 Vöran,57,,8,4,12
112 Vöran,58,,2,2,4
112 Vöran,59,,6,3,9
112 Vöran,60,,3,1,4
112 Vöran,61,,1,6,7
112 Vöran,62,,5,6,11
112 Vöran,63,,4,5,9
112 Vöran,64,,5,2,7
112 Vöran,65,,5,1,6
112 Vöran,66,,1,3,4
112 Vöran,67,,6,1,7
112 Vöran,68,,-,3,3
112 Vöran,69,,-,3,3
112 Vöran,70,,3,4,7
112 Vöran,71,,1,2,3
112 Vöran,72,,3,2,5
112 Vöran,73,,2,-,2
112 Vöran,74,,3,1,4
112 Vöran,75,,-,4,4
112 Vöran,76,,-,1,1
112 Vöran,77,,-,1,1
112 Vöran,79,,1,3,4
112 Vöran,80,,1,-,1
112 Vöran,81,,-,1,1
112 Vöran,82,,-,1,1
112 Vöran,83,,-,1,1
112 Vöran,85,,2,1,3
112 Vöran,86,,-,2,2
112 Vöran,87,,1,-,1
112 Vöran,88,,-,1,1
112 Vöran,89,,-,1,1
112 Vöran,91,,-,1,1
113 Niederdorf,0,,5,10,15
113 Niederdorf,1,,12,6,18
113 Niederdorf,2,,9,6,15
113 Niederdorf,3,,7,8,15
113 Niederdorf,4,,7,10,17
113 Niederdorf,5,,14,11,25
113 Niederdorf,6,,8,7,15
113 Niederdorf,7,,6,7,13
113 Niederdorf,8,,3,11,14
113 Niederdorf,9,,4,6,10
113 Niederdorf,10,,7,5,12
113 Niederdorf,11,,11,5,16
113 Niederdorf,12,,6,9,15
113 Niederdorf,13,,3,11,14
113 Niederdorf,14,,10,7,17
113 Niederdorf,15,,9,4,13
113 Niederdorf,16,,8,4,12
113 Niederdorf,17,,5,4,9
113 Niederdorf,18,,6,4,10
113 Niederdorf,19,,12,7,19
113 Niederdorf,20,,5,8,13
113 Niederdorf,21,,10,6,16
113 Niederdorf,22,,12,5,17
113 Niederdorf,23,,13,5,18
113 Niederdorf,24,,11,10,21
113 Niederdorf,25,,8,12,20
113 Niederdorf,26,,18,15,33
113 Niederdorf,27,,13,11,24
113 Niederdorf,28,,15,16,31
113 Niederdorf,29,,23,8,31
113 Niederdorf,30,,11,17,28
113 Niederdorf,31,,21,15,36
113 Niederdorf,32,,11,11,22
113 Niederdorf,33,,17,8,25
113 Niederdorf,34,,13,12,25
113 Niederdorf,35,,12,10,22
113 Niederdorf,36,,12,7,19
113 Niederdorf,37,,7,6,13
113 Niederdorf,38,,13,10,23
113 Niederdorf,39,,10,9,19
113 Niederdorf,40,,9,8,17
113 Niederdorf,41,,9,6,15
113 Niederdorf,42,,5,3,8
113 Niederdorf,43,,8,5,13
113 Niederdorf,44,,3,3,6
113 Niederdorf,45,,8,3,11
113 Niederdorf,46,,11,4,15
113 Niederdorf,47,,6,8,14
113 Niederdorf,48,,6,8,14
113 Niederdorf,49,,6,7,13
113 Niederdorf,50,,2,6,8
113 Niederdorf,51,,11,4,15
113 Niederdorf,52,,5,9,14
113 Niederdorf,53,,6,11,17
113 Niederdorf,54,,5,6,11
113 Niederdorf,55,,4,9,13
113 Niederdorf,56,,1,4,5
113 Niederdorf,57,,6,8,14
113 Niederdorf,58,,6,7,13
113 Niederdorf,59,,6,9,15
113 Niederdorf,60,,7,7,14
113 Niederdorf,61,,3,12,15
113 Niederdorf,62,,6,8,14
113 Niederdorf,63,,8,7,15
113 Niederdorf,64,,9,7,16
113 Niederdorf,65,,7,10,17
113 Niederdorf,66,,5,9,14
113 Niederdorf,67,,5,6,11
113 Niederdorf,68,,8,9,17
113 Niederdorf,69,,3,6,9
113 Niederdorf,70,,1,7,8
113 Niederdorf,71,,6,11,17
113 Niederdorf,72,,3,3,6
113 Niederdorf,73,,6,9,15
113 Niederdorf,74,,5,4,9
113 Niederdorf,75,,3,5,8
113 Niederdorf,76,,2,5,7
113 Niederdorf,77,,1,4,5
113 Niederdorf,78,,2,3,5
113 Niederdorf,79,,3,3,6
113 Niederdorf,80,,-,4,4
113 Niederdorf,81,,3,2,5
113 Niederdorf,82,,1,1,2
113 Niederdorf,83,,1,5,6
113 Niederdorf,84,,3,3,6
113 Niederdorf,85,,1,5,6
113 Niederdorf,86,,1,4,5
113 Niederdorf,87,,-,3,3
113 Niederdorf,88,,1,2,3
113 Niederdorf,89,,1,1,2
113 Niederdorf,90,,1,2,3
113 Niederdorf,91,,1,1,2
113 Niederdorf,92,,-,3,3
113 Niederdorf,93,,-,1,1
113 Niederdorf,94,,-,1,1
114 Villanders,0,,17,8,25
114 Villanders,1,,10,13,23
114 Villanders,2,,8,18,26
114 Villanders,3,,13,8,21
114 Villanders,4,,19,17,36
114 Villanders,5,,16,14,30
114 Villanders,6,,12,10,22
114 Villanders,7,,10,12,22
114 Villanders,8,,5,16,21
114 Villanders,9,,10,8,18
114 Villanders,10,,10,10,20
114 Villanders,11,,12,12,24
114 Villanders,12,,13,6,19
114 Villanders,13,,15,11,26
114 Villanders,14,,19,13,32
114 Villanders,15,,10,17,27
114 Villanders,16,,16,6,22
114 Villanders,17,,12,12,24
114 Villanders,18,,15,15,30
114 Villanders,19,,13,15,28
114 Villanders,20,,10,15,25
114 Villanders,21,,14,17,31
114 Villanders,22,,12,17,29
114 Villanders,23,,14,15,29
114 Villanders,24,,15,23,38
114 Villanders,25,,18,15,33
114 Villanders,26,,24,21,45
114 Villanders,27,,21,19,40
114 Villanders,28,,19,25,44
114 Villanders,29,,23,17,40
114 Villanders,30,,22,18,40
114 Villanders,31,,17,17,34
114 Villanders,32,,15,13,28
114 Villanders,33,,20,11,31
114 Villanders,34,,15,12,27
114 Villanders,35,,20,7,27
114 Villanders,36,,14,11,25
114 Villanders,37,,16,9,25
114 Villanders,38,,8,6,14
114 Villanders,39,,12,10,22
114 Villanders,40,,10,16,26
114 Villanders,41,,10,5,15
114 Villanders,42,,11,7,18
114 Villanders,43,,10,8,18
114 Villanders,44,,11,6,17
114 Villanders,45,,8,9,17
114 Villanders,46,,10,7,17
114 Villanders,47,,6,11,17
114 Villanders,48,,7,8,15
114 Villanders,49,,10,11,21
114 Villanders,50,,6,3,9
114 Villanders,51,,5,9,14
114 Villanders,52,,8,8,16
114 Villanders,53,,11,8,19
114 Villanders,54,,8,8,16
114 Villanders,55,,9,14,23
114 Villanders,56,,9,6,15
114 Villanders,57,,10,7,17
114 Villanders,58,,6,9,15
114 Villanders,59,,6,7,13
114 Villanders,60,,3,9,12
114 Villanders,61,,1,9,10
114 Villanders,62,,12,9,21
114 Villanders,63,,9,10,19
114 Villanders,64,,6,8,14
114 Villanders,65,,10,7,17
114 Villanders,66,,4,10,14
114 Villanders,67,,7,10,17
114 Villanders,68,,9,7,16
114 Villanders,69,,7,6,13
114 Villanders,70,,2,7,9
114 Villanders,71,,5,6,11
114 Villanders,72,,7,3,10
114 Villanders,73,,5,6,11
114 Villanders,74,,6,13,19
114 Villanders,75,,5,5,10
114 Villanders,76,,1,4,5
114 Villanders,77,,3,-,3
114 Villanders,78,,-,2,2
114 Villanders,79,,1,3,4
114 Villanders,80,,-,5,5
114 Villanders,81,,2,7,9
114 Villanders,82,,2,3,5
114 Villanders,83,,4,7,11
114 Villanders,84,,2,5,7
114 Villanders,85,,1,3,4
114 Villanders,86,,2,4,6
114 Villanders,87,,2,2,4
114 Villanders,88,,2,2,4
114 Villanders,89,,2,3,5
114 Villanders,90,,1,2,3
114 Villanders,91,,1,2,3
114 Villanders,92,,-,1,1
114 Villanders,93,,-,1,1
114 Villanders,94,,-,1,1
115 Sterzing,0,,28,28,56
115 Sterzing,1,,35,21,56
115 Sterzing,2,,29,29,58
115 Sterzing,3,,26,35,61
115 Sterzing,4,,32,35,67
115 Sterzing,5,,19,32,51
115 Sterzing,6,,36,21,57
115 Sterzing,7,,27,26,53
115 Sterzing,8,,28,24,52
115 Sterzing,9,,32,32,64
115 Sterzing,10,,17,27,44
115 Sterzing,11,,35,23,58
115 Sterzing,12,,26,31,57
115 Sterzing,13,,26,34,60
115 Sterzing,14,,44,31,75
115 Sterzing,15,,29,40,69
115 Sterzing,16,,30,40,70
115 Sterzing,17,,44,25,69
115 Sterzing,18,,36,34,70
115 Sterzing,19,,36,36,72
115 Sterzing,20,,54,49,103
115 Sterzing,21,,52,42,94
115 Sterzing,22,,51,58,109
115 Sterzing,23,,58,56,114
115 Sterzing,24,,62,49,111
115 Sterzing,25,,54,57,111
115 Sterzing,26,,55,46,101
115 Sterzing,27,,68,47,115
115 Sterzing,28,,63,46,109
115 Sterzing,29,,63,61,124
115 Sterzing,30,,61,50,111
115 Sterzing,31,,54,36,90
115 Sterzing,32,,60,47,107
115 Sterzing,33,,42,45,87
115 Sterzing,34,,44,44,88
115 Sterzing,35,,43,45,88
115 Sterzing,36,,47,37,84
115 Sterzing,37,,41,41,82
115 Sterzing,38,,36,49,85
115 Sterzing,39,,44,29,73
115 Sterzing,40,,36,43,79
115 Sterzing,41,,36,37,73
115 Sterzing,42,,30,40,70
115 Sterzing,43,,44,37,81
115 Sterzing,44,,40,41,81
115 Sterzing,45,,33,38,71
115 Sterzing,46,,34,52,86
115 Sterzing,47,,44,44,88
115 Sterzing,48,,41,28,69
115 Sterzing,49,,47,43,90
115 Sterzing,50,,40,36,76
115 Sterzing,51,,32,26,58
115 Sterzing,52,,45,47,92
115 Sterzing,53,,34,33,67
115 Sterzing,54,,35,30,65
115 Sterzing,55,,43,31,74
115 Sterzing,56,,35,27,62
115 Sterzing,57,,34,27,61
115 Sterzing,58,,26,36,62
115 Sterzing,59,,26,42,68
115 Sterzing,60,,23,25,48
115 Sterzing,61,,21,27,48
115 Sterzing,62,,32,32,64
115 Sterzing,63,,24,19,43
115 Sterzing,64,,27,34,61
115 Sterzing,65,,12,27,39
115 Sterzing,66,,23,20,43
115 Sterzing,67,,23,30,53
115 Sterzing,68,,24,22,46
115 Sterzing,69,,19,24,43
115 Sterzing,70,,14,25,39
115 Sterzing,71,,13,27,40
115 Sterzing,72,,17,21,38
115 Sterzing,73,,21,27,48
115 Sterzing,74,,7,23,30
115 Sterzing,75,,7,15,22
115 Sterzing,76,,7,15,22
115 Sterzing,77,,7,7,14
115 Sterzing,78,,6,7,13
115 Sterzing,79,,5,9,14
115 Sterzing,80,,6,9,15
115 Sterzing,81,,3,18,21
115 Sterzing,82,,4,18,22
115 Sterzing,83,,1,19,20
115 Sterzing,84,,3,10,13
115 Sterzing,85,,2,5,7
115 Sterzing,86,,3,9,12
115 Sterzing,87,,4,4,8
115 Sterzing,88,,1,4,5
115 Sterzing,89,,1,8,9
115 Sterzing,90,,-,3,3
115 Sterzing,91,,-,3,3
115 Sterzing,92,,1,1,2
115 Sterzing,93,,-,1,1
115 Sterzing,94,,-,4,4
115 Sterzing,95,,-,3,3
115 Sterzing,99,,1,-,1
115 Sterzing,100,,-,1,1
115 Sterzing,101,,-,1,1
116 Feldthurns,0,,18,21,39
116 Feldthurns,1,,18,13,31
116 Feldthurns,2,,27,21,48
116 Feldthurns,3,,17,18,35
116 Feldthurns,4,,12,13,25
116 Feldthurns,5,,12,18,30
116 Feldthurns,6,,19,15,34
116 Feldthurns,7,,17,19,36
116 Feldthurns,8,,20,13,33
116 Feldthurns,9,,16,19,35
116 Feldthurns,10,,14,21,35
116 Feldthurns,11,,17,20,37
116 Feldthurns,12,,24,25,49
116 Feldthurns,13,,16,22,38
116 Feldthurns,14,,21,19,40
116 Feldthurns,15,,11,25,36
116 Feldthurns,16,,14,16,30
116 Feldthurns,17,,32,24,56
116 Feldthurns,18,,19,16,35
116 Feldthurns,19,,26,22,48
116 Feldthurns,20,,18,20,38
116 Feldthurns,21,,22,32,54
116 Feldthurns,22,,23,22,45
116 Feldthurns,23,,32,20,52
116 Feldthurns,24,,16,20,36
116 Feldthurns,25,,15,23,38
116 Feldthurns,26,,22,26,48
116 Feldthurns,27,,20,26,46
116 Feldthurns,28,,24,20,44
116 Feldthurns,29,,18,21,39
116 Feldthurns,30,,23,28,51
116 Feldthurns,31,,28,21,49
116 Feldthurns,32,,27,15,42
116 Feldthurns,33,,14,17,31
116 Feldthurns,34,,19,19,38
116 Feldthurns,35,,18,10,28
116 Feldthurns,36,,17,17,34
116 Feldthurns,37,,18,21,39
116 Feldthurns,38,,13,14,27
116 Feldthurns,39,,11,18,29
116 Feldthurns,40,,16,13,29
116 Feldthurns,41,,14,16,30
116 Feldthurns,42,,18,12,30
116 Feldthurns,43,,24,16,40
116 Feldthurns,44,,15,11,26
116 Feldthurns,45,,13,16,29
116 Feldthurns,46,,6,15,21
116 Feldthurns,47,,14,11,25
116 Feldthurns,48,,15,8,23
116 Feldthurns,49,,11,9,20
116 Feldthurns,50,,13,14,27
116 Feldthurns,51,,22,11,33
116 Feldthurns,52,,13,13,26
116 Feldthurns,53,,9,11,20
116 Feldthurns,54,,8,4,12
116 Feldthurns,55,,10,7,17
116 Feldthurns,56,,8,10,18
116 Feldthurns,57,,12,8,20
116 Feldthurns,58,,4,9,13
116 Feldthurns,59,,8,11,19
116 Feldthurns,60,,11,11,22
116 Feldthurns,61,,5,5,10
116 Feldthurns,62,,9,6,15
116 Feldthurns,63,,9,11,20
116 Feldthurns,64,,6,7,13
116 Feldthurns,65,,7,14,21
116 Feldthurns,66,,5,13,18
116 Feldthurns,67,,9,4,13
116 Feldthurns,68,,5,7,12
116 Feldthurns,69,,5,10,15
116 Feldthurns,70,,6,10,16
116 Feldthurns,71,,4,9,13
116 Feldthurns,72,,8,12,20
116 Feldthurns,73,,2,11,13
116 Feldthurns,74,,4,9,13
116 Feldthurns,75,,12,10,22
116 Feldthurns,76,,5,7,12
116 Feldthurns,77,,3,3,6
116 Feldthurns,78,,2,3,5
116 Feldthurns,79,,1,4,5
116 Feldthurns,80,,2,8,10
116 Feldthurns,81,,4,5,9
116 Feldthurns,82,,2,4,6
116 Feldthurns,83,,2,4,6
116 Feldthurns,84,,2,3,5
116 Feldthurns,85,,-,1,1
116 Feldthurns,86,,3,2,5
116 Feldthurns,87,,1,-,1
116 Feldthurns,89,,-,1,1
116 Feldthurns,90,,-,2,2
116 Feldthurns,91,,-,1,1
117 Wengen,0,,11,10,21
117 Wengen,1,,15,6,21
117 Wengen,2,,10,7,17
117 Wengen,3,,11,7,18
117 Wengen,4,,16,5,21
117 Wengen,5,,12,8,20
117 Wengen,6,,5,7,12
117 Wengen,7,,7,9,16
117 Wengen,8,,11,5,16
117 Wengen,9,,9,8,17
117 Wengen,10,,9,6,15
117 Wengen,11,,14,8,22
117 Wengen,12,,13,5,18
117 Wengen,13,,11,5,16
117 Wengen,14,,6,9,15
117 Wengen,15,,9,10,19
117 Wengen,16,,14,7,21
117 Wengen,17,,6,8,14
117 Wengen,18,,10,8,18
117 Wengen,19,,6,9,15
117 Wengen,20,,16,9,25
117 Wengen,21,,10,9,19
117 Wengen,22,,16,14,30
117 Wengen,23,,14,20,34
117 Wengen,24,,12,17,29
117 Wengen,25,,12,16,28
117 Wengen,26,,11,15,26
117 Wengen,27,,18,11,29
117 Wengen,28,,13,11,24
117 Wengen,29,,12,6,18
117 Wengen,30,,9,11,20
117 Wengen,31,,10,9,19
117 Wengen,32,,12,13,25
117 Wengen,33,,14,9,23
117 Wengen,34,,9,10,19
117 Wengen,35,,12,12,24
117 Wengen,36,,8,7,15
117 Wengen,37,,5,8,13
117 Wengen,38,,7,11,18
117 Wengen,39,,6,6,12
117 Wengen,40,,7,6,13
117 Wengen,41,,10,5,15
117 Wengen,42,,7,2,9
117 Wengen,43,,6,7,13
117 Wengen,44,,10,5,15
117 Wengen,45,,3,6,9
117 Wengen,46,,5,9,14
117 Wengen,47,,2,12,14
117 Wengen,48,,6,3,9
117 Wengen,49,,5,3,8
117 Wengen,50,,5,3,8
117 Wengen,51,,8,8,16
117 Wengen,52,,3,7,10
117 Wengen,53,,8,7,15
117 Wengen,54,,6,4,10
117 Wengen,55,,7,8,15
117 Wengen,56,,6,3,9
117 Wengen,57,,5,5,10
117 Wengen,58,,7,7,14
117 Wengen,59,,2,2,4
117 Wengen,60,,4,6,10
117 Wengen,61,,2,9,11
117 Wengen,62,,5,2,7
117 Wengen,63,,3,8,11
117 Wengen,64,,5,2,7
117 Wengen,65,,5,3,8
117 Wengen,66,,2,9,11
117 Wengen,67,,5,4,9
117 Wengen,68,,4,5,9
117 Wengen,69,,4,6,10
117 Wengen,70,,4,4,8
117 Wengen,71,,3,5,8
117 Wengen,72,,4,7,11
117 Wengen,73,,3,6,9
117 Wengen,74,,6,9,15
117 Wengen,75,,3,5,8
117 Wengen,76,,2,2,4
117 Wengen,77,,2,-,2
117 Wengen,78,,2,1,3
117 Wengen,80,,1,2,3
117 Wengen,81,,1,1,2
117 Wengen,82,,2,3,5
117 Wengen,83,,2,1,3
117 Wengen,84,,2,1,3
117 Wengen,85,,2,2,4
117 Wengen,86,,1,2,3
117 Wengen,87,,-,5,5
117 Wengen,89,,2,2,4
117 Wengen,90,,1,-,1
117 Wengen,91,,1,2,3
118 U.L.Frau i.W.-St.Felix,0,,5,8,13
118 U.L.Frau i.W.-St.Felix,1,,7,8,15
118 U.L.Frau i.W.-St.Felix,2,,8,5,13
118 U.L.Frau i.W.-St.Felix,3,,6,4,10
118 U.L.Frau i.W.-St.Felix,4,,11,8,19
118 U.L.Frau i.W.-St.Felix,5,,7,5,12
118 U.L.Frau i.W.-St.Felix,6,,8,7,15
118 U.L.Frau i.W.-St.Felix,7,,7,6,13
118 U.L.Frau i.W.-St.Felix,8,,4,7,11
118 U.L.Frau i.W.-St.Felix,9,,8,3,11
118 U.L.Frau i.W.-St.Felix,10,,5,7,12
118 U.L.Frau i.W.-St.Felix,11,,6,6,12
118 U.L.Frau i.W.-St.Felix,12,,2,10,12
118 U.L.Frau i.W.-St.Felix,13,,3,5,8
118 U.L.Frau i.W.-St.Felix,14,,6,3,9
118 U.L.Frau i.W.-St.Felix,15,,3,6,9
118 U.L.Frau i.W.-St.Felix,16,,2,2,4
118 U.L.Frau i.W.-St.Felix,17,,1,3,4
118 U.L.Frau i.W.-St.Felix,18,,5,5,10
118 U.L.Frau i.W.-St.Felix,19,,4,8,12
118 U.L.Frau i.W.-St.Felix,20,,7,3,10
118 U.L.Frau i.W.-St.Felix,21,,5,4,9
118 U.L.Frau i.W.-St.Felix,22,,3,4,7
118 U.L.Frau i.W.-St.Felix,23,,8,2,10
118 U.L.Frau i.W.-St.Felix,24,,2,6,8
118 U.L.Frau i.W.-St.Felix,25,,7,6,13
118 U.L.Frau i.W.-St.Felix,26,,8,5,13
118 U.L.Frau i.W.-St.Felix,27,,6,8,14
118 U.L.Frau i.W.-St.Felix,28,,3,4,7
118 U.L.Frau i.W.-St.Felix,29,,10,8,18
118 U.L.Frau i.W.-St.Felix,30,,9,7,16
118 U.L.Frau i.W.-St.Felix,31,,4,8,12
118 U.L.Frau i.W.-St.Felix,32,,16,9,25
118 U.L.Frau i.W.-St.Felix,33,,8,10,18
118 U.L.Frau i.W.-St.Felix,34,,5,5,10
118 U.L.Frau i.W.-St.Felix,35,,8,9,17
118 U.L.Frau i.W.-St.Felix,36,,5,6,11
118 U.L.Frau i.W.-St.Felix,37,,4,3,7
118 U.L.Frau i.W.-St.Felix,38,,4,5,9
118 U.L.Frau i.W.-St.Felix,39,,5,5,10
118 U.L.Frau i.W.-St.Felix,40,,4,4,8
118 U.L.Frau i.W.-St.Felix,41,,7,4,11
118 U.L.Frau i.W.-St.Felix,42,,3,3,6
118 U.L.Frau i.W.-St.Felix,43,,6,3,9
118 U.L.Frau i.W.-St.Felix,44,,6,3,9
118 U.L.Frau i.W.-St.Felix,45,,3,3,6
118 U.L.Frau i.W.-St.Felix,46,,5,-,5
118 U.L.Frau i.W.-St.Felix,47,,5,2,7
118 U.L.Frau i.W.-St.Felix,48,,2,6,8
118 U.L.Frau i.W.-St.Felix,49,,1,3,4
118 U.L.Frau i.W.-St.Felix,50,,3,2,5
118 U.L.Frau i.W.-St.Felix,51,,5,-,5
118 U.L.Frau i.W.-St.Felix,52,,7,4,11
118 U.L.Frau i.W.-St.Felix,53,,5,4,9
118 U.L.Frau i.W.-St.Felix,54,,5,9,14
118 U.L.Frau i.W.-St.Felix,55,,4,1,5
118 U.L.Frau i.W.-St.Felix,56,,1,4,5
118 U.L.Frau i.W.-St.Felix,57,,3,4,7
118 U.L.Frau i.W.-St.Felix,58,,3,-,3
118 U.L.Frau i.W.-St.Felix,59,,4,2,6
118 U.L.Frau i.W.-St.Felix,60,,3,4,7
118 U.L.Frau i.W.-St.Felix,61,,3,3,6
118 U.L.Frau i.W.-St.Felix,62,,6,5,11
118 U.L.Frau i.W.-St.Felix,63,,5,1,6
118 U.L.Frau i.W.-St.Felix,64,,4,1,5
118 U.L.Frau i.W.-St.Felix,65,,4,5,9
118 U.L.Frau i.W.-St.Felix,66,,2,3,5
118 U.L.Frau i.W.-St.Felix,67,,3,5,8
118 U.L.Frau i.W.-St.Felix,68,,3,4,7
118 U.L.Frau i.W.-St.Felix,69,,2,3,5
118 U.L.Frau i.W.-St.Felix,70,,5,6,11
118 U.L.Frau i.W.-St.Felix,71,,6,4,10
118 U.L.Frau i.W.-St.Felix,72,,2,6,8
118 U.L.Frau i.W.-St.Felix,73,,1,2,3
118 U.L.Frau i.W.-St.Felix,74,,1,3,4
118 U.L.Frau i.W.-St.Felix,75,,-,1,1
118 U.L.Frau i.W.-St.Felix,76,,1,2,3
118 U.L.Frau i.W.-St.Felix,77,,1,-,1
118 U.L.Frau i.W.-St.Felix,78,,1,-,1
118 U.L.Frau i.W.-St.Felix,80,,1,1,2
118 U.L.Frau i.W.-St.Felix,81,,3,2,5
118 U.L.Frau i.W.-St.Felix,82,,2,3,5
118 U.L.Frau i.W.-St.Felix,83,,3,2,5
118 U.L.Frau i.W.-St.Felix,84,,2,-,2
118 U.L.Frau i.W.-St.Felix,85,,1,2,3
118 U.L.Frau i.W.-St.Felix,86,,1,-,1
118 U.L.Frau i.W.-St.Felix,87,,-,1,1
118 U.L.Frau i.W.-St.Felix,88,,1,-,1
118 U.L.Frau i.W.-St.Felix,90,,1,-,1
