Gemeinde,Altersklassen,Geschlecht,Männer,Frauen,Insgesamt
001 Aldein,0,,7,7,14
001 Aldein,1,,9,12,21
001 Aldein,2,,13,6,19
001 Aldein,3,,12,10,22
001 Aldein,4,,8,12,20
001 Aldein,5,,7,6,13
001 Aldein,6,,8,6,14
001 Aldein,7,,9,17,26
001 Aldein,8,,12,9,21
001 Aldein,9,,11,7,18
001 Aldein,10,,11,10,21
001 Aldein,11,,12,12,24
001 Aldein,12,,10,7,17
001 Aldein,13,,14,12,26
001 Aldein,14,,18,7,25
001 Aldein,15,,10,16,26
001 Aldein,16,,10,15,25
001 Aldein,17,,10,20,30
001 Aldein,18,,10,9,19
001 Aldein,19,,8,23,31
001 Aldein,20,,14,17,31
001 Aldein,21,,17,19,36
001 Aldein,22,,11,19,30
001 Aldein,23,,16,14,30
001 Aldein,24,,18,12,30
001 Aldein,25,,18,24,42
001 Aldein,26,,16,18,34
001 Aldein,27,,20,8,28
001 Aldein,28,,12,16,28
001 Aldein,29,,9,18,27
001 Aldein,30,,9,21,30
001 Aldein,31,,19,10,29
001 Aldein,32,,14,9,23
001 Aldein,33,,15,6,21
001 Aldein,34,,10,14,24
001 Aldein,35,,16,16,32
001 Aldein,36,,17,9,26
001 Aldein,37,,13,14,27
001 Aldein,38,,8,5,13
001 Aldein,39,,9,10,19
001 Aldein,40,,11,10,21
001 Aldein,41,,10,10,20
001 Aldein,42,,10,7,17
001 Aldein,43,,8,9,17
001 Aldein,44,,6,4,10
001 Aldein,45,,15,10,25
001 Aldein,46,,6,12,18
001 Aldein,47,,10,6,16
001 Aldein,48,,9,9,18
001 Aldein,49,,4,11,15
001 Aldein,50,,7,11,18
001 Aldein,51,,7,5,12
001 Aldein,52,,6,7,13
001 Aldein,53,,11,11,22
001 Aldein,54,,9,13,22
001 Aldein,55,,8,12,20
001 Aldein,56,,9,9,18
001 Aldein,57,,4,9,13
001 Aldein,58,,6,8,14
001 Aldein,59,,8,9,17
001 Aldein,60,,9,6,15
001 Aldein,61,,4,4,8
001 Aldein,62,,16,5,21
001 Aldein,63,,9,4,13
001 Aldein,64,,5,8,13
001 Aldein,65,,11,4,15
001 Aldein,66,,7,6,13
001 Aldein,67,,9,10,19
001 Aldein,68,,6,4,10
001 Aldein,69,,8,6,14
001 Aldein,70,,4,7,11
001 Aldein,71,,3,9,12
001 Aldein,72,,5,8,13
001 Aldein,73,,3,6,9
001 Aldein,74,,3,9,12
001 Aldein,75,,7,15,22
001 Aldein,76,,6,3,9
001 Aldein,77,,1,4,5
001 Aldein,78,,3,3,6
001 Aldein,79,,-,3,3
001 Aldein,80,,2,2,4
001 Aldein,81,,3,3,6
001 Aldein,82,,1,3,4
001 Aldein,83,,2,5,7
001 Aldein,84,,3,3,6
001 Aldein,85,,2,3,5
001 Aldein,86,,2,3,5
001 Aldein,87,,2,1,3
001 Aldein,88,,-,2,2
001 Aldein,89,,1,1,2
001 Aldein,90,,1,2,3
001 Aldein,92,,-,1,1
001 Aldein,94,,-,1,1
001 Aldein,Insgesamt,,792,838,1.630
002 Andrian,0,,2,10,12
002 Andrian,1,,7,5,12
002 Andrian,2,,5,4,9
002 Andrian,3,,5,6,11
002 Andrian,4,,6,6,12
002 Andrian,5,,8,7,15
002 Andrian,6,,5,4,9
002 Andrian,7,,4,5,9
002 Andrian,8,,12,6,18
002 Andrian,9,,6,7,13
002 Andrian,10,,8,6,14
002 Andrian,11,,1,4,5
002 Andrian,12,,6,4,10
002 Andrian,13,,5,2,7
002 Andrian,14,,10,7,17
002 Andrian,15,,1,3,4
002 Andrian,16,,5,2,7
002 Andrian,17,,5,3,8
002 Andrian,18,,4,4,8
002 Andrian,19,,5,4,9
002 Andrian,20,,6,4,10
002 Andrian,21,,5,2,7
002 Andrian,22,,6,3,9
002 Andrian,23,,5,6,11
002 Andrian,24,,4,4,8
002 Andrian,25,,6,9,15
002 Andrian,26,,10,8,18
002 Andrian,27,,4,7,11
002 Andrian,28,,7,8,15
002 Andrian,29,,6,5,11
002 Andrian,30,,8,10,18
002 Andrian,31,,10,7,17
002 Andrian,32,,6,6,12
002 Andrian,33,,6,12,18
002 Andrian,34,,7,5,12
002 Andrian,35,,7,2,9
002 Andrian,36,,7,4,11
002 Andrian,37,,7,3,10
002 Andrian,38,,7,8,15
002 Andrian,39,,5,9,14
002 Andrian,40,,6,9,15
002 Andrian,41,,1,4,5
002 Andrian,42,,6,2,8
002 Andrian,43,,6,6,12
002 Andrian,44,,3,3,6
002 Andrian,45,,4,3,7
002 Andrian,46,,7,6,13
002 Andrian,47,,4,1,5
002 Andrian,48,,7,5,12
002 Andrian,49,,5,4,9
002 Andrian,50,,3,7,10
002 Andrian,51,,1,2,3
002 Andrian,52,,1,4,5
002 Andrian,53,,5,7,12
002 Andrian,54,,4,5,9
002 Andrian,55,,6,4,10
002 Andrian,56,,5,9,14
002 Andrian,57,,1,8,9
002 Andrian,58,,4,4,8
002 Andrian,59,,6,4,10
002 Andrian,60,,2,3,5
002 Andrian,61,,3,3,6
002 Andrian,62,,5,3,8
002 Andrian,63,,3,4,7
002 Andrian,64,,8,5,13
002 Andrian,65,,3,5,8
002 Andrian,66,,3,1,4
002 Andrian,67,,2,1,3
002 Andrian,68,,3,5,8
002 Andrian,69,,1,2,3
002 Andrian,70,,4,4,8
002 Andrian,71,,2,1,3
002 Andrian,72,,2,5,7
002 Andrian,73,,1,3,4
002 Andrian,74,,1,5,6
002 Andrian,75,,1,4,5
002 Andrian,76,,1,1,2
002 Andrian,77,,3,3,6
002 Andrian,78,,2,2,4
002 Andrian,80,,1,-,1
002 Andrian,81,,1,2,3
002 Andrian,82,,1,3,4
002 Andrian,83,,1,2,3
002 Andrian,84,,-,2,2
002 Andrian,86,,-,1,1
002 Andrian,87,,2,1,3
002 Andrian,88,,-,1,1
002 Andrian,89,,2,2,4
002 Andrian,91,,-,1,1
002 Andrian,93,,-,2,2
002 Andrian,Insgesamt,,382,395,777
003 Altrei,0,,-,2,2
003 Altrei,1,,1,2,3
003 Altrei,2,,3,2,5
003 Altrei,3,,3,-,3
003 Altrei,4,,6,2,8
003 Altrei,5,,1,1,2
003 Altrei,6,,2,2,4
003 Altrei,7,,2,2,4
003 Altrei,8,,4,4,8
003 Altrei,9,,2,1,3
003 Altrei,10,,3,3,6
003 Altrei,11,,2,2,4
003 Altrei,12,,3,1,4
003 Altrei,13,,4,2,6
003 Altrei,14,,2,2,4
003 Altrei,15,,3,2,5
003 Altrei,16,,3,4,7
003 Altrei,17,,-,1,1
003 Altrei,18,,2,4,6
003 Altrei,19,,-,4,4
003 Altrei,20,,2,3,5
003 Altrei,21,,2,1,3
003 Altrei,22,,1,2,3
003 Altrei,23,,2,4,6
003 Altrei,24,,3,1,4
003 Altrei,25,,5,3,8
003 Altrei,26,,1,2,3
003 Altrei,27,,3,5,8
003 Altrei,28,,-,2,2
003 Altrei,29,,2,1,3
003 Altrei,30,,4,5,9
003 Altrei,31,,2,5,7
003 Altrei,32,,3,5,8
003 Altrei,33,,3,3,6
003 Altrei,34,,9,1,10
003 Altrei,35,,3,3,6
003 Altrei,36,,5,3,8
003 Altrei,37,,5,2,7
003 Altrei,38,,1,3,4
003 Altrei,39,,1,3,4
003 Altrei,40,,5,1,6
003 Altrei,41,,3,3,6
003 Altrei,42,,1,1,2
003 Altrei,43,,3,2,5
003 Altrei,44,,6,3,9
003 Altrei,45,,6,4,10
003 Altrei,46,,1,2,3
003 Altrei,47,,2,-,2
003 Altrei,48,,3,3,6
003 Altrei,49,,2,2,4
003 Altrei,50,,1,2,3
003 Altrei,51,,4,-,4
003 Altrei,52,,2,2,4
003 Altrei,53,,1,3,4
003 Altrei,54,,3,1,4
003 Altrei,55,,1,2,3
003 Altrei,56,,2,4,6
003 Altrei,57,,1,3,4
003 Altrei,58,,1,-,1
003 Altrei,59,,2,1,3
003 Altrei,60,,2,1,3
003 Altrei,61,,3,2,5
003 Altrei,62,,-,2,2
003 Altrei,63,,3,3,6
003 Altrei,64,,-,3,3
003 Altrei,65,,-,2,2
003 Altrei,66,,5,2,7
003 Altrei,67,,2,3,5
003 Altrei,68,,1,2,3
003 Altrei,69,,3,4,7
003 Altrei,70,,2,4,6
003 Altrei,71,,-,3,3
003 Altrei,72,,1,3,4
003 Altrei,73,,1,3,4
003 Altrei,74,,3,2,5
003 Altrei,75,,-,3,3
003 Altrei,76,,3,1,4
003 Altrei,77,,-,2,2
003 Altrei,78,,-,2,2
003 Altrei,79,,-,3,3
003 Altrei,81,,-,1,1
003 Altrei,82,,1,3,4
003 Altrei,83,,1,1,2
003 Altrei,84,,3,-,3
003 Altrei,85,,1,2,3
003 Altrei,87,,1,1,2
003 Altrei,88,,-,1,1
003 Altrei,90,,1,-,1
003 Altrei,91,,-,1,1
003 Altrei,92,,1,-,1
003 Altrei,96,,-,1,1
003 Altrei,97,,-,1,1
003 Altrei,Insgesamt,,191,201,392
004 Eppan a.d. Weinstr.,0,,76,70,146
004 Eppan a.d. Weinstr.,1,,63,60,123
004 Eppan a.d. Weinstr.,2,,74,65,139
004 Eppan a.d. Weinstr.,3,,74,84,158
004 Eppan a.d. Weinstr.,4,,64,64,128
004 Eppan a.d. Weinstr.,5,,71,59,130
004 Eppan a.d. Weinstr.,6,,80,59,139
004 Eppan a.d. Weinstr.,7,,76,57,133
004 Eppan a.d. Weinstr.,8,,78,75,153
004 Eppan a.d. Weinstr.,9,,71,60,131
004 Eppan a.d. Weinstr.,10,,79,65,144
004 Eppan a.d. Weinstr.,11,,75,54,129
004 Eppan a.d. Weinstr.,12,,79,72,151
004 Eppan a.d. Weinstr.,13,,62,62,124
004 Eppan a.d. Weinstr.,14,,66,65,131
004 Eppan a.d. Weinstr.,15,,53,71,124
004 Eppan a.d. Weinstr.,16,,74,64,138
004 Eppan a.d. Weinstr.,17,,68,58,126
004 Eppan a.d. Weinstr.,18,,79,69,148
004 Eppan a.d. Weinstr.,19,,82,50,132
004 Eppan a.d. Weinstr.,20,,70,64,134
004 Eppan a.d. Weinstr.,21,,76,75,151
004 Eppan a.d. Weinstr.,22,,68,85,153
004 Eppan a.d. Weinstr.,23,,78,79,157
004 Eppan a.d. Weinstr.,24,,86,109,195
004 Eppan a.d. Weinstr.,25,,98,79,177
004 Eppan a.d. Weinstr.,26,,113,115,228
004 Eppan a.d. Weinstr.,27,,115,107,222
004 Eppan a.d. Weinstr.,28,,106,93,199
004 Eppan a.d. Weinstr.,29,,129,118,247
004 Eppan a.d. Weinstr.,30,,106,125,231
004 Eppan a.d. Weinstr.,31,,108,110,218
004 Eppan a.d. Weinstr.,32,,119,108,227
004 Eppan a.d. Weinstr.,33,,100,117,217
004 Eppan a.d. Weinstr.,34,,113,103,216
004 Eppan a.d. Weinstr.,35,,131,98,229
004 Eppan a.d. Weinstr.,36,,98,110,208
004 Eppan a.d. Weinstr.,37,,117,99,216
004 Eppan a.d. Weinstr.,38,,100,97,197
004 Eppan a.d. Weinstr.,39,,97,90,187
004 Eppan a.d. Weinstr.,40,,84,68,152
004 Eppan a.d. Weinstr.,41,,85,91,176
004 Eppan a.d. Weinstr.,42,,68,92,160
004 Eppan a.d. Weinstr.,43,,82,77,159
004 Eppan a.d. Weinstr.,44,,75,79,154
004 Eppan a.d. Weinstr.,45,,83,70,153
004 Eppan a.d. Weinstr.,46,,60,71,131
004 Eppan a.d. Weinstr.,47,,64,62,126
004 Eppan a.d. Weinstr.,48,,80,69,149
004 Eppan a.d. Weinstr.,49,,67,83,150
004 Eppan a.d. Weinstr.,50,,83,72,155
004 Eppan a.d. Weinstr.,51,,63,50,113
004 Eppan a.d. Weinstr.,52,,71,84,155
004 Eppan a.d. Weinstr.,53,,96,78,174
004 Eppan a.d. Weinstr.,54,,100,80,180
004 Eppan a.d. Weinstr.,55,,69,104,173
004 Eppan a.d. Weinstr.,56,,82,66,148
004 Eppan a.d. Weinstr.,57,,59,81,140
004 Eppan a.d. Weinstr.,58,,65,50,115
004 Eppan a.d. Weinstr.,59,,49,57,106
004 Eppan a.d. Weinstr.,60,,49,53,102
004 Eppan a.d. Weinstr.,61,,45,46,91
004 Eppan a.d. Weinstr.,62,,37,59,96
004 Eppan a.d. Weinstr.,63,,60,61,121
004 Eppan a.d. Weinstr.,64,,51,54,105
004 Eppan a.d. Weinstr.,65,,46,63,109
004 Eppan a.d. Weinstr.,66,,55,71,126
004 Eppan a.d. Weinstr.,67,,55,59,114
004 Eppan a.d. Weinstr.,68,,49,52,101
004 Eppan a.d. Weinstr.,69,,40,51,91
004 Eppan a.d. Weinstr.,70,,52,48,100
004 Eppan a.d. Weinstr.,71,,45,62,107
004 Eppan a.d. Weinstr.,72,,31,77,108
004 Eppan a.d. Weinstr.,73,,32,52,84
004 Eppan a.d. Weinstr.,74,,27,52,79
004 Eppan a.d. Weinstr.,75,,32,52,84
004 Eppan a.d. Weinstr.,76,,23,36,59
004 Eppan a.d. Weinstr.,77,,20,40,60
004 Eppan a.d. Weinstr.,78,,13,25,38
004 Eppan a.d. Weinstr.,79,,16,14,30
004 Eppan a.d. Weinstr.,80,,16,20,36
004 Eppan a.d. Weinstr.,81,,19,20,39
004 Eppan a.d. Weinstr.,82,,20,45,65
004 Eppan a.d. Weinstr.,83,,12,35,47
004 Eppan a.d. Weinstr.,84,,11,25,36
004 Eppan a.d. Weinstr.,85,,8,34,42
004 Eppan a.d. Weinstr.,86,,4,19,23
004 Eppan a.d. Weinstr.,87,,4,13,17
004 Eppan a.d. Weinstr.,88,,3,17,20
004 Eppan a.d. Weinstr.,89,,5,14,19
004 Eppan a.d. Weinstr.,90,,3,6,9
004 Eppan a.d. Weinstr.,91,,2,10,12
004 Eppan a.d. Weinstr.,92,,1,7,8
004 Eppan a.d. Weinstr.,93,,-,4,4
004 Eppan a.d. Weinstr.,94,,-,3,3
004 Eppan a.d. Weinstr.,95,,1,1,2
004 Eppan a.d. Weinstr.,96,,1,2,3
004 Eppan a.d. Weinstr.,100,,-,1,1
004 Eppan a.d. Weinstr.,Insgesamt,,5.845,6.051,11.896
005 Hafling,0,,8,2,10
005 Hafling,1,,8,6,14
005 Hafling,2,,5,6,11
005 Hafling,3,,3,6,9
005 Hafling,4,,3,5,8
005 Hafling,5,,9,2,11
005 Hafling,6,,5,6,11
005 Hafling,7,,4,2,6
005 Hafling,8,,2,7,9
005 Hafling,9,,4,3,7
005 Hafling,10,,4,3,7
005 Hafling,11,,5,5,10
005 Hafling,12,,5,7,12
005 Hafling,13,,3,-,3
005 Hafling,14,,7,2,9
005 Hafling,15,,4,4,8
005 Hafling,16,,3,9,12
005 Hafling,17,,4,5,9
005 Hafling,18,,2,4,6
005 Hafling,19,,3,3,6
005 Hafling,20,,4,6,10
005 Hafling,21,,6,4,10
005 Hafling,22,,8,6,14
005 Hafling,23,,7,3,10
005 Hafling,24,,7,3,10
005 Hafling,25,,9,4,13
005 Hafling,26,,6,6,12
005 Hafling,27,,6,9,15
005 Hafling,28,,5,12,17
005 Hafling,29,,7,5,12
005 Hafling,30,,9,7,16
005 Hafling,31,,6,10,16
005 Hafling,32,,4,3,7
005 Hafling,33,,6,4,10
005 Hafling,34,,4,4,8
005 Hafling,35,,7,4,11
005 Hafling,36,,9,6,15
005 Hafling,37,,6,5,11
005 Hafling,38,,3,4,7
005 Hafling,39,,2,5,7
005 Hafling,40,,3,9,12
005 Hafling,41,,5,1,6
005 Hafling,42,,4,1,5
005 Hafling,43,,2,3,5
005 Hafling,44,,6,2,8
005 Hafling,45,,2,2,4
005 Hafling,46,,4,3,7
005 Hafling,47,,5,3,8
005 Hafling,48,,8,2,10
005 Hafling,49,,3,4,7
005 Hafling,50,,1,4,5
005 Hafling,51,,5,2,7
005 Hafling,52,,1,2,3
005 Hafling,53,,6,4,10
005 Hafling,54,,5,3,8
005 Hafling,55,,5,4,9
005 Hafling,56,,2,1,3
005 Hafling,57,,3,5,8
005 Hafling,58,,2,3,5
005 Hafling,59,,4,2,6
005 Hafling,60,,1,1,2
005 Hafling,61,,1,1,2
005 Hafling,62,,1,4,5
005 Hafling,63,,6,3,9
005 Hafling,64,,4,4,8
005 Hafling,65,,3,6,9
005 Hafling,66,,2,4,6
005 Hafling,67,,4,1,5
005 Hafling,68,,3,3,6
005 Hafling,69,,4,5,9
005 Hafling,70,,1,2,3
005 Hafling,71,,2,-,2
005 Hafling,72,,1,3,4
005 Hafling,73,,1,-,1
005 Hafling,74,,-,2,2
005 Hafling,75,,-,4,4
005 Hafling,76,,3,1,4
005 Hafling,77,,1,3,4
005 Hafling,78,,-,2,2
005 Hafling,79,,-,1,1
005 Hafling,80,,1,2,3
005 Hafling,81,,2,-,2
005 Hafling,82,,1,-,1
005 Hafling,83,,-,3,3
005 Hafling,84,,-,1,1
005 Hafling,85,,1,2,3
005 Hafling,86,,1,-,1
005 Hafling,87,,2,-,2
005 Hafling,90,,-,1,1
005 Hafling,92,,2,-,2
005 Hafling,Insgesamt,,336,316,652
006 Abtei,0,,24,14,38
006 Abtei,1,,24,26,50
006 Abtei,2,,18,15,33
006 Abtei,3,,16,19,35
006 Abtei,4,,24,14,38
006 Abtei,5,,20,14,34
006 Abtei,6,,22,15,37
006 Abtei,7,,15,14,29
006 Abtei,8,,13,8,21
006 Abtei,9,,19,12,31
006 Abtei,10,,16,17,33
006 Abtei,11,,11,14,25
006 Abtei,12,,11,20,31
006 Abtei,13,,15,11,26
006 Abtei,14,,17,20,37
006 Abtei,15,,18,18,36
006 Abtei,16,,23,15,38
006 Abtei,17,,10,23,33
006 Abtei,18,,21,26,47
006 Abtei,19,,19,28,47
006 Abtei,20,,24,24,48
006 Abtei,21,,18,28,46
006 Abtei,22,,20,26,46
006 Abtei,23,,21,24,45
006 Abtei,24,,38,27,65
006 Abtei,25,,15,30,45
006 Abtei,26,,28,31,59
006 Abtei,27,,26,32,58
006 Abtei,28,,22,32,54
006 Abtei,29,,33,36,69
006 Abtei,30,,20,28,48
006 Abtei,31,,30,20,50
006 Abtei,32,,24,31,55
006 Abtei,33,,26,27,53
006 Abtei,34,,24,28,52
006 Abtei,35,,21,27,48
006 Abtei,36,,24,20,44
006 Abtei,37,,26,22,48
006 Abtei,38,,17,24,41
006 Abtei,39,,18,15,33
006 Abtei,40,,18,17,35
006 Abtei,41,,17,14,31
006 Abtei,42,,11,16,27
006 Abtei,43,,16,19,35
006 Abtei,44,,12,12,24
006 Abtei,45,,12,12,24
006 Abtei,46,,14,20,34
006 Abtei,47,,13,18,31
006 Abtei,48,,25,18,43
006 Abtei,49,,16,15,31
006 Abtei,50,,27,18,45
006 Abtei,51,,15,20,35
006 Abtei,52,,14,18,32
006 Abtei,53,,13,11,24
006 Abtei,54,,19,11,30
006 Abtei,55,,18,24,42
006 Abtei,56,,19,19,38
006 Abtei,57,,17,13,30
006 Abtei,58,,15,19,34
006 Abtei,59,,9,19,28
006 Abtei,60,,21,10,31
006 Abtei,61,,13,20,33
006 Abtei,62,,15,18,33
006 Abtei,63,,11,17,28
006 Abtei,64,,9,6,15
006 Abtei,65,,13,14,27
006 Abtei,66,,17,12,29
006 Abtei,67,,12,8,20
006 Abtei,68,,10,16,26
006 Abtei,69,,9,10,19
006 Abtei,70,,11,7,18
006 Abtei,71,,11,7,18
006 Abtei,72,,6,10,16
006 Abtei,73,,8,16,24
006 Abtei,74,,8,6,14
006 Abtei,75,,5,7,12
006 Abtei,76,,4,16,20
006 Abtei,77,,2,5,7
006 Abtei,78,,3,4,7
006 Abtei,79,,-,6,6
006 Abtei,80,,1,3,4
006 Abtei,81,,1,4,5
006 Abtei,82,,3,5,8
006 Abtei,83,,3,2,5
006 Abtei,84,,3,7,10
006 Abtei,85,,1,5,6
006 Abtei,86,,1,5,6
006 Abtei,87,,4,5,9
006 Abtei,88,,1,4,5
006 Abtei,89,,-,2,2
006 Abtei,90,,1,2,3
006 Abtei,91,,-,3,3
006 Abtei,92,,1,-,1
006 Abtei,93,,1,-,1
006 Abtei,94,,2,1,3
006 Abtei,96,,1,1,2
006 Abtei,Insgesamt,,1.363,1.472,2.835
007 Barbian,0,,6,9,15
007 Barbian,1,,11,9,20
007 Barbian,2,,10,4,14
007 Barbian,3,,11,13,24
007 Barbian,4,,11,10,21
007 Barbian,5,,11,10,21
007 Barbian,6,,13,13,26
007 Barbian,7,,8,13,21
007 Barbian,8,,11,5,16
007 Barbian,9,,8,6,14
007 Barbian,10,,13,6,19
007 Barbian,11,,8,10,18
007 Barbian,12,,9,7,16
007 Barbian,13,,11,8,19
007 Barbian,14,,10,5,15
007 Barbian,15,,14,14,28
007 Barbian,16,,8,7,15
007 Barbian,17,,18,13,31
007 Barbian,18,,11,9,20
007 Barbian,19,,7,17,24
007 Barbian,20,,7,11,18
007 Barbian,21,,11,10,21
007 Barbian,22,,16,10,26
007 Barbian,23,,10,16,26
007 Barbian,24,,18,18,36
007 Barbian,25,,15,15,30
007 Barbian,26,,12,11,23
007 Barbian,27,,17,7,24
007 Barbian,28,,13,10,23
007 Barbian,29,,8,8,16
007 Barbian,30,,11,13,24
007 Barbian,31,,9,9,18
007 Barbian,32,,13,15,28
007 Barbian,33,,16,14,30
007 Barbian,34,,17,14,31
007 Barbian,35,,19,9,28
007 Barbian,36,,13,16,29
007 Barbian,37,,10,8,18
007 Barbian,38,,11,8,19
007 Barbian,39,,13,7,20
007 Barbian,40,,5,10,15
007 Barbian,41,,10,8,18
007 Barbian,42,,5,14,19
007 Barbian,43,,10,7,17
007 Barbian,44,,7,4,11
007 Barbian,45,,7,11,18
007 Barbian,46,,12,11,23
007 Barbian,47,,6,5,11
007 Barbian,48,,4,4,8
007 Barbian,49,,6,10,16
007 Barbian,50,,17,7,24
007 Barbian,51,,8,4,12
007 Barbian,52,,12,8,20
007 Barbian,53,,9,6,15
007 Barbian,54,,11,13,24
007 Barbian,55,,9,13,22
007 Barbian,56,,8,3,11
007 Barbian,57,,6,6,12
007 Barbian,58,,5,10,15
007 Barbian,59,,9,8,17
007 Barbian,60,,4,7,11
007 Barbian,61,,3,8,11
007 Barbian,62,,6,6,12
007 Barbian,63,,8,5,13
007 Barbian,64,,5,7,12
007 Barbian,65,,5,10,15
007 Barbian,66,,7,6,13
007 Barbian,67,,9,8,17
007 Barbian,68,,5,10,15
007 Barbian,69,,7,4,11
007 Barbian,70,,4,3,7
007 Barbian,71,,9,3,12
007 Barbian,72,,4,6,10
007 Barbian,73,,3,10,13
007 Barbian,74,,3,6,9
007 Barbian,75,,3,3,6
007 Barbian,76,,4,4,8
007 Barbian,77,,1,4,5
007 Barbian,78,,3,1,4
007 Barbian,79,,-,1,1
007 Barbian,80,,1,3,4
007 Barbian,81,,-,5,5
007 Barbian,82,,4,6,10
007 Barbian,83,,2,4,6
007 Barbian,84,,-,1,1
007 Barbian,85,,3,2,5
007 Barbian,86,,3,4,7
007 Barbian,87,,-,1,1
007 Barbian,88,,-,3,3
007 Barbian,89,,-,1,1
007 Barbian,92,,-,1,1
007 Barbian,Insgesamt,,740,722,1.462
008 Bozen,0,,384,399,783
008 Bozen,1,,391,358,749
008 Bozen,2,,416,394,810
008 Bozen,3,,386,389,775
008 Bozen,4,,390,371,761
008 Bozen,5,,445,368,813
008 Bozen,6,,426,378,804
008 Bozen,7,,412,372,784
008 Bozen,8,,397,395,792
008 Bozen,9,,332,372,704
008 Bozen,10,,368,352,720
008 Bozen,11,,395,359,754
008 Bozen,12,,374,370,744
008 Bozen,13,,395,345,740
008 Bozen,14,,402,382,784
008 Bozen,15,,403,375,778
008 Bozen,16,,438,386,824
008 Bozen,17,,387,410,797
008 Bozen,18,,447,417,864
008 Bozen,19,,482,421,903
008 Bozen,20,,488,497,985
008 Bozen,21,,592,560,1.152
008 Bozen,22,,641,614,1.255
008 Bozen,23,,665,702,1.367
008 Bozen,24,,752,684,1.436
008 Bozen,25,,851,783,1.634
008 Bozen,26,,822,656,1.478
008 Bozen,27,,897,758,1.655
008 Bozen,28,,812,743,1.555
008 Bozen,29,,812,777,1.589
008 Bozen,30,,896,816,1.712
008 Bozen,31,,909,812,1.721
008 Bozen,32,,908,885,1.793
008 Bozen,33,,821,771,1.592
008 Bozen,34,,803,756,1.559
008 Bozen,35,,772,714,1.486
008 Bozen,36,,717,677,1.394
008 Bozen,37,,707,649,1.356
008 Bozen,38,,696,686,1.382
008 Bozen,39,,669,700,1.369
008 Bozen,40,,662,653,1.315
008 Bozen,41,,640,632,1.272
008 Bozen,42,,647,594,1.241
008 Bozen,43,,567,602,1.169
008 Bozen,44,,584,644,1.228
008 Bozen,45,,564,653,1.217
008 Bozen,46,,638,679,1.317
008 Bozen,47,,658,658,1.316
008 Bozen,48,,691,733,1.424
008 Bozen,49,,704,837,1.541
008 Bozen,50,,788,908,1.696
008 Bozen,51,,590,626,1.216
008 Bozen,52,,647,763,1.410
008 Bozen,53,,687,774,1.461
008 Bozen,54,,715,767,1.482
008 Bozen,55,,806,808,1.614
008 Bozen,56,,746,774,1.520
008 Bozen,57,,660,774,1.434
008 Bozen,58,,730,702,1.432
008 Bozen,59,,615,624,1.239
008 Bozen,60,,577,622,1.199
008 Bozen,61,,550,606,1.156
008 Bozen,62,,563,618,1.181
008 Bozen,63,,486,610,1.096
008 Bozen,64,,514,619,1.133
008 Bozen,65,,522,618,1.140
008 Bozen,66,,526,639,1.165
008 Bozen,67,,424,618,1.042
008 Bozen,68,,453,572,1.025
008 Bozen,69,,440,580,1.020
008 Bozen,70,,497,566,1.063
008 Bozen,71,,393,593,986
008 Bozen,72,,385,599,984
008 Bozen,73,,410,603,1.013
008 Bozen,74,,393,639,1.032
008 Bozen,75,,327,595,922
008 Bozen,76,,330,576,906
008 Bozen,77,,186,358,544
008 Bozen,78,,118,236,354
008 Bozen,79,,136,252,388
008 Bozen,80,,137,255,392
008 Bozen,81,,198,368,566
008 Bozen,82,,205,347,552
008 Bozen,83,,201,367,568
008 Bozen,84,,173,344,517
008 Bozen,85,,138,292,430
008 Bozen,86,,94,233,327
008 Bozen,87,,80,209,289
008 Bozen,88,,70,174,244
008 Bozen,89,,34,155,189
008 Bozen,90,,44,121,165
008 Bozen,91,,23,78,101
008 Bozen,92,,13,82,95
008 Bozen,93,,10,65,75
008 Bozen,94,,9,35,44
008 Bozen,95,,6,23,29
008 Bozen,96,,4,22,26
008 Bozen,97,,7,13,20
008 Bozen,98,,2,8,10
008 Bozen,99,,2,4,6
008 Bozen,100,,-,3,3
008 Bozen,101,,-,3,3
008 Bozen,103,,-,2,2
008 Bozen,Insgesamt,,46.319,50.380,96.699
009 Prags,0,,2,4,6
009 Prags,1,,2,3,5
009 Prags,2,,5,6,11
009 Prags,3,,7,4,11
009 Prags,4,,6,3,9
009 Prags,5,,7,2,9
009 Prags,6,,4,2,6
009 Prags,7,,9,3,12
009 Prags,8,,3,3,6
009 Prags,9,,3,3,6
009 Prags,10,,6,5,11
009 Prags,11,,8,2,10
009 Prags,12,,5,3,8
009 Prags,13,,3,7,10
009 Prags,14,,3,5,8
009 Prags,15,,1,6,7
009 Prags,16,,4,1,5
009 Prags,17,,2,1,3
009 Prags,18,,6,3,9
009 Prags,19,,4,2,6
009 Prags,20,,5,4,9
009 Prags,21,,2,7,9
009 Prags,22,,4,4,8
009 Prags,23,,8,8,16
009 Prags,24,,3,1,4
009 Prags,25,,5,5,10
009 Prags,26,,6,3,9
009 Prags,27,,7,5,12
009 Prags,28,,8,7,15
009 Prags,29,,7,8,15
009 Prags,30,,7,4,11
009 Prags,31,,9,7,16
009 Prags,32,,8,6,14
009 Prags,33,,7,6,13
009 Prags,34,,4,6,10
009 Prags,35,,5,9,14
009 Prags,36,,7,3,10
009 Prags,37,,12,5,17
009 Prags,38,,6,3,9
009 Prags,39,,5,4,9
009 Prags,40,,3,6,9
009 Prags,41,,3,4,7
009 Prags,42,,6,4,10
009 Prags,43,,4,2,6
009 Prags,44,,3,5,8
009 Prags,45,,3,1,4
009 Prags,46,,5,1,6
009 Prags,47,,1,2,3
009 Prags,48,,5,1,6
009 Prags,49,,1,-,1
009 Prags,50,,2,4,6
009 Prags,51,,2,2,4
009 Prags,52,,5,5,10
009 Prags,53,,1,4,5
009 Prags,54,,4,4,8
009 Prags,55,,5,2,7
009 Prags,56,,1,3,4
009 Prags,57,,3,5,8
009 Prags,58,,5,3,8
009 Prags,59,,1,3,4
009 Prags,60,,2,2,4
009 Prags,61,,2,4,6
009 Prags,62,,4,2,6
009 Prags,63,,5,2,7
009 Prags,64,,6,7,13
009 Prags,65,,1,4,5
009 Prags,66,,2,1,3
009 Prags,67,,5,1,6
009 Prags,68,,3,2,5
009 Prags,69,,3,7,10
009 Prags,70,,3,4,7
009 Prags,71,,2,5,7
009 Prags,72,,4,2,6
009 Prags,73,,-,5,5
009 Prags,74,,3,2,5
009 Prags,75,,2,3,5
009 Prags,76,,1,1,2
009 Prags,77,,3,4,7
009 Prags,78,,-,1,1
009 Prags,79,,2,2,4
009 Prags,80,,-,1,1
009 Prags,81,,1,2,3
009 Prags,82,,1,2,3
009 Prags,83,,-,2,2
009 Prags,84,,-,1,1
009 Prags,85,,-,1,1
009 Prags,87,,1,-,1
009 Prags,88,,-,2,2
009 Prags,89,,-,1,1
009 Prags,92,,2,-,2
009 Prags,101,,-,1,1
009 Prags,Insgesamt,,336,308,644
010 Brenner,0,,8,11,19
010 Brenner,1,,9,9,18
010 Brenner,2,,19,9,28
010 Brenner,3,,12,9,21
010 Brenner,4,,10,8,18
010 Brenner,5,,8,18,26
010 Brenner,6,,13,8,21
010 Brenner,7,,15,4,19
010 Brenner,8,,12,5,17
010 Brenner,9,,8,9,17
010 Brenner,10,,11,11,22
010 Brenner,11,,20,11,31
010 Brenner,12,,14,16,30
010 Brenner,13,,16,17,33
010 Brenner,14,,12,7,19
010 Brenner,15,,9,15,24
010 Brenner,16,,12,15,27
010 Brenner,17,,13,9,22
010 Brenner,18,,17,11,28
010 Brenner,19,,17,11,28
010 Brenner,20,,12,11,23
010 Brenner,21,,13,19,32
010 Brenner,22,,21,13,34
010 Brenner,23,,29,15,44
010 Brenner,24,,38,22,60
010 Brenner,25,,37,15,52
010 Brenner,26,,27,26,53
010 Brenner,27,,17,20,37
010 Brenner,28,,19,19,38
010 Brenner,29,,19,20,39
010 Brenner,30,,25,16,41
010 Brenner,31,,28,19,47
010 Brenner,32,,32,16,48
010 Brenner,33,,16,22,38
010 Brenner,34,,18,11,29
010 Brenner,35,,25,12,37
010 Brenner,36,,21,18,39
010 Brenner,37,,21,15,36
010 Brenner,38,,20,11,31
010 Brenner,39,,18,18,36
010 Brenner,40,,21,13,34
010 Brenner,41,,14,11,25
010 Brenner,42,,12,15,27
010 Brenner,43,,11,18,29
010 Brenner,44,,21,9,30
010 Brenner,45,,20,11,31
010 Brenner,46,,14,14,28
010 Brenner,47,,16,16,32
010 Brenner,48,,5,8,13
010 Brenner,49,,21,13,34
010 Brenner,50,,13,17,30
010 Brenner,51,,10,8,18
010 Brenner,52,,21,13,34
010 Brenner,53,,22,14,36
010 Brenner,54,,10,10,20
010 Brenner,55,,13,13,26
010 Brenner,56,,12,12,24
010 Brenner,57,,12,8,20
010 Brenner,58,,11,18,29
010 Brenner,59,,10,14,24
010 Brenner,60,,14,6,20
010 Brenner,61,,7,6,13
010 Brenner,62,,12,9,21
010 Brenner,63,,7,8,15
010 Brenner,64,,3,3,6
010 Brenner,65,,10,12,22
010 Brenner,66,,9,12,21
010 Brenner,67,,13,11,24
010 Brenner,68,,13,11,24
010 Brenner,69,,9,5,14
010 Brenner,70,,11,11,22
010 Brenner,71,,5,12,17
010 Brenner,72,,4,10,14
010 Brenner,73,,5,11,16
010 Brenner,74,,2,9,11
010 Brenner,75,,4,5,9
010 Brenner,76,,7,9,16
010 Brenner,77,,3,2,5
010 Brenner,78,,2,2,4
010 Brenner,79,,1,6,7
010 Brenner,80,,2,-,2
010 Brenner,81,,3,3,6
010 Brenner,82,,1,7,8
010 Brenner,83,,2,5,7
010 Brenner,84,,-,5,5
010 Brenner,85,,5,1,6
010 Brenner,86,,1,5,6
010 Brenner,87,,2,2,4
010 Brenner,88,,2,-,2
010 Brenner,89,,-,1,1
010 Brenner,90,,-,4,4
010 Brenner,91,,1,1,2
010 Brenner,92,,-,1,1
010 Brenner,93,,-,2,2
010 Brenner,94,,1,1,2
010 Brenner,95,,-,1,1
010 Brenner,Insgesamt,,1.161,1.005,2.166
011 Brixen,0,,102,93,195
011 Brixen,1,,106,107,213
011 Brixen,2,,110,115,225
011 Brixen,3,,98,101,199
011 Brixen,4,,103,115,218
011 Brixen,5,,106,107,213
011 Brixen,6,,90,104,194
011 Brixen,7,,110,84,194
011 Brixen,8,,104,92,196
011 Brixen,9,,96,84,180
011 Brixen,10,,99,105,204
011 Brixen,11,,114,87,201
011 Brixen,12,,111,82,193
011 Brixen,13,,106,121,227
011 Brixen,14,,113,100,213
011 Brixen,15,,104,93,197
011 Brixen,16,,97,99,196
011 Brixen,17,,117,93,210
011 Brixen,18,,89,100,189
011 Brixen,19,,114,100,214
011 Brixen,20,,123,112,235
011 Brixen,21,,105,94,199
011 Brixen,22,,127,126,253
011 Brixen,23,,126,135,261
011 Brixen,24,,131,139,270
011 Brixen,25,,142,158,300
011 Brixen,26,,156,142,298
011 Brixen,27,,180,164,344
011 Brixen,28,,164,160,324
011 Brixen,29,,161,154,315
011 Brixen,30,,169,173,342
011 Brixen,31,,179,143,322
011 Brixen,32,,177,179,356
011 Brixen,33,,155,162,317
011 Brixen,34,,156,156,312
011 Brixen,35,,147,159,306
011 Brixen,36,,151,142,293
011 Brixen,37,,144,140,284
011 Brixen,38,,154,111,265
011 Brixen,39,,135,132,267
011 Brixen,40,,105,133,238
011 Brixen,41,,130,90,220
011 Brixen,42,,99,105,204
011 Brixen,43,,84,108,192
011 Brixen,44,,106,101,207
011 Brixen,45,,102,101,203
011 Brixen,46,,109,102,211
011 Brixen,47,,84,125,209
011 Brixen,48,,115,119,234
011 Brixen,49,,89,112,201
011 Brixen,50,,106,116,222
011 Brixen,51,,72,100,172
011 Brixen,52,,122,104,226
011 Brixen,53,,141,122,263
011 Brixen,54,,101,102,203
011 Brixen,55,,114,120,234
011 Brixen,56,,91,124,215
011 Brixen,57,,106,113,219
011 Brixen,58,,96,97,193
011 Brixen,59,,90,97,187
011 Brixen,60,,77,91,168
011 Brixen,61,,85,87,172
011 Brixen,62,,86,100,186
011 Brixen,63,,86,70,156
011 Brixen,64,,76,83,159
011 Brixen,65,,79,89,168
011 Brixen,66,,81,99,180
011 Brixen,67,,62,105,167
011 Brixen,68,,69,81,150
011 Brixen,69,,54,101,155
011 Brixen,70,,63,82,145
011 Brixen,71,,60,86,146
011 Brixen,72,,54,94,148
011 Brixen,73,,58,69,127
011 Brixen,74,,51,91,142
011 Brixen,75,,46,87,133
011 Brixen,76,,44,83,127
011 Brixen,77,,34,57,91
011 Brixen,78,,22,37,59
011 Brixen,79,,20,44,64
011 Brixen,80,,17,28,45
011 Brixen,81,,17,46,63
011 Brixen,82,,30,56,86
011 Brixen,83,,16,60,76
011 Brixen,84,,21,54,75
011 Brixen,85,,12,44,56
011 Brixen,86,,15,44,59
011 Brixen,87,,12,24,36
011 Brixen,88,,13,30,43
011 Brixen,89,,4,24,28
011 Brixen,90,,3,22,25
011 Brixen,91,,4,19,23
011 Brixen,92,,1,3,4
011 Brixen,93,,2,5,7
011 Brixen,94,,1,12,13
011 Brixen,95,,1,11,12
011 Brixen,96,,-,8,8
011 Brixen,97,,-,2,2
011 Brixen,98,,1,-,1
011 Brixen,99,,1,1,2
011 Brixen,102,,-,1,1
011 Brixen,104,,1,1,2
011 Brixen,Insgesamt,,8.512,9.185,17.697
012 Branzoll,0,,17,5,22
012 Branzoll,1,,11,11,22
012 Branzoll,2,,16,7,23
012 Branzoll,3,,16,16,32
012 Branzoll,4,,15,9,24
012 Branzoll,5,,9,19,28
012 Branzoll,6,,7,17,24
012 Branzoll,7,,11,11,22
012 Branzoll,8,,16,13,29
012 Branzoll,9,,11,6,17
012 Branzoll,10,,9,13,22
012 Branzoll,11,,14,15,29
012 Branzoll,12,,15,11,26
012 Branzoll,13,,13,11,24
012 Branzoll,14,,14,12,26
012 Branzoll,15,,11,13,24
012 Branzoll,16,,7,13,20
012 Branzoll,17,,11,7,18
012 Branzoll,18,,10,11,21
012 Branzoll,19,,11,11,22
012 Branzoll,20,,15,11,26
012 Branzoll,21,,9,13,22
012 Branzoll,22,,14,21,35
012 Branzoll,23,,19,13,32
012 Branzoll,24,,20,10,30
012 Branzoll,25,,16,14,30
012 Branzoll,26,,18,25,43
012 Branzoll,27,,21,17,38
012 Branzoll,28,,20,22,42
012 Branzoll,29,,19,15,34
012 Branzoll,30,,18,18,36
012 Branzoll,31,,19,21,40
012 Branzoll,32,,30,21,51
012 Branzoll,33,,18,15,33
012 Branzoll,34,,19,18,37
012 Branzoll,35,,25,28,53
012 Branzoll,36,,20,23,43
012 Branzoll,37,,13,24,37
012 Branzoll,38,,21,16,37
012 Branzoll,39,,27,18,45
012 Branzoll,40,,14,13,27
012 Branzoll,41,,15,16,31
012 Branzoll,42,,24,16,40
012 Branzoll,43,,14,23,37
012 Branzoll,44,,16,16,32
012 Branzoll,45,,13,12,25
012 Branzoll,46,,19,16,35
012 Branzoll,47,,14,17,31
012 Branzoll,48,,12,15,27
012 Branzoll,49,,13,15,28
012 Branzoll,50,,15,19,34
012 Branzoll,51,,14,6,20
012 Branzoll,52,,10,10,20
012 Branzoll,53,,15,11,26
012 Branzoll,54,,20,7,27
012 Branzoll,55,,18,12,30
012 Branzoll,56,,10,14,24
012 Branzoll,57,,16,11,27
012 Branzoll,58,,10,11,21
012 Branzoll,59,,5,12,17
012 Branzoll,60,,10,10,20
012 Branzoll,61,,8,11,19
012 Branzoll,62,,6,11,17
012 Branzoll,63,,19,11,30
012 Branzoll,64,,10,11,21
012 Branzoll,65,,5,9,14
012 Branzoll,66,,9,17,26
012 Branzoll,67,,7,11,18
012 Branzoll,68,,9,13,22
012 Branzoll,69,,4,8,12
012 Branzoll,70,,12,11,23
012 Branzoll,71,,7,8,15
012 Branzoll,72,,4,9,13
012 Branzoll,73,,10,13,23
012 Branzoll,74,,5,6,11
012 Branzoll,75,,4,12,16
012 Branzoll,76,,1,7,8
012 Branzoll,77,,4,5,9
012 Branzoll,78,,4,5,9
012 Branzoll,79,,-,4,4
012 Branzoll,80,,3,2,5
012 Branzoll,81,,3,3,6
012 Branzoll,82,,-,5,5
012 Branzoll,83,,3,7,10
012 Branzoll,84,,1,5,6
012 Branzoll,85,,4,4,8
012 Branzoll,86,,1,2,3
012 Branzoll,87,,2,5,7
012 Branzoll,88,,1,2,3
012 Branzoll,89,,3,2,5
012 Branzoll,90,,1,-,1
012 Branzoll,91,,-,2,2
012 Branzoll,92,,-,1,1
012 Branzoll,93,,-,1,1
012 Branzoll,94,,-,1,1
012 Branzoll,95,,-,1,1
012 Branzoll,Insgesamt,,1.072,1.101,2.173
013 Bruneck,0,,71,80,151
013 Bruneck,1,,62,69,131
013 Bruneck,2,,80,70,150
013 Bruneck,3,,73,66,139
013 Bruneck,4,,87,76,163
013 Bruneck,5,,80,55,135
013 Bruneck,6,,85,69,154
013 Bruneck,7,,75,77,152
013 Bruneck,8,,63,70,133
013 Bruneck,9,,60,59,119
013 Bruneck,10,,100,69,169
013 Bruneck,11,,72,64,136
013 Bruneck,12,,76,73,149
013 Bruneck,13,,66,72,138
013 Bruneck,14,,70,73,143
013 Bruneck,15,,79,84,163
013 Bruneck,16,,100,89,189
013 Bruneck,17,,85,94,179
013 Bruneck,18,,113,86,199
013 Bruneck,19,,98,75,173
013 Bruneck,20,,84,97,181
013 Bruneck,21,,92,111,203
013 Bruneck,22,,111,90,201
013 Bruneck,23,,121,106,227
013 Bruneck,24,,110,109,219
013 Bruneck,25,,125,110,235
013 Bruneck,26,,109,114,223
013 Bruneck,27,,125,107,232
013 Bruneck,28,,110,135,245
013 Bruneck,29,,127,107,234
013 Bruneck,30,,125,100,225
013 Bruneck,31,,141,126,267
013 Bruneck,32,,125,123,248
013 Bruneck,33,,114,116,230
013 Bruneck,34,,116,103,219
013 Bruneck,35,,116,103,219
013 Bruneck,36,,100,113,213
013 Bruneck,37,,102,96,198
013 Bruneck,38,,103,108,211
013 Bruneck,39,,83,99,182
013 Bruneck,40,,84,95,179
013 Bruneck,41,,84,82,166
013 Bruneck,42,,94,84,178
013 Bruneck,43,,70,97,167
013 Bruneck,44,,83,100,183
013 Bruneck,45,,76,90,166
013 Bruneck,46,,87,92,179
013 Bruneck,47,,90,92,182
013 Bruneck,48,,85,107,192
013 Bruneck,49,,98,70,168
013 Bruneck,50,,100,84,184
013 Bruneck,51,,60,67,127
013 Bruneck,52,,92,94,186
013 Bruneck,53,,100,91,191
013 Bruneck,54,,95,91,186
013 Bruneck,55,,85,93,178
013 Bruneck,56,,84,85,169
013 Bruneck,57,,88,87,175
013 Bruneck,58,,62,56,118
013 Bruneck,59,,58,63,121
013 Bruneck,60,,58,57,115
013 Bruneck,61,,50,56,106
013 Bruneck,62,,50,49,99
013 Bruneck,63,,59,63,122
013 Bruneck,64,,63,51,114
013 Bruneck,65,,45,53,98
013 Bruneck,66,,46,71,117
013 Bruneck,67,,45,61,106
013 Bruneck,68,,47,62,109
013 Bruneck,69,,41,51,92
013 Bruneck,70,,36,43,79
013 Bruneck,71,,35,52,87
013 Bruneck,72,,27,67,94
013 Bruneck,73,,44,51,95
013 Bruneck,74,,34,48,82
013 Bruneck,75,,27,33,60
013 Bruneck,76,,24,50,74
013 Bruneck,77,,21,35,56
013 Bruneck,78,,11,25,36
013 Bruneck,79,,7,23,30
013 Bruneck,80,,10,33,43
013 Bruneck,81,,14,25,39
013 Bruneck,82,,13,28,41
013 Bruneck,83,,14,43,57
013 Bruneck,84,,15,29,44
013 Bruneck,85,,5,33,38
013 Bruneck,86,,9,24,33
013 Bruneck,87,,16,17,33
013 Bruneck,88,,10,14,24
013 Bruneck,89,,6,16,22
013 Bruneck,90,,4,15,19
013 Bruneck,91,,3,5,8
013 Bruneck,92,,5,2,7
013 Bruneck,93,,3,6,9
013 Bruneck,94,,-,4,4
013 Bruneck,95,,-,1,1
013 Bruneck,96,,-,2,2
013 Bruneck,97,,1,-,1
013 Bruneck,98,,-,2,2
013 Bruneck,99,,-,1,1
013 Bruneck,Insgesamt,,6.407,6.664,13.071
014 Kuens,0,,4,1,5
014 Kuens,1,,2,3,5
014 Kuens,2,,1,4,5
014 Kuens,3,,3,3,6
014 Kuens,4,,3,2,5
014 Kuens,5,,2,2,4
014 Kuens,6,,3,2,5
014 Kuens,7,,3,2,5
014 Kuens,8,,1,3,4
014 Kuens,9,,3,-,3
014 Kuens,10,,1,-,1
014 Kuens,12,,1,-,1
014 Kuens,13,,2,2,4
014 Kuens,14,,2,-,2
014 Kuens,15,,2,-,2
014 Kuens,16,,3,2,5
014 Kuens,17,,1,1,2
014 Kuens,18,,2,-,2
014 Kuens,19,,2,3,5
014 Kuens,20,,3,2,5
014 Kuens,21,,3,2,5
014 Kuens,22,,4,5,9
014 Kuens,23,,-,3,3
014 Kuens,24,,4,2,6
014 Kuens,25,,2,4,6
014 Kuens,26,,6,3,9
014 Kuens,27,,4,-,4
014 Kuens,28,,3,4,7
014 Kuens,29,,4,10,14
014 Kuens,30,,3,5,8
014 Kuens,31,,7,1,8
014 Kuens,32,,5,3,8
014 Kuens,33,,9,3,12
014 Kuens,34,,5,3,8
014 Kuens,35,,-,4,4
014 Kuens,36,,-,1,1
014 Kuens,37,,1,-,1
014 Kuens,38,,1,4,5
014 Kuens,39,,4,-,4
014 Kuens,40,,2,-,2
014 Kuens,41,,1,2,3
014 Kuens,43,,1,1,2
014 Kuens,44,,-,1,1
014 Kuens,46,,1,3,4
014 Kuens,47,,2,2,4
014 Kuens,48,,3,1,4
014 Kuens,49,,1,2,3
014 Kuens,50,,1,2,3
014 Kuens,51,,4,-,4
014 Kuens,53,,-,2,2
014 Kuens,54,,-,4,4
014 Kuens,55,,-,2,2
014 Kuens,56,,-,1,1
014 Kuens,57,,4,2,6
014 Kuens,58,,3,2,5
014 Kuens,59,,1,3,4
014 Kuens,60,,2,3,5
014 Kuens,61,,1,3,4
014 Kuens,62,,-,1,1
014 Kuens,63,,2,1,3
014 Kuens,64,,4,2,6
014 Kuens,65,,3,2,5
014 Kuens,66,,3,2,5
014 Kuens,67,,1,-,1
014 Kuens,68,,1,-,1
014 Kuens,69,,1,2,3
014 Kuens,70,,1,-,1
014 Kuens,74,,-,2,2
014 Kuens,75,,-,1,1
014 Kuens,77,,-,1,1
014 Kuens,80,,1,1,2
014 Kuens,81,,1,-,1
014 Kuens,83,,-,1,1
014 Kuens,84,,1,-,1
014 Kuens,86,,1,-,1
014 Kuens,88,,-,1,1
014 Kuens,89,,-,1,1
014 Kuens,Insgesamt,,156,143,299
015 Kaltern a.d. Weinstr.,0,,32,41,73
015 Kaltern a.d. Weinstr.,1,,35,36,71
015 Kaltern a.d. Weinstr.,2,,27,36,63
015 Kaltern a.d. Weinstr.,3,,34,38,72
015 Kaltern a.d. Weinstr.,4,,40,37,77
015 Kaltern a.d. Weinstr.,5,,30,41,71
015 Kaltern a.d. Weinstr.,6,,37,36,73
015 Kaltern a.d. Weinstr.,7,,53,26,79
015 Kaltern a.d. Weinstr.,8,,40,33,73
015 Kaltern a.d. Weinstr.,9,,41,31,72
015 Kaltern a.d. Weinstr.,10,,50,40,90
015 Kaltern a.d. Weinstr.,11,,47,36,83
015 Kaltern a.d. Weinstr.,12,,37,33,70
015 Kaltern a.d. Weinstr.,13,,42,37,79
015 Kaltern a.d. Weinstr.,14,,43,43,86
015 Kaltern a.d. Weinstr.,15,,45,34,79
015 Kaltern a.d. Weinstr.,16,,40,41,81
015 Kaltern a.d. Weinstr.,17,,43,39,82
015 Kaltern a.d. Weinstr.,18,,42,28,70
015 Kaltern a.d. Weinstr.,19,,26,37,63
015 Kaltern a.d. Weinstr.,20,,35,41,76
015 Kaltern a.d. Weinstr.,21,,32,40,72
015 Kaltern a.d. Weinstr.,22,,47,44,91
015 Kaltern a.d. Weinstr.,23,,36,48,84
015 Kaltern a.d. Weinstr.,24,,43,48,91
015 Kaltern a.d. Weinstr.,25,,47,35,82
015 Kaltern a.d. Weinstr.,26,,56,61,117
015 Kaltern a.d. Weinstr.,27,,53,64,117
015 Kaltern a.d. Weinstr.,28,,60,64,124
015 Kaltern a.d. Weinstr.,29,,50,51,101
015 Kaltern a.d. Weinstr.,30,,55,62,117
015 Kaltern a.d. Weinstr.,31,,55,58,113
015 Kaltern a.d. Weinstr.,32,,84,51,135
015 Kaltern a.d. Weinstr.,33,,60,55,115
015 Kaltern a.d. Weinstr.,34,,58,63,121
015 Kaltern a.d. Weinstr.,35,,65,61,126
015 Kaltern a.d. Weinstr.,36,,55,63,118
015 Kaltern a.d. Weinstr.,37,,52,51,103
015 Kaltern a.d. Weinstr.,38,,56,57,113
015 Kaltern a.d. Weinstr.,39,,50,54,104
015 Kaltern a.d. Weinstr.,40,,62,45,107
015 Kaltern a.d. Weinstr.,41,,56,38,94
015 Kaltern a.d. Weinstr.,42,,38,48,86
015 Kaltern a.d. Weinstr.,43,,35,36,71
015 Kaltern a.d. Weinstr.,44,,40,51,91
015 Kaltern a.d. Weinstr.,45,,35,32,67
015 Kaltern a.d. Weinstr.,46,,45,34,79
015 Kaltern a.d. Weinstr.,47,,32,40,72
015 Kaltern a.d. Weinstr.,48,,41,39,80
015 Kaltern a.d. Weinstr.,49,,39,57,96
015 Kaltern a.d. Weinstr.,50,,54,39,93
015 Kaltern a.d. Weinstr.,51,,38,37,75
015 Kaltern a.d. Weinstr.,52,,45,44,89
015 Kaltern a.d. Weinstr.,53,,34,36,70
015 Kaltern a.d. Weinstr.,54,,38,45,83
015 Kaltern a.d. Weinstr.,55,,44,43,87
015 Kaltern a.d. Weinstr.,56,,34,42,76
015 Kaltern a.d. Weinstr.,57,,25,33,58
015 Kaltern a.d. Weinstr.,58,,41,43,84
015 Kaltern a.d. Weinstr.,59,,32,34,66
015 Kaltern a.d. Weinstr.,60,,24,25,49
015 Kaltern a.d. Weinstr.,61,,28,25,53
015 Kaltern a.d. Weinstr.,62,,27,26,53
015 Kaltern a.d. Weinstr.,63,,30,37,67
015 Kaltern a.d. Weinstr.,64,,31,33,64
015 Kaltern a.d. Weinstr.,65,,28,40,68
015 Kaltern a.d. Weinstr.,66,,37,43,80
015 Kaltern a.d. Weinstr.,67,,28,32,60
015 Kaltern a.d. Weinstr.,68,,26,35,61
015 Kaltern a.d. Weinstr.,69,,24,42,66
015 Kaltern a.d. Weinstr.,70,,23,33,56
015 Kaltern a.d. Weinstr.,71,,24,40,64
015 Kaltern a.d. Weinstr.,72,,28,33,61
015 Kaltern a.d. Weinstr.,73,,17,34,51
015 Kaltern a.d. Weinstr.,74,,20,34,54
015 Kaltern a.d. Weinstr.,75,,21,40,61
015 Kaltern a.d. Weinstr.,76,,14,30,44
015 Kaltern a.d. Weinstr.,77,,10,20,30
015 Kaltern a.d. Weinstr.,78,,9,11,20
015 Kaltern a.d. Weinstr.,79,,3,16,19
015 Kaltern a.d. Weinstr.,80,,3,10,13
015 Kaltern a.d. Weinstr.,81,,3,18,21
015 Kaltern a.d. Weinstr.,82,,11,19,30
015 Kaltern a.d. Weinstr.,83,,11,22,33
015 Kaltern a.d. Weinstr.,84,,9,30,39
015 Kaltern a.d. Weinstr.,85,,5,13,18
015 Kaltern a.d. Weinstr.,86,,5,10,15
015 Kaltern a.d. Weinstr.,87,,4,15,19
015 Kaltern a.d. Weinstr.,88,,5,6,11
015 Kaltern a.d. Weinstr.,89,,2,12,14
015 Kaltern a.d. Weinstr.,90,,2,7,9
015 Kaltern a.d. Weinstr.,91,,1,4,5
015 Kaltern a.d. Weinstr.,92,,3,5,8
015 Kaltern a.d. Weinstr.,93,,1,4,5
015 Kaltern a.d. Weinstr.,94,,-,1,1
015 Kaltern a.d. Weinstr.,95,,-,1,1
015 Kaltern a.d. Weinstr.,103,,-,1,1
015 Kaltern a.d. Weinstr.,Insgesamt,,3.158,3.417,6.575
016 Freienfeld,0,,24,11,35
016 Freienfeld,1,,16,13,29
016 Freienfeld,2,,12,8,20
016 Freienfeld,3,,16,10,26
016 Freienfeld,4,,18,22,40
016 Freienfeld,5,,12,13,25
016 Freienfeld,6,,19,18,37
016 Freienfeld,7,,27,21,48
016 Freienfeld,8,,18,13,31
016 Freienfeld,9,,14,15,29
016 Freienfeld,10,,15,14,29
016 Freienfeld,11,,15,14,29
016 Freienfeld,12,,23,15,38
016 Freienfeld,13,,20,19,39
016 Freienfeld,14,,14,17,31
016 Freienfeld,15,,24,23,47
016 Freienfeld,16,,18,15,33
016 Freienfeld,17,,19,22,41
016 Freienfeld,18,,14,18,32
016 Freienfeld,19,,15,19,34
016 Freienfeld,20,,17,10,27
016 Freienfeld,21,,18,24,42
016 Freienfeld,22,,20,18,38
016 Freienfeld,23,,19,16,35
016 Freienfeld,24,,22,23,45
016 Freienfeld,25,,22,22,44
016 Freienfeld,26,,23,20,43
016 Freienfeld,27,,19,20,39
016 Freienfeld,28,,20,25,45
016 Freienfeld,29,,20,28,48
016 Freienfeld,30,,22,19,41
016 Freienfeld,31,,29,15,44
016 Freienfeld,32,,27,22,49
016 Freienfeld,33,,23,15,38
016 Freienfeld,34,,27,31,58
016 Freienfeld,35,,23,20,43
016 Freienfeld,36,,25,22,47
016 Freienfeld,37,,30,13,43
016 Freienfeld,38,,18,19,37
016 Freienfeld,39,,13,17,30
016 Freienfeld,40,,22,15,37
016 Freienfeld,41,,21,10,31
016 Freienfeld,42,,18,19,37
016 Freienfeld,43,,20,10,30
016 Freienfeld,44,,12,20,32
016 Freienfeld,45,,15,13,28
016 Freienfeld,46,,22,11,33
016 Freienfeld,47,,18,12,30
016 Freienfeld,48,,18,12,30
016 Freienfeld,49,,7,14,21
016 Freienfeld,50,,11,16,27
016 Freienfeld,51,,11,2,13
016 Freienfeld,52,,12,6,18
016 Freienfeld,53,,15,12,27
016 Freienfeld,54,,13,10,23
016 Freienfeld,55,,13,12,25
016 Freienfeld,56,,13,4,17
016 Freienfeld,57,,11,10,21
016 Freienfeld,58,,12,12,24
016 Freienfeld,59,,8,11,19
016 Freienfeld,60,,9,15,24
016 Freienfeld,61,,11,12,23
016 Freienfeld,62,,6,7,13
016 Freienfeld,63,,13,8,21
016 Freienfeld,64,,14,10,24
016 Freienfeld,65,,9,9,18
016 Freienfeld,66,,9,9,18
016 Freienfeld,67,,6,6,12
016 Freienfeld,68,,9,6,15
016 Freienfeld,69,,7,9,16
016 Freienfeld,70,,9,16,25
016 Freienfeld,71,,8,11,19
016 Freienfeld,72,,10,8,18
016 Freienfeld,73,,3,18,21
016 Freienfeld,74,,3,10,13
016 Freienfeld,75,,3,3,6
016 Freienfeld,76,,10,5,15
016 Freienfeld,77,,3,5,8
016 Freienfeld,78,,3,5,8
016 Freienfeld,79,,2,5,7
016 Freienfeld,80,,2,3,5
016 Freienfeld,81,,1,5,6
016 Freienfeld,82,,4,10,14
016 Freienfeld,83,,3,3,6
016 Freienfeld,84,,1,3,4
016 Freienfeld,85,,4,4,8
016 Freienfeld,86,,4,2,6
016 Freienfeld,87,,1,1,2
016 Freienfeld,88,,-,5,5
016 Freienfeld,89,,2,4,6
016 Freienfeld,90,,-,2,2
016 Freienfeld,91,,-,2,2
016 Freienfeld,92,,-,1,1
016 Freienfeld,94,,-,2,2
016 Freienfeld,Insgesamt,,1.251,1.174,2.425
017 Sand in Taufers,0,,27,26,53
017 Sand in Taufers,1,,32,29,61
017 Sand in Taufers,2,,40,33,73
017 Sand in Taufers,3,,25,32,57
017 Sand in Taufers,4,,32,35,67
017 Sand in Taufers,5,,26,34,60
017 Sand in Taufers,6,,23,30,53
017 Sand in Taufers,7,,27,28,55
017 Sand in Taufers,8,,28,29,57
017 Sand in Taufers,9,,23,23,46
017 Sand in Taufers,10,,22,20,42
017 Sand in Taufers,11,,23,25,48
017 Sand in Taufers,12,,31,24,55
017 Sand in Taufers,13,,34,29,63
017 Sand in Taufers,14,,24,39,63
017 Sand in Taufers,15,,35,33,68
017 Sand in Taufers,16,,31,36,67
017 Sand in Taufers,17,,31,39,70
017 Sand in Taufers,18,,38,34,72
017 Sand in Taufers,19,,36,36,72
017 Sand in Taufers,20,,40,34,74
017 Sand in Taufers,21,,44,43,87
017 Sand in Taufers,22,,61,41,102
017 Sand in Taufers,23,,57,38,95
017 Sand in Taufers,24,,50,54,104
017 Sand in Taufers,25,,44,47,91
017 Sand in Taufers,26,,39,58,97
017 Sand in Taufers,27,,57,41,98
017 Sand in Taufers,28,,50,39,89
017 Sand in Taufers,29,,31,45,76
017 Sand in Taufers,30,,51,33,84
017 Sand in Taufers,31,,49,35,84
017 Sand in Taufers,32,,49,42,91
017 Sand in Taufers,33,,52,47,99
017 Sand in Taufers,34,,36,38,74
017 Sand in Taufers,35,,43,40,83
017 Sand in Taufers,36,,42,35,77
017 Sand in Taufers,37,,40,36,76
017 Sand in Taufers,38,,35,23,58
017 Sand in Taufers,39,,23,37,60
017 Sand in Taufers,40,,30,36,66
017 Sand in Taufers,41,,26,20,46
017 Sand in Taufers,42,,27,27,54
017 Sand in Taufers,43,,34,23,57
017 Sand in Taufers,44,,17,30,47
017 Sand in Taufers,45,,30,24,54
017 Sand in Taufers,46,,33,34,67
017 Sand in Taufers,47,,32,23,55
017 Sand in Taufers,48,,24,25,49
017 Sand in Taufers,49,,25,27,52
017 Sand in Taufers,50,,29,27,56
017 Sand in Taufers,51,,30,9,39
017 Sand in Taufers,52,,19,29,48
017 Sand in Taufers,53,,30,32,62
017 Sand in Taufers,54,,32,35,67
017 Sand in Taufers,55,,27,32,59
017 Sand in Taufers,56,,25,21,46
017 Sand in Taufers,57,,28,31,59
017 Sand in Taufers,58,,18,27,45
017 Sand in Taufers,59,,29,13,42
017 Sand in Taufers,60,,17,26,43
017 Sand in Taufers,61,,34,18,52
017 Sand in Taufers,62,,15,15,30
017 Sand in Taufers,63,,17,17,34
017 Sand in Taufers,64,,13,17,30
017 Sand in Taufers,65,,15,14,29
017 Sand in Taufers,66,,16,19,35
017 Sand in Taufers,67,,19,15,34
017 Sand in Taufers,68,,14,17,31
017 Sand in Taufers,69,,19,14,33
017 Sand in Taufers,70,,14,20,34
017 Sand in Taufers,71,,11,16,27
017 Sand in Taufers,72,,10,19,29
017 Sand in Taufers,73,,15,15,30
017 Sand in Taufers,74,,14,18,32
017 Sand in Taufers,75,,9,20,29
017 Sand in Taufers,76,,10,12,22
017 Sand in Taufers,77,,7,10,17
017 Sand in Taufers,78,,4,9,13
017 Sand in Taufers,79,,4,12,16
017 Sand in Taufers,80,,-,7,7
017 Sand in Taufers,81,,4,9,13
017 Sand in Taufers,82,,7,15,22
017 Sand in Taufers,83,,2,13,15
017 Sand in Taufers,84,,2,8,10
017 Sand in Taufers,85,,3,8,11
017 Sand in Taufers,86,,1,2,3
017 Sand in Taufers,87,,2,8,10
017 Sand in Taufers,88,,2,2,4
017 Sand in Taufers,89,,2,5,7
017 Sand in Taufers,90,,2,2,4
017 Sand in Taufers,91,,1,-,1
017 Sand in Taufers,92,,-,2,2
017 Sand in Taufers,94,,1,-,1
017 Sand in Taufers,95,,1,-,1
017 Sand in Taufers,96,,-,1,1
017 Sand in Taufers,97,,-,1,1
017 Sand in Taufers,Insgesamt,,2.333,2.351,4.684
018 Kastelbell-Tschars,0,,10,16,26
018 Kastelbell-Tschars,1,,15,11,26
018 Kastelbell-Tschars,2,,12,16,28
018 Kastelbell-Tschars,3,,13,15,28
018 Kastelbell-Tschars,4,,15,15,30
018 Kastelbell-Tschars,5,,19,13,32
018 Kastelbell-Tschars,6,,16,11,27
018 Kastelbell-Tschars,7,,16,10,26
018 Kastelbell-Tschars,8,,17,8,25
018 Kastelbell-Tschars,9,,18,15,33
018 Kastelbell-Tschars,10,,18,20,38
018 Kastelbell-Tschars,11,,21,14,35
018 Kastelbell-Tschars,12,,6,10,16
018 Kastelbell-Tschars,13,,13,23,36
018 Kastelbell-Tschars,14,,24,13,37
018 Kastelbell-Tschars,15,,15,22,37
018 Kastelbell-Tschars,16,,18,18,36
018 Kastelbell-Tschars,17,,16,16,32
018 Kastelbell-Tschars,18,,13,27,40
018 Kastelbell-Tschars,19,,10,19,29
018 Kastelbell-Tschars,20,,20,16,36
018 Kastelbell-Tschars,21,,18,14,32
018 Kastelbell-Tschars,22,,20,15,35
018 Kastelbell-Tschars,23,,25,19,44
018 Kastelbell-Tschars,24,,16,16,32
018 Kastelbell-Tschars,25,,16,13,29
018 Kastelbell-Tschars,26,,16,19,35
018 Kastelbell-Tschars,27,,26,26,52
018 Kastelbell-Tschars,28,,19,14,33
018 Kastelbell-Tschars,29,,15,23,38
018 Kastelbell-Tschars,30,,25,13,38
018 Kastelbell-Tschars,31,,21,17,38
018 Kastelbell-Tschars,32,,24,15,39
018 Kastelbell-Tschars,33,,23,20,43
018 Kastelbell-Tschars,34,,8,24,32
018 Kastelbell-Tschars,35,,19,19,38
018 Kastelbell-Tschars,36,,24,19,43
018 Kastelbell-Tschars,37,,25,16,41
018 Kastelbell-Tschars,38,,18,14,32
018 Kastelbell-Tschars,39,,15,11,26
018 Kastelbell-Tschars,40,,12,19,31
018 Kastelbell-Tschars,41,,17,18,35
018 Kastelbell-Tschars,42,,9,13,22
018 Kastelbell-Tschars,43,,10,15,25
018 Kastelbell-Tschars,44,,12,18,30
018 Kastelbell-Tschars,45,,16,13,29
018 Kastelbell-Tschars,46,,13,14,27
018 Kastelbell-Tschars,47,,12,9,21
018 Kastelbell-Tschars,48,,16,9,25
018 Kastelbell-Tschars,49,,10,9,19
018 Kastelbell-Tschars,50,,15,13,28
018 Kastelbell-Tschars,51,,10,4,14
018 Kastelbell-Tschars,52,,11,7,18
018 Kastelbell-Tschars,53,,10,9,19
018 Kastelbell-Tschars,54,,10,12,22
018 Kastelbell-Tschars,55,,10,8,18
018 Kastelbell-Tschars,56,,9,10,19
018 Kastelbell-Tschars,57,,14,15,29
018 Kastelbell-Tschars,58,,8,15,23
018 Kastelbell-Tschars,59,,12,11,23
018 Kastelbell-Tschars,60,,10,17,27
018 Kastelbell-Tschars,61,,11,10,21
018 Kastelbell-Tschars,62,,6,17,23
018 Kastelbell-Tschars,63,,19,13,32
018 Kastelbell-Tschars,64,,8,14,22
018 Kastelbell-Tschars,65,,10,14,24
018 Kastelbell-Tschars,66,,23,17,40
018 Kastelbell-Tschars,67,,11,14,25
018 Kastelbell-Tschars,68,,10,11,21
018 Kastelbell-Tschars,69,,11,9,20
018 Kastelbell-Tschars,70,,16,17,33
018 Kastelbell-Tschars,71,,14,15,29
018 Kastelbell-Tschars,72,,5,12,17
018 Kastelbell-Tschars,73,,13,10,23
018 Kastelbell-Tschars,74,,7,10,17
018 Kastelbell-Tschars,75,,4,9,13
018 Kastelbell-Tschars,76,,5,9,14
018 Kastelbell-Tschars,77,,2,5,7
018 Kastelbell-Tschars,78,,2,4,6
018 Kastelbell-Tschars,79,,3,4,7
018 Kastelbell-Tschars,80,,-,5,5
018 Kastelbell-Tschars,81,,7,4,11
018 Kastelbell-Tschars,82,,4,8,12
018 Kastelbell-Tschars,83,,7,4,11
018 Kastelbell-Tschars,84,,-,6,6
018 Kastelbell-Tschars,85,,3,5,8
018 Kastelbell-Tschars,86,,-,3,3
018 Kastelbell-Tschars,87,,2,-,2
018 Kastelbell-Tschars,88,,-,8,8
018 Kastelbell-Tschars,89,,-,1,1
018 Kastelbell-Tschars,91,,2,-,2
018 Kastelbell-Tschars,92,,1,2,3
018 Kastelbell-Tschars,94,,-,1,1
018 Kastelbell-Tschars,96,,-,1,1
018 Kastelbell-Tschars,Insgesamt,,1.150,1.175,2.325
019 Kastelruth,0,,38,35,73
019 Kastelruth,1,,51,40,91
019 Kastelruth,2,,32,32,64
019 Kastelruth,3,,39,33,72
019 Kastelruth,4,,36,52,88
019 Kastelruth,5,,36,40,76
019 Kastelruth,6,,37,36,73
019 Kastelruth,7,,45,39,84
019 Kastelruth,8,,26,24,50
019 Kastelruth,9,,37,42,79
019 Kastelruth,10,,32,23,55
019 Kastelruth,11,,26,33,59
019 Kastelruth,12,,34,29,63
019 Kastelruth,13,,34,43,77
019 Kastelruth,14,,44,32,76
019 Kastelruth,15,,36,40,76
019 Kastelruth,16,,45,37,82
019 Kastelruth,17,,30,44,74
019 Kastelruth,18,,32,40,72
019 Kastelruth,19,,37,37,74
019 Kastelruth,20,,43,42,85
019 Kastelruth,21,,52,35,87
019 Kastelruth,22,,54,50,104
019 Kastelruth,23,,41,63,104
019 Kastelruth,24,,62,46,108
019 Kastelruth,25,,55,50,105
019 Kastelruth,26,,52,70,122
019 Kastelruth,27,,62,66,128
019 Kastelruth,28,,65,57,122
019 Kastelruth,29,,66,66,132
019 Kastelruth,30,,70,48,118
019 Kastelruth,31,,46,71,117
019 Kastelruth,32,,54,44,98
019 Kastelruth,33,,57,34,91
019 Kastelruth,34,,38,49,87
019 Kastelruth,35,,47,42,89
019 Kastelruth,36,,52,42,94
019 Kastelruth,37,,47,45,92
019 Kastelruth,38,,48,43,91
019 Kastelruth,39,,34,37,71
019 Kastelruth,40,,35,30,65
019 Kastelruth,41,,38,36,74
019 Kastelruth,42,,35,29,64
019 Kastelruth,43,,30,30,60
019 Kastelruth,44,,37,27,64
019 Kastelruth,45,,30,27,57
019 Kastelruth,46,,42,18,60
019 Kastelruth,47,,20,34,54
019 Kastelruth,48,,28,38,66
019 Kastelruth,49,,36,33,69
019 Kastelruth,50,,22,39,61
019 Kastelruth,51,,24,21,45
019 Kastelruth,52,,20,45,65
019 Kastelruth,53,,44,36,80
019 Kastelruth,54,,35,29,64
019 Kastelruth,55,,37,46,83
019 Kastelruth,56,,31,37,68
019 Kastelruth,57,,28,26,54
019 Kastelruth,58,,29,27,56
019 Kastelruth,59,,27,24,51
019 Kastelruth,60,,34,21,55
019 Kastelruth,61,,34,31,65
019 Kastelruth,62,,25,23,48
019 Kastelruth,63,,35,30,65
019 Kastelruth,64,,21,37,58
019 Kastelruth,65,,44,28,72
019 Kastelruth,66,,13,28,41
019 Kastelruth,67,,30,27,57
019 Kastelruth,68,,17,22,39
019 Kastelruth,69,,28,33,61
019 Kastelruth,70,,18,26,44
019 Kastelruth,71,,13,25,38
019 Kastelruth,72,,21,23,44
019 Kastelruth,73,,12,23,35
019 Kastelruth,74,,16,17,33
019 Kastelruth,75,,13,24,37
019 Kastelruth,76,,13,20,33
019 Kastelruth,77,,13,10,23
019 Kastelruth,78,,6,14,20
019 Kastelruth,79,,7,7,14
019 Kastelruth,80,,2,5,7
019 Kastelruth,81,,4,14,18
019 Kastelruth,82,,12,10,22
019 Kastelruth,83,,10,13,23
019 Kastelruth,84,,10,14,24
019 Kastelruth,85,,8,13,21
019 Kastelruth,86,,3,9,12
019 Kastelruth,87,,2,9,11
019 Kastelruth,88,,2,4,6
019 Kastelruth,89,,4,8,12
019 Kastelruth,90,,1,8,9
019 Kastelruth,91,,2,4,6
019 Kastelruth,92,,3,2,5
019 Kastelruth,93,,-,2,2
019 Kastelruth,94,,-,1,1
019 Kastelruth,95,,-,3,3
019 Kastelruth,96,,-,2,2
019 Kastelruth,Insgesamt,,2.876,2.953,5.829
020 Tscherms,0,,5,4,9
020 Tscherms,1,,9,10,19
020 Tscherms,2,,9,15,24
020 Tscherms,3,,5,7,12
020 Tscherms,4,,10,6,16
020 Tscherms,5,,6,8,14
020 Tscherms,6,,7,4,11
020 Tscherms,7,,4,5,9
020 Tscherms,8,,5,17,22
020 Tscherms,9,,11,5,16
020 Tscherms,10,,9,6,15
020 Tscherms,11,,12,11,23
020 Tscherms,12,,10,5,15
020 Tscherms,13,,9,10,19
020 Tscherms,14,,5,8,13
020 Tscherms,15,,8,8,16
020 Tscherms,16,,6,6,12
020 Tscherms,17,,3,6,9
020 Tscherms,18,,4,7,11
020 Tscherms,19,,7,1,8
020 Tscherms,20,,7,6,13
020 Tscherms,21,,5,5,10
020 Tscherms,22,,8,1,9
020 Tscherms,23,,7,11,18
020 Tscherms,24,,5,5,10
020 Tscherms,25,,12,12,24
020 Tscherms,26,,7,6,13
020 Tscherms,27,,11,16,27
020 Tscherms,28,,15,9,24
020 Tscherms,29,,11,12,23
020 Tscherms,30,,9,7,16
020 Tscherms,31,,10,16,26
020 Tscherms,32,,13,12,25
020 Tscherms,33,,18,11,29
020 Tscherms,34,,11,7,18
020 Tscherms,35,,10,8,18
020 Tscherms,36,,8,11,19
020 Tscherms,37,,6,15,21
020 Tscherms,38,,10,5,15
020 Tscherms,39,,10,7,17
020 Tscherms,40,,8,8,16
020 Tscherms,41,,11,9,20
020 Tscherms,42,,6,9,15
020 Tscherms,43,,8,3,11
020 Tscherms,44,,13,6,19
020 Tscherms,45,,8,10,18
020 Tscherms,46,,8,9,17
020 Tscherms,47,,4,3,7
020 Tscherms,48,,6,4,10
020 Tscherms,49,,11,8,19
020 Tscherms,50,,3,7,10
020 Tscherms,51,,5,8,13
020 Tscherms,52,,6,11,17
020 Tscherms,53,,9,6,15
020 Tscherms,54,,7,3,10
020 Tscherms,55,,11,7,18
020 Tscherms,56,,5,5,10
020 Tscherms,57,,3,4,7
020 Tscherms,58,,6,2,8
020 Tscherms,59,,5,8,13
020 Tscherms,60,,5,6,11
020 Tscherms,61,,5,7,12
020 Tscherms,62,,2,9,11
020 Tscherms,63,,7,2,9
020 Tscherms,64,,6,4,10
020 Tscherms,65,,2,4,6
020 Tscherms,66,,5,5,10
020 Tscherms,67,,3,4,7
020 Tscherms,68,,5,6,11
020 Tscherms,69,,8,5,13
020 Tscherms,70,,4,4,8
020 Tscherms,71,,5,6,11
020 Tscherms,72,,4,7,11
020 Tscherms,73,,1,3,4
020 Tscherms,74,,3,8,11
020 Tscherms,75,,6,4,10
020 Tscherms,76,,7,4,11
020 Tscherms,77,,-,2,2
020 Tscherms,78,,4,2,6
020 Tscherms,79,,1,2,3
020 Tscherms,80,,1,2,3
020 Tscherms,81,,2,2,4
020 Tscherms,82,,3,3,6
020 Tscherms,83,,-,8,8
020 Tscherms,84,,4,-,4
020 Tscherms,85,,-,2,2
020 Tscherms,86,,1,2,3
020 Tscherms,88,,-,1,1
020 Tscherms,89,,-,2,2
020 Tscherms,90,,1,1,2
020 Tscherms,91,,-,1,1
020 Tscherms,93,,-,2,2
020 Tscherms,95,,-,1,1
020 Tscherms,Insgesamt,,575,582,1.157
021 Kiens,0,,19,18,37
021 Kiens,1,,15,22,37
021 Kiens,2,,17,17,34
021 Kiens,3,,18,16,34
021 Kiens,4,,24,17,41
021 Kiens,5,,14,24,38
021 Kiens,6,,13,20,33
021 Kiens,7,,14,17,31
021 Kiens,8,,13,15,28
021 Kiens,9,,12,12,24
021 Kiens,10,,18,11,29
021 Kiens,11,,18,14,32
021 Kiens,12,,16,11,27
021 Kiens,13,,13,19,32
021 Kiens,14,,23,17,40
021 Kiens,15,,15,21,36
021 Kiens,16,,17,21,38
021 Kiens,17,,16,20,36
021 Kiens,18,,29,18,47
021 Kiens,19,,18,15,33
021 Kiens,20,,29,19,48
021 Kiens,21,,20,25,45
021 Kiens,22,,21,22,43
021 Kiens,23,,35,26,61
021 Kiens,24,,27,23,50
021 Kiens,25,,32,37,69
021 Kiens,26,,23,26,49
021 Kiens,27,,34,23,57
021 Kiens,28,,46,20,66
021 Kiens,29,,21,26,47
021 Kiens,30,,25,27,52
021 Kiens,31,,19,20,39
021 Kiens,32,,33,20,53
021 Kiens,33,,18,23,41
021 Kiens,34,,32,18,50
021 Kiens,35,,20,23,43
021 Kiens,36,,19,20,39
021 Kiens,37,,26,18,44
021 Kiens,38,,14,12,26
021 Kiens,39,,12,18,30
021 Kiens,40,,17,11,28
021 Kiens,41,,16,11,27
021 Kiens,42,,11,14,25
021 Kiens,43,,14,23,37
021 Kiens,44,,14,10,24
021 Kiens,45,,13,12,25
021 Kiens,46,,19,11,30
021 Kiens,47,,9,14,23
021 Kiens,48,,10,17,27
021 Kiens,49,,16,14,30
021 Kiens,50,,19,14,33
021 Kiens,51,,8,13,21
021 Kiens,52,,11,14,25
021 Kiens,53,,23,12,35
021 Kiens,54,,20,12,32
021 Kiens,55,,21,11,32
021 Kiens,56,,14,17,31
021 Kiens,57,,14,11,25
021 Kiens,58,,16,14,30
021 Kiens,59,,11,13,24
021 Kiens,60,,11,12,23
021 Kiens,61,,5,19,24
021 Kiens,62,,9,15,24
021 Kiens,63,,13,8,21
021 Kiens,64,,17,12,29
021 Kiens,65,,18,8,26
021 Kiens,66,,10,13,23
021 Kiens,67,,8,9,17
021 Kiens,68,,4,8,12
021 Kiens,69,,9,6,15
021 Kiens,70,,3,5,8
021 Kiens,71,,7,5,12
021 Kiens,72,,6,7,13
021 Kiens,73,,10,6,16
021 Kiens,74,,4,6,10
021 Kiens,75,,2,7,9
021 Kiens,76,,5,4,9
021 Kiens,77,,1,5,6
021 Kiens,78,,2,2,4
021 Kiens,79,,1,4,5
021 Kiens,80,,1,4,5
021 Kiens,81,,2,4,6
021 Kiens,82,,4,5,9
021 Kiens,83,,5,4,9
021 Kiens,84,,2,4,6
021 Kiens,85,,3,3,6
021 Kiens,86,,5,2,7
021 Kiens,87,,2,1,3
021 Kiens,88,,1,4,5
021 Kiens,89,,1,4,5
021 Kiens,90,,4,-,4
021 Kiens,91,,-,1,1
021 Kiens,94,,-,1,1
021 Kiens,95,,1,-,1
021 Kiens,Insgesamt,,1.320,1.257,2.577
022 Klausen,0,,26,28,54
022 Klausen,1,,33,23,56
022 Klausen,2,,20,34,54
022 Klausen,3,,30,24,54
022 Klausen,4,,39,26,65
022 Klausen,5,,33,33,66
022 Klausen,6,,34,23,57
022 Klausen,7,,31,27,58
022 Klausen,8,,28,31,59
022 Klausen,9,,18,33,51
022 Klausen,10,,33,30,63
022 Klausen,11,,36,37,73
022 Klausen,12,,33,27,60
022 Klausen,13,,26,37,63
022 Klausen,14,,38,34,72
022 Klausen,15,,36,30,66
022 Klausen,16,,26,35,61
022 Klausen,17,,32,38,70
022 Klausen,18,,39,41,80
022 Klausen,19,,32,29,61
022 Klausen,20,,36,20,56
022 Klausen,21,,35,36,71
022 Klausen,22,,34,23,57
022 Klausen,23,,44,24,68
022 Klausen,24,,32,40,72
022 Klausen,25,,49,34,83
022 Klausen,26,,44,39,83
022 Klausen,27,,44,45,89
022 Klausen,28,,57,39,96
022 Klausen,29,,46,47,93
022 Klausen,30,,61,39,100
022 Klausen,31,,44,40,84
022 Klausen,32,,41,46,87
022 Klausen,33,,36,38,74
022 Klausen,34,,26,41,67
022 Klausen,35,,54,38,92
022 Klausen,36,,37,29,66
022 Klausen,37,,31,36,67
022 Klausen,38,,29,26,55
022 Klausen,39,,29,25,54
022 Klausen,40,,31,25,56
022 Klausen,41,,33,32,65
022 Klausen,42,,31,40,71
022 Klausen,43,,20,29,49
022 Klausen,44,,30,16,46
022 Klausen,45,,32,25,57
022 Klausen,46,,32,24,56
022 Klausen,47,,29,25,54
022 Klausen,48,,29,26,55
022 Klausen,49,,26,21,47
022 Klausen,50,,29,21,50
022 Klausen,51,,11,17,28
022 Klausen,52,,21,17,38
022 Klausen,53,,24,28,52
022 Klausen,54,,22,27,49
022 Klausen,55,,30,19,49
022 Klausen,56,,25,22,47
022 Klausen,57,,26,20,46
022 Klausen,58,,17,20,37
022 Klausen,59,,17,19,36
022 Klausen,60,,21,25,46
022 Klausen,61,,16,22,38
022 Klausen,62,,18,16,34
022 Klausen,63,,24,18,42
022 Klausen,64,,10,22,32
022 Klausen,65,,12,16,28
022 Klausen,66,,13,19,32
022 Klausen,67,,23,23,46
022 Klausen,68,,11,20,31
022 Klausen,69,,11,15,26
022 Klausen,70,,16,15,31
022 Klausen,71,,15,10,25
022 Klausen,72,,15,18,33
022 Klausen,73,,6,18,24
022 Klausen,74,,8,17,25
022 Klausen,75,,5,16,21
022 Klausen,76,,7,17,24
022 Klausen,77,,4,13,17
022 Klausen,78,,5,14,19
022 Klausen,79,,3,11,14
022 Klausen,80,,4,6,10
022 Klausen,81,,7,4,11
022 Klausen,82,,6,9,15
022 Klausen,83,,1,21,22
022 Klausen,84,,3,8,11
022 Klausen,85,,7,9,16
022 Klausen,86,,4,5,9
022 Klausen,87,,4,7,11
022 Klausen,88,,3,8,11
022 Klausen,89,,-,3,3
022 Klausen,90,,2,5,7
022 Klausen,91,,-,4,4
022 Klausen,92,,1,2,3
022 Klausen,93,,-,3,3
022 Klausen,94,,1,2,3
022 Klausen,96,,-,1,1
022 Klausen,98,,-,1,1
022 Klausen,Insgesamt,,2.233,2.241,4.474
023 Karneid,0,,21,17,38
023 Karneid,1,,22,18,40
023 Karneid,2,,23,18,41
023 Karneid,3,,20,19,39
023 Karneid,4,,20,19,39
023 Karneid,5,,17,17,34
023 Karneid,6,,22,16,38
023 Karneid,7,,14,15,29
023 Karneid,8,,18,18,36
023 Karneid,9,,12,21,33
023 Karneid,10,,18,20,38
023 Karneid,11,,20,11,31
023 Karneid,12,,25,15,40
023 Karneid,13,,20,9,29
023 Karneid,14,,21,14,35
023 Karneid,15,,29,28,57
023 Karneid,16,,22,21,43
023 Karneid,17,,24,24,48
023 Karneid,18,,25,12,37
023 Karneid,19,,16,17,33
023 Karneid,20,,23,26,49
023 Karneid,21,,19,18,37
023 Karneid,22,,29,21,50
023 Karneid,23,,27,19,46
023 Karneid,24,,26,28,54
023 Karneid,25,,28,30,58
023 Karneid,26,,31,15,46
023 Karneid,27,,22,25,47
023 Karneid,28,,36,30,66
023 Karneid,29,,30,33,63
023 Karneid,30,,28,34,62
023 Karneid,31,,27,26,53
023 Karneid,32,,32,26,58
023 Karneid,33,,35,17,52
023 Karneid,34,,23,33,56
023 Karneid,35,,29,20,49
023 Karneid,36,,29,25,54
023 Karneid,37,,26,18,44
023 Karneid,38,,20,20,40
023 Karneid,39,,19,20,39
023 Karneid,40,,19,18,37
023 Karneid,41,,18,8,26
023 Karneid,42,,14,14,28
023 Karneid,43,,23,15,38
023 Karneid,44,,11,21,32
023 Karneid,45,,18,11,29
023 Karneid,46,,22,15,37
023 Karneid,47,,10,13,23
023 Karneid,48,,17,22,39
023 Karneid,49,,7,17,24
023 Karneid,50,,11,19,30
023 Karneid,51,,11,14,25
023 Karneid,52,,13,13,26
023 Karneid,53,,21,15,36
023 Karneid,54,,16,25,41
023 Karneid,55,,21,16,37
023 Karneid,56,,16,18,34
023 Karneid,57,,17,18,35
023 Karneid,58,,20,10,30
023 Karneid,59,,10,9,19
023 Karneid,60,,12,12,24
023 Karneid,61,,13,16,29
023 Karneid,62,,17,15,32
023 Karneid,63,,12,14,26
023 Karneid,64,,15,5,20
023 Karneid,65,,20,11,31
023 Karneid,66,,7,10,17
023 Karneid,67,,12,9,21
023 Karneid,68,,9,10,19
023 Karneid,69,,4,9,13
023 Karneid,70,,9,10,19
023 Karneid,71,,6,7,13
023 Karneid,72,,9,14,23
023 Karneid,73,,7,5,12
023 Karneid,74,,4,9,13
023 Karneid,75,,2,6,8
023 Karneid,76,,8,11,19
023 Karneid,77,,9,5,14
023 Karneid,78,,1,6,7
023 Karneid,79,,2,4,6
023 Karneid,80,,1,4,5
023 Karneid,81,,4,2,6
023 Karneid,82,,2,5,7
023 Karneid,83,,1,4,5
023 Karneid,84,,1,6,7
023 Karneid,85,,-,5,5
023 Karneid,86,,6,5,11
023 Karneid,87,,2,3,5
023 Karneid,88,,1,6,7
023 Karneid,89,,-,1,1
023 Karneid,90,,-,3,3
023 Karneid,91,,-,1,1
023 Karneid,92,,-,2,2
023 Karneid,94,,-,1,1
023 Karneid,96,,-,1,1
023 Karneid,Insgesamt,,1.459,1.381,2.840
024 Kurtatsch a.d.Weinstr.,0,,22,13,35
024 Kurtatsch a.d.Weinstr.,1,,19,10,29
024 Kurtatsch a.d.Weinstr.,2,,16,8,24
024 Kurtatsch a.d.Weinstr.,3,,21,18,39
024 Kurtatsch a.d.Weinstr.,4,,20,11,31
024 Kurtatsch a.d.Weinstr.,5,,14,18,32
024 Kurtatsch a.d.Weinstr.,6,,11,8,19
024 Kurtatsch a.d.Weinstr.,7,,10,17,27
024 Kurtatsch a.d.Weinstr.,8,,8,13,21
024 Kurtatsch a.d.Weinstr.,9,,10,12,22
024 Kurtatsch a.d.Weinstr.,10,,9,10,19
024 Kurtatsch a.d.Weinstr.,11,,13,10,23
024 Kurtatsch a.d.Weinstr.,12,,15,9,24
024 Kurtatsch a.d.Weinstr.,13,,13,8,21
024 Kurtatsch a.d.Weinstr.,14,,11,20,31
024 Kurtatsch a.d.Weinstr.,15,,10,11,21
024 Kurtatsch a.d.Weinstr.,16,,7,14,21
024 Kurtatsch a.d.Weinstr.,17,,10,8,18
024 Kurtatsch a.d.Weinstr.,18,,6,15,21
024 Kurtatsch a.d.Weinstr.,19,,10,15,25
024 Kurtatsch a.d.Weinstr.,20,,11,14,25
024 Kurtatsch a.d.Weinstr.,21,,12,11,23
024 Kurtatsch a.d.Weinstr.,22,,9,17,26
024 Kurtatsch a.d.Weinstr.,23,,12,9,21
024 Kurtatsch a.d.Weinstr.,24,,11,16,27
024 Kurtatsch a.d.Weinstr.,25,,14,17,31
024 Kurtatsch a.d.Weinstr.,26,,11,22,33
024 Kurtatsch a.d.Weinstr.,27,,22,12,34
024 Kurtatsch a.d.Weinstr.,28,,23,9,32
024 Kurtatsch a.d.Weinstr.,29,,19,21,40
024 Kurtatsch a.d.Weinstr.,30,,27,17,44
024 Kurtatsch a.d.Weinstr.,31,,24,25,49
024 Kurtatsch a.d.Weinstr.,32,,14,26,40
024 Kurtatsch a.d.Weinstr.,33,,18,21,39
024 Kurtatsch a.d.Weinstr.,34,,22,8,30
024 Kurtatsch a.d.Weinstr.,35,,18,18,36
024 Kurtatsch a.d.Weinstr.,36,,19,21,40
024 Kurtatsch a.d.Weinstr.,37,,20,12,32
024 Kurtatsch a.d.Weinstr.,38,,14,16,30
024 Kurtatsch a.d.Weinstr.,39,,11,14,25
024 Kurtatsch a.d.Weinstr.,40,,10,9,19
024 Kurtatsch a.d.Weinstr.,41,,12,18,30
024 Kurtatsch a.d.Weinstr.,42,,15,8,23
024 Kurtatsch a.d.Weinstr.,43,,17,18,35
024 Kurtatsch a.d.Weinstr.,44,,13,7,20
024 Kurtatsch a.d.Weinstr.,45,,9,14,23
024 Kurtatsch a.d.Weinstr.,46,,14,5,19
024 Kurtatsch a.d.Weinstr.,47,,11,9,20
024 Kurtatsch a.d.Weinstr.,48,,9,6,15
024 Kurtatsch a.d.Weinstr.,49,,12,9,21
024 Kurtatsch a.d.Weinstr.,50,,12,8,20
024 Kurtatsch a.d.Weinstr.,51,,6,8,14
024 Kurtatsch a.d.Weinstr.,52,,5,8,13
024 Kurtatsch a.d.Weinstr.,53,,11,6,17
024 Kurtatsch a.d.Weinstr.,54,,11,12,23
024 Kurtatsch a.d.Weinstr.,55,,7,9,16
024 Kurtatsch a.d.Weinstr.,56,,12,12,24
024 Kurtatsch a.d.Weinstr.,57,,5,14,19
024 Kurtatsch a.d.Weinstr.,58,,9,11,20
024 Kurtatsch a.d.Weinstr.,59,,5,11,16
024 Kurtatsch a.d.Weinstr.,60,,10,7,17
024 Kurtatsch a.d.Weinstr.,61,,7,9,16
024 Kurtatsch a.d.Weinstr.,62,,8,10,18
024 Kurtatsch a.d.Weinstr.,63,,9,5,14
024 Kurtatsch a.d.Weinstr.,64,,12,15,27
024 Kurtatsch a.d.Weinstr.,65,,10,12,22
024 Kurtatsch a.d.Weinstr.,66,,12,16,28
024 Kurtatsch a.d.Weinstr.,67,,9,13,22
024 Kurtatsch a.d.Weinstr.,68,,9,8,17
024 Kurtatsch a.d.Weinstr.,69,,11,7,18
024 Kurtatsch a.d.Weinstr.,70,,9,6,15
024 Kurtatsch a.d.Weinstr.,71,,4,10,14
024 Kurtatsch a.d.Weinstr.,72,,8,11,19
024 Kurtatsch a.d.Weinstr.,73,,8,21,29
024 Kurtatsch a.d.Weinstr.,74,,2,6,8
024 Kurtatsch a.d.Weinstr.,75,,5,7,12
024 Kurtatsch a.d.Weinstr.,76,,7,6,13
024 Kurtatsch a.d.Weinstr.,77,,2,2,4
024 Kurtatsch a.d.Weinstr.,78,,-,2,2
024 Kurtatsch a.d.Weinstr.,79,,-,6,6
024 Kurtatsch a.d.Weinstr.,80,,1,2,3
024 Kurtatsch a.d.Weinstr.,81,,2,1,3
024 Kurtatsch a.d.Weinstr.,82,,3,3,6
024 Kurtatsch a.d.Weinstr.,83,,2,5,7
024 Kurtatsch a.d.Weinstr.,84,,4,6,10
024 Kurtatsch a.d.Weinstr.,85,,2,4,6
024 Kurtatsch a.d.Weinstr.,86,,-,3,3
024 Kurtatsch a.d.Weinstr.,87,,3,3,6
024 Kurtatsch a.d.Weinstr.,88,,1,2,3
024 Kurtatsch a.d.Weinstr.,89,,-,2,2
024 Kurtatsch a.d.Weinstr.,90,,2,1,3
024 Kurtatsch a.d.Weinstr.,91,,1,2,3
024 Kurtatsch a.d.Weinstr.,92,,1,-,1
024 Kurtatsch a.d.Weinstr.,93,,-,1,1
024 Kurtatsch a.d.Weinstr.,94,,-,1,1
024 Kurtatsch a.d.Weinstr.,95,,1,1,2
024 Kurtatsch a.d.Weinstr.,101,,-,1,1
024 Kurtatsch a.d.Weinstr.,Insgesamt,,956,993,1.949
025 Kurtinig a.d. Weinstr.,0,,1,4,5
025 Kurtinig a.d. Weinstr.,1,,5,2,7
025 Kurtinig a.d. Weinstr.,2,,3,5,8
025 Kurtinig a.d. Weinstr.,3,,4,5,9
025 Kurtinig a.d. Weinstr.,4,,3,5,8
025 Kurtinig a.d. Weinstr.,5,,6,2,8
025 Kurtinig a.d. Weinstr.,6,,3,2,5
025 Kurtinig a.d. Weinstr.,7,,6,4,10
025 Kurtinig a.d. Weinstr.,8,,6,5,11
025 Kurtinig a.d. Weinstr.,9,,5,6,11
025 Kurtinig a.d. Weinstr.,10,,4,5,9
025 Kurtinig a.d. Weinstr.,11,,2,3,5
025 Kurtinig a.d. Weinstr.,12,,3,2,5
025 Kurtinig a.d. Weinstr.,13,,3,4,7
025 Kurtinig a.d. Weinstr.,14,,6,4,10
025 Kurtinig a.d. Weinstr.,15,,5,5,10
025 Kurtinig a.d. Weinstr.,16,,4,2,6
025 Kurtinig a.d. Weinstr.,17,,4,9,13
025 Kurtinig a.d. Weinstr.,18,,2,3,5
025 Kurtinig a.d. Weinstr.,19,,5,-,5
025 Kurtinig a.d. Weinstr.,20,,2,-,2
025 Kurtinig a.d. Weinstr.,21,,1,4,5
025 Kurtinig a.d. Weinstr.,22,,3,1,4
025 Kurtinig a.d. Weinstr.,23,,4,2,6
025 Kurtinig a.d. Weinstr.,24,,2,4,6
025 Kurtinig a.d. Weinstr.,25,,4,1,5
025 Kurtinig a.d. Weinstr.,26,,7,3,10
025 Kurtinig a.d. Weinstr.,27,,5,6,11
025 Kurtinig a.d. Weinstr.,28,,5,6,11
025 Kurtinig a.d. Weinstr.,29,,5,4,9
025 Kurtinig a.d. Weinstr.,30,,2,5,7
025 Kurtinig a.d. Weinstr.,31,,5,4,9
025 Kurtinig a.d. Weinstr.,32,,7,6,13
025 Kurtinig a.d. Weinstr.,33,,5,6,11
025 Kurtinig a.d. Weinstr.,34,,6,5,11
025 Kurtinig a.d. Weinstr.,35,,9,11,20
025 Kurtinig a.d. Weinstr.,36,,5,4,9
025 Kurtinig a.d. Weinstr.,37,,12,7,19
025 Kurtinig a.d. Weinstr.,38,,3,6,9
025 Kurtinig a.d. Weinstr.,39,,9,8,17
025 Kurtinig a.d. Weinstr.,40,,2,3,5
025 Kurtinig a.d. Weinstr.,41,,4,1,5
025 Kurtinig a.d. Weinstr.,42,,6,2,8
025 Kurtinig a.d. Weinstr.,43,,5,4,9
025 Kurtinig a.d. Weinstr.,44,,2,4,6
025 Kurtinig a.d. Weinstr.,45,,2,4,6
025 Kurtinig a.d. Weinstr.,46,,2,3,5
025 Kurtinig a.d. Weinstr.,47,,3,3,6
025 Kurtinig a.d. Weinstr.,48,,4,5,9
025 Kurtinig a.d. Weinstr.,49,,5,1,6
025 Kurtinig a.d. Weinstr.,50,,-,5,5
025 Kurtinig a.d. Weinstr.,51,,3,2,5
025 Kurtinig a.d. Weinstr.,52,,3,2,5
025 Kurtinig a.d. Weinstr.,53,,4,3,7
025 Kurtinig a.d. Weinstr.,54,,2,2,4
025 Kurtinig a.d. Weinstr.,55,,3,1,4
025 Kurtinig a.d. Weinstr.,56,,2,2,4
025 Kurtinig a.d. Weinstr.,57,,5,3,8
025 Kurtinig a.d. Weinstr.,58,,2,2,4
025 Kurtinig a.d. Weinstr.,59,,3,3,6
025 Kurtinig a.d. Weinstr.,60,,6,3,9
025 Kurtinig a.d. Weinstr.,61,,-,6,6
025 Kurtinig a.d. Weinstr.,62,,1,4,5
025 Kurtinig a.d. Weinstr.,63,,1,2,3
025 Kurtinig a.d. Weinstr.,64,,3,3,6
025 Kurtinig a.d. Weinstr.,65,,2,2,4
025 Kurtinig a.d. Weinstr.,66,,3,4,7
025 Kurtinig a.d. Weinstr.,67,,2,3,5
025 Kurtinig a.d. Weinstr.,68,,2,5,7
025 Kurtinig a.d. Weinstr.,69,,2,3,5
025 Kurtinig a.d. Weinstr.,70,,5,1,6
025 Kurtinig a.d. Weinstr.,71,,-,5,5
025 Kurtinig a.d. Weinstr.,72,,2,7,9
025 Kurtinig a.d. Weinstr.,73,,1,1,2
025 Kurtinig a.d. Weinstr.,74,,1,3,4
025 Kurtinig a.d. Weinstr.,75,,2,1,3
025 Kurtinig a.d. Weinstr.,76,,3,1,4
025 Kurtinig a.d. Weinstr.,77,,-,2,2
025 Kurtinig a.d. Weinstr.,78,,1,1,2
025 Kurtinig a.d. Weinstr.,79,,-,1,1
025 Kurtinig a.d. Weinstr.,80,,-,1,1
025 Kurtinig a.d. Weinstr.,81,,-,3,3
025 Kurtinig a.d. Weinstr.,82,,1,2,3
025 Kurtinig a.d. Weinstr.,83,,1,1,2
025 Kurtinig a.d. Weinstr.,84,,1,1,2
025 Kurtinig a.d. Weinstr.,87,,1,1,2
025 Kurtinig a.d. Weinstr.,90,,1,-,1
025 Kurtinig a.d. Weinstr.,92,,-,2,2
025 Kurtinig a.d. Weinstr.,Insgesamt,,285,294,579
026 Corvara,0,,9,4,13
026 Corvara,1,,8,9,17
026 Corvara,2,,4,5,9
026 Corvara,3,,7,3,10
026 Corvara,4,,5,11,16
026 Corvara,5,,3,5,8
026 Corvara,6,,10,4,14
026 Corvara,7,,5,5,10
026 Corvara,8,,6,4,10
026 Corvara,9,,10,7,17
026 Corvara,10,,3,1,4
026 Corvara,11,,6,8,14
026 Corvara,12,,8,3,11
026 Corvara,13,,7,7,14
026 Corvara,14,,9,11,20
026 Corvara,15,,15,2,17
026 Corvara,16,,11,7,18
026 Corvara,17,,11,8,19
026 Corvara,18,,10,3,13
026 Corvara,19,,16,6,22
026 Corvara,20,,12,5,17
026 Corvara,21,,9,18,27
026 Corvara,22,,7,14,21
026 Corvara,23,,12,12,24
026 Corvara,24,,9,7,16
026 Corvara,25,,11,8,19
026 Corvara,26,,12,10,22
026 Corvara,27,,14,13,27
026 Corvara,28,,8,14,22
026 Corvara,29,,15,21,36
026 Corvara,30,,13,17,30
026 Corvara,31,,15,13,28
026 Corvara,32,,8,9,17
026 Corvara,33,,13,13,26
026 Corvara,34,,11,14,25
026 Corvara,35,,8,9,17
026 Corvara,36,,15,14,29
026 Corvara,37,,6,10,16
026 Corvara,38,,13,6,19
026 Corvara,39,,7,5,12
026 Corvara,40,,3,9,12
026 Corvara,41,,15,8,23
026 Corvara,42,,8,8,16
026 Corvara,43,,6,13,19
026 Corvara,44,,5,8,13
026 Corvara,45,,6,8,14
026 Corvara,46,,7,8,15
026 Corvara,47,,3,9,12
026 Corvara,48,,5,6,11
026 Corvara,49,,3,10,13
026 Corvara,50,,14,11,25
026 Corvara,51,,5,5,10
026 Corvara,52,,9,9,18
026 Corvara,53,,7,10,17
026 Corvara,54,,6,9,15
026 Corvara,55,,17,12,29
026 Corvara,56,,9,7,16
026 Corvara,57,,10,5,15
026 Corvara,58,,4,8,12
026 Corvara,59,,5,8,13
026 Corvara,60,,6,8,14
026 Corvara,61,,8,5,13
026 Corvara,62,,9,8,17
026 Corvara,63,,5,4,9
026 Corvara,64,,7,4,11
026 Corvara,65,,7,12,19
026 Corvara,66,,7,4,11
026 Corvara,67,,5,6,11
026 Corvara,68,,3,2,5
026 Corvara,69,,7,4,11
026 Corvara,70,,3,4,7
026 Corvara,71,,2,3,5
026 Corvara,72,,4,1,5
026 Corvara,73,,5,3,8
026 Corvara,74,,3,6,9
026 Corvara,75,,5,1,6
026 Corvara,76,,4,1,5
026 Corvara,77,,2,4,6
026 Corvara,78,,1,1,2
026 Corvara,79,,1,4,5
026 Corvara,80,,-,3,3
026 Corvara,82,,2,3,5
026 Corvara,83,,1,6,7
026 Corvara,84,,2,5,7
026 Corvara,85,,2,-,2
026 Corvara,86,,1,2,3
026 Corvara,87,,-,3,3
026 Corvara,88,,-,3,3
026 Corvara,89,,-,2,2
026 Corvara,90,,-,3,3
026 Corvara,93,,1,-,1
026 Corvara,Insgesamt,,631,631,1.262
027 Graun im Vinschgau,0,,20,19,39
027 Graun im Vinschgau,1,,18,20,38
027 Graun im Vinschgau,2,,18,11,29
027 Graun im Vinschgau,3,,19,13,32
027 Graun im Vinschgau,4,,17,14,31
027 Graun im Vinschgau,5,,9,14,23
027 Graun im Vinschgau,6,,17,21,38
027 Graun im Vinschgau,7,,25,18,43
027 Graun im Vinschgau,8,,22,11,33
027 Graun im Vinschgau,9,,16,11,27
027 Graun im Vinschgau,10,,8,8,16
027 Graun im Vinschgau,11,,19,10,29
027 Graun im Vinschgau,12,,18,15,33
027 Graun im Vinschgau,13,,7,16,23
027 Graun im Vinschgau,14,,22,18,40
027 Graun im Vinschgau,15,,22,17,39
027 Graun im Vinschgau,16,,24,13,37
027 Graun im Vinschgau,17,,13,24,37
027 Graun im Vinschgau,18,,18,15,33
027 Graun im Vinschgau,19,,18,21,39
027 Graun im Vinschgau,20,,15,20,35
027 Graun im Vinschgau,21,,24,20,44
027 Graun im Vinschgau,22,,25,10,35
027 Graun im Vinschgau,23,,25,19,44
027 Graun im Vinschgau,24,,22,20,42
027 Graun im Vinschgau,25,,27,12,39
027 Graun im Vinschgau,26,,27,21,48
027 Graun im Vinschgau,27,,28,18,46
027 Graun im Vinschgau,28,,19,23,42
027 Graun im Vinschgau,29,,32,24,56
027 Graun im Vinschgau,30,,21,24,45
027 Graun im Vinschgau,31,,16,22,38
027 Graun im Vinschgau,32,,22,22,44
027 Graun im Vinschgau,33,,23,20,43
027 Graun im Vinschgau,34,,23,22,45
027 Graun im Vinschgau,35,,22,14,36
027 Graun im Vinschgau,36,,21,21,42
027 Graun im Vinschgau,37,,25,12,37
027 Graun im Vinschgau,38,,20,15,35
027 Graun im Vinschgau,39,,16,13,29
027 Graun im Vinschgau,40,,15,11,26
027 Graun im Vinschgau,41,,18,10,28
027 Graun im Vinschgau,42,,17,17,34
027 Graun im Vinschgau,43,,19,8,27
027 Graun im Vinschgau,44,,17,11,28
027 Graun im Vinschgau,45,,13,16,29
027 Graun im Vinschgau,46,,12,12,24
027 Graun im Vinschgau,47,,8,21,29
027 Graun im Vinschgau,48,,13,12,25
027 Graun im Vinschgau,49,,6,11,17
027 Graun im Vinschgau,50,,8,7,15
027 Graun im Vinschgau,51,,9,8,17
027 Graun im Vinschgau,52,,11,9,20
027 Graun im Vinschgau,53,,10,13,23
027 Graun im Vinschgau,54,,10,12,22
027 Graun im Vinschgau,55,,15,9,24
027 Graun im Vinschgau,56,,15,9,24
027 Graun im Vinschgau,57,,12,14,26
027 Graun im Vinschgau,58,,11,12,23
027 Graun im Vinschgau,59,,11,3,14
027 Graun im Vinschgau,60,,15,14,29
027 Graun im Vinschgau,61,,10,9,19
027 Graun im Vinschgau,62,,13,10,23
027 Graun im Vinschgau,63,,8,7,15
027 Graun im Vinschgau,64,,14,8,22
027 Graun im Vinschgau,65,,14,11,25
027 Graun im Vinschgau,66,,7,9,16
027 Graun im Vinschgau,67,,17,15,32
027 Graun im Vinschgau,68,,12,14,26
027 Graun im Vinschgau,69,,6,9,15
027 Graun im Vinschgau,70,,10,15,25
027 Graun im Vinschgau,71,,8,6,14
027 Graun im Vinschgau,72,,10,11,21
027 Graun im Vinschgau,73,,7,15,22
027 Graun im Vinschgau,74,,9,8,17
027 Graun im Vinschgau,75,,9,15,24
027 Graun im Vinschgau,76,,7,3,10
027 Graun im Vinschgau,77,,1,7,8
027 Graun im Vinschgau,78,,3,3,6
027 Graun im Vinschgau,79,,-,5,5
027 Graun im Vinschgau,80,,3,2,5
027 Graun im Vinschgau,81,,3,5,8
027 Graun im Vinschgau,82,,6,7,13
027 Graun im Vinschgau,83,,2,5,7
027 Graun im Vinschgau,84,,1,5,6
027 Graun im Vinschgau,85,,1,7,8
027 Graun im Vinschgau,86,,3,-,3
027 Graun im Vinschgau,87,,2,3,5
027 Graun im Vinschgau,88,,-,4,4
027 Graun im Vinschgau,89,,1,5,6
027 Graun im Vinschgau,90,,-,1,1
027 Graun im Vinschgau,92,,1,-,1
027 Graun im Vinschgau,93,,-,1,1
027 Graun im Vinschgau,94,,-,1,1
027 Graun im Vinschgau,97,,1,-,1
027 Graun im Vinschgau,Insgesamt,,1.257,1.146,2.403
028 Toblach,0,,29,18,47
028 Toblach,1,,16,8,24
028 Toblach,2,,22,17,39
028 Toblach,3,,17,21,38
028 Toblach,4,,16,16,32
028 Toblach,5,,16,28,44
028 Toblach,6,,17,22,39
028 Toblach,7,,10,16,26
028 Toblach,8,,13,25,38
028 Toblach,9,,31,15,46
028 Toblach,10,,15,22,37
028 Toblach,11,,24,23,47
028 Toblach,12,,21,28,49
028 Toblach,13,,22,20,42
028 Toblach,14,,24,28,52
028 Toblach,15,,23,23,46
028 Toblach,16,,23,20,43
028 Toblach,17,,22,27,49
028 Toblach,18,,26,24,50
028 Toblach,19,,15,30,45
028 Toblach,20,,26,26,52
028 Toblach,21,,24,23,47
028 Toblach,22,,27,18,45
028 Toblach,23,,33,25,58
028 Toblach,24,,32,35,67
028 Toblach,25,,35,18,53
028 Toblach,26,,28,25,53
028 Toblach,27,,30,26,56
028 Toblach,28,,36,30,66
028 Toblach,29,,31,25,56
028 Toblach,30,,33,29,62
028 Toblach,31,,36,27,63
028 Toblach,32,,37,32,69
028 Toblach,33,,33,27,60
028 Toblach,34,,36,30,66
028 Toblach,35,,21,31,52
028 Toblach,36,,18,18,36
028 Toblach,37,,39,27,66
028 Toblach,38,,20,14,34
028 Toblach,39,,29,20,49
028 Toblach,40,,19,28,47
028 Toblach,41,,20,25,45
028 Toblach,42,,24,19,43
028 Toblach,43,,19,24,43
028 Toblach,44,,19,16,35
028 Toblach,45,,28,12,40
028 Toblach,46,,17,16,33
028 Toblach,47,,21,14,35
028 Toblach,48,,14,25,39
028 Toblach,49,,21,14,35
028 Toblach,50,,14,15,29
028 Toblach,51,,13,17,30
028 Toblach,52,,20,11,31
028 Toblach,53,,15,17,32
028 Toblach,54,,13,20,33
028 Toblach,55,,16,12,28
028 Toblach,56,,14,14,28
028 Toblach,57,,16,12,28
028 Toblach,58,,16,8,24
028 Toblach,59,,7,10,17
028 Toblach,60,,12,17,29
028 Toblach,61,,9,19,28
028 Toblach,62,,17,17,34
028 Toblach,63,,10,11,21
028 Toblach,64,,14,16,30
028 Toblach,65,,18,16,34
028 Toblach,66,,11,11,22
028 Toblach,67,,11,17,28
028 Toblach,68,,15,14,29
028 Toblach,69,,10,15,25
028 Toblach,70,,10,15,25
028 Toblach,71,,16,9,25
028 Toblach,72,,12,11,23
028 Toblach,73,,10,11,21
028 Toblach,74,,5,17,22
028 Toblach,75,,9,11,20
028 Toblach,76,,4,10,14
028 Toblach,77,,5,16,21
028 Toblach,78,,5,6,11
028 Toblach,79,,5,5,10
028 Toblach,80,,3,6,9
028 Toblach,81,,1,14,15
028 Toblach,82,,2,11,13
028 Toblach,83,,2,7,9
028 Toblach,84,,3,4,7
028 Toblach,85,,2,5,7
028 Toblach,86,,1,5,6
028 Toblach,87,,3,3,6
028 Toblach,88,,4,5,9
028 Toblach,89,,1,3,4
028 Toblach,90,,2,3,5
028 Toblach,91,,1,1,2
028 Toblach,92,,-,1,1
028 Toblach,95,,-,1,1
028 Toblach,106,,1,-,1
028 Toblach,Insgesamt,,1.586,1.599,3.185
029 Neumarkt,0,,16,21,37
029 Neumarkt,1,,22,25,47
029 Neumarkt,2,,18,19,37
029 Neumarkt,3,,25,33,58
029 Neumarkt,4,,21,24,45
029 Neumarkt,5,,26,17,43
029 Neumarkt,6,,27,23,50
029 Neumarkt,7,,22,32,54
029 Neumarkt,8,,21,23,44
029 Neumarkt,9,,28,29,57
029 Neumarkt,10,,22,17,39
029 Neumarkt,11,,23,15,38
029 Neumarkt,12,,16,23,39
029 Neumarkt,13,,13,23,36
029 Neumarkt,14,,22,23,45
029 Neumarkt,15,,25,20,45
029 Neumarkt,16,,21,19,40
029 Neumarkt,17,,22,17,39
029 Neumarkt,18,,34,19,53
029 Neumarkt,19,,16,13,29
029 Neumarkt,20,,30,30,60
029 Neumarkt,21,,28,23,51
029 Neumarkt,22,,24,35,59
029 Neumarkt,23,,23,23,46
029 Neumarkt,24,,28,31,59
029 Neumarkt,25,,29,41,70
029 Neumarkt,26,,38,24,62
029 Neumarkt,27,,35,34,69
029 Neumarkt,28,,33,43,76
029 Neumarkt,29,,41,37,78
029 Neumarkt,30,,48,35,83
029 Neumarkt,31,,48,34,82
029 Neumarkt,32,,47,39,86
029 Neumarkt,33,,44,39,83
029 Neumarkt,34,,46,36,82
029 Neumarkt,35,,36,35,71
029 Neumarkt,36,,45,47,92
029 Neumarkt,37,,49,37,86
029 Neumarkt,38,,31,35,66
029 Neumarkt,39,,34,31,65
029 Neumarkt,40,,34,24,58
029 Neumarkt,41,,42,41,83
029 Neumarkt,42,,39,26,65
029 Neumarkt,43,,24,20,44
029 Neumarkt,44,,28,23,51
029 Neumarkt,45,,22,21,43
029 Neumarkt,46,,26,22,48
029 Neumarkt,47,,18,27,45
029 Neumarkt,48,,24,23,47
029 Neumarkt,49,,25,30,55
029 Neumarkt,50,,36,31,67
029 Neumarkt,51,,26,25,51
029 Neumarkt,52,,24,16,40
029 Neumarkt,53,,26,22,48
029 Neumarkt,54,,26,24,50
029 Neumarkt,55,,39,25,64
029 Neumarkt,56,,35,34,69
029 Neumarkt,57,,22,28,50
029 Neumarkt,58,,19,19,38
029 Neumarkt,59,,24,23,47
029 Neumarkt,60,,23,20,43
029 Neumarkt,61,,22,21,43
029 Neumarkt,62,,17,23,40
029 Neumarkt,63,,19,19,38
029 Neumarkt,64,,21,24,45
029 Neumarkt,65,,26,29,55
029 Neumarkt,66,,20,28,48
029 Neumarkt,67,,18,19,37
029 Neumarkt,68,,11,21,32
029 Neumarkt,69,,23,20,43
029 Neumarkt,70,,22,21,43
029 Neumarkt,71,,17,22,39
029 Neumarkt,72,,14,18,32
029 Neumarkt,73,,16,31,47
029 Neumarkt,74,,13,19,32
029 Neumarkt,75,,9,27,36
029 Neumarkt,76,,13,21,34
029 Neumarkt,77,,4,13,17
029 Neumarkt,78,,6,6,12
029 Neumarkt,79,,5,8,13
029 Neumarkt,80,,3,7,10
029 Neumarkt,81,,2,10,12
029 Neumarkt,82,,10,15,25
029 Neumarkt,83,,7,7,14
029 Neumarkt,84,,5,10,15
029 Neumarkt,85,,3,11,14
029 Neumarkt,86,,4,10,14
029 Neumarkt,87,,5,6,11
029 Neumarkt,88,,3,6,9
029 Neumarkt,89,,-,3,3
029 Neumarkt,90,,1,3,4
029 Neumarkt,91,,1,1,2
029 Neumarkt,92,,-,2,2
029 Neumarkt,93,,-,2,2
029 Neumarkt,97,,1,-,1
029 Neumarkt,98,,-,1,1
029 Neumarkt,Insgesamt,,2.100,2.132,4.232
030 Pfalzen,0,,15,14,29
030 Pfalzen,1,,23,16,39
030 Pfalzen,2,,9,13,22
030 Pfalzen,3,,12,15,27
030 Pfalzen,4,,15,21,36
030 Pfalzen,5,,13,21,34
030 Pfalzen,6,,21,10,31
030 Pfalzen,7,,16,21,37
030 Pfalzen,8,,12,8,20
030 Pfalzen,9,,11,24,35
030 Pfalzen,10,,18,17,35
030 Pfalzen,11,,23,13,36
030 Pfalzen,12,,17,10,27
030 Pfalzen,13,,11,11,22
030 Pfalzen,14,,18,19,37
030 Pfalzen,15,,19,19,38
030 Pfalzen,16,,22,17,39
030 Pfalzen,17,,15,20,35
030 Pfalzen,18,,15,19,34
030 Pfalzen,19,,19,18,37
030 Pfalzen,20,,20,10,30
030 Pfalzen,21,,9,17,26
030 Pfalzen,22,,22,19,41
030 Pfalzen,23,,16,17,33
030 Pfalzen,24,,16,16,32
030 Pfalzen,25,,20,18,38
030 Pfalzen,26,,15,17,32
030 Pfalzen,27,,29,16,45
030 Pfalzen,28,,28,30,58
030 Pfalzen,29,,19,23,42
030 Pfalzen,30,,21,23,44
030 Pfalzen,31,,24,26,50
030 Pfalzen,32,,24,16,40
030 Pfalzen,33,,27,17,44
030 Pfalzen,34,,19,28,47
030 Pfalzen,35,,23,16,39
030 Pfalzen,36,,21,12,33
030 Pfalzen,37,,13,14,27
030 Pfalzen,38,,14,20,34
030 Pfalzen,39,,23,19,42
030 Pfalzen,40,,16,15,31
030 Pfalzen,41,,15,11,26
030 Pfalzen,42,,14,13,27
030 Pfalzen,43,,13,11,24
030 Pfalzen,44,,10,10,20
030 Pfalzen,45,,16,16,32
030 Pfalzen,46,,12,11,23
030 Pfalzen,47,,14,6,20
030 Pfalzen,48,,10,10,20
030 Pfalzen,49,,12,4,16
030 Pfalzen,50,,9,10,19
030 Pfalzen,51,,8,9,17
030 Pfalzen,52,,12,6,18
030 Pfalzen,53,,8,12,20
030 Pfalzen,54,,6,14,20
030 Pfalzen,55,,12,8,20
030 Pfalzen,56,,13,9,22
030 Pfalzen,57,,10,6,16
030 Pfalzen,58,,11,11,22
030 Pfalzen,59,,7,6,13
030 Pfalzen,60,,2,9,11
030 Pfalzen,61,,7,5,12
030 Pfalzen,62,,8,12,20
030 Pfalzen,63,,7,8,15
030 Pfalzen,64,,10,7,17
030 Pfalzen,65,,13,6,19
030 Pfalzen,66,,10,12,22
030 Pfalzen,67,,11,6,17
030 Pfalzen,68,,4,6,10
030 Pfalzen,69,,7,5,12
030 Pfalzen,70,,5,4,9
030 Pfalzen,71,,8,5,13
030 Pfalzen,72,,4,11,15
030 Pfalzen,73,,8,9,17
030 Pfalzen,74,,5,3,8
030 Pfalzen,75,,-,8,8
030 Pfalzen,76,,3,7,10
030 Pfalzen,77,,5,4,9
030 Pfalzen,78,,1,2,3
030 Pfalzen,79,,1,2,3
030 Pfalzen,80,,-,2,2
030 Pfalzen,81,,2,-,2
030 Pfalzen,82,,2,6,8
030 Pfalzen,83,,1,5,6
030 Pfalzen,84,,2,1,3
030 Pfalzen,85,,1,4,5
030 Pfalzen,86,,2,4,6
030 Pfalzen,87,,5,2,7
030 Pfalzen,88,,2,1,3
030 Pfalzen,91,,-,1,1
030 Pfalzen,92,,-,1,1
030 Pfalzen,Insgesamt,,1.091,1.056,2.147
031 Völs am Schlern,0,,14,22,36
031 Völs am Schlern,1,,23,26,49
031 Völs am Schlern,2,,24,13,37
031 Völs am Schlern,3,,16,18,34
031 Völs am Schlern,4,,21,15,36
031 Völs am Schlern,5,,13,20,33
031 Völs am Schlern,6,,19,19,38
031 Völs am Schlern,7,,18,14,32
031 Völs am Schlern,8,,16,14,30
031 Völs am Schlern,9,,17,15,32
031 Völs am Schlern,10,,23,12,35
031 Völs am Schlern,11,,18,14,32
031 Völs am Schlern,12,,15,7,22
031 Völs am Schlern,13,,11,22,33
031 Völs am Schlern,14,,20,23,43
031 Völs am Schlern,15,,25,18,43
031 Völs am Schlern,16,,29,12,41
031 Völs am Schlern,17,,19,25,44
031 Völs am Schlern,18,,24,18,42
031 Völs am Schlern,19,,21,21,42
031 Völs am Schlern,20,,25,23,48
031 Völs am Schlern,21,,19,24,43
031 Völs am Schlern,22,,26,25,51
031 Völs am Schlern,23,,24,30,54
031 Völs am Schlern,24,,30,28,58
031 Völs am Schlern,25,,33,31,64
031 Völs am Schlern,26,,27,27,54
031 Völs am Schlern,27,,31,34,65
031 Völs am Schlern,28,,37,37,74
031 Völs am Schlern,29,,30,26,56
031 Völs am Schlern,30,,42,21,63
031 Völs am Schlern,31,,26,26,52
031 Völs am Schlern,32,,28,17,45
031 Völs am Schlern,33,,39,27,66
031 Völs am Schlern,34,,26,18,44
031 Völs am Schlern,35,,22,19,41
031 Völs am Schlern,36,,27,21,48
031 Völs am Schlern,37,,19,14,33
031 Völs am Schlern,38,,21,17,38
031 Völs am Schlern,39,,24,19,43
031 Völs am Schlern,40,,19,18,37
031 Völs am Schlern,41,,16,12,28
031 Völs am Schlern,42,,19,23,42
031 Völs am Schlern,43,,18,24,42
031 Völs am Schlern,44,,18,18,36
031 Völs am Schlern,45,,18,19,37
031 Völs am Schlern,46,,22,16,38
031 Völs am Schlern,47,,19,8,27
031 Völs am Schlern,48,,16,14,30
031 Völs am Schlern,49,,16,17,33
031 Völs am Schlern,50,,14,13,27
031 Völs am Schlern,51,,12,13,25
031 Völs am Schlern,52,,16,9,25
031 Völs am Schlern,53,,12,23,35
031 Völs am Schlern,54,,15,13,28
031 Völs am Schlern,55,,21,19,40
031 Völs am Schlern,56,,12,19,31
031 Völs am Schlern,57,,16,10,26
031 Völs am Schlern,58,,13,14,27
031 Völs am Schlern,59,,11,9,20
031 Völs am Schlern,60,,11,21,32
031 Völs am Schlern,61,,17,12,29
031 Völs am Schlern,62,,16,9,25
031 Völs am Schlern,63,,8,13,21
031 Völs am Schlern,64,,16,8,24
031 Völs am Schlern,65,,15,16,31
031 Völs am Schlern,66,,7,14,21
031 Völs am Schlern,67,,7,11,18
031 Völs am Schlern,68,,10,11,21
031 Völs am Schlern,69,,11,11,22
031 Völs am Schlern,70,,12,6,18
031 Völs am Schlern,71,,11,11,22
031 Völs am Schlern,72,,15,12,27
031 Völs am Schlern,73,,5,7,12
031 Völs am Schlern,74,,5,9,14
031 Völs am Schlern,75,,6,12,18
031 Völs am Schlern,76,,4,7,11
031 Völs am Schlern,77,,1,11,12
031 Völs am Schlern,78,,2,5,7
031 Völs am Schlern,79,,2,6,8
031 Völs am Schlern,80,,4,2,6
031 Völs am Schlern,81,,4,5,9
031 Völs am Schlern,82,,7,4,11
031 Völs am Schlern,83,,7,3,10
031 Völs am Schlern,84,,4,3,7
031 Völs am Schlern,85,,1,9,10
031 Völs am Schlern,86,,2,3,5
031 Völs am Schlern,87,,2,5,7
031 Völs am Schlern,88,,1,4,5
031 Völs am Schlern,89,,1,4,5
031 Völs am Schlern,90,,1,1,2
031 Völs am Schlern,91,,-,2,2
031 Völs am Schlern,92,,1,2,3
031 Völs am Schlern,94,,1,-,1
031 Völs am Schlern,Insgesamt,,1.482,1.402,2.884
032 Franzensfeste,0,,8,5,13
032 Franzensfeste,1,,3,2,5
032 Franzensfeste,2,,9,4,13
032 Franzensfeste,3,,5,3,8
032 Franzensfeste,4,,6,9,15
032 Franzensfeste,5,,5,4,9
032 Franzensfeste,6,,2,4,6
032 Franzensfeste,7,,4,6,10
032 Franzensfeste,8,,5,3,8
032 Franzensfeste,9,,4,3,7
032 Franzensfeste,10,,5,2,7
032 Franzensfeste,11,,3,7,10
032 Franzensfeste,12,,3,4,7
032 Franzensfeste,13,,7,4,11
032 Franzensfeste,14,,2,7,9
032 Franzensfeste,15,,7,5,12
032 Franzensfeste,16,,4,10,14
032 Franzensfeste,17,,10,5,15
032 Franzensfeste,18,,5,7,12
032 Franzensfeste,19,,3,2,5
032 Franzensfeste,20,,4,5,9
032 Franzensfeste,21,,7,6,13
032 Franzensfeste,22,,6,6,12
032 Franzensfeste,23,,5,5,10
032 Franzensfeste,24,,4,10,14
032 Franzensfeste,25,,11,7,18
032 Franzensfeste,26,,8,8,16
032 Franzensfeste,27,,6,8,14
032 Franzensfeste,28,,8,8,16
032 Franzensfeste,29,,9,5,14
032 Franzensfeste,30,,7,9,16
032 Franzensfeste,31,,9,7,16
032 Franzensfeste,32,,14,8,22
032 Franzensfeste,33,,9,9,18
032 Franzensfeste,34,,12,2,14
032 Franzensfeste,35,,5,10,15
032 Franzensfeste,36,,7,8,15
032 Franzensfeste,37,,10,8,18
032 Franzensfeste,38,,10,1,11
032 Franzensfeste,39,,5,6,11
032 Franzensfeste,40,,4,7,11
032 Franzensfeste,41,,9,7,16
032 Franzensfeste,42,,3,12,15
032 Franzensfeste,43,,7,6,13
032 Franzensfeste,44,,5,3,8
032 Franzensfeste,45,,7,1,8
032 Franzensfeste,46,,10,3,13
032 Franzensfeste,47,,3,4,7
032 Franzensfeste,48,,5,6,11
032 Franzensfeste,49,,4,4,8
032 Franzensfeste,50,,8,5,13
032 Franzensfeste,51,,4,7,11
032 Franzensfeste,52,,5,9,14
032 Franzensfeste,53,,6,2,8
032 Franzensfeste,54,,5,2,7
032 Franzensfeste,55,,6,3,9
032 Franzensfeste,56,,5,4,9
032 Franzensfeste,57,,8,5,13
032 Franzensfeste,58,,2,3,5
032 Franzensfeste,59,,7,6,13
032 Franzensfeste,60,,6,2,8
032 Franzensfeste,61,,3,3,6
032 Franzensfeste,62,,3,3,6
032 Franzensfeste,63,,3,5,8
032 Franzensfeste,64,,4,6,10
032 Franzensfeste,65,,3,8,11
032 Franzensfeste,66,,7,5,12
032 Franzensfeste,67,,4,8,12
032 Franzensfeste,68,,2,2,4
032 Franzensfeste,69,,4,7,11
032 Franzensfeste,70,,4,10,14
032 Franzensfeste,71,,5,1,6
032 Franzensfeste,72,,6,5,11
032 Franzensfeste,73,,4,8,12
032 Franzensfeste,74,,7,5,12
032 Franzensfeste,75,,2,5,7
032 Franzensfeste,76,,2,4,6
032 Franzensfeste,77,,1,-,1
032 Franzensfeste,78,,-,3,3
032 Franzensfeste,79,,1,-,1
032 Franzensfeste,80,,1,-,1
032 Franzensfeste,81,,1,3,4
032 Franzensfeste,82,,2,3,5
032 Franzensfeste,83,,2,1,3
032 Franzensfeste,84,,1,2,3
032 Franzensfeste,85,,-,1,1
032 Franzensfeste,86,,1,-,1
032 Franzensfeste,87,,-,2,2
032 Franzensfeste,88,,-,2,2
032 Franzensfeste,89,,-,1,1
032 Franzensfeste,90,,2,2,4
032 Franzensfeste,92,,1,1,2
032 Franzensfeste,94,,-,1,1
032 Franzensfeste,102,,1,-,1
032 Franzensfeste,Insgesamt,,452,440,892
033 Villnöss,0,,17,19,36
033 Villnöss,1,,18,12,30
033 Villnöss,2,,15,12,27
033 Villnöss,3,,16,11,27
033 Villnöss,4,,12,14,26
033 Villnöss,5,,22,17,39
033 Villnöss,6,,14,12,26
033 Villnöss,7,,12,7,19
033 Villnöss,8,,16,23,39
033 Villnöss,9,,19,18,37
033 Villnöss,10,,10,16,26
033 Villnöss,11,,19,17,36
033 Villnöss,12,,15,13,28
033 Villnöss,13,,16,14,30
033 Villnöss,14,,12,15,27
033 Villnöss,15,,12,18,30
033 Villnöss,16,,20,9,29
033 Villnöss,17,,11,12,23
033 Villnöss,18,,15,13,28
033 Villnöss,19,,17,15,32
033 Villnöss,20,,15,13,28
033 Villnöss,21,,23,16,39
033 Villnöss,22,,21,22,43
033 Villnöss,23,,14,24,38
033 Villnöss,24,,22,25,47
033 Villnöss,25,,27,29,56
033 Villnöss,26,,22,31,53
033 Villnöss,27,,30,20,50
033 Villnöss,28,,30,20,50
033 Villnöss,29,,24,20,44
033 Villnöss,30,,28,25,53
033 Villnöss,31,,33,27,60
033 Villnöss,32,,35,26,61
033 Villnöss,33,,29,18,47
033 Villnöss,34,,21,19,40
033 Villnöss,35,,24,15,39
033 Villnöss,36,,20,12,32
033 Villnöss,37,,11,11,22
033 Villnöss,38,,9,15,24
033 Villnöss,39,,13,12,25
033 Villnöss,40,,12,13,25
033 Villnöss,41,,12,2,14
033 Villnöss,42,,16,13,29
033 Villnöss,43,,13,13,26
033 Villnöss,44,,15,11,26
033 Villnöss,45,,9,9,18
033 Villnöss,46,,7,10,17
033 Villnöss,47,,9,13,22
033 Villnöss,48,,9,9,18
033 Villnöss,49,,10,10,20
033 Villnöss,50,,8,5,13
033 Villnöss,51,,6,5,11
033 Villnöss,52,,9,15,24
033 Villnöss,53,,13,8,21
033 Villnöss,54,,15,18,33
033 Villnöss,55,,13,9,22
033 Villnöss,56,,10,18,28
033 Villnöss,57,,12,13,25
033 Villnöss,58,,13,9,22
033 Villnöss,59,,11,15,26
033 Villnöss,60,,7,17,24
033 Villnöss,61,,6,10,16
033 Villnöss,62,,12,9,21
033 Villnöss,63,,11,12,23
033 Villnöss,64,,16,14,30
033 Villnöss,65,,10,11,21
033 Villnöss,66,,14,11,25
033 Villnöss,67,,13,12,25
033 Villnöss,68,,16,8,24
033 Villnöss,69,,10,11,21
033 Villnöss,70,,8,9,17
033 Villnöss,71,,9,7,16
033 Villnöss,72,,7,15,22
033 Villnöss,73,,7,15,22
033 Villnöss,74,,5,13,18
033 Villnöss,75,,1,8,9
033 Villnöss,76,,1,7,8
033 Villnöss,77,,4,4,8
033 Villnöss,78,,1,3,4
033 Villnöss,79,,5,5,10
033 Villnöss,80,,1,2,3
033 Villnöss,81,,4,4,8
033 Villnöss,82,,5,4,9
033 Villnöss,83,,3,5,8
033 Villnöss,84,,1,5,6
033 Villnöss,85,,1,1,2
033 Villnöss,86,,1,3,4
033 Villnöss,87,,1,4,5
033 Villnöss,88,,-,8,8
033 Villnöss,89,,1,1,2
033 Villnöss,90,,2,2,4
033 Villnöss,91,,-,1,1
033 Villnöss,96,,1,-,1
033 Villnöss,Insgesamt,,1.165,1.146,2.311
034 Gais,0,,7,21,28
034 Gais,1,,23,17,40
034 Gais,2,,22,22,44
034 Gais,3,,12,22,34
034 Gais,4,,22,27,49
034 Gais,5,,24,29,53
034 Gais,6,,14,21,35
034 Gais,7,,16,15,31
034 Gais,8,,20,18,38
034 Gais,9,,17,20,37
034 Gais,10,,18,16,34
034 Gais,11,,23,15,38
034 Gais,12,,22,14,36
034 Gais,13,,23,18,41
034 Gais,14,,18,18,36
034 Gais,15,,22,20,42
034 Gais,16,,24,20,44
034 Gais,17,,25,14,39
034 Gais,18,,19,18,37
034 Gais,19,,17,21,38
034 Gais,20,,23,21,44
034 Gais,21,,19,20,39
034 Gais,22,,28,28,56
034 Gais,23,,27,25,52
034 Gais,24,,21,38,59
034 Gais,25,,27,24,51
034 Gais,26,,28,27,55
034 Gais,27,,33,34,67
034 Gais,28,,21,26,47
034 Gais,29,,22,26,48
034 Gais,30,,32,17,49
034 Gais,31,,28,28,56
034 Gais,32,,29,29,58
034 Gais,33,,14,14,28
034 Gais,34,,30,17,47
034 Gais,35,,18,27,45
034 Gais,36,,18,13,31
034 Gais,37,,19,22,41
034 Gais,38,,26,19,45
034 Gais,39,,13,14,27
034 Gais,40,,28,18,46
034 Gais,41,,15,13,28
034 Gais,42,,16,12,28
034 Gais,43,,16,14,30
034 Gais,44,,15,14,29
034 Gais,45,,15,19,34
034 Gais,46,,20,20,40
034 Gais,47,,16,11,27
034 Gais,48,,25,15,40
034 Gais,49,,22,13,35
034 Gais,50,,15,16,31
034 Gais,51,,11,9,20
034 Gais,52,,13,14,27
034 Gais,53,,12,16,28
034 Gais,54,,14,13,27
034 Gais,55,,23,14,37
034 Gais,56,,18,14,32
034 Gais,57,,13,15,28
034 Gais,58,,15,15,30
034 Gais,59,,17,16,33
034 Gais,60,,10,13,23
034 Gais,61,,15,12,27
034 Gais,62,,7,6,13
034 Gais,63,,5,10,15
034 Gais,64,,8,11,19
034 Gais,65,,13,9,22
034 Gais,66,,7,13,20
034 Gais,67,,5,5,10
034 Gais,68,,10,8,18
034 Gais,69,,6,10,16
034 Gais,70,,14,11,25
034 Gais,71,,7,6,13
034 Gais,72,,5,9,14
034 Gais,73,,8,12,20
034 Gais,74,,3,6,9
034 Gais,75,,4,8,12
034 Gais,76,,3,4,7
034 Gais,77,,1,7,8
034 Gais,78,,3,7,10
034 Gais,79,,1,5,6
034 Gais,80,,-,5,5
034 Gais,81,,1,7,8
034 Gais,82,,1,6,7
034 Gais,83,,5,4,9
034 Gais,84,,-,3,3
034 Gais,85,,3,3,6
034 Gais,86,,2,1,3
034 Gais,87,,1,2,3
034 Gais,88,,1,2,3
034 Gais,91,,-,1,1
034 Gais,93,,-,1,1
034 Gais,94,,-,1,1
034 Gais,Insgesamt,,1.352,1.354,2.706
035 Gargazon,0,,4,5,9
035 Gargazon,1,,7,2,9
035 Gargazon,2,,3,6,9
035 Gargazon,3,,8,5,13
035 Gargazon,4,,8,8,16
035 Gargazon,5,,16,9,25
035 Gargazon,6,,4,10,14
035 Gargazon,7,,10,6,16
035 Gargazon,8,,9,4,13
035 Gargazon,9,,6,8,14
035 Gargazon,10,,6,9,15
035 Gargazon,11,,10,3,13
035 Gargazon,12,,10,4,14
035 Gargazon,13,,4,7,11
035 Gargazon,14,,5,7,12
035 Gargazon,15,,10,6,16
035 Gargazon,16,,5,11,16
035 Gargazon,17,,6,7,13
035 Gargazon,18,,2,8,10
035 Gargazon,19,,4,4,8
035 Gargazon,20,,5,2,7
035 Gargazon,21,,6,3,9
035 Gargazon,22,,6,12,18
035 Gargazon,23,,7,7,14
035 Gargazon,24,,7,8,15
035 Gargazon,25,,10,11,21
035 Gargazon,26,,10,8,18
035 Gargazon,27,,11,11,22
035 Gargazon,28,,14,15,29
035 Gargazon,29,,13,15,28
035 Gargazon,30,,11,8,19
035 Gargazon,31,,11,9,20
035 Gargazon,32,,9,14,23
035 Gargazon,33,,13,16,29
035 Gargazon,34,,11,9,20
035 Gargazon,35,,7,10,17
035 Gargazon,36,,9,11,20
035 Gargazon,37,,15,11,26
035 Gargazon,38,,8,8,16
035 Gargazon,39,,16,10,26
035 Gargazon,40,,12,6,18
035 Gargazon,41,,8,2,10
035 Gargazon,42,,9,9,18
035 Gargazon,43,,15,8,23
035 Gargazon,44,,3,5,8
035 Gargazon,45,,11,7,18
035 Gargazon,46,,6,7,13
035 Gargazon,47,,4,9,13
035 Gargazon,48,,7,8,15
035 Gargazon,49,,6,10,16
035 Gargazon,50,,7,13,20
035 Gargazon,51,,8,5,13
035 Gargazon,52,,2,4,6
035 Gargazon,53,,3,7,10
035 Gargazon,54,,8,9,17
035 Gargazon,55,,10,10,20
035 Gargazon,56,,5,14,19
035 Gargazon,57,,12,5,17
035 Gargazon,58,,11,7,18
035 Gargazon,59,,7,11,18
035 Gargazon,60,,5,4,9
035 Gargazon,61,,15,2,17
035 Gargazon,62,,8,7,15
035 Gargazon,63,,5,11,16
035 Gargazon,64,,7,2,9
035 Gargazon,65,,5,7,12
035 Gargazon,66,,6,6,12
035 Gargazon,67,,3,10,13
035 Gargazon,68,,4,5,9
035 Gargazon,69,,5,5,10
035 Gargazon,70,,6,3,9
035 Gargazon,71,,5,6,11
035 Gargazon,72,,3,4,7
035 Gargazon,73,,5,6,11
035 Gargazon,74,,3,8,11
035 Gargazon,75,,7,6,13
035 Gargazon,76,,4,5,9
035 Gargazon,77,,2,3,5
035 Gargazon,78,,1,2,3
035 Gargazon,79,,-,3,3
035 Gargazon,80,,-,1,1
035 Gargazon,81,,2,2,4
035 Gargazon,82,,2,1,3
035 Gargazon,83,,2,7,9
035 Gargazon,84,,2,4,6
035 Gargazon,85,,-,1,1
035 Gargazon,86,,1,-,1
035 Gargazon,87,,-,3,3
035 Gargazon,88,,-,1,1
035 Gargazon,89,,1,1,2
035 Gargazon,90,,-,1,1
035 Gargazon,92,,-,1,1
035 Gargazon,Insgesamt,,599,611,1.210
036 Glurns,0,,6,4,10
036 Glurns,1,,7,4,11
036 Glurns,2,,1,5,6
036 Glurns,3,,7,6,13
036 Glurns,4,,4,8,12
036 Glurns,5,,6,3,9
036 Glurns,6,,10,5,15
036 Glurns,7,,4,3,7
036 Glurns,8,,6,9,15
036 Glurns,9,,7,6,13
036 Glurns,10,,6,7,13
036 Glurns,11,,3,3,6
036 Glurns,12,,7,7,14
036 Glurns,13,,9,6,15
036 Glurns,14,,10,9,19
036 Glurns,15,,6,7,13
036 Glurns,16,,13,7,20
036 Glurns,17,,6,8,14
036 Glurns,18,,5,8,13
036 Glurns,19,,5,5,10
036 Glurns,20,,10,4,14
036 Glurns,21,,6,7,13
036 Glurns,22,,7,5,12
036 Glurns,23,,3,2,5
036 Glurns,24,,3,8,11
036 Glurns,25,,3,8,11
036 Glurns,26,,1,3,4
036 Glurns,27,,4,6,10
036 Glurns,28,,6,5,11
036 Glurns,29,,5,9,14
036 Glurns,30,,3,5,8
036 Glurns,31,,2,6,8
036 Glurns,32,,9,4,13
036 Glurns,33,,6,10,16
036 Glurns,34,,4,5,9
036 Glurns,35,,3,7,10
036 Glurns,36,,8,8,16
036 Glurns,37,,12,7,19
036 Glurns,38,,4,10,14
036 Glurns,39,,6,12,18
036 Glurns,40,,8,5,13
036 Glurns,41,,11,7,18
036 Glurns,42,,12,4,16
036 Glurns,43,,9,9,18
036 Glurns,44,,5,10,15
036 Glurns,45,,8,9,17
036 Glurns,46,,6,5,11
036 Glurns,47,,6,3,9
036 Glurns,48,,7,4,11
036 Glurns,49,,10,7,17
036 Glurns,50,,9,2,11
036 Glurns,51,,7,1,8
036 Glurns,52,,5,4,9
036 Glurns,53,,1,4,5
036 Glurns,54,,6,5,11
036 Glurns,55,,5,1,6
036 Glurns,56,,5,2,7
036 Glurns,57,,1,3,4
036 Glurns,58,,3,4,7
036 Glurns,59,,5,5,10
036 Glurns,60,,-,1,1
036 Glurns,61,,2,4,6
036 Glurns,62,,1,6,7
036 Glurns,63,,1,1,2
036 Glurns,64,,7,3,10
036 Glurns,65,,4,2,6
036 Glurns,66,,7,2,9
036 Glurns,67,,5,7,12
036 Glurns,68,,1,3,4
036 Glurns,69,,1,3,4
036 Glurns,70,,1,2,3
036 Glurns,71,,1,6,7
036 Glurns,72,,3,2,5
036 Glurns,73,,-,1,1
036 Glurns,74,,2,-,2
036 Glurns,75,,2,3,5
036 Glurns,76,,2,3,5
036 Glurns,77,,2,3,5
036 Glurns,78,,-,3,3
036 Glurns,79,,1,2,3
036 Glurns,81,,-,6,6
036 Glurns,82,,-,5,5
036 Glurns,83,,1,6,7
036 Glurns,84,,-,3,3
036 Glurns,85,,1,3,4
036 Glurns,86,,-,2,2
036 Glurns,87,,-,2,2
036 Glurns,88,,-,1,1
036 Glurns,89,,-,1,1
036 Glurns,92,,-,1,1
036 Glurns,Insgesamt,,407,432,839
037 Latsch,0,,32,32,64
037 Latsch,1,,43,32,75
037 Latsch,2,,35,24,59
037 Latsch,3,,33,28,61
037 Latsch,4,,33,34,67
037 Latsch,5,,28,36,64
037 Latsch,6,,33,49,82
037 Latsch,7,,35,30,65
037 Latsch,8,,40,33,73
037 Latsch,9,,30,34,64
037 Latsch,10,,36,25,61
037 Latsch,11,,29,34,63
037 Latsch,12,,35,34,69
037 Latsch,13,,27,30,57
037 Latsch,14,,29,47,76
037 Latsch,15,,26,34,60
037 Latsch,16,,28,34,62
037 Latsch,17,,32,26,58
037 Latsch,18,,27,22,49
037 Latsch,19,,26,31,57
037 Latsch,20,,21,21,42
037 Latsch,21,,34,34,68
037 Latsch,22,,26,27,53
037 Latsch,23,,30,30,60
037 Latsch,24,,27,39,66
037 Latsch,25,,38,35,73
037 Latsch,26,,35,41,76
037 Latsch,27,,33,40,73
037 Latsch,28,,39,54,93
037 Latsch,29,,43,48,91
037 Latsch,30,,27,47,74
037 Latsch,31,,53,46,99
037 Latsch,32,,59,36,95
037 Latsch,33,,53,47,100
037 Latsch,34,,42,44,86
037 Latsch,35,,46,39,85
037 Latsch,36,,40,51,91
037 Latsch,37,,44,42,86
037 Latsch,38,,38,29,67
037 Latsch,39,,26,30,56
037 Latsch,40,,31,31,62
037 Latsch,41,,35,26,61
037 Latsch,42,,32,21,53
037 Latsch,43,,29,18,47
037 Latsch,44,,38,17,55
037 Latsch,45,,19,35,54
037 Latsch,46,,30,14,44
037 Latsch,47,,15,22,37
037 Latsch,48,,18,22,40
037 Latsch,49,,19,16,35
037 Latsch,50,,19,20,39
037 Latsch,51,,19,18,37
037 Latsch,52,,24,12,36
037 Latsch,53,,27,22,49
037 Latsch,54,,31,24,55
037 Latsch,55,,17,26,43
037 Latsch,56,,20,24,44
037 Latsch,57,,17,20,37
037 Latsch,58,,19,29,48
037 Latsch,59,,15,29,44
037 Latsch,60,,22,14,36
037 Latsch,61,,29,15,44
037 Latsch,62,,21,27,48
037 Latsch,63,,21,22,43
037 Latsch,64,,25,22,47
037 Latsch,65,,20,18,38
037 Latsch,66,,22,20,42
037 Latsch,67,,19,16,35
037 Latsch,68,,19,20,39
037 Latsch,69,,18,32,50
037 Latsch,70,,23,16,39
037 Latsch,71,,21,22,43
037 Latsch,72,,12,17,29
037 Latsch,73,,15,24,39
037 Latsch,74,,11,25,36
037 Latsch,75,,16,21,37
037 Latsch,76,,14,13,27
037 Latsch,77,,7,15,22
037 Latsch,78,,3,5,8
037 Latsch,79,,4,9,13
037 Latsch,80,,2,5,7
037 Latsch,81,,5,6,11
037 Latsch,82,,4,12,16
037 Latsch,83,,6,14,20
037 Latsch,84,,7,4,11
037 Latsch,85,,3,7,10
037 Latsch,86,,2,5,7
037 Latsch,87,,3,9,12
037 Latsch,88,,3,8,11
037 Latsch,89,,2,2,4
037 Latsch,90,,1,7,8
037 Latsch,91,,3,4,7
037 Latsch,92,,1,3,4
037 Latsch,93,,-,3,3
037 Latsch,96,,-,1,1
037 Latsch,Insgesamt,,2.249,2.338,4.587
038 Algund,0,,20,19,39
038 Algund,1,,30,21,51
038 Algund,2,,30,13,43
038 Algund,3,,24,20,44
038 Algund,4,,26,18,44
038 Algund,5,,23,21,44
038 Algund,6,,29,15,44
038 Algund,7,,20,33,53
038 Algund,8,,19,23,42
038 Algund,9,,27,19,46
038 Algund,10,,17,31,48
038 Algund,11,,26,20,46
038 Algund,12,,22,18,40
038 Algund,13,,23,28,51
038 Algund,14,,25,20,45
038 Algund,15,,23,21,44
038 Algund,16,,26,27,53
038 Algund,17,,17,21,38
038 Algund,18,,14,28,42
038 Algund,19,,17,26,43
038 Algund,20,,22,22,44
038 Algund,21,,22,20,42
038 Algund,22,,19,23,42
038 Algund,23,,30,22,52
038 Algund,24,,31,35,66
038 Algund,25,,23,31,54
038 Algund,26,,46,30,76
038 Algund,27,,41,27,68
038 Algund,28,,40,26,66
038 Algund,29,,34,39,73
038 Algund,30,,34,42,76
038 Algund,31,,32,38,70
038 Algund,32,,45,29,74
038 Algund,33,,38,41,79
038 Algund,34,,29,37,66
038 Algund,35,,28,44,72
038 Algund,36,,33,42,75
038 Algund,37,,37,28,65
038 Algund,38,,36,31,67
038 Algund,39,,27,27,54
038 Algund,40,,31,31,62
038 Algund,41,,24,26,50
038 Algund,42,,30,21,51
038 Algund,43,,17,32,49
038 Algund,44,,26,24,50
038 Algund,45,,23,27,50
038 Algund,46,,22,25,47
038 Algund,47,,27,27,54
038 Algund,48,,27,20,47
038 Algund,49,,22,18,40
038 Algund,50,,32,27,59
038 Algund,51,,26,23,49
038 Algund,52,,24,29,53
038 Algund,53,,26,22,48
038 Algund,54,,22,36,58
038 Algund,55,,23,25,48
038 Algund,56,,15,24,39
038 Algund,57,,28,31,59
038 Algund,58,,24,25,49
038 Algund,59,,16,12,28
038 Algund,60,,19,30,49
038 Algund,61,,16,20,36
038 Algund,62,,23,27,50
038 Algund,63,,25,23,48
038 Algund,64,,20,23,43
038 Algund,65,,15,25,40
038 Algund,66,,16,25,41
038 Algund,67,,15,24,39
038 Algund,68,,15,22,37
038 Algund,69,,13,23,36
038 Algund,70,,17,21,38
038 Algund,71,,12,17,29
038 Algund,72,,10,19,29
038 Algund,73,,10,12,22
038 Algund,74,,14,25,39
038 Algund,75,,13,18,31
038 Algund,76,,18,15,33
038 Algund,77,,10,17,27
038 Algund,78,,8,9,17
038 Algund,79,,4,7,11
038 Algund,80,,4,8,12
038 Algund,81,,9,8,17
038 Algund,82,,8,9,17
038 Algund,83,,2,12,14
038 Algund,84,,5,14,19
038 Algund,85,,4,13,17
038 Algund,86,,9,12,21
038 Algund,87,,3,3,6
038 Algund,88,,4,6,10
038 Algund,89,,3,4,7
038 Algund,90,,2,5,7
038 Algund,91,,3,4,7
038 Algund,92,,-,1,1
038 Algund,93,,1,-,1
038 Algund,94,,2,5,7
038 Algund,95,,-,1,1
038 Algund,99,,-,1,1
038 Algund,Insgesamt,,1.942,2.089,4.031
039 Lajen,0,,15,10,25
039 Lajen,1,,9,12,21
039 Lajen,2,,9,11,20
039 Lajen,3,,14,12,26
039 Lajen,4,,15,11,26
039 Lajen,5,,19,16,35
039 Lajen,6,,8,9,17
039 Lajen,7,,17,14,31
039 Lajen,8,,12,9,21
039 Lajen,9,,13,6,19
039 Lajen,10,,18,13,31
039 Lajen,11,,19,11,30
039 Lajen,12,,9,13,22
039 Lajen,13,,9,18,27
039 Lajen,14,,20,15,35
039 Lajen,15,,11,22,33
039 Lajen,16,,20,17,37
039 Lajen,17,,18,12,30
039 Lajen,18,,23,17,40
039 Lajen,19,,17,9,26
039 Lajen,20,,17,13,30
039 Lajen,21,,17,25,42
039 Lajen,22,,26,18,44
039 Lajen,23,,16,14,30
039 Lajen,24,,19,21,40
039 Lajen,25,,18,20,38
039 Lajen,26,,20,22,42
039 Lajen,27,,27,20,47
039 Lajen,28,,20,21,41
039 Lajen,29,,24,18,42
039 Lajen,30,,19,16,35
039 Lajen,31,,28,14,42
039 Lajen,32,,23,17,40
039 Lajen,33,,15,9,24
039 Lajen,34,,25,14,39
039 Lajen,35,,14,23,37
039 Lajen,36,,12,9,21
039 Lajen,37,,15,21,36
039 Lajen,38,,19,11,30
039 Lajen,39,,13,12,25
039 Lajen,40,,10,13,23
039 Lajen,41,,14,10,24
039 Lajen,42,,7,13,20
039 Lajen,43,,8,8,16
039 Lajen,44,,8,9,17
039 Lajen,45,,8,13,21
039 Lajen,46,,13,14,27
039 Lajen,47,,4,13,17
039 Lajen,48,,10,15,25
039 Lajen,49,,14,6,20
039 Lajen,50,,12,11,23
039 Lajen,51,,13,10,23
039 Lajen,52,,10,8,18
039 Lajen,53,,12,13,25
039 Lajen,54,,20,12,32
039 Lajen,55,,17,15,32
039 Lajen,56,,15,11,26
039 Lajen,57,,16,10,26
039 Lajen,58,,7,14,21
039 Lajen,59,,7,8,15
039 Lajen,60,,8,8,16
039 Lajen,61,,9,9,18
039 Lajen,62,,8,8,16
039 Lajen,63,,5,12,17
039 Lajen,64,,10,4,14
039 Lajen,65,,5,8,13
039 Lajen,66,,8,5,13
039 Lajen,67,,7,5,12
039 Lajen,68,,8,10,18
039 Lajen,69,,8,11,19
039 Lajen,70,,11,7,18
039 Lajen,71,,7,9,16
039 Lajen,72,,7,7,14
039 Lajen,73,,8,9,17
039 Lajen,74,,5,6,11
039 Lajen,75,,5,10,15
039 Lajen,76,,1,5,6
039 Lajen,77,,3,5,8
039 Lajen,78,,2,4,6
039 Lajen,79,,1,2,3
039 Lajen,80,,-,3,3
039 Lajen,81,,4,3,7
039 Lajen,82,,2,4,6
039 Lajen,83,,2,3,5
039 Lajen,84,,2,5,7
039 Lajen,85,,3,-,3
039 Lajen,86,,2,4,6
039 Lajen,87,,2,5,7
039 Lajen,88,,2,4,6
039 Lajen,89,,-,4,4
039 Lajen,90,,1,2,3
039 Lajen,91,,-,1,1
039 Lajen,93,,-,3,3
039 Lajen,94,,-,1,1
039 Lajen,Insgesamt,,1.053,1.007,2.060
040 Leifers,0,,99,79,178
040 Leifers,1,,95,99,194
040 Leifers,2,,86,90,176
040 Leifers,3,,79,67,146
040 Leifers,4,,87,72,159
040 Leifers,5,,88,86,174
040 Leifers,6,,95,76,171
040 Leifers,7,,68,79,147
040 Leifers,8,,68,81,149
040 Leifers,9,,61,72,133
040 Leifers,10,,77,85,162
040 Leifers,11,,78,65,143
040 Leifers,12,,73,76,149
040 Leifers,13,,72,95,167
040 Leifers,14,,61,62,123
040 Leifers,15,,68,63,131
040 Leifers,16,,73,68,141
040 Leifers,17,,64,80,144
040 Leifers,18,,68,70,138
040 Leifers,19,,73,95,168
040 Leifers,20,,79,74,153
040 Leifers,21,,93,108,201
040 Leifers,22,,117,117,234
040 Leifers,23,,122,109,231
040 Leifers,24,,131,109,240
040 Leifers,25,,127,119,246
040 Leifers,26,,122,125,247
040 Leifers,27,,142,118,260
040 Leifers,28,,136,153,289
040 Leifers,29,,141,134,275
040 Leifers,30,,153,132,285
040 Leifers,31,,155,141,296
040 Leifers,32,,174,155,329
040 Leifers,33,,135,154,289
040 Leifers,34,,138,123,261
040 Leifers,35,,146,151,297
040 Leifers,36,,132,120,252
040 Leifers,37,,120,103,223
040 Leifers,38,,99,110,209
040 Leifers,39,,104,116,220
040 Leifers,40,,144,137,281
040 Leifers,41,,109,126,235
040 Leifers,42,,95,111,206
040 Leifers,43,,119,118,237
040 Leifers,44,,105,100,205
040 Leifers,45,,110,95,205
040 Leifers,46,,95,89,184
040 Leifers,47,,104,100,204
040 Leifers,48,,115,106,221
040 Leifers,49,,105,103,208
040 Leifers,50,,129,150,279
040 Leifers,51,,78,88,166
040 Leifers,52,,103,94,197
040 Leifers,53,,101,95,196
040 Leifers,54,,94,93,187
040 Leifers,55,,93,86,179
040 Leifers,56,,98,94,192
040 Leifers,57,,101,96,197
040 Leifers,58,,97,82,179
040 Leifers,59,,69,86,155
040 Leifers,60,,69,66,135
040 Leifers,61,,57,72,129
040 Leifers,62,,73,65,138
040 Leifers,63,,67,66,133
040 Leifers,64,,72,81,153
040 Leifers,65,,57,72,129
040 Leifers,66,,65,67,132
040 Leifers,67,,53,62,115
040 Leifers,68,,55,48,103
040 Leifers,69,,43,70,113
040 Leifers,70,,38,58,96
040 Leifers,71,,35,56,91
040 Leifers,72,,35,59,94
040 Leifers,73,,34,41,75
040 Leifers,74,,33,45,78
040 Leifers,75,,28,31,59
040 Leifers,76,,25,29,54
040 Leifers,77,,15,37,52
040 Leifers,78,,11,21,32
040 Leifers,79,,4,13,17
040 Leifers,80,,8,20,28
040 Leifers,81,,7,22,29
040 Leifers,82,,11,27,38
040 Leifers,83,,16,28,44
040 Leifers,84,,11,32,43
040 Leifers,85,,9,25,34
040 Leifers,86,,3,20,23
040 Leifers,87,,8,14,22
040 Leifers,88,,3,10,13
040 Leifers,89,,4,11,15
040 Leifers,90,,1,10,11
040 Leifers,91,,4,5,9
040 Leifers,92,,1,7,8
040 Leifers,93,,1,5,6
040 Leifers,94,,-,3,3
040 Leifers,95,,-,2,2
040 Leifers,96,,-,3,3
040 Leifers,Insgesamt,,7.119,7.383,14.502
041 Lana,0,,53,61,114
041 Lana,1,,53,55,108
041 Lana,2,,54,62,116
041 Lana,3,,54,51,105
041 Lana,4,,52,54,106
041 Lana,5,,50,58,108
041 Lana,6,,41,60,101
041 Lana,7,,41,71,112
041 Lana,8,,57,48,105
041 Lana,9,,66,45,111
041 Lana,10,,55,48,103
041 Lana,11,,57,53,110
041 Lana,12,,60,46,106
041 Lana,13,,63,58,121
041 Lana,14,,63,50,113
041 Lana,15,,46,62,108
041 Lana,16,,49,49,98
041 Lana,17,,53,65,118
041 Lana,18,,59,50,109
041 Lana,19,,68,47,115
041 Lana,20,,54,48,102
041 Lana,21,,53,59,112
041 Lana,22,,66,58,124
041 Lana,23,,67,73,140
041 Lana,24,,84,64,148
041 Lana,25,,71,70,141
041 Lana,26,,66,88,154
041 Lana,27,,109,62,171
041 Lana,28,,65,78,143
041 Lana,29,,85,87,172
041 Lana,30,,80,95,175
041 Lana,31,,91,85,176
041 Lana,32,,86,85,171
041 Lana,33,,99,81,180
041 Lana,34,,80,76,156
041 Lana,35,,76,81,157
041 Lana,36,,76,71,147
041 Lana,37,,84,72,156
041 Lana,38,,71,83,154
041 Lana,39,,77,70,147
041 Lana,40,,59,62,121
041 Lana,41,,60,67,127
041 Lana,42,,60,58,118
041 Lana,43,,59,62,121
041 Lana,44,,46,56,102
041 Lana,45,,56,61,117
041 Lana,46,,48,54,102
041 Lana,47,,52,55,107
041 Lana,48,,56,64,120
041 Lana,49,,56,44,100
041 Lana,50,,68,62,130
041 Lana,51,,43,47,90
041 Lana,52,,50,56,106
041 Lana,53,,60,58,118
041 Lana,54,,61,64,125
041 Lana,55,,51,48,99
041 Lana,56,,40,47,87
041 Lana,57,,54,50,104
041 Lana,58,,46,60,106
041 Lana,59,,36,42,78
041 Lana,60,,45,51,96
041 Lana,61,,42,39,81
041 Lana,62,,41,42,83
041 Lana,63,,35,44,79
041 Lana,64,,34,35,69
041 Lana,65,,30,45,75
041 Lana,66,,29,40,69
041 Lana,67,,26,40,66
041 Lana,68,,40,35,75
041 Lana,69,,34,39,73
041 Lana,70,,30,41,71
041 Lana,71,,34,47,81
041 Lana,72,,17,26,43
041 Lana,73,,22,36,58
041 Lana,74,,29,40,69
041 Lana,75,,20,38,58
041 Lana,76,,23,40,63
041 Lana,77,,12,29,41
041 Lana,78,,4,13,17
041 Lana,79,,5,22,27
041 Lana,80,,3,7,10
041 Lana,81,,16,27,43
041 Lana,82,,16,15,31
041 Lana,83,,10,31,41
041 Lana,84,,7,18,25
041 Lana,85,,7,27,34
041 Lana,86,,8,18,26
041 Lana,87,,6,12,18
041 Lana,88,,6,13,19
041 Lana,89,,2,10,12
041 Lana,90,,4,11,15
041 Lana,91,,3,5,8
041 Lana,92,,1,6,7
041 Lana,93,,1,6,7
041 Lana,94,,-,4,4
041 Lana,95,,1,5,6
041 Lana,96,,1,1,2
041 Lana,97,,1,-,1
041 Lana,Insgesamt,,4.340,4.654,8.994
042 Laas,0,,32,27,59
042 Laas,1,,31,22,53
042 Laas,2,,27,25,52
042 Laas,3,,22,20,42
042 Laas,4,,15,25,40
042 Laas,5,,24,20,44
042 Laas,6,,23,25,48
042 Laas,7,,20,23,43
042 Laas,8,,24,18,42
042 Laas,9,,28,22,50
042 Laas,10,,32,22,54
042 Laas,11,,26,27,53
042 Laas,12,,28,25,53
042 Laas,13,,22,38,60
042 Laas,14,,34,24,58
042 Laas,15,,26,28,54
042 Laas,16,,17,23,40
042 Laas,17,,30,32,62
042 Laas,18,,31,18,49
042 Laas,19,,25,20,45
042 Laas,20,,25,27,52
042 Laas,21,,28,25,53
042 Laas,22,,34,25,59
042 Laas,23,,30,35,65
042 Laas,24,,26,28,54
042 Laas,25,,30,26,56
042 Laas,26,,40,27,67
042 Laas,27,,37,44,81
042 Laas,28,,42,25,67
042 Laas,29,,30,26,56
042 Laas,30,,37,26,63
042 Laas,31,,39,32,71
042 Laas,32,,28,30,58
042 Laas,33,,31,27,58
042 Laas,34,,35,28,63
042 Laas,35,,29,28,57
042 Laas,36,,34,21,55
042 Laas,37,,35,30,65
042 Laas,38,,27,24,51
042 Laas,39,,18,26,44
042 Laas,40,,24,17,41
042 Laas,41,,15,14,29
042 Laas,42,,16,24,40
042 Laas,43,,25,12,37
042 Laas,44,,28,25,53
042 Laas,45,,16,17,33
042 Laas,46,,25,26,51
042 Laas,47,,20,20,40
042 Laas,48,,16,20,36
042 Laas,49,,27,13,40
042 Laas,50,,14,15,29
042 Laas,51,,16,12,28
042 Laas,52,,13,15,28
042 Laas,53,,13,16,29
042 Laas,54,,16,20,36
042 Laas,55,,16,21,37
042 Laas,56,,24,25,49
042 Laas,57,,15,25,40
042 Laas,58,,21,14,35
042 Laas,59,,16,14,30
042 Laas,60,,24,14,38
042 Laas,61,,19,21,40
042 Laas,62,,12,21,33
042 Laas,63,,23,12,35
042 Laas,64,,17,18,35
042 Laas,65,,21,23,44
042 Laas,66,,20,22,42
042 Laas,67,,18,14,32
042 Laas,68,,15,13,28
042 Laas,69,,15,19,34
042 Laas,70,,18,13,31
042 Laas,71,,11,15,26
042 Laas,72,,13,20,33
042 Laas,73,,17,12,29
042 Laas,74,,11,20,31
042 Laas,75,,7,11,18
042 Laas,76,,11,13,24
042 Laas,77,,5,12,17
042 Laas,78,,8,5,13
042 Laas,79,,3,4,7
042 Laas,80,,4,4,8
042 Laas,81,,1,4,5
042 Laas,82,,2,9,11
042 Laas,83,,3,9,12
042 Laas,84,,4,9,13
042 Laas,85,,1,3,4
042 Laas,86,,6,6,12
042 Laas,87,,5,5,10
042 Laas,88,,-,5,5
042 Laas,89,,1,4,5
042 Laas,90,,-,3,3
042 Laas,91,,-,2,2
042 Laas,92,,1,-,1
042 Laas,94,,-,3,3
042 Laas,95,,-,1,1
042 Laas,96,,-,1,1
042 Laas,Insgesamt,,1.844,1.779,3.623
043 Laurein,0,,-,2,2
043 Laurein,1,,3,3,6
043 Laurein,2,,2,3,5
043 Laurein,3,,1,5,6
043 Laurein,4,,1,1,2
043 Laurein,5,,1,1,2
043 Laurein,6,,4,-,4
043 Laurein,7,,3,2,5
043 Laurein,8,,1,-,1
043 Laurein,9,,2,2,4
043 Laurein,10,,4,2,6
043 Laurein,11,,2,3,5
043 Laurein,12,,1,2,3
043 Laurein,13,,1,-,1
043 Laurein,14,,2,2,4
043 Laurein,15,,3,1,4
043 Laurein,16,,2,-,2
043 Laurein,17,,2,-,2
043 Laurein,18,,2,5,7
043 Laurein,19,,1,2,3
043 Laurein,20,,4,-,4
043 Laurein,21,,-,6,6
043 Laurein,22,,-,5,5
043 Laurein,23,,5,1,6
043 Laurein,24,,1,2,3
043 Laurein,25,,6,5,11
043 Laurein,26,,5,4,9
043 Laurein,27,,5,5,10
043 Laurein,28,,-,2,2
043 Laurein,29,,5,7,12
043 Laurein,30,,6,2,8
043 Laurein,31,,5,2,7
043 Laurein,32,,3,3,6
043 Laurein,33,,1,2,3
043 Laurein,34,,2,2,4
043 Laurein,35,,5,6,11
043 Laurein,36,,2,1,3
043 Laurein,37,,4,4,8
043 Laurein,38,,3,2,5
043 Laurein,39,,7,-,7
043 Laurein,41,,3,-,3
043 Laurein,42,,3,1,4
043 Laurein,43,,2,1,3
043 Laurein,44,,2,1,3
043 Laurein,46,,2,1,3
043 Laurein,47,,3,2,5
043 Laurein,48,,2,-,2
043 Laurein,49,,2,3,5
043 Laurein,50,,-,1,1
043 Laurein,51,,-,1,1
043 Laurein,52,,-,1,1
043 Laurein,53,,1,-,1
043 Laurein,54,,2,-,2
043 Laurein,56,,4,2,6
043 Laurein,57,,3,3,6
043 Laurein,58,,1,1,2
043 Laurein,59,,2,1,3
043 Laurein,60,,1,2,3
043 Laurein,61,,1,3,4
043 Laurein,62,,2,5,7
043 Laurein,63,,1,3,4
043 Laurein,64,,4,2,6
043 Laurein,65,,1,3,4
043 Laurein,66,,3,5,8
043 Laurein,67,,3,-,3
043 Laurein,68,,5,1,6
043 Laurein,69,,7,1,8
043 Laurein,70,,2,2,4
043 Laurein,71,,4,2,6
043 Laurein,72,,-,2,2
043 Laurein,73,,1,-,1
043 Laurein,74,,-,3,3
043 Laurein,75,,1,-,1
043 Laurein,76,,3,3,6
043 Laurein,80,,1,-,1
043 Laurein,81,,1,-,1
043 Laurein,82,,-,3,3
043 Laurein,83,,1,1,2
043 Laurein,84,,1,-,1
043 Laurein,85,,-,1,1
043 Laurein,86,,1,2,3
043 Laurein,89,,1,1,2
043 Laurein,90,,-,1,1
043 Laurein,Insgesamt,,184,162,346
044 Lüsen,0,,9,11,20
044 Lüsen,1,,8,11,19
044 Lüsen,2,,14,14,28
044 Lüsen,3,,10,9,19
044 Lüsen,4,,10,11,21
044 Lüsen,5,,8,10,18
044 Lüsen,6,,6,11,17
044 Lüsen,7,,18,7,25
044 Lüsen,8,,10,9,19
044 Lüsen,9,,7,8,15
044 Lüsen,10,,12,12,24
044 Lüsen,11,,3,3,6
044 Lüsen,12,,9,18,27
044 Lüsen,13,,6,11,17
044 Lüsen,14,,15,10,25
044 Lüsen,15,,11,13,24
044 Lüsen,16,,15,13,28
044 Lüsen,17,,8,10,18
044 Lüsen,18,,16,18,34
044 Lüsen,19,,6,9,15
044 Lüsen,20,,15,10,25
044 Lüsen,21,,12,10,22
044 Lüsen,22,,18,12,30
044 Lüsen,23,,10,6,16
044 Lüsen,24,,12,12,24
044 Lüsen,25,,16,15,31
044 Lüsen,26,,18,17,35
044 Lüsen,27,,9,12,21
044 Lüsen,28,,15,17,32
044 Lüsen,29,,12,23,35
044 Lüsen,30,,11,15,26
044 Lüsen,31,,18,13,31
044 Lüsen,32,,14,9,23
044 Lüsen,33,,14,8,22
044 Lüsen,34,,9,13,22
044 Lüsen,35,,12,9,21
044 Lüsen,36,,9,13,22
044 Lüsen,37,,7,4,11
044 Lüsen,38,,11,13,24
044 Lüsen,39,,10,11,21
044 Lüsen,40,,10,9,19
044 Lüsen,41,,7,7,14
044 Lüsen,42,,14,5,19
044 Lüsen,43,,8,10,18
044 Lüsen,44,,10,4,14
044 Lüsen,45,,5,7,12
044 Lüsen,46,,6,7,13
044 Lüsen,47,,8,12,20
044 Lüsen,48,,8,2,10
044 Lüsen,49,,7,4,11
044 Lüsen,50,,10,5,15
044 Lüsen,51,,4,9,13
044 Lüsen,52,,4,7,11
044 Lüsen,53,,7,6,13
044 Lüsen,54,,2,6,8
044 Lüsen,55,,7,5,12
044 Lüsen,56,,6,9,15
044 Lüsen,57,,9,7,16
044 Lüsen,58,,8,4,12
044 Lüsen,59,,9,6,15
044 Lüsen,60,,6,9,15
044 Lüsen,61,,8,5,13
044 Lüsen,62,,4,6,10
044 Lüsen,63,,7,5,12
044 Lüsen,64,,4,11,15
044 Lüsen,65,,8,5,13
044 Lüsen,66,,4,6,10
044 Lüsen,67,,6,8,14
044 Lüsen,68,,8,9,17
044 Lüsen,69,,8,4,12
044 Lüsen,70,,5,9,14
044 Lüsen,71,,4,7,11
044 Lüsen,72,,5,3,8
044 Lüsen,73,,5,4,9
044 Lüsen,74,,2,4,6
044 Lüsen,75,,2,7,9
044 Lüsen,76,,3,6,9
044 Lüsen,77,,3,2,5
044 Lüsen,78,,-,4,4
044 Lüsen,79,,1,2,3
044 Lüsen,80,,-,3,3
044 Lüsen,81,,-,4,4
044 Lüsen,82,,3,3,6
044 Lüsen,83,,5,4,9
044 Lüsen,84,,3,3,6
044 Lüsen,85,,1,2,3
044 Lüsen,86,,-,1,1
044 Lüsen,87,,1,2,3
044 Lüsen,88,,2,-,2
044 Lüsen,92,,1,-,1
044 Lüsen,93,,1,-,1
044 Lüsen,96,,-,1,1
044 Lüsen,Insgesamt,,712,730,1.442
045 Margreid a.d. Weinstr.,0,,6,4,10
045 Margreid a.d. Weinstr.,1,,1,8,9
045 Margreid a.d. Weinstr.,2,,6,7,13
045 Margreid a.d. Weinstr.,3,,4,13,17
045 Margreid a.d. Weinstr.,4,,4,2,6
045 Margreid a.d. Weinstr.,5,,7,7,14
045 Margreid a.d. Weinstr.,6,,6,10,16
045 Margreid a.d. Weinstr.,7,,7,6,13
045 Margreid a.d. Weinstr.,8,,8,6,14
045 Margreid a.d. Weinstr.,9,,7,5,12
045 Margreid a.d. Weinstr.,10,,6,10,16
045 Margreid a.d. Weinstr.,11,,11,-,11
045 Margreid a.d. Weinstr.,12,,4,12,16
045 Margreid a.d. Weinstr.,13,,6,9,15
045 Margreid a.d. Weinstr.,14,,8,9,17
045 Margreid a.d. Weinstr.,15,,13,2,15
045 Margreid a.d. Weinstr.,16,,2,1,3
045 Margreid a.d. Weinstr.,17,,8,4,12
045 Margreid a.d. Weinstr.,18,,7,4,11
045 Margreid a.d. Weinstr.,19,,8,6,14
045 Margreid a.d. Weinstr.,20,,8,7,15
045 Margreid a.d. Weinstr.,21,,7,5,12
045 Margreid a.d. Weinstr.,22,,5,11,16
045 Margreid a.d. Weinstr.,23,,9,10,19
045 Margreid a.d. Weinstr.,24,,8,7,15
045 Margreid a.d. Weinstr.,25,,9,9,18
045 Margreid a.d. Weinstr.,26,,10,8,18
045 Margreid a.d. Weinstr.,27,,13,11,24
045 Margreid a.d. Weinstr.,28,,22,14,36
045 Margreid a.d. Weinstr.,29,,11,14,25
045 Margreid a.d. Weinstr.,30,,19,12,31
045 Margreid a.d. Weinstr.,31,,12,5,17
045 Margreid a.d. Weinstr.,32,,6,7,13
045 Margreid a.d. Weinstr.,33,,12,11,23
045 Margreid a.d. Weinstr.,34,,7,12,19
045 Margreid a.d. Weinstr.,35,,14,12,26
045 Margreid a.d. Weinstr.,36,,15,8,23
045 Margreid a.d. Weinstr.,37,,9,13,22
045 Margreid a.d. Weinstr.,38,,8,6,14
045 Margreid a.d. Weinstr.,39,,8,4,12
045 Margreid a.d. Weinstr.,40,,12,5,17
045 Margreid a.d. Weinstr.,41,,8,6,14
045 Margreid a.d. Weinstr.,42,,5,4,9
045 Margreid a.d. Weinstr.,43,,9,7,16
045 Margreid a.d. Weinstr.,44,,7,9,16
045 Margreid a.d. Weinstr.,45,,3,8,11
045 Margreid a.d. Weinstr.,46,,5,6,11
045 Margreid a.d. Weinstr.,47,,9,5,14
045 Margreid a.d. Weinstr.,48,,6,10,16
045 Margreid a.d. Weinstr.,49,,6,7,13
045 Margreid a.d. Weinstr.,50,,5,5,10
045 Margreid a.d. Weinstr.,51,,7,7,14
045 Margreid a.d. Weinstr.,52,,4,6,10
045 Margreid a.d. Weinstr.,53,,7,3,10
045 Margreid a.d. Weinstr.,54,,11,5,16
045 Margreid a.d. Weinstr.,55,,7,7,14
045 Margreid a.d. Weinstr.,56,,5,3,8
045 Margreid a.d. Weinstr.,57,,4,5,9
045 Margreid a.d. Weinstr.,58,,5,7,12
045 Margreid a.d. Weinstr.,59,,6,4,10
045 Margreid a.d. Weinstr.,60,,7,6,13
045 Margreid a.d. Weinstr.,61,,2,7,9
045 Margreid a.d. Weinstr.,62,,5,3,8
045 Margreid a.d. Weinstr.,63,,4,6,10
045 Margreid a.d. Weinstr.,64,,4,7,11
045 Margreid a.d. Weinstr.,65,,7,6,13
045 Margreid a.d. Weinstr.,66,,7,4,11
045 Margreid a.d. Weinstr.,67,,2,4,6
045 Margreid a.d. Weinstr.,68,,6,4,10
045 Margreid a.d. Weinstr.,69,,4,6,10
045 Margreid a.d. Weinstr.,70,,5,7,12
045 Margreid a.d. Weinstr.,71,,3,4,7
045 Margreid a.d. Weinstr.,72,,2,5,7
045 Margreid a.d. Weinstr.,73,,4,6,10
045 Margreid a.d. Weinstr.,74,,1,3,4
045 Margreid a.d. Weinstr.,75,,1,4,5
045 Margreid a.d. Weinstr.,76,,1,3,4
045 Margreid a.d. Weinstr.,77,,3,6,9
045 Margreid a.d. Weinstr.,78,,1,1,2
045 Margreid a.d. Weinstr.,79,,-,1,1
045 Margreid a.d. Weinstr.,80,,2,4,6
045 Margreid a.d. Weinstr.,81,,1,2,3
045 Margreid a.d. Weinstr.,82,,-,2,2
045 Margreid a.d. Weinstr.,83,,2,2,4
045 Margreid a.d. Weinstr.,84,,1,3,4
045 Margreid a.d. Weinstr.,85,,-,7,7
045 Margreid a.d. Weinstr.,86,,1,2,3
045 Margreid a.d. Weinstr.,87,,2,1,3
045 Margreid a.d. Weinstr.,88,,1,1,2
045 Margreid a.d. Weinstr.,89,,-,2,2
045 Margreid a.d. Weinstr.,90,,-,2,2
045 Margreid a.d. Weinstr.,91,,-,3,3
045 Margreid a.d. Weinstr.,Insgesamt,,551,554,1.105
046 Mals,0,,28,24,52
046 Mals,1,,35,40,75
046 Mals,2,,38,31,69
046 Mals,3,,30,31,61
046 Mals,4,,33,31,64
046 Mals,5,,33,33,66
046 Mals,6,,38,27,65
046 Mals,7,,38,36,74
046 Mals,8,,32,28,60
046 Mals,9,,32,31,63
046 Mals,10,,31,34,65
046 Mals,11,,40,37,77
046 Mals,12,,39,37,76
046 Mals,13,,31,33,64
046 Mals,14,,36,35,71
046 Mals,15,,35,39,74
046 Mals,16,,36,35,71
046 Mals,17,,32,31,63
046 Mals,18,,42,36,78
046 Mals,19,,33,25,58
046 Mals,20,,40,26,66
046 Mals,21,,42,37,79
046 Mals,22,,49,33,82
046 Mals,23,,32,40,72
046 Mals,24,,40,50,90
046 Mals,25,,42,52,94
046 Mals,26,,51,41,92
046 Mals,27,,51,43,94
046 Mals,28,,60,46,106
046 Mals,29,,49,27,76
046 Mals,30,,64,45,109
046 Mals,31,,51,37,88
046 Mals,32,,48,45,93
046 Mals,33,,49,55,104
046 Mals,34,,38,28,66
046 Mals,35,,52,42,94
046 Mals,36,,32,41,73
046 Mals,37,,32,38,70
046 Mals,38,,32,24,56
046 Mals,39,,43,35,78
046 Mals,40,,37,28,65
046 Mals,41,,29,26,55
046 Mals,42,,22,20,42
046 Mals,43,,31,33,64
046 Mals,44,,33,22,55
046 Mals,45,,35,22,57
046 Mals,46,,37,20,57
046 Mals,47,,18,27,45
046 Mals,48,,28,14,42
046 Mals,49,,23,20,43
046 Mals,50,,25,28,53
046 Mals,51,,14,18,32
046 Mals,52,,31,13,44
046 Mals,53,,27,18,45
046 Mals,54,,24,26,50
046 Mals,55,,21,18,39
046 Mals,56,,21,27,48
046 Mals,57,,28,25,53
046 Mals,58,,23,22,45
046 Mals,59,,17,32,49
046 Mals,60,,22,16,38
046 Mals,61,,16,21,37
046 Mals,62,,16,19,35
046 Mals,63,,18,24,42
046 Mals,64,,20,15,35
046 Mals,65,,18,18,36
046 Mals,66,,26,19,45
046 Mals,67,,24,19,43
046 Mals,68,,24,16,40
046 Mals,69,,22,16,38
046 Mals,70,,14,24,38
046 Mals,71,,15,21,36
046 Mals,72,,12,20,32
046 Mals,73,,9,17,26
046 Mals,74,,15,17,32
046 Mals,75,,16,15,31
046 Mals,76,,8,23,31
046 Mals,77,,7,23,30
046 Mals,78,,3,9,12
046 Mals,79,,6,5,11
046 Mals,80,,3,8,11
046 Mals,81,,9,13,22
046 Mals,82,,6,11,17
046 Mals,83,,14,23,37
046 Mals,84,,6,6,12
046 Mals,85,,3,10,13
046 Mals,86,,1,11,12
046 Mals,87,,2,3,5
046 Mals,88,,3,6,9
046 Mals,89,,2,3,5
046 Mals,90,,1,2,3
046 Mals,92,,-,3,3
046 Mals,93,,-,3,3
046 Mals,95,,1,2,3
046 Mals,96,,-,1,1
046 Mals,97,,-,2,2
046 Mals,Insgesamt,,2.475,2.362,4.837
047 Enneberg,0,,17,13,30
047 Enneberg,1,,21,8,29
047 Enneberg,2,,19,13,32
047 Enneberg,3,,19,19,38
047 Enneberg,4,,15,14,29
047 Enneberg,5,,17,22,39
047 Enneberg,6,,15,18,33
047 Enneberg,7,,20,15,35
047 Enneberg,8,,21,14,35
047 Enneberg,9,,16,13,29
047 Enneberg,10,,18,10,28
047 Enneberg,11,,23,16,39
047 Enneberg,12,,19,19,38
047 Enneberg,13,,12,16,28
047 Enneberg,14,,24,19,43
047 Enneberg,15,,22,20,42
047 Enneberg,16,,25,18,43
047 Enneberg,17,,11,21,32
047 Enneberg,18,,13,25,38
047 Enneberg,19,,19,21,40
047 Enneberg,20,,12,17,29
047 Enneberg,21,,12,26,38
047 Enneberg,22,,25,33,58
047 Enneberg,23,,21,23,44
047 Enneberg,24,,23,25,48
047 Enneberg,25,,32,31,63
047 Enneberg,26,,25,25,50
047 Enneberg,27,,29,21,50
047 Enneberg,28,,22,23,45
047 Enneberg,29,,24,23,47
047 Enneberg,30,,21,25,46
047 Enneberg,31,,28,25,53
047 Enneberg,32,,22,22,44
047 Enneberg,33,,25,20,45
047 Enneberg,34,,17,13,30
047 Enneberg,35,,18,17,35
047 Enneberg,36,,14,18,32
047 Enneberg,37,,23,14,37
047 Enneberg,38,,20,8,28
047 Enneberg,39,,16,15,31
047 Enneberg,40,,15,16,31
047 Enneberg,41,,12,13,25
047 Enneberg,42,,13,12,25
047 Enneberg,43,,18,20,38
047 Enneberg,44,,13,17,30
047 Enneberg,45,,17,11,28
047 Enneberg,46,,12,16,28
047 Enneberg,47,,18,8,26
047 Enneberg,48,,15,13,28
047 Enneberg,49,,9,11,20
047 Enneberg,50,,15,17,32
047 Enneberg,51,,9,13,22
047 Enneberg,52,,20,15,35
047 Enneberg,53,,19,12,31
047 Enneberg,54,,12,20,32
047 Enneberg,55,,14,10,24
047 Enneberg,56,,14,8,22
047 Enneberg,57,,18,11,29
047 Enneberg,58,,15,20,35
047 Enneberg,59,,17,13,30
047 Enneberg,60,,15,14,29
047 Enneberg,61,,15,16,31
047 Enneberg,62,,9,12,21
047 Enneberg,63,,12,9,21
047 Enneberg,64,,9,17,26
047 Enneberg,65,,13,12,25
047 Enneberg,66,,16,16,32
047 Enneberg,67,,10,7,17
047 Enneberg,68,,10,14,24
047 Enneberg,69,,14,9,23
047 Enneberg,70,,8,9,17
047 Enneberg,71,,11,7,18
047 Enneberg,72,,5,10,15
047 Enneberg,73,,8,13,21
047 Enneberg,74,,7,8,15
047 Enneberg,75,,4,13,17
047 Enneberg,76,,6,4,10
047 Enneberg,77,,4,6,10
047 Enneberg,78,,5,3,8
047 Enneberg,79,,1,8,9
047 Enneberg,80,,1,10,11
047 Enneberg,81,,4,8,12
047 Enneberg,82,,4,5,9
047 Enneberg,83,,4,6,10
047 Enneberg,84,,2,6,8
047 Enneberg,85,,4,7,11
047 Enneberg,86,,7,6,13
047 Enneberg,87,,4,2,6
047 Enneberg,88,,-,7,7
047 Enneberg,89,,2,2,4
047 Enneberg,90,,2,-,2
047 Enneberg,91,,-,2,2
047 Enneberg,92,,1,3,4
047 Enneberg,98,,1,-,1
047 Enneberg,Insgesamt,,1.308,1.305,2.613
048 Marling,0,,17,12,29
048 Marling,1,,21,12,33
048 Marling,2,,9,9,18
048 Marling,3,,15,8,23
048 Marling,4,,17,14,31
048 Marling,5,,12,10,22
048 Marling,6,,11,16,27
048 Marling,7,,11,16,27
048 Marling,8,,11,14,25
048 Marling,9,,5,9,14
048 Marling,10,,14,10,24
048 Marling,11,,11,15,26
048 Marling,12,,11,6,17
048 Marling,13,,10,10,20
048 Marling,14,,11,8,19
048 Marling,15,,14,11,25
048 Marling,16,,12,9,21
048 Marling,17,,16,17,33
048 Marling,18,,17,13,30
048 Marling,19,,11,16,27
048 Marling,20,,17,15,32
048 Marling,21,,14,14,28
048 Marling,22,,11,12,23
048 Marling,23,,15,18,33
048 Marling,24,,14,13,27
048 Marling,25,,25,16,41
048 Marling,26,,20,17,37
048 Marling,27,,27,22,49
048 Marling,28,,25,18,43
048 Marling,29,,19,21,40
048 Marling,30,,20,25,45
048 Marling,31,,23,19,42
048 Marling,32,,23,16,39
048 Marling,33,,33,30,63
048 Marling,34,,24,19,43
048 Marling,35,,25,12,37
048 Marling,36,,19,19,38
048 Marling,37,,17,15,32
048 Marling,38,,18,12,30
048 Marling,39,,8,14,22
048 Marling,40,,10,12,22
048 Marling,41,,10,7,17
048 Marling,42,,17,12,29
048 Marling,43,,11,16,27
048 Marling,44,,15,14,29
048 Marling,45,,6,13,19
048 Marling,46,,18,17,35
048 Marling,47,,19,18,37
048 Marling,48,,10,19,29
048 Marling,49,,18,13,31
048 Marling,50,,17,15,32
048 Marling,51,,19,12,31
048 Marling,52,,16,14,30
048 Marling,53,,11,17,28
048 Marling,54,,11,11,22
048 Marling,55,,24,18,42
048 Marling,56,,14,13,27
048 Marling,57,,16,19,35
048 Marling,58,,14,13,27
048 Marling,59,,12,17,29
048 Marling,60,,15,8,23
048 Marling,61,,7,15,22
048 Marling,62,,14,11,25
048 Marling,63,,9,13,22
048 Marling,64,,11,10,21
048 Marling,65,,14,10,24
048 Marling,66,,8,11,19
048 Marling,67,,9,9,18
048 Marling,68,,10,5,15
048 Marling,69,,12,10,22
048 Marling,70,,6,14,20
048 Marling,71,,6,18,24
048 Marling,72,,4,9,13
048 Marling,73,,7,8,15
048 Marling,74,,4,6,10
048 Marling,75,,5,9,14
048 Marling,76,,-,3,3
048 Marling,77,,5,7,12
048 Marling,78,,1,6,7
048 Marling,79,,4,2,6
048 Marling,80,,1,3,4
048 Marling,81,,3,4,7
048 Marling,82,,2,6,8
048 Marling,83,,2,6,8
048 Marling,84,,3,8,11
048 Marling,85,,-,1,1
048 Marling,86,,1,5,6
048 Marling,87,,3,2,5
048 Marling,88,,4,2,6
048 Marling,89,,-,5,5
048 Marling,90,,1,-,1
048 Marling,91,,-,4,4
048 Marling,92,,1,1,2
048 Marling,Insgesamt,,1.113,1.103,2.216
049 Martell,0,,4,5,9
049 Martell,1,,8,8,16
049 Martell,2,,6,9,15
049 Martell,3,,7,8,15
049 Martell,4,,5,5,10
049 Martell,5,,8,6,14
049 Martell,6,,6,5,11
049 Martell,7,,10,3,13
049 Martell,8,,4,1,5
049 Martell,9,,8,4,12
049 Martell,10,,-,4,4
049 Martell,11,,5,7,12
049 Martell,12,,6,4,10
049 Martell,13,,9,4,13
049 Martell,14,,6,6,12
049 Martell,15,,8,5,13
049 Martell,16,,9,5,14
049 Martell,17,,9,7,16
049 Martell,18,,3,6,9
049 Martell,19,,7,4,11
049 Martell,20,,6,7,13
049 Martell,21,,2,6,8
049 Martell,22,,6,9,15
049 Martell,23,,9,7,16
049 Martell,24,,6,7,13
049 Martell,25,,12,5,17
049 Martell,26,,6,5,11
049 Martell,27,,6,15,21
049 Martell,28,,11,6,17
049 Martell,29,,6,8,14
049 Martell,30,,16,5,21
049 Martell,31,,18,9,27
049 Martell,32,,9,8,17
049 Martell,33,,16,2,18
049 Martell,34,,12,10,22
049 Martell,35,,8,5,13
049 Martell,36,,10,3,13
049 Martell,37,,8,7,15
049 Martell,38,,7,6,13
049 Martell,39,,7,3,10
049 Martell,40,,4,3,7
049 Martell,41,,7,2,9
049 Martell,42,,7,6,13
049 Martell,43,,5,4,9
049 Martell,44,,6,4,10
049 Martell,45,,6,8,14
049 Martell,46,,3,4,7
049 Martell,47,,4,2,6
049 Martell,48,,6,4,10
049 Martell,49,,5,3,8
049 Martell,50,,3,-,3
049 Martell,51,,6,1,7
049 Martell,52,,1,3,4
049 Martell,53,,2,3,5
049 Martell,54,,5,6,11
049 Martell,55,,4,4,8
049 Martell,56,,6,2,8
049 Martell,57,,2,5,7
049 Martell,58,,1,6,7
049 Martell,59,,3,5,8
049 Martell,60,,3,4,7
049 Martell,61,,4,9,13
049 Martell,62,,9,1,10
049 Martell,63,,6,5,11
049 Martell,64,,2,4,6
049 Martell,65,,6,1,7
049 Martell,66,,7,4,11
049 Martell,67,,5,4,9
049 Martell,68,,3,6,9
049 Martell,69,,3,3,6
049 Martell,70,,3,9,12
049 Martell,71,,2,3,5
049 Martell,72,,5,7,12
049 Martell,73,,1,7,8
049 Martell,74,,2,3,5
049 Martell,75,,1,2,3
049 Martell,76,,-,2,2
049 Martell,77,,1,1,2
049 Martell,78,,2,3,5
049 Martell,79,,1,-,1
049 Martell,80,,-,1,1
049 Martell,81,,4,4,8
049 Martell,82,,1,1,2
049 Martell,83,,1,-,1
049 Martell,84,,1,-,1
049 Martell,85,,3,3,6
049 Martell,86,,-,1,1
049 Martell,87,,1,1,2
049 Martell,88,,-,1,1
049 Martell,89,,-,1,1
049 Martell,90,,1,-,1
049 Martell,93,,-,1,1
049 Martell,Insgesamt,,473,406,879
050 Mölten,0,,16,10,26
050 Mölten,1,,11,10,21
050 Mölten,2,,11,5,16
050 Mölten,3,,13,11,24
050 Mölten,4,,7,15,22
050 Mölten,5,,12,6,18
050 Mölten,6,,13,5,18
050 Mölten,7,,12,6,18
050 Mölten,8,,7,8,15
050 Mölten,9,,9,8,17
050 Mölten,10,,10,6,16
050 Mölten,11,,7,13,20
050 Mölten,12,,6,3,9
050 Mölten,13,,7,15,22
050 Mölten,14,,9,6,15
050 Mölten,15,,12,6,18
050 Mölten,16,,12,8,20
050 Mölten,17,,11,9,20
050 Mölten,18,,10,6,16
050 Mölten,19,,6,12,18
050 Mölten,20,,7,18,25
050 Mölten,21,,15,10,25
050 Mölten,22,,12,10,22
050 Mölten,23,,11,12,23
050 Mölten,24,,12,8,20
050 Mölten,25,,15,9,24
050 Mölten,26,,15,11,26
050 Mölten,27,,17,16,33
050 Mölten,28,,15,17,32
050 Mölten,29,,18,13,31
050 Mölten,30,,15,14,29
050 Mölten,31,,9,14,23
050 Mölten,32,,24,11,35
050 Mölten,33,,15,8,23
050 Mölten,34,,12,10,22
050 Mölten,35,,17,9,26
050 Mölten,36,,7,7,14
050 Mölten,37,,13,4,17
050 Mölten,38,,2,11,13
050 Mölten,39,,5,2,7
050 Mölten,40,,4,7,11
050 Mölten,41,,15,7,22
050 Mölten,42,,7,5,12
050 Mölten,43,,5,6,11
050 Mölten,44,,5,4,9
050 Mölten,45,,5,3,8
050 Mölten,46,,9,9,18
050 Mölten,47,,6,4,10
050 Mölten,48,,4,4,8
050 Mölten,49,,4,7,11
050 Mölten,50,,10,2,12
050 Mölten,51,,5,5,10
050 Mölten,52,,2,6,8
050 Mölten,53,,14,8,22
050 Mölten,54,,6,10,16
050 Mölten,55,,10,3,13
050 Mölten,56,,7,7,14
050 Mölten,57,,5,8,13
050 Mölten,58,,2,3,5
050 Mölten,59,,5,6,11
050 Mölten,60,,5,5,10
050 Mölten,61,,10,6,16
050 Mölten,62,,9,5,14
050 Mölten,63,,10,10,20
050 Mölten,64,,3,6,9
050 Mölten,65,,11,2,13
050 Mölten,66,,6,5,11
050 Mölten,67,,3,7,10
050 Mölten,68,,3,6,9
050 Mölten,69,,5,4,9
050 Mölten,70,,3,6,9
050 Mölten,71,,2,4,6
050 Mölten,72,,2,4,6
050 Mölten,73,,7,6,13
050 Mölten,74,,4,2,6
050 Mölten,75,,1,7,8
050 Mölten,76,,3,7,10
050 Mölten,77,,-,5,5
050 Mölten,78,,2,3,5
050 Mölten,79,,1,1,2
050 Mölten,80,,2,2,4
050 Mölten,81,,-,2,2
050 Mölten,82,,-,7,7
050 Mölten,83,,3,1,4
050 Mölten,84,,-,2,2
050 Mölten,85,,-,1,1
050 Mölten,86,,1,2,3
050 Mölten,87,,-,3,3
050 Mölten,88,,1,-,1
050 Mölten,89,,-,1,1
050 Mölten,90,,-,1,1
050 Mölten,92,,-,1,1
050 Mölten,93,,-,1,1
050 Mölten,94,,1,-,1
050 Mölten,Insgesamt,,685,621,1.306
051 Meran,0,,161,129,290
051 Meran,1,,152,141,293
051 Meran,2,,156,153,309
051 Meran,3,,123,136,259
051 Meran,4,,157,132,289
051 Meran,5,,138,156,294
051 Meran,6,,147,150,297
051 Meran,7,,159,140,299
051 Meran,8,,161,110,271
051 Meran,9,,155,139,294
051 Meran,10,,149,109,258
051 Meran,11,,126,169,295
051 Meran,12,,151,139,290
051 Meran,13,,141,146,287
051 Meran,14,,139,145,284
051 Meran,15,,161,147,308
051 Meran,16,,155,133,288
051 Meran,17,,135,152,287
051 Meran,18,,168,154,322
051 Meran,19,,160,185,345
051 Meran,20,,177,199,376
051 Meran,21,,197,191,388
051 Meran,22,,253,231,484
051 Meran,23,,220,214,434
051 Meran,24,,235,235,470
051 Meran,25,,243,247,490
051 Meran,26,,264,266,530
051 Meran,27,,293,284,577
051 Meran,28,,312,297,609
051 Meran,29,,309,283,592
051 Meran,30,,325,292,617
051 Meran,31,,341,312,653
051 Meran,32,,337,301,638
051 Meran,33,,342,271,613
051 Meran,34,,254,272,526
051 Meran,35,,306,287,593
051 Meran,36,,305,260,565
051 Meran,37,,272,243,515
051 Meran,38,,258,230,488
051 Meran,39,,238,238,476
051 Meran,40,,225,207,432
051 Meran,41,,201,218,419
051 Meran,42,,185,223,408
051 Meran,43,,198,219,417
051 Meran,44,,228,228,456
051 Meran,45,,219,210,429
051 Meran,46,,207,225,432
051 Meran,47,,228,248,476
051 Meran,48,,231,261,492
051 Meran,49,,230,285,515
051 Meran,50,,243,308,551
051 Meran,51,,223,223,446
051 Meran,52,,230,236,466
051 Meran,53,,280,257,537
051 Meran,54,,275,301,576
051 Meran,55,,248,280,528
051 Meran,56,,214,220,434
051 Meran,57,,225,256,481
051 Meran,58,,207,235,442
051 Meran,59,,205,242,447
051 Meran,60,,190,209,399
051 Meran,61,,196,219,415
051 Meran,62,,182,197,379
051 Meran,63,,172,189,361
051 Meran,64,,148,218,366
051 Meran,65,,150,196,346
051 Meran,66,,160,201,361
051 Meran,67,,144,158,302
051 Meran,68,,147,211,358
051 Meran,69,,137,174,311
051 Meran,70,,142,210,352
051 Meran,71,,110,182,292
051 Meran,72,,109,200,309
051 Meran,73,,105,202,307
051 Meran,74,,111,218,329
051 Meran,75,,84,211,295
051 Meran,76,,106,196,302
051 Meran,77,,74,150,224
051 Meran,78,,59,112,171
051 Meran,79,,51,100,151
051 Meran,80,,39,97,136
051 Meran,81,,65,121,186
051 Meran,82,,67,154,221
051 Meran,83,,62,129,191
051 Meran,84,,62,135,197
051 Meran,85,,41,116,157
051 Meran,86,,42,116,158
051 Meran,87,,40,91,131
051 Meran,88,,37,72,109
051 Meran,89,,24,49,73
051 Meran,90,,22,54,76
051 Meran,91,,7,32,39
051 Meran,92,,8,37,45
051 Meran,93,,5,24,29
051 Meran,94,,5,13,18
051 Meran,95,,5,9,14
051 Meran,96,,1,3,4
051 Meran,97,,2,3,5
051 Meran,98,,1,5,6
051 Meran,102,,-,3,3
051 Meran,103,,-,1,1
051 Meran,104,,-,1,1
051 Meran,107,,-,1,1
051 Meran,Insgesamt,,16.089,17.919,34.008
052 Welsberg-Taisten,0,,15,13,28
052 Welsberg-Taisten,1,,15,12,27
052 Welsberg-Taisten,2,,12,16,28
052 Welsberg-Taisten,3,,15,18,33
052 Welsberg-Taisten,4,,10,10,20
052 Welsberg-Taisten,5,,19,19,38
052 Welsberg-Taisten,6,,13,17,30
052 Welsberg-Taisten,7,,7,17,24
052 Welsberg-Taisten,8,,15,16,31
052 Welsberg-Taisten,9,,15,13,28
052 Welsberg-Taisten,10,,10,12,22
052 Welsberg-Taisten,11,,9,14,23
052 Welsberg-Taisten,12,,24,14,38
052 Welsberg-Taisten,13,,20,18,38
052 Welsberg-Taisten,14,,19,14,33
052 Welsberg-Taisten,15,,10,12,22
052 Welsberg-Taisten,16,,18,17,35
052 Welsberg-Taisten,17,,24,15,39
052 Welsberg-Taisten,18,,19,15,34
052 Welsberg-Taisten,19,,12,19,31
052 Welsberg-Taisten,20,,17,14,31
052 Welsberg-Taisten,21,,15,19,34
052 Welsberg-Taisten,22,,26,21,47
052 Welsberg-Taisten,23,,27,9,36
052 Welsberg-Taisten,24,,18,27,45
052 Welsberg-Taisten,25,,28,19,47
052 Welsberg-Taisten,26,,26,20,46
052 Welsberg-Taisten,27,,19,22,41
052 Welsberg-Taisten,28,,27,12,39
052 Welsberg-Taisten,29,,28,24,52
052 Welsberg-Taisten,30,,23,25,48
052 Welsberg-Taisten,31,,20,20,40
052 Welsberg-Taisten,32,,31,20,51
052 Welsberg-Taisten,33,,26,24,50
052 Welsberg-Taisten,34,,19,24,43
052 Welsberg-Taisten,35,,21,20,41
052 Welsberg-Taisten,36,,14,16,30
052 Welsberg-Taisten,37,,23,20,43
052 Welsberg-Taisten,38,,27,17,44
052 Welsberg-Taisten,39,,11,19,30
052 Welsberg-Taisten,40,,19,21,40
052 Welsberg-Taisten,41,,21,12,33
052 Welsberg-Taisten,42,,17,13,30
052 Welsberg-Taisten,43,,19,12,31
052 Welsberg-Taisten,44,,19,13,32
052 Welsberg-Taisten,45,,17,8,25
052 Welsberg-Taisten,46,,18,15,33
052 Welsberg-Taisten,47,,15,12,27
052 Welsberg-Taisten,48,,17,17,34
052 Welsberg-Taisten,49,,11,10,21
052 Welsberg-Taisten,50,,13,14,27
052 Welsberg-Taisten,51,,9,13,22
052 Welsberg-Taisten,52,,13,11,24
052 Welsberg-Taisten,53,,14,12,26
052 Welsberg-Taisten,54,,10,12,22
052 Welsberg-Taisten,55,,18,20,38
052 Welsberg-Taisten,56,,8,13,21
052 Welsberg-Taisten,57,,15,13,28
052 Welsberg-Taisten,58,,14,11,25
052 Welsberg-Taisten,59,,10,8,18
052 Welsberg-Taisten,60,,11,10,21
052 Welsberg-Taisten,61,,4,17,21
052 Welsberg-Taisten,62,,18,16,34
052 Welsberg-Taisten,63,,12,9,21
052 Welsberg-Taisten,64,,12,15,27
052 Welsberg-Taisten,65,,8,12,20
052 Welsberg-Taisten,66,,12,9,21
052 Welsberg-Taisten,67,,12,12,24
052 Welsberg-Taisten,68,,7,22,29
052 Welsberg-Taisten,69,,11,13,24
052 Welsberg-Taisten,70,,8,7,15
052 Welsberg-Taisten,71,,1,9,10
052 Welsberg-Taisten,72,,8,13,21
052 Welsberg-Taisten,73,,9,13,22
052 Welsberg-Taisten,74,,6,8,14
052 Welsberg-Taisten,75,,6,11,17
052 Welsberg-Taisten,76,,7,10,17
052 Welsberg-Taisten,77,,1,8,9
052 Welsberg-Taisten,78,,4,1,5
052 Welsberg-Taisten,79,,2,4,6
052 Welsberg-Taisten,80,,3,1,4
052 Welsberg-Taisten,81,,5,7,12
052 Welsberg-Taisten,82,,5,3,8
052 Welsberg-Taisten,83,,1,6,7
052 Welsberg-Taisten,84,,3,6,9
052 Welsberg-Taisten,85,,-,8,8
052 Welsberg-Taisten,86,,2,7,9
052 Welsberg-Taisten,87,,-,8,8
052 Welsberg-Taisten,88,,-,2,2
052 Welsberg-Taisten,89,,1,2,3
052 Welsberg-Taisten,90,,-,1,1
052 Welsberg-Taisten,91,,-,2,2
052 Welsberg-Taisten,92,,-,2,2
052 Welsberg-Taisten,94,,-,1,1
052 Welsberg-Taisten,95,,-,1,1
052 Welsberg-Taisten,96,,1,-,1
052 Welsberg-Taisten,98,,-,1,1
052 Welsberg-Taisten,108,,-,1,1
052 Welsberg-Taisten,Insgesamt,,1.224,1.231,2.455
053 Montan,0,,11,8,19
053 Montan,1,,14,16,30
053 Montan,2,,9,5,14
053 Montan,3,,8,9,17
053 Montan,4,,8,10,18
053 Montan,5,,14,8,22
053 Montan,6,,10,9,19
053 Montan,7,,9,11,20
053 Montan,8,,12,13,25
053 Montan,9,,9,14,23
053 Montan,10,,13,4,17
053 Montan,11,,9,8,17
053 Montan,12,,6,3,9
053 Montan,13,,11,5,16
053 Montan,14,,9,8,17
053 Montan,15,,9,7,16
053 Montan,16,,4,4,8
053 Montan,17,,10,9,19
053 Montan,18,,9,6,15
053 Montan,19,,7,4,11
053 Montan,20,,5,5,10
053 Montan,21,,10,9,19
053 Montan,22,,7,7,14
053 Montan,23,,11,5,16
053 Montan,24,,11,6,17
053 Montan,25,,14,6,20
053 Montan,26,,11,13,24
053 Montan,27,,9,14,23
053 Montan,28,,14,16,30
053 Montan,29,,15,11,26
053 Montan,30,,10,14,24
053 Montan,31,,25,13,38
053 Montan,32,,15,13,28
053 Montan,33,,11,16,27
053 Montan,34,,12,17,29
053 Montan,35,,18,12,30
053 Montan,36,,13,11,24
053 Montan,37,,11,10,21
053 Montan,38,,13,8,21
053 Montan,39,,15,11,26
053 Montan,40,,6,15,21
053 Montan,41,,7,13,20
053 Montan,42,,13,12,25
053 Montan,43,,12,7,19
053 Montan,44,,13,3,16
053 Montan,45,,7,6,13
053 Montan,46,,4,5,9
053 Montan,47,,9,3,12
053 Montan,48,,4,6,10
053 Montan,49,,7,9,16
053 Montan,50,,5,2,7
053 Montan,51,,3,4,7
053 Montan,52,,4,5,9
053 Montan,53,,6,7,13
053 Montan,54,,6,6,12
053 Montan,55,,8,4,12
053 Montan,56,,8,7,15
053 Montan,57,,8,9,17
053 Montan,58,,9,8,17
053 Montan,59,,3,7,10
053 Montan,60,,7,11,18
053 Montan,61,,1,9,10
053 Montan,62,,4,6,10
053 Montan,63,,16,5,21
053 Montan,64,,6,7,13
053 Montan,65,,8,11,19
053 Montan,66,,11,12,23
053 Montan,67,,8,10,18
053 Montan,68,,9,4,13
053 Montan,69,,9,7,16
053 Montan,70,,9,10,19
053 Montan,71,,5,8,13
053 Montan,72,,3,7,10
053 Montan,73,,6,11,17
053 Montan,74,,6,10,16
053 Montan,75,,8,4,12
053 Montan,76,,2,8,10
053 Montan,77,,2,5,7
053 Montan,78,,2,3,5
053 Montan,79,,2,6,8
053 Montan,80,,-,3,3
053 Montan,81,,1,9,10
053 Montan,82,,3,5,8
053 Montan,83,,1,5,6
053 Montan,84,,3,4,7
053 Montan,85,,2,2,4
053 Montan,86,,3,-,3
053 Montan,87,,-,3,3
053 Montan,88,,1,4,5
053 Montan,89,,1,1,2
053 Montan,91,,1,1,2
053 Montan,92,,-,1,1
053 Montan,93,,-,1,1
053 Montan,95,,-,1,1
053 Montan,Insgesamt,,723,710,1.433
054 Moos in Passeier,0,,16,19,35
054 Moos in Passeier,1,,10,12,22
054 Moos in Passeier,2,,16,20,36
054 Moos in Passeier,3,,21,15,36
054 Moos in Passeier,4,,19,17,36
054 Moos in Passeier,5,,17,20,37
054 Moos in Passeier,6,,16,13,29
054 Moos in Passeier,7,,18,19,37
054 Moos in Passeier,8,,15,20,35
054 Moos in Passeier,9,,16,14,30
054 Moos in Passeier,10,,17,15,32
054 Moos in Passeier,11,,19,13,32
054 Moos in Passeier,12,,23,21,44
054 Moos in Passeier,13,,15,14,29
054 Moos in Passeier,14,,17,22,39
054 Moos in Passeier,15,,20,19,39
054 Moos in Passeier,16,,20,23,43
054 Moos in Passeier,17,,21,16,37
054 Moos in Passeier,18,,26,19,45
054 Moos in Passeier,19,,21,21,42
054 Moos in Passeier,20,,15,17,32
054 Moos in Passeier,21,,27,22,49
054 Moos in Passeier,22,,27,16,43
054 Moos in Passeier,23,,17,28,45
054 Moos in Passeier,24,,23,16,39
054 Moos in Passeier,25,,24,17,41
054 Moos in Passeier,26,,27,15,42
054 Moos in Passeier,27,,23,21,44
054 Moos in Passeier,28,,22,25,47
054 Moos in Passeier,29,,24,20,44
054 Moos in Passeier,30,,26,22,48
054 Moos in Passeier,31,,24,13,37
054 Moos in Passeier,32,,27,11,38
054 Moos in Passeier,33,,15,17,32
054 Moos in Passeier,34,,11,21,32
054 Moos in Passeier,35,,10,9,19
054 Moos in Passeier,36,,17,17,34
054 Moos in Passeier,37,,19,16,35
054 Moos in Passeier,38,,16,15,31
054 Moos in Passeier,39,,22,9,31
054 Moos in Passeier,40,,9,8,17
054 Moos in Passeier,41,,10,9,19
054 Moos in Passeier,42,,17,9,26
054 Moos in Passeier,43,,8,9,17
054 Moos in Passeier,44,,8,6,14
054 Moos in Passeier,45,,12,9,21
054 Moos in Passeier,46,,10,9,19
054 Moos in Passeier,47,,18,9,27
054 Moos in Passeier,48,,6,7,13
054 Moos in Passeier,49,,22,11,33
054 Moos in Passeier,50,,9,8,17
054 Moos in Passeier,51,,8,6,14
054 Moos in Passeier,52,,9,9,18
054 Moos in Passeier,53,,15,12,27
054 Moos in Passeier,54,,6,12,18
054 Moos in Passeier,55,,11,16,27
054 Moos in Passeier,56,,8,10,18
054 Moos in Passeier,57,,6,7,13
054 Moos in Passeier,58,,12,10,22
054 Moos in Passeier,59,,5,7,12
054 Moos in Passeier,60,,8,8,16
054 Moos in Passeier,61,,9,8,17
054 Moos in Passeier,62,,10,14,24
054 Moos in Passeier,63,,10,11,21
054 Moos in Passeier,64,,9,4,13
054 Moos in Passeier,65,,11,8,19
054 Moos in Passeier,66,,11,8,19
054 Moos in Passeier,67,,9,13,22
054 Moos in Passeier,68,,4,10,14
054 Moos in Passeier,69,,8,6,14
054 Moos in Passeier,70,,12,4,16
054 Moos in Passeier,71,,9,8,17
054 Moos in Passeier,72,,4,8,12
054 Moos in Passeier,73,,4,3,7
054 Moos in Passeier,74,,3,6,9
054 Moos in Passeier,75,,2,3,5
054 Moos in Passeier,76,,2,4,6
054 Moos in Passeier,77,,1,4,5
054 Moos in Passeier,78,,3,3,6
054 Moos in Passeier,79,,3,2,5
054 Moos in Passeier,80,,1,3,4
054 Moos in Passeier,81,,3,2,5
054 Moos in Passeier,82,,1,8,9
054 Moos in Passeier,83,,1,3,4
054 Moos in Passeier,84,,-,4,4
054 Moos in Passeier,85,,1,3,4
054 Moos in Passeier,86,,-,2,2
054 Moos in Passeier,87,,-,2,2
054 Moos in Passeier,88,,1,1,2
054 Moos in Passeier,90,,1,1,2
054 Moos in Passeier,95,,-,1,1
054 Moos in Passeier,Insgesamt,,1.129,1.047,2.176
055 Nals,0,,11,10,21
055 Nals,1,,6,5,11
055 Nals,2,,11,9,20
055 Nals,3,,10,12,22
055 Nals,4,,14,9,23
055 Nals,5,,8,14,22
055 Nals,6,,10,8,18
055 Nals,7,,11,9,20
055 Nals,8,,8,13,21
055 Nals,9,,10,10,20
055 Nals,10,,5,2,7
055 Nals,11,,12,5,17
055 Nals,12,,8,9,17
055 Nals,13,,6,8,14
055 Nals,14,,7,13,20
055 Nals,15,,10,9,19
055 Nals,16,,14,8,22
055 Nals,17,,9,6,15
055 Nals,18,,10,7,17
055 Nals,19,,6,3,9
055 Nals,20,,11,14,25
055 Nals,21,,3,6,9
055 Nals,22,,17,12,29
055 Nals,23,,8,6,14
055 Nals,24,,8,15,23
055 Nals,25,,13,12,25
055 Nals,26,,15,14,29
055 Nals,27,,11,13,24
055 Nals,28,,15,19,34
055 Nals,29,,14,13,27
055 Nals,30,,17,9,26
055 Nals,31,,16,15,31
055 Nals,32,,20,17,37
055 Nals,33,,11,22,33
055 Nals,34,,19,9,28
055 Nals,35,,17,16,33
055 Nals,36,,12,9,21
055 Nals,37,,16,12,28
055 Nals,38,,17,16,33
055 Nals,39,,10,10,20
055 Nals,40,,7,9,16
055 Nals,41,,18,15,33
055 Nals,42,,7,7,14
055 Nals,43,,8,7,15
055 Nals,44,,8,7,15
055 Nals,45,,4,13,17
055 Nals,46,,8,9,17
055 Nals,47,,9,9,18
055 Nals,48,,11,11,22
055 Nals,49,,13,5,18
055 Nals,50,,6,13,19
055 Nals,51,,7,11,18
055 Nals,52,,6,11,17
055 Nals,53,,13,6,19
055 Nals,54,,5,8,13
055 Nals,55,,13,5,18
055 Nals,56,,7,10,17
055 Nals,57,,10,10,20
055 Nals,58,,7,9,16
055 Nals,59,,3,13,16
055 Nals,60,,5,4,9
055 Nals,61,,7,6,13
055 Nals,62,,6,6,12
055 Nals,63,,10,11,21
055 Nals,64,,6,5,11
055 Nals,65,,3,7,10
055 Nals,66,,5,6,11
055 Nals,67,,10,8,18
055 Nals,68,,7,9,16
055 Nals,69,,6,6,12
055 Nals,70,,8,7,15
055 Nals,71,,6,5,11
055 Nals,72,,3,2,5
055 Nals,73,,1,6,7
055 Nals,74,,3,7,10
055 Nals,75,,2,10,12
055 Nals,76,,1,2,3
055 Nals,77,,1,5,6
055 Nals,78,,2,-,2
055 Nals,79,,2,-,2
055 Nals,80,,-,3,3
055 Nals,81,,5,3,8
055 Nals,82,,-,5,5
055 Nals,83,,1,1,2
055 Nals,84,,2,3,5
055 Nals,85,,-,3,3
055 Nals,86,,1,2,3
055 Nals,87,,-,1,1
055 Nals,88,,1,3,4
055 Nals,90,,2,2,4
055 Nals,91,,-,1,1
055 Nals,93,,1,-,1
055 Nals,Insgesamt,,733,755,1.488
056 Naturns,0,,37,31,68
056 Naturns,1,,46,31,77
056 Naturns,2,,34,37,71
056 Naturns,3,,33,41,74
056 Naturns,4,,32,37,69
056 Naturns,5,,44,37,81
056 Naturns,6,,34,31,65
056 Naturns,7,,39,27,66
056 Naturns,8,,43,34,77
056 Naturns,9,,32,20,52
056 Naturns,10,,29,26,55
056 Naturns,11,,39,23,62
056 Naturns,12,,37,20,57
056 Naturns,13,,30,35,65
056 Naturns,14,,37,30,67
056 Naturns,15,,37,50,87
056 Naturns,16,,33,29,62
056 Naturns,17,,43,36,79
056 Naturns,18,,38,40,78
056 Naturns,19,,29,32,61
056 Naturns,20,,33,37,70
056 Naturns,21,,29,35,64
056 Naturns,22,,39,37,76
056 Naturns,23,,40,35,75
056 Naturns,24,,43,41,84
056 Naturns,25,,38,41,79
056 Naturns,26,,42,39,81
056 Naturns,27,,40,47,87
056 Naturns,28,,50,42,92
056 Naturns,29,,44,49,93
056 Naturns,30,,53,43,96
056 Naturns,31,,45,51,96
056 Naturns,32,,47,39,86
056 Naturns,33,,41,48,89
056 Naturns,34,,43,46,89
056 Naturns,35,,39,41,80
056 Naturns,36,,59,41,100
056 Naturns,37,,39,42,81
056 Naturns,38,,32,36,68
056 Naturns,39,,33,33,66
056 Naturns,40,,41,35,76
056 Naturns,41,,32,34,66
056 Naturns,42,,43,32,75
056 Naturns,43,,32,29,61
056 Naturns,44,,35,36,71
056 Naturns,45,,36,36,72
056 Naturns,46,,27,35,62
056 Naturns,47,,27,19,46
056 Naturns,48,,31,25,56
056 Naturns,49,,18,19,37
056 Naturns,50,,27,29,56
056 Naturns,51,,26,18,44
056 Naturns,52,,20,22,42
056 Naturns,53,,28,34,62
056 Naturns,54,,34,35,69
056 Naturns,55,,41,33,74
056 Naturns,56,,23,19,42
056 Naturns,57,,22,20,42
056 Naturns,58,,28,16,44
056 Naturns,59,,23,23,46
056 Naturns,60,,22,19,41
056 Naturns,61,,24,12,36
056 Naturns,62,,21,20,41
056 Naturns,63,,17,15,32
056 Naturns,64,,16,20,36
056 Naturns,65,,12,26,38
056 Naturns,66,,21,24,45
056 Naturns,67,,19,20,39
056 Naturns,68,,19,16,35
056 Naturns,69,,14,20,34
056 Naturns,70,,14,21,35
056 Naturns,71,,17,18,35
056 Naturns,72,,18,17,35
056 Naturns,73,,19,14,33
056 Naturns,74,,7,17,24
056 Naturns,75,,13,20,33
056 Naturns,76,,4,11,15
056 Naturns,77,,4,14,18
056 Naturns,78,,3,7,10
056 Naturns,79,,4,3,7
056 Naturns,80,,4,5,9
056 Naturns,81,,2,11,13
056 Naturns,82,,6,15,21
056 Naturns,83,,6,17,23
056 Naturns,84,,4,9,13
056 Naturns,85,,7,9,16
056 Naturns,86,,9,6,15
056 Naturns,87,,3,10,13
056 Naturns,88,,-,4,4
056 Naturns,89,,2,8,10
056 Naturns,90,,3,2,5
056 Naturns,91,,2,2,4
056 Naturns,92,,2,6,8
056 Naturns,93,,-,1,1
056 Naturns,95,,-,1,1
056 Naturns,96,,1,1,2
056 Naturns,99,,1,-,1
056 Naturns,Insgesamt,,2.489,2.460,4.949
057 Natz-Schabs,0,,21,16,37
057 Natz-Schabs,1,,16,13,29
057 Natz-Schabs,2,,17,16,33
057 Natz-Schabs,3,,16,17,33
057 Natz-Schabs,4,,18,14,32
057 Natz-Schabs,5,,22,20,42
057 Natz-Schabs,6,,15,25,40
057 Natz-Schabs,7,,14,25,39
057 Natz-Schabs,8,,22,18,40
057 Natz-Schabs,9,,19,20,39
057 Natz-Schabs,10,,17,21,38
057 Natz-Schabs,11,,19,21,40
057 Natz-Schabs,12,,17,18,35
057 Natz-Schabs,13,,21,19,40
057 Natz-Schabs,14,,10,19,29
057 Natz-Schabs,15,,18,22,40
057 Natz-Schabs,16,,22,11,33
057 Natz-Schabs,17,,13,14,27
057 Natz-Schabs,18,,12,11,23
057 Natz-Schabs,19,,11,10,21
057 Natz-Schabs,20,,9,11,20
057 Natz-Schabs,21,,12,17,29
057 Natz-Schabs,22,,14,20,34
057 Natz-Schabs,23,,13,20,33
057 Natz-Schabs,24,,17,16,33
057 Natz-Schabs,25,,18,17,35
057 Natz-Schabs,26,,24,19,43
057 Natz-Schabs,27,,24,20,44
057 Natz-Schabs,28,,23,12,35
057 Natz-Schabs,29,,29,24,53
057 Natz-Schabs,30,,27,17,44
057 Natz-Schabs,31,,31,25,56
057 Natz-Schabs,32,,26,24,50
057 Natz-Schabs,33,,21,22,43
057 Natz-Schabs,34,,16,21,37
057 Natz-Schabs,35,,17,16,33
057 Natz-Schabs,36,,24,24,48
057 Natz-Schabs,37,,21,19,40
057 Natz-Schabs,38,,21,16,37
057 Natz-Schabs,39,,18,19,37
057 Natz-Schabs,40,,18,22,40
057 Natz-Schabs,41,,20,17,37
057 Natz-Schabs,42,,14,12,26
057 Natz-Schabs,43,,17,14,31
057 Natz-Schabs,44,,16,9,25
057 Natz-Schabs,45,,12,9,21
057 Natz-Schabs,46,,20,15,35
057 Natz-Schabs,47,,21,14,35
057 Natz-Schabs,48,,12,13,25
057 Natz-Schabs,49,,11,13,24
057 Natz-Schabs,50,,14,10,24
057 Natz-Schabs,51,,10,9,19
057 Natz-Schabs,52,,13,12,25
057 Natz-Schabs,53,,8,9,17
057 Natz-Schabs,54,,13,7,20
057 Natz-Schabs,55,,14,9,23
057 Natz-Schabs,56,,4,8,12
057 Natz-Schabs,57,,2,6,8
057 Natz-Schabs,58,,4,6,10
057 Natz-Schabs,59,,12,9,21
057 Natz-Schabs,60,,9,4,13
057 Natz-Schabs,61,,9,7,16
057 Natz-Schabs,62,,7,3,10
057 Natz-Schabs,63,,9,12,21
057 Natz-Schabs,64,,6,9,15
057 Natz-Schabs,65,,8,6,14
057 Natz-Schabs,66,,6,7,13
057 Natz-Schabs,67,,11,2,13
057 Natz-Schabs,68,,5,11,16
057 Natz-Schabs,69,,2,5,7
057 Natz-Schabs,70,,4,8,12
057 Natz-Schabs,71,,5,6,11
057 Natz-Schabs,72,,2,7,9
057 Natz-Schabs,73,,2,9,11
057 Natz-Schabs,74,,7,4,11
057 Natz-Schabs,75,,5,6,11
057 Natz-Schabs,76,,3,10,13
057 Natz-Schabs,77,,-,2,2
057 Natz-Schabs,78,,1,4,5
057 Natz-Schabs,79,,2,2,4
057 Natz-Schabs,80,,3,-,3
057 Natz-Schabs,81,,3,2,5
057 Natz-Schabs,82,,1,1,2
057 Natz-Schabs,83,,2,-,2
057 Natz-Schabs,84,,1,3,4
057 Natz-Schabs,85,,2,1,3
057 Natz-Schabs,87,,2,-,2
057 Natz-Schabs,88,,1,1,2
057 Natz-Schabs,90,,2,-,2
057 Natz-Schabs,Insgesamt,,1.120,1.084,2.204
058 Welschnofen,0,,8,10,18
058 Welschnofen,1,,13,12,25
058 Welschnofen,2,,12,12,24
058 Welschnofen,3,,10,7,17
058 Welschnofen,4,,14,13,27
058 Welschnofen,5,,13,11,24
058 Welschnofen,6,,10,13,23
058 Welschnofen,7,,14,8,22
058 Welschnofen,8,,13,16,29
058 Welschnofen,9,,9,8,17
058 Welschnofen,10,,7,12,19
058 Welschnofen,11,,12,7,19
058 Welschnofen,12,,7,8,15
058 Welschnofen,13,,10,12,22
058 Welschnofen,14,,10,18,28
058 Welschnofen,15,,12,10,22
058 Welschnofen,16,,12,6,18
058 Welschnofen,17,,11,3,14
058 Welschnofen,18,,13,11,24
058 Welschnofen,19,,11,17,28
058 Welschnofen,20,,17,10,27
058 Welschnofen,21,,15,12,27
058 Welschnofen,22,,14,17,31
058 Welschnofen,23,,13,14,27
058 Welschnofen,24,,11,11,22
058 Welschnofen,25,,10,14,24
058 Welschnofen,26,,15,12,27
058 Welschnofen,27,,15,15,30
058 Welschnofen,28,,18,18,36
058 Welschnofen,29,,15,14,29
058 Welschnofen,30,,22,13,35
058 Welschnofen,31,,20,16,36
058 Welschnofen,32,,14,9,23
058 Welschnofen,33,,17,17,34
058 Welschnofen,34,,11,15,26
058 Welschnofen,35,,18,17,35
058 Welschnofen,36,,22,8,30
058 Welschnofen,37,,13,12,25
058 Welschnofen,38,,18,9,27
058 Welschnofen,39,,10,13,23
058 Welschnofen,40,,10,12,22
058 Welschnofen,41,,15,14,29
058 Welschnofen,42,,15,11,26
058 Welschnofen,43,,11,13,24
058 Welschnofen,44,,11,9,20
058 Welschnofen,45,,18,6,24
058 Welschnofen,46,,8,7,15
058 Welschnofen,47,,12,12,24
058 Welschnofen,48,,9,11,20
058 Welschnofen,49,,9,7,16
058 Welschnofen,50,,11,10,21
058 Welschnofen,51,,8,6,14
058 Welschnofen,52,,7,12,19
058 Welschnofen,53,,13,12,25
058 Welschnofen,54,,14,13,27
058 Welschnofen,55,,12,7,19
058 Welschnofen,56,,8,7,15
058 Welschnofen,57,,11,7,18
058 Welschnofen,58,,7,6,13
058 Welschnofen,59,,9,4,13
058 Welschnofen,60,,6,12,18
058 Welschnofen,61,,7,6,13
058 Welschnofen,62,,12,10,22
058 Welschnofen,63,,10,14,24
058 Welschnofen,64,,8,7,15
058 Welschnofen,65,,7,8,15
058 Welschnofen,66,,7,10,17
058 Welschnofen,67,,11,12,23
058 Welschnofen,68,,7,6,13
058 Welschnofen,69,,4,4,8
058 Welschnofen,70,,7,8,15
058 Welschnofen,71,,8,6,14
058 Welschnofen,72,,6,15,21
058 Welschnofen,73,,7,10,17
058 Welschnofen,74,,6,6,12
058 Welschnofen,75,,4,11,15
058 Welschnofen,76,,3,9,12
058 Welschnofen,77,,2,6,8
058 Welschnofen,78,,3,2,5
058 Welschnofen,79,,1,1,2
058 Welschnofen,80,,2,5,7
058 Welschnofen,81,,1,4,5
058 Welschnofen,82,,3,4,7
058 Welschnofen,83,,1,10,11
058 Welschnofen,84,,4,7,11
058 Welschnofen,85,,2,3,5
058 Welschnofen,86,,3,6,9
058 Welschnofen,87,,3,3,6
058 Welschnofen,88,,2,-,2
058 Welschnofen,89,,1,2,3
058 Welschnofen,90,,-,2,2
058 Welschnofen,91,,1,1,2
058 Welschnofen,92,,1,1,2
058 Welschnofen,94,,1,2,3
058 Welschnofen,95,,-,1,1
058 Welschnofen,96,,-,1,1
058 Welschnofen,97,,-,1,1
058 Welschnofen,Insgesamt,,898,882,1.780
059 Deutschnofen,0,,18,30,48
059 Deutschnofen,1,,25,26,51
059 Deutschnofen,2,,28,16,44
059 Deutschnofen,3,,23,28,51
059 Deutschnofen,4,,32,28,60
059 Deutschnofen,5,,20,19,39
059 Deutschnofen,6,,34,30,64
059 Deutschnofen,7,,22,22,44
059 Deutschnofen,8,,21,33,54
059 Deutschnofen,9,,20,25,45
059 Deutschnofen,10,,27,17,44
059 Deutschnofen,11,,26,20,46
059 Deutschnofen,12,,35,27,62
059 Deutschnofen,13,,22,22,44
059 Deutschnofen,14,,20,33,53
059 Deutschnofen,15,,20,17,37
059 Deutschnofen,16,,28,19,47
059 Deutschnofen,17,,23,27,50
059 Deutschnofen,18,,23,19,42
059 Deutschnofen,19,,31,22,53
059 Deutschnofen,20,,11,19,30
059 Deutschnofen,21,,19,26,45
059 Deutschnofen,22,,28,30,58
059 Deutschnofen,23,,16,29,45
059 Deutschnofen,24,,21,31,52
059 Deutschnofen,25,,26,22,48
059 Deutschnofen,26,,28,26,54
059 Deutschnofen,27,,37,28,65
059 Deutschnofen,28,,22,28,50
059 Deutschnofen,29,,32,31,63
059 Deutschnofen,30,,29,35,64
059 Deutschnofen,31,,39,23,62
059 Deutschnofen,32,,34,27,61
059 Deutschnofen,33,,29,24,53
059 Deutschnofen,34,,24,29,53
059 Deutschnofen,35,,36,23,59
059 Deutschnofen,36,,43,23,66
059 Deutschnofen,37,,24,23,47
059 Deutschnofen,38,,25,29,54
059 Deutschnofen,39,,22,26,48
059 Deutschnofen,40,,33,26,59
059 Deutschnofen,41,,28,23,51
059 Deutschnofen,42,,24,19,43
059 Deutschnofen,43,,24,17,41
059 Deutschnofen,44,,24,23,47
059 Deutschnofen,45,,24,14,38
059 Deutschnofen,46,,17,19,36
059 Deutschnofen,47,,24,13,37
059 Deutschnofen,48,,26,17,43
059 Deutschnofen,49,,13,14,27
059 Deutschnofen,50,,16,23,39
059 Deutschnofen,51,,18,15,33
059 Deutschnofen,52,,16,18,34
059 Deutschnofen,53,,26,20,46
059 Deutschnofen,54,,18,16,34
059 Deutschnofen,55,,14,25,39
059 Deutschnofen,56,,13,19,32
059 Deutschnofen,57,,25,14,39
059 Deutschnofen,58,,16,23,39
059 Deutschnofen,59,,11,8,19
059 Deutschnofen,60,,15,10,25
059 Deutschnofen,61,,11,13,24
059 Deutschnofen,62,,15,13,28
059 Deutschnofen,63,,9,14,23
059 Deutschnofen,64,,18,14,32
059 Deutschnofen,65,,16,9,25
059 Deutschnofen,66,,13,12,25
059 Deutschnofen,67,,11,11,22
059 Deutschnofen,68,,12,24,36
059 Deutschnofen,69,,10,15,25
059 Deutschnofen,70,,18,11,29
059 Deutschnofen,71,,11,24,35
059 Deutschnofen,72,,8,13,21
059 Deutschnofen,73,,8,12,20
059 Deutschnofen,74,,11,20,31
059 Deutschnofen,75,,7,18,25
059 Deutschnofen,76,,5,12,17
059 Deutschnofen,77,,2,6,8
059 Deutschnofen,78,,4,7,11
059 Deutschnofen,79,,1,5,6
059 Deutschnofen,80,,4,4,8
059 Deutschnofen,81,,6,8,14
059 Deutschnofen,82,,4,12,16
059 Deutschnofen,83,,7,12,19
059 Deutschnofen,84,,3,7,10
059 Deutschnofen,85,,2,8,10
059 Deutschnofen,86,,4,6,10
059 Deutschnofen,87,,1,5,6
059 Deutschnofen,88,,4,2,6
059 Deutschnofen,89,,2,-,2
059 Deutschnofen,90,,2,3,5
059 Deutschnofen,91,,-,2,2
059 Deutschnofen,92,,1,3,4
059 Deutschnofen,93,,1,-,1
059 Deutschnofen,95,,-,2,2
059 Deutschnofen,Insgesamt,,1.699,1.715,3.414
060 Auer,0,,16,17,33
060 Auer,1,,22,15,37
060 Auer,2,,19,16,35
060 Auer,3,,12,21,33
060 Auer,4,,16,20,36
060 Auer,5,,23,12,35
060 Auer,6,,16,15,31
060 Auer,7,,19,18,37
060 Auer,8,,17,24,41
060 Auer,9,,21,14,35
060 Auer,10,,15,15,30
060 Auer,11,,22,17,39
060 Auer,12,,14,9,23
060 Auer,13,,17,15,32
060 Auer,14,,18,24,42
060 Auer,15,,12,15,27
060 Auer,16,,14,10,24
060 Auer,17,,18,17,35
060 Auer,18,,11,8,19
060 Auer,19,,12,18,30
060 Auer,20,,17,23,40
060 Auer,21,,13,15,28
060 Auer,22,,21,22,43
060 Auer,23,,25,12,37
060 Auer,24,,13,25,38
060 Auer,25,,26,20,46
060 Auer,26,,22,18,40
060 Auer,27,,18,24,42
060 Auer,28,,24,33,57
060 Auer,29,,25,20,45
060 Auer,30,,28,33,61
060 Auer,31,,31,28,59
060 Auer,32,,33,20,53
060 Auer,33,,28,33,61
060 Auer,34,,21,24,45
060 Auer,35,,36,31,67
060 Auer,36,,21,31,52
060 Auer,37,,31,28,59
060 Auer,38,,31,17,48
060 Auer,39,,26,26,52
060 Auer,40,,29,26,55
060 Auer,41,,16,23,39
060 Auer,42,,17,13,30
060 Auer,43,,14,21,35
060 Auer,44,,20,20,40
060 Auer,45,,16,20,36
060 Auer,46,,15,24,39
060 Auer,47,,12,14,26
060 Auer,48,,26,16,42
060 Auer,49,,16,21,37
060 Auer,50,,19,24,43
060 Auer,51,,15,13,28
060 Auer,52,,23,15,38
060 Auer,53,,17,20,37
060 Auer,54,,17,20,37
060 Auer,55,,22,16,38
060 Auer,56,,13,9,22
060 Auer,57,,14,18,32
060 Auer,58,,18,18,36
060 Auer,59,,12,13,25
060 Auer,60,,9,11,20
060 Auer,61,,10,15,25
060 Auer,62,,20,17,37
060 Auer,63,,6,10,16
060 Auer,64,,4,19,23
060 Auer,65,,13,10,23
060 Auer,66,,13,10,23
060 Auer,67,,12,15,27
060 Auer,68,,12,12,24
060 Auer,69,,10,14,24
060 Auer,70,,7,17,24
060 Auer,71,,17,12,29
060 Auer,72,,13,9,22
060 Auer,73,,11,15,26
060 Auer,74,,5,18,23
060 Auer,75,,5,12,17
060 Auer,76,,7,13,20
060 Auer,77,,6,3,9
060 Auer,78,,3,9,12
060 Auer,79,,4,7,11
060 Auer,80,,2,3,5
060 Auer,81,,2,5,7
060 Auer,82,,1,4,5
060 Auer,83,,4,8,12
060 Auer,84,,1,7,8
060 Auer,85,,1,5,6
060 Auer,86,,1,1,2
060 Auer,87,,2,3,5
060 Auer,88,,2,2,4
060 Auer,89,,2,3,5
060 Auer,90,,-,2,2
060 Auer,92,,-,2,2
060 Auer,93,,-,4,4
060 Auer,94,,-,1,1
060 Auer,101,,-,1,1
060 Auer,Insgesamt,,1.380,1.466,2.846
061 St.Ulrich,0,,29,20,49
061 St.Ulrich,1,,36,32,68
061 St.Ulrich,2,,27,30,57
061 St.Ulrich,3,,22,30,52
061 St.Ulrich,4,,35,32,67
061 St.Ulrich,5,,31,33,64
061 St.Ulrich,6,,29,22,51
061 St.Ulrich,7,,18,25,43
061 St.Ulrich,8,,20,23,43
061 St.Ulrich,9,,28,18,46
061 St.Ulrich,10,,18,18,36
061 St.Ulrich,11,,24,21,45
061 St.Ulrich,12,,23,19,42
061 St.Ulrich,13,,20,20,40
061 St.Ulrich,14,,24,26,50
061 St.Ulrich,15,,21,24,45
061 St.Ulrich,16,,24,29,53
061 St.Ulrich,17,,30,22,52
061 St.Ulrich,18,,22,25,47
061 St.Ulrich,19,,24,23,47
061 St.Ulrich,20,,33,35,68
061 St.Ulrich,21,,36,29,65
061 St.Ulrich,22,,37,28,65
061 St.Ulrich,23,,41,25,66
061 St.Ulrich,24,,42,40,82
061 St.Ulrich,25,,36,39,75
061 St.Ulrich,26,,39,30,69
061 St.Ulrich,27,,50,43,93
061 St.Ulrich,28,,43,40,83
061 St.Ulrich,29,,35,36,71
061 St.Ulrich,30,,44,33,77
061 St.Ulrich,31,,34,35,69
061 St.Ulrich,32,,43,43,86
061 St.Ulrich,33,,41,34,75
061 St.Ulrich,34,,32,35,67
061 St.Ulrich,35,,32,25,57
061 St.Ulrich,36,,36,29,65
061 St.Ulrich,37,,40,25,65
061 St.Ulrich,38,,24,18,42
061 St.Ulrich,39,,26,36,62
061 St.Ulrich,40,,18,29,47
061 St.Ulrich,41,,28,38,66
061 St.Ulrich,42,,26,34,60
061 St.Ulrich,43,,29,17,46
061 St.Ulrich,44,,16,27,43
061 St.Ulrich,45,,27,24,51
061 St.Ulrich,46,,24,24,48
061 St.Ulrich,47,,20,28,48
061 St.Ulrich,48,,32,31,63
061 St.Ulrich,49,,24,23,47
061 St.Ulrich,50,,39,26,65
061 St.Ulrich,51,,21,19,40
061 St.Ulrich,52,,31,33,64
061 St.Ulrich,53,,42,38,80
061 St.Ulrich,54,,34,37,71
061 St.Ulrich,55,,43,45,88
061 St.Ulrich,56,,33,29,62
061 St.Ulrich,57,,20,19,39
061 St.Ulrich,58,,27,28,55
061 St.Ulrich,59,,24,27,51
061 St.Ulrich,60,,26,16,42
061 St.Ulrich,61,,16,23,39
061 St.Ulrich,62,,21,13,34
061 St.Ulrich,63,,21,14,35
061 St.Ulrich,64,,16,23,39
061 St.Ulrich,65,,22,18,40
061 St.Ulrich,66,,21,11,32
061 St.Ulrich,67,,19,7,26
061 St.Ulrich,68,,18,13,31
061 St.Ulrich,69,,18,20,38
061 St.Ulrich,70,,11,16,27
061 St.Ulrich,71,,15,12,27
061 St.Ulrich,72,,11,22,33
061 St.Ulrich,73,,12,26,38
061 St.Ulrich,74,,6,21,27
061 St.Ulrich,75,,10,18,28
061 St.Ulrich,76,,13,19,32
061 St.Ulrich,77,,8,12,20
061 St.Ulrich,78,,8,11,19
061 St.Ulrich,79,,2,8,10
061 St.Ulrich,80,,6,7,13
061 St.Ulrich,81,,4,11,15
061 St.Ulrich,82,,12,14,26
061 St.Ulrich,83,,10,22,32
061 St.Ulrich,84,,10,17,27
061 St.Ulrich,85,,1,12,13
061 St.Ulrich,86,,7,7,14
061 St.Ulrich,87,,8,3,11
061 St.Ulrich,88,,3,1,4
061 St.Ulrich,89,,1,8,9
061 St.Ulrich,90,,1,5,6
061 St.Ulrich,91,,3,3,6
061 St.Ulrich,92,,-,4,4
061 St.Ulrich,93,,2,-,2
061 St.Ulrich,94,,-,1,1
061 St.Ulrich,95,,-,1,1
061 St.Ulrich,96,,-,1,1
061 St.Ulrich,Insgesamt,,2.169,2.166,4.335
062 Partschins,0,,13,17,30
062 Partschins,1,,24,14,38
062 Partschins,2,,21,19,40
062 Partschins,3,,26,17,43
062 Partschins,4,,22,17,39
062 Partschins,5,,23,27,50
062 Partschins,6,,23,22,45
062 Partschins,7,,12,23,35
062 Partschins,8,,20,27,47
062 Partschins,9,,17,13,30
062 Partschins,10,,24,20,44
062 Partschins,11,,12,14,26
062 Partschins,12,,20,21,41
062 Partschins,13,,16,22,38
062 Partschins,14,,19,21,40
062 Partschins,15,,20,28,48
062 Partschins,16,,25,17,42
062 Partschins,17,,14,14,28
062 Partschins,18,,17,22,39
062 Partschins,19,,28,17,45
062 Partschins,20,,17,15,32
062 Partschins,21,,29,22,51
062 Partschins,22,,21,15,36
062 Partschins,23,,27,19,46
062 Partschins,24,,23,26,49
062 Partschins,25,,21,25,46
062 Partschins,26,,24,25,49
062 Partschins,27,,32,30,62
062 Partschins,28,,22,29,51
062 Partschins,29,,31,20,51
062 Partschins,30,,35,33,68
062 Partschins,31,,30,33,63
062 Partschins,32,,27,43,70
062 Partschins,33,,37,24,61
062 Partschins,34,,36,23,59
062 Partschins,35,,19,27,46
062 Partschins,36,,24,38,62
062 Partschins,37,,28,17,45
062 Partschins,38,,21,18,39
062 Partschins,39,,21,25,46
062 Partschins,40,,26,18,44
062 Partschins,41,,24,26,50
062 Partschins,42,,9,27,36
062 Partschins,43,,24,14,38
062 Partschins,44,,17,13,30
062 Partschins,45,,19,14,33
062 Partschins,46,,15,21,36
062 Partschins,47,,9,11,20
062 Partschins,48,,17,17,34
062 Partschins,49,,20,17,37
062 Partschins,50,,32,29,61
062 Partschins,51,,13,15,28
062 Partschins,52,,16,19,35
062 Partschins,53,,24,26,50
062 Partschins,54,,14,18,32
062 Partschins,55,,23,30,53
062 Partschins,56,,16,14,30
062 Partschins,57,,12,16,28
062 Partschins,58,,20,15,35
062 Partschins,59,,14,16,30
062 Partschins,60,,14,19,33
062 Partschins,61,,11,10,21
062 Partschins,62,,12,17,29
062 Partschins,63,,15,17,32
062 Partschins,64,,16,11,27
062 Partschins,65,,16,22,38
062 Partschins,66,,14,12,26
062 Partschins,67,,12,11,23
062 Partschins,68,,14,15,29
062 Partschins,69,,12,12,24
062 Partschins,70,,11,10,21
062 Partschins,71,,10,13,23
062 Partschins,72,,5,15,20
062 Partschins,73,,10,12,22
062 Partschins,74,,7,9,16
062 Partschins,75,,16,10,26
062 Partschins,76,,6,9,15
062 Partschins,77,,5,10,15
062 Partschins,78,,3,3,6
062 Partschins,79,,2,6,8
062 Partschins,80,,2,3,5
062 Partschins,81,,4,1,5
062 Partschins,82,,6,8,14
062 Partschins,83,,2,13,15
062 Partschins,84,,1,9,10
062 Partschins,85,,8,3,11
062 Partschins,86,,3,9,12
062 Partschins,87,,-,3,3
062 Partschins,88,,2,2,4
062 Partschins,89,,-,1,1
062 Partschins,90,,4,3,7
062 Partschins,91,,1,1,2
062 Partschins,92,,-,1,1
062 Partschins,93,,1,1,2
062 Partschins,94,,-,2,2
062 Partschins,95,,-,1,1
062 Partschins,Insgesamt,,1.530,1.579,3.109
063 Percha,0,,7,5,12
063 Percha,1,,7,6,13
063 Percha,2,,10,10,20
063 Percha,3,,7,10,17
063 Percha,4,,14,5,19
063 Percha,5,,9,9,18
063 Percha,6,,9,6,15
063 Percha,7,,6,8,14
063 Percha,8,,6,5,11
063 Percha,9,,9,17,26
063 Percha,10,,5,7,12
063 Percha,11,,8,13,21
063 Percha,12,,18,9,27
063 Percha,13,,14,10,24
063 Percha,14,,6,11,17
063 Percha,15,,9,6,15
063 Percha,16,,11,5,16
063 Percha,17,,5,12,17
063 Percha,18,,8,11,19
063 Percha,19,,9,9,18
063 Percha,20,,15,11,26
063 Percha,21,,10,6,16
063 Percha,22,,5,11,16
063 Percha,23,,12,7,19
063 Percha,24,,12,16,28
063 Percha,25,,15,8,23
063 Percha,26,,8,13,21
063 Percha,27,,17,15,32
063 Percha,28,,12,14,26
063 Percha,29,,12,12,24
063 Percha,30,,21,7,28
063 Percha,31,,13,16,29
063 Percha,32,,16,11,27
063 Percha,33,,10,15,25
063 Percha,34,,14,10,24
063 Percha,35,,13,10,23
063 Percha,36,,10,7,17
063 Percha,37,,5,9,14
063 Percha,38,,9,8,17
063 Percha,39,,9,5,14
063 Percha,40,,6,12,18
063 Percha,41,,13,11,24
063 Percha,42,,4,4,8
063 Percha,43,,8,7,15
063 Percha,44,,5,8,13
063 Percha,45,,7,7,14
063 Percha,46,,6,8,14
063 Percha,47,,10,5,15
063 Percha,48,,6,4,10
063 Percha,49,,5,7,12
063 Percha,50,,8,8,16
063 Percha,51,,8,5,13
063 Percha,52,,12,4,16
063 Percha,53,,8,7,15
063 Percha,54,,10,7,17
063 Percha,55,,10,6,16
063 Percha,56,,5,5,10
063 Percha,57,,7,6,13
063 Percha,58,,5,10,15
063 Percha,59,,1,5,6
063 Percha,60,,4,5,9
063 Percha,61,,4,5,9
063 Percha,62,,4,6,10
063 Percha,63,,5,5,10
063 Percha,64,,6,3,9
063 Percha,65,,7,2,9
063 Percha,66,,9,4,13
063 Percha,67,,5,5,10
063 Percha,68,,4,4,8
063 Percha,69,,6,4,10
063 Percha,70,,3,8,11
063 Percha,71,,4,6,10
063 Percha,72,,2,3,5
063 Percha,73,,3,5,8
063 Percha,74,,3,2,5
063 Percha,75,,1,2,3
063 Percha,76,,1,4,5
063 Percha,77,,1,1,2
063 Percha,78,,2,1,3
063 Percha,80,,1,1,2
063 Percha,81,,1,1,2
063 Percha,82,,-,5,5
063 Percha,84,,-,4,4
063 Percha,86,,1,-,1
063 Percha,101,,-,1,1
063 Percha,Insgesamt,,636,608,1.244
064 Plaus,0,,4,2,6
064 Plaus,1,,2,3,5
064 Plaus,2,,3,3,6
064 Plaus,3,,6,4,10
064 Plaus,4,,5,4,9
064 Plaus,5,,3,8,11
064 Plaus,6,,4,2,6
064 Plaus,7,,2,6,8
064 Plaus,8,,3,2,5
064 Plaus,9,,4,2,6
064 Plaus,10,,-,4,4
064 Plaus,11,,2,4,6
064 Plaus,12,,4,1,5
064 Plaus,13,,2,1,3
064 Plaus,14,,-,3,3
064 Plaus,15,,2,2,4
064 Plaus,16,,-,5,5
064 Plaus,17,,1,3,4
064 Plaus,18,,3,5,8
064 Plaus,19,,1,3,4
064 Plaus,20,,3,1,4
064 Plaus,21,,6,-,6
064 Plaus,22,,4,1,5
064 Plaus,23,,4,-,4
064 Plaus,24,,4,6,10
064 Plaus,25,,4,5,9
064 Plaus,26,,6,5,11
064 Plaus,27,,6,7,13
064 Plaus,28,,2,6,8
064 Plaus,29,,10,5,15
064 Plaus,30,,3,7,10
064 Plaus,31,,9,2,11
064 Plaus,32,,8,7,15
064 Plaus,33,,3,7,10
064 Plaus,34,,7,4,11
064 Plaus,35,,4,2,6
064 Plaus,36,,1,5,6
064 Plaus,37,,8,1,9
064 Plaus,38,,3,3,6
064 Plaus,39,,2,2,4
064 Plaus,40,,6,1,7
064 Plaus,41,,3,3,6
064 Plaus,42,,1,1,2
064 Plaus,43,,3,4,7
064 Plaus,44,,6,2,8
064 Plaus,45,,4,3,7
064 Plaus,46,,1,2,3
064 Plaus,47,,3,2,5
064 Plaus,48,,1,3,4
064 Plaus,49,,2,4,6
064 Plaus,50,,5,3,8
064 Plaus,51,,2,1,3
064 Plaus,52,,2,3,5
064 Plaus,53,,4,1,5
064 Plaus,54,,-,4,4
064 Plaus,55,,3,4,7
064 Plaus,56,,3,3,6
064 Plaus,57,,3,2,5
064 Plaus,58,,1,1,2
064 Plaus,59,,3,4,7
064 Plaus,61,,2,2,4
064 Plaus,62,,4,3,7
064 Plaus,63,,-,3,3
064 Plaus,64,,1,3,4
064 Plaus,65,,2,1,3
064 Plaus,66,,-,1,1
064 Plaus,67,,1,1,2
064 Plaus,68,,1,-,1
064 Plaus,69,,1,1,2
064 Plaus,70,,1,2,3
064 Plaus,71,,1,-,1
064 Plaus,72,,-,4,4
064 Plaus,73,,-,5,5
064 Plaus,74,,1,2,3
064 Plaus,75,,1,1,2
064 Plaus,76,,2,1,3
064 Plaus,77,,-,2,2
064 Plaus,78,,-,2,2
064 Plaus,82,,-,1,1
064 Plaus,83,,1,1,2
064 Plaus,84,,1,1,2
064 Plaus,85,,-,1,1
064 Plaus,88,,3,-,3
064 Plaus,Insgesamt,,227,232,459
065 Waidbruck,0,,2,-,2
065 Waidbruck,1,,2,2,4
065 Waidbruck,2,,3,3,6
065 Waidbruck,3,,1,1,2
065 Waidbruck,4,,-,1,1
065 Waidbruck,5,,2,1,3
065 Waidbruck,6,,1,1,2
065 Waidbruck,7,,-,1,1
065 Waidbruck,8,,-,3,3
065 Waidbruck,9,,-,1,1
065 Waidbruck,10,,1,2,3
065 Waidbruck,12,,2,1,3
065 Waidbruck,13,,2,-,2
065 Waidbruck,15,,-,3,3
065 Waidbruck,16,,3,-,3
065 Waidbruck,17,,1,-,1
065 Waidbruck,18,,2,-,2
065 Waidbruck,19,,-,1,1
065 Waidbruck,20,,1,1,2
065 Waidbruck,22,,3,-,3
065 Waidbruck,23,,2,1,3
065 Waidbruck,24,,-,2,2
065 Waidbruck,25,,2,-,2
065 Waidbruck,26,,3,3,6
065 Waidbruck,27,,1,5,6
065 Waidbruck,28,,2,-,2
065 Waidbruck,29,,2,4,6
065 Waidbruck,30,,2,4,6
065 Waidbruck,31,,3,-,3
065 Waidbruck,32,,5,-,5
065 Waidbruck,33,,-,1,1
065 Waidbruck,34,,3,1,4
065 Waidbruck,35,,-,1,1
065 Waidbruck,36,,1,1,2
065 Waidbruck,37,,2,4,6
065 Waidbruck,38,,-,1,1
065 Waidbruck,39,,1,1,2
065 Waidbruck,40,,1,-,1
065 Waidbruck,41,,2,1,3
065 Waidbruck,42,,-,1,1
065 Waidbruck,43,,1,1,2
065 Waidbruck,44,,1,1,2
065 Waidbruck,45,,-,1,1
065 Waidbruck,50,,-,3,3
065 Waidbruck,51,,1,1,2
065 Waidbruck,52,,1,3,4
065 Waidbruck,54,,1,-,1
065 Waidbruck,55,,1,2,3
065 Waidbruck,56,,-,2,2
065 Waidbruck,57,,1,-,1
065 Waidbruck,58,,-,3,3
065 Waidbruck,59,,2,1,3
065 Waidbruck,60,,2,1,3
065 Waidbruck,61,,-,3,3
065 Waidbruck,62,,3,1,4
065 Waidbruck,63,,2,1,3
065 Waidbruck,64,,1,4,5
065 Waidbruck,65,,3,-,3
065 Waidbruck,66,,2,-,2
065 Waidbruck,67,,-,1,1
065 Waidbruck,68,,1,-,1
065 Waidbruck,69,,3,1,4
065 Waidbruck,70,,-,1,1
065 Waidbruck,71,,1,1,2
065 Waidbruck,73,,-,2,2
065 Waidbruck,74,,1,1,2
065 Waidbruck,76,,-,3,3
065 Waidbruck,77,,-,2,2
065 Waidbruck,81,,2,-,2
065 Waidbruck,82,,-,1,1
065 Waidbruck,84,,1,-,1
065 Waidbruck,85,,1,-,1
065 Waidbruck,91,,-,1,1
065 Waidbruck,Insgesamt,,90,95,185
066 Burgstall,0,,3,7,10
066 Burgstall,1,,9,5,14
066 Burgstall,2,,5,9,14
066 Burgstall,3,,3,10,13
066 Burgstall,4,,7,5,12
066 Burgstall,5,,4,11,15
066 Burgstall,6,,12,8,20
066 Burgstall,7,,8,4,12
066 Burgstall,8,,6,6,12
066 Burgstall,9,,9,9,18
066 Burgstall,10,,10,4,14
066 Burgstall,11,,6,10,16
066 Burgstall,12,,9,12,21
066 Burgstall,13,,7,7,14
066 Burgstall,14,,13,7,20
066 Burgstall,15,,6,8,14
066 Burgstall,16,,11,5,16
066 Burgstall,17,,5,8,13
066 Burgstall,18,,7,5,12
066 Burgstall,19,,2,11,13
066 Burgstall,20,,9,6,15
066 Burgstall,21,,16,7,23
066 Burgstall,22,,6,10,16
066 Burgstall,23,,9,10,19
066 Burgstall,24,,10,15,25
066 Burgstall,25,,14,6,20
066 Burgstall,26,,10,8,18
066 Burgstall,27,,10,9,19
066 Burgstall,28,,13,11,24
066 Burgstall,29,,10,16,26
066 Burgstall,30,,20,10,30
066 Burgstall,31,,18,14,32
066 Burgstall,32,,16,11,27
066 Burgstall,33,,15,10,25
066 Burgstall,34,,17,9,26
066 Burgstall,35,,11,14,25
066 Burgstall,36,,8,8,16
066 Burgstall,37,,5,9,14
066 Burgstall,38,,11,8,19
066 Burgstall,39,,8,8,16
066 Burgstall,40,,14,10,24
066 Burgstall,41,,7,7,14
066 Burgstall,42,,9,12,21
066 Burgstall,43,,8,10,18
066 Burgstall,44,,8,13,21
066 Burgstall,45,,11,7,18
066 Burgstall,46,,11,11,22
066 Burgstall,47,,8,7,15
066 Burgstall,48,,6,12,18
066 Burgstall,49,,7,9,16
066 Burgstall,50,,9,8,17
066 Burgstall,51,,6,10,16
066 Burgstall,52,,12,8,20
066 Burgstall,53,,9,7,16
066 Burgstall,54,,5,6,11
066 Burgstall,55,,8,5,13
066 Burgstall,56,,5,13,18
066 Burgstall,57,,5,11,16
066 Burgstall,58,,11,13,24
066 Burgstall,59,,5,9,14
066 Burgstall,60,,5,6,11
066 Burgstall,61,,7,4,11
066 Burgstall,62,,10,7,17
066 Burgstall,63,,9,4,13
066 Burgstall,64,,4,9,13
066 Burgstall,65,,6,3,9
066 Burgstall,66,,6,7,13
066 Burgstall,67,,2,4,6
066 Burgstall,68,,4,10,14
066 Burgstall,69,,3,12,15
066 Burgstall,70,,5,9,14
066 Burgstall,71,,7,5,12
066 Burgstall,72,,1,9,10
066 Burgstall,73,,6,3,9
066 Burgstall,74,,8,5,13
066 Burgstall,75,,3,3,6
066 Burgstall,76,,4,4,8
066 Burgstall,77,,1,5,6
066 Burgstall,78,,-,1,1
066 Burgstall,79,,2,1,3
066 Burgstall,80,,3,4,7
066 Burgstall,81,,4,4,8
066 Burgstall,82,,3,5,8
066 Burgstall,83,,2,4,6
066 Burgstall,84,,-,5,5
066 Burgstall,85,,2,5,7
066 Burgstall,86,,1,2,3
066 Burgstall,87,,-,3,3
066 Burgstall,88,,1,-,1
066 Burgstall,89,,1,-,1
066 Burgstall,90,,1,-,1
066 Burgstall,93,,-,1,1
066 Burgstall,94,,-,1,1
066 Burgstall,95,,1,-,1
066 Burgstall,Insgesamt,,654,683,1.337
067 Prad am Stilfser Joch,0,,20,16,36
067 Prad am Stilfser Joch,1,,22,12,34
067 Prad am Stilfser Joch,2,,20,23,43
067 Prad am Stilfser Joch,3,,26,27,53
067 Prad am Stilfser Joch,4,,16,19,35
067 Prad am Stilfser Joch,5,,17,12,29
067 Prad am Stilfser Joch,6,,19,19,38
067 Prad am Stilfser Joch,7,,20,21,41
067 Prad am Stilfser Joch,8,,30,15,45
067 Prad am Stilfser Joch,9,,11,19,30
067 Prad am Stilfser Joch,10,,27,26,53
067 Prad am Stilfser Joch,11,,30,22,52
067 Prad am Stilfser Joch,12,,31,28,59
067 Prad am Stilfser Joch,13,,28,25,53
067 Prad am Stilfser Joch,14,,28,22,50
067 Prad am Stilfser Joch,15,,24,24,48
067 Prad am Stilfser Joch,16,,26,22,48
067 Prad am Stilfser Joch,17,,19,9,28
067 Prad am Stilfser Joch,18,,21,19,40
067 Prad am Stilfser Joch,19,,19,37,56
067 Prad am Stilfser Joch,20,,21,22,43
067 Prad am Stilfser Joch,21,,23,17,40
067 Prad am Stilfser Joch,22,,32,25,57
067 Prad am Stilfser Joch,23,,24,29,53
067 Prad am Stilfser Joch,24,,32,20,52
067 Prad am Stilfser Joch,25,,35,21,56
067 Prad am Stilfser Joch,26,,30,23,53
067 Prad am Stilfser Joch,27,,27,27,54
067 Prad am Stilfser Joch,28,,30,31,61
067 Prad am Stilfser Joch,29,,27,23,50
067 Prad am Stilfser Joch,30,,35,28,63
067 Prad am Stilfser Joch,31,,33,25,58
067 Prad am Stilfser Joch,32,,28,27,55
067 Prad am Stilfser Joch,33,,25,11,36
067 Prad am Stilfser Joch,34,,27,29,56
067 Prad am Stilfser Joch,35,,20,26,46
067 Prad am Stilfser Joch,36,,19,27,46
067 Prad am Stilfser Joch,37,,32,12,44
067 Prad am Stilfser Joch,38,,24,30,54
067 Prad am Stilfser Joch,39,,24,25,49
067 Prad am Stilfser Joch,40,,23,22,45
067 Prad am Stilfser Joch,41,,29,16,45
067 Prad am Stilfser Joch,42,,30,18,48
067 Prad am Stilfser Joch,43,,28,17,45
067 Prad am Stilfser Joch,44,,14,21,35
067 Prad am Stilfser Joch,45,,20,21,41
067 Prad am Stilfser Joch,46,,22,18,40
067 Prad am Stilfser Joch,47,,24,21,45
067 Prad am Stilfser Joch,48,,19,12,31
067 Prad am Stilfser Joch,49,,16,13,29
067 Prad am Stilfser Joch,50,,18,15,33
067 Prad am Stilfser Joch,51,,19,12,31
067 Prad am Stilfser Joch,52,,13,15,28
067 Prad am Stilfser Joch,53,,25,18,43
067 Prad am Stilfser Joch,54,,19,17,36
067 Prad am Stilfser Joch,55,,22,12,34
067 Prad am Stilfser Joch,56,,10,16,26
067 Prad am Stilfser Joch,57,,14,13,27
067 Prad am Stilfser Joch,58,,19,14,33
067 Prad am Stilfser Joch,59,,13,12,25
067 Prad am Stilfser Joch,60,,12,11,23
067 Prad am Stilfser Joch,61,,15,15,30
067 Prad am Stilfser Joch,62,,9,25,34
067 Prad am Stilfser Joch,63,,12,10,22
067 Prad am Stilfser Joch,64,,15,19,34
067 Prad am Stilfser Joch,65,,9,15,24
067 Prad am Stilfser Joch,66,,13,14,27
067 Prad am Stilfser Joch,67,,10,11,21
067 Prad am Stilfser Joch,68,,8,9,17
067 Prad am Stilfser Joch,69,,10,10,20
067 Prad am Stilfser Joch,70,,10,14,24
067 Prad am Stilfser Joch,71,,12,9,21
067 Prad am Stilfser Joch,72,,8,13,21
067 Prad am Stilfser Joch,73,,4,14,18
067 Prad am Stilfser Joch,74,,6,13,19
067 Prad am Stilfser Joch,75,,8,7,15
067 Prad am Stilfser Joch,76,,7,7,14
067 Prad am Stilfser Joch,77,,8,4,12
067 Prad am Stilfser Joch,78,,2,6,8
067 Prad am Stilfser Joch,79,,-,5,5
067 Prad am Stilfser Joch,80,,2,5,7
067 Prad am Stilfser Joch,81,,5,2,7
067 Prad am Stilfser Joch,82,,4,11,15
067 Prad am Stilfser Joch,83,,1,5,6
067 Prad am Stilfser Joch,84,,5,10,15
067 Prad am Stilfser Joch,85,,2,4,6
067 Prad am Stilfser Joch,86,,2,8,10
067 Prad am Stilfser Joch,87,,2,4,6
067 Prad am Stilfser Joch,88,,2,4,6
067 Prad am Stilfser Joch,89,,4,5,9
067 Prad am Stilfser Joch,90,,1,-,1
067 Prad am Stilfser Joch,91,,1,3,4
067 Prad am Stilfser Joch,92,,-,2,2
067 Prad am Stilfser Joch,93,,1,1,2
067 Prad am Stilfser Joch,95,,1,2,3
067 Prad am Stilfser Joch,96,,-,1,1
067 Prad am Stilfser Joch,Insgesamt,,1.610,1.516,3.126
068 Prettau,0,,1,2,3
068 Prettau,1,,6,6,12
068 Prettau,2,,5,7,12
068 Prettau,3,,4,8,12
068 Prettau,4,,3,3,6
068 Prettau,5,,1,4,5
068 Prettau,6,,1,7,8
068 Prettau,7,,-,4,4
068 Prettau,8,,5,3,8
068 Prettau,9,,5,1,6
068 Prettau,10,,2,2,4
068 Prettau,11,,2,1,3
068 Prettau,12,,3,6,9
068 Prettau,13,,4,2,6
068 Prettau,14,,2,2,4
068 Prettau,15,,2,1,3
068 Prettau,16,,4,2,6
068 Prettau,17,,5,2,7
068 Prettau,18,,1,-,1
068 Prettau,19,,5,4,9
068 Prettau,20,,1,1,2
068 Prettau,21,,6,4,10
068 Prettau,22,,6,1,7
068 Prettau,23,,7,8,15
068 Prettau,24,,10,6,16
068 Prettau,25,,5,4,9
068 Prettau,26,,5,7,12
068 Prettau,27,,9,8,17
068 Prettau,28,,6,5,11
068 Prettau,29,,9,8,17
068 Prettau,30,,5,3,8
068 Prettau,31,,4,11,15
068 Prettau,32,,10,6,16
068 Prettau,33,,6,8,14
068 Prettau,34,,3,6,9
068 Prettau,35,,6,5,11
068 Prettau,36,,9,4,13
068 Prettau,37,,5,2,7
068 Prettau,38,,7,-,7
068 Prettau,39,,2,1,3
068 Prettau,40,,6,5,11
068 Prettau,41,,6,5,11
068 Prettau,42,,6,2,8
068 Prettau,43,,4,3,7
068 Prettau,44,,4,3,7
068 Prettau,45,,2,2,4
068 Prettau,46,,2,2,4
068 Prettau,47,,2,3,5
068 Prettau,48,,3,2,5
068 Prettau,49,,4,5,9
068 Prettau,50,,9,4,13
068 Prettau,51,,2,3,5
068 Prettau,52,,7,5,12
068 Prettau,53,,4,2,6
068 Prettau,54,,2,2,4
068 Prettau,55,,3,3,6
068 Prettau,56,,4,5,9
068 Prettau,57,,4,4,8
068 Prettau,58,,5,7,12
068 Prettau,59,,3,6,9
068 Prettau,60,,4,3,7
068 Prettau,61,,6,3,9
068 Prettau,62,,1,3,4
068 Prettau,63,,4,3,7
068 Prettau,64,,4,-,4
068 Prettau,65,,2,1,3
068 Prettau,66,,5,4,9
068 Prettau,67,,4,6,10
068 Prettau,68,,-,3,3
068 Prettau,69,,3,1,4
068 Prettau,70,,1,8,9
068 Prettau,71,,1,3,4
068 Prettau,72,,4,1,5
068 Prettau,73,,1,5,6
068 Prettau,74,,2,1,3
068 Prettau,75,,1,2,3
068 Prettau,76,,4,4,8
068 Prettau,77,,3,2,5
068 Prettau,78,,1,3,4
068 Prettau,79,,1,1,2
068 Prettau,80,,2,3,5
068 Prettau,81,,-,1,1
068 Prettau,82,,-,5,5
068 Prettau,83,,1,6,7
068 Prettau,84,,-,2,2
068 Prettau,85,,-,5,5
068 Prettau,87,,-,1,1
068 Prettau,88,,1,-,1
068 Prettau,90,,-,1,1
068 Prettau,91,,-,2,2
068 Prettau,96,,-,1,1
068 Prettau,Insgesamt,,320,322,642
069 Proveis,0,,2,2,4
069 Proveis,1,,-,4,4
069 Proveis,2,,3,-,3
069 Proveis,3,,2,1,3
069 Proveis,4,,3,1,4
069 Proveis,5,,3,2,5
069 Proveis,7,,1,1,2
069 Proveis,8,,2,3,5
069 Proveis,9,,2,2,4
069 Proveis,10,,3,1,4
069 Proveis,11,,5,-,5
069 Proveis,12,,3,3,6
069 Proveis,13,,3,3,6
069 Proveis,14,,1,-,1
069 Proveis,15,,2,3,5
069 Proveis,17,,3,1,4
069 Proveis,18,,3,2,5
069 Proveis,19,,2,2,4
069 Proveis,20,,1,3,4
069 Proveis,21,,2,3,5
069 Proveis,22,,6,2,8
069 Proveis,23,,2,-,2
069 Proveis,24,,-,4,4
069 Proveis,25,,1,2,3
069 Proveis,26,,4,3,7
069 Proveis,27,,5,3,8
069 Proveis,28,,5,2,7
069 Proveis,29,,2,1,3
069 Proveis,30,,2,1,3
069 Proveis,31,,1,1,2
069 Proveis,32,,3,-,3
069 Proveis,33,,4,2,6
069 Proveis,34,,4,3,7
069 Proveis,35,,4,1,5
069 Proveis,36,,1,4,5
069 Proveis,37,,4,-,4
069 Proveis,38,,1,3,4
069 Proveis,39,,2,3,5
069 Proveis,40,,4,1,5
069 Proveis,41,,3,4,7
069 Proveis,42,,3,2,5
069 Proveis,43,,2,1,3
069 Proveis,44,,3,3,6
069 Proveis,45,,2,-,2
069 Proveis,46,,-,2,2
069 Proveis,47,,1,-,1
069 Proveis,48,,2,1,3
069 Proveis,49,,1,2,3
069 Proveis,50,,3,-,3
069 Proveis,51,,1,1,2
069 Proveis,52,,2,-,2
069 Proveis,53,,2,1,3
069 Proveis,54,,2,1,3
069 Proveis,55,,1,1,2
069 Proveis,56,,3,-,3
069 Proveis,57,,1,3,4
069 Proveis,58,,-,2,2
069 Proveis,59,,1,1,2
069 Proveis,60,,2,1,3
069 Proveis,61,,1,1,2
069 Proveis,62,,-,1,1
069 Proveis,63,,-,2,2
069 Proveis,64,,1,1,2
069 Proveis,65,,2,1,3
069 Proveis,66,,-,1,1
069 Proveis,67,,3,4,7
069 Proveis,68,,4,1,5
069 Proveis,69,,2,2,4
069 Proveis,70,,1,1,2
069 Proveis,71,,-,3,3
069 Proveis,72,,3,-,3
069 Proveis,73,,1,-,1
069 Proveis,74,,2,2,4
069 Proveis,75,,-,6,6
069 Proveis,76,,1,1,2
069 Proveis,79,,-,1,1
069 Proveis,81,,-,1,1
069 Proveis,82,,-,2,2
069 Proveis,83,,-,1,1
069 Proveis,89,,1,-,1
069 Proveis,Insgesamt,,158,131,289
070 Ratschings,0,,25,33,58
070 Ratschings,1,,26,28,54
070 Ratschings,2,,20,29,49
070 Ratschings,3,,28,21,49
070 Ratschings,4,,37,31,68
070 Ratschings,5,,26,18,44
070 Ratschings,6,,32,28,60
070 Ratschings,7,,24,19,43
070 Ratschings,8,,36,26,62
070 Ratschings,9,,27,32,59
070 Ratschings,10,,30,26,56
070 Ratschings,11,,29,32,61
070 Ratschings,12,,29,18,47
070 Ratschings,13,,31,21,52
070 Ratschings,14,,34,24,58
070 Ratschings,15,,28,32,60
070 Ratschings,16,,22,23,45
070 Ratschings,17,,34,22,56
070 Ratschings,18,,31,22,53
070 Ratschings,19,,34,22,56
070 Ratschings,20,,25,30,55
070 Ratschings,21,,31,26,57
070 Ratschings,22,,36,24,60
070 Ratschings,23,,27,35,62
070 Ratschings,24,,32,35,67
070 Ratschings,25,,37,40,77
070 Ratschings,26,,29,34,63
070 Ratschings,27,,34,42,76
070 Ratschings,28,,44,37,81
070 Ratschings,29,,37,36,73
070 Ratschings,30,,44,35,79
070 Ratschings,31,,33,47,80
070 Ratschings,32,,48,40,88
070 Ratschings,33,,46,24,70
070 Ratschings,34,,36,38,74
070 Ratschings,35,,33,27,60
070 Ratschings,36,,39,23,62
070 Ratschings,37,,40,26,66
070 Ratschings,38,,30,21,51
070 Ratschings,39,,33,17,50
070 Ratschings,40,,37,20,57
070 Ratschings,41,,16,32,48
070 Ratschings,42,,28,15,43
070 Ratschings,43,,20,24,44
070 Ratschings,44,,21,19,40
070 Ratschings,45,,15,15,30
070 Ratschings,46,,23,20,43
070 Ratschings,47,,23,23,46
070 Ratschings,48,,32,20,52
070 Ratschings,49,,18,14,32
070 Ratschings,50,,24,8,32
070 Ratschings,51,,18,20,38
070 Ratschings,52,,21,11,32
070 Ratschings,53,,15,14,29
070 Ratschings,54,,21,20,41
070 Ratschings,55,,25,21,46
070 Ratschings,56,,20,17,37
070 Ratschings,57,,20,19,39
070 Ratschings,58,,15,21,36
070 Ratschings,59,,20,10,30
070 Ratschings,60,,16,13,29
070 Ratschings,61,,19,17,36
070 Ratschings,62,,14,12,26
070 Ratschings,63,,16,19,35
070 Ratschings,64,,16,14,30
070 Ratschings,65,,13,13,26
070 Ratschings,66,,14,19,33
070 Ratschings,67,,12,23,35
070 Ratschings,68,,11,15,26
070 Ratschings,69,,19,15,34
070 Ratschings,70,,14,16,30
070 Ratschings,71,,14,9,23
070 Ratschings,72,,14,14,28
070 Ratschings,73,,13,11,24
070 Ratschings,74,,8,13,21
070 Ratschings,75,,9,16,25
070 Ratschings,76,,5,14,19
070 Ratschings,77,,4,5,9
070 Ratschings,78,,-,11,11
070 Ratschings,79,,-,1,1
070 Ratschings,80,,4,4,8
070 Ratschings,81,,4,9,13
070 Ratschings,82,,4,5,9
070 Ratschings,83,,6,5,11
070 Ratschings,84,,3,7,10
070 Ratschings,85,,2,4,6
070 Ratschings,86,,1,-,1
070 Ratschings,87,,1,3,4
070 Ratschings,88,,3,3,6
070 Ratschings,90,,-,3,3
070 Ratschings,91,,2,1,3
070 Ratschings,92,,-,1,1
070 Ratschings,95,,-,1,1
070 Ratschings,Insgesamt,,1.990,1.823,3.813
071 Rasen-Antholz,0,,23,16,39
071 Rasen-Antholz,1,,10,16,26
071 Rasen-Antholz,2,,20,11,31
071 Rasen-Antholz,3,,21,17,38
071 Rasen-Antholz,4,,30,19,49
071 Rasen-Antholz,5,,18,16,34
071 Rasen-Antholz,6,,14,26,40
071 Rasen-Antholz,7,,19,18,37
071 Rasen-Antholz,8,,20,16,36
071 Rasen-Antholz,9,,27,10,37
071 Rasen-Antholz,10,,16,21,37
071 Rasen-Antholz,11,,23,13,36
071 Rasen-Antholz,12,,18,18,36
071 Rasen-Antholz,13,,14,18,32
071 Rasen-Antholz,14,,21,24,45
071 Rasen-Antholz,15,,15,15,30
071 Rasen-Antholz,16,,19,11,30
071 Rasen-Antholz,17,,17,19,36
071 Rasen-Antholz,18,,16,17,33
071 Rasen-Antholz,19,,16,22,38
071 Rasen-Antholz,20,,20,22,42
071 Rasen-Antholz,21,,23,27,50
071 Rasen-Antholz,22,,32,26,58
071 Rasen-Antholz,23,,36,23,59
071 Rasen-Antholz,24,,36,14,50
071 Rasen-Antholz,25,,30,23,53
071 Rasen-Antholz,26,,27,33,60
071 Rasen-Antholz,27,,33,31,64
071 Rasen-Antholz,28,,29,28,57
071 Rasen-Antholz,29,,29,27,56
071 Rasen-Antholz,30,,28,20,48
071 Rasen-Antholz,31,,33,28,61
071 Rasen-Antholz,32,,29,20,49
071 Rasen-Antholz,33,,24,20,44
071 Rasen-Antholz,34,,30,19,49
071 Rasen-Antholz,35,,20,26,46
071 Rasen-Antholz,36,,21,22,43
071 Rasen-Antholz,37,,27,22,49
071 Rasen-Antholz,38,,24,16,40
071 Rasen-Antholz,39,,23,12,35
071 Rasen-Antholz,40,,18,16,34
071 Rasen-Antholz,41,,18,16,34
071 Rasen-Antholz,42,,15,12,27
071 Rasen-Antholz,43,,18,11,29
071 Rasen-Antholz,44,,12,14,26
071 Rasen-Antholz,45,,14,12,26
071 Rasen-Antholz,46,,16,9,25
071 Rasen-Antholz,47,,14,9,23
071 Rasen-Antholz,48,,15,9,24
071 Rasen-Antholz,49,,10,13,23
071 Rasen-Antholz,50,,11,14,25
071 Rasen-Antholz,51,,11,9,20
071 Rasen-Antholz,52,,9,9,18
071 Rasen-Antholz,53,,14,14,28
071 Rasen-Antholz,54,,11,14,25
071 Rasen-Antholz,55,,14,13,27
071 Rasen-Antholz,56,,11,17,28
071 Rasen-Antholz,57,,17,13,30
071 Rasen-Antholz,58,,15,9,24
071 Rasen-Antholz,59,,10,12,22
071 Rasen-Antholz,60,,10,12,22
071 Rasen-Antholz,61,,11,8,19
071 Rasen-Antholz,62,,12,10,22
071 Rasen-Antholz,63,,13,15,28
071 Rasen-Antholz,64,,18,12,30
071 Rasen-Antholz,65,,14,14,28
071 Rasen-Antholz,66,,5,11,16
071 Rasen-Antholz,67,,13,4,17
071 Rasen-Antholz,68,,5,4,9
071 Rasen-Antholz,69,,14,10,24
071 Rasen-Antholz,70,,9,6,15
071 Rasen-Antholz,71,,7,13,20
071 Rasen-Antholz,72,,9,13,22
071 Rasen-Antholz,73,,4,12,16
071 Rasen-Antholz,74,,5,7,12
071 Rasen-Antholz,75,,10,6,16
071 Rasen-Antholz,76,,4,6,10
071 Rasen-Antholz,77,,6,7,13
071 Rasen-Antholz,78,,2,3,5
071 Rasen-Antholz,79,,4,4,8
071 Rasen-Antholz,80,,-,5,5
071 Rasen-Antholz,81,,3,4,7
071 Rasen-Antholz,82,,1,5,6
071 Rasen-Antholz,83,,1,4,5
071 Rasen-Antholz,84,,2,4,6
071 Rasen-Antholz,85,,3,4,7
071 Rasen-Antholz,86,,-,4,4
071 Rasen-Antholz,87,,2,5,7
071 Rasen-Antholz,88,,1,4,5
071 Rasen-Antholz,89,,1,2,3
071 Rasen-Antholz,90,,-,2,2
071 Rasen-Antholz,91,,-,1,1
071 Rasen-Antholz,94,,1,-,1
071 Rasen-Antholz,Insgesamt,,1.394,1.268,2.662
072 Ritten,0,,43,50,93
072 Ritten,1,,58,51,109
072 Ritten,2,,56,45,101
072 Ritten,3,,58,51,109
072 Ritten,4,,49,69,118
072 Ritten,5,,61,45,106
072 Ritten,6,,59,45,104
072 Ritten,7,,53,46,99
072 Ritten,8,,55,48,103
072 Ritten,9,,49,43,92
072 Ritten,10,,47,42,89
072 Ritten,11,,44,48,92
072 Ritten,12,,45,29,74
072 Ritten,13,,51,41,92
072 Ritten,14,,38,46,84
072 Ritten,15,,45,46,91
072 Ritten,16,,46,33,79
072 Ritten,17,,48,41,89
072 Ritten,18,,42,36,78
072 Ritten,19,,59,39,98
072 Ritten,20,,41,42,83
072 Ritten,21,,58,39,97
072 Ritten,22,,64,55,119
072 Ritten,23,,50,57,107
072 Ritten,24,,52,48,100
072 Ritten,25,,52,72,124
072 Ritten,26,,48,70,118
072 Ritten,27,,46,57,103
072 Ritten,28,,65,63,128
072 Ritten,29,,72,56,128
072 Ritten,30,,57,48,105
072 Ritten,31,,71,52,123
072 Ritten,32,,67,57,124
072 Ritten,33,,61,57,118
072 Ritten,34,,59,63,122
072 Ritten,35,,49,61,110
072 Ritten,36,,63,56,119
072 Ritten,37,,61,52,113
072 Ritten,38,,40,42,82
072 Ritten,39,,43,37,80
072 Ritten,40,,49,44,93
072 Ritten,41,,50,40,90
072 Ritten,42,,39,32,71
072 Ritten,43,,45,32,77
072 Ritten,44,,42,45,87
072 Ritten,45,,43,35,78
072 Ritten,46,,35,42,77
072 Ritten,47,,34,42,76
072 Ritten,48,,50,32,82
072 Ritten,49,,32,26,58
072 Ritten,50,,31,37,68
072 Ritten,51,,23,23,46
072 Ritten,52,,33,41,74
072 Ritten,53,,40,41,81
072 Ritten,54,,45,37,82
072 Ritten,55,,36,37,73
072 Ritten,56,,41,23,64
072 Ritten,57,,38,32,70
072 Ritten,58,,33,35,68
072 Ritten,59,,31,24,55
072 Ritten,60,,26,25,51
072 Ritten,61,,26,34,60
072 Ritten,62,,25,28,53
072 Ritten,63,,21,27,48
072 Ritten,64,,29,24,53
072 Ritten,65,,19,31,50
072 Ritten,66,,19,22,41
072 Ritten,67,,28,20,48
072 Ritten,68,,21,11,32
072 Ritten,69,,23,18,41
072 Ritten,70,,17,21,38
072 Ritten,71,,20,39,59
072 Ritten,72,,20,32,52
072 Ritten,73,,24,26,50
072 Ritten,74,,7,30,37
072 Ritten,75,,14,24,38
072 Ritten,76,,12,27,39
072 Ritten,77,,6,16,22
072 Ritten,78,,4,9,13
072 Ritten,79,,5,12,17
072 Ritten,80,,2,5,7
072 Ritten,81,,8,9,17
072 Ritten,82,,11,14,25
072 Ritten,83,,9,20,29
072 Ritten,84,,7,17,24
072 Ritten,85,,5,12,17
072 Ritten,86,,8,8,16
072 Ritten,87,,6,6,12
072 Ritten,88,,1,8,9
072 Ritten,89,,3,5,8
072 Ritten,90,,-,2,2
072 Ritten,91,,1,2,3
072 Ritten,92,,1,1,2
072 Ritten,93,,2,4,6
072 Ritten,94,,-,1,1
072 Ritten,97,,-,1,1
072 Ritten,99,,1,-,1
072 Ritten,Insgesamt,,3.326,3.269,6.595
073 Riffian,0,,5,8,13
073 Riffian,1,,5,11,16
073 Riffian,2,,8,6,14
073 Riffian,3,,7,6,13
073 Riffian,4,,10,10,20
073 Riffian,5,,9,12,21
073 Riffian,6,,7,7,14
073 Riffian,7,,12,5,17
073 Riffian,8,,5,12,17
073 Riffian,9,,6,9,15
073 Riffian,10,,8,7,15
073 Riffian,11,,8,2,10
073 Riffian,12,,8,6,14
073 Riffian,13,,9,7,16
073 Riffian,14,,10,10,20
073 Riffian,15,,9,8,17
073 Riffian,16,,5,4,9
073 Riffian,17,,7,9,16
073 Riffian,18,,9,4,13
073 Riffian,19,,11,9,20
073 Riffian,20,,9,2,11
073 Riffian,21,,6,13,19
073 Riffian,22,,9,4,13
073 Riffian,23,,11,10,21
073 Riffian,24,,10,18,28
073 Riffian,25,,10,19,29
073 Riffian,26,,7,9,16
073 Riffian,27,,11,14,25
073 Riffian,28,,12,17,29
073 Riffian,29,,13,14,27
073 Riffian,30,,9,9,18
073 Riffian,31,,16,7,23
073 Riffian,32,,12,10,22
073 Riffian,33,,15,9,24
073 Riffian,34,,11,8,19
073 Riffian,35,,8,8,16
073 Riffian,36,,14,4,18
073 Riffian,37,,7,15,22
073 Riffian,38,,8,6,14
073 Riffian,39,,6,11,17
073 Riffian,40,,13,4,17
073 Riffian,41,,6,10,16
073 Riffian,42,,9,6,15
073 Riffian,43,,10,3,13
073 Riffian,44,,7,3,10
073 Riffian,45,,7,10,17
073 Riffian,46,,4,3,7
073 Riffian,47,,6,6,12
073 Riffian,48,,6,6,12
073 Riffian,49,,4,4,8
073 Riffian,50,,2,6,8
073 Riffian,51,,5,4,9
073 Riffian,52,,8,8,16
073 Riffian,53,,7,7,14
073 Riffian,54,,11,7,18
073 Riffian,55,,9,3,12
073 Riffian,56,,4,3,7
073 Riffian,57,,4,9,13
073 Riffian,58,,10,4,14
073 Riffian,59,,4,6,10
073 Riffian,60,,2,4,6
073 Riffian,61,,1,3,4
073 Riffian,62,,1,4,5
073 Riffian,63,,7,5,12
073 Riffian,64,,4,4,8
073 Riffian,65,,5,9,14
073 Riffian,66,,5,3,8
073 Riffian,67,,3,7,10
073 Riffian,68,,2,3,5
073 Riffian,69,,5,6,11
073 Riffian,70,,6,2,8
073 Riffian,71,,5,3,8
073 Riffian,72,,5,7,12
073 Riffian,73,,4,7,11
073 Riffian,74,,3,2,5
073 Riffian,75,,1,4,5
073 Riffian,76,,4,3,7
073 Riffian,77,,-,1,1
073 Riffian,78,,1,1,2
073 Riffian,79,,1,3,4
073 Riffian,80,,1,-,1
073 Riffian,81,,1,1,2
073 Riffian,82,,1,7,8
073 Riffian,83,,2,4,6
073 Riffian,84,,1,2,3
073 Riffian,85,,1,-,1
073 Riffian,86,,2,-,2
073 Riffian,87,,-,1,1
073 Riffian,88,,2,3,5
073 Riffian,90,,1,-,1
073 Riffian,94,,1,-,1
073 Riffian,96,,-,1,1
073 Riffian,Insgesamt,,576,571,1.147
074 Mühlbach,0,,14,17,31
074 Mühlbach,1,,10,17,27
074 Mühlbach,2,,22,12,34
074 Mühlbach,3,,17,17,34
074 Mühlbach,4,,13,23,36
074 Mühlbach,5,,12,17,29
074 Mühlbach,6,,12,14,26
074 Mühlbach,7,,14,18,32
074 Mühlbach,8,,19,15,34
074 Mühlbach,9,,23,12,35
074 Mühlbach,10,,18,8,26
074 Mühlbach,11,,16,16,32
074 Mühlbach,12,,16,22,38
074 Mühlbach,13,,17,17,34
074 Mühlbach,14,,24,24,48
074 Mühlbach,15,,23,17,40
074 Mühlbach,16,,17,15,32
074 Mühlbach,17,,20,12,32
074 Mühlbach,18,,24,22,46
074 Mühlbach,19,,21,14,35
074 Mühlbach,20,,17,34,51
074 Mühlbach,21,,18,20,38
074 Mühlbach,22,,17,16,33
074 Mühlbach,23,,26,15,41
074 Mühlbach,24,,21,19,40
074 Mühlbach,25,,25,24,49
074 Mühlbach,26,,24,12,36
074 Mühlbach,27,,25,36,61
074 Mühlbach,28,,35,23,58
074 Mühlbach,29,,22,22,44
074 Mühlbach,30,,27,16,43
074 Mühlbach,31,,21,28,49
074 Mühlbach,32,,16,21,37
074 Mühlbach,33,,24,17,41
074 Mühlbach,34,,24,13,37
074 Mühlbach,35,,22,21,43
074 Mühlbach,36,,20,14,34
074 Mühlbach,37,,21,19,40
074 Mühlbach,38,,18,12,30
074 Mühlbach,39,,17,19,36
074 Mühlbach,40,,20,22,42
074 Mühlbach,41,,17,18,35
074 Mühlbach,42,,14,18,32
074 Mühlbach,43,,21,17,38
074 Mühlbach,44,,15,23,38
074 Mühlbach,45,,14,22,36
074 Mühlbach,46,,19,16,35
074 Mühlbach,47,,12,13,25
074 Mühlbach,48,,18,12,30
074 Mühlbach,49,,11,17,28
074 Mühlbach,50,,25,13,38
074 Mühlbach,51,,10,9,19
074 Mühlbach,52,,15,13,28
074 Mühlbach,53,,13,11,24
074 Mühlbach,54,,15,12,27
074 Mühlbach,55,,17,16,33
074 Mühlbach,56,,14,11,25
074 Mühlbach,57,,13,15,28
074 Mühlbach,58,,15,8,23
074 Mühlbach,59,,5,12,17
074 Mühlbach,60,,8,7,15
074 Mühlbach,61,,8,11,19
074 Mühlbach,62,,14,12,26
074 Mühlbach,63,,11,11,22
074 Mühlbach,64,,8,10,18
074 Mühlbach,65,,8,12,20
074 Mühlbach,66,,18,9,27
074 Mühlbach,67,,9,4,13
074 Mühlbach,68,,15,19,34
074 Mühlbach,69,,8,8,16
074 Mühlbach,70,,10,12,22
074 Mühlbach,71,,7,7,14
074 Mühlbach,72,,6,6,12
074 Mühlbach,73,,6,11,17
074 Mühlbach,74,,6,12,18
074 Mühlbach,75,,5,6,11
074 Mühlbach,76,,6,10,16
074 Mühlbach,77,,2,11,13
074 Mühlbach,78,,1,3,4
074 Mühlbach,79,,3,4,7
074 Mühlbach,80,,2,1,3
074 Mühlbach,81,,2,2,4
074 Mühlbach,82,,5,9,14
074 Mühlbach,83,,3,9,12
074 Mühlbach,84,,-,3,3
074 Mühlbach,85,,-,4,4
074 Mühlbach,86,,2,6,8
074 Mühlbach,87,,1,2,3
074 Mühlbach,88,,-,1,1
074 Mühlbach,89,,1,2,3
074 Mühlbach,90,,1,4,5
074 Mühlbach,91,,1,2,3
074 Mühlbach,93,,-,1,1
074 Mühlbach,Insgesamt,,1.272,1.259,2.531
075 Rodeneck,0,,10,11,21
075 Rodeneck,1,,6,11,17
075 Rodeneck,2,,7,11,18
075 Rodeneck,3,,7,7,14
075 Rodeneck,4,,9,10,19
075 Rodeneck,5,,6,9,15
075 Rodeneck,6,,11,8,19
075 Rodeneck,7,,7,6,13
075 Rodeneck,8,,13,8,21
075 Rodeneck,9,,6,5,11
075 Rodeneck,10,,9,12,21
075 Rodeneck,11,,12,9,21
075 Rodeneck,12,,16,11,27
075 Rodeneck,13,,11,7,18
075 Rodeneck,14,,7,6,13
075 Rodeneck,15,,10,8,18
075 Rodeneck,16,,6,9,15
075 Rodeneck,17,,8,7,15
075 Rodeneck,18,,6,8,14
075 Rodeneck,19,,8,8,16
075 Rodeneck,20,,8,5,13
075 Rodeneck,21,,9,6,15
075 Rodeneck,22,,7,5,12
075 Rodeneck,23,,16,10,26
075 Rodeneck,24,,10,10,20
075 Rodeneck,25,,12,6,18
075 Rodeneck,26,,9,13,22
075 Rodeneck,27,,15,8,23
075 Rodeneck,28,,9,9,18
075 Rodeneck,29,,13,9,22
075 Rodeneck,30,,13,8,21
075 Rodeneck,31,,8,8,16
075 Rodeneck,32,,12,11,23
075 Rodeneck,33,,9,10,19
075 Rodeneck,34,,9,15,24
075 Rodeneck,35,,9,12,21
075 Rodeneck,36,,6,11,17
075 Rodeneck,37,,12,5,17
075 Rodeneck,38,,8,5,13
075 Rodeneck,39,,6,7,13
075 Rodeneck,40,,10,5,15
075 Rodeneck,41,,6,6,12
075 Rodeneck,42,,11,4,15
075 Rodeneck,43,,5,2,7
075 Rodeneck,44,,8,5,13
075 Rodeneck,45,,3,2,5
075 Rodeneck,46,,1,7,8
075 Rodeneck,47,,4,8,12
075 Rodeneck,48,,4,7,11
075 Rodeneck,49,,6,4,10
075 Rodeneck,50,,10,6,16
075 Rodeneck,51,,-,4,4
075 Rodeneck,52,,5,5,10
075 Rodeneck,53,,3,2,5
075 Rodeneck,54,,3,6,9
075 Rodeneck,55,,10,3,13
075 Rodeneck,56,,5,3,8
075 Rodeneck,57,,3,9,12
075 Rodeneck,58,,4,3,7
075 Rodeneck,59,,3,4,7
075 Rodeneck,60,,5,5,10
075 Rodeneck,61,,5,2,7
075 Rodeneck,62,,1,12,13
075 Rodeneck,63,,3,2,5
075 Rodeneck,64,,5,5,10
075 Rodeneck,65,,7,5,12
075 Rodeneck,66,,5,3,8
075 Rodeneck,67,,7,3,10
075 Rodeneck,68,,6,5,11
075 Rodeneck,69,,5,6,11
075 Rodeneck,70,,4,6,10
075 Rodeneck,71,,3,8,11
075 Rodeneck,72,,5,5,10
075 Rodeneck,73,,2,4,6
075 Rodeneck,74,,4,3,7
075 Rodeneck,75,,3,1,4
075 Rodeneck,76,,2,2,4
075 Rodeneck,77,,5,2,7
075 Rodeneck,78,,1,3,4
075 Rodeneck,79,,-,1,1
075 Rodeneck,80,,1,1,2
075 Rodeneck,81,,1,3,4
075 Rodeneck,82,,2,1,3
075 Rodeneck,83,,1,1,2
075 Rodeneck,84,,2,2,4
075 Rodeneck,85,,-,2,2
075 Rodeneck,86,,3,-,3
075 Rodeneck,88,,-,1,1
075 Rodeneck,89,,-,1,1
075 Rodeneck,93,,1,-,1
075 Rodeneck,Insgesamt,,568,534,1.102
076 Salurn,0,,18,16,34
076 Salurn,1,,23,10,33
076 Salurn,2,,22,19,41
076 Salurn,3,,15,13,28
076 Salurn,4,,24,16,40
076 Salurn,5,,9,12,21
076 Salurn,6,,10,9,19
076 Salurn,7,,17,14,31
076 Salurn,8,,14,18,32
076 Salurn,9,,18,12,30
076 Salurn,10,,13,16,29
076 Salurn,11,,20,16,36
076 Salurn,12,,12,14,26
076 Salurn,13,,11,16,27
076 Salurn,14,,17,13,30
076 Salurn,15,,16,13,29
076 Salurn,16,,19,15,34
076 Salurn,17,,10,13,23
076 Salurn,18,,14,10,24
076 Salurn,19,,19,14,33
076 Salurn,20,,9,16,25
076 Salurn,21,,12,20,32
076 Salurn,22,,13,19,32
076 Salurn,23,,16,18,34
076 Salurn,24,,16,28,44
076 Salurn,25,,26,15,41
076 Salurn,26,,28,23,51
076 Salurn,27,,23,25,48
076 Salurn,28,,25,16,41
076 Salurn,29,,21,25,46
076 Salurn,30,,26,22,48
076 Salurn,31,,27,24,51
076 Salurn,32,,33,25,58
076 Salurn,33,,36,23,59
076 Salurn,34,,31,20,51
076 Salurn,35,,31,27,58
076 Salurn,36,,24,29,53
076 Salurn,37,,23,24,47
076 Salurn,38,,26,19,45
076 Salurn,39,,16,22,38
076 Salurn,40,,21,15,36
076 Salurn,41,,17,19,36
076 Salurn,42,,25,19,44
076 Salurn,43,,18,16,34
076 Salurn,44,,28,18,46
076 Salurn,45,,29,19,48
076 Salurn,46,,25,19,44
076 Salurn,47,,25,12,37
076 Salurn,48,,16,23,39
076 Salurn,49,,19,15,34
076 Salurn,50,,19,18,37
076 Salurn,51,,16,10,26
076 Salurn,52,,21,21,42
076 Salurn,53,,17,17,34
076 Salurn,54,,20,16,36
076 Salurn,55,,15,17,32
076 Salurn,56,,14,10,24
076 Salurn,57,,11,11,22
076 Salurn,58,,6,13,19
076 Salurn,59,,10,9,19
076 Salurn,60,,13,22,35
076 Salurn,61,,20,16,36
076 Salurn,62,,13,6,19
076 Salurn,63,,13,9,22
076 Salurn,64,,10,21,31
076 Salurn,65,,7,13,20
076 Salurn,66,,14,11,25
076 Salurn,67,,25,13,38
076 Salurn,68,,11,24,35
076 Salurn,69,,7,24,31
076 Salurn,70,,9,16,25
076 Salurn,71,,8,24,32
076 Salurn,72,,12,16,28
076 Salurn,73,,9,10,19
076 Salurn,74,,13,22,35
076 Salurn,75,,8,17,25
076 Salurn,76,,14,13,27
076 Salurn,77,,7,15,22
076 Salurn,78,,6,4,10
076 Salurn,79,,2,5,7
076 Salurn,80,,5,9,14
076 Salurn,81,,7,9,16
076 Salurn,82,,7,12,19
076 Salurn,83,,3,8,11
076 Salurn,84,,4,8,12
076 Salurn,85,,3,7,10
076 Salurn,86,,5,5,10
076 Salurn,87,,4,5,9
076 Salurn,88,,2,5,7
076 Salurn,89,,1,6,7
076 Salurn,90,,1,3,4
076 Salurn,91,,1,1,2
076 Salurn,92,,-,1,1
076 Salurn,93,,-,3,3
076 Salurn,94,,-,1,1
076 Salurn,Insgesamt,,1.419,1.420,2.839
077 Innichen,0,,15,20,35
077 Innichen,1,,22,13,35
077 Innichen,2,,15,18,33
077 Innichen,3,,21,20,41
077 Innichen,4,,24,19,43
077 Innichen,5,,21,24,45
077 Innichen,6,,16,14,30
077 Innichen,7,,18,22,40
077 Innichen,8,,29,20,49
077 Innichen,9,,21,19,40
077 Innichen,10,,22,18,40
077 Innichen,11,,21,20,41
077 Innichen,12,,20,21,41
077 Innichen,13,,22,16,38
077 Innichen,14,,18,22,40
077 Innichen,15,,15,19,34
077 Innichen,16,,22,17,39
077 Innichen,17,,25,22,47
077 Innichen,18,,9,16,25
077 Innichen,19,,14,20,34
077 Innichen,20,,19,26,45
077 Innichen,21,,25,5,30
077 Innichen,22,,24,24,48
077 Innichen,23,,28,24,52
077 Innichen,24,,26,24,50
077 Innichen,25,,21,23,44
077 Innichen,26,,27,30,57
077 Innichen,27,,29,29,58
077 Innichen,28,,34,32,66
077 Innichen,29,,20,26,46
077 Innichen,30,,30,29,59
077 Innichen,31,,34,33,67
077 Innichen,32,,37,34,71
077 Innichen,33,,35,28,63
077 Innichen,34,,32,26,58
077 Innichen,35,,28,30,58
077 Innichen,36,,37,19,56
077 Innichen,37,,28,25,53
077 Innichen,38,,25,25,50
077 Innichen,39,,21,25,46
077 Innichen,40,,26,15,41
077 Innichen,41,,25,18,43
077 Innichen,42,,22,13,35
077 Innichen,43,,25,19,44
077 Innichen,44,,13,26,39
077 Innichen,45,,12,19,31
077 Innichen,46,,18,20,38
077 Innichen,47,,22,17,39
077 Innichen,48,,18,12,30
077 Innichen,49,,14,16,30
077 Innichen,50,,16,15,31
077 Innichen,51,,13,9,22
077 Innichen,52,,8,13,21
077 Innichen,53,,23,10,33
077 Innichen,54,,16,18,34
077 Innichen,55,,15,16,31
077 Innichen,56,,10,23,33
077 Innichen,57,,12,13,25
077 Innichen,58,,8,11,19
077 Innichen,59,,11,13,24
077 Innichen,60,,11,17,28
077 Innichen,61,,8,20,28
077 Innichen,62,,11,14,25
077 Innichen,63,,12,10,22
077 Innichen,64,,21,16,37
077 Innichen,65,,15,20,35
077 Innichen,66,,17,11,28
077 Innichen,67,,15,17,32
077 Innichen,68,,13,22,35
077 Innichen,69,,10,12,22
077 Innichen,70,,19,14,33
077 Innichen,71,,10,23,33
077 Innichen,72,,12,5,17
077 Innichen,73,,9,14,23
077 Innichen,74,,8,16,24
077 Innichen,75,,8,15,23
077 Innichen,76,,8,13,21
077 Innichen,77,,4,5,9
077 Innichen,78,,2,6,8
077 Innichen,79,,3,4,7
077 Innichen,80,,3,5,8
077 Innichen,81,,4,5,9
077 Innichen,82,,4,6,10
077 Innichen,83,,5,9,14
077 Innichen,84,,2,6,8
077 Innichen,85,,1,1,2
077 Innichen,86,,1,5,6
077 Innichen,87,,4,3,7
077 Innichen,88,,3,5,8
077 Innichen,89,,1,2,3
077 Innichen,90,,1,1,2
077 Innichen,91,,-,2,2
077 Innichen,92,,-,2,2
077 Innichen,93,,-,2,2
077 Innichen,94,,1,3,4
077 Innichen,95,,-,1,1
077 Innichen,Insgesamt,,1.523,1.545,3.068
079 Jenesien,0,,22,10,32
079 Jenesien,1,,28,17,45
079 Jenesien,2,,22,23,45
079 Jenesien,3,,15,20,35
079 Jenesien,4,,25,20,45
079 Jenesien,5,,18,20,38
079 Jenesien,6,,18,15,33
079 Jenesien,7,,19,12,31
079 Jenesien,8,,23,16,39
079 Jenesien,9,,13,19,32
079 Jenesien,10,,17,16,33
079 Jenesien,11,,13,4,17
079 Jenesien,12,,18,15,33
079 Jenesien,13,,16,19,35
079 Jenesien,14,,13,24,37
079 Jenesien,15,,6,20,26
079 Jenesien,16,,15,21,36
079 Jenesien,17,,21,20,41
079 Jenesien,18,,12,13,25
079 Jenesien,19,,18,24,42
079 Jenesien,20,,13,13,26
079 Jenesien,21,,9,14,23
079 Jenesien,22,,17,19,36
079 Jenesien,23,,18,21,39
079 Jenesien,24,,16,22,38
079 Jenesien,25,,27,19,46
079 Jenesien,26,,29,24,53
079 Jenesien,27,,31,16,47
079 Jenesien,28,,21,29,50
079 Jenesien,29,,16,20,36
079 Jenesien,30,,29,28,57
079 Jenesien,31,,31,28,59
079 Jenesien,32,,36,34,70
079 Jenesien,33,,29,21,50
079 Jenesien,34,,27,20,47
079 Jenesien,35,,27,20,47
079 Jenesien,36,,23,12,35
079 Jenesien,37,,23,14,37
079 Jenesien,38,,24,8,32
079 Jenesien,39,,13,16,29
079 Jenesien,40,,18,14,32
079 Jenesien,41,,9,10,19
079 Jenesien,42,,16,16,32
079 Jenesien,43,,16,9,25
079 Jenesien,44,,15,20,35
079 Jenesien,45,,11,9,20
079 Jenesien,46,,10,21,31
079 Jenesien,47,,12,14,26
079 Jenesien,48,,12,7,19
079 Jenesien,49,,13,11,24
079 Jenesien,50,,8,11,19
079 Jenesien,51,,7,15,22
079 Jenesien,52,,13,14,27
079 Jenesien,53,,18,10,28
079 Jenesien,54,,15,10,25
079 Jenesien,55,,16,19,35
079 Jenesien,56,,16,11,27
079 Jenesien,57,,15,17,32
079 Jenesien,58,,22,9,31
079 Jenesien,59,,11,16,27
079 Jenesien,60,,7,19,26
079 Jenesien,61,,8,7,15
079 Jenesien,62,,9,7,16
079 Jenesien,63,,16,12,28
079 Jenesien,64,,8,11,19
079 Jenesien,65,,11,9,20
079 Jenesien,66,,7,16,23
079 Jenesien,67,,11,16,27
079 Jenesien,68,,15,10,25
079 Jenesien,69,,8,10,18
079 Jenesien,70,,11,14,25
079 Jenesien,71,,5,14,19
079 Jenesien,72,,8,11,19
079 Jenesien,73,,10,11,21
079 Jenesien,74,,7,12,19
079 Jenesien,75,,4,7,11
079 Jenesien,76,,3,10,13
079 Jenesien,77,,2,5,7
079 Jenesien,78,,-,1,1
079 Jenesien,79,,3,1,4
079 Jenesien,80,,2,2,4
079 Jenesien,81,,2,5,7
079 Jenesien,82,,4,5,9
079 Jenesien,83,,1,8,9
079 Jenesien,84,,1,6,7
079 Jenesien,85,,3,7,10
079 Jenesien,86,,-,4,4
079 Jenesien,87,,3,2,5
079 Jenesien,88,,3,4,7
079 Jenesien,89,,-,1,1
079 Jenesien,90,,1,3,4
079 Jenesien,91,,-,2,2
079 Jenesien,92,,-,2,2
079 Jenesien,93,,2,-,2
079 Jenesien,Insgesamt,,1.259,1.263,2.522
080 St.Leonhard in Pass.,0,,30,20,50
080 St.Leonhard in Pass.,1,,22,13,35
080 St.Leonhard in Pass.,2,,25,20,45
080 St.Leonhard in Pass.,3,,26,21,47
080 St.Leonhard in Pass.,4,,23,20,43
080 St.Leonhard in Pass.,5,,24,21,45
080 St.Leonhard in Pass.,6,,24,22,46
080 St.Leonhard in Pass.,7,,36,31,67
080 St.Leonhard in Pass.,8,,22,25,47
080 St.Leonhard in Pass.,9,,31,25,56
080 St.Leonhard in Pass.,10,,34,35,69
080 St.Leonhard in Pass.,11,,23,27,50
080 St.Leonhard in Pass.,12,,30,26,56
080 St.Leonhard in Pass.,13,,29,28,57
080 St.Leonhard in Pass.,14,,30,22,52
080 St.Leonhard in Pass.,15,,23,31,54
080 St.Leonhard in Pass.,16,,29,34,63
080 St.Leonhard in Pass.,17,,26,24,50
080 St.Leonhard in Pass.,18,,31,20,51
080 St.Leonhard in Pass.,19,,37,29,66
080 St.Leonhard in Pass.,20,,20,27,47
080 St.Leonhard in Pass.,21,,28,13,41
080 St.Leonhard in Pass.,22,,34,34,68
080 St.Leonhard in Pass.,23,,32,37,69
080 St.Leonhard in Pass.,24,,36,30,66
080 St.Leonhard in Pass.,25,,32,23,55
080 St.Leonhard in Pass.,26,,28,31,59
080 St.Leonhard in Pass.,27,,26,31,57
080 St.Leonhard in Pass.,28,,32,26,58
080 St.Leonhard in Pass.,29,,32,24,56
080 St.Leonhard in Pass.,30,,39,38,77
080 St.Leonhard in Pass.,31,,29,31,60
080 St.Leonhard in Pass.,32,,23,32,55
080 St.Leonhard in Pass.,33,,28,29,57
080 St.Leonhard in Pass.,34,,26,32,58
080 St.Leonhard in Pass.,35,,30,25,55
080 St.Leonhard in Pass.,36,,30,21,51
080 St.Leonhard in Pass.,37,,23,26,49
080 St.Leonhard in Pass.,38,,21,20,41
080 St.Leonhard in Pass.,39,,23,27,50
080 St.Leonhard in Pass.,40,,24,16,40
080 St.Leonhard in Pass.,41,,26,20,46
080 St.Leonhard in Pass.,42,,21,16,37
080 St.Leonhard in Pass.,43,,30,25,55
080 St.Leonhard in Pass.,44,,21,27,48
080 St.Leonhard in Pass.,45,,27,16,43
080 St.Leonhard in Pass.,46,,19,15,34
080 St.Leonhard in Pass.,47,,26,12,38
080 St.Leonhard in Pass.,48,,22,14,36
080 St.Leonhard in Pass.,49,,20,17,37
080 St.Leonhard in Pass.,50,,18,19,37
080 St.Leonhard in Pass.,51,,10,11,21
080 St.Leonhard in Pass.,52,,18,14,32
080 St.Leonhard in Pass.,53,,11,26,37
080 St.Leonhard in Pass.,54,,10,16,26
080 St.Leonhard in Pass.,55,,15,15,30
080 St.Leonhard in Pass.,56,,24,14,38
080 St.Leonhard in Pass.,57,,21,19,40
080 St.Leonhard in Pass.,58,,14,13,27
080 St.Leonhard in Pass.,59,,20,9,29
080 St.Leonhard in Pass.,60,,20,11,31
080 St.Leonhard in Pass.,61,,14,14,28
080 St.Leonhard in Pass.,62,,11,14,25
080 St.Leonhard in Pass.,63,,13,17,30
080 St.Leonhard in Pass.,64,,16,14,30
080 St.Leonhard in Pass.,65,,8,15,23
080 St.Leonhard in Pass.,66,,9,10,19
080 St.Leonhard in Pass.,67,,12,9,21
080 St.Leonhard in Pass.,68,,8,14,22
080 St.Leonhard in Pass.,69,,7,16,23
080 St.Leonhard in Pass.,70,,10,13,23
080 St.Leonhard in Pass.,71,,8,12,20
080 St.Leonhard in Pass.,72,,7,11,18
080 St.Leonhard in Pass.,73,,8,13,21
080 St.Leonhard in Pass.,74,,9,11,20
080 St.Leonhard in Pass.,75,,3,8,11
080 St.Leonhard in Pass.,76,,5,10,15
080 St.Leonhard in Pass.,77,,6,3,9
080 St.Leonhard in Pass.,78,,2,5,7
080 St.Leonhard in Pass.,79,,1,6,7
080 St.Leonhard in Pass.,80,,2,1,3
080 St.Leonhard in Pass.,81,,2,4,6
080 St.Leonhard in Pass.,82,,4,11,15
080 St.Leonhard in Pass.,83,,-,4,4
080 St.Leonhard in Pass.,84,,1,10,11
080 St.Leonhard in Pass.,85,,4,5,9
080 St.Leonhard in Pass.,86,,-,2,2
080 St.Leonhard in Pass.,87,,2,4,6
080 St.Leonhard in Pass.,88,,3,2,5
080 St.Leonhard in Pass.,89,,1,5,6
080 St.Leonhard in Pass.,90,,2,2,4
080 St.Leonhard in Pass.,91,,1,3,4
080 St.Leonhard in Pass.,92,,-,3,3
080 St.Leonhard in Pass.,93,,1,-,1
080 St.Leonhard in Pass.,94,,-,1,1
080 St.Leonhard in Pass.,Insgesamt,,1.724,1.668,3.392
081 St.Lorenzen,0,,24,23,47
081 St.Lorenzen,1,,24,13,37
081 St.Lorenzen,2,,29,20,49
081 St.Lorenzen,3,,22,31,53
081 St.Lorenzen,4,,26,20,46
081 St.Lorenzen,5,,22,15,37
081 St.Lorenzen,6,,24,21,45
081 St.Lorenzen,7,,19,17,36
081 St.Lorenzen,8,,19,25,44
081 St.Lorenzen,9,,19,22,41
081 St.Lorenzen,10,,22,21,43
081 St.Lorenzen,11,,24,22,46
081 St.Lorenzen,12,,25,26,51
081 St.Lorenzen,13,,21,19,40
081 St.Lorenzen,14,,30,18,48
081 St.Lorenzen,15,,19,19,38
081 St.Lorenzen,16,,13,17,30
081 St.Lorenzen,17,,24,26,50
081 St.Lorenzen,18,,22,24,46
081 St.Lorenzen,19,,27,20,47
081 St.Lorenzen,20,,24,21,45
081 St.Lorenzen,21,,23,22,45
081 St.Lorenzen,22,,17,26,43
081 St.Lorenzen,23,,35,20,55
081 St.Lorenzen,24,,34,22,56
081 St.Lorenzen,25,,31,21,52
081 St.Lorenzen,26,,24,29,53
081 St.Lorenzen,27,,26,27,53
081 St.Lorenzen,28,,41,33,74
081 St.Lorenzen,29,,38,30,68
081 St.Lorenzen,30,,34,38,72
081 St.Lorenzen,31,,38,24,62
081 St.Lorenzen,32,,30,23,53
081 St.Lorenzen,33,,35,32,67
081 St.Lorenzen,34,,29,33,62
081 St.Lorenzen,35,,23,36,59
081 St.Lorenzen,36,,33,23,56
081 St.Lorenzen,37,,29,26,55
081 St.Lorenzen,38,,27,30,57
081 St.Lorenzen,39,,26,24,50
081 St.Lorenzen,40,,26,27,53
081 St.Lorenzen,41,,18,17,35
081 St.Lorenzen,42,,19,20,39
081 St.Lorenzen,43,,23,16,39
081 St.Lorenzen,44,,18,11,29
081 St.Lorenzen,45,,18,15,33
081 St.Lorenzen,46,,14,18,32
081 St.Lorenzen,47,,11,21,32
081 St.Lorenzen,48,,14,12,26
081 St.Lorenzen,49,,21,9,30
081 St.Lorenzen,50,,22,8,30
081 St.Lorenzen,51,,14,20,34
081 St.Lorenzen,52,,16,15,31
081 St.Lorenzen,53,,16,15,31
081 St.Lorenzen,54,,19,25,44
081 St.Lorenzen,55,,21,18,39
081 St.Lorenzen,56,,14,14,28
081 St.Lorenzen,57,,15,17,32
081 St.Lorenzen,58,,15,13,28
081 St.Lorenzen,59,,18,17,35
081 St.Lorenzen,60,,13,16,29
081 St.Lorenzen,61,,14,17,31
081 St.Lorenzen,62,,16,14,30
081 St.Lorenzen,63,,15,14,29
081 St.Lorenzen,64,,15,13,28
081 St.Lorenzen,65,,10,16,26
081 St.Lorenzen,66,,13,11,24
081 St.Lorenzen,67,,12,20,32
081 St.Lorenzen,68,,20,17,37
081 St.Lorenzen,69,,12,7,19
081 St.Lorenzen,70,,11,13,24
081 St.Lorenzen,71,,12,20,32
081 St.Lorenzen,72,,5,12,17
081 St.Lorenzen,73,,10,12,22
081 St.Lorenzen,74,,7,9,16
081 St.Lorenzen,75,,7,6,13
081 St.Lorenzen,76,,4,10,14
081 St.Lorenzen,77,,7,10,17
081 St.Lorenzen,78,,3,8,11
081 St.Lorenzen,79,,-,6,6
081 St.Lorenzen,80,,2,5,7
081 St.Lorenzen,81,,2,4,6
081 St.Lorenzen,82,,7,6,13
081 St.Lorenzen,83,,2,3,5
081 St.Lorenzen,84,,4,5,9
081 St.Lorenzen,85,,3,3,6
081 St.Lorenzen,86,,2,6,8
081 St.Lorenzen,87,,2,2,4
081 St.Lorenzen,88,,-,4,4
081 St.Lorenzen,89,,1,5,6
081 St.Lorenzen,90,,-,1,1
081 St.Lorenzen,91,,-,2,2
081 St.Lorenzen,92,,1,2,3
081 St.Lorenzen,93,,-,2,2
081 St.Lorenzen,96,,-,1,1
081 St.Lorenzen,Insgesamt,,1.636,1.589,3.225
082 St.Martin in Thurn,0,,21,14,35
082 St.Martin in Thurn,1,,14,13,27
082 St.Martin in Thurn,2,,14,8,22
082 St.Martin in Thurn,3,,9,8,17
082 St.Martin in Thurn,4,,16,14,30
082 St.Martin in Thurn,5,,11,10,21
082 St.Martin in Thurn,6,,6,16,22
082 St.Martin in Thurn,7,,17,15,32
082 St.Martin in Thurn,8,,8,6,14
082 St.Martin in Thurn,9,,14,12,26
082 St.Martin in Thurn,10,,13,10,23
082 St.Martin in Thurn,11,,12,14,26
082 St.Martin in Thurn,12,,8,6,14
082 St.Martin in Thurn,13,,15,9,24
082 St.Martin in Thurn,14,,14,12,26
082 St.Martin in Thurn,15,,16,8,24
082 St.Martin in Thurn,16,,8,13,21
082 St.Martin in Thurn,17,,9,11,20
082 St.Martin in Thurn,18,,18,9,27
082 St.Martin in Thurn,19,,14,13,27
082 St.Martin in Thurn,20,,12,11,23
082 St.Martin in Thurn,21,,8,15,23
082 St.Martin in Thurn,22,,6,10,16
082 St.Martin in Thurn,23,,12,10,22
082 St.Martin in Thurn,24,,11,13,24
082 St.Martin in Thurn,25,,13,15,28
082 St.Martin in Thurn,26,,14,10,24
082 St.Martin in Thurn,27,,14,13,27
082 St.Martin in Thurn,28,,13,18,31
082 St.Martin in Thurn,29,,11,10,21
082 St.Martin in Thurn,30,,15,22,37
082 St.Martin in Thurn,31,,15,19,34
082 St.Martin in Thurn,32,,12,14,26
082 St.Martin in Thurn,33,,16,14,30
082 St.Martin in Thurn,34,,15,14,29
082 St.Martin in Thurn,35,,14,21,35
082 St.Martin in Thurn,36,,15,6,21
082 St.Martin in Thurn,37,,12,12,24
082 St.Martin in Thurn,38,,13,8,21
082 St.Martin in Thurn,39,,12,9,21
082 St.Martin in Thurn,40,,7,7,14
082 St.Martin in Thurn,41,,13,9,22
082 St.Martin in Thurn,42,,8,8,16
082 St.Martin in Thurn,43,,8,11,19
082 St.Martin in Thurn,44,,3,4,7
082 St.Martin in Thurn,45,,7,8,15
082 St.Martin in Thurn,46,,11,7,18
082 St.Martin in Thurn,47,,4,7,11
082 St.Martin in Thurn,48,,9,7,16
082 St.Martin in Thurn,49,,9,6,15
082 St.Martin in Thurn,50,,9,7,16
082 St.Martin in Thurn,51,,7,4,11
082 St.Martin in Thurn,52,,11,8,19
082 St.Martin in Thurn,53,,4,8,12
082 St.Martin in Thurn,54,,7,6,13
082 St.Martin in Thurn,55,,7,8,15
082 St.Martin in Thurn,56,,4,5,9
082 St.Martin in Thurn,57,,5,7,12
082 St.Martin in Thurn,58,,10,7,17
082 St.Martin in Thurn,59,,7,14,21
082 St.Martin in Thurn,60,,4,6,10
082 St.Martin in Thurn,61,,7,5,12
082 St.Martin in Thurn,62,,8,4,12
082 St.Martin in Thurn,63,,2,11,13
082 St.Martin in Thurn,64,,9,7,16
082 St.Martin in Thurn,65,,11,7,18
082 St.Martin in Thurn,66,,7,7,14
082 St.Martin in Thurn,67,,5,7,12
082 St.Martin in Thurn,68,,3,7,10
082 St.Martin in Thurn,69,,6,6,12
082 St.Martin in Thurn,70,,9,8,17
082 St.Martin in Thurn,71,,8,4,12
082 St.Martin in Thurn,72,,8,9,17
082 St.Martin in Thurn,73,,4,8,12
082 St.Martin in Thurn,74,,10,5,15
082 St.Martin in Thurn,75,,7,4,11
082 St.Martin in Thurn,76,,7,8,15
082 St.Martin in Thurn,77,,2,4,6
082 St.Martin in Thurn,78,,2,-,2
082 St.Martin in Thurn,79,,4,2,6
082 St.Martin in Thurn,80,,1,1,2
082 St.Martin in Thurn,81,,1,1,2
082 St.Martin in Thurn,82,,1,3,4
082 St.Martin in Thurn,83,,1,2,3
082 St.Martin in Thurn,84,,1,1,2
082 St.Martin in Thurn,85,,2,2,4
082 St.Martin in Thurn,86,,3,2,5
082 St.Martin in Thurn,87,,1,3,4
082 St.Martin in Thurn,88,,3,1,4
082 St.Martin in Thurn,89,,-,2,2
082 St.Martin in Thurn,90,,-,1,1
082 St.Martin in Thurn,92,,2,2,4
082 St.Martin in Thurn,Insgesamt,,799,773,1.572
083 St.Martin in Passeier,0,,23,21,44
083 St.Martin in Passeier,1,,21,17,38
083 St.Martin in Passeier,2,,21,23,44
083 St.Martin in Passeier,3,,18,21,39
083 St.Martin in Passeier,4,,27,17,44
083 St.Martin in Passeier,5,,23,21,44
083 St.Martin in Passeier,6,,19,25,44
083 St.Martin in Passeier,7,,19,19,38
083 St.Martin in Passeier,8,,17,15,32
083 St.Martin in Passeier,9,,18,23,41
083 St.Martin in Passeier,10,,22,22,44
083 St.Martin in Passeier,11,,16,21,37
083 St.Martin in Passeier,12,,15,23,38
083 St.Martin in Passeier,13,,17,9,26
083 St.Martin in Passeier,14,,20,20,40
083 St.Martin in Passeier,15,,23,20,43
083 St.Martin in Passeier,16,,20,21,41
083 St.Martin in Passeier,17,,21,12,33
083 St.Martin in Passeier,18,,31,17,48
083 St.Martin in Passeier,19,,20,20,40
083 St.Martin in Passeier,20,,22,22,44
083 St.Martin in Passeier,21,,24,20,44
083 St.Martin in Passeier,22,,20,26,46
083 St.Martin in Passeier,23,,22,30,52
083 St.Martin in Passeier,24,,29,27,56
083 St.Martin in Passeier,25,,30,25,55
083 St.Martin in Passeier,26,,28,25,53
083 St.Martin in Passeier,27,,27,30,57
083 St.Martin in Passeier,28,,23,27,50
083 St.Martin in Passeier,29,,18,29,47
083 St.Martin in Passeier,30,,29,31,60
083 St.Martin in Passeier,31,,34,28,62
083 St.Martin in Passeier,32,,23,22,45
083 St.Martin in Passeier,33,,35,19,54
083 St.Martin in Passeier,34,,20,29,49
083 St.Martin in Passeier,35,,35,21,56
083 St.Martin in Passeier,36,,20,26,46
083 St.Martin in Passeier,37,,28,22,50
083 St.Martin in Passeier,38,,25,21,46
083 St.Martin in Passeier,39,,28,11,39
083 St.Martin in Passeier,40,,22,16,38
083 St.Martin in Passeier,41,,34,14,48
083 St.Martin in Passeier,42,,16,8,24
083 St.Martin in Passeier,43,,23,18,41
083 St.Martin in Passeier,44,,6,21,27
083 St.Martin in Passeier,45,,22,14,36
083 St.Martin in Passeier,46,,12,16,28
083 St.Martin in Passeier,47,,12,8,20
083 St.Martin in Passeier,48,,14,10,24
083 St.Martin in Passeier,49,,16,13,29
083 St.Martin in Passeier,50,,15,11,26
083 St.Martin in Passeier,51,,12,13,25
083 St.Martin in Passeier,52,,18,12,30
083 St.Martin in Passeier,53,,15,11,26
083 St.Martin in Passeier,54,,15,14,29
083 St.Martin in Passeier,55,,11,14,25
083 St.Martin in Passeier,56,,5,13,18
083 St.Martin in Passeier,57,,6,14,20
083 St.Martin in Passeier,58,,14,9,23
083 St.Martin in Passeier,59,,14,18,32
083 St.Martin in Passeier,60,,15,14,29
083 St.Martin in Passeier,61,,6,14,20
083 St.Martin in Passeier,62,,20,9,29
083 St.Martin in Passeier,63,,15,9,24
083 St.Martin in Passeier,64,,11,12,23
083 St.Martin in Passeier,65,,7,13,20
083 St.Martin in Passeier,66,,11,14,25
083 St.Martin in Passeier,67,,13,10,23
083 St.Martin in Passeier,68,,9,8,17
083 St.Martin in Passeier,69,,13,6,19
083 St.Martin in Passeier,70,,5,13,18
083 St.Martin in Passeier,71,,9,9,18
083 St.Martin in Passeier,72,,7,14,21
083 St.Martin in Passeier,73,,4,10,14
083 St.Martin in Passeier,74,,8,7,15
083 St.Martin in Passeier,75,,8,13,21
083 St.Martin in Passeier,76,,3,5,8
083 St.Martin in Passeier,77,,2,5,7
083 St.Martin in Passeier,78,,1,3,4
083 St.Martin in Passeier,79,,4,5,9
083 St.Martin in Passeier,80,,1,2,3
083 St.Martin in Passeier,81,,4,1,5
083 St.Martin in Passeier,82,,1,8,9
083 St.Martin in Passeier,83,,3,7,10
083 St.Martin in Passeier,84,,2,4,6
083 St.Martin in Passeier,85,,2,2,4
083 St.Martin in Passeier,86,,1,2,3
083 St.Martin in Passeier,87,,1,-,1
083 St.Martin in Passeier,88,,2,2,4
083 St.Martin in Passeier,89,,-,1,1
083 St.Martin in Passeier,90,,1,2,3
083 St.Martin in Passeier,Insgesamt,,1.422,1.369,2.791
084 St.Pankraz,0,,10,10,20
084 St.Pankraz,1,,8,5,13
084 St.Pankraz,2,,10,7,17
084 St.Pankraz,3,,4,9,13
084 St.Pankraz,4,,6,6,12
084 St.Pankraz,5,,11,13,24
084 St.Pankraz,6,,8,4,12
084 St.Pankraz,7,,12,14,26
084 St.Pankraz,8,,14,7,21
084 St.Pankraz,9,,10,6,16
084 St.Pankraz,10,,10,7,17
084 St.Pankraz,11,,9,7,16
084 St.Pankraz,12,,9,5,14
084 St.Pankraz,13,,11,7,18
084 St.Pankraz,14,,12,9,21
084 St.Pankraz,15,,8,13,21
084 St.Pankraz,16,,12,9,21
084 St.Pankraz,17,,6,8,14
084 St.Pankraz,18,,15,10,25
084 St.Pankraz,19,,8,16,24
084 St.Pankraz,20,,6,8,14
084 St.Pankraz,21,,11,9,20
084 St.Pankraz,22,,14,15,29
084 St.Pankraz,23,,14,11,25
084 St.Pankraz,24,,11,10,21
084 St.Pankraz,25,,17,12,29
084 St.Pankraz,26,,11,9,20
084 St.Pankraz,27,,18,16,34
084 St.Pankraz,28,,23,19,42
084 St.Pankraz,29,,10,15,25
084 St.Pankraz,30,,19,9,28
084 St.Pankraz,31,,26,16,42
084 St.Pankraz,32,,15,14,29
084 St.Pankraz,33,,12,12,24
084 St.Pankraz,34,,18,10,28
084 St.Pankraz,35,,12,14,26
084 St.Pankraz,36,,12,5,17
084 St.Pankraz,37,,17,13,30
084 St.Pankraz,38,,8,9,17
084 St.Pankraz,39,,13,9,22
084 St.Pankraz,40,,9,16,25
084 St.Pankraz,41,,8,4,12
084 St.Pankraz,42,,10,9,19
084 St.Pankraz,43,,10,9,19
084 St.Pankraz,44,,16,9,25
084 St.Pankraz,45,,4,3,7
084 St.Pankraz,46,,10,6,16
084 St.Pankraz,47,,7,6,13
084 St.Pankraz,48,,7,4,11
084 St.Pankraz,49,,8,8,16
084 St.Pankraz,50,,6,9,15
084 St.Pankraz,51,,3,6,9
084 St.Pankraz,52,,4,8,12
084 St.Pankraz,53,,11,14,25
084 St.Pankraz,54,,8,14,22
084 St.Pankraz,55,,8,10,18
084 St.Pankraz,56,,8,8,16
084 St.Pankraz,57,,10,7,17
084 St.Pankraz,58,,5,11,16
084 St.Pankraz,59,,8,10,18
084 St.Pankraz,60,,7,5,12
084 St.Pankraz,61,,5,9,14
084 St.Pankraz,62,,8,7,15
084 St.Pankraz,63,,8,3,11
084 St.Pankraz,64,,8,10,18
084 St.Pankraz,65,,9,5,14
084 St.Pankraz,66,,8,7,15
084 St.Pankraz,67,,12,8,20
084 St.Pankraz,68,,9,11,20
084 St.Pankraz,69,,7,6,13
084 St.Pankraz,70,,10,7,17
084 St.Pankraz,71,,8,7,15
084 St.Pankraz,72,,8,11,19
084 St.Pankraz,73,,12,4,16
084 St.Pankraz,74,,10,10,20
084 St.Pankraz,75,,2,12,14
084 St.Pankraz,76,,3,9,12
084 St.Pankraz,77,,4,5,9
084 St.Pankraz,78,,3,5,8
084 St.Pankraz,79,,1,3,4
084 St.Pankraz,80,,3,-,3
084 St.Pankraz,81,,3,4,7
084 St.Pankraz,82,,2,5,7
084 St.Pankraz,83,,2,2,4
084 St.Pankraz,84,,4,3,7
084 St.Pankraz,85,,2,2,4
084 St.Pankraz,86,,2,4,6
084 St.Pankraz,87,,3,5,8
084 St.Pankraz,88,,-,3,3
084 St.Pankraz,89,,1,-,1
084 St.Pankraz,90,,2,2,4
084 St.Pankraz,91,,1,1,2
084 St.Pankraz,92,,1,2,3
084 St.Pankraz,93,,1,-,1
084 St.Pankraz,98,,-,2,2
084 St.Pankraz,Insgesamt,,809,757,1.566
085 St.Christina in Gröden,0,,16,8,24
085 St.Christina in Gröden,1,,13,10,23
085 St.Christina in Gröden,2,,9,14,23
085 St.Christina in Gröden,3,,13,13,26
085 St.Christina in Gröden,4,,14,14,28
085 St.Christina in Gröden,5,,12,16,28
085 St.Christina in Gröden,6,,7,16,23
085 St.Christina in Gröden,7,,5,6,11
085 St.Christina in Gröden,8,,11,8,19
085 St.Christina in Gröden,9,,11,6,17
085 St.Christina in Gröden,10,,11,8,19
085 St.Christina in Gröden,11,,6,11,17
085 St.Christina in Gröden,12,,10,5,15
085 St.Christina in Gröden,13,,18,13,31
085 St.Christina in Gröden,14,,12,5,17
085 St.Christina in Gröden,15,,9,13,22
085 St.Christina in Gröden,16,,10,12,22
085 St.Christina in Gröden,17,,12,10,22
085 St.Christina in Gröden,18,,6,8,14
085 St.Christina in Gröden,19,,3,8,11
085 St.Christina in Gröden,20,,13,12,25
085 St.Christina in Gröden,21,,11,10,21
085 St.Christina in Gröden,22,,5,16,21
085 St.Christina in Gröden,23,,6,12,18
085 St.Christina in Gröden,24,,19,10,29
085 St.Christina in Gröden,25,,8,14,22
085 St.Christina in Gröden,26,,23,19,42
085 St.Christina in Gröden,27,,16,8,24
085 St.Christina in Gröden,28,,19,20,39
085 St.Christina in Gröden,29,,15,18,33
085 St.Christina in Gröden,30,,19,14,33
085 St.Christina in Gröden,31,,15,19,34
085 St.Christina in Gröden,32,,13,23,36
085 St.Christina in Gröden,33,,14,17,31
085 St.Christina in Gröden,34,,20,18,38
085 St.Christina in Gröden,35,,18,13,31
085 St.Christina in Gröden,36,,18,19,37
085 St.Christina in Gröden,37,,11,10,21
085 St.Christina in Gröden,38,,7,13,20
085 St.Christina in Gröden,39,,17,10,27
085 St.Christina in Gröden,40,,11,10,21
085 St.Christina in Gröden,41,,9,10,19
085 St.Christina in Gröden,42,,16,14,30
085 St.Christina in Gröden,43,,9,9,18
085 St.Christina in Gröden,44,,6,5,11
085 St.Christina in Gröden,45,,11,6,17
085 St.Christina in Gröden,46,,8,6,14
085 St.Christina in Gröden,47,,7,12,19
085 St.Christina in Gröden,48,,8,6,14
085 St.Christina in Gröden,49,,6,9,15
085 St.Christina in Gröden,50,,9,13,22
085 St.Christina in Gröden,51,,6,6,12
085 St.Christina in Gröden,52,,5,11,16
085 St.Christina in Gröden,53,,13,16,29
085 St.Christina in Gröden,54,,10,6,16
085 St.Christina in Gröden,55,,13,7,20
085 St.Christina in Gröden,56,,10,11,21
085 St.Christina in Gröden,57,,11,11,22
085 St.Christina in Gröden,58,,7,8,15
085 St.Christina in Gröden,59,,9,7,16
085 St.Christina in Gröden,60,,15,10,25
085 St.Christina in Gröden,61,,14,5,19
085 St.Christina in Gröden,62,,8,12,20
085 St.Christina in Gröden,63,,6,14,20
085 St.Christina in Gröden,64,,9,10,19
085 St.Christina in Gröden,65,,6,9,15
085 St.Christina in Gröden,66,,14,5,19
085 St.Christina in Gröden,67,,5,10,15
085 St.Christina in Gröden,68,,6,5,11
085 St.Christina in Gröden,69,,5,7,12
085 St.Christina in Gröden,70,,9,7,16
085 St.Christina in Gröden,71,,7,10,17
085 St.Christina in Gröden,72,,3,5,8
085 St.Christina in Gröden,73,,6,4,10
085 St.Christina in Gröden,74,,1,10,11
085 St.Christina in Gröden,75,,4,4,8
085 St.Christina in Gröden,76,,6,6,12
085 St.Christina in Gröden,77,,4,1,5
085 St.Christina in Gröden,78,,-,1,1
085 St.Christina in Gröden,79,,1,2,3
085 St.Christina in Gröden,80,,1,3,4
085 St.Christina in Gröden,81,,6,1,7
085 St.Christina in Gröden,82,,3,4,7
085 St.Christina in Gröden,83,,4,1,5
085 St.Christina in Gröden,84,,3,2,5
085 St.Christina in Gröden,85,,-,3,3
085 St.Christina in Gröden,86,,2,3,5
085 St.Christina in Gröden,87,,2,2,4
085 St.Christina in Gröden,88,,-,1,1
085 St.Christina in Gröden,89,,1,2,3
085 St.Christina in Gröden,90,,-,1,1
085 St.Christina in Gröden,92,,1,1,2
085 St.Christina in Gröden,94,,-,1,1
085 St.Christina in Gröden,Insgesamt,,831,844,1.675
086 Sarntal,0,,47,40,87
086 Sarntal,1,,40,42,82
086 Sarntal,2,,33,42,75
086 Sarntal,3,,32,39,71
086 Sarntal,4,,45,38,83
086 Sarntal,5,,43,42,85
086 Sarntal,6,,46,30,76
086 Sarntal,7,,54,37,91
086 Sarntal,8,,47,41,88
086 Sarntal,9,,36,32,68
086 Sarntal,10,,40,44,84
086 Sarntal,11,,44,39,83
086 Sarntal,12,,39,42,81
086 Sarntal,13,,50,42,92
086 Sarntal,14,,63,51,114
086 Sarntal,15,,43,58,101
086 Sarntal,16,,60,50,110
086 Sarntal,17,,56,48,104
086 Sarntal,18,,55,52,107
086 Sarntal,19,,59,46,105
086 Sarntal,20,,49,42,91
086 Sarntal,21,,66,52,118
086 Sarntal,22,,50,67,117
086 Sarntal,23,,62,60,122
086 Sarntal,24,,73,49,122
086 Sarntal,25,,52,51,103
086 Sarntal,26,,67,61,128
086 Sarntal,27,,64,59,123
086 Sarntal,28,,49,47,96
086 Sarntal,29,,51,52,103
086 Sarntal,30,,54,59,113
086 Sarntal,31,,65,57,122
086 Sarntal,32,,65,60,125
086 Sarntal,33,,45,50,95
086 Sarntal,34,,63,35,98
086 Sarntal,35,,41,52,93
086 Sarntal,36,,65,45,110
086 Sarntal,37,,45,38,83
086 Sarntal,38,,55,43,98
086 Sarntal,39,,38,45,83
086 Sarntal,40,,41,30,71
086 Sarntal,41,,41,37,78
086 Sarntal,42,,37,29,66
086 Sarntal,43,,42,32,74
086 Sarntal,44,,37,41,78
086 Sarntal,45,,46,34,80
086 Sarntal,46,,38,36,74
086 Sarntal,47,,52,25,77
086 Sarntal,48,,38,38,76
086 Sarntal,49,,40,28,68
086 Sarntal,50,,37,37,74
086 Sarntal,51,,30,31,61
086 Sarntal,52,,27,31,58
086 Sarntal,53,,41,41,82
086 Sarntal,54,,43,40,83
086 Sarntal,55,,33,34,67
086 Sarntal,56,,31,44,75
086 Sarntal,57,,40,32,72
086 Sarntal,58,,37,29,66
086 Sarntal,59,,26,34,60
086 Sarntal,60,,22,26,48
086 Sarntal,61,,26,25,51
086 Sarntal,62,,28,22,50
086 Sarntal,63,,25,24,49
086 Sarntal,64,,33,27,60
086 Sarntal,65,,22,26,48
086 Sarntal,66,,23,26,49
086 Sarntal,67,,22,30,52
086 Sarntal,68,,26,30,56
086 Sarntal,69,,20,34,54
086 Sarntal,70,,25,17,42
086 Sarntal,71,,23,27,50
086 Sarntal,72,,17,30,47
086 Sarntal,73,,15,28,43
086 Sarntal,74,,20,35,55
086 Sarntal,75,,11,18,29
086 Sarntal,76,,17,20,37
086 Sarntal,77,,8,19,27
086 Sarntal,78,,6,14,20
086 Sarntal,79,,3,12,15
086 Sarntal,80,,3,10,13
086 Sarntal,81,,5,10,15
086 Sarntal,82,,11,12,23
086 Sarntal,83,,12,15,27
086 Sarntal,84,,9,16,25
086 Sarntal,85,,7,13,20
086 Sarntal,86,,3,14,17
086 Sarntal,87,,5,7,12
086 Sarntal,88,,2,5,7
086 Sarntal,89,,3,8,11
086 Sarntal,90,,6,3,9
086 Sarntal,91,,5,1,6
086 Sarntal,92,,1,3,4
086 Sarntal,93,,-,1,1
086 Sarntal,94,,1,3,4
086 Sarntal,95,,-,3,3
086 Sarntal,Insgesamt,,3.273,3.176,6.449
087 Schenna,0,,19,17,36
087 Schenna,1,,17,17,34
087 Schenna,2,,21,17,38
087 Schenna,3,,15,8,23
087 Schenna,4,,16,19,35
087 Schenna,5,,12,20,32
087 Schenna,6,,18,16,34
087 Schenna,7,,21,10,31
087 Schenna,8,,20,19,39
087 Schenna,9,,21,16,37
087 Schenna,10,,18,12,30
087 Schenna,11,,15,16,31
087 Schenna,12,,16,14,30
087 Schenna,13,,17,14,31
087 Schenna,14,,11,17,28
087 Schenna,15,,22,8,30
087 Schenna,16,,19,17,36
087 Schenna,17,,23,21,44
087 Schenna,18,,15,21,36
087 Schenna,19,,19,19,38
087 Schenna,20,,24,20,44
087 Schenna,21,,17,25,42
087 Schenna,22,,31,29,60
087 Schenna,23,,28,23,51
087 Schenna,24,,24,21,45
087 Schenna,25,,30,27,57
087 Schenna,26,,24,22,46
087 Schenna,27,,28,19,47
087 Schenna,28,,22,21,43
087 Schenna,29,,34,20,54
087 Schenna,30,,12,21,33
087 Schenna,31,,24,31,55
087 Schenna,32,,23,25,48
087 Schenna,33,,27,21,48
087 Schenna,34,,27,14,41
087 Schenna,35,,28,21,49
087 Schenna,36,,33,24,57
087 Schenna,37,,17,13,30
087 Schenna,38,,21,19,40
087 Schenna,39,,11,20,31
087 Schenna,40,,17,16,33
087 Schenna,41,,14,16,30
087 Schenna,42,,15,18,33
087 Schenna,43,,15,17,32
087 Schenna,44,,15,16,31
087 Schenna,45,,16,13,29
087 Schenna,46,,20,14,34
087 Schenna,47,,20,20,40
087 Schenna,48,,15,15,30
087 Schenna,49,,15,17,32
087 Schenna,50,,18,23,41
087 Schenna,51,,15,13,28
087 Schenna,52,,17,10,27
087 Schenna,53,,25,10,35
087 Schenna,54,,12,19,31
087 Schenna,55,,15,13,28
087 Schenna,56,,10,9,19
087 Schenna,57,,14,15,29
087 Schenna,58,,16,20,36
087 Schenna,59,,7,10,17
087 Schenna,60,,11,11,22
087 Schenna,61,,14,9,23
087 Schenna,62,,13,15,28
087 Schenna,63,,6,10,16
087 Schenna,64,,11,15,26
087 Schenna,65,,14,13,27
087 Schenna,66,,12,10,22
087 Schenna,67,,9,12,21
087 Schenna,68,,7,11,18
087 Schenna,69,,5,15,20
087 Schenna,70,,9,7,16
087 Schenna,71,,5,13,18
087 Schenna,72,,11,8,19
087 Schenna,73,,8,5,13
087 Schenna,74,,9,5,14
087 Schenna,75,,8,15,23
087 Schenna,76,,9,5,14
087 Schenna,77,,3,7,10
087 Schenna,78,,2,4,6
087 Schenna,79,,2,6,8
087 Schenna,80,,4,1,5
087 Schenna,81,,4,6,10
087 Schenna,82,,5,5,10
087 Schenna,83,,2,3,5
087 Schenna,84,,7,3,10
087 Schenna,86,,1,3,4
087 Schenna,87,,3,4,7
087 Schenna,88,,-,2,2
087 Schenna,89,,2,1,3
087 Schenna,90,,-,2,2
087 Schenna,94,,-,2,2
087 Schenna,96,,-,1,1
087 Schenna,Insgesamt,,1.347,1.287,2.634
088 Mühlwald,0,,11,11,22
088 Mühlwald,1,,14,5,19
088 Mühlwald,2,,10,5,15
088 Mühlwald,3,,13,11,24
088 Mühlwald,4,,5,6,11
088 Mühlwald,5,,10,7,17
088 Mühlwald,6,,9,7,16
088 Mühlwald,7,,16,8,24
088 Mühlwald,8,,7,3,10
088 Mühlwald,9,,9,14,23
088 Mühlwald,10,,6,7,13
088 Mühlwald,11,,12,18,30
088 Mühlwald,12,,11,19,30
088 Mühlwald,13,,12,11,23
088 Mühlwald,14,,8,17,25
088 Mühlwald,15,,16,15,31
088 Mühlwald,16,,21,6,27
088 Mühlwald,17,,8,19,27
088 Mühlwald,18,,12,13,25
088 Mühlwald,19,,8,8,16
088 Mühlwald,20,,15,13,28
088 Mühlwald,21,,11,10,21
088 Mühlwald,22,,10,8,18
088 Mühlwald,23,,16,10,26
088 Mühlwald,24,,11,14,25
088 Mühlwald,25,,22,16,38
088 Mühlwald,26,,10,11,21
088 Mühlwald,27,,16,17,33
088 Mühlwald,28,,18,12,30
088 Mühlwald,29,,17,14,31
088 Mühlwald,30,,16,8,24
088 Mühlwald,31,,18,12,30
088 Mühlwald,32,,16,9,25
088 Mühlwald,33,,12,11,23
088 Mühlwald,34,,9,13,22
088 Mühlwald,35,,6,8,14
088 Mühlwald,36,,16,8,24
088 Mühlwald,37,,14,5,19
088 Mühlwald,38,,11,7,18
088 Mühlwald,39,,14,11,25
088 Mühlwald,40,,7,8,15
088 Mühlwald,41,,8,8,16
088 Mühlwald,42,,10,4,14
088 Mühlwald,43,,13,9,22
088 Mühlwald,44,,10,8,18
088 Mühlwald,45,,10,4,14
088 Mühlwald,46,,5,10,15
088 Mühlwald,47,,9,4,13
088 Mühlwald,48,,12,4,16
088 Mühlwald,49,,10,7,17
088 Mühlwald,50,,9,3,12
088 Mühlwald,51,,6,4,10
088 Mühlwald,52,,8,4,12
088 Mühlwald,53,,13,3,16
088 Mühlwald,54,,6,7,13
088 Mühlwald,55,,4,8,12
088 Mühlwald,56,,3,8,11
088 Mühlwald,57,,6,11,17
088 Mühlwald,58,,10,4,14
088 Mühlwald,59,,12,3,15
088 Mühlwald,60,,6,4,10
088 Mühlwald,61,,5,4,9
088 Mühlwald,62,,3,11,14
088 Mühlwald,63,,4,11,15
088 Mühlwald,64,,1,2,3
088 Mühlwald,65,,8,6,14
088 Mühlwald,66,,5,6,11
088 Mühlwald,67,,11,11,22
088 Mühlwald,68,,4,4,8
088 Mühlwald,69,,10,4,14
088 Mühlwald,70,,6,6,12
088 Mühlwald,71,,5,4,9
088 Mühlwald,72,,7,6,13
088 Mühlwald,73,,1,6,7
088 Mühlwald,74,,-,6,6
088 Mühlwald,75,,-,6,6
088 Mühlwald,76,,2,3,5
088 Mühlwald,77,,3,2,5
088 Mühlwald,78,,1,4,5
088 Mühlwald,79,,5,2,7
088 Mühlwald,80,,-,1,1
088 Mühlwald,81,,-,3,3
088 Mühlwald,82,,1,3,4
088 Mühlwald,83,,1,4,5
088 Mühlwald,85,,1,2,3
088 Mühlwald,86,,-,1,1
088 Mühlwald,87,,-,1,1
088 Mühlwald,88,,1,-,1
088 Mühlwald,89,,1,-,1
088 Mühlwald,90,,-,2,2
088 Mühlwald,91,,-,1,1
088 Mühlwald,92,,-,1,1
088 Mühlwald,94,,1,-,1
088 Mühlwald,Insgesamt,,760,675,1.435
089 Wolkenstein in Gröden,0,,10,11,21
089 Wolkenstein in Gröden,1,,17,12,29
089 Wolkenstein in Gröden,2,,15,18,33
089 Wolkenstein in Gröden,3,,14,13,27
089 Wolkenstein in Gröden,4,,20,12,32
089 Wolkenstein in Gröden,5,,19,14,33
089 Wolkenstein in Gröden,6,,12,12,24
089 Wolkenstein in Gröden,7,,17,14,31
089 Wolkenstein in Gröden,8,,15,16,31
089 Wolkenstein in Gröden,9,,11,19,30
089 Wolkenstein in Gröden,10,,16,13,29
089 Wolkenstein in Gröden,11,,16,10,26
089 Wolkenstein in Gröden,12,,13,11,24
089 Wolkenstein in Gröden,13,,17,9,26
089 Wolkenstein in Gröden,14,,11,17,28
089 Wolkenstein in Gröden,15,,15,12,27
089 Wolkenstein in Gröden,16,,15,17,32
089 Wolkenstein in Gröden,17,,7,15,22
089 Wolkenstein in Gröden,18,,8,11,19
089 Wolkenstein in Gröden,19,,12,12,24
089 Wolkenstein in Gröden,20,,18,19,37
089 Wolkenstein in Gröden,21,,22,20,42
089 Wolkenstein in Gröden,22,,11,17,28
089 Wolkenstein in Gröden,23,,27,26,53
089 Wolkenstein in Gröden,24,,13,18,31
089 Wolkenstein in Gröden,25,,20,24,44
089 Wolkenstein in Gröden,26,,20,28,48
089 Wolkenstein in Gröden,27,,28,19,47
089 Wolkenstein in Gröden,28,,32,25,57
089 Wolkenstein in Gröden,29,,28,26,54
089 Wolkenstein in Gröden,30,,29,24,53
089 Wolkenstein in Gröden,31,,24,29,53
089 Wolkenstein in Gröden,32,,30,23,53
089 Wolkenstein in Gröden,33,,22,18,40
089 Wolkenstein in Gröden,34,,19,24,43
089 Wolkenstein in Gröden,35,,26,26,52
089 Wolkenstein in Gröden,36,,22,23,45
089 Wolkenstein in Gröden,37,,17,16,33
089 Wolkenstein in Gröden,38,,19,18,37
089 Wolkenstein in Gröden,39,,19,17,36
089 Wolkenstein in Gröden,40,,12,13,25
089 Wolkenstein in Gröden,41,,14,11,25
089 Wolkenstein in Gröden,42,,17,10,27
089 Wolkenstein in Gröden,43,,8,15,23
089 Wolkenstein in Gröden,44,,13,7,20
089 Wolkenstein in Gröden,45,,15,11,26
089 Wolkenstein in Gröden,46,,7,18,25
089 Wolkenstein in Gröden,47,,17,13,30
089 Wolkenstein in Gröden,48,,14,13,27
089 Wolkenstein in Gröden,49,,12,18,30
089 Wolkenstein in Gröden,50,,16,19,35
089 Wolkenstein in Gröden,51,,6,13,19
089 Wolkenstein in Gröden,52,,14,11,25
089 Wolkenstein in Gröden,53,,21,16,37
089 Wolkenstein in Gröden,54,,15,14,29
089 Wolkenstein in Gröden,55,,18,19,37
089 Wolkenstein in Gröden,56,,18,18,36
089 Wolkenstein in Gröden,57,,20,16,36
089 Wolkenstein in Gröden,58,,22,8,30
089 Wolkenstein in Gröden,59,,12,18,30
089 Wolkenstein in Gröden,60,,10,15,25
089 Wolkenstein in Gröden,61,,16,10,26
089 Wolkenstein in Gröden,62,,18,10,28
089 Wolkenstein in Gröden,63,,7,12,19
089 Wolkenstein in Gröden,64,,6,10,16
089 Wolkenstein in Gröden,65,,12,10,22
089 Wolkenstein in Gröden,66,,10,12,22
089 Wolkenstein in Gröden,67,,10,7,17
089 Wolkenstein in Gröden,68,,7,13,20
089 Wolkenstein in Gröden,69,,12,8,20
089 Wolkenstein in Gröden,70,,9,6,15
089 Wolkenstein in Gröden,71,,8,8,16
089 Wolkenstein in Gröden,72,,4,13,17
089 Wolkenstein in Gröden,73,,6,5,11
089 Wolkenstein in Gröden,74,,6,10,16
089 Wolkenstein in Gröden,75,,2,6,8
089 Wolkenstein in Gröden,76,,5,5,10
089 Wolkenstein in Gröden,77,,1,3,4
089 Wolkenstein in Gröden,78,,-,3,3
089 Wolkenstein in Gröden,79,,1,5,6
089 Wolkenstein in Gröden,80,,-,3,3
089 Wolkenstein in Gröden,81,,1,4,5
089 Wolkenstein in Gröden,82,,5,4,9
089 Wolkenstein in Gröden,83,,2,2,4
089 Wolkenstein in Gröden,84,,1,6,7
089 Wolkenstein in Gröden,85,,1,5,6
089 Wolkenstein in Gröden,86,,3,4,7
089 Wolkenstein in Gröden,87,,2,2,4
089 Wolkenstein in Gröden,88,,2,4,6
089 Wolkenstein in Gröden,89,,-,1,1
089 Wolkenstein in Gröden,91,,1,2,3
089 Wolkenstein in Gröden,92,,-,2,2
089 Wolkenstein in Gröden,93,,-,1,1
089 Wolkenstein in Gröden,94,,-,1,1
089 Wolkenstein in Gröden,Insgesamt,,1.185,1.201,2.386
091 Schnals,0,,5,12,17
091 Schnals,1,,6,9,15
091 Schnals,2,,4,9,13
091 Schnals,3,,12,4,16
091 Schnals,4,,13,12,25
091 Schnals,5,,14,9,23
091 Schnals,6,,5,8,13
091 Schnals,7,,21,9,30
091 Schnals,8,,10,5,15
091 Schnals,9,,12,11,23
091 Schnals,10,,10,10,20
091 Schnals,11,,7,11,18
091 Schnals,12,,12,16,28
091 Schnals,13,,10,10,20
091 Schnals,14,,12,8,20
091 Schnals,15,,16,10,26
091 Schnals,16,,14,12,26
091 Schnals,17,,12,10,22
091 Schnals,18,,12,9,21
091 Schnals,19,,8,10,18
091 Schnals,20,,12,5,17
091 Schnals,21,,8,11,19
091 Schnals,22,,15,10,25
091 Schnals,23,,8,11,19
091 Schnals,24,,8,10,18
091 Schnals,25,,14,13,27
091 Schnals,26,,11,10,21
091 Schnals,27,,15,11,26
091 Schnals,28,,10,13,23
091 Schnals,29,,17,15,32
091 Schnals,30,,16,15,31
091 Schnals,31,,18,9,27
091 Schnals,32,,8,9,17
091 Schnals,33,,11,15,26
091 Schnals,34,,17,10,27
091 Schnals,35,,12,14,26
091 Schnals,36,,11,8,19
091 Schnals,37,,16,12,28
091 Schnals,38,,14,12,26
091 Schnals,39,,12,5,17
091 Schnals,40,,14,7,21
091 Schnals,41,,11,6,17
091 Schnals,42,,10,9,19
091 Schnals,43,,12,8,20
091 Schnals,44,,15,8,23
091 Schnals,45,,12,8,20
091 Schnals,46,,12,6,18
091 Schnals,47,,11,10,21
091 Schnals,48,,3,2,5
091 Schnals,49,,11,8,19
091 Schnals,50,,5,7,12
091 Schnals,51,,9,4,13
091 Schnals,52,,5,7,12
091 Schnals,53,,7,10,17
091 Schnals,54,,4,5,9
091 Schnals,55,,5,5,10
091 Schnals,56,,8,7,15
091 Schnals,57,,7,7,14
091 Schnals,58,,3,11,14
091 Schnals,59,,7,5,12
091 Schnals,60,,6,7,13
091 Schnals,61,,5,5,10
091 Schnals,62,,3,4,7
091 Schnals,63,,7,5,12
091 Schnals,64,,3,10,13
091 Schnals,65,,4,5,9
091 Schnals,66,,2,5,7
091 Schnals,67,,9,6,15
091 Schnals,68,,2,7,9
091 Schnals,69,,6,7,13
091 Schnals,70,,9,4,13
091 Schnals,71,,6,10,16
091 Schnals,72,,4,7,11
091 Schnals,73,,1,1,2
091 Schnals,74,,8,4,12
091 Schnals,75,,1,6,7
091 Schnals,76,,3,7,10
091 Schnals,77,,2,1,3
091 Schnals,78,,3,3,6
091 Schnals,79,,-,4,4
091 Schnals,80,,1,3,4
091 Schnals,81,,4,3,7
091 Schnals,82,,2,2,4
091 Schnals,83,,-,2,2
091 Schnals,84,,3,3,6
091 Schnals,85,,-,2,2
091 Schnals,86,,-,2,2
091 Schnals,87,,-,2,2
091 Schnals,88,,-,1,1
091 Schnals,89,,-,1,1
091 Schnals,90,,1,-,1
091 Schnals,91,,-,2,2
091 Schnals,93,,1,1,2
091 Schnals,94,,1,-,1
091 Schnals,Insgesamt,,736,684,1.420
092 Sexten,0,,10,12,22
092 Sexten,1,,14,16,30
092 Sexten,2,,16,11,27
092 Sexten,3,,8,3,11
092 Sexten,4,,14,9,23
092 Sexten,5,,14,11,25
092 Sexten,6,,9,21,30
092 Sexten,7,,9,9,18
092 Sexten,8,,9,6,15
092 Sexten,9,,12,10,22
092 Sexten,10,,7,10,17
092 Sexten,11,,12,11,23
092 Sexten,12,,7,11,18
092 Sexten,13,,11,9,20
092 Sexten,14,,11,19,30
092 Sexten,15,,14,13,27
092 Sexten,16,,16,8,24
092 Sexten,17,,11,18,29
092 Sexten,18,,10,15,25
092 Sexten,19,,9,7,16
092 Sexten,20,,17,12,29
092 Sexten,21,,9,10,19
092 Sexten,22,,8,8,16
092 Sexten,23,,10,10,20
092 Sexten,24,,15,15,30
092 Sexten,25,,14,20,34
092 Sexten,26,,14,20,34
092 Sexten,27,,25,14,39
092 Sexten,28,,14,17,31
092 Sexten,29,,23,17,40
092 Sexten,30,,19,19,38
092 Sexten,31,,20,19,39
092 Sexten,32,,20,16,36
092 Sexten,33,,31,18,49
092 Sexten,34,,16,15,31
092 Sexten,35,,22,15,37
092 Sexten,36,,20,9,29
092 Sexten,37,,15,16,31
092 Sexten,38,,22,18,40
092 Sexten,39,,18,14,32
092 Sexten,40,,14,15,29
092 Sexten,41,,13,13,26
092 Sexten,42,,11,11,22
092 Sexten,43,,6,11,17
092 Sexten,44,,6,11,17
092 Sexten,45,,7,8,15
092 Sexten,46,,13,7,20
092 Sexten,47,,9,5,14
092 Sexten,48,,10,6,16
092 Sexten,49,,13,4,17
092 Sexten,50,,6,9,15
092 Sexten,51,,10,4,14
092 Sexten,52,,7,12,19
092 Sexten,53,,8,6,14
092 Sexten,54,,5,7,12
092 Sexten,55,,10,15,25
092 Sexten,56,,8,14,22
092 Sexten,57,,7,10,17
092 Sexten,58,,15,12,27
092 Sexten,59,,12,9,21
092 Sexten,60,,9,11,20
092 Sexten,61,,13,15,28
092 Sexten,62,,13,7,20
092 Sexten,63,,6,12,18
092 Sexten,64,,6,8,14
092 Sexten,65,,13,13,26
092 Sexten,66,,11,12,23
092 Sexten,67,,8,13,21
092 Sexten,68,,11,13,24
092 Sexten,69,,13,18,31
092 Sexten,70,,8,4,12
092 Sexten,71,,10,13,23
092 Sexten,72,,7,10,17
092 Sexten,73,,9,11,20
092 Sexten,74,,9,12,21
092 Sexten,75,,4,10,14
092 Sexten,76,,3,5,8
092 Sexten,77,,3,4,7
092 Sexten,78,,-,1,1
092 Sexten,79,,2,2,4
092 Sexten,80,,2,2,4
092 Sexten,81,,3,-,3
092 Sexten,82,,2,2,4
092 Sexten,83,,-,6,6
092 Sexten,84,,3,5,8
092 Sexten,85,,-,1,1
092 Sexten,86,,-,1,1
092 Sexten,87,,-,1,1
092 Sexten,88,,-,4,4
092 Sexten,89,,1,1,2
092 Sexten,90,,1,2,3
092 Sexten,91,,-,2,2
092 Sexten,92,,-,1,1
092 Sexten,93,,-,1,1
092 Sexten,98,,-,1,1
092 Sexten,Insgesamt,,935,944,1.879
093 Schlanders,0,,43,32,75
093 Schlanders,1,,36,26,62
093 Schlanders,2,,38,37,75
093 Schlanders,3,,40,45,85
093 Schlanders,4,,35,39,74
093 Schlanders,5,,39,35,74
093 Schlanders,6,,48,43,91
093 Schlanders,7,,37,36,73
093 Schlanders,8,,31,44,75
093 Schlanders,9,,37,33,70
093 Schlanders,10,,36,33,69
093 Schlanders,11,,40,37,77
093 Schlanders,12,,35,37,72
093 Schlanders,13,,32,35,67
093 Schlanders,14,,53,39,92
093 Schlanders,15,,47,36,83
093 Schlanders,16,,35,34,69
093 Schlanders,17,,36,38,74
093 Schlanders,18,,50,31,81
093 Schlanders,19,,34,36,70
093 Schlanders,20,,36,27,63
093 Schlanders,21,,43,39,82
093 Schlanders,22,,54,38,92
093 Schlanders,23,,52,42,94
093 Schlanders,24,,46,39,85
093 Schlanders,25,,52,43,95
093 Schlanders,26,,44,44,88
093 Schlanders,27,,59,39,98
093 Schlanders,28,,48,37,85
093 Schlanders,29,,58,47,105
093 Schlanders,30,,49,55,104
093 Schlanders,31,,50,48,98
093 Schlanders,32,,44,46,90
093 Schlanders,33,,57,60,117
093 Schlanders,34,,53,45,98
093 Schlanders,35,,46,52,98
093 Schlanders,36,,52,45,97
093 Schlanders,37,,45,38,83
093 Schlanders,38,,56,55,111
093 Schlanders,39,,43,38,81
093 Schlanders,40,,27,36,63
093 Schlanders,41,,35,39,74
093 Schlanders,42,,32,32,64
093 Schlanders,43,,36,36,72
093 Schlanders,44,,32,26,58
093 Schlanders,45,,31,32,63
093 Schlanders,46,,26,32,58
093 Schlanders,47,,30,36,66
093 Schlanders,48,,35,28,63
093 Schlanders,49,,24,25,49
093 Schlanders,50,,30,21,51
093 Schlanders,51,,32,18,50
093 Schlanders,52,,28,35,63
093 Schlanders,53,,30,32,62
093 Schlanders,54,,37,35,72
093 Schlanders,55,,37,37,74
093 Schlanders,56,,29,31,60
093 Schlanders,57,,30,34,64
093 Schlanders,58,,21,21,42
093 Schlanders,59,,26,26,52
093 Schlanders,60,,24,24,48
093 Schlanders,61,,19,28,47
093 Schlanders,62,,25,27,52
093 Schlanders,63,,24,33,57
093 Schlanders,64,,23,21,44
093 Schlanders,65,,26,21,47
093 Schlanders,66,,26,30,56
093 Schlanders,67,,14,21,35
093 Schlanders,68,,20,26,46
093 Schlanders,69,,19,27,46
093 Schlanders,70,,18,28,46
093 Schlanders,71,,14,21,35
093 Schlanders,72,,19,22,41
093 Schlanders,73,,11,20,31
093 Schlanders,74,,13,21,34
093 Schlanders,75,,9,11,20
093 Schlanders,76,,5,23,28
093 Schlanders,77,,9,17,26
093 Schlanders,78,,9,19,28
093 Schlanders,79,,11,3,14
093 Schlanders,80,,6,12,18
093 Schlanders,81,,6,5,11
093 Schlanders,82,,7,19,26
093 Schlanders,83,,7,13,20
093 Schlanders,84,,7,14,21
093 Schlanders,85,,5,16,21
093 Schlanders,86,,3,14,17
093 Schlanders,87,,2,7,9
093 Schlanders,88,,3,8,11
093 Schlanders,89,,2,2,4
093 Schlanders,90,,3,6,9
093 Schlanders,91,,1,2,3
093 Schlanders,92,,3,3,6
093 Schlanders,93,,-,5,5
093 Schlanders,94,,-,1,1
093 Schlanders,95,,-,1,1
093 Schlanders,96,,-,1,1
093 Schlanders,98,,-,1,1
093 Schlanders,Insgesamt,,2.770,2.788,5.558
094 Schluderns,0,,9,17,26
094 Schluderns,1,,8,14,22
094 Schluderns,2,,17,19,36
094 Schluderns,3,,18,7,25
094 Schluderns,4,,8,8,16
094 Schluderns,5,,9,9,18
094 Schluderns,6,,21,7,28
094 Schluderns,7,,15,12,27
094 Schluderns,8,,11,13,24
094 Schluderns,9,,6,11,17
094 Schluderns,10,,14,22,36
094 Schluderns,11,,18,11,29
094 Schluderns,12,,17,14,31
094 Schluderns,13,,13,8,21
094 Schluderns,14,,10,11,21
094 Schluderns,15,,20,14,34
094 Schluderns,16,,8,10,18
094 Schluderns,17,,7,19,26
094 Schluderns,18,,12,14,26
094 Schluderns,19,,12,16,28
094 Schluderns,20,,10,14,24
094 Schluderns,21,,13,6,19
094 Schluderns,22,,19,12,31
094 Schluderns,23,,24,15,39
094 Schluderns,24,,15,13,28
094 Schluderns,25,,13,18,31
094 Schluderns,26,,11,16,27
094 Schluderns,27,,20,10,30
094 Schluderns,28,,18,14,32
094 Schluderns,29,,17,12,29
094 Schluderns,30,,17,21,38
094 Schluderns,31,,25,9,34
094 Schluderns,32,,24,11,35
094 Schluderns,33,,16,22,38
094 Schluderns,34,,15,21,36
094 Schluderns,35,,18,19,37
094 Schluderns,36,,13,7,20
094 Schluderns,37,,12,23,35
094 Schluderns,38,,9,11,20
094 Schluderns,39,,15,6,21
094 Schluderns,40,,13,19,32
094 Schluderns,41,,19,11,30
094 Schluderns,42,,12,6,18
094 Schluderns,43,,10,6,16
094 Schluderns,44,,8,6,14
094 Schluderns,45,,11,3,14
094 Schluderns,46,,6,14,20
094 Schluderns,47,,13,9,22
094 Schluderns,48,,12,8,20
094 Schluderns,49,,6,4,10
094 Schluderns,50,,8,9,17
094 Schluderns,51,,6,4,10
094 Schluderns,52,,4,12,16
094 Schluderns,53,,3,8,11
094 Schluderns,54,,7,8,15
094 Schluderns,55,,11,14,25
094 Schluderns,56,,8,6,14
094 Schluderns,57,,13,8,21
094 Schluderns,58,,11,10,21
094 Schluderns,59,,8,8,16
094 Schluderns,60,,4,7,11
094 Schluderns,61,,6,10,16
094 Schluderns,62,,12,12,24
094 Schluderns,63,,4,10,14
094 Schluderns,64,,11,9,20
094 Schluderns,65,,4,7,11
094 Schluderns,66,,8,10,18
094 Schluderns,67,,11,7,18
094 Schluderns,68,,7,10,17
094 Schluderns,69,,9,1,10
094 Schluderns,70,,5,16,21
094 Schluderns,71,,3,5,8
094 Schluderns,72,,5,5,10
094 Schluderns,73,,2,5,7
094 Schluderns,74,,8,6,14
094 Schluderns,75,,3,9,12
094 Schluderns,76,,1,3,4
094 Schluderns,77,,3,7,10
094 Schluderns,78,,4,2,6
094 Schluderns,79,,3,3,6
094 Schluderns,80,,4,5,9
094 Schluderns,81,,1,3,4
094 Schluderns,82,,2,5,7
094 Schluderns,83,,2,2,4
094 Schluderns,84,,2,7,9
094 Schluderns,85,,1,4,5
094 Schluderns,86,,1,1,2
094 Schluderns,87,,2,2,4
094 Schluderns,88,,1,1,2
094 Schluderns,89,,-,2,2
094 Schluderns,90,,1,-,1
094 Schluderns,91,,-,3,3
094 Schluderns,95,,-,1,1
094 Schluderns,96,,-,1,1
094 Schluderns,Insgesamt,,896,890,1.786
095 Stilfs,0,,11,1,12
095 Stilfs,1,,6,7,13
095 Stilfs,2,,9,7,16
095 Stilfs,3,,5,16,21
095 Stilfs,4,,4,10,14
095 Stilfs,5,,13,5,18
095 Stilfs,6,,17,7,24
095 Stilfs,7,,9,6,15
095 Stilfs,8,,6,4,10
095 Stilfs,9,,6,6,12
095 Stilfs,10,,9,8,17
095 Stilfs,11,,13,5,18
095 Stilfs,12,,15,5,20
095 Stilfs,13,,8,7,15
095 Stilfs,14,,12,5,17
095 Stilfs,15,,11,3,14
095 Stilfs,16,,8,4,12
095 Stilfs,17,,6,9,15
095 Stilfs,18,,10,7,17
095 Stilfs,19,,10,13,23
095 Stilfs,20,,14,4,18
095 Stilfs,21,,10,10,20
095 Stilfs,22,,10,8,18
095 Stilfs,23,,4,21,25
095 Stilfs,24,,14,8,22
095 Stilfs,25,,12,13,25
095 Stilfs,26,,12,12,24
095 Stilfs,27,,10,15,25
095 Stilfs,28,,12,11,23
095 Stilfs,29,,11,9,20
095 Stilfs,30,,17,10,27
095 Stilfs,31,,11,13,24
095 Stilfs,32,,13,5,18
095 Stilfs,33,,9,5,14
095 Stilfs,34,,10,14,24
095 Stilfs,35,,11,3,14
095 Stilfs,36,,10,8,18
095 Stilfs,37,,10,8,18
095 Stilfs,38,,5,12,17
095 Stilfs,39,,11,6,17
095 Stilfs,40,,4,11,15
095 Stilfs,41,,6,4,10
095 Stilfs,42,,14,9,23
095 Stilfs,43,,11,4,15
095 Stilfs,44,,11,5,16
095 Stilfs,45,,14,10,24
095 Stilfs,46,,4,10,14
095 Stilfs,47,,7,3,10
095 Stilfs,48,,9,10,19
095 Stilfs,49,,5,5,10
095 Stilfs,50,,10,10,20
095 Stilfs,51,,2,4,6
095 Stilfs,52,,13,7,20
095 Stilfs,53,,9,8,17
095 Stilfs,54,,7,13,20
095 Stilfs,55,,9,4,13
095 Stilfs,56,,8,12,20
095 Stilfs,57,,6,12,18
095 Stilfs,58,,6,6,12
095 Stilfs,59,,8,7,15
095 Stilfs,60,,4,11,15
095 Stilfs,61,,5,9,14
095 Stilfs,62,,5,4,9
095 Stilfs,63,,6,6,12
095 Stilfs,64,,8,7,15
095 Stilfs,65,,5,4,9
095 Stilfs,66,,7,9,16
095 Stilfs,67,,6,1,7
095 Stilfs,68,,4,11,15
095 Stilfs,69,,6,10,16
095 Stilfs,70,,7,5,12
095 Stilfs,71,,8,3,11
095 Stilfs,72,,2,12,14
095 Stilfs,73,,5,5,10
095 Stilfs,74,,4,6,10
095 Stilfs,75,,2,6,8
095 Stilfs,76,,2,10,12
095 Stilfs,77,,4,1,5
095 Stilfs,78,,3,3,6
095 Stilfs,79,,-,3,3
095 Stilfs,80,,1,4,5
095 Stilfs,81,,1,3,4
095 Stilfs,82,,3,4,7
095 Stilfs,83,,-,1,1
095 Stilfs,84,,1,7,8
095 Stilfs,85,,1,5,6
095 Stilfs,86,,2,4,6
095 Stilfs,87,,2,4,6
095 Stilfs,88,,-,2,2
095 Stilfs,89,,1,2,3
095 Stilfs,90,,-,2,2
095 Stilfs,92,,1,-,1
095 Stilfs,97,,1,-,1
095 Stilfs,Insgesamt,,674,648,1.322
096 Terenten,0,,9,11,20
096 Terenten,1,,9,7,16
096 Terenten,2,,15,16,31
096 Terenten,3,,7,14,21
096 Terenten,4,,10,9,19
096 Terenten,5,,7,16,23
096 Terenten,6,,13,19,32
096 Terenten,7,,15,7,22
096 Terenten,8,,10,8,18
096 Terenten,9,,17,6,23
096 Terenten,10,,10,10,20
096 Terenten,11,,11,14,25
096 Terenten,12,,13,12,25
096 Terenten,13,,13,16,29
096 Terenten,14,,12,9,21
096 Terenten,15,,13,6,19
096 Terenten,16,,11,13,24
096 Terenten,17,,10,9,19
096 Terenten,18,,16,15,31
096 Terenten,19,,11,10,21
096 Terenten,20,,16,9,25
096 Terenten,21,,17,9,26
096 Terenten,22,,16,13,29
096 Terenten,23,,3,17,20
096 Terenten,24,,16,10,26
096 Terenten,25,,14,12,26
096 Terenten,26,,22,15,37
096 Terenten,27,,15,13,28
096 Terenten,28,,11,17,28
096 Terenten,29,,14,17,31
096 Terenten,30,,13,14,27
096 Terenten,31,,16,11,27
096 Terenten,32,,16,17,33
096 Terenten,33,,23,15,38
096 Terenten,34,,19,12,31
096 Terenten,35,,11,15,26
096 Terenten,36,,11,9,20
096 Terenten,37,,13,11,24
096 Terenten,38,,13,8,21
096 Terenten,39,,13,8,21
096 Terenten,40,,11,12,23
096 Terenten,41,,13,10,23
096 Terenten,42,,16,11,27
096 Terenten,43,,8,6,14
096 Terenten,44,,7,7,14
096 Terenten,45,,5,6,11
096 Terenten,46,,10,7,17
096 Terenten,47,,10,4,14
096 Terenten,48,,10,8,18
096 Terenten,49,,7,3,10
096 Terenten,50,,7,4,11
096 Terenten,51,,7,3,10
096 Terenten,52,,3,6,9
096 Terenten,53,,8,4,12
096 Terenten,54,,4,5,9
096 Terenten,55,,7,4,11
096 Terenten,56,,7,5,12
096 Terenten,57,,2,6,8
096 Terenten,58,,7,10,17
096 Terenten,59,,7,5,12
096 Terenten,60,,5,9,14
096 Terenten,61,,7,5,12
096 Terenten,62,,1,5,6
096 Terenten,63,,6,3,9
096 Terenten,64,,4,4,8
096 Terenten,65,,7,11,18
096 Terenten,66,,7,7,14
096 Terenten,67,,6,4,10
096 Terenten,68,,8,7,15
096 Terenten,69,,2,4,6
096 Terenten,70,,3,10,13
096 Terenten,71,,6,4,10
096 Terenten,72,,1,7,8
096 Terenten,73,,4,4,8
096 Terenten,74,,4,1,5
096 Terenten,75,,2,5,7
096 Terenten,76,,5,5,10
096 Terenten,77,,1,3,4
096 Terenten,78,,1,3,4
096 Terenten,79,,1,1,2
096 Terenten,80,,1,2,3
096 Terenten,81,,1,1,2
096 Terenten,82,,3,3,6
096 Terenten,83,,1,2,3
096 Terenten,84,,-,1,1
096 Terenten,85,,1,-,1
096 Terenten,86,,1,2,3
096 Terenten,87,,-,1,1
096 Terenten,88,,-,2,2
096 Terenten,89,,-,1,1
096 Terenten,90,,1,-,1
096 Terenten,91,,1,-,1
096 Terenten,96,,1,-,1
096 Terenten,Insgesamt,,772,722,1.494
097 Terlan,0,,15,19,34
097 Terlan,1,,27,21,48
097 Terlan,2,,18,18,36
097 Terlan,3,,21,20,41
097 Terlan,4,,28,28,56
097 Terlan,5,,23,19,42
097 Terlan,6,,11,20,31
097 Terlan,7,,23,26,49
097 Terlan,8,,21,16,37
097 Terlan,9,,23,12,35
097 Terlan,10,,16,22,38
097 Terlan,11,,25,17,42
097 Terlan,12,,12,10,22
097 Terlan,13,,24,17,41
097 Terlan,14,,21,17,38
097 Terlan,15,,15,15,30
097 Terlan,16,,25,23,48
097 Terlan,17,,16,26,42
097 Terlan,18,,15,15,30
097 Terlan,19,,25,19,44
097 Terlan,20,,28,23,51
097 Terlan,21,,21,13,34
097 Terlan,22,,26,26,52
097 Terlan,23,,19,24,43
097 Terlan,24,,38,18,56
097 Terlan,25,,23,23,46
097 Terlan,26,,25,37,62
097 Terlan,27,,33,27,60
097 Terlan,28,,33,30,63
097 Terlan,29,,27,29,56
097 Terlan,30,,34,22,56
097 Terlan,31,,28,27,55
097 Terlan,32,,28,29,57
097 Terlan,33,,27,31,58
097 Terlan,34,,28,35,63
097 Terlan,35,,40,21,61
097 Terlan,36,,26,29,55
097 Terlan,37,,19,21,40
097 Terlan,38,,30,26,56
097 Terlan,39,,16,27,43
097 Terlan,40,,25,29,54
097 Terlan,41,,21,24,45
097 Terlan,42,,24,19,43
097 Terlan,43,,17,22,39
097 Terlan,44,,21,22,43
097 Terlan,45,,18,19,37
097 Terlan,46,,22,22,44
097 Terlan,47,,21,15,36
097 Terlan,48,,22,24,46
097 Terlan,49,,15,19,34
097 Terlan,50,,16,25,41
097 Terlan,51,,21,21,42
097 Terlan,52,,23,26,49
097 Terlan,53,,19,29,48
097 Terlan,54,,36,19,55
097 Terlan,55,,18,26,44
097 Terlan,56,,22,15,37
097 Terlan,57,,17,20,37
097 Terlan,58,,22,18,40
097 Terlan,59,,17,17,34
097 Terlan,60,,10,14,24
097 Terlan,61,,16,23,39
097 Terlan,62,,7,24,31
097 Terlan,63,,16,16,32
097 Terlan,64,,17,11,28
097 Terlan,65,,22,15,37
097 Terlan,66,,15,16,31
097 Terlan,67,,14,16,30
097 Terlan,68,,16,13,29
097 Terlan,69,,14,13,27
097 Terlan,70,,13,25,38
097 Terlan,71,,12,14,26
097 Terlan,72,,10,15,25
097 Terlan,73,,8,23,31
097 Terlan,74,,10,13,23
097 Terlan,75,,10,15,25
097 Terlan,76,,2,11,13
097 Terlan,77,,-,11,11
097 Terlan,78,,6,3,9
097 Terlan,79,,1,4,5
097 Terlan,80,,-,6,6
097 Terlan,81,,3,6,9
097 Terlan,82,,-,12,12
097 Terlan,83,,6,10,16
097 Terlan,84,,3,7,10
097 Terlan,85,,3,12,15
097 Terlan,86,,2,5,7
097 Terlan,87,,5,3,8
097 Terlan,88,,1,2,3
097 Terlan,89,,-,5,5
097 Terlan,90,,1,1,2
097 Terlan,91,,1,1,2
097 Terlan,92,,1,2,3
097 Terlan,93,,1,1,2
097 Terlan,Insgesamt,,1.616,1.697,3.313
098 Tramin a.d. Weinstr.,0,,22,27,49
098 Tramin a.d. Weinstr.,1,,17,19,36
098 Tramin a.d. Weinstr.,2,,22,24,46
098 Tramin a.d. Weinstr.,3,,16,15,31
098 Tramin a.d. Weinstr.,4,,20,24,44
098 Tramin a.d. Weinstr.,5,,17,12,29
098 Tramin a.d. Weinstr.,6,,26,20,46
098 Tramin a.d. Weinstr.,7,,11,30,41
098 Tramin a.d. Weinstr.,8,,12,25,37
098 Tramin a.d. Weinstr.,9,,18,24,42
098 Tramin a.d. Weinstr.,10,,10,16,26
098 Tramin a.d. Weinstr.,11,,19,22,41
098 Tramin a.d. Weinstr.,12,,20,16,36
098 Tramin a.d. Weinstr.,13,,15,14,29
098 Tramin a.d. Weinstr.,14,,25,17,42
098 Tramin a.d. Weinstr.,15,,29,19,48
098 Tramin a.d. Weinstr.,16,,19,13,32
098 Tramin a.d. Weinstr.,17,,14,15,29
098 Tramin a.d. Weinstr.,18,,12,18,30
098 Tramin a.d. Weinstr.,19,,16,21,37
098 Tramin a.d. Weinstr.,20,,20,19,39
098 Tramin a.d. Weinstr.,21,,20,16,36
098 Tramin a.d. Weinstr.,22,,21,14,35
098 Tramin a.d. Weinstr.,23,,21,15,36
098 Tramin a.d. Weinstr.,24,,15,23,38
098 Tramin a.d. Weinstr.,25,,25,34,59
098 Tramin a.d. Weinstr.,26,,25,22,47
098 Tramin a.d. Weinstr.,27,,35,26,61
098 Tramin a.d. Weinstr.,28,,24,25,49
098 Tramin a.d. Weinstr.,29,,23,27,50
098 Tramin a.d. Weinstr.,30,,31,28,59
098 Tramin a.d. Weinstr.,31,,33,28,61
098 Tramin a.d. Weinstr.,32,,24,27,51
098 Tramin a.d. Weinstr.,33,,25,28,53
098 Tramin a.d. Weinstr.,34,,21,13,34
098 Tramin a.d. Weinstr.,35,,35,25,60
098 Tramin a.d. Weinstr.,36,,32,31,63
098 Tramin a.d. Weinstr.,37,,17,32,49
098 Tramin a.d. Weinstr.,38,,24,23,47
098 Tramin a.d. Weinstr.,39,,18,18,36
098 Tramin a.d. Weinstr.,40,,23,19,42
098 Tramin a.d. Weinstr.,41,,17,19,36
098 Tramin a.d. Weinstr.,42,,17,17,34
098 Tramin a.d. Weinstr.,43,,17,15,32
098 Tramin a.d. Weinstr.,44,,20,18,38
098 Tramin a.d. Weinstr.,45,,9,14,23
098 Tramin a.d. Weinstr.,46,,16,17,33
098 Tramin a.d. Weinstr.,47,,16,15,31
098 Tramin a.d. Weinstr.,48,,18,18,36
098 Tramin a.d. Weinstr.,49,,14,23,37
098 Tramin a.d. Weinstr.,50,,28,18,46
098 Tramin a.d. Weinstr.,51,,9,10,19
098 Tramin a.d. Weinstr.,52,,24,23,47
098 Tramin a.d. Weinstr.,53,,19,21,40
098 Tramin a.d. Weinstr.,54,,21,19,40
098 Tramin a.d. Weinstr.,55,,13,24,37
098 Tramin a.d. Weinstr.,56,,21,17,38
098 Tramin a.d. Weinstr.,57,,14,14,28
098 Tramin a.d. Weinstr.,58,,10,20,30
098 Tramin a.d. Weinstr.,59,,16,13,29
098 Tramin a.d. Weinstr.,60,,15,15,30
098 Tramin a.d. Weinstr.,61,,16,15,31
098 Tramin a.d. Weinstr.,62,,13,13,26
098 Tramin a.d. Weinstr.,63,,10,16,26
098 Tramin a.d. Weinstr.,64,,13,20,33
098 Tramin a.d. Weinstr.,65,,10,21,31
098 Tramin a.d. Weinstr.,66,,25,17,42
098 Tramin a.d. Weinstr.,67,,14,15,29
098 Tramin a.d. Weinstr.,68,,19,18,37
098 Tramin a.d. Weinstr.,69,,19,16,35
098 Tramin a.d. Weinstr.,70,,20,20,40
098 Tramin a.d. Weinstr.,71,,13,22,35
098 Tramin a.d. Weinstr.,72,,8,15,23
098 Tramin a.d. Weinstr.,73,,11,19,30
098 Tramin a.d. Weinstr.,74,,8,17,25
098 Tramin a.d. Weinstr.,75,,16,13,29
098 Tramin a.d. Weinstr.,76,,9,18,27
098 Tramin a.d. Weinstr.,77,,5,14,19
098 Tramin a.d. Weinstr.,78,,4,3,7
098 Tramin a.d. Weinstr.,79,,1,7,8
098 Tramin a.d. Weinstr.,80,,3,3,6
098 Tramin a.d. Weinstr.,81,,2,6,8
098 Tramin a.d. Weinstr.,82,,8,10,18
098 Tramin a.d. Weinstr.,83,,4,3,7
098 Tramin a.d. Weinstr.,84,,3,5,8
098 Tramin a.d. Weinstr.,85,,-,11,11
098 Tramin a.d. Weinstr.,86,,3,9,12
098 Tramin a.d. Weinstr.,87,,-,4,4
098 Tramin a.d. Weinstr.,88,,2,8,10
098 Tramin a.d. Weinstr.,89,,-,8,8
098 Tramin a.d. Weinstr.,90,,-,2,2
098 Tramin a.d. Weinstr.,91,,-,2,2
098 Tramin a.d. Weinstr.,92,,-,5,5
098 Tramin a.d. Weinstr.,95,,-,1,1
098 Tramin a.d. Weinstr.,96,,-,2,2
098 Tramin a.d. Weinstr.,Insgesamt,,1.465,1.612,3.077
099 Tisens,0,,9,8,17
099 Tisens,1,,10,5,15
099 Tisens,2,,10,12,22
099 Tisens,3,,5,8,13
099 Tisens,4,,5,16,21
099 Tisens,5,,16,6,22
099 Tisens,6,,10,13,23
099 Tisens,7,,13,9,22
099 Tisens,8,,7,11,18
099 Tisens,9,,12,7,19
099 Tisens,10,,14,7,21
099 Tisens,11,,8,6,14
099 Tisens,12,,13,13,26
099 Tisens,13,,18,5,23
099 Tisens,14,,10,14,24
099 Tisens,15,,4,18,22
099 Tisens,16,,15,12,27
099 Tisens,17,,9,7,16
099 Tisens,18,,13,11,24
099 Tisens,19,,12,7,19
099 Tisens,20,,9,4,13
099 Tisens,21,,15,13,28
099 Tisens,22,,9,9,18
099 Tisens,23,,10,9,19
099 Tisens,24,,7,10,17
099 Tisens,25,,15,14,29
099 Tisens,26,,16,14,30
099 Tisens,27,,15,16,31
099 Tisens,28,,17,18,35
099 Tisens,29,,17,21,38
099 Tisens,30,,19,13,32
099 Tisens,31,,17,24,41
099 Tisens,32,,16,5,21
099 Tisens,33,,16,16,32
099 Tisens,34,,23,4,27
099 Tisens,35,,16,13,29
099 Tisens,36,,17,7,24
099 Tisens,37,,12,9,21
099 Tisens,38,,8,12,20
099 Tisens,39,,18,20,38
099 Tisens,40,,9,12,21
099 Tisens,41,,17,9,26
099 Tisens,42,,8,8,16
099 Tisens,43,,12,9,21
099 Tisens,44,,7,12,19
099 Tisens,45,,10,10,20
099 Tisens,46,,10,6,16
099 Tisens,47,,5,7,12
099 Tisens,48,,13,8,21
099 Tisens,49,,7,8,15
099 Tisens,50,,9,7,16
099 Tisens,51,,4,7,11
099 Tisens,52,,10,10,20
099 Tisens,53,,11,10,21
099 Tisens,54,,10,8,18
099 Tisens,55,,8,14,22
099 Tisens,56,,6,8,14
099 Tisens,57,,13,10,23
099 Tisens,58,,7,12,19
099 Tisens,59,,5,5,10
099 Tisens,60,,7,8,15
099 Tisens,61,,5,11,16
099 Tisens,62,,9,7,16
099 Tisens,63,,2,12,14
099 Tisens,64,,9,10,19
099 Tisens,65,,9,9,18
099 Tisens,66,,5,14,19
099 Tisens,67,,10,12,22
099 Tisens,68,,14,13,27
099 Tisens,69,,15,10,25
099 Tisens,70,,6,9,15
099 Tisens,71,,5,6,11
099 Tisens,72,,3,7,10
099 Tisens,73,,4,12,16
099 Tisens,74,,7,6,13
099 Tisens,75,,7,7,14
099 Tisens,76,,5,8,13
099 Tisens,77,,3,9,12
099 Tisens,78,,4,6,10
099 Tisens,79,,3,5,8
099 Tisens,80,,1,5,6
099 Tisens,81,,2,4,6
099 Tisens,82,,2,8,10
099 Tisens,83,,4,4,8
099 Tisens,84,,3,5,8
099 Tisens,85,,3,4,7
099 Tisens,86,,1,5,6
099 Tisens,87,,2,-,2
099 Tisens,88,,-,4,4
099 Tisens,89,,1,3,4
099 Tisens,90,,1,-,1
099 Tisens,91,,-,3,3
099 Tisens,92,,1,1,2
099 Tisens,93,,-,1,1
099 Tisens,94,,1,-,1
099 Tisens,95,,-,1,1
099 Tisens,96,,1,-,1
099 Tisens,Insgesamt,,841,855,1.696
100 Tiers,0,,6,4,10
100 Tiers,1,,7,10,17
100 Tiers,2,,6,6,12
100 Tiers,3,,5,-,5
100 Tiers,4,,6,4,10
100 Tiers,5,,4,4,8
100 Tiers,6,,6,5,11
100 Tiers,7,,4,6,10
100 Tiers,8,,7,8,15
100 Tiers,9,,5,4,9
100 Tiers,10,,9,4,13
100 Tiers,11,,5,6,11
100 Tiers,12,,3,8,11
100 Tiers,13,,7,6,13
100 Tiers,14,,6,6,12
100 Tiers,15,,5,4,9
100 Tiers,16,,2,4,6
100 Tiers,17,,1,9,10
100 Tiers,18,,8,7,15
100 Tiers,19,,6,3,9
100 Tiers,20,,-,3,3
100 Tiers,21,,7,2,9
100 Tiers,22,,4,4,8
100 Tiers,23,,7,7,14
100 Tiers,24,,9,9,18
100 Tiers,25,,5,7,12
100 Tiers,26,,8,9,17
100 Tiers,27,,12,9,21
100 Tiers,28,,4,4,8
100 Tiers,29,,9,11,20
100 Tiers,30,,11,7,18
100 Tiers,31,,5,8,13
100 Tiers,32,,7,2,9
100 Tiers,33,,7,12,19
100 Tiers,34,,4,9,13
100 Tiers,35,,7,4,11
100 Tiers,36,,3,6,9
100 Tiers,37,,9,4,13
100 Tiers,38,,8,4,12
100 Tiers,39,,4,7,11
100 Tiers,40,,11,6,17
100 Tiers,41,,5,4,9
100 Tiers,42,,8,5,13
100 Tiers,43,,6,4,10
100 Tiers,44,,3,4,7
100 Tiers,45,,1,3,4
100 Tiers,46,,6,5,11
100 Tiers,47,,2,4,6
100 Tiers,48,,4,5,9
100 Tiers,49,,-,2,2
100 Tiers,50,,5,4,9
100 Tiers,51,,10,3,13
100 Tiers,52,,-,5,5
100 Tiers,53,,8,9,17
100 Tiers,54,,2,5,7
100 Tiers,55,,5,7,12
100 Tiers,56,,2,4,6
100 Tiers,57,,5,7,12
100 Tiers,58,,6,5,11
100 Tiers,59,,7,5,12
100 Tiers,60,,4,7,11
100 Tiers,61,,7,2,9
100 Tiers,62,,2,5,7
100 Tiers,63,,7,3,10
100 Tiers,64,,4,5,9
100 Tiers,65,,8,3,11
100 Tiers,66,,5,1,6
100 Tiers,67,,3,3,6
100 Tiers,68,,4,3,7
100 Tiers,69,,4,4,8
100 Tiers,70,,4,2,6
100 Tiers,71,,5,6,11
100 Tiers,72,,3,7,10
100 Tiers,73,,3,3,6
100 Tiers,74,,3,2,5
100 Tiers,75,,1,10,11
100 Tiers,76,,2,4,6
100 Tiers,77,,3,2,5
100 Tiers,78,,1,2,3
100 Tiers,79,,3,2,5
100 Tiers,81,,1,2,3
100 Tiers,82,,2,1,3
100 Tiers,83,,2,2,4
100 Tiers,84,,2,3,5
100 Tiers,85,,1,3,4
100 Tiers,86,,4,3,7
100 Tiers,87,,2,1,3
100 Tiers,88,,1,1,2
100 Tiers,89,,-,1,1
100 Tiers,90,,1,-,1
100 Tiers,92,,1,-,1
100 Tiers,93,,1,-,1
100 Tiers,94,,-,1,1
100 Tiers,Insgesamt,,428,426,854
101 Tirol,0,,22,17,39
101 Tirol,1,,10,17,27
101 Tirol,2,,14,17,31
101 Tirol,3,,23,8,31
101 Tirol,4,,10,13,23
101 Tirol,5,,8,9,17
101 Tirol,6,,14,11,25
101 Tirol,7,,10,19,29
101 Tirol,8,,10,17,27
101 Tirol,9,,16,8,24
101 Tirol,10,,10,12,22
101 Tirol,11,,11,16,27
101 Tirol,12,,15,11,26
101 Tirol,13,,18,16,34
101 Tirol,14,,13,13,26
101 Tirol,15,,18,23,41
101 Tirol,16,,19,9,28
101 Tirol,17,,20,7,27
101 Tirol,18,,11,13,24
101 Tirol,19,,15,17,32
101 Tirol,20,,14,11,25
101 Tirol,21,,18,25,43
101 Tirol,22,,15,21,36
101 Tirol,23,,21,18,39
101 Tirol,24,,22,18,40
101 Tirol,25,,22,12,34
101 Tirol,26,,18,12,30
101 Tirol,27,,20,24,44
101 Tirol,28,,24,21,45
101 Tirol,29,,23,26,49
101 Tirol,30,,21,20,41
101 Tirol,31,,22,22,44
101 Tirol,32,,28,20,48
101 Tirol,33,,23,13,36
101 Tirol,34,,22,17,39
101 Tirol,35,,18,26,44
101 Tirol,36,,25,13,38
101 Tirol,37,,16,11,27
101 Tirol,38,,16,18,34
101 Tirol,39,,23,16,39
101 Tirol,40,,10,16,26
101 Tirol,41,,13,14,27
101 Tirol,42,,14,15,29
101 Tirol,43,,19,19,38
101 Tirol,44,,14,10,24
101 Tirol,45,,14,18,32
101 Tirol,46,,16,13,29
101 Tirol,47,,21,17,38
101 Tirol,48,,20,15,35
101 Tirol,49,,9,16,25
101 Tirol,50,,13,9,22
101 Tirol,51,,13,14,27
101 Tirol,52,,19,18,37
101 Tirol,53,,13,12,25
101 Tirol,54,,12,23,35
101 Tirol,55,,15,19,34
101 Tirol,56,,11,15,26
101 Tirol,57,,16,15,31
101 Tirol,58,,9,9,18
101 Tirol,59,,11,15,26
101 Tirol,60,,8,12,20
101 Tirol,61,,13,12,25
101 Tirol,62,,15,6,21
101 Tirol,63,,8,13,21
101 Tirol,64,,7,10,17
101 Tirol,65,,8,8,16
101 Tirol,66,,7,9,16
101 Tirol,67,,13,15,28
101 Tirol,68,,10,9,19
101 Tirol,69,,11,8,19
101 Tirol,70,,7,14,21
101 Tirol,71,,7,10,17
101 Tirol,72,,9,12,21
101 Tirol,73,,5,6,11
101 Tirol,74,,4,7,11
101 Tirol,75,,8,11,19
101 Tirol,76,,6,9,15
101 Tirol,77,,3,6,9
101 Tirol,78,,3,6,9
101 Tirol,79,,2,1,3
101 Tirol,80,,2,6,8
101 Tirol,81,,3,6,9
101 Tirol,82,,4,8,12
101 Tirol,83,,4,7,11
101 Tirol,84,,1,5,6
101 Tirol,85,,3,7,10
101 Tirol,86,,2,4,6
101 Tirol,87,,3,8,11
101 Tirol,88,,1,3,4
101 Tirol,89,,1,2,3
101 Tirol,90,,2,1,3
101 Tirol,91,,-,1,1
101 Tirol,92,,1,1,2
101 Tirol,Insgesamt,,1.161,1.182,2.343
102 Truden im Naturpark,0,,6,6,12
102 Truden im Naturpark,1,,4,5,9
102 Truden im Naturpark,2,,5,6,11
102 Truden im Naturpark,3,,8,3,11
102 Truden im Naturpark,4,,8,5,13
102 Truden im Naturpark,5,,6,7,13
102 Truden im Naturpark,6,,5,5,10
102 Truden im Naturpark,7,,10,7,17
102 Truden im Naturpark,8,,9,8,17
102 Truden im Naturpark,9,,6,4,10
102 Truden im Naturpark,10,,1,5,6
102 Truden im Naturpark,11,,8,6,14
102 Truden im Naturpark,12,,11,4,15
102 Truden im Naturpark,13,,6,5,11
102 Truden im Naturpark,14,,12,3,15
102 Truden im Naturpark,15,,4,8,12
102 Truden im Naturpark,16,,4,4,8
102 Truden im Naturpark,17,,7,5,12
102 Truden im Naturpark,18,,7,6,13
102 Truden im Naturpark,19,,4,5,9
102 Truden im Naturpark,20,,12,9,21
102 Truden im Naturpark,21,,8,5,13
102 Truden im Naturpark,22,,4,6,10
102 Truden im Naturpark,23,,7,9,16
102 Truden im Naturpark,24,,5,8,13
102 Truden im Naturpark,25,,3,6,9
102 Truden im Naturpark,26,,2,6,8
102 Truden im Naturpark,27,,8,10,18
102 Truden im Naturpark,28,,9,11,20
102 Truden im Naturpark,29,,11,8,19
102 Truden im Naturpark,30,,6,6,12
102 Truden im Naturpark,31,,6,5,11
102 Truden im Naturpark,32,,9,8,17
102 Truden im Naturpark,33,,9,6,15
102 Truden im Naturpark,34,,7,7,14
102 Truden im Naturpark,35,,7,8,15
102 Truden im Naturpark,36,,10,12,22
102 Truden im Naturpark,37,,7,10,17
102 Truden im Naturpark,38,,5,8,13
102 Truden im Naturpark,39,,6,10,16
102 Truden im Naturpark,40,,7,5,12
102 Truden im Naturpark,41,,7,11,18
102 Truden im Naturpark,42,,6,5,11
102 Truden im Naturpark,43,,9,5,14
102 Truden im Naturpark,44,,7,7,14
102 Truden im Naturpark,45,,9,6,15
102 Truden im Naturpark,46,,2,2,4
102 Truden im Naturpark,47,,5,3,8
102 Truden im Naturpark,48,,2,7,9
102 Truden im Naturpark,49,,6,1,7
102 Truden im Naturpark,50,,8,6,14
102 Truden im Naturpark,51,,4,2,6
102 Truden im Naturpark,52,,4,5,9
102 Truden im Naturpark,53,,5,4,9
102 Truden im Naturpark,54,,6,3,9
102 Truden im Naturpark,55,,5,6,11
102 Truden im Naturpark,56,,3,4,7
102 Truden im Naturpark,57,,8,3,11
102 Truden im Naturpark,58,,7,8,15
102 Truden im Naturpark,59,,3,4,7
102 Truden im Naturpark,60,,5,4,9
102 Truden im Naturpark,61,,5,3,8
102 Truden im Naturpark,62,,5,1,6
102 Truden im Naturpark,63,,7,7,14
102 Truden im Naturpark,64,,4,4,8
102 Truden im Naturpark,65,,7,4,11
102 Truden im Naturpark,66,,6,10,16
102 Truden im Naturpark,67,,-,8,8
102 Truden im Naturpark,68,,3,6,9
102 Truden im Naturpark,69,,7,6,13
102 Truden im Naturpark,70,,3,8,11
102 Truden im Naturpark,71,,2,8,10
102 Truden im Naturpark,72,,-,9,9
102 Truden im Naturpark,73,,4,8,12
102 Truden im Naturpark,74,,6,4,10
102 Truden im Naturpark,75,,4,7,11
102 Truden im Naturpark,76,,-,10,10
102 Truden im Naturpark,77,,1,3,4
102 Truden im Naturpark,78,,1,3,4
102 Truden im Naturpark,79,,1,1,2
102 Truden im Naturpark,81,,2,1,3
102 Truden im Naturpark,82,,-,5,5
102 Truden im Naturpark,83,,-,1,1
102 Truden im Naturpark,84,,1,1,2
102 Truden im Naturpark,85,,-,3,3
102 Truden im Naturpark,86,,1,2,3
102 Truden im Naturpark,87,,-,2,2
102 Truden im Naturpark,90,,1,3,4
102 Truden im Naturpark,94,,-,1,1
102 Truden im Naturpark,98,,-,1,1
102 Truden im Naturpark,Insgesamt,,461,496,957
103 Taufers im Münstertal,0,,7,4,11
103 Taufers im Münstertal,1,,9,10,19
103 Taufers im Münstertal,2,,5,10,15
103 Taufers im Münstertal,3,,4,5,9
103 Taufers im Münstertal,4,,9,9,18
103 Taufers im Münstertal,5,,7,12,19
103 Taufers im Münstertal,6,,7,7,14
103 Taufers im Münstertal,7,,6,3,9
103 Taufers im Münstertal,8,,6,7,13
103 Taufers im Münstertal,9,,4,6,10
103 Taufers im Münstertal,10,,4,4,8
103 Taufers im Münstertal,11,,4,3,7
103 Taufers im Münstertal,12,,5,7,12
103 Taufers im Münstertal,13,,5,6,11
103 Taufers im Münstertal,14,,5,11,16
103 Taufers im Münstertal,15,,9,2,11
103 Taufers im Münstertal,16,,8,5,13
103 Taufers im Münstertal,17,,6,2,8
103 Taufers im Münstertal,18,,8,5,13
103 Taufers im Münstertal,19,,5,6,11
103 Taufers im Münstertal,20,,2,4,6
103 Taufers im Münstertal,21,,10,1,11
103 Taufers im Münstertal,22,,7,7,14
103 Taufers im Münstertal,23,,4,7,11
103 Taufers im Münstertal,24,,7,7,14
103 Taufers im Münstertal,25,,10,14,24
103 Taufers im Münstertal,26,,9,6,15
103 Taufers im Münstertal,27,,10,11,21
103 Taufers im Münstertal,28,,9,8,17
103 Taufers im Münstertal,29,,6,6,12
103 Taufers im Münstertal,30,,10,10,20
103 Taufers im Münstertal,31,,18,9,27
103 Taufers im Münstertal,32,,8,13,21
103 Taufers im Münstertal,33,,13,10,23
103 Taufers im Münstertal,34,,11,9,20
103 Taufers im Münstertal,35,,9,7,16
103 Taufers im Münstertal,36,,14,7,21
103 Taufers im Münstertal,37,,6,9,15
103 Taufers im Münstertal,38,,5,6,11
103 Taufers im Münstertal,39,,10,6,16
103 Taufers im Münstertal,40,,11,10,21
103 Taufers im Münstertal,41,,3,3,6
103 Taufers im Münstertal,42,,3,7,10
103 Taufers im Münstertal,43,,6,3,9
103 Taufers im Münstertal,44,,6,2,8
103 Taufers im Münstertal,45,,5,4,9
103 Taufers im Münstertal,46,,7,1,8
103 Taufers im Münstertal,47,,6,1,7
103 Taufers im Münstertal,48,,6,1,7
103 Taufers im Münstertal,49,,3,7,10
103 Taufers im Münstertal,50,,4,3,7
103 Taufers im Münstertal,51,,3,3,6
103 Taufers im Münstertal,52,,1,1,2
103 Taufers im Münstertal,53,,7,5,12
103 Taufers im Münstertal,54,,5,5,10
103 Taufers im Münstertal,55,,4,6,10
103 Taufers im Münstertal,56,,4,3,7
103 Taufers im Münstertal,57,,4,4,8
103 Taufers im Münstertal,58,,8,10,18
103 Taufers im Münstertal,59,,4,5,9
103 Taufers im Münstertal,60,,3,8,11
103 Taufers im Münstertal,61,,7,2,9
103 Taufers im Münstertal,62,,3,8,11
103 Taufers im Münstertal,63,,6,5,11
103 Taufers im Münstertal,64,,6,3,9
103 Taufers im Münstertal,65,,9,4,13
103 Taufers im Münstertal,66,,5,4,9
103 Taufers im Münstertal,67,,4,6,10
103 Taufers im Münstertal,68,,5,5,10
103 Taufers im Münstertal,69,,3,3,6
103 Taufers im Münstertal,70,,4,6,10
103 Taufers im Münstertal,71,,1,7,8
103 Taufers im Münstertal,72,,2,7,9
103 Taufers im Münstertal,73,,4,7,11
103 Taufers im Münstertal,74,,3,3,6
103 Taufers im Münstertal,75,,5,-,5
103 Taufers im Münstertal,76,,4,3,7
103 Taufers im Münstertal,77,,2,4,6
103 Taufers im Münstertal,78,,-,1,1
103 Taufers im Münstertal,79,,2,5,7
103 Taufers im Münstertal,80,,1,1,2
103 Taufers im Münstertal,81,,2,2,4
103 Taufers im Münstertal,82,,1,1,2
103 Taufers im Münstertal,83,,-,3,3
103 Taufers im Münstertal,84,,-,2,2
103 Taufers im Münstertal,85,,1,-,1
103 Taufers im Münstertal,86,,1,1,2
103 Taufers im Münstertal,87,,-,2,2
103 Taufers im Münstertal,88,,-,5,5
103 Taufers im Münstertal,89,,-,1,1
103 Taufers im Münstertal,92,,-,2,2
103 Taufers im Münstertal,95,,-,1,1
103 Taufers im Münstertal,Insgesamt,,485,477,962
104 Ulten,0,,9,12,21
104 Ulten,1,,13,18,31
104 Ulten,2,,20,17,37
104 Ulten,3,,25,15,40
104 Ulten,4,,17,17,34
104 Ulten,5,,26,30,56
104 Ulten,6,,17,18,35
104 Ulten,7,,18,30,48
104 Ulten,8,,18,18,36
104 Ulten,9,,19,19,38
104 Ulten,10,,22,13,35
104 Ulten,11,,14,17,31
104 Ulten,12,,22,20,42
104 Ulten,13,,22,21,43
104 Ulten,14,,15,27,42
104 Ulten,15,,19,18,37
104 Ulten,16,,22,21,43
104 Ulten,17,,18,20,38
104 Ulten,18,,21,17,38
104 Ulten,19,,24,13,37
104 Ulten,20,,17,24,41
104 Ulten,21,,25,26,51
104 Ulten,22,,20,28,48
104 Ulten,23,,29,23,52
104 Ulten,24,,26,29,55
104 Ulten,25,,28,23,51
104 Ulten,26,,27,33,60
104 Ulten,27,,31,18,49
104 Ulten,28,,30,25,55
104 Ulten,29,,16,24,40
104 Ulten,30,,20,17,37
104 Ulten,31,,27,22,49
104 Ulten,32,,28,24,52
104 Ulten,33,,28,25,53
104 Ulten,34,,33,24,57
104 Ulten,35,,32,19,51
104 Ulten,36,,30,20,50
104 Ulten,37,,23,22,45
104 Ulten,38,,28,17,45
104 Ulten,39,,35,24,59
104 Ulten,40,,18,14,32
104 Ulten,41,,14,12,26
104 Ulten,42,,20,18,38
104 Ulten,43,,25,15,40
104 Ulten,44,,18,14,32
104 Ulten,45,,18,18,36
104 Ulten,46,,21,14,35
104 Ulten,47,,18,11,29
104 Ulten,48,,15,13,28
104 Ulten,49,,18,8,26
104 Ulten,50,,18,15,33
104 Ulten,51,,10,12,22
104 Ulten,52,,14,22,36
104 Ulten,53,,18,15,33
104 Ulten,54,,12,19,31
104 Ulten,55,,17,13,30
104 Ulten,56,,18,11,29
104 Ulten,57,,22,16,38
104 Ulten,58,,8,11,19
104 Ulten,59,,10,11,21
104 Ulten,60,,9,11,20
104 Ulten,61,,12,13,25
104 Ulten,62,,14,13,27
104 Ulten,63,,6,13,19
104 Ulten,64,,14,8,22
104 Ulten,65,,13,10,23
104 Ulten,66,,16,18,34
104 Ulten,67,,8,15,23
104 Ulten,68,,11,17,28
104 Ulten,69,,15,19,34
104 Ulten,70,,10,16,26
104 Ulten,71,,17,17,34
104 Ulten,72,,13,12,25
104 Ulten,73,,15,26,41
104 Ulten,74,,12,13,25
104 Ulten,75,,12,16,28
104 Ulten,76,,11,16,27
104 Ulten,77,,5,14,19
104 Ulten,78,,3,6,9
104 Ulten,79,,1,4,5
104 Ulten,80,,1,5,6
104 Ulten,81,,4,1,5
104 Ulten,82,,5,10,15
104 Ulten,83,,6,9,15
104 Ulten,84,,6,9,15
104 Ulten,85,,3,9,12
104 Ulten,86,,5,8,13
104 Ulten,87,,3,6,9
104 Ulten,88,,3,4,7
104 Ulten,89,,2,1,3
104 Ulten,90,,3,2,5
104 Ulten,91,,2,2,4
104 Ulten,97,,-,1,1
104 Ulten,98,,-,1,1
104 Ulten,100,,1,-,1
104 Ulten,Insgesamt,,1.507,1.475,2.982
105 Pfatten,0,,8,5,13
105 Pfatten,1,,3,2,5
105 Pfatten,2,,10,10,20
105 Pfatten,3,,2,5,7
105 Pfatten,4,,6,5,11
105 Pfatten,5,,6,6,12
105 Pfatten,6,,8,8,16
105 Pfatten,7,,6,7,13
105 Pfatten,8,,3,6,9
105 Pfatten,9,,5,4,9
105 Pfatten,10,,6,7,13
105 Pfatten,11,,5,5,10
105 Pfatten,12,,3,4,7
105 Pfatten,13,,4,4,8
105 Pfatten,14,,5,2,7
105 Pfatten,15,,7,3,10
105 Pfatten,16,,1,5,6
105 Pfatten,17,,2,4,6
105 Pfatten,18,,5,4,9
105 Pfatten,19,,3,5,8
105 Pfatten,20,,7,2,9
105 Pfatten,21,,1,2,3
105 Pfatten,22,,8,6,14
105 Pfatten,23,,7,5,12
105 Pfatten,24,,4,7,11
105 Pfatten,25,,6,5,11
105 Pfatten,26,,7,10,17
105 Pfatten,27,,5,6,11
105 Pfatten,28,,5,9,14
105 Pfatten,29,,13,6,19
105 Pfatten,30,,10,6,16
105 Pfatten,31,,11,10,21
105 Pfatten,32,,8,8,16
105 Pfatten,33,,11,11,22
105 Pfatten,34,,11,13,24
105 Pfatten,35,,9,11,20
105 Pfatten,36,,9,10,19
105 Pfatten,37,,6,14,20
105 Pfatten,38,,8,9,17
105 Pfatten,39,,16,4,20
105 Pfatten,40,,7,7,14
105 Pfatten,41,,8,4,12
105 Pfatten,42,,9,3,12
105 Pfatten,43,,8,6,14
105 Pfatten,44,,4,6,10
105 Pfatten,45,,4,4,8
105 Pfatten,46,,5,7,12
105 Pfatten,47,,4,2,6
105 Pfatten,48,,5,2,7
105 Pfatten,49,,7,8,15
105 Pfatten,50,,6,6,12
105 Pfatten,51,,4,5,9
105 Pfatten,52,,4,2,6
105 Pfatten,53,,3,2,5
105 Pfatten,54,,5,3,8
105 Pfatten,55,,4,6,10
105 Pfatten,56,,5,5,10
105 Pfatten,57,,4,1,5
105 Pfatten,58,,6,4,10
105 Pfatten,59,,6,2,8
105 Pfatten,60,,3,6,9
105 Pfatten,61,,9,2,11
105 Pfatten,62,,5,6,11
105 Pfatten,63,,2,3,5
105 Pfatten,64,,1,3,4
105 Pfatten,65,,3,4,7
105 Pfatten,66,,3,3,6
105 Pfatten,67,,-,6,6
105 Pfatten,68,,3,1,4
105 Pfatten,69,,3,2,5
105 Pfatten,70,,3,5,8
105 Pfatten,71,,4,5,9
105 Pfatten,72,,2,4,6
105 Pfatten,73,,3,2,5
105 Pfatten,74,,3,1,4
105 Pfatten,75,,1,1,2
105 Pfatten,76,,2,1,3
105 Pfatten,77,,1,-,1
105 Pfatten,78,,-,1,1
105 Pfatten,79,,1,1,2
105 Pfatten,80,,-,2,2
105 Pfatten,81,,1,3,4
105 Pfatten,82,,1,1,2
105 Pfatten,83,,3,2,5
105 Pfatten,84,,-,2,2
105 Pfatten,87,,1,1,2
105 Pfatten,89,,-,2,2
105 Pfatten,94,,-,1,1
105 Pfatten,Insgesamt,,426,411,837
106 Olang,0,,26,20,46
106 Olang,1,,19,9,28
106 Olang,2,,21,12,33
106 Olang,3,,17,24,41
106 Olang,4,,13,16,29
106 Olang,5,,24,17,41
106 Olang,6,,22,24,46
106 Olang,7,,17,19,36
106 Olang,8,,15,17,32
106 Olang,9,,23,18,41
106 Olang,10,,17,17,34
106 Olang,11,,12,22,34
106 Olang,12,,21,14,35
106 Olang,13,,18,22,40
106 Olang,14,,21,23,44
106 Olang,15,,17,23,40
106 Olang,16,,22,28,50
106 Olang,17,,21,16,37
106 Olang,18,,22,16,38
106 Olang,19,,29,24,53
106 Olang,20,,19,21,40
106 Olang,21,,24,21,45
106 Olang,22,,17,24,41
106 Olang,23,,30,24,54
106 Olang,24,,22,24,46
106 Olang,25,,28,19,47
106 Olang,26,,24,25,49
106 Olang,27,,24,28,52
106 Olang,28,,26,26,52
106 Olang,29,,25,25,50
106 Olang,30,,27,22,49
106 Olang,31,,16,24,40
106 Olang,32,,18,34,52
106 Olang,33,,27,22,49
106 Olang,34,,24,14,38
106 Olang,35,,17,26,43
106 Olang,36,,22,25,47
106 Olang,37,,21,17,38
106 Olang,38,,22,13,35
106 Olang,39,,26,13,39
106 Olang,40,,14,28,42
106 Olang,41,,15,17,32
106 Olang,42,,14,19,33
106 Olang,43,,15,19,34
106 Olang,44,,19,13,32
106 Olang,45,,10,13,23
106 Olang,46,,31,17,48
106 Olang,47,,25,13,38
106 Olang,48,,19,21,40
106 Olang,49,,15,24,39
106 Olang,50,,17,13,30
106 Olang,51,,18,12,30
106 Olang,52,,18,6,24
106 Olang,53,,10,17,27
106 Olang,54,,15,15,30
106 Olang,55,,16,13,29
106 Olang,56,,18,11,29
106 Olang,57,,11,9,20
106 Olang,58,,8,14,22
106 Olang,59,,11,9,20
106 Olang,60,,10,8,18
106 Olang,61,,9,14,23
106 Olang,62,,12,11,23
106 Olang,63,,12,14,26
106 Olang,64,,10,15,25
106 Olang,65,,7,6,13
106 Olang,66,,16,9,25
106 Olang,67,,13,14,27
106 Olang,68,,7,13,20
106 Olang,69,,9,11,20
106 Olang,70,,8,13,21
106 Olang,71,,5,7,12
106 Olang,72,,5,8,13
106 Olang,73,,8,5,13
106 Olang,74,,7,6,13
106 Olang,75,,9,5,14
106 Olang,76,,6,7,13
106 Olang,77,,2,5,7
106 Olang,78,,1,4,5
106 Olang,79,,1,5,6
106 Olang,80,,1,1,2
106 Olang,81,,4,9,13
106 Olang,82,,2,9,11
106 Olang,83,,3,6,9
106 Olang,84,,2,7,9
106 Olang,85,,2,5,7
106 Olang,86,,1,4,5
106 Olang,87,,1,2,3
106 Olang,88,,1,1,2
106 Olang,89,,3,2,5
106 Olang,90,,1,1,2
106 Olang,91,,1,1,2
106 Olang,92,,-,1,1
106 Olang,93,,-,1,1
106 Olang,94,,1,1,2
106 Olang,95,,-,1,1
106 Olang,Insgesamt,,1.355,1.363,2.718
107 Pfitsch,0,,6,14,20
107 Pfitsch,1,,16,13,29
107 Pfitsch,2,,16,20,36
107 Pfitsch,3,,15,11,26
107 Pfitsch,4,,15,16,31
107 Pfitsch,5,,19,15,34
107 Pfitsch,6,,17,17,34
107 Pfitsch,7,,9,21,30
107 Pfitsch,8,,15,16,31
107 Pfitsch,9,,14,18,32
107 Pfitsch,10,,16,8,24
107 Pfitsch,11,,17,11,28
107 Pfitsch,12,,24,12,36
107 Pfitsch,13,,20,21,41
107 Pfitsch,14,,29,15,44
107 Pfitsch,15,,24,18,42
107 Pfitsch,16,,20,24,44
107 Pfitsch,17,,27,21,48
107 Pfitsch,18,,24,17,41
107 Pfitsch,19,,17,23,40
107 Pfitsch,20,,24,21,45
107 Pfitsch,21,,17,19,36
107 Pfitsch,22,,14,19,33
107 Pfitsch,23,,21,11,32
107 Pfitsch,24,,12,24,36
107 Pfitsch,25,,25,21,46
107 Pfitsch,26,,25,16,41
107 Pfitsch,27,,26,22,48
107 Pfitsch,28,,23,23,46
107 Pfitsch,29,,21,21,42
107 Pfitsch,30,,27,22,49
107 Pfitsch,31,,19,17,36
107 Pfitsch,32,,14,27,41
107 Pfitsch,33,,18,19,37
107 Pfitsch,34,,26,21,47
107 Pfitsch,35,,19,18,37
107 Pfitsch,36,,21,26,47
107 Pfitsch,37,,14,19,33
107 Pfitsch,38,,25,19,44
107 Pfitsch,39,,24,22,46
107 Pfitsch,40,,17,18,35
107 Pfitsch,41,,16,15,31
107 Pfitsch,42,,23,22,45
107 Pfitsch,43,,22,14,36
107 Pfitsch,44,,20,25,45
107 Pfitsch,45,,22,13,35
107 Pfitsch,46,,24,18,42
107 Pfitsch,47,,18,20,38
107 Pfitsch,48,,9,9,18
107 Pfitsch,49,,12,13,25
107 Pfitsch,50,,15,15,30
107 Pfitsch,51,,13,12,25
107 Pfitsch,52,,14,17,31
107 Pfitsch,53,,22,11,33
107 Pfitsch,54,,25,14,39
107 Pfitsch,55,,16,19,35
107 Pfitsch,56,,13,17,30
107 Pfitsch,57,,17,9,26
107 Pfitsch,58,,5,14,19
107 Pfitsch,59,,10,9,19
107 Pfitsch,60,,9,14,23
107 Pfitsch,61,,9,8,17
107 Pfitsch,62,,12,5,17
107 Pfitsch,63,,12,14,26
107 Pfitsch,64,,4,16,20
107 Pfitsch,65,,11,14,25
107 Pfitsch,66,,9,18,27
107 Pfitsch,67,,17,12,29
107 Pfitsch,68,,8,14,22
107 Pfitsch,69,,12,14,26
107 Pfitsch,70,,9,13,22
107 Pfitsch,71,,12,11,23
107 Pfitsch,72,,7,19,26
107 Pfitsch,73,,9,14,23
107 Pfitsch,74,,10,8,18
107 Pfitsch,75,,9,10,19
107 Pfitsch,76,,1,9,10
107 Pfitsch,77,,4,9,13
107 Pfitsch,78,,-,5,5
107 Pfitsch,79,,3,5,8
107 Pfitsch,80,,1,3,4
107 Pfitsch,81,,3,8,11
107 Pfitsch,82,,1,6,7
107 Pfitsch,83,,3,5,8
107 Pfitsch,84,,3,4,7
107 Pfitsch,85,,2,4,6
107 Pfitsch,86,,3,-,3
107 Pfitsch,87,,4,4,8
107 Pfitsch,88,,-,8,8
107 Pfitsch,89,,4,1,5
107 Pfitsch,91,,-,3,3
107 Pfitsch,92,,-,1,1
107 Pfitsch,93,,-,1,1
107 Pfitsch,95,,1,1,2
107 Pfitsch,101,,-,1,1
107 Pfitsch,Insgesamt,,1.300,1.324,2.624
108 Ahrntal,0,,39,46,85
108 Ahrntal,1,,36,28,64
108 Ahrntal,2,,23,30,53
108 Ahrntal,3,,43,39,82
108 Ahrntal,4,,43,33,76
108 Ahrntal,5,,30,35,65
108 Ahrntal,6,,41,32,73
108 Ahrntal,7,,39,33,72
108 Ahrntal,8,,28,33,61
108 Ahrntal,9,,36,39,75
108 Ahrntal,10,,39,50,89
108 Ahrntal,11,,36,45,81
108 Ahrntal,12,,41,34,75
108 Ahrntal,13,,44,48,92
108 Ahrntal,14,,39,45,84
108 Ahrntal,15,,49,40,89
108 Ahrntal,16,,41,39,80
108 Ahrntal,17,,45,39,84
108 Ahrntal,18,,34,45,79
108 Ahrntal,19,,46,48,94
108 Ahrntal,20,,43,52,95
108 Ahrntal,21,,48,51,99
108 Ahrntal,22,,44,51,95
108 Ahrntal,23,,46,57,103
108 Ahrntal,24,,59,60,119
108 Ahrntal,25,,76,42,118
108 Ahrntal,26,,56,50,106
108 Ahrntal,27,,51,53,104
108 Ahrntal,28,,59,56,115
108 Ahrntal,29,,46,49,95
108 Ahrntal,30,,63,44,107
108 Ahrntal,31,,56,44,100
108 Ahrntal,32,,56,44,100
108 Ahrntal,33,,48,46,94
108 Ahrntal,34,,39,44,83
108 Ahrntal,35,,36,39,75
108 Ahrntal,36,,40,33,73
108 Ahrntal,37,,45,39,84
108 Ahrntal,38,,48,26,74
108 Ahrntal,39,,28,41,69
108 Ahrntal,40,,37,21,58
108 Ahrntal,41,,38,25,63
108 Ahrntal,42,,33,23,56
108 Ahrntal,43,,29,31,60
108 Ahrntal,44,,29,31,60
108 Ahrntal,45,,35,26,61
108 Ahrntal,46,,31,23,54
108 Ahrntal,47,,34,31,65
108 Ahrntal,48,,30,30,60
108 Ahrntal,49,,26,15,41
108 Ahrntal,50,,17,22,39
108 Ahrntal,51,,20,14,34
108 Ahrntal,52,,21,18,39
108 Ahrntal,53,,23,32,55
108 Ahrntal,54,,31,31,62
108 Ahrntal,55,,31,32,63
108 Ahrntal,56,,31,24,55
108 Ahrntal,57,,27,25,52
108 Ahrntal,58,,37,31,68
108 Ahrntal,59,,26,23,49
108 Ahrntal,60,,22,16,38
108 Ahrntal,61,,26,36,62
108 Ahrntal,62,,22,20,42
108 Ahrntal,63,,20,19,39
108 Ahrntal,64,,22,27,49
108 Ahrntal,65,,36,25,61
108 Ahrntal,66,,22,24,46
108 Ahrntal,67,,21,19,40
108 Ahrntal,68,,16,27,43
108 Ahrntal,69,,19,19,38
108 Ahrntal,70,,25,14,39
108 Ahrntal,71,,15,19,34
108 Ahrntal,72,,16,18,34
108 Ahrntal,73,,11,15,26
108 Ahrntal,74,,14,19,33
108 Ahrntal,75,,7,11,18
108 Ahrntal,76,,7,10,17
108 Ahrntal,77,,12,6,18
108 Ahrntal,78,,2,10,12
108 Ahrntal,79,,3,7,10
108 Ahrntal,80,,-,3,3
108 Ahrntal,81,,4,11,15
108 Ahrntal,82,,11,10,21
108 Ahrntal,83,,5,6,11
108 Ahrntal,84,,5,11,16
108 Ahrntal,85,,4,12,16
108 Ahrntal,86,,6,6,12
108 Ahrntal,87,,5,7,12
108 Ahrntal,88,,-,7,7
108 Ahrntal,89,,-,5,5
108 Ahrntal,90,,2,5,7
108 Ahrntal,91,,1,3,4
108 Ahrntal,92,,1,1,2
108 Ahrntal,93,,-,2,2
108 Ahrntal,94,,-,1,1
108 Ahrntal,95,,-,1,1
108 Ahrntal,Insgesamt,,2.727,2.662,5.389
109 Gsies,0,,12,15,27
109 Gsies,1,,15,18,33
109 Gsies,2,,11,18,29
109 Gsies,3,,18,21,39
109 Gsies,4,,16,10,26
109 Gsies,5,,16,25,41
109 Gsies,6,,16,13,29
109 Gsies,7,,9,12,21
109 Gsies,8,,7,14,21
109 Gsies,9,,18,18,36
109 Gsies,10,,12,17,29
109 Gsies,11,,17,15,32
109 Gsies,12,,12,8,20
109 Gsies,13,,18,10,28
109 Gsies,14,,18,19,37
109 Gsies,15,,15,18,33
109 Gsies,16,,24,21,45
109 Gsies,17,,10,16,26
109 Gsies,18,,14,16,30
109 Gsies,19,,17,21,38
109 Gsies,20,,16,19,35
109 Gsies,21,,20,30,50
109 Gsies,22,,21,19,40
109 Gsies,23,,18,19,37
109 Gsies,24,,9,18,27
109 Gsies,25,,24,28,52
109 Gsies,26,,31,13,44
109 Gsies,27,,25,12,37
109 Gsies,28,,17,18,35
109 Gsies,29,,17,13,30
109 Gsies,30,,15,21,36
109 Gsies,31,,24,7,31
109 Gsies,32,,13,19,32
109 Gsies,33,,15,17,32
109 Gsies,34,,20,10,30
109 Gsies,35,,10,13,23
109 Gsies,36,,18,16,34
109 Gsies,37,,15,14,29
109 Gsies,38,,16,15,31
109 Gsies,39,,13,14,27
109 Gsies,40,,17,7,24
109 Gsies,41,,17,11,28
109 Gsies,42,,16,6,22
109 Gsies,43,,17,6,23
109 Gsies,44,,17,11,28
109 Gsies,45,,16,13,29
109 Gsies,46,,8,8,16
109 Gsies,47,,15,15,30
109 Gsies,48,,9,10,19
109 Gsies,49,,20,7,27
109 Gsies,50,,16,10,26
109 Gsies,51,,4,11,15
109 Gsies,52,,9,13,22
109 Gsies,53,,10,9,19
109 Gsies,54,,6,13,19
109 Gsies,55,,6,11,17
109 Gsies,56,,9,10,19
109 Gsies,57,,6,9,15
109 Gsies,58,,7,9,16
109 Gsies,59,,11,9,20
109 Gsies,60,,4,10,14
109 Gsies,61,,5,9,14
109 Gsies,62,,6,9,15
109 Gsies,63,,7,5,12
109 Gsies,64,,10,6,16
109 Gsies,65,,9,10,19
109 Gsies,66,,13,6,19
109 Gsies,67,,5,6,11
109 Gsies,68,,8,9,17
109 Gsies,69,,4,12,16
109 Gsies,70,,5,4,9
109 Gsies,71,,9,5,14
109 Gsies,72,,6,9,15
109 Gsies,73,,6,8,14
109 Gsies,74,,11,8,19
109 Gsies,75,,2,11,13
109 Gsies,76,,4,4,8
109 Gsies,77,,4,4,8
109 Gsies,78,,1,4,5
109 Gsies,79,,1,3,4
109 Gsies,80,,2,3,5
109 Gsies,81,,3,2,5
109 Gsies,82,,3,3,6
109 Gsies,83,,2,5,7
109 Gsies,84,,4,7,11
109 Gsies,85,,2,7,9
109 Gsies,86,,1,3,4
109 Gsies,87,,2,2,4
109 Gsies,88,,2,5,7
109 Gsies,89,,-,3,3
109 Gsies,90,,1,-,1
109 Gsies,91,,1,1,2
109 Gsies,92,,-,1,1
109 Gsies,96,,-,1,1
109 Gsies,Insgesamt,,1.031,1.043,2.074
110 Vintl,0,,19,19,38
110 Vintl,1,,36,26,62
110 Vintl,2,,19,19,38
110 Vintl,3,,24,19,43
110 Vintl,4,,31,20,51
110 Vintl,5,,23,29,52
110 Vintl,6,,28,22,50
110 Vintl,7,,26,17,43
110 Vintl,8,,21,19,40
110 Vintl,9,,21,23,44
110 Vintl,10,,21,17,38
110 Vintl,11,,10,15,25
110 Vintl,12,,27,10,37
110 Vintl,13,,25,17,42
110 Vintl,14,,20,21,41
110 Vintl,15,,20,25,45
110 Vintl,16,,33,19,52
110 Vintl,17,,32,17,49
110 Vintl,18,,21,32,53
110 Vintl,19,,19,26,45
110 Vintl,20,,21,28,49
110 Vintl,21,,26,23,49
110 Vintl,22,,31,31,62
110 Vintl,23,,20,23,43
110 Vintl,24,,34,22,56
110 Vintl,25,,31,35,66
110 Vintl,26,,24,21,45
110 Vintl,27,,29,29,58
110 Vintl,28,,21,24,45
110 Vintl,29,,32,39,71
110 Vintl,30,,33,33,66
110 Vintl,31,,35,34,69
110 Vintl,32,,36,28,64
110 Vintl,33,,31,27,58
110 Vintl,34,,32,27,59
110 Vintl,35,,28,30,58
110 Vintl,36,,20,22,42
110 Vintl,37,,27,22,49
110 Vintl,38,,19,12,31
110 Vintl,39,,23,28,51
110 Vintl,40,,27,21,48
110 Vintl,41,,20,16,36
110 Vintl,42,,18,21,39
110 Vintl,43,,23,9,32
110 Vintl,44,,18,18,36
110 Vintl,45,,21,16,37
110 Vintl,46,,25,18,43
110 Vintl,47,,20,18,38
110 Vintl,48,,13,13,26
110 Vintl,49,,21,15,36
110 Vintl,50,,17,13,30
110 Vintl,51,,18,18,36
110 Vintl,52,,12,5,17
110 Vintl,53,,21,12,33
110 Vintl,54,,11,13,24
110 Vintl,55,,6,16,22
110 Vintl,56,,8,19,27
110 Vintl,57,,18,16,34
110 Vintl,58,,14,6,20
110 Vintl,59,,11,9,20
110 Vintl,60,,13,10,23
110 Vintl,61,,9,12,21
110 Vintl,62,,16,9,25
110 Vintl,63,,8,18,26
110 Vintl,64,,11,15,26
110 Vintl,65,,14,12,26
110 Vintl,66,,9,15,24
110 Vintl,67,,11,20,31
110 Vintl,68,,17,10,27
110 Vintl,69,,13,16,29
110 Vintl,70,,20,9,29
110 Vintl,71,,9,11,20
110 Vintl,72,,10,12,22
110 Vintl,73,,15,13,28
110 Vintl,74,,8,8,16
110 Vintl,75,,11,9,20
110 Vintl,76,,3,10,13
110 Vintl,77,,6,7,13
110 Vintl,78,,1,3,4
110 Vintl,79,,4,4,8
110 Vintl,80,,2,3,5
110 Vintl,81,,4,6,10
110 Vintl,82,,2,7,9
110 Vintl,83,,-,10,10
110 Vintl,84,,1,3,4
110 Vintl,85,,-,9,9
110 Vintl,86,,2,3,5
110 Vintl,87,,2,1,3
110 Vintl,88,,2,3,5
110 Vintl,89,,2,2,4
110 Vintl,92,,-,1,1
110 Vintl,96,,-,1,1
110 Vintl,Insgesamt,,1.596,1.514,3.110
111 Vahrn,0,,31,17,48
111 Vahrn,1,,19,20,39
111 Vahrn,2,,20,25,45
111 Vahrn,3,,19,20,39
111 Vahrn,4,,23,21,44
111 Vahrn,5,,18,21,39
111 Vahrn,6,,15,26,41
111 Vahrn,7,,32,20,52
111 Vahrn,8,,24,20,44
111 Vahrn,9,,20,18,38
111 Vahrn,10,,20,16,36
111 Vahrn,11,,26,27,53
111 Vahrn,12,,19,23,42
111 Vahrn,13,,26,26,52
111 Vahrn,14,,25,26,51
111 Vahrn,15,,27,18,45
111 Vahrn,16,,18,26,44
111 Vahrn,17,,18,25,43
111 Vahrn,18,,21,19,40
111 Vahrn,19,,17,21,38
111 Vahrn,20,,35,19,54
111 Vahrn,21,,28,20,48
111 Vahrn,22,,24,34,58
111 Vahrn,23,,27,31,58
111 Vahrn,24,,21,28,49
111 Vahrn,25,,31,34,65
111 Vahrn,26,,37,28,65
111 Vahrn,27,,27,37,64
111 Vahrn,28,,27,33,60
111 Vahrn,29,,49,22,71
111 Vahrn,30,,31,29,60
111 Vahrn,31,,40,37,77
111 Vahrn,32,,41,36,77
111 Vahrn,33,,29,34,63
111 Vahrn,34,,32,38,70
111 Vahrn,35,,26,22,48
111 Vahrn,36,,35,29,64
111 Vahrn,37,,31,24,55
111 Vahrn,38,,21,24,45
111 Vahrn,39,,30,32,62
111 Vahrn,40,,23,18,41
111 Vahrn,41,,30,27,57
111 Vahrn,42,,23,31,54
111 Vahrn,43,,23,27,50
111 Vahrn,44,,20,18,38
111 Vahrn,45,,22,10,32
111 Vahrn,46,,17,17,34
111 Vahrn,47,,23,28,51
111 Vahrn,48,,20,15,35
111 Vahrn,49,,15,21,36
111 Vahrn,50,,19,23,42
111 Vahrn,51,,9,16,25
111 Vahrn,52,,20,20,40
111 Vahrn,53,,23,20,43
111 Vahrn,54,,19,21,40
111 Vahrn,55,,21,27,48
111 Vahrn,56,,21,15,36
111 Vahrn,57,,19,18,37
111 Vahrn,58,,17,11,28
111 Vahrn,59,,19,19,38
111 Vahrn,60,,13,18,31
111 Vahrn,61,,13,16,29
111 Vahrn,62,,13,18,31
111 Vahrn,63,,10,14,24
111 Vahrn,64,,15,13,28
111 Vahrn,65,,16,16,32
111 Vahrn,66,,14,17,31
111 Vahrn,67,,10,18,28
111 Vahrn,68,,9,13,22
111 Vahrn,69,,14,21,35
111 Vahrn,70,,11,7,18
111 Vahrn,71,,9,18,27
111 Vahrn,72,,10,19,29
111 Vahrn,73,,10,12,22
111 Vahrn,74,,6,15,21
111 Vahrn,75,,8,10,18
111 Vahrn,76,,4,6,10
111 Vahrn,77,,3,5,8
111 Vahrn,78,,6,5,11
111 Vahrn,79,,5,7,12
111 Vahrn,80,,2,2,4
111 Vahrn,81,,-,8,8
111 Vahrn,82,,4,6,10
111 Vahrn,83,,2,5,7
111 Vahrn,84,,1,9,10
111 Vahrn,85,,1,4,5
111 Vahrn,86,,1,3,4
111 Vahrn,87,,-,4,4
111 Vahrn,88,,-,2,2
111 Vahrn,89,,-,1,1
111 Vahrn,90,,-,2,2
111 Vahrn,91,,-,2,2
111 Vahrn,92,,-,2,2
111 Vahrn,93,,-,1,1
111 Vahrn,94,,1,-,1
111 Vahrn,95,,-,1,1
111 Vahrn,Insgesamt,,1.674,1.748,3.422
112 Vöran,0,,9,6,15
112 Vöran,1,,5,10,15
112 Vöran,2,,6,8,14
112 Vöran,3,,7,5,12
112 Vöran,4,,7,4,11
112 Vöran,5,,7,2,9
112 Vöran,6,,6,8,14
112 Vöran,7,,12,5,17
112 Vöran,8,,8,7,15
112 Vöran,9,,12,6,18
112 Vöran,10,,6,7,13
112 Vöran,11,,9,12,21
112 Vöran,12,,10,4,14
112 Vöran,13,,6,6,12
112 Vöran,14,,7,9,16
112 Vöran,15,,10,10,20
112 Vöran,16,,4,5,9
112 Vöran,17,,3,5,8
112 Vöran,18,,10,9,19
112 Vöran,19,,12,6,18
112 Vöran,20,,6,6,12
112 Vöran,21,,6,7,13
112 Vöran,22,,11,8,19
112 Vöran,23,,6,5,11
112 Vöran,24,,9,10,19
112 Vöran,25,,7,11,18
112 Vöran,26,,11,6,17
112 Vöran,27,,6,4,10
112 Vöran,28,,16,3,19
112 Vöran,29,,6,6,12
112 Vöran,30,,9,8,17
112 Vöran,31,,4,4,8
112 Vöran,32,,10,5,15
112 Vöran,33,,7,6,13
112 Vöran,34,,12,14,26
112 Vöran,35,,6,7,13
112 Vöran,36,,7,6,13
112 Vöran,37,,5,8,13
112 Vöran,38,,8,5,13
112 Vöran,39,,4,9,13
112 Vöran,40,,2,2,4
112 Vöran,41,,5,2,7
112 Vöran,42,,6,7,13
112 Vöran,43,,5,4,9
112 Vöran,44,,9,3,12
112 Vöran,45,,2,-,2
112 Vöran,46,,7,4,11
112 Vöran,47,,6,4,10
112 Vöran,48,,3,4,7
112 Vöran,49,,5,4,9
112 Vöran,50,,4,2,6
112 Vöran,51,,-,4,4
112 Vöran,52,,4,3,7
112 Vöran,53,,3,5,8
112 Vöran,54,,6,4,10
112 Vöran,55,,4,6,10
112 Vöran,56,,2,5,7
112 Vöran,57,,3,3,6
112 Vöran,58,,8,4,12
112 Vöran,59,,2,2,4
112 Vöran,60,,6,3,9
112 Vöran,61,,3,1,4
112 Vöran,62,,1,6,7
112 Vöran,63,,5,6,11
112 Vöran,64,,4,5,9
112 Vöran,65,,5,2,7
112 Vöran,66,,5,1,6
112 Vöran,67,,1,3,4
112 Vöran,68,,6,1,7
112 Vöran,69,,-,3,3
112 Vöran,70,,-,3,3
112 Vöran,71,,3,4,7
112 Vöran,72,,1,2,3
112 Vöran,73,,3,2,5
112 Vöran,74,,2,-,2
112 Vöran,75,,3,1,4
112 Vöran,76,,-,4,4
112 Vöran,77,,-,1,1
112 Vöran,78,,-,1,1
112 Vöran,80,,1,2,3
112 Vöran,82,,-,1,1
112 Vöran,83,,-,1,1
112 Vöran,84,,-,1,1
112 Vöran,86,,2,1,3
112 Vöran,87,,-,2,2
112 Vöran,88,,1,-,1
112 Vöran,89,,-,1,1
112 Vöran,92,,-,1,1
112 Vöran,Insgesamt,,450,403,853
113 Niederdorf,0,,2,7,9
113 Niederdorf,1,,5,10,15
113 Niederdorf,2,,12,8,20
113 Niederdorf,3,,9,6,15
113 Niederdorf,4,,6,8,14
113 Niederdorf,5,,7,10,17
113 Niederdorf,6,,14,10,24
113 Niederdorf,7,,8,7,15
113 Niederdorf,8,,6,7,13
113 Niederdorf,9,,2,11,13
113 Niederdorf,10,,4,6,10
113 Niederdorf,11,,7,5,12
113 Niederdorf,12,,11,5,16
113 Niederdorf,13,,7,8,15
113 Niederdorf,14,,3,11,14
113 Niederdorf,15,,10,7,17
113 Niederdorf,16,,9,4,13
113 Niederdorf,17,,8,4,12
113 Niederdorf,18,,5,3,8
113 Niederdorf,19,,6,4,10
113 Niederdorf,20,,11,7,18
113 Niederdorf,21,,5,9,14
113 Niederdorf,22,,10,8,18
113 Niederdorf,23,,12,6,18
113 Niederdorf,24,,13,5,18
113 Niederdorf,25,,14,10,24
113 Niederdorf,26,,12,12,24
113 Niederdorf,27,,21,14,35
113 Niederdorf,28,,14,11,25
113 Niederdorf,29,,15,18,33
113 Niederdorf,30,,23,9,32
113 Niederdorf,31,,10,15,25
113 Niederdorf,32,,20,16,36
113 Niederdorf,33,,10,9,19
113 Niederdorf,34,,17,8,25
113 Niederdorf,35,,15,12,27
113 Niederdorf,36,,11,10,21
113 Niederdorf,37,,12,7,19
113 Niederdorf,38,,6,5,11
113 Niederdorf,39,,12,10,22
113 Niederdorf,40,,10,9,19
113 Niederdorf,41,,10,8,18
113 Niederdorf,42,,9,6,15
113 Niederdorf,43,,5,3,8
113 Niederdorf,44,,8,5,13
113 Niederdorf,45,,2,3,5
113 Niederdorf,46,,7,4,11
113 Niederdorf,47,,11,4,15
113 Niederdorf,48,,6,8,14
113 Niederdorf,49,,8,8,16
113 Niederdorf,50,,6,7,13
113 Niederdorf,51,,2,6,8
113 Niederdorf,52,,11,5,16
113 Niederdorf,53,,5,10,15
113 Niederdorf,54,,6,11,17
113 Niederdorf,55,,5,6,11
113 Niederdorf,56,,4,9,13
113 Niederdorf,57,,1,4,5
113 Niederdorf,58,,6,8,14
113 Niederdorf,59,,6,7,13
113 Niederdorf,60,,6,9,15
113 Niederdorf,61,,7,7,14
113 Niederdorf,62,,3,12,15
113 Niederdorf,63,,6,8,14
113 Niederdorf,64,,8,7,15
113 Niederdorf,65,,9,7,16
113 Niederdorf,66,,7,10,17
113 Niederdorf,67,,5,8,13
113 Niederdorf,68,,4,6,10
113 Niederdorf,69,,8,9,17
113 Niederdorf,70,,3,6,9
113 Niederdorf,71,,1,7,8
113 Niederdorf,72,,6,11,17
113 Niederdorf,73,,3,3,6
113 Niederdorf,74,,6,9,15
113 Niederdorf,75,,5,4,9
113 Niederdorf,76,,2,5,7
113 Niederdorf,77,,2,5,7
113 Niederdorf,78,,1,4,5
113 Niederdorf,79,,2,3,5
113 Niederdorf,80,,2,3,5
113 Niederdorf,81,,-,4,4
113 Niederdorf,82,,3,1,4
113 Niederdorf,83,,1,1,2
113 Niederdorf,84,,-,4,4
113 Niederdorf,85,,3,3,6
113 Niederdorf,86,,1,4,5
113 Niederdorf,87,,1,4,5
113 Niederdorf,88,,-,3,3
113 Niederdorf,89,,-,1,1
113 Niederdorf,90,,1,1,2
113 Niederdorf,91,,-,2,2
113 Niederdorf,92,,1,1,2
113 Niederdorf,93,,-,3,3
113 Niederdorf,94,,-,1,1
113 Niederdorf,95,,-,1,1
113 Niederdorf,Insgesamt,,639,650,1.289
114 Villanders,0,,16,6,22
114 Villanders,1,,18,7,25
114 Villanders,2,,11,13,24
114 Villanders,3,,8,18,26
114 Villanders,4,,13,9,22
114 Villanders,5,,19,17,36
114 Villanders,6,,16,14,30
114 Villanders,7,,12,10,22
114 Villanders,8,,9,12,21
114 Villanders,9,,5,16,21
114 Villanders,10,,9,8,17
114 Villanders,11,,10,10,20
114 Villanders,12,,12,12,24
114 Villanders,13,,13,6,19
114 Villanders,14,,15,11,26
114 Villanders,15,,19,13,32
114 Villanders,16,,10,17,27
114 Villanders,17,,16,6,22
114 Villanders,18,,12,13,25
114 Villanders,19,,15,16,31
114 Villanders,20,,13,15,28
114 Villanders,21,,10,15,25
114 Villanders,22,,14,17,31
114 Villanders,23,,12,18,30
114 Villanders,24,,15,15,30
114 Villanders,25,,16,24,40
114 Villanders,26,,18,14,32
114 Villanders,27,,24,21,45
114 Villanders,28,,22,15,37
114 Villanders,29,,18,25,43
114 Villanders,30,,23,15,38
114 Villanders,31,,21,17,38
114 Villanders,32,,18,16,34
114 Villanders,33,,15,13,28
114 Villanders,34,,20,11,31
114 Villanders,35,,14,12,26
114 Villanders,36,,20,8,28
114 Villanders,37,,14,11,25
114 Villanders,38,,16,9,25
114 Villanders,39,,8,6,14
114 Villanders,40,,12,10,22
114 Villanders,41,,10,16,26
114 Villanders,42,,10,5,15
114 Villanders,43,,11,7,18
114 Villanders,44,,10,8,18
114 Villanders,45,,12,6,18
114 Villanders,46,,8,9,17
114 Villanders,47,,10,7,17
114 Villanders,48,,6,11,17
114 Villanders,49,,7,8,15
114 Villanders,50,,10,11,21
114 Villanders,51,,6,3,9
114 Villanders,52,,5,9,14
114 Villanders,53,,8,7,15
114 Villanders,54,,11,8,19
114 Villanders,55,,9,8,17
114 Villanders,56,,9,14,23
114 Villanders,57,,9,6,15
114 Villanders,58,,10,6,16
114 Villanders,59,,5,9,14
114 Villanders,60,,5,7,12
114 Villanders,61,,2,9,11
114 Villanders,62,,1,9,10
114 Villanders,63,,12,9,21
114 Villanders,64,,9,10,19
114 Villanders,65,,6,8,14
114 Villanders,66,,10,7,17
114 Villanders,67,,4,10,14
114 Villanders,68,,7,10,17
114 Villanders,69,,9,6,15
114 Villanders,70,,6,6,12
114 Villanders,71,,2,7,9
114 Villanders,72,,5,5,10
114 Villanders,73,,6,3,9
114 Villanders,74,,5,6,11
114 Villanders,75,,4,13,17
114 Villanders,76,,5,5,10
114 Villanders,77,,1,3,4
114 Villanders,78,,2,-,2
114 Villanders,79,,-,2,2
114 Villanders,80,,1,3,4
114 Villanders,81,,-,5,5
114 Villanders,82,,2,7,9
114 Villanders,83,,1,3,4
114 Villanders,84,,4,7,11
114 Villanders,85,,2,5,7
114 Villanders,86,,1,3,4
114 Villanders,87,,2,4,6
114 Villanders,88,,2,2,4
114 Villanders,89,,2,2,4
114 Villanders,90,,2,3,5
114 Villanders,91,,-,2,2
114 Villanders,92,,1,1,2
114 Villanders,93,,-,1,1
114 Villanders,94,,-,1,1
114 Villanders,95,,-,1,1
114 Villanders,Insgesamt,,888,884,1.772
115 Sterzing,0,,27,34,61
115 Sterzing,1,,28,29,57
115 Sterzing,2,,37,19,56
115 Sterzing,3,,31,28,59
115 Sterzing,4,,29,33,62
115 Sterzing,5,,31,34,65
115 Sterzing,6,,21,32,53
115 Sterzing,7,,37,21,58
115 Sterzing,8,,26,26,52
115 Sterzing,9,,29,24,53
115 Sterzing,10,,32,31,63
115 Sterzing,11,,18,28,46
115 Sterzing,12,,34,23,57
115 Sterzing,13,,26,31,57
115 Sterzing,14,,27,33,60
115 Sterzing,15,,44,32,76
115 Sterzing,16,,29,39,68
115 Sterzing,17,,30,39,69
115 Sterzing,18,,45,25,70
115 Sterzing,19,,36,33,69
115 Sterzing,20,,37,34,71
115 Sterzing,21,,54,49,103
115 Sterzing,22,,53,42,95
115 Sterzing,23,,52,58,110
115 Sterzing,24,,60,52,112
115 Sterzing,25,,55,51,106
115 Sterzing,26,,56,58,114
115 Sterzing,27,,56,43,99
115 Sterzing,28,,69,50,119
115 Sterzing,29,,62,47,109
115 Sterzing,30,,59,63,122
115 Sterzing,31,,60,51,111
115 Sterzing,32,,52,34,86
115 Sterzing,33,,61,48,109
115 Sterzing,34,,43,46,89
115 Sterzing,35,,43,45,88
115 Sterzing,36,,43,45,88
115 Sterzing,37,,47,37,84
115 Sterzing,38,,39,39,78
115 Sterzing,39,,36,47,83
115 Sterzing,40,,43,29,72
115 Sterzing,41,,36,44,80
115 Sterzing,42,,36,36,72
115 Sterzing,43,,29,40,69
115 Sterzing,44,,43,37,80
115 Sterzing,45,,39,39,78
115 Sterzing,46,,33,37,70
115 Sterzing,47,,33,52,85
115 Sterzing,48,,44,44,88
115 Sterzing,49,,39,28,67
115 Sterzing,50,,48,43,91
115 Sterzing,51,,41,36,77
115 Sterzing,52,,31,27,58
115 Sterzing,53,,44,45,89
115 Sterzing,54,,34,34,68
115 Sterzing,55,,35,30,65
115 Sterzing,56,,42,30,72
115 Sterzing,57,,36,27,63
115 Sterzing,58,,34,27,61
115 Sterzing,59,,25,36,61
115 Sterzing,60,,25,42,67
115 Sterzing,61,,21,25,46
115 Sterzing,62,,21,26,47
115 Sterzing,63,,32,32,64
115 Sterzing,64,,22,19,41
115 Sterzing,65,,26,33,59
115 Sterzing,66,,11,26,37
115 Sterzing,67,,23,19,42
115 Sterzing,68,,22,30,52
115 Sterzing,69,,23,23,46
115 Sterzing,70,,18,25,43
115 Sterzing,71,,13,24,37
115 Sterzing,72,,13,26,39
115 Sterzing,73,,16,21,37
115 Sterzing,74,,19,27,46
115 Sterzing,75,,6,23,29
115 Sterzing,76,,7,15,22
115 Sterzing,77,,7,12,19
115 Sterzing,78,,7,6,13
115 Sterzing,79,,6,6,12
115 Sterzing,80,,5,8,13
115 Sterzing,81,,6,8,14
115 Sterzing,82,,3,17,20
115 Sterzing,83,,3,17,20
115 Sterzing,84,,1,18,19
115 Sterzing,85,,3,9,12
115 Sterzing,86,,2,5,7
115 Sterzing,87,,3,8,11
115 Sterzing,88,,4,4,8
115 Sterzing,89,,1,4,5
115 Sterzing,90,,1,8,9
115 Sterzing,91,,-,2,2
115 Sterzing,92,,-,2,2
115 Sterzing,93,,1,1,2
115 Sterzing,94,,-,1,1
115 Sterzing,95,,-,4,4
115 Sterzing,96,,-,3,3
115 Sterzing,100,,1,-,1
115 Sterzing,102,,-,1,1
115 Sterzing,Insgesamt,,2.771,2.834,5.605
116 Feldthurns,0,,16,16,32
116 Feldthurns,1,,18,21,39
116 Feldthurns,2,,18,15,33
116 Feldthurns,3,,28,20,48
116 Feldthurns,4,,17,18,35
116 Feldthurns,5,,11,13,24
116 Feldthurns,6,,11,18,29
116 Feldthurns,7,,19,15,34
116 Feldthurns,8,,18,19,37
116 Feldthurns,9,,20,13,33
116 Feldthurns,10,,16,19,35
116 Feldthurns,11,,14,21,35
116 Feldthurns,12,,17,20,37
116 Feldthurns,13,,25,25,50
116 Feldthurns,14,,16,22,38
116 Feldthurns,15,,21,19,40
116 Feldthurns,16,,11,25,36
116 Feldthurns,17,,14,16,30
116 Feldthurns,18,,31,24,55
116 Feldthurns,19,,18,16,34
116 Feldthurns,20,,27,22,49
116 Feldthurns,21,,16,19,35
116 Feldthurns,22,,22,31,53
116 Feldthurns,23,,23,23,46
116 Feldthurns,24,,31,21,52
116 Feldthurns,25,,15,20,35
116 Feldthurns,26,,14,26,40
116 Feldthurns,27,,25,25,50
116 Feldthurns,28,,20,26,46
116 Feldthurns,29,,26,20,46
116 Feldthurns,30,,18,21,39
116 Feldthurns,31,,23,25,48
116 Feldthurns,32,,27,20,47
116 Feldthurns,33,,26,16,42
116 Feldthurns,34,,16,17,33
116 Feldthurns,35,,19,20,39
116 Feldthurns,36,,18,10,28
116 Feldthurns,37,,17,16,33
116 Feldthurns,38,,17,21,38
116 Feldthurns,39,,14,14,28
116 Feldthurns,40,,12,18,30
116 Feldthurns,41,,15,13,28
116 Feldthurns,42,,14,16,30
116 Feldthurns,43,,18,11,29
116 Feldthurns,44,,24,16,40
116 Feldthurns,45,,15,11,26
116 Feldthurns,46,,12,17,29
116 Feldthurns,47,,7,15,22
116 Feldthurns,48,,14,11,25
116 Feldthurns,49,,15,8,23
116 Feldthurns,50,,10,9,19
116 Feldthurns,51,,13,14,27
116 Feldthurns,52,,22,11,33
116 Feldthurns,53,,13,13,26
116 Feldthurns,54,,9,11,20
116 Feldthurns,55,,8,4,12
116 Feldthurns,56,,9,7,16
116 Feldthurns,57,,8,10,18
116 Feldthurns,58,,11,8,19
116 Feldthurns,59,,4,9,13
116 Feldthurns,60,,8,11,19
116 Feldthurns,61,,11,10,21
116 Feldthurns,62,,5,5,10
116 Feldthurns,63,,8,6,14
116 Feldthurns,64,,9,11,20
116 Feldthurns,65,,5,7,12
116 Feldthurns,66,,7,15,22
116 Feldthurns,67,,5,13,18
116 Feldthurns,68,,9,4,13
116 Feldthurns,69,,4,7,11
116 Feldthurns,70,,5,11,16
116 Feldthurns,71,,7,10,17
116 Feldthurns,72,,4,9,13
116 Feldthurns,73,,8,12,20
116 Feldthurns,74,,2,11,13
116 Feldthurns,75,,4,9,13
116 Feldthurns,76,,12,10,22
116 Feldthurns,77,,5,7,12
116 Feldthurns,78,,3,3,6
116 Feldthurns,79,,2,3,5
116 Feldthurns,80,,1,4,5
116 Feldthurns,81,,2,7,9
116 Feldthurns,82,,4,5,9
116 Feldthurns,83,,2,4,6
116 Feldthurns,84,,2,4,6
116 Feldthurns,85,,2,2,4
116 Feldthurns,87,,3,1,4
116 Feldthurns,88,,1,-,1
116 Feldthurns,90,,-,1,1
116 Feldthurns,91,,-,1,1
116 Feldthurns,92,,-,1,1
116 Feldthurns,Insgesamt,,1.166,1.224,2.390
117 Wengen,0,,9,7,16
117 Wengen,1,,11,10,21
117 Wengen,2,,14,6,20
117 Wengen,3,,10,7,17
117 Wengen,4,,11,7,18
117 Wengen,5,,16,5,21
117 Wengen,6,,12,8,20
117 Wengen,7,,5,7,12
117 Wengen,8,,7,9,16
117 Wengen,9,,11,5,16
117 Wengen,10,,9,8,17
117 Wengen,11,,9,6,15
117 Wengen,12,,14,8,22
117 Wengen,13,,13,5,18
117 Wengen,14,,11,5,16
117 Wengen,15,,6,9,15
117 Wengen,16,,9,10,19
117 Wengen,17,,14,7,21
117 Wengen,18,,6,8,14
117 Wengen,19,,10,8,18
117 Wengen,20,,6,9,15
117 Wengen,21,,16,9,25
117 Wengen,22,,10,9,19
117 Wengen,23,,16,14,30
117 Wengen,24,,13,19,32
117 Wengen,25,,13,15,28
117 Wengen,26,,12,16,28
117 Wengen,27,,11,15,26
117 Wengen,28,,18,10,28
117 Wengen,29,,12,11,23
117 Wengen,30,,12,7,19
117 Wengen,31,,9,10,19
117 Wengen,32,,10,8,18
117 Wengen,33,,11,12,23
117 Wengen,34,,14,9,23
117 Wengen,35,,9,9,18
117 Wengen,36,,12,12,24
117 Wengen,37,,8,7,15
117 Wengen,38,,5,8,13
117 Wengen,39,,7,11,18
117 Wengen,40,,6,6,12
117 Wengen,41,,7,6,13
117 Wengen,42,,10,5,15
117 Wengen,43,,7,2,9
117 Wengen,44,,6,7,13
117 Wengen,45,,10,5,15
117 Wengen,46,,3,6,9
117 Wengen,47,,5,9,14
117 Wengen,48,,2,12,14
117 Wengen,49,,6,3,9
117 Wengen,50,,5,3,8
117 Wengen,51,,5,3,8
117 Wengen,52,,8,8,16
117 Wengen,53,,3,7,10
117 Wengen,54,,8,7,15
117 Wengen,55,,6,4,10
117 Wengen,56,,7,8,15
117 Wengen,57,,6,3,9
117 Wengen,58,,5,5,10
117 Wengen,59,,7,7,14
117 Wengen,60,,2,2,4
117 Wengen,61,,4,6,10
117 Wengen,62,,2,9,11
117 Wengen,63,,5,2,7
117 Wengen,64,,3,8,11
117 Wengen,65,,5,2,7
117 Wengen,66,,5,3,8
117 Wengen,67,,2,9,11
117 Wengen,68,,5,4,9
117 Wengen,69,,4,5,9
117 Wengen,70,,4,6,10
117 Wengen,71,,4,4,8
117 Wengen,72,,3,5,8
117 Wengen,73,,4,7,11
117 Wengen,74,,3,6,9
117 Wengen,75,,6,9,15
117 Wengen,76,,3,5,8
117 Wengen,77,,2,2,4
117 Wengen,78,,1,-,1
117 Wengen,79,,2,1,3
117 Wengen,81,,1,2,3
117 Wengen,82,,1,1,2
117 Wengen,83,,1,3,4
117 Wengen,84,,2,1,3
117 Wengen,85,,2,1,3
117 Wengen,86,,1,2,3
117 Wengen,87,,1,2,3
117 Wengen,88,,-,4,4
117 Wengen,90,,1,1,2
117 Wengen,91,,1,-,1
117 Wengen,92,,1,2,3
117 Wengen,Insgesamt,,634,595,1.229
118 U.L.Frau i.W.-St.Felix,0,,8,4,12
118 U.L.Frau i.W.-St.Felix,1,,4,8,12
118 U.L.Frau i.W.-St.Felix,2,,7,8,15
118 U.L.Frau i.W.-St.Felix,3,,8,5,13
118 U.L.Frau i.W.-St.Felix,4,,6,4,10
118 U.L.Frau i.W.-St.Felix,5,,11,8,19
118 U.L.Frau i.W.-St.Felix,6,,7,5,12
118 U.L.Frau i.W.-St.Felix,7,,8,7,15
118 U.L.Frau i.W.-St.Felix,8,,8,6,14
118 U.L.Frau i.W.-St.Felix,9,,4,7,11
118 U.L.Frau i.W.-St.Felix,10,,8,4,12
118 U.L.Frau i.W.-St.Felix,11,,5,7,12
118 U.L.Frau i.W.-St.Felix,12,,6,5,11
118 U.L.Frau i.W.-St.Felix,13,,2,10,12
118 U.L.Frau i.W.-St.Felix,14,,3,6,9
118 U.L.Frau i.W.-St.Felix,15,,6,3,9
118 U.L.Frau i.W.-St.Felix,16,,3,6,9
118 U.L.Frau i.W.-St.Felix,17,,2,2,4
118 U.L.Frau i.W.-St.Felix,18,,1,3,4
118 U.L.Frau i.W.-St.Felix,19,,5,4,9
118 U.L.Frau i.W.-St.Felix,20,,4,8,12
118 U.L.Frau i.W.-St.Felix,21,,7,3,10
118 U.L.Frau i.W.-St.Felix,22,,5,4,9
118 U.L.Frau i.W.-St.Felix,23,,3,4,7
118 U.L.Frau i.W.-St.Felix,24,,8,2,10
118 U.L.Frau i.W.-St.Felix,25,,2,6,8
118 U.L.Frau i.W.-St.Felix,26,,6,5,11
118 U.L.Frau i.W.-St.Felix,27,,8,5,13
118 U.L.Frau i.W.-St.Felix,28,,7,8,15
118 U.L.Frau i.W.-St.Felix,29,,3,4,7
118 U.L.Frau i.W.-St.Felix,30,,9,8,17
118 U.L.Frau i.W.-St.Felix,31,,10,7,17
118 U.L.Frau i.W.-St.Felix,32,,4,8,12
118 U.L.Frau i.W.-St.Felix,33,,16,8,24
118 U.L.Frau i.W.-St.Felix,34,,8,10,18
118 U.L.Frau i.W.-St.Felix,35,,4,4,8
118 U.L.Frau i.W.-St.Felix,36,,8,9,17
118 U.L.Frau i.W.-St.Felix,37,,5,6,11
118 U.L.Frau i.W.-St.Felix,38,,4,3,7
118 U.L.Frau i.W.-St.Felix,39,,3,5,8
118 U.L.Frau i.W.-St.Felix,40,,5,6,11
118 U.L.Frau i.W.-St.Felix,41,,4,4,8
118 U.L.Frau i.W.-St.Felix,42,,7,4,11
118 U.L.Frau i.W.-St.Felix,43,,3,3,6
118 U.L.Frau i.W.-St.Felix,44,,6,3,9
118 U.L.Frau i.W.-St.Felix,45,,6,3,9
118 U.L.Frau i.W.-St.Felix,46,,3,3,6
118 U.L.Frau i.W.-St.Felix,47,,5,-,5
118 U.L.Frau i.W.-St.Felix,48,,5,2,7
118 U.L.Frau i.W.-St.Felix,49,,2,6,8
118 U.L.Frau i.W.-St.Felix,50,,2,3,5
118 U.L.Frau i.W.-St.Felix,51,,3,2,5
118 U.L.Frau i.W.-St.Felix,52,,5,-,5
118 U.L.Frau i.W.-St.Felix,53,,7,4,11
118 U.L.Frau i.W.-St.Felix,54,,5,4,9
118 U.L.Frau i.W.-St.Felix,55,,5,8,13
118 U.L.Frau i.W.-St.Felix,56,,4,1,5
118 U.L.Frau i.W.-St.Felix,57,,1,4,5
118 U.L.Frau i.W.-St.Felix,58,,3,4,7
118 U.L.Frau i.W.-St.Felix,59,,3,-,3
118 U.L.Frau i.W.-St.Felix,60,,4,2,6
118 U.L.Frau i.W.-St.Felix,61,,3,4,7
118 U.L.Frau i.W.-St.Felix,62,,3,3,6
118 U.L.Frau i.W.-St.Felix,63,,6,5,11
118 U.L.Frau i.W.-St.Felix,64,,5,1,6
118 U.L.Frau i.W.-St.Felix,65,,4,1,5
118 U.L.Frau i.W.-St.Felix,66,,4,5,9
118 U.L.Frau i.W.-St.Felix,67,,2,3,5
118 U.L.Frau i.W.-St.Felix,68,,3,5,8
118 U.L.Frau i.W.-St.Felix,69,,3,4,7
118 U.L.Frau i.W.-St.Felix,70,,2,3,5
118 U.L.Frau i.W.-St.Felix,71,,5,6,11
118 U.L.Frau i.W.-St.Felix,72,,6,4,10
118 U.L.Frau i.W.-St.Felix,73,,2,6,8
118 U.L.Frau i.W.-St.Felix,74,,1,2,3
118 U.L.Frau i.W.-St.Felix,75,,1,3,4
118 U.L.Frau i.W.-St.Felix,76,,-,1,1
118 U.L.Frau i.W.-St.Felix,77,,1,2,3
118 U.L.Frau i.W.-St.Felix,78,,1,-,1
118 U.L.Frau i.W.-St.Felix,79,,1,-,1
118 U.L.Frau i.W.-St.Felix,81,,1,1,2
118 U.L.Frau i.W.-St.Felix,82,,3,2,5
118 U.L.Frau i.W.-St.Felix,83,,2,3,5
118 U.L.Frau i.W.-St.Felix,84,,3,2,5
118 U.L.Frau i.W.-St.Felix,85,,1,-,1
118 U.L.Frau i.W.-St.Felix,86,,1,2,3
118 U.L.Frau i.W.-St.Felix,87,,1,-,1
118 U.L.Frau i.W.-St.Felix,88,,-,1,1
118 U.L.Frau i.W.-St.Felix,89,,1,-,1
118 U.L.Frau i.W.-St.Felix,91,,1,-,1
118 U.L.Frau i.W.-St.Felix,Insgesamt,,391,364,755
Insgesamt,,,223.164,229.848,453.012
