Gemeinde,Altersklassen,Geschlecht,Männer,Frauen,Insgesamt
001 Aldein,0,,15,8,23
001 Aldein,1,,6,8,14
001 Aldein,2,,9,12,21
001 Aldein,3,,13,7,20
001 Aldein,4,,12,10,22
001 Aldein,5,,8,12,20
001 Aldein,6,,7,7,14
001 Aldein,7,,7,6,13
001 Aldein,8,,9,17,26
001 Aldein,9,,12,9,21
001 Aldein,10,,11,7,18
001 Aldein,11,,11,10,21
001 Aldein,12,,12,12,24
001 Aldein,13,,10,7,17
001 Aldein,14,,14,12,26
001 Aldein,15,,18,7,25
001 Aldein,16,,10,16,26
001 Aldein,17,,10,15,25
001 Aldein,18,,10,20,30
001 Aldein,19,,10,9,19
001 Aldein,20,,7,23,30
001 Aldein,21,,14,17,31
001 Aldein,22,,17,20,37
001 Aldein,23,,10,20,30
001 Aldein,24,,14,11,25
001 Aldein,25,,18,12,30
001 Aldein,26,,18,23,41
001 Aldein,27,,16,18,34
001 Aldein,28,,20,8,28
001 Aldein,29,,13,17,30
001 Aldein,30,,8,17,25
001 Aldein,31,,9,21,30
001 Aldein,32,,19,11,30
001 Aldein,33,,14,8,22
001 Aldein,34,,15,6,21
001 Aldein,35,,10,14,24
001 Aldein,36,,16,17,33
001 Aldein,37,,17,9,26
001 Aldein,38,,13,14,27
001 Aldein,39,,8,5,13
001 Aldein,40,,9,10,19
001 Aldein,41,,10,10,20
001 Aldein,42,,10,10,20
001 Aldein,43,,11,7,18
001 Aldein,44,,8,9,17
001 Aldein,45,,7,4,11
001 Aldein,46,,15,10,25
001 Aldein,47,,6,12,18
001 Aldein,48,,10,6,16
001 Aldein,49,,10,9,19
001 Aldein,50,,4,11,15
001 Aldein,51,,7,11,18
001 Aldein,52,,7,5,12
001 Aldein,53,,6,6,12
001 Aldein,54,,11,11,22
001 Aldein,55,,8,13,21
001 Aldein,56,,7,12,19
001 Aldein,57,,9,9,18
001 Aldein,58,,4,10,14
001 Aldein,59,,6,8,14
001 Aldein,60,,8,9,17
001 Aldein,61,,10,6,16
001 Aldein,62,,4,4,8
001 Aldein,63,,16,5,21
001 Aldein,64,,9,4,13
001 Aldein,65,,5,8,13
001 Aldein,66,,10,4,14
001 Aldein,67,,7,6,13
001 Aldein,68,,9,10,19
001 Aldein,69,,6,4,10
001 Aldein,70,,7,6,13
001 Aldein,71,,3,7,10
001 Aldein,72,,3,7,10
001 Aldein,73,,5,8,13
001 Aldein,74,,3,6,9
001 Aldein,75,,2,9,11
001 Aldein,76,,6,14,20
001 Aldein,77,,6,3,9
001 Aldein,78,,1,4,5
001 Aldein,79,,2,3,5
001 Aldein,80,,-,3,3
001 Aldein,81,,2,2,4
001 Aldein,82,,2,3,5
001 Aldein,83,,1,3,4
001 Aldein,84,,1,5,6
001 Aldein,85,,3,3,6
001 Aldein,86,,1,2,3
001 Aldein,87,,2,3,5
001 Aldein,88,,2,1,3
001 Aldein,89,,-,2,2
001 Aldein,90,,1,1,2
001 Aldein,91,,-,2,2
001 Aldein,93,,-,1,1
001 Aldein,95,,-,1,1
001 Aldein,Insgesamt,,792,844,1.636
002 Andrian,0,,8,5,13
002 Andrian,1,,2,10,12
002 Andrian,2,,7,5,12
002 Andrian,3,,5,4,9
002 Andrian,4,,5,6,11
002 Andrian,5,,6,6,12
002 Andrian,6,,7,7,14
002 Andrian,7,,5,4,9
002 Andrian,8,,4,5,9
002 Andrian,9,,12,6,18
002 Andrian,10,,6,7,13
002 Andrian,11,,8,6,14
002 Andrian,12,,1,4,5
002 Andrian,13,,6,4,10
002 Andrian,14,,5,2,7
002 Andrian,15,,10,7,17
002 Andrian,16,,1,3,4
002 Andrian,17,,5,2,7
002 Andrian,18,,5,3,8
002 Andrian,19,,4,4,8
002 Andrian,20,,4,4,8
002 Andrian,21,,6,4,10
002 Andrian,22,,4,2,6
002 Andrian,23,,6,3,9
002 Andrian,24,,5,7,12
002 Andrian,25,,4,5,9
002 Andrian,26,,6,8,14
002 Andrian,27,,9,8,17
002 Andrian,28,,5,8,13
002 Andrian,29,,8,7,15
002 Andrian,30,,8,5,13
002 Andrian,31,,10,9,19
002 Andrian,32,,10,7,17
002 Andrian,33,,6,6,12
002 Andrian,34,,6,12,18
002 Andrian,35,,6,6,12
002 Andrian,36,,7,2,9
002 Andrian,37,,7,4,11
002 Andrian,38,,7,3,10
002 Andrian,39,,8,8,16
002 Andrian,40,,5,8,13
002 Andrian,41,,6,9,15
002 Andrian,42,,1,4,5
002 Andrian,43,,6,2,8
002 Andrian,44,,6,6,12
002 Andrian,45,,3,3,6
002 Andrian,46,,4,3,7
002 Andrian,47,,7,6,13
002 Andrian,48,,4,1,5
002 Andrian,49,,6,5,11
002 Andrian,50,,5,4,9
002 Andrian,51,,3,7,10
002 Andrian,52,,1,2,3
002 Andrian,53,,1,3,4
002 Andrian,54,,5,7,12
002 Andrian,55,,4,5,9
002 Andrian,56,,6,3,9
002 Andrian,57,,5,8,13
002 Andrian,58,,1,8,9
002 Andrian,59,,4,4,8
002 Andrian,60,,6,4,10
002 Andrian,61,,2,3,5
002 Andrian,62,,3,3,6
002 Andrian,63,,5,3,8
002 Andrian,64,,3,4,7
002 Andrian,65,,7,5,12
002 Andrian,66,,4,5,9
002 Andrian,67,,3,1,4
002 Andrian,68,,2,1,3
002 Andrian,69,,3,5,8
002 Andrian,70,,1,2,3
002 Andrian,71,,4,4,8
002 Andrian,72,,2,1,3
002 Andrian,73,,2,5,7
002 Andrian,74,,1,2,3
002 Andrian,75,,1,5,6
002 Andrian,76,,1,4,5
002 Andrian,77,,1,1,2
002 Andrian,78,,2,3,5
002 Andrian,79,,2,2,4
002 Andrian,81,,1,-,1
002 Andrian,82,,1,2,3
002 Andrian,83,,1,2,3
002 Andrian,84,,1,2,3
002 Andrian,85,,-,2,2
002 Andrian,87,,-,1,1
002 Andrian,88,,1,1,2
002 Andrian,89,,-,1,1
002 Andrian,90,,2,1,3
002 Andrian,92,,-,1,1
002 Andrian,94,,-,1,1
002 Andrian,Insgesamt,,389,393,782
003 Altrei,0,,2,1,3
003 Altrei,1,,-,2,2
003 Altrei,2,,1,1,2
003 Altrei,3,,3,2,5
003 Altrei,4,,3,-,3
003 Altrei,5,,6,2,8
003 Altrei,6,,1,1,2
003 Altrei,7,,3,2,5
003 Altrei,8,,2,2,4
003 Altrei,9,,4,4,8
003 Altrei,10,,2,1,3
003 Altrei,11,,3,3,6
003 Altrei,12,,2,2,4
003 Altrei,13,,3,1,4
003 Altrei,14,,4,2,6
003 Altrei,15,,2,2,4
003 Altrei,16,,3,2,5
003 Altrei,17,,3,4,7
003 Altrei,18,,-,1,1
003 Altrei,19,,2,3,5
003 Altrei,20,,-,4,4
003 Altrei,21,,2,3,5
003 Altrei,22,,2,1,3
003 Altrei,23,,1,2,3
003 Altrei,24,,2,4,6
003 Altrei,25,,3,1,4
003 Altrei,26,,5,4,9
003 Altrei,27,,1,3,4
003 Altrei,28,,3,5,8
003 Altrei,29,,-,2,2
003 Altrei,30,,2,-,2
003 Altrei,31,,4,5,9
003 Altrei,32,,2,5,7
003 Altrei,33,,3,5,8
003 Altrei,34,,3,3,6
003 Altrei,35,,9,1,10
003 Altrei,36,,2,3,5
003 Altrei,37,,5,3,8
003 Altrei,38,,5,2,7
003 Altrei,39,,1,3,4
003 Altrei,40,,1,3,4
003 Altrei,41,,5,1,6
003 Altrei,42,,3,3,6
003 Altrei,43,,1,1,2
003 Altrei,44,,3,2,5
003 Altrei,45,,6,3,9
003 Altrei,46,,6,4,10
003 Altrei,47,,1,2,3
003 Altrei,48,,2,-,2
003 Altrei,49,,3,3,6
003 Altrei,50,,2,2,4
003 Altrei,51,,1,2,3
003 Altrei,52,,4,-,4
003 Altrei,53,,2,2,4
003 Altrei,54,,1,3,4
003 Altrei,55,,3,1,4
003 Altrei,56,,1,2,3
003 Altrei,57,,2,4,6
003 Altrei,58,,1,3,4
003 Altrei,59,,1,-,1
003 Altrei,60,,2,1,3
003 Altrei,61,,2,1,3
003 Altrei,62,,3,2,5
003 Altrei,63,,-,2,2
003 Altrei,64,,3,3,6
003 Altrei,65,,-,3,3
003 Altrei,66,,-,2,2
003 Altrei,67,,5,2,7
003 Altrei,68,,2,3,5
003 Altrei,69,,-,2,2
003 Altrei,70,,3,4,7
003 Altrei,71,,2,4,6
003 Altrei,72,,-,3,3
003 Altrei,73,,1,3,4
003 Altrei,74,,1,3,4
003 Altrei,75,,3,2,5
003 Altrei,76,,-,3,3
003 Altrei,77,,3,1,4
003 Altrei,78,,-,2,2
003 Altrei,79,,-,1,1
003 Altrei,80,,-,3,3
003 Altrei,82,,-,1,1
003 Altrei,83,,1,3,4
003 Altrei,84,,1,1,2
003 Altrei,85,,3,-,3
003 Altrei,86,,1,2,3
003 Altrei,88,,1,1,2
003 Altrei,89,,-,1,1
003 Altrei,91,,1,-,1
003 Altrei,93,,1,-,1
003 Altrei,98,,-,1,1
003 Altrei,Insgesamt,,192,198,390
004 Eppan a.d. Weinstr.,0,,78,69,147
004 Eppan a.d. Weinstr.,1,,79,70,149
004 Eppan a.d. Weinstr.,2,,63,61,124
004 Eppan a.d. Weinstr.,3,,72,68,140
004 Eppan a.d. Weinstr.,4,,74,87,161
004 Eppan a.d. Weinstr.,5,,65,69,134
004 Eppan a.d. Weinstr.,6,,74,57,131
004 Eppan a.d. Weinstr.,7,,79,60,139
004 Eppan a.d. Weinstr.,8,,75,57,132
004 Eppan a.d. Weinstr.,9,,77,75,152
004 Eppan a.d. Weinstr.,10,,71,61,132
004 Eppan a.d. Weinstr.,11,,78,67,145
004 Eppan a.d. Weinstr.,12,,77,56,133
004 Eppan a.d. Weinstr.,13,,77,72,149
004 Eppan a.d. Weinstr.,14,,61,63,124
004 Eppan a.d. Weinstr.,15,,66,65,131
004 Eppan a.d. Weinstr.,16,,54,69,123
004 Eppan a.d. Weinstr.,17,,76,63,139
004 Eppan a.d. Weinstr.,18,,69,62,131
004 Eppan a.d. Weinstr.,19,,79,69,148
004 Eppan a.d. Weinstr.,20,,82,51,133
004 Eppan a.d. Weinstr.,21,,67,66,133
004 Eppan a.d. Weinstr.,22,,79,77,156
004 Eppan a.d. Weinstr.,23,,70,83,153
004 Eppan a.d. Weinstr.,24,,82,79,161
004 Eppan a.d. Weinstr.,25,,82,109,191
004 Eppan a.d. Weinstr.,26,,104,90,194
004 Eppan a.d. Weinstr.,27,,128,119,247
004 Eppan a.d. Weinstr.,28,,119,112,231
004 Eppan a.d. Weinstr.,29,,107,96,203
004 Eppan a.d. Weinstr.,30,,134,119,253
004 Eppan a.d. Weinstr.,31,,111,131,242
004 Eppan a.d. Weinstr.,32,,109,107,216
004 Eppan a.d. Weinstr.,33,,123,112,235
004 Eppan a.d. Weinstr.,34,,97,124,221
004 Eppan a.d. Weinstr.,35,,120,104,224
004 Eppan a.d. Weinstr.,36,,128,100,228
004 Eppan a.d. Weinstr.,37,,99,113,212
004 Eppan a.d. Weinstr.,38,,116,100,216
004 Eppan a.d. Weinstr.,39,,102,96,198
004 Eppan a.d. Weinstr.,40,,96,93,189
004 Eppan a.d. Weinstr.,41,,85,71,156
004 Eppan a.d. Weinstr.,42,,85,90,175
004 Eppan a.d. Weinstr.,43,,67,91,158
004 Eppan a.d. Weinstr.,44,,83,76,159
004 Eppan a.d. Weinstr.,45,,75,79,154
004 Eppan a.d. Weinstr.,46,,78,68,146
004 Eppan a.d. Weinstr.,47,,61,73,134
004 Eppan a.d. Weinstr.,48,,66,64,130
004 Eppan a.d. Weinstr.,49,,83,68,151
004 Eppan a.d. Weinstr.,50,,67,84,151
004 Eppan a.d. Weinstr.,51,,84,72,156
004 Eppan a.d. Weinstr.,52,,63,49,112
004 Eppan a.d. Weinstr.,53,,71,84,155
004 Eppan a.d. Weinstr.,54,,94,80,174
004 Eppan a.d. Weinstr.,55,,99,80,179
004 Eppan a.d. Weinstr.,56,,67,107,174
004 Eppan a.d. Weinstr.,57,,79,65,144
004 Eppan a.d. Weinstr.,58,,62,83,145
004 Eppan a.d. Weinstr.,59,,64,51,115
004 Eppan a.d. Weinstr.,60,,49,57,106
004 Eppan a.d. Weinstr.,61,,47,53,100
004 Eppan a.d. Weinstr.,62,,44,47,91
004 Eppan a.d. Weinstr.,63,,36,58,94
004 Eppan a.d. Weinstr.,64,,58,61,119
004 Eppan a.d. Weinstr.,65,,50,54,104
004 Eppan a.d. Weinstr.,66,,45,63,108
004 Eppan a.d. Weinstr.,67,,55,69,124
004 Eppan a.d. Weinstr.,68,,54,58,112
004 Eppan a.d. Weinstr.,69,,46,53,99
004 Eppan a.d. Weinstr.,70,,39,51,90
004 Eppan a.d. Weinstr.,71,,50,50,100
004 Eppan a.d. Weinstr.,72,,44,63,107
004 Eppan a.d. Weinstr.,73,,30,76,106
004 Eppan a.d. Weinstr.,74,,30,51,81
004 Eppan a.d. Weinstr.,75,,25,51,76
004 Eppan a.d. Weinstr.,76,,32,52,84
004 Eppan a.d. Weinstr.,77,,22,38,60
004 Eppan a.d. Weinstr.,78,,21,38,59
004 Eppan a.d. Weinstr.,79,,12,23,35
004 Eppan a.d. Weinstr.,80,,15,15,30
004 Eppan a.d. Weinstr.,81,,14,21,35
004 Eppan a.d. Weinstr.,82,,19,18,37
004 Eppan a.d. Weinstr.,83,,19,39,58
004 Eppan a.d. Weinstr.,84,,10,31,41
004 Eppan a.d. Weinstr.,85,,11,24,35
004 Eppan a.d. Weinstr.,86,,7,34,41
004 Eppan a.d. Weinstr.,87,,4,17,21
004 Eppan a.d. Weinstr.,88,,4,11,15
004 Eppan a.d. Weinstr.,89,,3,15,18
004 Eppan a.d. Weinstr.,90,,3,14,17
004 Eppan a.d. Weinstr.,91,,2,4,6
004 Eppan a.d. Weinstr.,92,,2,6,8
004 Eppan a.d. Weinstr.,93,,1,7,8
004 Eppan a.d. Weinstr.,94,,-,4,4
004 Eppan a.d. Weinstr.,95,,-,3,3
004 Eppan a.d. Weinstr.,96,,1,1,2
004 Eppan a.d. Weinstr.,97,,1,1,2
004 Eppan a.d. Weinstr.,101,,-,1,1
004 Eppan a.d. Weinstr.,Insgesamt,,5.937,6.168,12.105
005 Hafling,0,,1,11,12
005 Hafling,1,,9,3,12
005 Hafling,2,,7,5,12
005 Hafling,3,,4,6,10
005 Hafling,4,,3,6,9
005 Hafling,5,,3,5,8
005 Hafling,6,,8,2,10
005 Hafling,7,,5,6,11
005 Hafling,8,,4,2,6
005 Hafling,9,,2,7,9
005 Hafling,10,,4,3,7
005 Hafling,11,,5,3,8
005 Hafling,12,,5,5,10
005 Hafling,13,,5,7,12
005 Hafling,14,,3,-,3
005 Hafling,15,,7,2,9
005 Hafling,16,,4,4,8
005 Hafling,17,,3,10,13
005 Hafling,18,,4,5,9
005 Hafling,19,,2,4,6
005 Hafling,20,,3,2,5
005 Hafling,21,,5,6,11
005 Hafling,22,,7,4,11
005 Hafling,23,,8,5,13
005 Hafling,24,,7,3,10
005 Hafling,25,,8,4,12
005 Hafling,26,,9,4,13
005 Hafling,27,,6,8,14
005 Hafling,28,,7,10,17
005 Hafling,29,,5,11,16
005 Hafling,30,,7,4,11
005 Hafling,31,,10,7,17
005 Hafling,32,,6,10,16
005 Hafling,33,,4,2,6
005 Hafling,34,,6,4,10
005 Hafling,35,,4,4,8
005 Hafling,36,,7,4,11
005 Hafling,37,,8,6,14
005 Hafling,38,,6,5,11
005 Hafling,39,,3,4,7
005 Hafling,40,,2,5,7
005 Hafling,41,,3,9,12
005 Hafling,42,,5,1,6
005 Hafling,43,,4,1,5
005 Hafling,44,,2,3,5
005 Hafling,45,,4,2,6
005 Hafling,46,,2,2,4
005 Hafling,47,,4,3,7
005 Hafling,48,,5,3,8
005 Hafling,49,,8,2,10
005 Hafling,50,,3,4,7
005 Hafling,51,,2,4,6
005 Hafling,52,,5,2,7
005 Hafling,53,,1,2,3
005 Hafling,54,,6,5,11
005 Hafling,55,,5,3,8
005 Hafling,56,,5,4,9
005 Hafling,57,,2,1,3
005 Hafling,58,,3,5,8
005 Hafling,59,,2,3,5
005 Hafling,60,,4,2,6
005 Hafling,61,,1,1,2
005 Hafling,62,,1,1,2
005 Hafling,63,,1,3,4
005 Hafling,64,,6,3,9
005 Hafling,65,,3,4,7
005 Hafling,66,,3,7,10
005 Hafling,67,,2,4,6
005 Hafling,68,,4,1,5
005 Hafling,69,,5,3,8
005 Hafling,70,,4,5,9
005 Hafling,71,,1,2,3
005 Hafling,72,,2,-,2
005 Hafling,73,,1,3,4
005 Hafling,74,,1,-,1
005 Hafling,75,,-,2,2
005 Hafling,76,,-,4,4
005 Hafling,77,,3,1,4
005 Hafling,78,,1,3,4
005 Hafling,79,,-,2,2
005 Hafling,80,,-,1,1
005 Hafling,81,,1,2,3
005 Hafling,82,,1,-,1
005 Hafling,83,,1,-,1
005 Hafling,84,,-,3,3
005 Hafling,85,,-,1,1
005 Hafling,86,,1,2,3
005 Hafling,87,,1,-,1
005 Hafling,88,,2,-,2
005 Hafling,91,,-,1,1
005 Hafling,93,,1,-,1
005 Hafling,Insgesamt,,338,328,666
006 Abtei,0,,24,21,45
006 Abtei,1,,28,14,42
006 Abtei,2,,24,26,50
006 Abtei,3,,18,14,32
006 Abtei,4,,16,20,36
006 Abtei,5,,24,15,39
006 Abtei,6,,20,14,34
006 Abtei,7,,22,15,37
006 Abtei,8,,15,14,29
006 Abtei,9,,13,9,22
006 Abtei,10,,19,12,31
006 Abtei,11,,16,18,34
006 Abtei,12,,11,14,25
006 Abtei,13,,11,20,31
006 Abtei,14,,15,11,26
006 Abtei,15,,18,20,38
006 Abtei,16,,18,18,36
006 Abtei,17,,23,15,38
006 Abtei,18,,10,23,33
006 Abtei,19,,21,26,47
006 Abtei,20,,19,28,47
006 Abtei,21,,24,24,48
006 Abtei,22,,18,28,46
006 Abtei,23,,20,25,45
006 Abtei,24,,21,25,46
006 Abtei,25,,38,28,66
006 Abtei,26,,15,31,46
006 Abtei,27,,30,32,62
006 Abtei,28,,26,33,59
006 Abtei,29,,22,34,56
006 Abtei,30,,34,37,71
006 Abtei,31,,21,29,50
006 Abtei,32,,33,21,54
006 Abtei,33,,21,33,54
006 Abtei,34,,28,26,54
006 Abtei,35,,24,28,52
006 Abtei,36,,21,28,49
006 Abtei,37,,26,20,46
006 Abtei,38,,25,23,48
006 Abtei,39,,18,24,42
006 Abtei,40,,18,15,33
006 Abtei,41,,19,17,36
006 Abtei,42,,19,15,34
006 Abtei,43,,11,15,26
006 Abtei,44,,15,19,34
006 Abtei,45,,12,12,24
006 Abtei,46,,12,12,24
006 Abtei,47,,14,20,34
006 Abtei,48,,13,18,31
006 Abtei,49,,26,18,44
006 Abtei,50,,16,15,31
006 Abtei,51,,26,19,45
006 Abtei,52,,15,20,35
006 Abtei,53,,14,18,32
006 Abtei,54,,13,11,24
006 Abtei,55,,20,11,31
006 Abtei,56,,17,24,41
006 Abtei,57,,19,19,38
006 Abtei,58,,17,13,30
006 Abtei,59,,15,19,34
006 Abtei,60,,7,19,26
006 Abtei,61,,21,10,31
006 Abtei,62,,13,20,33
006 Abtei,63,,15,18,33
006 Abtei,64,,11,17,28
006 Abtei,65,,9,6,15
006 Abtei,66,,13,14,27
006 Abtei,67,,17,12,29
006 Abtei,68,,12,8,20
006 Abtei,69,,8,16,24
006 Abtei,70,,9,9,18
006 Abtei,71,,10,7,17
006 Abtei,72,,11,7,18
006 Abtei,73,,6,10,16
006 Abtei,74,,8,15,23
006 Abtei,75,,7,6,13
006 Abtei,76,,5,7,12
006 Abtei,77,,4,15,19
006 Abtei,78,,2,5,7
006 Abtei,79,,3,4,7
006 Abtei,80,,-,5,5
006 Abtei,81,,1,3,4
006 Abtei,82,,1,4,5
006 Abtei,83,,3,5,8
006 Abtei,84,,3,2,5
006 Abtei,85,,2,7,9
006 Abtei,86,,1,4,5
006 Abtei,87,,1,5,6
006 Abtei,88,,3,5,8
006 Abtei,89,,-,4,4
006 Abtei,90,,-,1,1
006 Abtei,91,,-,1,1
006 Abtei,92,,-,2,2
006 Abtei,93,,1,-,1
006 Abtei,95,,2,-,2
006 Abtei,97,,1,1,2
006 Abtei,Insgesamt,,1.391,1.500,2.891
007 Barbian,0,,9,6,15
007 Barbian,1,,7,10,17
007 Barbian,2,,10,9,19
007 Barbian,3,,8,4,12
007 Barbian,4,,10,11,21
007 Barbian,5,,11,9,20
007 Barbian,6,,11,10,21
007 Barbian,7,,13,13,26
007 Barbian,8,,8,13,21
007 Barbian,9,,11,5,16
007 Barbian,10,,8,6,14
007 Barbian,11,,13,6,19
007 Barbian,12,,8,10,18
007 Barbian,13,,9,7,16
007 Barbian,14,,11,7,18
007 Barbian,15,,10,5,15
007 Barbian,16,,14,14,28
007 Barbian,17,,8,7,15
007 Barbian,18,,18,13,31
007 Barbian,19,,11,9,20
007 Barbian,20,,6,17,23
007 Barbian,21,,7,10,17
007 Barbian,22,,11,10,21
007 Barbian,23,,15,10,25
007 Barbian,24,,10,16,26
007 Barbian,25,,19,17,36
007 Barbian,26,,14,14,28
007 Barbian,27,,11,9,20
007 Barbian,28,,18,7,25
007 Barbian,29,,13,10,23
007 Barbian,30,,7,8,15
007 Barbian,31,,11,16,27
007 Barbian,32,,9,10,19
007 Barbian,33,,13,15,28
007 Barbian,34,,14,13,27
007 Barbian,35,,17,13,30
007 Barbian,36,,19,8,27
007 Barbian,37,,13,16,29
007 Barbian,38,,10,8,18
007 Barbian,39,,10,8,18
007 Barbian,40,,15,7,22
007 Barbian,41,,5,9,14
007 Barbian,42,,10,8,18
007 Barbian,43,,5,14,19
007 Barbian,44,,10,7,17
007 Barbian,45,,7,4,11
007 Barbian,46,,7,11,18
007 Barbian,47,,12,11,23
007 Barbian,48,,6,5,11
007 Barbian,49,,4,4,8
007 Barbian,50,,6,10,16
007 Barbian,51,,17,7,24
007 Barbian,52,,7,4,11
007 Barbian,53,,12,8,20
007 Barbian,54,,9,6,15
007 Barbian,55,,11,12,23
007 Barbian,56,,8,12,20
007 Barbian,57,,8,3,11
007 Barbian,58,,7,6,13
007 Barbian,59,,5,10,15
007 Barbian,60,,8,8,16
007 Barbian,61,,3,8,11
007 Barbian,62,,3,8,11
007 Barbian,63,,6,6,12
007 Barbian,64,,8,5,13
007 Barbian,65,,4,7,11
007 Barbian,66,,5,10,15
007 Barbian,67,,7,6,13
007 Barbian,68,,9,8,17
007 Barbian,69,,5,10,15
007 Barbian,70,,6,4,10
007 Barbian,71,,4,3,7
007 Barbian,72,,9,3,12
007 Barbian,73,,4,6,10
007 Barbian,74,,3,10,13
007 Barbian,75,,3,6,9
007 Barbian,76,,3,3,6
007 Barbian,77,,4,4,8
007 Barbian,78,,1,4,5
007 Barbian,79,,3,1,4
007 Barbian,80,,-,1,1
007 Barbian,81,,1,3,4
007 Barbian,82,,-,5,5
007 Barbian,83,,4,6,10
007 Barbian,84,,1,4,5
007 Barbian,86,,3,2,5
007 Barbian,87,,3,3,6
007 Barbian,88,,-,1,1
007 Barbian,89,,-,2,2
007 Barbian,93,,-,1,1
007 Barbian,Insgesamt,,736,715,1.451
008 Bozen,0,,433,360,793
008 Bozen,1,,404,416,820
008 Bozen,2,,399,353,752
008 Bozen,3,,424,400,824
008 Bozen,4,,395,397,792
008 Bozen,5,,396,370,766
008 Bozen,6,,448,379,827
008 Bozen,7,,428,382,810
008 Bozen,8,,420,382,802
008 Bozen,9,,400,396,796
008 Bozen,10,,335,377,712
008 Bozen,11,,368,358,726
008 Bozen,12,,394,362,756
008 Bozen,13,,378,378,756
008 Bozen,14,,394,348,742
008 Bozen,15,,409,386,795
008 Bozen,16,,399,378,777
008 Bozen,17,,439,387,826
008 Bozen,18,,387,412,799
008 Bozen,19,,448,422,870
008 Bozen,20,,481,421,902
008 Bozen,21,,503,502,1.005
008 Bozen,22,,605,566,1.171
008 Bozen,23,,649,624,1.273
008 Bozen,24,,662,719,1.381
008 Bozen,25,,748,698,1.446
008 Bozen,26,,858,775,1.633
008 Bozen,27,,834,691,1.525
008 Bozen,28,,896,779,1.675
008 Bozen,29,,820,740,1.560
008 Bozen,30,,826,784,1.610
008 Bozen,31,,899,816,1.715
008 Bozen,32,,911,816,1.727
008 Bozen,33,,918,882,1.800
008 Bozen,34,,814,782,1.596
008 Bozen,35,,798,770,1.568
008 Bozen,36,,781,710,1.491
008 Bozen,37,,717,673,1.390
008 Bozen,38,,719,657,1.376
008 Bozen,39,,702,684,1.386
008 Bozen,40,,658,701,1.359
008 Bozen,41,,662,653,1.315
008 Bozen,42,,637,633,1.270
008 Bozen,43,,650,601,1.251
008 Bozen,44,,573,600,1.173
008 Bozen,45,,579,645,1.224
008 Bozen,46,,561,649,1.210
008 Bozen,47,,625,676,1.301
008 Bozen,48,,658,656,1.314
008 Bozen,49,,683,731,1.414
008 Bozen,50,,696,822,1.518
008 Bozen,51,,776,899,1.675
008 Bozen,52,,586,623,1.209
008 Bozen,53,,643,759,1.402
008 Bozen,54,,673,768,1.441
008 Bozen,55,,701,753,1.454
008 Bozen,56,,786,795,1.581
008 Bozen,57,,744,771,1.515
008 Bozen,58,,644,767,1.411
008 Bozen,59,,721,694,1.415
008 Bozen,60,,597,614,1.211
008 Bozen,61,,568,607,1.175
008 Bozen,62,,540,601,1.141
008 Bozen,63,,552,605,1.157
008 Bozen,64,,477,597,1.074
008 Bozen,65,,506,609,1.115
008 Bozen,66,,510,605,1.115
008 Bozen,67,,514,628,1.142
008 Bozen,68,,414,602,1.016
008 Bozen,69,,436,562,998
008 Bozen,70,,423,558,981
008 Bozen,71,,480,553,1.033
008 Bozen,72,,382,586,968
008 Bozen,73,,361,581,942
008 Bozen,74,,388,581,969
008 Bozen,75,,374,619,993
008 Bozen,76,,308,572,880
008 Bozen,77,,305,561,866
008 Bozen,78,,167,353,520
008 Bozen,79,,105,223,328
008 Bozen,80,,127,234,361
008 Bozen,81,,129,235,364
008 Bozen,82,,172,340,512
008 Bozen,83,,178,328,506
008 Bozen,84,,165,334,499
008 Bozen,85,,136,316,452
008 Bozen,86,,109,265,374
008 Bozen,87,,86,200,286
008 Bozen,88,,69,177,246
008 Bozen,89,,57,149,206
008 Bozen,90,,26,122,148
008 Bozen,91,,33,98,131
008 Bozen,92,,16,65,81
008 Bozen,93,,11,60,71
008 Bozen,94,,5,54,59
008 Bozen,95,,9,25,34
008 Bozen,96,,4,15,19
008 Bozen,97,,2,14,16
008 Bozen,98,,5,8,13
008 Bozen,99,,1,6,7
008 Bozen,100,,2,3,5
008 Bozen,101,,-,2,2
008 Bozen,102,,-,3,3
008 Bozen,104,,-,2,2
008 Bozen,Insgesamt,,46.244,50.200,96.444
009 Prags,0,,4,4,8
009 Prags,1,,2,4,6
009 Prags,2,,2,3,5
009 Prags,3,,5,5,10
009 Prags,4,,7,4,11
009 Prags,5,,6,3,9
009 Prags,6,,7,2,9
009 Prags,7,,4,2,6
009 Prags,8,,9,3,12
009 Prags,9,,3,3,6
009 Prags,10,,3,3,6
009 Prags,11,,6,5,11
009 Prags,12,,8,2,10
009 Prags,13,,5,3,8
009 Prags,14,,3,7,10
009 Prags,15,,3,5,8
009 Prags,16,,1,6,7
009 Prags,17,,4,1,5
009 Prags,18,,2,1,3
009 Prags,19,,6,3,9
009 Prags,20,,4,3,7
009 Prags,21,,6,3,9
009 Prags,22,,2,6,8
009 Prags,23,,4,4,8
009 Prags,24,,7,9,16
009 Prags,25,,4,1,5
009 Prags,26,,5,5,10
009 Prags,27,,6,4,10
009 Prags,28,,6,4,10
009 Prags,29,,8,6,14
009 Prags,30,,7,8,15
009 Prags,31,,8,4,12
009 Prags,32,,8,8,16
009 Prags,33,,7,6,13
009 Prags,34,,7,6,13
009 Prags,35,,4,6,10
009 Prags,36,,5,10,15
009 Prags,37,,7,3,10
009 Prags,38,,12,5,17
009 Prags,39,,6,3,9
009 Prags,40,,5,4,9
009 Prags,41,,3,6,9
009 Prags,42,,3,4,7
009 Prags,43,,6,4,10
009 Prags,44,,4,2,6
009 Prags,45,,2,5,7
009 Prags,46,,3,1,4
009 Prags,47,,5,1,6
009 Prags,48,,1,2,3
009 Prags,49,,5,1,6
009 Prags,50,,1,-,1
009 Prags,51,,2,4,6
009 Prags,52,,2,2,4
009 Prags,53,,5,5,10
009 Prags,54,,1,4,5
009 Prags,55,,4,4,8
009 Prags,56,,5,2,7
009 Prags,57,,1,3,4
009 Prags,58,,3,5,8
009 Prags,59,,5,3,8
009 Prags,60,,1,3,4
009 Prags,61,,2,3,5
009 Prags,62,,2,4,6
009 Prags,63,,4,2,6
009 Prags,64,,5,2,7
009 Prags,65,,6,7,13
009 Prags,66,,1,4,5
009 Prags,67,,2,1,3
009 Prags,68,,4,1,5
009 Prags,69,,3,2,5
009 Prags,70,,3,7,10
009 Prags,71,,3,4,7
009 Prags,72,,2,5,7
009 Prags,73,,4,2,6
009 Prags,74,,-,5,5
009 Prags,75,,3,2,5
009 Prags,76,,2,3,5
009 Prags,77,,1,1,2
009 Prags,78,,2,3,5
009 Prags,79,,-,1,1
009 Prags,80,,2,2,4
009 Prags,81,,-,1,1
009 Prags,82,,1,2,3
009 Prags,83,,1,2,3
009 Prags,84,,-,1,1
009 Prags,85,,-,1,1
009 Prags,86,,-,1,1
009 Prags,88,,1,-,1
009 Prags,89,,-,2,2
009 Prags,90,,-,1,1
009 Prags,93,,2,-,2
009 Prags,102,,-,1,1
009 Prags,Insgesamt,,336,311,647
010 Brenner,0,,14,7,21
010 Brenner,1,,8,9,17
010 Brenner,2,,10,9,19
010 Brenner,3,,21,9,30
010 Brenner,4,,13,10,23
010 Brenner,5,,10,8,18
010 Brenner,6,,8,19,27
010 Brenner,7,,13,8,21
010 Brenner,8,,14,4,18
010 Brenner,9,,12,5,17
010 Brenner,10,,8,9,17
010 Brenner,11,,9,11,20
010 Brenner,12,,20,10,30
010 Brenner,13,,14,16,30
010 Brenner,14,,16,17,33
010 Brenner,15,,12,6,18
010 Brenner,16,,8,15,23
010 Brenner,17,,11,15,26
010 Brenner,18,,13,9,22
010 Brenner,19,,16,11,27
010 Brenner,20,,18,11,29
010 Brenner,21,,13,11,24
010 Brenner,22,,14,20,34
010 Brenner,23,,21,11,32
010 Brenner,24,,26,15,41
010 Brenner,25,,30,24,54
010 Brenner,26,,33,15,48
010 Brenner,27,,30,26,56
010 Brenner,28,,21,20,41
010 Brenner,29,,18,19,37
010 Brenner,30,,19,17,36
010 Brenner,31,,26,15,41
010 Brenner,32,,24,20,44
010 Brenner,33,,28,17,45
010 Brenner,34,,17,23,40
010 Brenner,35,,20,13,33
010 Brenner,36,,24,11,35
010 Brenner,37,,23,18,41
010 Brenner,38,,21,14,35
010 Brenner,39,,20,9,29
010 Brenner,40,,18,18,36
010 Brenner,41,,20,13,33
010 Brenner,42,,13,11,24
010 Brenner,43,,12,15,27
010 Brenner,44,,11,18,29
010 Brenner,45,,22,9,31
010 Brenner,46,,20,11,31
010 Brenner,47,,14,13,27
010 Brenner,48,,18,16,34
010 Brenner,49,,5,8,13
010 Brenner,50,,21,13,34
010 Brenner,51,,13,17,30
010 Brenner,52,,10,8,18
010 Brenner,53,,21,13,34
010 Brenner,54,,22,14,36
010 Brenner,55,,10,10,20
010 Brenner,56,,12,13,25
010 Brenner,57,,12,12,24
010 Brenner,58,,12,7,19
010 Brenner,59,,11,18,29
010 Brenner,60,,10,13,23
010 Brenner,61,,14,6,20
010 Brenner,62,,7,6,13
010 Brenner,63,,10,9,19
010 Brenner,64,,7,8,15
010 Brenner,65,,3,4,7
010 Brenner,66,,10,12,22
010 Brenner,67,,9,12,21
010 Brenner,68,,13,9,22
010 Brenner,69,,10,11,21
010 Brenner,70,,9,5,14
010 Brenner,71,,11,11,22
010 Brenner,72,,5,12,17
010 Brenner,73,,3,10,13
010 Brenner,74,,5,11,16
010 Brenner,75,,1,9,10
010 Brenner,76,,3,5,8
010 Brenner,77,,6,9,15
010 Brenner,78,,3,2,5
010 Brenner,79,,2,2,4
010 Brenner,80,,1,6,7
010 Brenner,81,,2,-,2
010 Brenner,82,,2,3,5
010 Brenner,83,,1,7,8
010 Brenner,84,,1,4,5
010 Brenner,85,,-,5,5
010 Brenner,86,,5,1,6
010 Brenner,87,,1,5,6
010 Brenner,88,,1,2,3
010 Brenner,89,,2,-,2
010 Brenner,91,,-,4,4
010 Brenner,92,,1,1,2
010 Brenner,93,,-,1,1
010 Brenner,95,,1,1,2
010 Brenner,96,,-,1,1
010 Brenner,Insgesamt,,1.152,1.000,2.152
011 Brixen,0,,104,93,197
011 Brixen,1,,113,103,216
011 Brixen,2,,108,110,218
011 Brixen,3,,111,114,225
011 Brixen,4,,99,101,200
011 Brixen,5,,106,114,220
011 Brixen,6,,107,107,214
011 Brixen,7,,95,104,199
011 Brixen,8,,111,86,197
011 Brixen,9,,104,93,197
011 Brixen,10,,95,85,180
011 Brixen,11,,99,106,205
011 Brixen,12,,113,88,201
011 Brixen,13,,109,83,192
011 Brixen,14,,107,122,229
011 Brixen,15,,115,100,215
011 Brixen,16,,105,93,198
011 Brixen,17,,96,100,196
011 Brixen,18,,119,91,210
011 Brixen,19,,88,100,188
011 Brixen,20,,115,103,218
011 Brixen,21,,126,111,237
011 Brixen,22,,104,100,204
011 Brixen,23,,123,127,250
011 Brixen,24,,131,140,271
011 Brixen,25,,131,140,271
011 Brixen,26,,142,155,297
011 Brixen,27,,161,144,305
011 Brixen,28,,182,173,355
011 Brixen,29,,164,161,325
011 Brixen,30,,165,154,319
011 Brixen,31,,172,179,351
011 Brixen,32,,187,142,329
011 Brixen,33,,182,182,364
011 Brixen,34,,153,162,315
011 Brixen,35,,159,157,316
011 Brixen,36,,144,159,303
011 Brixen,37,,154,144,298
011 Brixen,38,,146,141,287
011 Brixen,39,,159,111,270
011 Brixen,40,,134,132,266
011 Brixen,41,,106,139,245
011 Brixen,42,,128,92,220
011 Brixen,43,,98,105,203
011 Brixen,44,,85,105,190
011 Brixen,45,,108,100,208
011 Brixen,46,,101,102,203
011 Brixen,47,,112,103,215
011 Brixen,48,,81,124,205
011 Brixen,49,,117,117,234
011 Brixen,50,,93,110,203
011 Brixen,51,,107,115,222
011 Brixen,52,,72,97,169
011 Brixen,53,,121,105,226
011 Brixen,54,,140,121,261
011 Brixen,55,,99,102,201
011 Brixen,56,,112,121,233
011 Brixen,57,,90,124,214
011 Brixen,58,,103,111,214
011 Brixen,59,,97,97,194
011 Brixen,60,,89,98,187
011 Brixen,61,,75,90,165
011 Brixen,62,,85,85,170
011 Brixen,63,,87,99,186
011 Brixen,64,,83,70,153
011 Brixen,65,,76,84,160
011 Brixen,66,,77,89,166
011 Brixen,67,,82,100,182
011 Brixen,68,,62,105,167
011 Brixen,69,,68,81,149
011 Brixen,70,,54,99,153
011 Brixen,71,,60,82,142
011 Brixen,72,,60,85,145
011 Brixen,73,,54,92,146
011 Brixen,74,,56,71,127
011 Brixen,75,,48,89,137
011 Brixen,76,,44,88,132
011 Brixen,77,,44,78,122
011 Brixen,78,,32,56,88
011 Brixen,79,,21,38,59
011 Brixen,80,,18,43,61
011 Brixen,81,,14,28,42
011 Brixen,82,,17,42,59
011 Brixen,83,,26,56,82
011 Brixen,84,,13,56,69
011 Brixen,85,,21,47,68
011 Brixen,86,,10,42,52
011 Brixen,87,,13,43,56
011 Brixen,88,,11,24,35
011 Brixen,89,,10,28,38
011 Brixen,90,,4,20,24
011 Brixen,91,,3,19,22
011 Brixen,92,,4,13,17
011 Brixen,93,,1,4,5
011 Brixen,94,,2,3,5
011 Brixen,95,,-,12,12
011 Brixen,96,,1,8,9
011 Brixen,97,,-,8,8
011 Brixen,105,,-,1,1
011 Brixen,Insgesamt,,8.633,9.276,17.909
012 Branzoll,0,,10,21,31
012 Branzoll,1,,19,7,26
012 Branzoll,2,,12,11,23
012 Branzoll,3,,18,8,26
012 Branzoll,4,,16,15,31
012 Branzoll,5,,13,10,23
012 Branzoll,6,,11,17,28
012 Branzoll,7,,8,17,25
012 Branzoll,8,,11,11,22
012 Branzoll,9,,15,12,27
012 Branzoll,10,,11,5,16
012 Branzoll,11,,9,13,22
012 Branzoll,12,,13,15,28
012 Branzoll,13,,15,11,26
012 Branzoll,14,,13,11,24
012 Branzoll,15,,14,12,26
012 Branzoll,16,,13,13,26
012 Branzoll,17,,7,13,20
012 Branzoll,18,,11,6,17
012 Branzoll,19,,10,12,22
012 Branzoll,20,,11,11,22
012 Branzoll,21,,15,12,27
012 Branzoll,22,,11,13,24
012 Branzoll,23,,16,22,38
012 Branzoll,24,,18,15,33
012 Branzoll,25,,18,13,31
012 Branzoll,26,,17,13,30
012 Branzoll,27,,18,26,44
012 Branzoll,28,,25,19,44
012 Branzoll,29,,22,23,45
012 Branzoll,30,,21,17,38
012 Branzoll,31,,19,21,40
012 Branzoll,32,,19,23,42
012 Branzoll,33,,30,21,51
012 Branzoll,34,,18,16,34
012 Branzoll,35,,18,18,36
012 Branzoll,36,,27,29,56
012 Branzoll,37,,22,20,42
012 Branzoll,38,,12,23,35
012 Branzoll,39,,23,16,39
012 Branzoll,40,,27,18,45
012 Branzoll,41,,16,13,29
012 Branzoll,42,,16,16,32
012 Branzoll,43,,23,17,40
012 Branzoll,44,,14,23,37
012 Branzoll,45,,16,17,33
012 Branzoll,46,,14,14,28
012 Branzoll,47,,19,16,35
012 Branzoll,48,,15,16,31
012 Branzoll,49,,13,16,29
012 Branzoll,50,,13,15,28
012 Branzoll,51,,15,19,34
012 Branzoll,52,,14,7,21
012 Branzoll,53,,10,10,20
012 Branzoll,54,,14,11,25
012 Branzoll,55,,20,7,27
012 Branzoll,56,,17,12,29
012 Branzoll,57,,10,14,24
012 Branzoll,58,,16,12,28
012 Branzoll,59,,10,11,21
012 Branzoll,60,,5,12,17
012 Branzoll,61,,10,10,20
012 Branzoll,62,,7,11,18
012 Branzoll,63,,6,11,17
012 Branzoll,64,,19,12,31
012 Branzoll,65,,10,11,21
012 Branzoll,66,,5,10,15
012 Branzoll,67,,9,17,26
012 Branzoll,68,,7,11,18
012 Branzoll,69,,9,13,22
012 Branzoll,70,,4,8,12
012 Branzoll,71,,12,11,23
012 Branzoll,72,,7,6,13
012 Branzoll,73,,4,9,13
012 Branzoll,74,,10,12,22
012 Branzoll,75,,4,6,10
012 Branzoll,76,,5,11,16
012 Branzoll,77,,1,7,8
012 Branzoll,78,,3,6,9
012 Branzoll,79,,3,5,8
012 Branzoll,80,,-,3,3
012 Branzoll,81,,3,2,5
012 Branzoll,82,,3,3,6
012 Branzoll,83,,-,5,5
012 Branzoll,84,,3,7,10
012 Branzoll,85,,1,4,5
012 Branzoll,86,,4,4,8
012 Branzoll,87,,1,2,3
012 Branzoll,88,,1,4,5
012 Branzoll,89,,1,2,3
012 Branzoll,90,,3,2,5
012 Branzoll,91,,1,-,1
012 Branzoll,92,,-,2,2
012 Branzoll,93,,-,1,1
012 Branzoll,95,,-,1,1
012 Branzoll,Insgesamt,,1.102,1.136,2.238
013 Bruneck,0,,106,63,169
013 Bruneck,1,,81,80,161
013 Bruneck,2,,60,69,129
013 Bruneck,3,,84,72,156
013 Bruneck,4,,73,72,145
013 Bruneck,5,,88,76,164
013 Bruneck,6,,82,56,138
013 Bruneck,7,,86,68,154
013 Bruneck,8,,75,78,153
013 Bruneck,9,,62,72,134
013 Bruneck,10,,60,60,120
013 Bruneck,11,,99,68,167
013 Bruneck,12,,73,66,139
013 Bruneck,13,,76,72,148
013 Bruneck,14,,66,74,140
013 Bruneck,15,,70,71,141
013 Bruneck,16,,80,86,166
013 Bruneck,17,,99,88,187
013 Bruneck,18,,86,93,179
013 Bruneck,19,,114,89,203
013 Bruneck,20,,97,79,176
013 Bruneck,21,,86,96,182
013 Bruneck,22,,92,111,203
013 Bruneck,23,,114,95,209
013 Bruneck,24,,124,109,233
013 Bruneck,25,,107,113,220
013 Bruneck,26,,129,119,248
013 Bruneck,27,,108,119,227
013 Bruneck,28,,124,109,233
013 Bruneck,29,,118,136,254
013 Bruneck,30,,131,113,244
013 Bruneck,31,,123,101,224
013 Bruneck,32,,136,126,262
013 Bruneck,33,,128,125,253
013 Bruneck,34,,118,117,235
013 Bruneck,35,,112,102,214
013 Bruneck,36,,115,102,217
013 Bruneck,37,,102,112,214
013 Bruneck,38,,100,100,200
013 Bruneck,39,,103,106,209
013 Bruneck,40,,83,99,182
013 Bruneck,41,,84,91,175
013 Bruneck,42,,85,83,168
013 Bruneck,43,,93,86,179
013 Bruneck,44,,71,97,168
013 Bruneck,45,,82,101,183
013 Bruneck,46,,77,90,167
013 Bruneck,47,,87,94,181
013 Bruneck,48,,88,92,180
013 Bruneck,49,,86,111,197
013 Bruneck,50,,97,70,167
013 Bruneck,51,,100,84,184
013 Bruneck,52,,59,67,126
013 Bruneck,53,,91,94,185
013 Bruneck,54,,101,90,191
013 Bruneck,55,,95,90,185
013 Bruneck,56,,85,94,179
013 Bruneck,57,,83,85,168
013 Bruneck,58,,88,90,178
013 Bruneck,59,,62,55,117
013 Bruneck,60,,58,64,122
013 Bruneck,61,,57,57,114
013 Bruneck,62,,50,55,105
013 Bruneck,63,,49,49,98
013 Bruneck,64,,58,63,121
013 Bruneck,65,,63,52,115
013 Bruneck,66,,42,53,95
013 Bruneck,67,,46,70,116
013 Bruneck,68,,43,61,104
013 Bruneck,69,,46,62,108
013 Bruneck,70,,39,51,90
013 Bruneck,71,,35,41,76
013 Bruneck,72,,34,47,81
013 Bruneck,73,,24,66,90
013 Bruneck,74,,42,49,91
013 Bruneck,75,,34,50,84
013 Bruneck,76,,27,33,60
013 Bruneck,77,,24,47,71
013 Bruneck,78,,17,34,51
013 Bruneck,79,,11,25,36
013 Bruneck,80,,8,22,30
013 Bruneck,81,,9,32,41
013 Bruneck,82,,12,25,37
013 Bruneck,83,,11,28,39
013 Bruneck,84,,12,42,54
013 Bruneck,85,,14,27,41
013 Bruneck,86,,5,28,33
013 Bruneck,87,,8,19,27
013 Bruneck,88,,14,17,31
013 Bruneck,89,,7,13,20
013 Bruneck,90,,5,13,18
013 Bruneck,91,,4,14,18
013 Bruneck,92,,3,5,8
013 Bruneck,93,,3,2,5
013 Bruneck,94,,2,5,7
013 Bruneck,95,,-,4,4
013 Bruneck,97,,-,2,2
013 Bruneck,99,,-,2,2
013 Bruneck,100,,-,1,1
013 Bruneck,Insgesamt,,6.500,6.756,13.256
014 Kuens,0,,1,2,3
014 Kuens,1,,5,2,7
014 Kuens,2,,2,3,5
014 Kuens,3,,1,4,5
014 Kuens,4,,3,3,6
014 Kuens,5,,3,2,5
014 Kuens,6,,2,2,4
014 Kuens,7,,3,2,5
014 Kuens,8,,3,2,5
014 Kuens,9,,1,3,4
014 Kuens,10,,3,-,3
014 Kuens,11,,1,-,1
014 Kuens,13,,1,-,1
014 Kuens,14,,2,2,4
014 Kuens,15,,2,-,2
014 Kuens,16,,2,-,2
014 Kuens,17,,3,2,5
014 Kuens,18,,1,1,2
014 Kuens,19,,2,-,2
014 Kuens,20,,2,3,5
014 Kuens,21,,3,2,5
014 Kuens,22,,4,2,6
014 Kuens,23,,4,5,9
014 Kuens,24,,-,3,3
014 Kuens,25,,4,1,5
014 Kuens,26,,2,5,7
014 Kuens,27,,6,2,8
014 Kuens,28,,4,1,5
014 Kuens,29,,3,5,8
014 Kuens,30,,4,9,13
014 Kuens,31,,3,5,8
014 Kuens,32,,7,1,8
014 Kuens,33,,5,4,9
014 Kuens,34,,10,3,13
014 Kuens,35,,5,3,8
014 Kuens,36,,-,4,4
014 Kuens,37,,-,1,1
014 Kuens,38,,1,-,1
014 Kuens,39,,1,4,5
014 Kuens,40,,4,-,4
014 Kuens,41,,2,-,2
014 Kuens,42,,1,3,4
014 Kuens,44,,1,1,2
014 Kuens,45,,-,1,1
014 Kuens,46,,1,-,1
014 Kuens,47,,1,3,4
014 Kuens,48,,2,2,4
014 Kuens,49,,2,1,3
014 Kuens,50,,1,1,2
014 Kuens,51,,1,2,3
014 Kuens,52,,4,1,5
014 Kuens,54,,-,2,2
014 Kuens,55,,-,4,4
014 Kuens,56,,-,2,2
014 Kuens,57,,-,1,1
014 Kuens,58,,4,2,6
014 Kuens,59,,3,2,5
014 Kuens,60,,1,3,4
014 Kuens,61,,2,3,5
014 Kuens,62,,1,3,4
014 Kuens,63,,-,1,1
014 Kuens,64,,2,1,3
014 Kuens,65,,4,2,6
014 Kuens,66,,3,2,5
014 Kuens,67,,3,2,5
014 Kuens,68,,1,-,1
014 Kuens,69,,1,-,1
014 Kuens,70,,1,1,2
014 Kuens,71,,1,-,1
014 Kuens,75,,-,2,2
014 Kuens,76,,-,1,1
014 Kuens,78,,-,1,1
014 Kuens,81,,1,1,2
014 Kuens,82,,1,-,1
014 Kuens,84,,-,1,1
014 Kuens,85,,1,-,1
014 Kuens,87,,1,-,1
014 Kuens,89,,-,1,1
014 Kuens,90,,-,1,1
014 Kuens,Insgesamt,,160,147,307
015 Kaltern a.d. Weinstr.,0,,41,42,83
015 Kaltern a.d. Weinstr.,1,,33,42,75
015 Kaltern a.d. Weinstr.,2,,36,34,70
015 Kaltern a.d. Weinstr.,3,,29,37,66
015 Kaltern a.d. Weinstr.,4,,33,37,70
015 Kaltern a.d. Weinstr.,5,,40,35,75
015 Kaltern a.d. Weinstr.,6,,29,43,72
015 Kaltern a.d. Weinstr.,7,,37,36,73
015 Kaltern a.d. Weinstr.,8,,53,24,77
015 Kaltern a.d. Weinstr.,9,,39,33,72
015 Kaltern a.d. Weinstr.,10,,41,31,72
015 Kaltern a.d. Weinstr.,11,,50,40,90
015 Kaltern a.d. Weinstr.,12,,48,36,84
015 Kaltern a.d. Weinstr.,13,,38,33,71
015 Kaltern a.d. Weinstr.,14,,42,37,79
015 Kaltern a.d. Weinstr.,15,,43,43,86
015 Kaltern a.d. Weinstr.,16,,44,34,78
015 Kaltern a.d. Weinstr.,17,,40,41,81
015 Kaltern a.d. Weinstr.,18,,45,39,84
015 Kaltern a.d. Weinstr.,19,,42,27,69
015 Kaltern a.d. Weinstr.,20,,27,37,64
015 Kaltern a.d. Weinstr.,21,,35,43,78
015 Kaltern a.d. Weinstr.,22,,34,43,77
015 Kaltern a.d. Weinstr.,23,,51,45,96
015 Kaltern a.d. Weinstr.,24,,34,50,84
015 Kaltern a.d. Weinstr.,25,,42,50,92
015 Kaltern a.d. Weinstr.,26,,51,34,85
015 Kaltern a.d. Weinstr.,27,,57,62,119
015 Kaltern a.d. Weinstr.,28,,53,61,114
015 Kaltern a.d. Weinstr.,29,,62,64,126
015 Kaltern a.d. Weinstr.,30,,54,53,107
015 Kaltern a.d. Weinstr.,31,,58,62,120
015 Kaltern a.d. Weinstr.,32,,56,60,116
015 Kaltern a.d. Weinstr.,33,,82,54,136
015 Kaltern a.d. Weinstr.,34,,57,55,112
015 Kaltern a.d. Weinstr.,35,,59,63,122
015 Kaltern a.d. Weinstr.,36,,66,61,127
015 Kaltern a.d. Weinstr.,37,,53,63,116
015 Kaltern a.d. Weinstr.,38,,51,50,101
015 Kaltern a.d. Weinstr.,39,,58,56,114
015 Kaltern a.d. Weinstr.,40,,49,53,102
015 Kaltern a.d. Weinstr.,41,,62,45,107
015 Kaltern a.d. Weinstr.,42,,56,39,95
015 Kaltern a.d. Weinstr.,43,,37,50,87
015 Kaltern a.d. Weinstr.,44,,35,36,71
015 Kaltern a.d. Weinstr.,45,,40,51,91
015 Kaltern a.d. Weinstr.,46,,36,33,69
015 Kaltern a.d. Weinstr.,47,,46,34,80
015 Kaltern a.d. Weinstr.,48,,30,39,69
015 Kaltern a.d. Weinstr.,49,,40,39,79
015 Kaltern a.d. Weinstr.,50,,39,56,95
015 Kaltern a.d. Weinstr.,51,,54,39,93
015 Kaltern a.d. Weinstr.,52,,38,38,76
015 Kaltern a.d. Weinstr.,53,,45,44,89
015 Kaltern a.d. Weinstr.,54,,36,37,73
015 Kaltern a.d. Weinstr.,55,,38,44,82
015 Kaltern a.d. Weinstr.,56,,43,43,86
015 Kaltern a.d. Weinstr.,57,,33,40,73
015 Kaltern a.d. Weinstr.,58,,24,32,56
015 Kaltern a.d. Weinstr.,59,,41,42,83
015 Kaltern a.d. Weinstr.,60,,31,34,65
015 Kaltern a.d. Weinstr.,61,,22,24,46
015 Kaltern a.d. Weinstr.,62,,27,26,53
015 Kaltern a.d. Weinstr.,63,,28,26,54
015 Kaltern a.d. Weinstr.,64,,31,37,68
015 Kaltern a.d. Weinstr.,65,,31,31,62
015 Kaltern a.d. Weinstr.,66,,27,39,66
015 Kaltern a.d. Weinstr.,67,,35,43,78
015 Kaltern a.d. Weinstr.,68,,28,32,60
015 Kaltern a.d. Weinstr.,69,,25,35,60
015 Kaltern a.d. Weinstr.,70,,23,41,64
015 Kaltern a.d. Weinstr.,71,,22,32,54
015 Kaltern a.d. Weinstr.,72,,24,41,65
015 Kaltern a.d. Weinstr.,73,,25,32,57
015 Kaltern a.d. Weinstr.,74,,14,35,49
015 Kaltern a.d. Weinstr.,75,,21,34,55
015 Kaltern a.d. Weinstr.,76,,19,38,57
015 Kaltern a.d. Weinstr.,77,,13,31,44
015 Kaltern a.d. Weinstr.,78,,10,20,30
015 Kaltern a.d. Weinstr.,79,,9,11,20
015 Kaltern a.d. Weinstr.,80,,3,15,18
015 Kaltern a.d. Weinstr.,81,,3,9,12
015 Kaltern a.d. Weinstr.,82,,3,20,23
015 Kaltern a.d. Weinstr.,83,,9,17,26
015 Kaltern a.d. Weinstr.,84,,10,21,31
015 Kaltern a.d. Weinstr.,85,,8,28,36
015 Kaltern a.d. Weinstr.,86,,3,12,15
015 Kaltern a.d. Weinstr.,87,,4,9,13
015 Kaltern a.d. Weinstr.,88,,4,14,18
015 Kaltern a.d. Weinstr.,89,,4,5,9
015 Kaltern a.d. Weinstr.,90,,-,11,11
015 Kaltern a.d. Weinstr.,91,,1,5,6
015 Kaltern a.d. Weinstr.,92,,1,5,6
015 Kaltern a.d. Weinstr.,93,,2,2,4
015 Kaltern a.d. Weinstr.,94,,1,3,4
015 Kaltern a.d. Weinstr.,96,,-,1,1
015 Kaltern a.d. Weinstr.,Insgesamt,,3.186,3.443,6.629
016 Freienfeld,0,,21,14,35
016 Freienfeld,1,,22,11,33
016 Freienfeld,2,,15,14,29
016 Freienfeld,3,,12,9,21
016 Freienfeld,4,,16,10,26
016 Freienfeld,5,,19,22,41
016 Freienfeld,6,,12,12,24
016 Freienfeld,7,,19,18,37
016 Freienfeld,8,,26,21,47
016 Freienfeld,9,,18,13,31
016 Freienfeld,10,,15,15,30
016 Freienfeld,11,,15,13,28
016 Freienfeld,12,,15,14,29
016 Freienfeld,13,,23,15,38
016 Freienfeld,14,,21,19,40
016 Freienfeld,15,,14,16,30
016 Freienfeld,16,,24,22,46
016 Freienfeld,17,,18,15,33
016 Freienfeld,18,,19,20,39
016 Freienfeld,19,,13,18,31
016 Freienfeld,20,,15,17,32
016 Freienfeld,21,,17,11,28
016 Freienfeld,22,,17,24,41
016 Freienfeld,23,,19,18,37
016 Freienfeld,24,,19,18,37
016 Freienfeld,25,,22,24,46
016 Freienfeld,26,,23,23,46
016 Freienfeld,27,,22,17,39
016 Freienfeld,28,,20,19,39
016 Freienfeld,29,,22,24,46
016 Freienfeld,30,,20,27,47
016 Freienfeld,31,,22,17,39
016 Freienfeld,32,,27,15,42
016 Freienfeld,33,,27,19,46
016 Freienfeld,34,,21,16,37
016 Freienfeld,35,,24,32,56
016 Freienfeld,36,,25,20,45
016 Freienfeld,37,,26,22,48
016 Freienfeld,38,,31,13,44
016 Freienfeld,39,,18,18,36
016 Freienfeld,40,,13,17,30
016 Freienfeld,41,,22,15,37
016 Freienfeld,42,,20,10,30
016 Freienfeld,43,,18,18,36
016 Freienfeld,44,,19,10,29
016 Freienfeld,45,,12,20,32
016 Freienfeld,46,,15,12,27
016 Freienfeld,47,,21,11,32
016 Freienfeld,48,,18,13,31
016 Freienfeld,49,,17,12,29
016 Freienfeld,50,,7,13,20
016 Freienfeld,51,,10,16,26
016 Freienfeld,52,,13,2,15
016 Freienfeld,53,,12,6,18
016 Freienfeld,54,,15,12,27
016 Freienfeld,55,,13,10,23
016 Freienfeld,56,,11,11,22
016 Freienfeld,57,,13,4,17
016 Freienfeld,58,,11,10,21
016 Freienfeld,59,,12,12,24
016 Freienfeld,60,,8,11,19
016 Freienfeld,61,,9,13,22
016 Freienfeld,62,,10,12,22
016 Freienfeld,63,,5,7,12
016 Freienfeld,64,,13,8,21
016 Freienfeld,65,,13,10,23
016 Freienfeld,66,,9,9,18
016 Freienfeld,67,,9,8,17
016 Freienfeld,68,,6,7,13
016 Freienfeld,69,,9,7,16
016 Freienfeld,70,,7,9,16
016 Freienfeld,71,,9,15,24
016 Freienfeld,72,,8,10,18
016 Freienfeld,73,,10,7,17
016 Freienfeld,74,,3,17,20
016 Freienfeld,75,,3,10,13
016 Freienfeld,76,,3,3,6
016 Freienfeld,77,,9,5,14
016 Freienfeld,78,,3,4,7
016 Freienfeld,79,,3,5,8
016 Freienfeld,80,,1,5,6
016 Freienfeld,81,,2,3,5
016 Freienfeld,82,,1,5,6
016 Freienfeld,83,,4,10,14
016 Freienfeld,84,,3,3,6
016 Freienfeld,85,,1,3,4
016 Freienfeld,86,,4,4,8
016 Freienfeld,87,,3,2,5
016 Freienfeld,88,,1,1,2
016 Freienfeld,89,,-,4,4
016 Freienfeld,90,,2,4,6
016 Freienfeld,91,,-,3,3
016 Freienfeld,92,,-,2,2
016 Freienfeld,95,,-,1,1
016 Freienfeld,Insgesamt,,1.257,1.166,2.423
017 Sand in Taufers,0,,36,37,73
017 Sand in Taufers,1,,24,30,54
017 Sand in Taufers,2,,27,29,56
017 Sand in Taufers,3,,41,32,73
017 Sand in Taufers,4,,24,33,57
017 Sand in Taufers,5,,30,35,65
017 Sand in Taufers,6,,26,33,59
017 Sand in Taufers,7,,23,31,54
017 Sand in Taufers,8,,27,29,56
017 Sand in Taufers,9,,28,29,57
017 Sand in Taufers,10,,22,23,45
017 Sand in Taufers,11,,21,20,41
017 Sand in Taufers,12,,23,25,48
017 Sand in Taufers,13,,31,24,55
017 Sand in Taufers,14,,35,29,64
017 Sand in Taufers,15,,24,39,63
017 Sand in Taufers,16,,36,34,70
017 Sand in Taufers,17,,31,36,67
017 Sand in Taufers,18,,31,39,70
017 Sand in Taufers,19,,38,34,72
017 Sand in Taufers,20,,36,36,72
017 Sand in Taufers,21,,41,34,75
017 Sand in Taufers,22,,44,43,87
017 Sand in Taufers,23,,59,40,99
017 Sand in Taufers,24,,58,37,95
017 Sand in Taufers,25,,50,54,104
017 Sand in Taufers,26,,43,46,89
017 Sand in Taufers,27,,39,56,95
017 Sand in Taufers,28,,54,40,94
017 Sand in Taufers,29,,49,40,89
017 Sand in Taufers,30,,29,42,71
017 Sand in Taufers,31,,52,32,84
017 Sand in Taufers,32,,48,33,81
017 Sand in Taufers,33,,50,42,92
017 Sand in Taufers,34,,51,47,98
017 Sand in Taufers,35,,36,37,73
017 Sand in Taufers,36,,44,39,83
017 Sand in Taufers,37,,41,34,75
017 Sand in Taufers,38,,41,36,77
017 Sand in Taufers,39,,36,23,59
017 Sand in Taufers,40,,23,39,62
017 Sand in Taufers,41,,29,36,65
017 Sand in Taufers,42,,26,21,47
017 Sand in Taufers,43,,28,27,55
017 Sand in Taufers,44,,34,24,58
017 Sand in Taufers,45,,18,30,48
017 Sand in Taufers,46,,30,24,54
017 Sand in Taufers,47,,33,33,66
017 Sand in Taufers,48,,32,22,54
017 Sand in Taufers,49,,23,26,49
017 Sand in Taufers,50,,25,27,52
017 Sand in Taufers,51,,29,25,54
017 Sand in Taufers,52,,29,9,38
017 Sand in Taufers,53,,18,28,46
017 Sand in Taufers,54,,30,32,62
017 Sand in Taufers,55,,31,35,66
017 Sand in Taufers,56,,27,32,59
017 Sand in Taufers,57,,25,21,46
017 Sand in Taufers,58,,28,31,59
017 Sand in Taufers,59,,19,27,46
017 Sand in Taufers,60,,29,13,42
017 Sand in Taufers,61,,17,25,42
017 Sand in Taufers,62,,34,17,51
017 Sand in Taufers,63,,15,15,30
017 Sand in Taufers,64,,17,17,34
017 Sand in Taufers,65,,13,17,30
017 Sand in Taufers,66,,15,14,29
017 Sand in Taufers,67,,16,19,35
017 Sand in Taufers,68,,18,15,33
017 Sand in Taufers,69,,14,17,31
017 Sand in Taufers,70,,19,13,32
017 Sand in Taufers,71,,12,20,32
017 Sand in Taufers,72,,11,15,26
017 Sand in Taufers,73,,9,18,27
017 Sand in Taufers,74,,15,13,28
017 Sand in Taufers,75,,13,18,31
017 Sand in Taufers,76,,8,20,28
017 Sand in Taufers,77,,10,11,21
017 Sand in Taufers,78,,7,11,18
017 Sand in Taufers,79,,3,8,11
017 Sand in Taufers,80,,5,12,17
017 Sand in Taufers,81,,-,7,7
017 Sand in Taufers,82,,3,9,12
017 Sand in Taufers,83,,7,14,21
017 Sand in Taufers,84,,-,13,13
017 Sand in Taufers,85,,2,6,8
017 Sand in Taufers,86,,3,8,11
017 Sand in Taufers,87,,-,2,2
017 Sand in Taufers,88,,2,8,10
017 Sand in Taufers,89,,2,2,4
017 Sand in Taufers,90,,3,5,8
017 Sand in Taufers,91,,1,3,4
017 Sand in Taufers,92,,1,-,1
017 Sand in Taufers,93,,-,1,1
017 Sand in Taufers,96,,1,-,1
017 Sand in Taufers,98,,-,1,1
017 Sand in Taufers,Insgesamt,,2.341,2.368,4.709
018 Kastelbell-Tschars,0,,9,9,18
018 Kastelbell-Tschars,1,,13,17,30
018 Kastelbell-Tschars,2,,14,11,25
018 Kastelbell-Tschars,3,,13,15,28
018 Kastelbell-Tschars,4,,13,15,28
018 Kastelbell-Tschars,5,,15,15,30
018 Kastelbell-Tschars,6,,19,13,32
018 Kastelbell-Tschars,7,,16,11,27
018 Kastelbell-Tschars,8,,16,10,26
018 Kastelbell-Tschars,9,,18,9,27
018 Kastelbell-Tschars,10,,18,15,33
018 Kastelbell-Tschars,11,,18,21,39
018 Kastelbell-Tschars,12,,21,15,36
018 Kastelbell-Tschars,13,,6,10,16
018 Kastelbell-Tschars,14,,13,23,36
018 Kastelbell-Tschars,15,,24,13,37
018 Kastelbell-Tschars,16,,15,22,37
018 Kastelbell-Tschars,17,,18,18,36
018 Kastelbell-Tschars,18,,16,16,32
018 Kastelbell-Tschars,19,,13,27,40
018 Kastelbell-Tschars,20,,10,19,29
018 Kastelbell-Tschars,21,,20,16,36
018 Kastelbell-Tschars,22,,17,15,32
018 Kastelbell-Tschars,23,,20,14,34
018 Kastelbell-Tschars,24,,24,20,44
018 Kastelbell-Tschars,25,,12,16,28
018 Kastelbell-Tschars,26,,16,13,29
018 Kastelbell-Tschars,27,,17,21,38
018 Kastelbell-Tschars,28,,24,23,47
018 Kastelbell-Tschars,29,,17,17,34
018 Kastelbell-Tschars,30,,14,23,37
018 Kastelbell-Tschars,31,,25,13,38
018 Kastelbell-Tschars,32,,22,18,40
018 Kastelbell-Tschars,33,,24,15,39
018 Kastelbell-Tschars,34,,23,20,43
018 Kastelbell-Tschars,35,,8,24,32
018 Kastelbell-Tschars,36,,19,19,38
018 Kastelbell-Tschars,37,,24,19,43
018 Kastelbell-Tschars,38,,25,17,42
018 Kastelbell-Tschars,39,,18,14,32
018 Kastelbell-Tschars,40,,15,11,26
018 Kastelbell-Tschars,41,,12,20,32
018 Kastelbell-Tschars,42,,17,19,36
018 Kastelbell-Tschars,43,,9,13,22
018 Kastelbell-Tschars,44,,10,15,25
018 Kastelbell-Tschars,45,,12,18,30
018 Kastelbell-Tschars,46,,16,13,29
018 Kastelbell-Tschars,47,,13,14,27
018 Kastelbell-Tschars,48,,11,8,19
018 Kastelbell-Tschars,49,,16,9,25
018 Kastelbell-Tschars,50,,10,9,19
018 Kastelbell-Tschars,51,,15,13,28
018 Kastelbell-Tschars,52,,10,4,14
018 Kastelbell-Tschars,53,,11,7,18
018 Kastelbell-Tschars,54,,10,8,18
018 Kastelbell-Tschars,55,,10,12,22
018 Kastelbell-Tschars,56,,11,8,19
018 Kastelbell-Tschars,57,,9,10,19
018 Kastelbell-Tschars,58,,14,15,29
018 Kastelbell-Tschars,59,,8,15,23
018 Kastelbell-Tschars,60,,12,11,23
018 Kastelbell-Tschars,61,,10,17,27
018 Kastelbell-Tschars,62,,11,11,22
018 Kastelbell-Tschars,63,,6,16,22
018 Kastelbell-Tschars,64,,19,13,32
018 Kastelbell-Tschars,65,,8,14,22
018 Kastelbell-Tschars,66,,10,14,24
018 Kastelbell-Tschars,67,,23,17,40
018 Kastelbell-Tschars,68,,11,14,25
018 Kastelbell-Tschars,69,,10,11,21
018 Kastelbell-Tschars,70,,11,9,20
018 Kastelbell-Tschars,71,,15,17,32
018 Kastelbell-Tschars,72,,14,15,29
018 Kastelbell-Tschars,73,,5,12,17
018 Kastelbell-Tschars,74,,13,10,23
018 Kastelbell-Tschars,75,,7,10,17
018 Kastelbell-Tschars,76,,4,8,12
018 Kastelbell-Tschars,77,,5,9,14
018 Kastelbell-Tschars,78,,2,5,7
018 Kastelbell-Tschars,79,,2,4,6
018 Kastelbell-Tschars,80,,3,4,7
018 Kastelbell-Tschars,81,,-,5,5
018 Kastelbell-Tschars,82,,7,4,11
018 Kastelbell-Tschars,83,,4,8,12
018 Kastelbell-Tschars,84,,7,4,11
018 Kastelbell-Tschars,85,,1,5,6
018 Kastelbell-Tschars,86,,3,5,8
018 Kastelbell-Tschars,87,,-,3,3
018 Kastelbell-Tschars,88,,2,-,2
018 Kastelbell-Tschars,89,,-,7,7
018 Kastelbell-Tschars,90,,-,1,1
018 Kastelbell-Tschars,92,,1,-,1
018 Kastelbell-Tschars,93,,1,2,3
018 Kastelbell-Tschars,95,,-,1,1
018 Kastelbell-Tschars,97,,-,1,1
018 Kastelbell-Tschars,Insgesamt,,1.153,1.189,2.342
019 Kastelruth,0,,51,51,102
019 Kastelruth,1,,41,37,78
019 Kastelruth,2,,55,42,97
019 Kastelruth,3,,32,32,64
019 Kastelruth,4,,39,33,72
019 Kastelruth,5,,37,51,88
019 Kastelruth,6,,36,41,77
019 Kastelruth,7,,37,36,73
019 Kastelruth,8,,45,39,84
019 Kastelruth,9,,28,24,52
019 Kastelruth,10,,37,41,78
019 Kastelruth,11,,33,23,56
019 Kastelruth,12,,27,33,60
019 Kastelruth,13,,35,29,64
019 Kastelruth,14,,34,43,77
019 Kastelruth,15,,44,33,77
019 Kastelruth,16,,36,40,76
019 Kastelruth,17,,45,37,82
019 Kastelruth,18,,30,43,73
019 Kastelruth,19,,32,40,72
019 Kastelruth,20,,37,38,75
019 Kastelruth,21,,43,44,87
019 Kastelruth,22,,52,35,87
019 Kastelruth,23,,53,52,105
019 Kastelruth,24,,41,64,105
019 Kastelruth,25,,62,45,107
019 Kastelruth,26,,57,49,106
019 Kastelruth,27,,52,66,118
019 Kastelruth,28,,64,61,125
019 Kastelruth,29,,62,58,120
019 Kastelruth,30,,70,68,138
019 Kastelruth,31,,68,50,118
019 Kastelruth,32,,45,75,120
019 Kastelruth,33,,55,43,98
019 Kastelruth,34,,54,35,89
019 Kastelruth,35,,37,51,88
019 Kastelruth,36,,50,43,93
019 Kastelruth,37,,51,42,93
019 Kastelruth,38,,47,46,93
019 Kastelruth,39,,48,43,91
019 Kastelruth,40,,37,36,73
019 Kastelruth,41,,35,29,64
019 Kastelruth,42,,38,36,74
019 Kastelruth,43,,35,29,64
019 Kastelruth,44,,30,31,61
019 Kastelruth,45,,38,26,64
019 Kastelruth,46,,31,26,57
019 Kastelruth,47,,41,18,59
019 Kastelruth,48,,20,34,54
019 Kastelruth,49,,29,38,67
019 Kastelruth,50,,35,33,68
019 Kastelruth,51,,22,39,61
019 Kastelruth,52,,24,21,45
019 Kastelruth,53,,20,45,65
019 Kastelruth,54,,42,36,78
019 Kastelruth,55,,35,29,64
019 Kastelruth,56,,35,46,81
019 Kastelruth,57,,30,37,67
019 Kastelruth,58,,28,28,56
019 Kastelruth,59,,30,27,57
019 Kastelruth,60,,27,24,51
019 Kastelruth,61,,34,21,55
019 Kastelruth,62,,33,31,64
019 Kastelruth,63,,24,22,46
019 Kastelruth,64,,35,29,64
019 Kastelruth,65,,21,38,59
019 Kastelruth,66,,40,28,68
019 Kastelruth,67,,14,28,42
019 Kastelruth,68,,29,27,56
019 Kastelruth,69,,17,22,39
019 Kastelruth,70,,28,32,60
019 Kastelruth,71,,16,26,42
019 Kastelruth,72,,13,24,37
019 Kastelruth,73,,21,23,44
019 Kastelruth,74,,11,22,33
019 Kastelruth,75,,14,17,31
019 Kastelruth,76,,12,23,35
019 Kastelruth,77,,13,20,33
019 Kastelruth,78,,12,10,22
019 Kastelruth,79,,6,14,20
019 Kastelruth,80,,6,7,13
019 Kastelruth,81,,2,6,8
019 Kastelruth,82,,4,13,17
019 Kastelruth,83,,11,9,20
019 Kastelruth,84,,9,11,20
019 Kastelruth,85,,9,13,22
019 Kastelruth,86,,7,13,20
019 Kastelruth,87,,2,9,11
019 Kastelruth,88,,2,8,10
019 Kastelruth,89,,2,4,6
019 Kastelruth,90,,4,7,11
019 Kastelruth,91,,1,6,7
019 Kastelruth,92,,1,4,5
019 Kastelruth,93,,2,2,4
019 Kastelruth,94,,-,2,2
019 Kastelruth,96,,-,2,2
019 Kastelruth,97,,-,2,2
019 Kastelruth,Insgesamt,,2.919,2.999,5.918
020 Tscherms,0,,5,9,14
020 Tscherms,1,,4,5,9
020 Tscherms,2,,9,9,18
020 Tscherms,3,,10,16,26
020 Tscherms,4,,6,6,12
020 Tscherms,5,,10,6,16
020 Tscherms,6,,4,8,12
020 Tscherms,7,,7,4,11
020 Tscherms,8,,4,5,9
020 Tscherms,9,,4,16,20
020 Tscherms,10,,11,5,16
020 Tscherms,11,,8,6,14
020 Tscherms,12,,12,10,22
020 Tscherms,13,,11,5,16
020 Tscherms,14,,10,9,19
020 Tscherms,15,,5,8,13
020 Tscherms,16,,8,8,16
020 Tscherms,17,,6,6,12
020 Tscherms,18,,3,6,9
020 Tscherms,19,,2,6,8
020 Tscherms,20,,7,1,8
020 Tscherms,21,,7,5,12
020 Tscherms,22,,4,4,8
020 Tscherms,23,,8,2,10
020 Tscherms,24,,8,11,19
020 Tscherms,25,,4,4,8
020 Tscherms,26,,8,9,17
020 Tscherms,27,,7,5,12
020 Tscherms,28,,10,16,26
020 Tscherms,29,,15,9,24
020 Tscherms,30,,12,11,23
020 Tscherms,31,,10,8,18
020 Tscherms,32,,12,16,28
020 Tscherms,33,,12,12,24
020 Tscherms,34,,18,11,29
020 Tscherms,35,,12,8,20
020 Tscherms,36,,9,9,18
020 Tscherms,37,,8,11,19
020 Tscherms,38,,6,16,22
020 Tscherms,39,,11,7,18
020 Tscherms,40,,10,8,18
020 Tscherms,41,,9,8,17
020 Tscherms,42,,12,8,20
020 Tscherms,43,,7,9,16
020 Tscherms,44,,8,3,11
020 Tscherms,45,,13,5,18
020 Tscherms,46,,6,10,16
020 Tscherms,47,,8,7,15
020 Tscherms,48,,4,3,7
020 Tscherms,49,,7,5,12
020 Tscherms,50,,8,7,15
020 Tscherms,51,,4,7,11
020 Tscherms,52,,5,8,13
020 Tscherms,53,,6,10,16
020 Tscherms,54,,9,6,15
020 Tscherms,55,,7,2,9
020 Tscherms,56,,11,7,18
020 Tscherms,57,,5,5,10
020 Tscherms,58,,3,4,7
020 Tscherms,59,,6,2,8
020 Tscherms,60,,5,8,13
020 Tscherms,61,,5,6,11
020 Tscherms,62,,5,7,12
020 Tscherms,63,,2,9,11
020 Tscherms,64,,6,2,8
020 Tscherms,65,,6,5,11
020 Tscherms,66,,2,3,5
020 Tscherms,67,,4,5,9
020 Tscherms,68,,3,4,7
020 Tscherms,69,,5,6,11
020 Tscherms,70,,9,5,14
020 Tscherms,71,,4,2,6
020 Tscherms,72,,5,6,11
020 Tscherms,73,,4,7,11
020 Tscherms,74,,1,3,4
020 Tscherms,75,,2,7,9
020 Tscherms,76,,6,4,10
020 Tscherms,77,,6,4,10
020 Tscherms,78,,-,2,2
020 Tscherms,79,,3,2,5
020 Tscherms,80,,1,2,3
020 Tscherms,81,,1,2,3
020 Tscherms,82,,2,2,4
020 Tscherms,83,,3,3,6
020 Tscherms,84,,-,6,6
020 Tscherms,85,,3,-,3
020 Tscherms,86,,-,2,2
020 Tscherms,87,,1,1,2
020 Tscherms,89,,-,1,1
020 Tscherms,90,,-,2,2
020 Tscherms,91,,1,1,2
020 Tscherms,92,,-,1,1
020 Tscherms,94,,-,1,1
020 Tscherms,Insgesamt,,570,573,1.143
021 Kiens,0,,20,11,31
021 Kiens,1,,17,19,36
021 Kiens,2,,14,22,36
021 Kiens,3,,17,20,37
021 Kiens,4,,17,17,34
021 Kiens,5,,25,17,42
021 Kiens,6,,13,25,38
021 Kiens,7,,15,20,35
021 Kiens,8,,14,17,31
021 Kiens,9,,13,15,28
021 Kiens,10,,12,12,24
021 Kiens,11,,18,11,29
021 Kiens,12,,19,13,32
021 Kiens,13,,16,11,27
021 Kiens,14,,13,18,31
021 Kiens,15,,22,17,39
021 Kiens,16,,14,21,35
021 Kiens,17,,17,21,38
021 Kiens,18,,15,21,36
021 Kiens,19,,29,17,46
021 Kiens,20,,18,15,33
021 Kiens,21,,28,19,47
021 Kiens,22,,20,23,43
021 Kiens,23,,19,20,39
021 Kiens,24,,32,27,59
021 Kiens,25,,27,23,50
021 Kiens,26,,31,33,64
021 Kiens,27,,22,28,50
021 Kiens,28,,34,24,58
021 Kiens,29,,43,20,63
021 Kiens,30,,24,27,51
021 Kiens,31,,24,26,50
021 Kiens,32,,18,19,37
021 Kiens,33,,34,21,55
021 Kiens,34,,18,23,41
021 Kiens,35,,32,18,50
021 Kiens,36,,21,23,44
021 Kiens,37,,20,20,40
021 Kiens,38,,26,17,43
021 Kiens,39,,15,12,27
021 Kiens,40,,12,18,30
021 Kiens,41,,18,13,31
021 Kiens,42,,16,10,26
021 Kiens,43,,12,15,27
021 Kiens,44,,14,23,37
021 Kiens,45,,12,10,22
021 Kiens,46,,12,12,24
021 Kiens,47,,19,11,30
021 Kiens,48,,9,14,23
021 Kiens,49,,11,17,28
021 Kiens,50,,15,14,29
021 Kiens,51,,19,14,33
021 Kiens,52,,8,12,20
021 Kiens,53,,11,13,24
021 Kiens,54,,23,12,35
021 Kiens,55,,20,12,32
021 Kiens,56,,21,11,32
021 Kiens,57,,14,16,30
021 Kiens,58,,14,9,23
021 Kiens,59,,16,14,30
021 Kiens,60,,11,13,24
021 Kiens,61,,11,12,23
021 Kiens,62,,5,19,24
021 Kiens,63,,9,14,23
021 Kiens,64,,12,8,20
021 Kiens,65,,17,12,29
021 Kiens,66,,17,9,26
021 Kiens,67,,10,13,23
021 Kiens,68,,8,9,17
021 Kiens,69,,4,8,12
021 Kiens,70,,9,7,16
021 Kiens,71,,3,4,7
021 Kiens,72,,6,5,11
021 Kiens,73,,5,7,12
021 Kiens,74,,10,6,16
021 Kiens,75,,4,6,10
021 Kiens,76,,2,7,9
021 Kiens,77,,5,4,9
021 Kiens,78,,1,4,5
021 Kiens,79,,1,2,3
021 Kiens,80,,1,4,5
021 Kiens,81,,-,4,4
021 Kiens,82,,2,4,6
021 Kiens,83,,4,5,9
021 Kiens,84,,5,4,9
021 Kiens,85,,1,4,5
021 Kiens,86,,3,2,5
021 Kiens,87,,5,2,7
021 Kiens,88,,2,-,2
021 Kiens,89,,1,2,3
021 Kiens,90,,1,4,5
021 Kiens,91,,2,-,2
021 Kiens,92,,-,1,1
021 Kiens,95,,-,1,1
021 Kiens,96,,1,-,1
021 Kiens,Insgesamt,,1.320,1.259,2.579
022 Klausen,0,,36,31,67
022 Klausen,1,,25,26,51
022 Klausen,2,,33,22,55
022 Klausen,3,,18,35,53
022 Klausen,4,,30,24,54
022 Klausen,5,,39,27,66
022 Klausen,6,,33,32,65
022 Klausen,7,,34,22,56
022 Klausen,8,,31,27,58
022 Klausen,9,,28,30,58
022 Klausen,10,,19,33,52
022 Klausen,11,,33,30,63
022 Klausen,12,,36,36,72
022 Klausen,13,,34,27,61
022 Klausen,14,,26,38,64
022 Klausen,15,,38,34,72
022 Klausen,16,,36,30,66
022 Klausen,17,,26,35,61
022 Klausen,18,,31,38,69
022 Klausen,19,,39,40,79
022 Klausen,20,,32,29,61
022 Klausen,21,,36,21,57
022 Klausen,22,,36,35,71
022 Klausen,23,,34,23,57
022 Klausen,24,,43,24,67
022 Klausen,25,,32,41,73
022 Klausen,26,,48,35,83
022 Klausen,27,,44,42,86
022 Klausen,28,,47,48,95
022 Klausen,29,,54,41,95
022 Klausen,30,,47,47,94
022 Klausen,31,,61,40,101
022 Klausen,32,,46,40,86
022 Klausen,33,,40,48,88
022 Klausen,34,,37,40,77
022 Klausen,35,,25,40,65
022 Klausen,36,,53,38,91
022 Klausen,37,,39,29,68
022 Klausen,38,,31,36,67
022 Klausen,39,,27,26,53
022 Klausen,40,,30,27,57
022 Klausen,41,,31,24,55
022 Klausen,42,,32,31,63
022 Klausen,43,,31,40,71
022 Klausen,44,,20,30,50
022 Klausen,45,,28,16,44
022 Klausen,46,,32,27,59
022 Klausen,47,,32,24,56
022 Klausen,48,,31,26,57
022 Klausen,49,,29,26,55
022 Klausen,50,,26,21,47
022 Klausen,51,,29,21,50
022 Klausen,52,,12,16,28
022 Klausen,53,,21,18,39
022 Klausen,54,,23,28,51
022 Klausen,55,,22,27,49
022 Klausen,56,,30,20,50
022 Klausen,57,,26,22,48
022 Klausen,58,,26,20,46
022 Klausen,59,,17,20,37
022 Klausen,60,,17,19,36
022 Klausen,61,,21,23,44
022 Klausen,62,,16,22,38
022 Klausen,63,,18,16,34
022 Klausen,64,,23,18,41
022 Klausen,65,,11,22,33
022 Klausen,66,,12,15,27
022 Klausen,67,,11,19,30
022 Klausen,68,,23,23,46
022 Klausen,69,,11,19,30
022 Klausen,70,,11,15,26
022 Klausen,71,,16,14,30
022 Klausen,72,,14,9,23
022 Klausen,73,,15,18,33
022 Klausen,74,,6,18,24
022 Klausen,75,,8,17,25
022 Klausen,76,,5,15,20
022 Klausen,77,,6,17,23
022 Klausen,78,,3,13,16
022 Klausen,79,,5,13,18
022 Klausen,80,,3,11,14
022 Klausen,81,,4,6,10
022 Klausen,82,,7,4,11
022 Klausen,83,,5,9,14
022 Klausen,84,,1,20,21
022 Klausen,85,,3,8,11
022 Klausen,86,,7,9,16
022 Klausen,87,,4,5,9
022 Klausen,88,,4,6,10
022 Klausen,89,,2,7,9
022 Klausen,90,,-,2,2
022 Klausen,91,,2,3,5
022 Klausen,92,,-,3,3
022 Klausen,93,,1,2,3
022 Klausen,94,,-,2,2
022 Klausen,95,,1,2,3
022 Klausen,97,,-,1,1
022 Klausen,Insgesamt,,2.261,2.269,4.530
023 Karneid,0,,31,18,49
023 Karneid,1,,21,18,39
023 Karneid,2,,22,18,40
023 Karneid,3,,24,19,43
023 Karneid,4,,19,20,39
023 Karneid,5,,21,20,41
023 Karneid,6,,18,18,36
023 Karneid,7,,22,16,38
023 Karneid,8,,16,16,32
023 Karneid,9,,19,19,38
023 Karneid,10,,12,21,33
023 Karneid,11,,19,19,38
023 Karneid,12,,21,12,33
023 Karneid,13,,25,15,40
023 Karneid,14,,20,9,29
023 Karneid,15,,21,15,36
023 Karneid,16,,29,28,57
023 Karneid,17,,22,21,43
023 Karneid,18,,24,24,48
023 Karneid,19,,24,12,36
023 Karneid,20,,16,18,34
023 Karneid,21,,23,29,52
023 Karneid,22,,21,21,42
023 Karneid,23,,30,20,50
023 Karneid,24,,28,21,49
023 Karneid,25,,27,33,60
023 Karneid,26,,30,32,62
023 Karneid,27,,33,15,48
023 Karneid,28,,20,29,49
023 Karneid,29,,42,31,73
023 Karneid,30,,34,39,73
023 Karneid,31,,33,39,72
023 Karneid,32,,29,28,57
023 Karneid,33,,35,29,64
023 Karneid,34,,38,19,57
023 Karneid,35,,25,34,59
023 Karneid,36,,27,19,46
023 Karneid,37,,30,26,56
023 Karneid,38,,29,18,47
023 Karneid,39,,19,19,38
023 Karneid,40,,20,19,39
023 Karneid,41,,20,18,38
023 Karneid,42,,17,9,26
023 Karneid,43,,16,15,31
023 Karneid,44,,23,15,38
023 Karneid,45,,11,21,32
023 Karneid,46,,19,11,30
023 Karneid,47,,23,14,37
023 Karneid,48,,11,14,25
023 Karneid,49,,17,24,41
023 Karneid,50,,8,17,25
023 Karneid,51,,11,20,31
023 Karneid,52,,11,15,26
023 Karneid,53,,12,13,25
023 Karneid,54,,21,15,36
023 Karneid,55,,16,25,41
023 Karneid,56,,22,16,38
023 Karneid,57,,15,18,33
023 Karneid,58,,17,17,34
023 Karneid,59,,20,10,30
023 Karneid,60,,10,9,19
023 Karneid,61,,11,12,23
023 Karneid,62,,13,16,29
023 Karneid,63,,18,16,34
023 Karneid,64,,11,14,25
023 Karneid,65,,15,5,20
023 Karneid,66,,20,11,31
023 Karneid,67,,7,10,17
023 Karneid,68,,12,9,21
023 Karneid,69,,9,10,19
023 Karneid,70,,4,9,13
023 Karneid,71,,9,10,19
023 Karneid,72,,6,7,13
023 Karneid,73,,9,13,22
023 Karneid,74,,7,5,12
023 Karneid,75,,3,9,12
023 Karneid,76,,2,6,8
023 Karneid,77,,8,10,18
023 Karneid,78,,9,4,13
023 Karneid,79,,1,6,7
023 Karneid,80,,2,4,6
023 Karneid,81,,1,4,5
023 Karneid,82,,4,2,6
023 Karneid,83,,2,5,7
023 Karneid,84,,1,4,5
023 Karneid,85,,1,5,6
023 Karneid,86,,-,5,5
023 Karneid,87,,4,5,9
023 Karneid,88,,2,2,4
023 Karneid,89,,1,6,7
023 Karneid,90,,-,1,1
023 Karneid,91,,-,3,3
023 Karneid,92,,-,1,1
023 Karneid,93,,-,2,2
023 Karneid,95,,-,1,1
023 Karneid,97,,-,1,1
023 Karneid,Insgesamt,,1.531,1.445,2.976
024 Kurtatsch a.d.Weinstr.,0,,12,14,26
024 Kurtatsch a.d.Weinstr.,1,,22,15,37
024 Kurtatsch a.d.Weinstr.,2,,19,11,30
024 Kurtatsch a.d.Weinstr.,3,,16,8,24
024 Kurtatsch a.d.Weinstr.,4,,21,18,39
024 Kurtatsch a.d.Weinstr.,5,,20,11,31
024 Kurtatsch a.d.Weinstr.,6,,14,17,31
024 Kurtatsch a.d.Weinstr.,7,,10,8,18
024 Kurtatsch a.d.Weinstr.,8,,10,17,27
024 Kurtatsch a.d.Weinstr.,9,,8,13,21
024 Kurtatsch a.d.Weinstr.,10,,10,12,22
024 Kurtatsch a.d.Weinstr.,11,,9,10,19
024 Kurtatsch a.d.Weinstr.,12,,13,10,23
024 Kurtatsch a.d.Weinstr.,13,,16,9,25
024 Kurtatsch a.d.Weinstr.,14,,13,8,21
024 Kurtatsch a.d.Weinstr.,15,,11,20,31
024 Kurtatsch a.d.Weinstr.,16,,10,11,21
024 Kurtatsch a.d.Weinstr.,17,,7,14,21
024 Kurtatsch a.d.Weinstr.,18,,9,8,17
024 Kurtatsch a.d.Weinstr.,19,,7,14,21
024 Kurtatsch a.d.Weinstr.,20,,10,15,25
024 Kurtatsch a.d.Weinstr.,21,,11,13,24
024 Kurtatsch a.d.Weinstr.,22,,11,12,23
024 Kurtatsch a.d.Weinstr.,23,,9,17,26
024 Kurtatsch a.d.Weinstr.,24,,13,10,23
024 Kurtatsch a.d.Weinstr.,25,,13,16,29
024 Kurtatsch a.d.Weinstr.,26,,15,16,31
024 Kurtatsch a.d.Weinstr.,27,,11,23,34
024 Kurtatsch a.d.Weinstr.,28,,23,14,37
024 Kurtatsch a.d.Weinstr.,29,,24,9,33
024 Kurtatsch a.d.Weinstr.,30,,18,20,38
024 Kurtatsch a.d.Weinstr.,31,,26,17,43
024 Kurtatsch a.d.Weinstr.,32,,24,25,49
024 Kurtatsch a.d.Weinstr.,33,,14,26,40
024 Kurtatsch a.d.Weinstr.,34,,18,21,39
024 Kurtatsch a.d.Weinstr.,35,,22,7,29
024 Kurtatsch a.d.Weinstr.,36,,18,19,37
024 Kurtatsch a.d.Weinstr.,37,,18,20,38
024 Kurtatsch a.d.Weinstr.,38,,19,12,31
024 Kurtatsch a.d.Weinstr.,39,,13,16,29
024 Kurtatsch a.d.Weinstr.,40,,11,13,24
024 Kurtatsch a.d.Weinstr.,41,,10,9,19
024 Kurtatsch a.d.Weinstr.,42,,12,17,29
024 Kurtatsch a.d.Weinstr.,43,,15,8,23
024 Kurtatsch a.d.Weinstr.,44,,16,18,34
024 Kurtatsch a.d.Weinstr.,45,,13,7,20
024 Kurtatsch a.d.Weinstr.,46,,9,14,23
024 Kurtatsch a.d.Weinstr.,47,,14,5,19
024 Kurtatsch a.d.Weinstr.,48,,11,9,20
024 Kurtatsch a.d.Weinstr.,49,,9,6,15
024 Kurtatsch a.d.Weinstr.,50,,12,8,20
024 Kurtatsch a.d.Weinstr.,51,,12,8,20
024 Kurtatsch a.d.Weinstr.,52,,6,8,14
024 Kurtatsch a.d.Weinstr.,53,,5,8,13
024 Kurtatsch a.d.Weinstr.,54,,11,6,17
024 Kurtatsch a.d.Weinstr.,55,,10,12,22
024 Kurtatsch a.d.Weinstr.,56,,7,9,16
024 Kurtatsch a.d.Weinstr.,57,,12,11,23
024 Kurtatsch a.d.Weinstr.,58,,5,14,19
024 Kurtatsch a.d.Weinstr.,59,,9,11,20
024 Kurtatsch a.d.Weinstr.,60,,5,11,16
024 Kurtatsch a.d.Weinstr.,61,,9,7,16
024 Kurtatsch a.d.Weinstr.,62,,6,9,15
024 Kurtatsch a.d.Weinstr.,63,,9,10,19
024 Kurtatsch a.d.Weinstr.,64,,9,5,14
024 Kurtatsch a.d.Weinstr.,65,,12,15,27
024 Kurtatsch a.d.Weinstr.,66,,10,12,22
024 Kurtatsch a.d.Weinstr.,67,,12,16,28
024 Kurtatsch a.d.Weinstr.,68,,9,12,21
024 Kurtatsch a.d.Weinstr.,69,,9,8,17
024 Kurtatsch a.d.Weinstr.,70,,11,6,17
024 Kurtatsch a.d.Weinstr.,71,,8,6,14
024 Kurtatsch a.d.Weinstr.,72,,4,9,13
024 Kurtatsch a.d.Weinstr.,73,,8,11,19
024 Kurtatsch a.d.Weinstr.,74,,7,22,29
024 Kurtatsch a.d.Weinstr.,75,,2,6,8
024 Kurtatsch a.d.Weinstr.,76,,5,7,12
024 Kurtatsch a.d.Weinstr.,77,,7,6,13
024 Kurtatsch a.d.Weinstr.,78,,2,2,4
024 Kurtatsch a.d.Weinstr.,79,,-,2,2
024 Kurtatsch a.d.Weinstr.,80,,-,6,6
024 Kurtatsch a.d.Weinstr.,81,,-,2,2
024 Kurtatsch a.d.Weinstr.,82,,2,1,3
024 Kurtatsch a.d.Weinstr.,83,,3,3,6
024 Kurtatsch a.d.Weinstr.,84,,2,4,6
024 Kurtatsch a.d.Weinstr.,85,,4,6,10
024 Kurtatsch a.d.Weinstr.,86,,2,4,6
024 Kurtatsch a.d.Weinstr.,87,,-,1,1
024 Kurtatsch a.d.Weinstr.,88,,1,2,3
024 Kurtatsch a.d.Weinstr.,89,,1,2,3
024 Kurtatsch a.d.Weinstr.,90,,-,2,2
024 Kurtatsch a.d.Weinstr.,91,,2,1,3
024 Kurtatsch a.d.Weinstr.,92,,1,2,3
024 Kurtatsch a.d.Weinstr.,93,,1,-,1
024 Kurtatsch a.d.Weinstr.,94,,-,1,1
024 Kurtatsch a.d.Weinstr.,95,,-,1,1
024 Kurtatsch a.d.Weinstr.,96,,1,1,2
024 Kurtatsch a.d.Weinstr.,102,,-,1,1
024 Kurtatsch a.d.Weinstr.,Insgesamt,,960,999,1.959
025 Kurtinig a.d. Weinstr.,0,,5,3,8
025 Kurtinig a.d. Weinstr.,1,,1,4,5
025 Kurtinig a.d. Weinstr.,2,,5,2,7
025 Kurtinig a.d. Weinstr.,3,,3,4,7
025 Kurtinig a.d. Weinstr.,4,,4,4,8
025 Kurtinig a.d. Weinstr.,5,,2,4,6
025 Kurtinig a.d. Weinstr.,6,,6,2,8
025 Kurtinig a.d. Weinstr.,7,,3,2,5
025 Kurtinig a.d. Weinstr.,8,,6,4,10
025 Kurtinig a.d. Weinstr.,9,,6,4,10
025 Kurtinig a.d. Weinstr.,10,,5,6,11
025 Kurtinig a.d. Weinstr.,11,,4,5,9
025 Kurtinig a.d. Weinstr.,12,,2,3,5
025 Kurtinig a.d. Weinstr.,13,,3,2,5
025 Kurtinig a.d. Weinstr.,14,,3,4,7
025 Kurtinig a.d. Weinstr.,15,,6,4,10
025 Kurtinig a.d. Weinstr.,16,,5,5,10
025 Kurtinig a.d. Weinstr.,17,,4,2,6
025 Kurtinig a.d. Weinstr.,18,,4,9,13
025 Kurtinig a.d. Weinstr.,19,,2,3,5
025 Kurtinig a.d. Weinstr.,20,,6,-,6
025 Kurtinig a.d. Weinstr.,21,,2,-,2
025 Kurtinig a.d. Weinstr.,22,,1,3,4
025 Kurtinig a.d. Weinstr.,23,,3,1,4
025 Kurtinig a.d. Weinstr.,24,,5,2,7
025 Kurtinig a.d. Weinstr.,25,,2,3,5
025 Kurtinig a.d. Weinstr.,26,,4,2,6
025 Kurtinig a.d. Weinstr.,27,,7,2,9
025 Kurtinig a.d. Weinstr.,28,,5,6,11
025 Kurtinig a.d. Weinstr.,29,,5,6,11
025 Kurtinig a.d. Weinstr.,30,,4,5,9
025 Kurtinig a.d. Weinstr.,31,,3,5,8
025 Kurtinig a.d. Weinstr.,32,,5,4,9
025 Kurtinig a.d. Weinstr.,33,,7,6,13
025 Kurtinig a.d. Weinstr.,34,,5,6,11
025 Kurtinig a.d. Weinstr.,35,,5,5,10
025 Kurtinig a.d. Weinstr.,36,,8,9,17
025 Kurtinig a.d. Weinstr.,37,,5,4,9
025 Kurtinig a.d. Weinstr.,38,,12,7,19
025 Kurtinig a.d. Weinstr.,39,,3,7,10
025 Kurtinig a.d. Weinstr.,40,,9,8,17
025 Kurtinig a.d. Weinstr.,41,,2,3,5
025 Kurtinig a.d. Weinstr.,42,,3,1,4
025 Kurtinig a.d. Weinstr.,43,,7,2,9
025 Kurtinig a.d. Weinstr.,44,,5,4,9
025 Kurtinig a.d. Weinstr.,45,,2,4,6
025 Kurtinig a.d. Weinstr.,46,,2,4,6
025 Kurtinig a.d. Weinstr.,47,,2,3,5
025 Kurtinig a.d. Weinstr.,48,,3,3,6
025 Kurtinig a.d. Weinstr.,49,,4,5,9
025 Kurtinig a.d. Weinstr.,50,,5,1,6
025 Kurtinig a.d. Weinstr.,51,,-,5,5
025 Kurtinig a.d. Weinstr.,52,,3,2,5
025 Kurtinig a.d. Weinstr.,53,,3,2,5
025 Kurtinig a.d. Weinstr.,54,,4,3,7
025 Kurtinig a.d. Weinstr.,55,,2,2,4
025 Kurtinig a.d. Weinstr.,56,,3,1,4
025 Kurtinig a.d. Weinstr.,57,,2,2,4
025 Kurtinig a.d. Weinstr.,58,,5,3,8
025 Kurtinig a.d. Weinstr.,59,,2,2,4
025 Kurtinig a.d. Weinstr.,60,,3,3,6
025 Kurtinig a.d. Weinstr.,61,,6,3,9
025 Kurtinig a.d. Weinstr.,62,,-,6,6
025 Kurtinig a.d. Weinstr.,63,,1,4,5
025 Kurtinig a.d. Weinstr.,64,,1,2,3
025 Kurtinig a.d. Weinstr.,65,,3,3,6
025 Kurtinig a.d. Weinstr.,66,,2,2,4
025 Kurtinig a.d. Weinstr.,67,,4,4,8
025 Kurtinig a.d. Weinstr.,68,,2,3,5
025 Kurtinig a.d. Weinstr.,69,,2,5,7
025 Kurtinig a.d. Weinstr.,70,,2,3,5
025 Kurtinig a.d. Weinstr.,71,,5,1,6
025 Kurtinig a.d. Weinstr.,72,,-,5,5
025 Kurtinig a.d. Weinstr.,73,,2,6,8
025 Kurtinig a.d. Weinstr.,74,,1,1,2
025 Kurtinig a.d. Weinstr.,75,,1,3,4
025 Kurtinig a.d. Weinstr.,76,,2,1,3
025 Kurtinig a.d. Weinstr.,77,,3,1,4
025 Kurtinig a.d. Weinstr.,78,,-,2,2
025 Kurtinig a.d. Weinstr.,79,,1,1,2
025 Kurtinig a.d. Weinstr.,80,,-,1,1
025 Kurtinig a.d. Weinstr.,81,,-,1,1
025 Kurtinig a.d. Weinstr.,82,,-,3,3
025 Kurtinig a.d. Weinstr.,83,,1,2,3
025 Kurtinig a.d. Weinstr.,84,,1,1,2
025 Kurtinig a.d. Weinstr.,85,,1,1,2
025 Kurtinig a.d. Weinstr.,88,,1,1,2
025 Kurtinig a.d. Weinstr.,91,,1,-,1
025 Kurtinig a.d. Weinstr.,93,,-,2,2
025 Kurtinig a.d. Weinstr.,Insgesamt,,290,290,580
026 Corvara,0,,3,5,8
026 Corvara,1,,8,4,12
026 Corvara,2,,8,8,16
026 Corvara,3,,4,5,9
026 Corvara,4,,7,3,10
026 Corvara,5,,6,11,17
026 Corvara,6,,2,6,8
026 Corvara,7,,10,5,15
026 Corvara,8,,5,5,10
026 Corvara,9,,6,3,9
026 Corvara,10,,10,7,17
026 Corvara,11,,3,-,3
026 Corvara,12,,6,8,14
026 Corvara,13,,8,3,11
026 Corvara,14,,7,7,14
026 Corvara,15,,8,11,19
026 Corvara,16,,15,2,17
026 Corvara,17,,11,7,18
026 Corvara,18,,11,8,19
026 Corvara,19,,10,3,13
026 Corvara,20,,16,6,22
026 Corvara,21,,12,5,17
026 Corvara,22,,9,18,27
026 Corvara,23,,7,14,21
026 Corvara,24,,12,11,23
026 Corvara,25,,7,7,14
026 Corvara,26,,11,8,19
026 Corvara,27,,12,10,22
026 Corvara,28,,15,13,28
026 Corvara,29,,8,13,21
026 Corvara,30,,15,22,37
026 Corvara,31,,13,17,30
026 Corvara,32,,15,13,28
026 Corvara,33,,8,8,16
026 Corvara,34,,12,12,24
026 Corvara,35,,13,13,26
026 Corvara,36,,8,8,16
026 Corvara,37,,15,13,28
026 Corvara,38,,6,8,14
026 Corvara,39,,12,6,18
026 Corvara,40,,7,5,12
026 Corvara,41,,3,8,11
026 Corvara,42,,13,8,21
026 Corvara,43,,8,8,16
026 Corvara,44,,6,13,19
026 Corvara,45,,5,8,13
026 Corvara,46,,6,8,14
026 Corvara,47,,7,8,15
026 Corvara,48,,3,9,12
026 Corvara,49,,6,6,12
026 Corvara,50,,3,10,13
026 Corvara,51,,14,11,25
026 Corvara,52,,5,5,10
026 Corvara,53,,9,9,18
026 Corvara,54,,7,10,17
026 Corvara,55,,6,9,15
026 Corvara,56,,17,12,29
026 Corvara,57,,9,7,16
026 Corvara,58,,10,5,15
026 Corvara,59,,4,8,12
026 Corvara,60,,5,8,13
026 Corvara,61,,6,8,14
026 Corvara,62,,8,5,13
026 Corvara,63,,9,8,17
026 Corvara,64,,5,4,9
026 Corvara,65,,7,4,11
026 Corvara,66,,7,12,19
026 Corvara,67,,7,4,11
026 Corvara,68,,5,6,11
026 Corvara,69,,3,2,5
026 Corvara,70,,7,4,11
026 Corvara,71,,3,4,7
026 Corvara,72,,2,3,5
026 Corvara,73,,3,1,4
026 Corvara,74,,5,3,8
026 Corvara,75,,3,6,9
026 Corvara,76,,4,1,5
026 Corvara,77,,4,1,5
026 Corvara,78,,2,4,6
026 Corvara,79,,1,1,2
026 Corvara,80,,1,3,4
026 Corvara,81,,-,2,2
026 Corvara,83,,2,3,5
026 Corvara,84,,1,6,7
026 Corvara,85,,2,5,7
026 Corvara,86,,2,-,2
026 Corvara,87,,1,2,3
026 Corvara,88,,-,3,3
026 Corvara,89,,-,3,3
026 Corvara,90,,-,2,2
026 Corvara,91,,1,3,4
026 Corvara,94,,1,-,1
026 Corvara,Insgesamt,,629,624,1.253
027 Graun im Vinschgau,0,,15,16,31
027 Graun im Vinschgau,1,,22,19,41
027 Graun im Vinschgau,2,,17,18,35
027 Graun im Vinschgau,3,,18,10,28
027 Graun im Vinschgau,4,,19,14,33
027 Graun im Vinschgau,5,,17,14,31
027 Graun im Vinschgau,6,,9,14,23
027 Graun im Vinschgau,7,,18,21,39
027 Graun im Vinschgau,8,,25,18,43
027 Graun im Vinschgau,9,,22,11,33
027 Graun im Vinschgau,10,,16,11,27
027 Graun im Vinschgau,11,,8,8,16
027 Graun im Vinschgau,12,,19,10,29
027 Graun im Vinschgau,13,,18,15,33
027 Graun im Vinschgau,14,,7,16,23
027 Graun im Vinschgau,15,,22,18,40
027 Graun im Vinschgau,16,,21,17,38
027 Graun im Vinschgau,17,,24,13,37
027 Graun im Vinschgau,18,,13,23,36
027 Graun im Vinschgau,19,,18,16,34
027 Graun im Vinschgau,20,,20,19,39
027 Graun im Vinschgau,21,,15,20,35
027 Graun im Vinschgau,22,,24,19,43
027 Graun im Vinschgau,23,,21,10,31
027 Graun im Vinschgau,24,,22,20,42
027 Graun im Vinschgau,25,,24,19,43
027 Graun im Vinschgau,26,,27,12,39
027 Graun im Vinschgau,27,,26,19,45
027 Graun im Vinschgau,28,,28,19,47
027 Graun im Vinschgau,29,,20,23,43
027 Graun im Vinschgau,30,,30,22,52
027 Graun im Vinschgau,31,,20,24,44
027 Graun im Vinschgau,32,,16,22,38
027 Graun im Vinschgau,33,,22,21,43
027 Graun im Vinschgau,34,,23,20,43
027 Graun im Vinschgau,35,,23,23,46
027 Graun im Vinschgau,36,,22,14,36
027 Graun im Vinschgau,37,,21,21,42
027 Graun im Vinschgau,38,,25,12,37
027 Graun im Vinschgau,39,,20,15,35
027 Graun im Vinschgau,40,,15,13,28
027 Graun im Vinschgau,41,,15,11,26
027 Graun im Vinschgau,42,,18,10,28
027 Graun im Vinschgau,43,,17,16,33
027 Graun im Vinschgau,44,,18,8,26
027 Graun im Vinschgau,45,,17,10,27
027 Graun im Vinschgau,46,,13,15,28
027 Graun im Vinschgau,47,,12,12,24
027 Graun im Vinschgau,48,,8,21,29
027 Graun im Vinschgau,49,,13,12,25
027 Graun im Vinschgau,50,,5,11,16
027 Graun im Vinschgau,51,,8,7,15
027 Graun im Vinschgau,52,,9,8,17
027 Graun im Vinschgau,53,,11,9,20
027 Graun im Vinschgau,54,,10,13,23
027 Graun im Vinschgau,55,,10,12,22
027 Graun im Vinschgau,56,,15,10,25
027 Graun im Vinschgau,57,,14,9,23
027 Graun im Vinschgau,58,,12,14,26
027 Graun im Vinschgau,59,,11,12,23
027 Graun im Vinschgau,60,,11,3,14
027 Graun im Vinschgau,61,,15,14,29
027 Graun im Vinschgau,62,,8,9,17
027 Graun im Vinschgau,63,,13,10,23
027 Graun im Vinschgau,64,,8,7,15
027 Graun im Vinschgau,65,,13,8,21
027 Graun im Vinschgau,66,,13,11,24
027 Graun im Vinschgau,67,,6,9,15
027 Graun im Vinschgau,68,,16,15,31
027 Graun im Vinschgau,69,,12,13,25
027 Graun im Vinschgau,70,,6,9,15
027 Graun im Vinschgau,71,,10,15,25
027 Graun im Vinschgau,72,,6,6,12
027 Graun im Vinschgau,73,,10,10,20
027 Graun im Vinschgau,74,,7,15,22
027 Graun im Vinschgau,75,,9,8,17
027 Graun im Vinschgau,76,,9,15,24
027 Graun im Vinschgau,77,,7,3,10
027 Graun im Vinschgau,78,,1,8,9
027 Graun im Vinschgau,79,,3,2,5
027 Graun im Vinschgau,80,,-,5,5
027 Graun im Vinschgau,81,,3,2,5
027 Graun im Vinschgau,82,,3,5,8
027 Graun im Vinschgau,83,,6,7,13
027 Graun im Vinschgau,84,,2,5,7
027 Graun im Vinschgau,85,,1,4,5
027 Graun im Vinschgau,86,,1,6,7
027 Graun im Vinschgau,87,,3,-,3
027 Graun im Vinschgau,88,,2,2,4
027 Graun im Vinschgau,89,,-,4,4
027 Graun im Vinschgau,90,,1,4,5
027 Graun im Vinschgau,91,,-,1,1
027 Graun im Vinschgau,93,,1,-,1
027 Graun im Vinschgau,94,,-,1,1
027 Graun im Vinschgau,Insgesamt,,1.254,1.145,2.399
028 Toblach,0,,25,16,41
028 Toblach,1,,30,20,50
028 Toblach,2,,17,9,26
028 Toblach,3,,21,17,38
028 Toblach,4,,17,21,38
028 Toblach,5,,15,16,31
028 Toblach,6,,16,29,45
028 Toblach,7,,17,22,39
028 Toblach,8,,10,15,25
028 Toblach,9,,14,25,39
028 Toblach,10,,31,16,47
028 Toblach,11,,15,22,37
028 Toblach,12,,24,23,47
028 Toblach,13,,21,28,49
028 Toblach,14,,22,20,42
028 Toblach,15,,24,28,52
028 Toblach,16,,23,23,46
028 Toblach,17,,23,20,43
028 Toblach,18,,22,27,49
028 Toblach,19,,26,24,50
028 Toblach,20,,15,30,45
028 Toblach,21,,25,26,51
028 Toblach,22,,24,23,47
028 Toblach,23,,28,18,46
028 Toblach,24,,35,25,60
028 Toblach,25,,32,36,68
028 Toblach,26,,34,19,53
028 Toblach,27,,27,24,51
028 Toblach,28,,29,28,57
028 Toblach,29,,38,30,68
028 Toblach,30,,28,24,52
028 Toblach,31,,31,30,61
028 Toblach,32,,33,28,61
028 Toblach,33,,37,32,69
028 Toblach,34,,32,26,58
028 Toblach,35,,37,30,67
028 Toblach,36,,21,30,51
028 Toblach,37,,19,17,36
028 Toblach,38,,39,26,65
028 Toblach,39,,21,15,36
028 Toblach,40,,29,21,50
028 Toblach,41,,19,28,47
028 Toblach,42,,19,25,44
028 Toblach,43,,24,19,43
028 Toblach,44,,20,24,44
028 Toblach,45,,18,16,34
028 Toblach,46,,28,13,41
028 Toblach,47,,16,16,32
028 Toblach,48,,21,14,35
028 Toblach,49,,14,25,39
028 Toblach,50,,20,14,34
028 Toblach,51,,14,15,29
028 Toblach,52,,12,17,29
028 Toblach,53,,19,11,30
028 Toblach,54,,16,17,33
028 Toblach,55,,14,20,34
028 Toblach,56,,16,12,28
028 Toblach,57,,14,14,28
028 Toblach,58,,16,13,29
028 Toblach,59,,16,8,24
028 Toblach,60,,6,11,17
028 Toblach,61,,12,17,29
028 Toblach,62,,9,19,28
028 Toblach,63,,17,17,34
028 Toblach,64,,10,11,21
028 Toblach,65,,13,16,29
028 Toblach,66,,18,16,34
028 Toblach,67,,10,11,21
028 Toblach,68,,11,17,28
028 Toblach,69,,15,14,29
028 Toblach,70,,10,15,25
028 Toblach,71,,10,15,25
028 Toblach,72,,16,9,25
028 Toblach,73,,11,10,21
028 Toblach,74,,10,11,21
028 Toblach,75,,5,18,23
028 Toblach,76,,8,11,19
028 Toblach,77,,4,10,14
028 Toblach,78,,5,15,20
028 Toblach,79,,5,6,11
028 Toblach,80,,5,4,9
028 Toblach,81,,3,6,9
028 Toblach,82,,1,12,13
028 Toblach,83,,2,10,12
028 Toblach,84,,2,6,8
028 Toblach,85,,3,3,6
028 Toblach,86,,2,5,7
028 Toblach,87,,1,5,6
028 Toblach,88,,2,3,5
028 Toblach,89,,4,4,8
028 Toblach,90,,1,3,4
028 Toblach,91,,2,2,4
028 Toblach,92,,-,1,1
028 Toblach,93,,-,1,1
028 Toblach,96,,-,1,1
028 Toblach,107,,1,-,1
028 Toblach,Insgesamt,,1.597,1.615,3.212
029 Neumarkt,0,,16,12,28
029 Neumarkt,1,,16,20,36
029 Neumarkt,2,,19,23,42
029 Neumarkt,3,,19,20,39
029 Neumarkt,4,,24,34,58
029 Neumarkt,5,,22,24,46
029 Neumarkt,6,,27,18,45
029 Neumarkt,7,,27,23,50
029 Neumarkt,8,,23,31,54
029 Neumarkt,9,,20,23,43
029 Neumarkt,10,,29,30,59
029 Neumarkt,11,,22,17,39
029 Neumarkt,12,,23,14,37
029 Neumarkt,13,,16,23,39
029 Neumarkt,14,,12,24,36
029 Neumarkt,15,,22,23,45
029 Neumarkt,16,,24,20,44
029 Neumarkt,17,,21,18,39
029 Neumarkt,18,,22,18,40
029 Neumarkt,19,,33,19,52
029 Neumarkt,20,,17,12,29
029 Neumarkt,21,,30,30,60
029 Neumarkt,22,,27,24,51
029 Neumarkt,23,,23,35,58
029 Neumarkt,24,,22,24,46
029 Neumarkt,25,,30,34,64
029 Neumarkt,26,,29,39,68
029 Neumarkt,27,,37,24,61
029 Neumarkt,28,,36,33,69
029 Neumarkt,29,,33,46,79
029 Neumarkt,30,,42,35,77
029 Neumarkt,31,,48,36,84
029 Neumarkt,32,,50,33,83
029 Neumarkt,33,,48,38,86
029 Neumarkt,34,,44,37,81
029 Neumarkt,35,,46,34,80
029 Neumarkt,36,,34,35,69
029 Neumarkt,37,,48,50,98
029 Neumarkt,38,,48,36,84
029 Neumarkt,39,,32,35,67
029 Neumarkt,40,,34,30,64
029 Neumarkt,41,,35,24,59
029 Neumarkt,42,,43,41,84
029 Neumarkt,43,,39,26,65
029 Neumarkt,44,,23,20,43
029 Neumarkt,45,,28,23,51
029 Neumarkt,46,,22,21,43
029 Neumarkt,47,,25,22,47
029 Neumarkt,48,,19,28,47
029 Neumarkt,49,,24,23,47
029 Neumarkt,50,,25,30,55
029 Neumarkt,51,,36,29,65
029 Neumarkt,52,,26,25,51
029 Neumarkt,53,,24,15,39
029 Neumarkt,54,,26,22,48
029 Neumarkt,55,,25,24,49
029 Neumarkt,56,,38,25,63
029 Neumarkt,57,,33,33,66
029 Neumarkt,58,,21,27,48
029 Neumarkt,59,,19,19,38
029 Neumarkt,60,,24,23,47
029 Neumarkt,61,,23,20,43
029 Neumarkt,62,,21,22,43
029 Neumarkt,63,,17,23,40
029 Neumarkt,64,,19,19,38
029 Neumarkt,65,,20,23,43
029 Neumarkt,66,,26,30,56
029 Neumarkt,67,,19,28,47
029 Neumarkt,68,,16,19,35
029 Neumarkt,69,,11,21,32
029 Neumarkt,70,,22,20,42
029 Neumarkt,71,,21,21,42
029 Neumarkt,72,,17,21,38
029 Neumarkt,73,,14,17,31
029 Neumarkt,74,,16,30,46
029 Neumarkt,75,,11,18,29
029 Neumarkt,76,,8,27,35
029 Neumarkt,77,,13,20,33
029 Neumarkt,78,,4,12,16
029 Neumarkt,79,,6,5,11
029 Neumarkt,80,,5,8,13
029 Neumarkt,81,,3,7,10
029 Neumarkt,82,,2,8,10
029 Neumarkt,83,,10,13,23
029 Neumarkt,84,,6,7,13
029 Neumarkt,85,,4,9,13
029 Neumarkt,86,,3,11,14
029 Neumarkt,87,,4,9,13
029 Neumarkt,88,,4,5,9
029 Neumarkt,89,,3,5,8
029 Neumarkt,90,,-,2,2
029 Neumarkt,91,,1,2,3
029 Neumarkt,92,,1,1,2
029 Neumarkt,93,,-,1,1
029 Neumarkt,94,,-,2,2
029 Neumarkt,99,,-,1,1
029 Neumarkt,Insgesamt,,2.100,2.121,4.221
030 Pfalzen,0,,8,15,23
030 Pfalzen,1,,14,14,28
030 Pfalzen,2,,24,16,40
030 Pfalzen,3,,9,13,22
030 Pfalzen,4,,12,15,27
030 Pfalzen,5,,15,20,35
030 Pfalzen,6,,12,20,32
030 Pfalzen,7,,19,10,29
030 Pfalzen,8,,16,20,36
030 Pfalzen,9,,12,8,20
030 Pfalzen,10,,11,23,34
030 Pfalzen,11,,18,17,35
030 Pfalzen,12,,22,13,35
030 Pfalzen,13,,16,10,26
030 Pfalzen,14,,11,11,22
030 Pfalzen,15,,18,19,37
030 Pfalzen,16,,18,19,37
030 Pfalzen,17,,22,17,39
030 Pfalzen,18,,15,20,35
030 Pfalzen,19,,16,19,35
030 Pfalzen,20,,20,17,37
030 Pfalzen,21,,17,11,28
030 Pfalzen,22,,9,18,27
030 Pfalzen,23,,23,19,42
030 Pfalzen,24,,15,19,34
030 Pfalzen,25,,16,16,32
030 Pfalzen,26,,20,18,38
030 Pfalzen,27,,16,18,34
030 Pfalzen,28,,29,16,45
030 Pfalzen,29,,27,27,54
030 Pfalzen,30,,19,21,40
030 Pfalzen,31,,22,22,44
030 Pfalzen,32,,27,27,54
030 Pfalzen,33,,24,16,40
030 Pfalzen,34,,27,17,44
030 Pfalzen,35,,19,28,47
030 Pfalzen,36,,22,16,38
030 Pfalzen,37,,21,13,34
030 Pfalzen,38,,13,13,26
030 Pfalzen,39,,14,20,34
030 Pfalzen,40,,22,18,40
030 Pfalzen,41,,16,14,30
030 Pfalzen,42,,15,11,26
030 Pfalzen,43,,13,13,26
030 Pfalzen,44,,13,11,24
030 Pfalzen,45,,10,10,20
030 Pfalzen,46,,16,16,32
030 Pfalzen,47,,11,11,22
030 Pfalzen,48,,14,6,20
030 Pfalzen,49,,9,10,19
030 Pfalzen,50,,12,4,16
030 Pfalzen,51,,9,9,18
030 Pfalzen,52,,7,9,16
030 Pfalzen,53,,11,6,17
030 Pfalzen,54,,8,12,20
030 Pfalzen,55,,6,14,20
030 Pfalzen,56,,12,8,20
030 Pfalzen,57,,13,9,22
030 Pfalzen,58,,10,6,16
030 Pfalzen,59,,11,11,22
030 Pfalzen,60,,7,6,13
030 Pfalzen,61,,2,9,11
030 Pfalzen,62,,8,5,13
030 Pfalzen,63,,8,12,20
030 Pfalzen,64,,7,8,15
030 Pfalzen,65,,10,6,16
030 Pfalzen,66,,13,7,20
030 Pfalzen,67,,10,11,21
030 Pfalzen,68,,11,6,17
030 Pfalzen,69,,4,6,10
030 Pfalzen,70,,7,5,12
030 Pfalzen,71,,5,4,9
030 Pfalzen,72,,7,5,12
030 Pfalzen,73,,4,11,15
030 Pfalzen,74,,7,8,15
030 Pfalzen,75,,5,3,8
030 Pfalzen,76,,-,8,8
030 Pfalzen,77,,3,7,10
030 Pfalzen,78,,4,4,8
030 Pfalzen,79,,1,2,3
030 Pfalzen,80,,1,2,3
030 Pfalzen,81,,-,2,2
030 Pfalzen,82,,2,-,2
030 Pfalzen,83,,2,6,8
030 Pfalzen,84,,1,3,4
030 Pfalzen,85,,2,1,3
030 Pfalzen,86,,1,4,5
030 Pfalzen,87,,1,4,5
030 Pfalzen,88,,5,2,7
030 Pfalzen,89,,2,1,3
030 Pfalzen,93,,-,1,1
030 Pfalzen,Insgesamt,,1.086,1.058,2.144
031 Völs am Schlern,0,,20,22,42
031 Völs am Schlern,1,,15,21,36
031 Völs am Schlern,2,,23,26,49
031 Völs am Schlern,3,,24,12,36
031 Völs am Schlern,4,,17,19,36
031 Völs am Schlern,5,,21,16,37
031 Völs am Schlern,6,,14,20,34
031 Völs am Schlern,7,,19,19,38
031 Völs am Schlern,8,,18,14,32
031 Völs am Schlern,9,,16,14,30
031 Völs am Schlern,10,,17,15,32
031 Völs am Schlern,11,,23,12,35
031 Völs am Schlern,12,,18,14,32
031 Völs am Schlern,13,,14,8,22
031 Völs am Schlern,14,,11,22,33
031 Völs am Schlern,15,,20,22,42
031 Völs am Schlern,16,,25,18,43
031 Völs am Schlern,17,,29,13,42
031 Völs am Schlern,18,,19,26,45
031 Völs am Schlern,19,,24,17,41
031 Völs am Schlern,20,,21,21,42
031 Völs am Schlern,21,,25,22,47
031 Völs am Schlern,22,,19,23,42
031 Völs am Schlern,23,,26,27,53
031 Völs am Schlern,24,,24,31,55
031 Völs am Schlern,25,,32,28,60
031 Völs am Schlern,26,,33,32,65
031 Völs am Schlern,27,,28,28,56
031 Völs am Schlern,28,,32,36,68
031 Völs am Schlern,29,,35,35,70
031 Völs am Schlern,30,,33,25,58
031 Völs am Schlern,31,,42,23,65
031 Völs am Schlern,32,,27,27,54
031 Völs am Schlern,33,,27,17,44
031 Völs am Schlern,34,,39,28,67
031 Völs am Schlern,35,,28,18,46
031 Völs am Schlern,36,,22,19,41
031 Völs am Schlern,37,,27,22,49
031 Völs am Schlern,38,,19,14,33
031 Völs am Schlern,39,,22,17,39
031 Völs am Schlern,40,,23,19,42
031 Völs am Schlern,41,,19,18,37
031 Völs am Schlern,42,,16,12,28
031 Völs am Schlern,43,,18,25,43
031 Völs am Schlern,44,,18,24,42
031 Völs am Schlern,45,,19,18,37
031 Völs am Schlern,46,,17,19,36
031 Völs am Schlern,47,,23,16,39
031 Völs am Schlern,48,,19,8,27
031 Völs am Schlern,49,,16,14,30
031 Völs am Schlern,50,,16,17,33
031 Völs am Schlern,51,,14,12,26
031 Völs am Schlern,52,,11,13,24
031 Völs am Schlern,53,,16,10,26
031 Völs am Schlern,54,,12,23,35
031 Völs am Schlern,55,,15,13,28
031 Völs am Schlern,56,,21,19,40
031 Völs am Schlern,57,,12,18,30
031 Völs am Schlern,58,,15,10,25
031 Völs am Schlern,59,,13,14,27
031 Völs am Schlern,60,,11,9,20
031 Völs am Schlern,61,,11,21,32
031 Völs am Schlern,62,,17,12,29
031 Völs am Schlern,63,,16,9,25
031 Völs am Schlern,64,,8,13,21
031 Völs am Schlern,65,,16,8,24
031 Völs am Schlern,66,,14,16,30
031 Völs am Schlern,67,,7,14,21
031 Völs am Schlern,68,,7,11,18
031 Völs am Schlern,69,,9,12,21
031 Völs am Schlern,70,,11,11,22
031 Völs am Schlern,71,,12,6,18
031 Völs am Schlern,72,,11,11,22
031 Völs am Schlern,73,,13,12,25
031 Völs am Schlern,74,,5,7,12
031 Völs am Schlern,75,,5,9,14
031 Völs am Schlern,76,,6,12,18
031 Völs am Schlern,77,,4,7,11
031 Völs am Schlern,78,,1,11,12
031 Völs am Schlern,79,,2,5,7
031 Völs am Schlern,80,,1,6,7
031 Völs am Schlern,81,,4,2,6
031 Völs am Schlern,82,,4,6,10
031 Völs am Schlern,83,,7,4,11
031 Völs am Schlern,84,,7,3,10
031 Völs am Schlern,85,,2,3,5
031 Völs am Schlern,86,,1,8,9
031 Völs am Schlern,87,,2,3,5
031 Völs am Schlern,88,,2,4,6
031 Völs am Schlern,89,,1,4,5
031 Völs am Schlern,90,,1,4,5
031 Völs am Schlern,91,,-,1,1
031 Völs am Schlern,92,,-,2,2
031 Völs am Schlern,93,,1,2,3
031 Völs am Schlern,Insgesamt,,1.500,1.433,2.933
032 Franzensfeste,0,,4,2,6
032 Franzensfeste,1,,8,6,14
032 Franzensfeste,2,,3,2,5
032 Franzensfeste,3,,8,4,12
032 Franzensfeste,4,,5,5,10
032 Franzensfeste,5,,6,9,15
032 Franzensfeste,6,,4,3,7
032 Franzensfeste,7,,2,4,6
032 Franzensfeste,8,,4,6,10
032 Franzensfeste,9,,4,3,7
032 Franzensfeste,10,,4,3,7
032 Franzensfeste,11,,5,2,7
032 Franzensfeste,12,,3,7,10
032 Franzensfeste,13,,3,4,7
032 Franzensfeste,14,,7,4,11
032 Franzensfeste,15,,2,7,9
032 Franzensfeste,16,,7,5,12
032 Franzensfeste,17,,4,9,13
032 Franzensfeste,18,,12,5,17
032 Franzensfeste,19,,4,6,10
032 Franzensfeste,20,,3,2,5
032 Franzensfeste,21,,3,5,8
032 Franzensfeste,22,,9,6,15
032 Franzensfeste,23,,6,7,13
032 Franzensfeste,24,,5,5,10
032 Franzensfeste,25,,3,9,12
032 Franzensfeste,26,,10,5,15
032 Franzensfeste,27,,9,8,17
032 Franzensfeste,28,,6,8,14
032 Franzensfeste,29,,8,7,15
032 Franzensfeste,30,,9,5,14
032 Franzensfeste,31,,7,7,14
032 Franzensfeste,32,,10,7,17
032 Franzensfeste,33,,15,8,23
032 Franzensfeste,34,,9,9,18
032 Franzensfeste,35,,12,2,14
032 Franzensfeste,36,,5,10,15
032 Franzensfeste,37,,6,7,13
032 Franzensfeste,38,,9,9,18
032 Franzensfeste,39,,10,1,11
032 Franzensfeste,40,,4,6,10
032 Franzensfeste,41,,4,7,11
032 Franzensfeste,42,,9,7,16
032 Franzensfeste,43,,4,12,16
032 Franzensfeste,44,,8,6,14
032 Franzensfeste,45,,5,3,8
032 Franzensfeste,46,,7,1,8
032 Franzensfeste,47,,10,3,13
032 Franzensfeste,48,,3,4,7
032 Franzensfeste,49,,5,5,10
032 Franzensfeste,50,,4,4,8
032 Franzensfeste,51,,8,5,13
032 Franzensfeste,52,,4,7,11
032 Franzensfeste,53,,5,9,14
032 Franzensfeste,54,,5,2,7
032 Franzensfeste,55,,5,1,6
032 Franzensfeste,56,,5,3,8
032 Franzensfeste,57,,5,4,9
032 Franzensfeste,58,,8,5,13
032 Franzensfeste,59,,2,4,6
032 Franzensfeste,60,,7,6,13
032 Franzensfeste,61,,4,2,6
032 Franzensfeste,62,,3,3,6
032 Franzensfeste,63,,3,3,6
032 Franzensfeste,64,,3,5,8
032 Franzensfeste,65,,4,6,10
032 Franzensfeste,66,,2,8,10
032 Franzensfeste,67,,7,5,12
032 Franzensfeste,68,,4,8,12
032 Franzensfeste,69,,2,2,4
032 Franzensfeste,70,,4,7,11
032 Franzensfeste,71,,4,10,14
032 Franzensfeste,72,,5,1,6
032 Franzensfeste,73,,6,5,11
032 Franzensfeste,74,,4,8,12
032 Franzensfeste,75,,5,5,10
032 Franzensfeste,76,,2,5,7
032 Franzensfeste,77,,2,4,6
032 Franzensfeste,78,,2,-,2
032 Franzensfeste,79,,-,3,3
032 Franzensfeste,80,,1,-,1
032 Franzensfeste,81,,1,-,1
032 Franzensfeste,82,,1,3,4
032 Franzensfeste,83,,2,3,5
032 Franzensfeste,84,,2,1,3
032 Franzensfeste,85,,1,1,2
032 Franzensfeste,86,,-,1,1
032 Franzensfeste,87,,1,-,1
032 Franzensfeste,88,,-,2,2
032 Franzensfeste,89,,-,1,1
032 Franzensfeste,91,,1,1,2
032 Franzensfeste,93,,-,1,1
032 Franzensfeste,95,,-,1,1
032 Franzensfeste,103,,1,-,1
032 Franzensfeste,Insgesamt,,447,432,879
033 Villnöss,0,,18,24,42
033 Villnöss,1,,21,21,42
033 Villnöss,2,,16,13,29
033 Villnöss,3,,16,12,28
033 Villnöss,4,,17,11,28
033 Villnöss,5,,12,13,25
033 Villnöss,6,,21,17,38
033 Villnöss,7,,14,13,27
033 Villnöss,8,,11,7,18
033 Villnöss,9,,16,23,39
033 Villnöss,10,,19,19,38
033 Villnöss,11,,10,16,26
033 Villnöss,12,,18,17,35
033 Villnöss,13,,15,13,28
033 Villnöss,14,,17,14,31
033 Villnöss,15,,11,15,26
033 Villnöss,16,,12,18,30
033 Villnöss,17,,20,9,29
033 Villnöss,18,,11,12,23
033 Villnöss,19,,15,13,28
033 Villnöss,20,,17,15,32
033 Villnöss,21,,15,13,28
033 Villnöss,22,,24,16,40
033 Villnöss,23,,21,22,43
033 Villnöss,24,,14,22,36
033 Villnöss,25,,22,23,45
033 Villnöss,26,,28,28,56
033 Villnöss,27,,21,30,51
033 Villnöss,28,,31,22,53
033 Villnöss,29,,27,21,48
033 Villnöss,30,,24,19,43
033 Villnöss,31,,28,22,50
033 Villnöss,32,,32,27,59
033 Villnöss,33,,35,26,61
033 Villnöss,34,,29,18,47
033 Villnöss,35,,23,20,43
033 Villnöss,36,,24,15,39
033 Villnöss,37,,20,12,32
033 Villnöss,38,,11,11,22
033 Villnöss,39,,7,15,22
033 Villnöss,40,,13,12,25
033 Villnöss,41,,12,13,25
033 Villnöss,42,,13,2,15
033 Villnöss,43,,16,13,29
033 Villnöss,44,,13,13,26
033 Villnöss,45,,15,11,26
033 Villnöss,46,,9,10,19
033 Villnöss,47,,7,10,17
033 Villnöss,48,,9,13,22
033 Villnöss,49,,9,9,18
033 Villnöss,50,,10,10,20
033 Villnöss,51,,8,5,13
033 Villnöss,52,,6,5,11
033 Villnöss,53,,9,15,24
033 Villnöss,54,,13,10,23
033 Villnöss,55,,14,18,32
033 Villnöss,56,,13,10,23
033 Villnöss,57,,9,18,27
033 Villnöss,58,,12,13,25
033 Villnöss,59,,13,9,22
033 Villnöss,60,,11,15,26
033 Villnöss,61,,7,17,24
033 Villnöss,62,,6,10,16
033 Villnöss,63,,12,9,21
033 Villnöss,64,,11,12,23
033 Villnöss,65,,16,14,30
033 Villnöss,66,,10,11,21
033 Villnöss,67,,13,11,24
033 Villnöss,68,,12,12,24
033 Villnöss,69,,16,8,24
033 Villnöss,70,,9,11,20
033 Villnöss,71,,7,9,16
033 Villnöss,72,,9,7,16
033 Villnöss,73,,7,15,22
033 Villnöss,74,,7,13,20
033 Villnöss,75,,5,13,18
033 Villnöss,76,,1,8,9
033 Villnöss,77,,1,7,8
033 Villnöss,78,,4,4,8
033 Villnöss,79,,1,3,4
033 Villnöss,80,,5,4,9
033 Villnöss,81,,1,2,3
033 Villnöss,82,,4,4,8
033 Villnöss,83,,5,4,9
033 Villnöss,84,,2,4,6
033 Villnöss,85,,1,4,5
033 Villnöss,86,,1,1,2
033 Villnöss,87,,1,3,4
033 Villnöss,88,,1,4,5
033 Villnöss,89,,-,6,6
033 Villnöss,90,,1,1,2
033 Villnöss,91,,2,2,4
033 Villnöss,92,,-,1,1
033 Villnöss,97,,1,-,1
033 Villnöss,Insgesamt,,1.176,1.165,2.341
034 Gais,0,,24,13,37
034 Gais,1,,9,20,29
034 Gais,2,,25,19,44
034 Gais,3,,23,22,45
034 Gais,4,,12,19,31
034 Gais,5,,22,27,49
034 Gais,6,,25,30,55
034 Gais,7,,13,20,33
034 Gais,8,,16,13,29
034 Gais,9,,20,17,37
034 Gais,10,,16,20,36
034 Gais,11,,18,17,35
034 Gais,12,,23,15,38
034 Gais,13,,23,15,38
034 Gais,14,,21,18,39
034 Gais,15,,18,18,36
034 Gais,16,,22,20,42
034 Gais,17,,24,20,44
034 Gais,18,,25,14,39
034 Gais,19,,19,17,36
034 Gais,20,,16,20,36
034 Gais,21,,23,19,42
034 Gais,22,,19,19,38
034 Gais,23,,28,29,57
034 Gais,24,,26,22,48
034 Gais,25,,22,38,60
034 Gais,26,,28,23,51
034 Gais,27,,27,26,53
034 Gais,28,,34,33,67
034 Gais,29,,23,24,47
034 Gais,30,,21,31,52
034 Gais,31,,32,16,48
034 Gais,32,,29,30,59
034 Gais,33,,29,28,57
034 Gais,34,,15,14,29
034 Gais,35,,31,18,49
034 Gais,36,,18,28,46
034 Gais,37,,17,12,29
034 Gais,38,,19,22,41
034 Gais,39,,26,19,45
034 Gais,40,,13,14,27
034 Gais,41,,28,19,47
034 Gais,42,,15,13,28
034 Gais,43,,15,12,27
034 Gais,44,,16,13,29
034 Gais,45,,15,14,29
034 Gais,46,,15,19,34
034 Gais,47,,20,20,40
034 Gais,48,,16,11,27
034 Gais,49,,25,14,39
034 Gais,50,,23,13,36
034 Gais,51,,14,16,30
034 Gais,52,,11,9,20
034 Gais,53,,14,13,27
034 Gais,54,,12,16,28
034 Gais,55,,14,13,27
034 Gais,56,,22,14,36
034 Gais,57,,18,14,32
034 Gais,58,,13,15,28
034 Gais,59,,16,16,32
034 Gais,60,,17,16,33
034 Gais,61,,10,13,23
034 Gais,62,,14,12,26
034 Gais,63,,7,6,13
034 Gais,64,,5,10,15
034 Gais,65,,8,11,19
034 Gais,66,,13,8,21
034 Gais,67,,6,13,19
034 Gais,68,,5,5,10
034 Gais,69,,10,8,18
034 Gais,70,,6,10,16
034 Gais,71,,14,10,24
034 Gais,72,,6,6,12
034 Gais,73,,5,9,14
034 Gais,74,,8,12,20
034 Gais,75,,3,6,9
034 Gais,76,,3,6,9
034 Gais,77,,2,4,6
034 Gais,78,,1,7,8
034 Gais,79,,3,7,10
034 Gais,80,,1,5,6
034 Gais,81,,-,5,5
034 Gais,82,,-,4,4
034 Gais,83,,1,6,7
034 Gais,84,,5,3,8
034 Gais,85,,-,3,3
034 Gais,86,,2,3,5
034 Gais,87,,1,1,2
034 Gais,88,,1,2,3
034 Gais,89,,-,2,2
034 Gais,95,,-,1,1
034 Gais,Insgesamt,,1.373,1.347,2.720
035 Gargazon,0,,7,10,17
035 Gargazon,1,,8,5,13
035 Gargazon,2,,9,3,12
035 Gargazon,3,,3,7,10
035 Gargazon,4,,9,5,14
035 Gargazon,5,,9,8,17
035 Gargazon,6,,17,10,27
035 Gargazon,7,,4,9,13
035 Gargazon,8,,10,6,16
035 Gargazon,9,,9,4,13
035 Gargazon,10,,6,9,15
035 Gargazon,11,,6,9,15
035 Gargazon,12,,10,3,13
035 Gargazon,13,,10,4,14
035 Gargazon,14,,4,7,11
035 Gargazon,15,,5,7,12
035 Gargazon,16,,10,6,16
035 Gargazon,17,,6,11,17
035 Gargazon,18,,6,7,13
035 Gargazon,19,,3,8,11
035 Gargazon,20,,4,4,8
035 Gargazon,21,,5,2,7
035 Gargazon,22,,7,4,11
035 Gargazon,23,,7,10,17
035 Gargazon,24,,9,7,16
035 Gargazon,25,,7,12,19
035 Gargazon,26,,10,10,20
035 Gargazon,27,,11,8,19
035 Gargazon,28,,12,11,23
035 Gargazon,29,,14,16,30
035 Gargazon,30,,16,16,32
035 Gargazon,31,,11,11,22
035 Gargazon,32,,11,9,20
035 Gargazon,33,,12,14,26
035 Gargazon,34,,12,16,28
035 Gargazon,35,,11,9,20
035 Gargazon,36,,7,11,18
035 Gargazon,37,,8,12,20
035 Gargazon,38,,15,12,27
035 Gargazon,39,,8,7,15
035 Gargazon,40,,17,10,27
035 Gargazon,41,,13,6,19
035 Gargazon,42,,7,2,9
035 Gargazon,43,,9,10,19
035 Gargazon,44,,15,8,23
035 Gargazon,45,,3,7,10
035 Gargazon,46,,11,7,18
035 Gargazon,47,,7,7,14
035 Gargazon,48,,5,10,15
035 Gargazon,49,,9,8,17
035 Gargazon,50,,5,10,15
035 Gargazon,51,,7,13,20
035 Gargazon,52,,8,6,14
035 Gargazon,53,,2,5,7
035 Gargazon,54,,4,7,11
035 Gargazon,55,,8,10,18
035 Gargazon,56,,10,11,21
035 Gargazon,57,,6,15,21
035 Gargazon,58,,12,5,17
035 Gargazon,59,,11,7,18
035 Gargazon,60,,7,11,18
035 Gargazon,61,,5,4,9
035 Gargazon,62,,15,2,17
035 Gargazon,63,,8,7,15
035 Gargazon,64,,5,11,16
035 Gargazon,65,,7,2,9
035 Gargazon,66,,5,7,12
035 Gargazon,67,,6,6,12
035 Gargazon,68,,3,10,13
035 Gargazon,69,,4,5,9
035 Gargazon,70,,5,5,10
035 Gargazon,71,,5,3,8
035 Gargazon,72,,5,6,11
035 Gargazon,73,,2,4,6
035 Gargazon,74,,5,6,11
035 Gargazon,75,,4,8,12
035 Gargazon,76,,7,6,13
035 Gargazon,77,,4,2,6
035 Gargazon,78,,2,3,5
035 Gargazon,79,,1,2,3
035 Gargazon,80,,-,3,3
035 Gargazon,81,,-,2,2
035 Gargazon,82,,2,2,4
035 Gargazon,83,,3,1,4
035 Gargazon,84,,2,7,9
035 Gargazon,85,,2,4,6
035 Gargazon,86,,-,1,1
035 Gargazon,88,,-,3,3
035 Gargazon,89,,-,1,1
035 Gargazon,90,,1,1,2
035 Gargazon,91,,-,1,1
035 Gargazon,93,,-,1,1
035 Gargazon,Insgesamt,,632,640,1.272
036 Glurns,0,,4,5,9
036 Glurns,1,,8,4,12
036 Glurns,2,,7,3,10
036 Glurns,3,,1,4,5
036 Glurns,4,,7,7,14
036 Glurns,5,,3,8,11
036 Glurns,6,,6,3,9
036 Glurns,7,,8,6,14
036 Glurns,8,,4,3,7
036 Glurns,9,,6,9,15
036 Glurns,10,,7,6,13
036 Glurns,11,,6,8,14
036 Glurns,12,,3,3,6
036 Glurns,13,,7,7,14
036 Glurns,14,,9,6,15
036 Glurns,15,,10,9,19
036 Glurns,16,,6,7,13
036 Glurns,17,,13,8,21
036 Glurns,18,,6,8,14
036 Glurns,19,,5,8,13
036 Glurns,20,,5,5,10
036 Glurns,21,,10,3,13
036 Glurns,22,,6,8,14
036 Glurns,23,,7,6,13
036 Glurns,24,,3,2,5
036 Glurns,25,,4,7,11
036 Glurns,26,,4,7,11
036 Glurns,27,,1,2,3
036 Glurns,28,,4,6,10
036 Glurns,29,,6,5,11
036 Glurns,30,,7,9,16
036 Glurns,31,,3,5,8
036 Glurns,32,,2,6,8
036 Glurns,33,,9,3,12
036 Glurns,34,,6,9,15
036 Glurns,35,,4,6,10
036 Glurns,36,,3,7,10
036 Glurns,37,,6,7,13
036 Glurns,38,,12,8,20
036 Glurns,39,,4,10,14
036 Glurns,40,,6,12,18
036 Glurns,41,,7,5,12
036 Glurns,42,,11,7,18
036 Glurns,43,,12,4,16
036 Glurns,44,,9,9,18
036 Glurns,45,,5,10,15
036 Glurns,46,,8,10,18
036 Glurns,47,,6,5,11
036 Glurns,48,,6,3,9
036 Glurns,49,,7,4,11
036 Glurns,50,,11,7,18
036 Glurns,51,,9,2,11
036 Glurns,52,,7,1,8
036 Glurns,53,,5,4,9
036 Glurns,54,,1,4,5
036 Glurns,55,,5,5,10
036 Glurns,56,,5,2,7
036 Glurns,57,,5,1,6
036 Glurns,58,,1,3,4
036 Glurns,59,,4,4,8
036 Glurns,60,,5,5,10
036 Glurns,61,,-,1,1
036 Glurns,62,,2,4,6
036 Glurns,63,,1,6,7
036 Glurns,64,,1,1,2
036 Glurns,65,,8,3,11
036 Glurns,66,,4,2,6
036 Glurns,67,,7,2,9
036 Glurns,68,,5,7,12
036 Glurns,69,,1,3,4
036 Glurns,70,,1,3,4
036 Glurns,71,,1,2,3
036 Glurns,72,,1,6,7
036 Glurns,73,,3,2,5
036 Glurns,74,,-,1,1
036 Glurns,75,,1,-,1
036 Glurns,76,,2,3,5
036 Glurns,77,,2,3,5
036 Glurns,78,,2,3,5
036 Glurns,79,,-,3,3
036 Glurns,80,,1,2,3
036 Glurns,82,,-,6,6
036 Glurns,83,,-,6,6
036 Glurns,84,,1,4,5
036 Glurns,85,,-,3,3
036 Glurns,86,,1,3,4
036 Glurns,87,,-,1,1
036 Glurns,88,,-,2,2
036 Glurns,90,,-,1,1
036 Glurns,93,,-,1,1
036 Glurns,Insgesamt,,412,434,846
037 Latsch,0,,34,37,71
037 Latsch,1,,36,32,68
037 Latsch,2,,44,32,76
037 Latsch,3,,38,23,61
037 Latsch,4,,34,28,62
037 Latsch,5,,34,33,67
037 Latsch,6,,28,36,64
037 Latsch,7,,33,50,83
037 Latsch,8,,35,29,64
037 Latsch,9,,40,33,73
037 Latsch,10,,30,36,66
037 Latsch,11,,35,25,60
037 Latsch,12,,30,34,64
037 Latsch,13,,35,34,69
037 Latsch,14,,27,30,57
037 Latsch,15,,29,48,77
037 Latsch,16,,26,34,60
037 Latsch,17,,30,34,64
037 Latsch,18,,33,27,60
037 Latsch,19,,28,22,50
037 Latsch,20,,28,33,61
037 Latsch,21,,21,20,41
037 Latsch,22,,35,32,67
037 Latsch,23,,28,32,60
037 Latsch,24,,31,33,64
037 Latsch,25,,28,38,66
037 Latsch,26,,38,34,72
037 Latsch,27,,37,35,72
037 Latsch,28,,38,40,78
037 Latsch,29,,43,56,99
037 Latsch,30,,42,48,90
037 Latsch,31,,32,46,78
037 Latsch,32,,53,48,101
037 Latsch,33,,58,36,94
037 Latsch,34,,55,50,105
037 Latsch,35,,43,44,87
037 Latsch,36,,45,39,84
037 Latsch,37,,42,55,97
037 Latsch,38,,46,43,89
037 Latsch,39,,40,29,69
037 Latsch,40,,25,31,56
037 Latsch,41,,32,32,64
037 Latsch,42,,36,27,63
037 Latsch,43,,32,21,53
037 Latsch,44,,29,20,49
037 Latsch,45,,41,18,59
037 Latsch,46,,21,35,56
037 Latsch,47,,32,15,47
037 Latsch,48,,16,22,38
037 Latsch,49,,17,22,39
037 Latsch,50,,19,16,35
037 Latsch,51,,19,21,40
037 Latsch,52,,20,18,38
037 Latsch,53,,24,13,37
037 Latsch,54,,27,24,51
037 Latsch,55,,30,24,54
037 Latsch,56,,18,26,44
037 Latsch,57,,20,26,46
037 Latsch,58,,17,21,38
037 Latsch,59,,20,30,50
037 Latsch,60,,14,29,43
037 Latsch,61,,21,14,35
037 Latsch,62,,28,15,43
037 Latsch,63,,22,27,49
037 Latsch,64,,20,22,42
037 Latsch,65,,25,21,46
037 Latsch,66,,19,18,37
037 Latsch,67,,22,21,43
037 Latsch,68,,19,16,35
037 Latsch,69,,19,20,39
037 Latsch,70,,18,32,50
037 Latsch,71,,23,16,39
037 Latsch,72,,21,21,42
037 Latsch,73,,11,18,29
037 Latsch,74,,13,24,37
037 Latsch,75,,12,25,37
037 Latsch,76,,16,19,35
037 Latsch,77,,13,13,26
037 Latsch,78,,7,13,20
037 Latsch,79,,3,5,8
037 Latsch,80,,4,8,12
037 Latsch,81,,2,5,7
037 Latsch,82,,5,5,10
037 Latsch,83,,4,10,14
037 Latsch,84,,5,13,18
037 Latsch,85,,6,4,10
037 Latsch,86,,3,6,9
037 Latsch,87,,2,4,6
037 Latsch,88,,2,9,11
037 Latsch,89,,3,5,8
037 Latsch,90,,1,1,2
037 Latsch,91,,1,7,8
037 Latsch,92,,2,3,5
037 Latsch,93,,1,3,4
037 Latsch,94,,-,2,2
037 Latsch,97,,-,1,1
037 Latsch,Insgesamt,,2.324,2.385,4.709
038 Algund,0,,25,17,42
038 Algund,1,,20,21,41
038 Algund,2,,31,21,52
038 Algund,3,,32,13,45
038 Algund,4,,26,21,47
038 Algund,5,,27,18,45
038 Algund,6,,24,21,45
038 Algund,7,,28,15,43
038 Algund,8,,20,32,52
038 Algund,9,,19,23,42
038 Algund,10,,27,19,46
038 Algund,11,,19,32,51
038 Algund,12,,25,21,46
038 Algund,13,,22,18,40
038 Algund,14,,23,27,50
038 Algund,15,,25,21,46
038 Algund,16,,23,22,45
038 Algund,17,,26,28,54
038 Algund,18,,19,21,40
038 Algund,19,,15,29,44
038 Algund,20,,18,26,44
038 Algund,21,,22,23,45
038 Algund,22,,21,18,39
038 Algund,23,,19,22,41
038 Algund,24,,28,19,47
038 Algund,25,,31,36,67
038 Algund,26,,23,33,56
038 Algund,27,,47,29,76
038 Algund,28,,39,27,66
038 Algund,29,,41,27,68
038 Algund,30,,34,38,72
038 Algund,31,,33,40,73
038 Algund,32,,30,36,66
038 Algund,33,,42,31,73
038 Algund,34,,38,44,82
038 Algund,35,,31,37,68
038 Algund,36,,29,42,71
038 Algund,37,,32,39,71
038 Algund,38,,37,28,65
038 Algund,39,,38,32,70
038 Algund,40,,28,27,55
038 Algund,41,,33,30,63
038 Algund,42,,25,27,52
038 Algund,43,,30,23,53
038 Algund,44,,16,32,48
038 Algund,45,,25,23,48
038 Algund,46,,23,27,50
038 Algund,47,,22,24,46
038 Algund,48,,27,27,54
038 Algund,49,,27,21,48
038 Algund,50,,22,18,40
038 Algund,51,,31,27,58
038 Algund,52,,25,24,49
038 Algund,53,,26,27,53
038 Algund,54,,26,23,49
038 Algund,55,,21,36,57
038 Algund,56,,23,24,47
038 Algund,57,,16,24,40
038 Algund,58,,27,30,57
038 Algund,59,,24,25,49
038 Algund,60,,16,12,28
038 Algund,61,,19,30,49
038 Algund,62,,16,20,36
038 Algund,63,,21,24,45
038 Algund,64,,24,23,47
038 Algund,65,,20,23,43
038 Algund,66,,15,25,40
038 Algund,67,,16,24,40
038 Algund,68,,15,23,38
038 Algund,69,,15,21,36
038 Algund,70,,13,22,35
038 Algund,71,,17,21,38
038 Algund,72,,12,17,29
038 Algund,73,,8,19,27
038 Algund,74,,7,12,19
038 Algund,75,,12,22,34
038 Algund,76,,13,17,30
038 Algund,77,,16,15,31
038 Algund,78,,9,16,25
038 Algund,79,,8,8,16
038 Algund,80,,4,7,11
038 Algund,81,,2,8,10
038 Algund,82,,8,8,16
038 Algund,83,,7,9,16
038 Algund,84,,2,11,13
038 Algund,85,,5,10,15
038 Algund,86,,4,12,16
038 Algund,87,,8,13,21
038 Algund,88,,3,4,7
038 Algund,89,,4,6,10
038 Algund,90,,3,4,7
038 Algund,91,,2,5,7
038 Algund,92,,3,3,6
038 Algund,93,,-,1,1
038 Algund,94,,1,-,1
038 Algund,95,,1,3,4
038 Algund,96,,-,1,1
038 Algund,100,,-,1,1
038 Algund,Insgesamt,,1.955,2.086,4.041
039 Lajen,0,,15,20,35
039 Lajen,1,,16,10,26
039 Lajen,2,,9,11,20
039 Lajen,3,,10,11,21
039 Lajen,4,,13,12,25
039 Lajen,5,,15,11,26
039 Lajen,6,,19,16,35
039 Lajen,7,,8,9,17
039 Lajen,8,,17,14,31
039 Lajen,9,,12,9,21
039 Lajen,10,,13,6,19
039 Lajen,11,,18,13,31
039 Lajen,12,,19,11,30
039 Lajen,13,,8,13,21
039 Lajen,14,,9,18,27
039 Lajen,15,,20,15,35
039 Lajen,16,,11,22,33
039 Lajen,17,,20,17,37
039 Lajen,18,,18,12,30
039 Lajen,19,,23,17,40
039 Lajen,20,,18,10,28
039 Lajen,21,,17,14,31
039 Lajen,22,,16,24,40
039 Lajen,23,,26,17,43
039 Lajen,24,,15,15,30
039 Lajen,25,,19,21,40
039 Lajen,26,,17,22,39
039 Lajen,27,,17,19,36
039 Lajen,28,,27,20,47
039 Lajen,29,,20,20,40
039 Lajen,30,,24,19,43
039 Lajen,31,,20,15,35
039 Lajen,32,,28,14,42
039 Lajen,33,,23,17,40
039 Lajen,34,,15,8,23
039 Lajen,35,,25,14,39
039 Lajen,36,,13,24,37
039 Lajen,37,,12,9,21
039 Lajen,38,,15,21,36
039 Lajen,39,,19,12,31
039 Lajen,40,,13,11,24
039 Lajen,41,,10,13,23
039 Lajen,42,,13,10,23
039 Lajen,43,,6,13,19
039 Lajen,44,,8,8,16
039 Lajen,45,,8,9,17
039 Lajen,46,,8,13,21
039 Lajen,47,,13,14,27
039 Lajen,48,,4,13,17
039 Lajen,49,,11,15,26
039 Lajen,50,,14,6,20
039 Lajen,51,,12,11,23
039 Lajen,52,,13,9,22
039 Lajen,53,,10,8,18
039 Lajen,54,,12,13,25
039 Lajen,55,,20,12,32
039 Lajen,56,,18,16,34
039 Lajen,57,,15,11,26
039 Lajen,58,,16,10,26
039 Lajen,59,,7,15,22
039 Lajen,60,,7,8,15
039 Lajen,61,,7,8,15
039 Lajen,62,,9,9,18
039 Lajen,63,,8,8,16
039 Lajen,64,,5,12,17
039 Lajen,65,,10,4,14
039 Lajen,66,,5,8,13
039 Lajen,67,,8,5,13
039 Lajen,68,,7,5,12
039 Lajen,69,,8,10,18
039 Lajen,70,,8,11,19
039 Lajen,71,,11,7,18
039 Lajen,72,,7,9,16
039 Lajen,73,,7,7,14
039 Lajen,74,,8,9,17
039 Lajen,75,,5,7,12
039 Lajen,76,,5,9,14
039 Lajen,77,,2,3,5
039 Lajen,78,,3,5,8
039 Lajen,79,,1,4,5
039 Lajen,80,,1,2,3
039 Lajen,81,,-,3,3
039 Lajen,82,,3,3,6
039 Lajen,83,,2,4,6
039 Lajen,84,,2,2,4
039 Lajen,85,,2,4,6
039 Lajen,86,,2,-,2
039 Lajen,87,,2,3,5
039 Lajen,88,,2,4,6
039 Lajen,89,,2,4,6
039 Lajen,90,,-,4,4
039 Lajen,91,,1,2,3
039 Lajen,92,,-,1,1
039 Lajen,94,,-,2,2
039 Lajen,Insgesamt,,1.060,1.018,2.078
040 Leifers,0,,105,93,198
040 Leifers,1,,98,80,178
040 Leifers,2,,92,98,190
040 Leifers,3,,84,88,172
040 Leifers,4,,75,66,141
040 Leifers,5,,86,74,160
040 Leifers,6,,85,83,168
040 Leifers,7,,95,77,172
040 Leifers,8,,67,79,146
040 Leifers,9,,69,83,152
040 Leifers,10,,62,69,131
040 Leifers,11,,78,83,161
040 Leifers,12,,76,65,141
040 Leifers,13,,73,74,147
040 Leifers,14,,73,93,166
040 Leifers,15,,61,61,122
040 Leifers,16,,67,63,130
040 Leifers,17,,73,67,140
040 Leifers,18,,64,82,146
040 Leifers,19,,68,71,139
040 Leifers,20,,76,98,174
040 Leifers,21,,85,75,160
040 Leifers,22,,97,107,204
040 Leifers,23,,122,118,240
040 Leifers,24,,122,109,231
040 Leifers,25,,131,109,240
040 Leifers,26,,128,125,253
040 Leifers,27,,128,118,246
040 Leifers,28,,145,116,261
040 Leifers,29,,129,147,276
040 Leifers,30,,145,137,282
040 Leifers,31,,155,125,280
040 Leifers,32,,157,142,299
040 Leifers,33,,170,157,327
040 Leifers,34,,139,151,290
040 Leifers,35,,140,121,261
040 Leifers,36,,142,148,290
040 Leifers,37,,136,121,257
040 Leifers,38,,115,104,219
040 Leifers,39,,97,111,208
040 Leifers,40,,105,115,220
040 Leifers,41,,140,133,273
040 Leifers,42,,108,125,233
040 Leifers,43,,93,105,198
040 Leifers,44,,117,120,237
040 Leifers,45,,107,98,205
040 Leifers,46,,108,93,201
040 Leifers,47,,96,88,184
040 Leifers,48,,102,103,205
040 Leifers,49,,116,105,221
040 Leifers,50,,106,103,209
040 Leifers,51,,131,153,284
040 Leifers,52,,79,85,164
040 Leifers,53,,104,93,197
040 Leifers,54,,102,94,196
040 Leifers,55,,94,96,190
040 Leifers,56,,93,86,179
040 Leifers,57,,100,95,195
040 Leifers,58,,100,95,195
040 Leifers,59,,95,81,176
040 Leifers,60,,68,86,154
040 Leifers,61,,68,67,135
040 Leifers,62,,57,71,128
040 Leifers,63,,73,65,138
040 Leifers,64,,67,66,133
040 Leifers,65,,72,80,152
040 Leifers,66,,57,69,126
040 Leifers,67,,62,67,129
040 Leifers,68,,50,62,112
040 Leifers,69,,54,45,99
040 Leifers,70,,43,68,111
040 Leifers,71,,36,57,93
040 Leifers,72,,31,53,84
040 Leifers,73,,34,56,90
040 Leifers,74,,33,42,75
040 Leifers,75,,34,43,77
040 Leifers,76,,25,29,54
040 Leifers,77,,21,28,49
040 Leifers,78,,15,38,53
040 Leifers,79,,10,21,31
040 Leifers,80,,3,14,17
040 Leifers,81,,8,19,27
040 Leifers,82,,6,20,26
040 Leifers,83,,11,25,36
040 Leifers,84,,14,25,39
040 Leifers,85,,10,32,42
040 Leifers,86,,8,20,28
040 Leifers,87,,3,19,22
040 Leifers,88,,8,10,18
040 Leifers,89,,3,7,10
040 Leifers,90,,4,10,14
040 Leifers,91,,1,9,10
040 Leifers,92,,1,5,6
040 Leifers,93,,1,7,8
040 Leifers,94,,1,3,4
040 Leifers,95,,-,2,2
040 Leifers,96,,-,2,2
040 Leifers,97,,-,3,3
040 Leifers,Insgesamt,,7.198,7.399,14.597
041 Lana,0,,51,62,113
041 Lana,1,,60,67,127
041 Lana,2,,54,56,110
041 Lana,3,,54,64,118
041 Lana,4,,56,52,108
041 Lana,5,,54,54,108
041 Lana,6,,48,56,104
041 Lana,7,,42,62,104
041 Lana,8,,43,71,114
041 Lana,9,,58,47,105
041 Lana,10,,67,44,111
041 Lana,11,,55,49,104
041 Lana,12,,59,54,113
041 Lana,13,,59,49,108
041 Lana,14,,64,59,123
041 Lana,15,,63,50,113
041 Lana,16,,46,62,108
041 Lana,17,,51,47,98
041 Lana,18,,53,64,117
041 Lana,19,,61,50,111
041 Lana,20,,68,47,115
041 Lana,21,,53,49,102
041 Lana,22,,57,62,119
041 Lana,23,,69,58,127
041 Lana,24,,63,75,138
041 Lana,25,,80,67,147
041 Lana,26,,70,73,143
041 Lana,27,,70,91,161
041 Lana,28,,111,68,179
041 Lana,29,,67,77,144
041 Lana,30,,86,88,174
041 Lana,31,,80,96,176
041 Lana,32,,89,86,175
041 Lana,33,,91,88,179
041 Lana,34,,98,80,178
041 Lana,35,,83,74,157
041 Lana,36,,78,83,161
041 Lana,37,,75,73,148
041 Lana,38,,83,71,154
041 Lana,39,,71,83,154
041 Lana,40,,74,71,145
041 Lana,41,,58,59,117
041 Lana,42,,61,69,130
041 Lana,43,,61,60,121
041 Lana,44,,59,63,122
041 Lana,45,,49,57,106
041 Lana,46,,56,64,120
041 Lana,47,,51,55,106
041 Lana,48,,53,55,108
041 Lana,49,,55,65,120
041 Lana,50,,57,43,100
041 Lana,51,,67,62,129
041 Lana,52,,43,48,91
041 Lana,53,,51,56,107
041 Lana,54,,61,59,120
041 Lana,55,,61,64,125
041 Lana,56,,51,49,100
041 Lana,57,,41,47,88
041 Lana,58,,54,52,106
041 Lana,59,,46,60,106
041 Lana,60,,36,42,78
041 Lana,61,,46,50,96
041 Lana,62,,40,39,79
041 Lana,63,,41,44,85
041 Lana,64,,35,43,78
041 Lana,65,,34,34,68
041 Lana,66,,30,45,75
041 Lana,67,,28,40,68
041 Lana,68,,24,39,63
041 Lana,69,,40,34,74
041 Lana,70,,33,38,71
041 Lana,71,,30,42,72
041 Lana,72,,34,47,81
041 Lana,73,,15,27,42
041 Lana,74,,21,33,54
041 Lana,75,,28,40,68
041 Lana,76,,19,37,56
041 Lana,77,,22,38,60
041 Lana,78,,12,30,42
041 Lana,79,,3,12,15
041 Lana,80,,5,22,27
041 Lana,81,,4,7,11
041 Lana,82,,16,25,41
041 Lana,83,,16,14,30
041 Lana,84,,10,28,38
041 Lana,85,,7,17,24
041 Lana,86,,8,23,31
041 Lana,87,,8,14,22
041 Lana,88,,5,11,16
041 Lana,89,,5,11,16
041 Lana,90,,1,10,11
041 Lana,91,,4,10,14
041 Lana,92,,3,3,6
041 Lana,93,,1,5,6
041 Lana,94,,1,6,7
041 Lana,95,,-,2,2
041 Lana,96,,1,4,5
041 Lana,97,,1,-,1
041 Lana,98,,1,-,1
041 Lana,Insgesamt,,4.417,4.732,9.149
042 Laas,0,,27,28,55
042 Laas,1,,33,33,66
042 Laas,2,,32,23,55
042 Laas,3,,26,25,51
042 Laas,4,,22,20,42
042 Laas,5,,14,25,39
042 Laas,6,,24,21,45
042 Laas,7,,22,25,47
042 Laas,8,,21,23,44
042 Laas,9,,24,19,43
042 Laas,10,,28,22,50
042 Laas,11,,33,21,54
042 Laas,12,,27,28,55
042 Laas,13,,28,25,53
042 Laas,14,,22,38,60
042 Laas,15,,34,24,58
042 Laas,16,,25,28,53
042 Laas,17,,17,23,40
042 Laas,18,,30,32,62
042 Laas,19,,31,17,48
042 Laas,20,,25,20,45
042 Laas,21,,24,29,53
042 Laas,22,,29,27,56
042 Laas,23,,35,25,60
042 Laas,24,,30,36,66
042 Laas,25,,27,27,54
042 Laas,26,,30,28,58
042 Laas,27,,40,27,67
042 Laas,28,,38,42,80
042 Laas,29,,41,25,66
042 Laas,30,,32,25,57
042 Laas,31,,34,27,61
042 Laas,32,,38,33,71
042 Laas,33,,28,30,58
042 Laas,34,,31,28,59
042 Laas,35,,35,27,62
042 Laas,36,,29,28,57
042 Laas,37,,34,21,55
042 Laas,38,,35,29,64
042 Laas,39,,28,23,51
042 Laas,40,,19,27,46
042 Laas,41,,24,17,41
042 Laas,42,,17,14,31
042 Laas,43,,16,24,40
042 Laas,44,,25,12,37
042 Laas,45,,28,25,53
042 Laas,46,,16,16,32
042 Laas,47,,24,25,49
042 Laas,48,,20,20,40
042 Laas,49,,16,20,36
042 Laas,50,,27,13,40
042 Laas,51,,14,15,29
042 Laas,52,,17,12,29
042 Laas,53,,12,15,27
042 Laas,54,,13,16,29
042 Laas,55,,17,20,37
042 Laas,56,,16,21,37
042 Laas,57,,24,25,49
042 Laas,58,,15,25,40
042 Laas,59,,21,13,34
042 Laas,60,,16,14,30
042 Laas,61,,24,14,38
042 Laas,62,,19,21,40
042 Laas,63,,12,21,33
042 Laas,64,,24,12,36
042 Laas,65,,17,18,35
042 Laas,66,,21,23,44
042 Laas,67,,19,21,40
042 Laas,68,,17,14,31
042 Laas,69,,15,13,28
042 Laas,70,,15,19,34
042 Laas,71,,18,13,31
042 Laas,72,,12,15,27
042 Laas,73,,13,20,33
042 Laas,74,,17,12,29
042 Laas,75,,11,20,31
042 Laas,76,,6,10,16
042 Laas,77,,9,12,21
042 Laas,78,,5,10,15
042 Laas,79,,7,4,11
042 Laas,80,,3,3,6
042 Laas,81,,4,4,8
042 Laas,82,,-,2,2
042 Laas,83,,2,9,11
042 Laas,84,,2,8,10
042 Laas,85,,3,9,12
042 Laas,86,,1,4,5
042 Laas,87,,6,5,11
042 Laas,88,,4,4,8
042 Laas,89,,-,4,4
042 Laas,90,,1,4,5
042 Laas,91,,-,3,3
042 Laas,92,,-,2,2
042 Laas,93,,1,-,1
042 Laas,95,,-,2,2
042 Laas,96,,-,1,1
042 Laas,97,,-,1,1
042 Laas,Insgesamt,,1.868,1.803,3.671
043 Laurein,0,,4,5,9
043 Laurein,1,,-,2,2
043 Laurein,2,,3,3,6
043 Laurein,3,,2,3,5
043 Laurein,4,,1,5,6
043 Laurein,5,,1,1,2
043 Laurein,6,,1,1,2
043 Laurein,7,,4,-,4
043 Laurein,8,,3,2,5
043 Laurein,9,,1,-,1
043 Laurein,10,,2,2,4
043 Laurein,11,,4,2,6
043 Laurein,12,,2,2,4
043 Laurein,13,,1,2,3
043 Laurein,15,,2,2,4
043 Laurein,16,,3,1,4
043 Laurein,17,,2,-,2
043 Laurein,18,,2,-,2
043 Laurein,19,,2,5,7
043 Laurein,20,,1,2,3
043 Laurein,21,,5,-,5
043 Laurein,22,,-,6,6
043 Laurein,23,,1,5,6
043 Laurein,24,,5,1,6
043 Laurein,25,,1,2,3
043 Laurein,26,,6,5,11
043 Laurein,27,,5,4,9
043 Laurein,28,,5,5,10
043 Laurein,29,,-,2,2
043 Laurein,30,,5,7,12
043 Laurein,31,,6,2,8
043 Laurein,32,,6,2,8
043 Laurein,33,,3,3,6
043 Laurein,34,,1,2,3
043 Laurein,35,,2,2,4
043 Laurein,36,,5,6,11
043 Laurein,37,,2,1,3
043 Laurein,38,,4,4,8
043 Laurein,39,,3,2,5
043 Laurein,40,,7,-,7
043 Laurein,42,,3,-,3
043 Laurein,43,,3,1,4
043 Laurein,44,,2,1,3
043 Laurein,45,,2,2,4
043 Laurein,47,,2,1,3
043 Laurein,48,,3,2,5
043 Laurein,49,,2,-,2
043 Laurein,50,,2,3,5
043 Laurein,51,,-,1,1
043 Laurein,52,,-,1,1
043 Laurein,53,,-,1,1
043 Laurein,54,,1,-,1
043 Laurein,55,,2,-,2
043 Laurein,57,,4,2,6
043 Laurein,58,,3,3,6
043 Laurein,59,,1,1,2
043 Laurein,60,,2,1,3
043 Laurein,61,,1,2,3
043 Laurein,62,,1,3,4
043 Laurein,63,,2,5,7
043 Laurein,64,,1,3,4
043 Laurein,65,,4,2,6
043 Laurein,66,,1,3,4
043 Laurein,67,,3,5,8
043 Laurein,68,,3,-,3
043 Laurein,69,,5,1,6
043 Laurein,70,,6,1,7
043 Laurein,71,,2,2,4
043 Laurein,72,,4,2,6
043 Laurein,73,,-,2,2
043 Laurein,74,,1,-,1
043 Laurein,75,,-,3,3
043 Laurein,76,,1,-,1
043 Laurein,77,,2,3,5
043 Laurein,78,,-,1,1
043 Laurein,81,,1,-,1
043 Laurein,83,,-,3,3
043 Laurein,84,,1,1,2
043 Laurein,85,,1,-,1
043 Laurein,86,,-,1,1
043 Laurein,87,,1,2,3
043 Laurein,90,,1,-,1
043 Laurein,91,,-,1,1
043 Laurein,Insgesamt,,187,167,354
044 Lüsen,0,,13,8,21
044 Lüsen,1,,9,13,22
044 Lüsen,2,,9,11,20
044 Lüsen,3,,14,14,28
044 Lüsen,4,,10,9,19
044 Lüsen,5,,10,11,21
044 Lüsen,6,,8,10,18
044 Lüsen,7,,6,11,17
044 Lüsen,8,,18,7,25
044 Lüsen,9,,10,9,19
044 Lüsen,10,,7,8,15
044 Lüsen,11,,12,12,24
044 Lüsen,12,,3,3,6
044 Lüsen,13,,9,18,27
044 Lüsen,14,,6,11,17
044 Lüsen,15,,15,10,25
044 Lüsen,16,,11,14,25
044 Lüsen,17,,15,13,28
044 Lüsen,18,,8,10,18
044 Lüsen,19,,16,18,34
044 Lüsen,20,,7,9,16
044 Lüsen,21,,15,11,26
044 Lüsen,22,,12,11,23
044 Lüsen,23,,18,12,30
044 Lüsen,24,,10,6,16
044 Lüsen,25,,11,12,23
044 Lüsen,26,,16,13,29
044 Lüsen,27,,18,18,36
044 Lüsen,28,,9,12,21
044 Lüsen,29,,15,16,31
044 Lüsen,30,,11,23,34
044 Lüsen,31,,13,15,28
044 Lüsen,32,,18,13,31
044 Lüsen,33,,14,9,23
044 Lüsen,34,,14,8,22
044 Lüsen,35,,9,13,22
044 Lüsen,36,,12,10,22
044 Lüsen,37,,8,13,21
044 Lüsen,38,,7,4,11
044 Lüsen,39,,11,13,24
044 Lüsen,40,,9,11,20
044 Lüsen,41,,9,9,18
044 Lüsen,42,,7,7,14
044 Lüsen,43,,14,5,19
044 Lüsen,44,,8,10,18
044 Lüsen,45,,10,4,14
044 Lüsen,46,,5,7,12
044 Lüsen,47,,6,7,13
044 Lüsen,48,,8,12,20
044 Lüsen,49,,8,2,10
044 Lüsen,50,,7,4,11
044 Lüsen,51,,10,5,15
044 Lüsen,52,,4,9,13
044 Lüsen,53,,4,7,11
044 Lüsen,54,,7,7,14
044 Lüsen,55,,2,6,8
044 Lüsen,56,,7,5,12
044 Lüsen,57,,6,9,15
044 Lüsen,58,,9,7,16
044 Lüsen,59,,8,4,12
044 Lüsen,60,,9,6,15
044 Lüsen,61,,5,9,14
044 Lüsen,62,,8,5,13
044 Lüsen,63,,4,5,9
044 Lüsen,64,,7,4,11
044 Lüsen,65,,3,11,14
044 Lüsen,66,,8,5,13
044 Lüsen,67,,4,6,10
044 Lüsen,68,,6,8,14
044 Lüsen,69,,8,9,17
044 Lüsen,70,,7,4,11
044 Lüsen,71,,4,8,12
044 Lüsen,72,,4,7,11
044 Lüsen,73,,5,3,8
044 Lüsen,74,,5,4,9
044 Lüsen,75,,2,4,6
044 Lüsen,76,,2,7,9
044 Lüsen,77,,3,6,9
044 Lüsen,78,,3,2,5
044 Lüsen,79,,-,4,4
044 Lüsen,80,,1,2,3
044 Lüsen,81,,-,2,2
044 Lüsen,82,,-,4,4
044 Lüsen,83,,2,2,4
044 Lüsen,84,,5,4,9
044 Lüsen,85,,2,3,5
044 Lüsen,86,,1,1,2
044 Lüsen,87,,-,1,1
044 Lüsen,88,,1,2,3
044 Lüsen,89,,2,-,2
044 Lüsen,93,,1,-,1
044 Lüsen,94,,1,-,1
044 Lüsen,97,,-,1,1
044 Lüsen,Insgesamt,,718,737,1.455
045 Margreid a.d. Weinstr.,0,,8,12,20
045 Margreid a.d. Weinstr.,1,,5,4,9
045 Margreid a.d. Weinstr.,2,,1,8,9
045 Margreid a.d. Weinstr.,3,,6,8,14
045 Margreid a.d. Weinstr.,4,,4,14,18
045 Margreid a.d. Weinstr.,5,,4,2,6
045 Margreid a.d. Weinstr.,6,,7,6,13
045 Margreid a.d. Weinstr.,7,,6,10,16
045 Margreid a.d. Weinstr.,8,,7,6,13
045 Margreid a.d. Weinstr.,9,,8,6,14
045 Margreid a.d. Weinstr.,10,,7,5,12
045 Margreid a.d. Weinstr.,11,,6,11,17
045 Margreid a.d. Weinstr.,12,,11,-,11
045 Margreid a.d. Weinstr.,13,,4,12,16
045 Margreid a.d. Weinstr.,14,,6,9,15
045 Margreid a.d. Weinstr.,15,,8,9,17
045 Margreid a.d. Weinstr.,16,,14,2,16
045 Margreid a.d. Weinstr.,17,,2,1,3
045 Margreid a.d. Weinstr.,18,,9,4,13
045 Margreid a.d. Weinstr.,19,,7,4,11
045 Margreid a.d. Weinstr.,20,,8,6,14
045 Margreid a.d. Weinstr.,21,,10,8,18
045 Margreid a.d. Weinstr.,22,,7,4,11
045 Margreid a.d. Weinstr.,23,,4,11,15
045 Margreid a.d. Weinstr.,24,,9,10,19
045 Margreid a.d. Weinstr.,25,,9,6,15
045 Margreid a.d. Weinstr.,26,,10,8,18
045 Margreid a.d. Weinstr.,27,,11,10,21
045 Margreid a.d. Weinstr.,28,,11,9,20
045 Margreid a.d. Weinstr.,29,,22,15,37
045 Margreid a.d. Weinstr.,30,,11,13,24
045 Margreid a.d. Weinstr.,31,,19,12,31
045 Margreid a.d. Weinstr.,32,,14,5,19
045 Margreid a.d. Weinstr.,33,,7,7,14
045 Margreid a.d. Weinstr.,34,,13,12,25
045 Margreid a.d. Weinstr.,35,,8,12,20
045 Margreid a.d. Weinstr.,36,,14,11,25
045 Margreid a.d. Weinstr.,37,,15,9,24
045 Margreid a.d. Weinstr.,38,,9,13,22
045 Margreid a.d. Weinstr.,39,,8,6,14
045 Margreid a.d. Weinstr.,40,,8,4,12
045 Margreid a.d. Weinstr.,41,,12,5,17
045 Margreid a.d. Weinstr.,42,,8,6,14
045 Margreid a.d. Weinstr.,43,,5,5,10
045 Margreid a.d. Weinstr.,44,,9,7,16
045 Margreid a.d. Weinstr.,45,,7,9,16
045 Margreid a.d. Weinstr.,46,,4,8,12
045 Margreid a.d. Weinstr.,47,,5,6,11
045 Margreid a.d. Weinstr.,48,,9,5,14
045 Margreid a.d. Weinstr.,49,,6,10,16
045 Margreid a.d. Weinstr.,50,,6,7,13
045 Margreid a.d. Weinstr.,51,,5,5,10
045 Margreid a.d. Weinstr.,52,,6,7,13
045 Margreid a.d. Weinstr.,53,,4,6,10
045 Margreid a.d. Weinstr.,54,,7,3,10
045 Margreid a.d. Weinstr.,55,,11,5,16
045 Margreid a.d. Weinstr.,56,,7,7,14
045 Margreid a.d. Weinstr.,57,,5,3,8
045 Margreid a.d. Weinstr.,58,,4,5,9
045 Margreid a.d. Weinstr.,59,,5,7,12
045 Margreid a.d. Weinstr.,60,,6,4,10
045 Margreid a.d. Weinstr.,61,,7,6,13
045 Margreid a.d. Weinstr.,62,,2,7,9
045 Margreid a.d. Weinstr.,63,,5,3,8
045 Margreid a.d. Weinstr.,64,,4,6,10
045 Margreid a.d. Weinstr.,65,,4,7,11
045 Margreid a.d. Weinstr.,66,,6,6,12
045 Margreid a.d. Weinstr.,67,,7,4,11
045 Margreid a.d. Weinstr.,68,,2,4,6
045 Margreid a.d. Weinstr.,69,,7,3,10
045 Margreid a.d. Weinstr.,70,,4,6,10
045 Margreid a.d. Weinstr.,71,,5,7,12
045 Margreid a.d. Weinstr.,72,,3,4,7
045 Margreid a.d. Weinstr.,73,,2,5,7
045 Margreid a.d. Weinstr.,74,,4,7,11
045 Margreid a.d. Weinstr.,75,,1,3,4
045 Margreid a.d. Weinstr.,76,,1,4,5
045 Margreid a.d. Weinstr.,77,,1,2,3
045 Margreid a.d. Weinstr.,78,,3,6,9
045 Margreid a.d. Weinstr.,79,,1,1,2
045 Margreid a.d. Weinstr.,80,,-,1,1
045 Margreid a.d. Weinstr.,81,,2,4,6
045 Margreid a.d. Weinstr.,82,,1,2,3
045 Margreid a.d. Weinstr.,83,,-,2,2
045 Margreid a.d. Weinstr.,84,,2,2,4
045 Margreid a.d. Weinstr.,85,,1,2,3
045 Margreid a.d. Weinstr.,86,,-,5,5
045 Margreid a.d. Weinstr.,87,,1,2,3
045 Margreid a.d. Weinstr.,88,,2,-,2
045 Margreid a.d. Weinstr.,89,,1,-,1
045 Margreid a.d. Weinstr.,90,,-,2,2
045 Margreid a.d. Weinstr.,91,,-,2,2
045 Margreid a.d. Weinstr.,92,,-,1,1
045 Margreid a.d. Weinstr.,Insgesamt,,567,560,1.127
046 Mals,0,,37,36,73
046 Mals,1,,29,25,54
046 Mals,2,,33,40,73
046 Mals,3,,35,29,64
046 Mals,4,,31,32,63
046 Mals,5,,34,30,64
046 Mals,6,,33,32,65
046 Mals,7,,37,25,62
046 Mals,8,,38,36,74
046 Mals,9,,31,26,57
046 Mals,10,,33,29,62
046 Mals,11,,30,32,62
046 Mals,12,,38,37,75
046 Mals,13,,38,36,74
046 Mals,14,,31,31,62
046 Mals,15,,36,33,69
046 Mals,16,,35,38,73
046 Mals,17,,35,32,67
046 Mals,18,,33,30,63
046 Mals,19,,41,36,77
046 Mals,20,,32,23,55
046 Mals,21,,39,28,67
046 Mals,22,,41,36,77
046 Mals,23,,48,31,79
046 Mals,24,,30,38,68
046 Mals,25,,36,48,84
046 Mals,26,,38,52,90
046 Mals,27,,49,43,92
046 Mals,28,,50,43,93
046 Mals,29,,60,45,105
046 Mals,30,,48,31,79
046 Mals,31,,62,44,106
046 Mals,32,,48,38,86
046 Mals,33,,49,45,94
046 Mals,34,,50,54,104
046 Mals,35,,39,28,67
046 Mals,36,,52,39,91
046 Mals,37,,32,41,73
046 Mals,38,,31,36,67
046 Mals,39,,32,23,55
046 Mals,40,,41,33,74
046 Mals,41,,36,27,63
046 Mals,42,,30,27,57
046 Mals,43,,22,20,42
046 Mals,44,,33,32,65
046 Mals,45,,28,22,50
046 Mals,46,,34,22,56
046 Mals,47,,36,20,56
046 Mals,48,,18,27,45
046 Mals,49,,28,15,43
046 Mals,50,,23,20,43
046 Mals,51,,26,28,54
046 Mals,52,,13,18,31
046 Mals,53,,30,13,43
046 Mals,54,,27,18,45
046 Mals,55,,24,27,51
046 Mals,56,,20,18,38
046 Mals,57,,22,27,49
046 Mals,58,,27,25,52
046 Mals,59,,23,21,44
046 Mals,60,,16,32,48
046 Mals,61,,22,16,38
046 Mals,62,,16,20,36
046 Mals,63,,16,19,35
046 Mals,64,,18,23,41
046 Mals,65,,20,14,34
046 Mals,66,,15,18,33
046 Mals,67,,26,19,45
046 Mals,68,,24,19,43
046 Mals,69,,24,15,39
046 Mals,70,,21,16,37
046 Mals,71,,12,24,36
046 Mals,72,,15,20,35
046 Mals,73,,12,18,30
046 Mals,74,,8,17,25
046 Mals,75,,15,17,32
046 Mals,76,,14,15,29
046 Mals,77,,7,20,27
046 Mals,78,,6,22,28
046 Mals,79,,3,8,11
046 Mals,80,,5,5,10
046 Mals,81,,3,8,11
046 Mals,82,,7,11,18
046 Mals,83,,6,9,15
046 Mals,84,,13,22,35
046 Mals,85,,5,6,11
046 Mals,86,,3,8,11
046 Mals,87,,1,9,10
046 Mals,88,,2,2,4
046 Mals,89,,3,5,8
046 Mals,90,,2,2,4
046 Mals,91,,1,1,2
046 Mals,93,,-,2,2
046 Mals,94,,-,2,2
046 Mals,96,,1,1,2
046 Mals,97,,-,1,1
046 Mals,98,,-,2,2
046 Mals,Insgesamt,,2.457,2.339,4.796
047 Enneberg,0,,24,14,38
047 Enneberg,1,,18,13,31
047 Enneberg,2,,21,8,29
047 Enneberg,3,,19,13,32
047 Enneberg,4,,20,18,38
047 Enneberg,5,,15,14,29
047 Enneberg,6,,17,23,40
047 Enneberg,7,,15,18,33
047 Enneberg,8,,20,15,35
047 Enneberg,9,,22,14,36
047 Enneberg,10,,16,13,29
047 Enneberg,11,,18,10,28
047 Enneberg,12,,23,16,39
047 Enneberg,13,,19,19,38
047 Enneberg,14,,14,16,30
047 Enneberg,15,,24,19,43
047 Enneberg,16,,22,20,42
047 Enneberg,17,,25,19,44
047 Enneberg,18,,11,21,32
047 Enneberg,19,,13,25,38
047 Enneberg,20,,19,22,41
047 Enneberg,21,,12,16,28
047 Enneberg,22,,12,26,38
047 Enneberg,23,,25,33,58
047 Enneberg,24,,21,24,45
047 Enneberg,25,,23,27,50
047 Enneberg,26,,33,32,65
047 Enneberg,27,,25,23,48
047 Enneberg,28,,29,20,49
047 Enneberg,29,,22,22,44
047 Enneberg,30,,25,21,46
047 Enneberg,31,,21,26,47
047 Enneberg,32,,28,23,51
047 Enneberg,33,,23,22,45
047 Enneberg,34,,25,20,45
047 Enneberg,35,,17,14,31
047 Enneberg,36,,18,17,35
047 Enneberg,37,,14,17,31
047 Enneberg,38,,23,14,37
047 Enneberg,39,,21,8,29
047 Enneberg,40,,16,14,30
047 Enneberg,41,,15,17,32
047 Enneberg,42,,14,13,27
047 Enneberg,43,,14,12,26
047 Enneberg,44,,17,20,37
047 Enneberg,45,,14,18,32
047 Enneberg,46,,17,11,28
047 Enneberg,47,,11,16,27
047 Enneberg,48,,18,8,26
047 Enneberg,49,,15,13,28
047 Enneberg,50,,9,11,20
047 Enneberg,51,,15,17,32
047 Enneberg,52,,9,13,22
047 Enneberg,53,,20,15,35
047 Enneberg,54,,18,11,29
047 Enneberg,55,,12,20,32
047 Enneberg,56,,14,10,24
047 Enneberg,57,,14,8,22
047 Enneberg,58,,18,11,29
047 Enneberg,59,,15,21,36
047 Enneberg,60,,17,13,30
047 Enneberg,61,,15,14,29
047 Enneberg,62,,15,16,31
047 Enneberg,63,,9,12,21
047 Enneberg,64,,12,9,21
047 Enneberg,65,,9,17,26
047 Enneberg,66,,13,12,25
047 Enneberg,67,,17,16,33
047 Enneberg,68,,10,6,16
047 Enneberg,69,,10,14,24
047 Enneberg,70,,14,9,23
047 Enneberg,71,,8,9,17
047 Enneberg,72,,11,7,18
047 Enneberg,73,,5,10,15
047 Enneberg,74,,7,12,19
047 Enneberg,75,,8,8,16
047 Enneberg,76,,4,13,17
047 Enneberg,77,,7,5,12
047 Enneberg,78,,3,4,7
047 Enneberg,79,,5,3,8
047 Enneberg,80,,-,8,8
047 Enneberg,81,,1,9,10
047 Enneberg,82,,4,7,11
047 Enneberg,83,,4,5,9
047 Enneberg,84,,3,5,8
047 Enneberg,85,,-,6,6
047 Enneberg,86,,3,7,10
047 Enneberg,87,,5,5,10
047 Enneberg,88,,3,1,4
047 Enneberg,89,,-,6,6
047 Enneberg,90,,2,2,4
047 Enneberg,91,,1,-,1
047 Enneberg,92,,-,2,2
047 Enneberg,93,,1,3,4
047 Enneberg,Insgesamt,,1.333,1.309,2.642
048 Marling,0,,14,11,25
048 Marling,1,,16,13,29
048 Marling,2,,19,11,30
048 Marling,3,,9,9,18
048 Marling,4,,15,9,24
048 Marling,5,,18,16,34
048 Marling,6,,12,10,22
048 Marling,7,,10,16,26
048 Marling,8,,11,15,26
048 Marling,9,,11,14,25
048 Marling,10,,4,10,14
048 Marling,11,,13,10,23
048 Marling,12,,11,15,26
048 Marling,13,,11,6,17
048 Marling,14,,10,10,20
048 Marling,15,,12,8,20
048 Marling,16,,14,10,24
048 Marling,17,,12,9,21
048 Marling,18,,15,17,32
048 Marling,19,,16,13,29
048 Marling,20,,12,18,30
048 Marling,21,,17,16,33
048 Marling,22,,15,16,31
048 Marling,23,,11,11,22
048 Marling,24,,16,20,36
048 Marling,25,,14,14,28
048 Marling,26,,25,13,38
048 Marling,27,,16,13,29
048 Marling,28,,27,22,49
048 Marling,29,,24,16,40
048 Marling,30,,19,19,38
048 Marling,31,,21,27,48
048 Marling,32,,25,18,43
048 Marling,33,,24,16,40
048 Marling,34,,33,28,61
048 Marling,35,,26,19,45
048 Marling,36,,24,13,37
048 Marling,37,,19,19,38
048 Marling,38,,17,15,32
048 Marling,39,,18,12,30
048 Marling,40,,8,12,20
048 Marling,41,,12,13,25
048 Marling,42,,10,7,17
048 Marling,43,,17,12,29
048 Marling,44,,12,17,29
048 Marling,45,,15,15,30
048 Marling,46,,6,13,19
048 Marling,47,,19,16,35
048 Marling,48,,19,18,37
048 Marling,49,,9,18,27
048 Marling,50,,18,13,31
048 Marling,51,,15,15,30
048 Marling,52,,19,12,31
048 Marling,53,,15,14,29
048 Marling,54,,11,18,29
048 Marling,55,,13,11,24
048 Marling,56,,24,18,42
048 Marling,57,,13,12,25
048 Marling,58,,15,19,34
048 Marling,59,,13,13,26
048 Marling,60,,12,17,29
048 Marling,61,,15,8,23
048 Marling,62,,7,15,22
048 Marling,63,,14,11,25
048 Marling,64,,9,13,22
048 Marling,65,,11,10,21
048 Marling,66,,13,10,23
048 Marling,67,,7,11,18
048 Marling,68,,8,9,17
048 Marling,69,,10,4,14
048 Marling,70,,12,10,22
048 Marling,71,,6,14,20
048 Marling,72,,6,18,24
048 Marling,73,,4,9,13
048 Marling,74,,7,8,15
048 Marling,75,,4,5,9
048 Marling,76,,5,9,14
048 Marling,77,,-,3,3
048 Marling,78,,5,6,11
048 Marling,79,,1,6,7
048 Marling,80,,3,2,5
048 Marling,81,,1,3,4
048 Marling,82,,3,4,7
048 Marling,83,,2,6,8
048 Marling,84,,2,5,7
048 Marling,85,,3,6,9
048 Marling,87,,1,4,5
048 Marling,88,,3,2,5
048 Marling,89,,4,2,6
048 Marling,90,,-,5,5
048 Marling,91,,1,-,1
048 Marling,92,,-,4,4
048 Marling,93,,1,1,2
048 Marling,Insgesamt,,1.119,1.103,2.222
049 Martell,0,,5,8,13
049 Martell,1,,4,6,10
049 Martell,2,,8,7,15
049 Martell,3,,7,9,16
049 Martell,4,,7,7,14
049 Martell,5,,5,5,10
049 Martell,6,,8,6,14
049 Martell,7,,6,5,11
049 Martell,8,,9,3,12
049 Martell,9,,4,1,5
049 Martell,10,,8,4,12
049 Martell,11,,-,4,4
049 Martell,12,,5,7,12
049 Martell,13,,6,4,10
049 Martell,14,,9,4,13
049 Martell,15,,6,6,12
049 Martell,16,,8,5,13
049 Martell,17,,9,5,14
049 Martell,18,,8,8,16
049 Martell,19,,3,6,9
049 Martell,20,,6,4,10
049 Martell,21,,6,7,13
049 Martell,22,,2,6,8
049 Martell,23,,6,9,15
049 Martell,24,,9,7,16
049 Martell,25,,6,7,13
049 Martell,26,,12,5,17
049 Martell,27,,6,3,9
049 Martell,28,,6,15,21
049 Martell,29,,9,7,16
049 Martell,30,,6,8,14
049 Martell,31,,15,5,20
049 Martell,32,,18,8,26
049 Martell,33,,9,9,18
049 Martell,34,,15,2,17
049 Martell,35,,12,9,21
049 Martell,36,,7,5,12
049 Martell,37,,10,3,13
049 Martell,38,,7,6,13
049 Martell,39,,7,6,13
049 Martell,40,,7,3,10
049 Martell,41,,4,3,7
049 Martell,42,,7,2,9
049 Martell,43,,7,6,13
049 Martell,44,,5,4,9
049 Martell,45,,5,4,9
049 Martell,46,,6,8,14
049 Martell,47,,3,4,7
049 Martell,48,,4,2,6
049 Martell,49,,6,4,10
049 Martell,50,,5,3,8
049 Martell,51,,3,-,3
049 Martell,52,,6,1,7
049 Martell,53,,1,3,4
049 Martell,54,,2,3,5
049 Martell,55,,5,6,11
049 Martell,56,,4,4,8
049 Martell,57,,6,2,8
049 Martell,58,,2,5,7
049 Martell,59,,1,6,7
049 Martell,60,,3,5,8
049 Martell,61,,3,4,7
049 Martell,62,,4,9,13
049 Martell,63,,9,1,10
049 Martell,64,,5,5,10
049 Martell,65,,2,4,6
049 Martell,66,,6,1,7
049 Martell,67,,7,4,11
049 Martell,68,,5,4,9
049 Martell,69,,3,6,9
049 Martell,70,,3,3,6
049 Martell,71,,3,9,12
049 Martell,72,,2,3,5
049 Martell,73,,4,7,11
049 Martell,74,,1,7,8
049 Martell,75,,2,2,4
049 Martell,76,,1,2,3
049 Martell,77,,-,1,1
049 Martell,78,,1,1,2
049 Martell,79,,2,3,5
049 Martell,80,,1,-,1
049 Martell,81,,-,1,1
049 Martell,82,,4,4,8
049 Martell,83,,1,1,2
049 Martell,84,,1,-,1
049 Martell,85,,1,-,1
049 Martell,86,,3,3,6
049 Martell,87,,-,1,1
049 Martell,88,,1,1,2
049 Martell,89,,-,1,1
049 Martell,90,,-,1,1
049 Martell,91,,1,-,1
049 Martell,94,,-,1,1
049 Martell,Insgesamt,,467,409,876
050 Mölten,0,,9,8,17
050 Mölten,1,,18,10,28
050 Mölten,2,,10,9,19
050 Mölten,3,,12,5,17
050 Mölten,4,,13,11,24
050 Mölten,5,,7,14,21
050 Mölten,6,,12,6,18
050 Mölten,7,,13,5,18
050 Mölten,8,,12,6,18
050 Mölten,9,,7,8,15
050 Mölten,10,,9,8,17
050 Mölten,11,,10,6,16
050 Mölten,12,,7,13,20
050 Mölten,13,,6,3,9
050 Mölten,14,,7,15,22
050 Mölten,15,,9,6,15
050 Mölten,16,,12,6,18
050 Mölten,17,,12,8,20
050 Mölten,18,,11,9,20
050 Mölten,19,,10,6,16
050 Mölten,20,,6,12,18
050 Mölten,21,,7,18,25
050 Mölten,22,,15,10,25
050 Mölten,23,,12,11,23
050 Mölten,24,,11,12,23
050 Mölten,25,,12,8,20
050 Mölten,26,,15,10,25
050 Mölten,27,,15,13,28
050 Mölten,28,,15,14,29
050 Mölten,29,,17,18,35
050 Mölten,30,,19,13,32
050 Mölten,31,,15,14,29
050 Mölten,32,,10,15,25
050 Mölten,33,,23,12,35
050 Mölten,34,,15,6,21
050 Mölten,35,,12,10,22
050 Mölten,36,,17,9,26
050 Mölten,37,,6,7,13
050 Mölten,38,,14,4,18
050 Mölten,39,,2,11,13
050 Mölten,40,,5,2,7
050 Mölten,41,,4,7,11
050 Mölten,42,,16,7,23
050 Mölten,43,,7,5,12
050 Mölten,44,,5,6,11
050 Mölten,45,,5,4,9
050 Mölten,46,,5,3,8
050 Mölten,47,,9,9,18
050 Mölten,48,,6,4,10
050 Mölten,49,,4,4,8
050 Mölten,50,,4,7,11
050 Mölten,51,,10,2,12
050 Mölten,52,,5,5,10
050 Mölten,53,,2,6,8
050 Mölten,54,,14,8,22
050 Mölten,55,,6,10,16
050 Mölten,56,,10,3,13
050 Mölten,57,,7,7,14
050 Mölten,58,,5,7,12
050 Mölten,59,,2,3,5
050 Mölten,60,,5,6,11
050 Mölten,61,,5,5,10
050 Mölten,62,,10,6,16
050 Mölten,63,,9,6,15
050 Mölten,64,,10,9,19
050 Mölten,65,,3,6,9
050 Mölten,66,,11,2,13
050 Mölten,67,,6,5,11
050 Mölten,68,,3,7,10
050 Mölten,69,,3,6,9
050 Mölten,70,,5,4,9
050 Mölten,71,,3,5,8
050 Mölten,72,,2,4,6
050 Mölten,73,,2,4,6
050 Mölten,74,,7,6,13
050 Mölten,75,,4,2,6
050 Mölten,76,,1,7,8
050 Mölten,77,,3,7,10
050 Mölten,78,,-,5,5
050 Mölten,79,,2,3,5
050 Mölten,80,,1,1,2
050 Mölten,81,,2,2,4
050 Mölten,82,,-,2,2
050 Mölten,83,,-,6,6
050 Mölten,84,,3,1,4
050 Mölten,85,,-,2,2
050 Mölten,86,,-,1,1
050 Mölten,87,,1,1,2
050 Mölten,88,,-,3,3
050 Mölten,91,,-,1,1
050 Mölten,93,,-,1,1
050 Mölten,94,,-,1,1
050 Mölten,Insgesamt,,696,625,1.321
051 Meran,0,,173,143,316
051 Meran,1,,171,135,306
051 Meran,2,,149,138,287
051 Meran,3,,151,154,305
051 Meran,4,,118,129,247
051 Meran,5,,153,133,286
051 Meran,6,,138,158,296
051 Meran,7,,146,147,293
051 Meran,8,,158,136,294
051 Meran,9,,160,112,272
051 Meran,10,,152,137,289
051 Meran,11,,150,109,259
051 Meran,12,,126,170,296
051 Meran,13,,150,135,285
051 Meran,14,,138,146,284
051 Meran,15,,138,147,285
051 Meran,16,,161,148,309
051 Meran,17,,151,133,284
051 Meran,18,,133,150,283
051 Meran,19,,168,155,323
051 Meran,20,,163,185,348
051 Meran,21,,177,198,375
051 Meran,22,,198,193,391
051 Meran,23,,250,232,482
051 Meran,24,,216,213,429
051 Meran,25,,238,234,472
051 Meran,26,,255,243,498
051 Meran,27,,261,272,533
051 Meran,28,,293,281,574
051 Meran,29,,302,292,594
051 Meran,30,,316,288,604
051 Meran,31,,327,290,617
051 Meran,32,,329,301,630
051 Meran,33,,330,296,626
051 Meran,34,,337,266,603
051 Meran,35,,251,272,523
051 Meran,36,,302,285,587
051 Meran,37,,294,263,557
051 Meran,38,,272,245,517
051 Meran,39,,261,223,484
051 Meran,40,,240,238,478
051 Meran,41,,226,209,435
051 Meran,42,,194,218,412
051 Meran,43,,187,221,408
051 Meran,44,,195,218,413
051 Meran,45,,229,228,457
051 Meran,46,,221,209,430
051 Meran,47,,207,228,435
051 Meran,48,,229,248,477
051 Meran,49,,230,255,485
051 Meran,50,,233,285,518
051 Meran,51,,246,305,551
051 Meran,52,,226,225,451
051 Meran,53,,226,239,465
051 Meran,54,,279,249,528
051 Meran,55,,274,305,579
051 Meran,56,,242,283,525
051 Meran,57,,212,223,435
051 Meran,58,,223,259,482
051 Meran,59,,205,233,438
051 Meran,60,,205,239,444
051 Meran,61,,187,210,397
051 Meran,62,,192,217,409
051 Meran,63,,180,195,375
051 Meran,64,,168,189,357
051 Meran,65,,147,214,361
051 Meran,66,,147,194,341
051 Meran,67,,157,199,356
051 Meran,68,,139,160,299
051 Meran,69,,149,213,362
051 Meran,70,,132,175,307
051 Meran,71,,136,204,340
051 Meran,72,,107,181,288
051 Meran,73,,108,198,306
051 Meran,74,,100,200,300
051 Meran,75,,108,218,326
051 Meran,76,,78,209,287
051 Meran,77,,100,194,294
051 Meran,78,,70,146,216
051 Meran,79,,59,108,167
051 Meran,80,,47,98,145
051 Meran,81,,37,97,134
051 Meran,82,,57,118,175
051 Meran,83,,64,151,215
051 Meran,84,,58,121,179
051 Meran,85,,54,127,181
051 Meran,86,,37,99,136
051 Meran,87,,37,103,140
051 Meran,88,,33,81,114
051 Meran,89,,31,65,96
051 Meran,90,,18,41,59
051 Meran,91,,17,46,63
051 Meran,92,,6,28,34
051 Meran,93,,6,33,39
051 Meran,94,,4,22,26
051 Meran,95,,4,12,16
051 Meran,96,,5,7,12
051 Meran,97,,1,2,3
051 Meran,98,,2,3,5
051 Meran,99,,-,4,4
051 Meran,103,,-,2,2
051 Meran,105,,-,1,1
051 Meran,Insgesamt,,16.067,17.889,33.956
052 Welsberg-Taisten,0,,22,21,43
052 Welsberg-Taisten,1,,15,15,30
052 Welsberg-Taisten,2,,16,13,29
052 Welsberg-Taisten,3,,13,16,29
052 Welsberg-Taisten,4,,14,17,31
052 Welsberg-Taisten,5,,9,10,19
052 Welsberg-Taisten,6,,19,19,38
052 Welsberg-Taisten,7,,12,18,30
052 Welsberg-Taisten,8,,7,17,24
052 Welsberg-Taisten,9,,15,16,31
052 Welsberg-Taisten,10,,15,13,28
052 Welsberg-Taisten,11,,10,12,22
052 Welsberg-Taisten,12,,9,14,23
052 Welsberg-Taisten,13,,24,14,38
052 Welsberg-Taisten,14,,19,19,38
052 Welsberg-Taisten,15,,19,14,33
052 Welsberg-Taisten,16,,10,12,22
052 Welsberg-Taisten,17,,16,17,33
052 Welsberg-Taisten,18,,24,15,39
052 Welsberg-Taisten,19,,19,15,34
052 Welsberg-Taisten,20,,12,20,32
052 Welsberg-Taisten,21,,17,14,31
052 Welsberg-Taisten,22,,15,21,36
052 Welsberg-Taisten,23,,26,20,46
052 Welsberg-Taisten,24,,27,9,36
052 Welsberg-Taisten,25,,19,28,47
052 Welsberg-Taisten,26,,30,19,49
052 Welsberg-Taisten,27,,26,20,46
052 Welsberg-Taisten,28,,20,23,43
052 Welsberg-Taisten,29,,26,12,38
052 Welsberg-Taisten,30,,29,23,52
052 Welsberg-Taisten,31,,24,25,49
052 Welsberg-Taisten,32,,22,20,42
052 Welsberg-Taisten,33,,29,21,50
052 Welsberg-Taisten,34,,26,24,50
052 Welsberg-Taisten,35,,19,24,43
052 Welsberg-Taisten,36,,22,18,40
052 Welsberg-Taisten,37,,13,16,29
052 Welsberg-Taisten,38,,24,20,44
052 Welsberg-Taisten,39,,26,17,43
052 Welsberg-Taisten,40,,11,18,29
052 Welsberg-Taisten,41,,19,20,39
052 Welsberg-Taisten,42,,20,12,32
052 Welsberg-Taisten,43,,18,13,31
052 Welsberg-Taisten,44,,19,13,32
052 Welsberg-Taisten,45,,19,13,32
052 Welsberg-Taisten,46,,17,8,25
052 Welsberg-Taisten,47,,17,15,32
052 Welsberg-Taisten,48,,14,12,26
052 Welsberg-Taisten,49,,17,17,34
052 Welsberg-Taisten,50,,11,10,21
052 Welsberg-Taisten,51,,13,14,27
052 Welsberg-Taisten,52,,9,13,22
052 Welsberg-Taisten,53,,13,11,24
052 Welsberg-Taisten,54,,13,12,25
052 Welsberg-Taisten,55,,10,12,22
052 Welsberg-Taisten,56,,18,20,38
052 Welsberg-Taisten,57,,8,13,21
052 Welsberg-Taisten,58,,15,13,28
052 Welsberg-Taisten,59,,15,11,26
052 Welsberg-Taisten,60,,10,8,18
052 Welsberg-Taisten,61,,11,10,21
052 Welsberg-Taisten,62,,3,17,20
052 Welsberg-Taisten,63,,18,16,34
052 Welsberg-Taisten,64,,12,10,22
052 Welsberg-Taisten,65,,12,15,27
052 Welsberg-Taisten,66,,9,12,21
052 Welsberg-Taisten,67,,12,9,21
052 Welsberg-Taisten,68,,11,12,23
052 Welsberg-Taisten,69,,7,20,27
052 Welsberg-Taisten,70,,11,13,24
052 Welsberg-Taisten,71,,8,7,15
052 Welsberg-Taisten,72,,1,9,10
052 Welsberg-Taisten,73,,8,13,21
052 Welsberg-Taisten,74,,7,12,19
052 Welsberg-Taisten,75,,6,8,14
052 Welsberg-Taisten,76,,7,11,18
052 Welsberg-Taisten,77,,7,9,16
052 Welsberg-Taisten,78,,1,8,9
052 Welsberg-Taisten,79,,4,1,5
052 Welsberg-Taisten,80,,2,4,6
052 Welsberg-Taisten,81,,3,1,4
052 Welsberg-Taisten,82,,5,6,11
052 Welsberg-Taisten,83,,4,3,7
052 Welsberg-Taisten,84,,1,6,7
052 Welsberg-Taisten,85,,2,5,7
052 Welsberg-Taisten,86,,-,6,6
052 Welsberg-Taisten,87,,2,7,9
052 Welsberg-Taisten,88,,-,7,7
052 Welsberg-Taisten,89,,-,2,2
052 Welsberg-Taisten,90,,1,2,3
052 Welsberg-Taisten,91,,-,1,1
052 Welsberg-Taisten,92,,-,2,2
052 Welsberg-Taisten,93,,-,1,1
052 Welsberg-Taisten,96,,-,1,1
052 Welsberg-Taisten,97,,1,-,1
052 Welsberg-Taisten,99,,-,1,1
052 Welsberg-Taisten,109,,-,1,1
052 Welsberg-Taisten,Insgesamt,,1.241,1.247,2.488
053 Montan,0,,6,7,13
053 Montan,1,,12,9,21
053 Montan,2,,14,15,29
053 Montan,3,,9,5,14
053 Montan,4,,6,9,15
053 Montan,5,,8,10,18
053 Montan,6,,13,9,22
053 Montan,7,,10,8,18
053 Montan,8,,9,10,19
053 Montan,9,,12,13,25
053 Montan,10,,9,15,24
053 Montan,11,,13,5,18
053 Montan,12,,10,8,18
053 Montan,13,,6,3,9
053 Montan,14,,10,5,15
053 Montan,15,,9,8,17
053 Montan,16,,9,7,16
053 Montan,17,,4,4,8
053 Montan,18,,10,9,19
053 Montan,19,,9,6,15
053 Montan,20,,6,4,10
053 Montan,21,,5,5,10
053 Montan,22,,11,8,19
053 Montan,23,,7,8,15
053 Montan,24,,11,6,17
053 Montan,25,,11,4,15
053 Montan,26,,14,8,22
053 Montan,27,,12,11,23
053 Montan,28,,10,14,24
053 Montan,29,,14,16,30
053 Montan,30,,10,11,21
053 Montan,31,,10,15,25
053 Montan,32,,24,13,37
053 Montan,33,,16,13,29
053 Montan,34,,11,16,27
053 Montan,35,,12,16,28
053 Montan,36,,18,11,29
053 Montan,37,,13,12,25
053 Montan,38,,11,10,21
053 Montan,39,,12,8,20
053 Montan,40,,16,10,26
053 Montan,41,,6,14,20
053 Montan,42,,7,12,19
053 Montan,43,,13,12,25
053 Montan,44,,11,7,18
053 Montan,45,,12,3,15
053 Montan,46,,7,6,13
053 Montan,47,,4,5,9
053 Montan,48,,9,3,12
053 Montan,49,,4,6,10
053 Montan,50,,7,9,16
053 Montan,51,,5,2,7
053 Montan,52,,3,4,7
053 Montan,53,,4,5,9
053 Montan,54,,6,7,13
053 Montan,55,,6,6,12
053 Montan,56,,8,4,12
053 Montan,57,,9,7,16
053 Montan,58,,8,9,17
053 Montan,59,,9,9,18
053 Montan,60,,3,7,10
053 Montan,61,,7,11,18
053 Montan,62,,1,9,10
053 Montan,63,,4,6,10
053 Montan,64,,16,5,21
053 Montan,65,,6,8,14
053 Montan,66,,8,11,19
053 Montan,67,,11,12,23
053 Montan,68,,8,9,17
053 Montan,69,,9,4,13
053 Montan,70,,9,7,16
053 Montan,71,,9,10,19
053 Montan,72,,5,8,13
053 Montan,73,,3,8,11
053 Montan,74,,6,11,17
053 Montan,75,,5,9,14
053 Montan,76,,6,4,10
053 Montan,77,,2,8,10
053 Montan,78,,2,5,7
053 Montan,79,,1,3,4
053 Montan,80,,2,6,8
053 Montan,81,,-,3,3
053 Montan,82,,1,9,10
053 Montan,83,,3,5,8
053 Montan,84,,1,5,6
053 Montan,85,,2,4,6
053 Montan,86,,2,2,4
053 Montan,87,,3,-,3
053 Montan,88,,-,2,2
053 Montan,89,,1,4,5
053 Montan,90,,1,1,2
053 Montan,92,,1,-,1
053 Montan,93,,-,1,1
053 Montan,94,,-,1,1
053 Montan,96,,-,1,1
053 Montan,Insgesamt,,718,713,1.431
054 Moos in Passeier,0,,13,19,32
054 Moos in Passeier,1,,17,19,36
054 Moos in Passeier,2,,10,11,21
054 Moos in Passeier,3,,16,20,36
054 Moos in Passeier,4,,21,15,36
054 Moos in Passeier,5,,18,17,35
054 Moos in Passeier,6,,18,20,38
054 Moos in Passeier,7,,16,13,29
054 Moos in Passeier,8,,18,19,37
054 Moos in Passeier,9,,14,20,34
054 Moos in Passeier,10,,16,14,30
054 Moos in Passeier,11,,17,15,32
054 Moos in Passeier,12,,19,13,32
054 Moos in Passeier,13,,22,21,43
054 Moos in Passeier,14,,15,14,29
054 Moos in Passeier,15,,17,22,39
054 Moos in Passeier,16,,20,19,39
054 Moos in Passeier,17,,20,23,43
054 Moos in Passeier,18,,21,16,37
054 Moos in Passeier,19,,26,19,45
054 Moos in Passeier,20,,21,20,41
054 Moos in Passeier,21,,15,17,32
054 Moos in Passeier,22,,26,20,46
054 Moos in Passeier,23,,25,13,38
054 Moos in Passeier,24,,17,27,44
054 Moos in Passeier,25,,23,17,40
054 Moos in Passeier,26,,25,18,43
054 Moos in Passeier,27,,27,14,41
054 Moos in Passeier,28,,23,19,42
054 Moos in Passeier,29,,21,24,45
054 Moos in Passeier,30,,23,19,42
054 Moos in Passeier,31,,27,21,48
054 Moos in Passeier,32,,24,12,36
054 Moos in Passeier,33,,28,11,39
054 Moos in Passeier,34,,15,18,33
054 Moos in Passeier,35,,12,21,33
054 Moos in Passeier,36,,10,9,19
054 Moos in Passeier,37,,18,16,34
054 Moos in Passeier,38,,19,16,35
054 Moos in Passeier,39,,15,15,30
054 Moos in Passeier,40,,22,9,31
054 Moos in Passeier,41,,9,8,17
054 Moos in Passeier,42,,10,9,19
054 Moos in Passeier,43,,17,9,26
054 Moos in Passeier,44,,7,9,16
054 Moos in Passeier,45,,8,5,13
054 Moos in Passeier,46,,12,9,21
054 Moos in Passeier,47,,10,9,19
054 Moos in Passeier,48,,17,9,26
054 Moos in Passeier,49,,6,7,13
054 Moos in Passeier,50,,22,11,33
054 Moos in Passeier,51,,9,8,17
054 Moos in Passeier,52,,8,6,14
054 Moos in Passeier,53,,9,9,18
054 Moos in Passeier,54,,15,12,27
054 Moos in Passeier,55,,6,12,18
054 Moos in Passeier,56,,11,16,27
054 Moos in Passeier,57,,8,10,18
054 Moos in Passeier,58,,6,7,13
054 Moos in Passeier,59,,12,9,21
054 Moos in Passeier,60,,5,7,12
054 Moos in Passeier,61,,8,8,16
054 Moos in Passeier,62,,9,8,17
054 Moos in Passeier,63,,10,14,24
054 Moos in Passeier,64,,9,11,20
054 Moos in Passeier,65,,9,4,13
054 Moos in Passeier,66,,11,8,19
054 Moos in Passeier,67,,11,8,19
054 Moos in Passeier,68,,9,13,22
054 Moos in Passeier,69,,4,10,14
054 Moos in Passeier,70,,8,6,14
054 Moos in Passeier,71,,11,4,15
054 Moos in Passeier,72,,9,8,17
054 Moos in Passeier,73,,3,8,11
054 Moos in Passeier,74,,4,3,7
054 Moos in Passeier,75,,3,6,9
054 Moos in Passeier,76,,2,3,5
054 Moos in Passeier,77,,2,4,6
054 Moos in Passeier,78,,1,4,5
054 Moos in Passeier,79,,2,2,4
054 Moos in Passeier,80,,3,2,5
054 Moos in Passeier,81,,1,3,4
054 Moos in Passeier,82,,2,1,3
054 Moos in Passeier,83,,1,7,8
054 Moos in Passeier,84,,1,3,4
054 Moos in Passeier,85,,-,2,2
054 Moos in Passeier,86,,1,1,2
054 Moos in Passeier,87,,-,2,2
054 Moos in Passeier,88,,-,2,2
054 Moos in Passeier,89,,1,1,2
054 Moos in Passeier,91,,1,1,2
054 Moos in Passeier,Insgesamt,,1.133,1.043,2.176
055 Nals,0,,12,4,16
055 Nals,1,,12,10,22
055 Nals,2,,7,5,12
055 Nals,3,,11,8,19
055 Nals,4,,10,12,22
055 Nals,5,,14,9,23
055 Nals,6,,8,14,22
055 Nals,7,,10,8,18
055 Nals,8,,11,8,19
055 Nals,9,,8,13,21
055 Nals,10,,11,10,21
055 Nals,11,,5,2,7
055 Nals,12,,12,5,17
055 Nals,13,,8,9,17
055 Nals,14,,5,8,13
055 Nals,15,,7,13,20
055 Nals,16,,10,9,19
055 Nals,17,,14,8,22
055 Nals,18,,9,6,15
055 Nals,19,,10,7,17
055 Nals,20,,6,3,9
055 Nals,21,,11,14,25
055 Nals,22,,3,8,11
055 Nals,23,,18,12,30
055 Nals,24,,9,6,15
055 Nals,25,,7,15,22
055 Nals,26,,13,12,25
055 Nals,27,,17,13,30
055 Nals,28,,9,15,24
055 Nals,29,,15,22,37
055 Nals,30,,14,14,28
055 Nals,31,,15,9,24
055 Nals,32,,18,17,35
055 Nals,33,,21,17,38
055 Nals,34,,11,22,33
055 Nals,35,,18,11,29
055 Nals,36,,15,15,30
055 Nals,37,,13,9,22
055 Nals,38,,15,11,26
055 Nals,39,,17,15,32
055 Nals,40,,9,10,19
055 Nals,41,,7,9,16
055 Nals,42,,18,15,33
055 Nals,43,,7,7,14
055 Nals,44,,8,7,15
055 Nals,45,,8,7,15
055 Nals,46,,4,12,16
055 Nals,47,,8,9,17
055 Nals,48,,10,9,19
055 Nals,49,,11,11,22
055 Nals,50,,12,5,17
055 Nals,51,,6,13,19
055 Nals,52,,7,11,18
055 Nals,53,,6,11,17
055 Nals,54,,13,6,19
055 Nals,55,,5,8,13
055 Nals,56,,13,5,18
055 Nals,57,,8,10,18
055 Nals,58,,10,9,19
055 Nals,59,,7,8,15
055 Nals,60,,3,13,16
055 Nals,61,,5,4,9
055 Nals,62,,7,6,13
055 Nals,63,,6,6,12
055 Nals,64,,10,11,21
055 Nals,65,,6,5,11
055 Nals,66,,3,7,10
055 Nals,67,,5,6,11
055 Nals,68,,10,8,18
055 Nals,69,,7,10,17
055 Nals,70,,6,6,12
055 Nals,71,,8,6,14
055 Nals,72,,6,5,11
055 Nals,73,,3,2,5
055 Nals,74,,1,6,7
055 Nals,75,,3,7,10
055 Nals,76,,3,10,13
055 Nals,77,,1,2,3
055 Nals,78,,1,5,6
055 Nals,79,,2,-,2
055 Nals,80,,1,-,1
055 Nals,81,,-,2,2
055 Nals,82,,4,3,7
055 Nals,83,,-,5,5
055 Nals,84,,1,1,2
055 Nals,85,,2,3,5
055 Nals,86,,-,3,3
055 Nals,87,,1,2,3
055 Nals,88,,-,1,1
055 Nals,89,,1,2,3
055 Nals,91,,2,2,4
055 Nals,92,,-,1,1
055 Nals,94,,1,-,1
055 Nals,Insgesamt,,745,760,1.505
056 Naturns,0,,22,18,40
056 Naturns,1,,33,34,67
056 Naturns,2,,46,32,78
056 Naturns,3,,35,39,74
056 Naturns,4,,33,40,73
056 Naturns,5,,33,39,72
056 Naturns,6,,45,39,84
056 Naturns,7,,35,31,66
056 Naturns,8,,38,25,63
056 Naturns,9,,43,34,77
056 Naturns,10,,34,20,54
056 Naturns,11,,28,25,53
056 Naturns,12,,38,23,61
056 Naturns,13,,37,20,57
056 Naturns,14,,30,35,65
056 Naturns,15,,37,30,67
056 Naturns,16,,37,49,86
056 Naturns,17,,33,29,62
056 Naturns,18,,42,36,78
056 Naturns,19,,37,41,78
056 Naturns,20,,30,35,65
056 Naturns,21,,34,38,72
056 Naturns,22,,28,35,63
056 Naturns,23,,41,37,78
056 Naturns,24,,43,34,77
056 Naturns,25,,43,42,85
056 Naturns,26,,37,42,79
056 Naturns,27,,42,40,82
056 Naturns,28,,39,49,88
056 Naturns,29,,49,40,89
056 Naturns,30,,44,48,92
056 Naturns,31,,52,44,96
056 Naturns,32,,43,53,96
056 Naturns,33,,48,38,86
056 Naturns,34,,42,48,90
056 Naturns,35,,44,47,91
056 Naturns,36,,39,42,81
056 Naturns,37,,57,42,99
056 Naturns,38,,42,41,83
056 Naturns,39,,31,35,66
056 Naturns,40,,34,34,68
056 Naturns,41,,41,35,76
056 Naturns,42,,32,32,64
056 Naturns,43,,43,33,76
056 Naturns,44,,31,30,61
056 Naturns,45,,37,36,73
056 Naturns,46,,35,36,71
056 Naturns,47,,27,34,61
056 Naturns,48,,26,19,45
056 Naturns,49,,32,26,58
056 Naturns,50,,18,18,36
056 Naturns,51,,26,30,56
056 Naturns,52,,27,18,45
056 Naturns,53,,21,22,43
056 Naturns,54,,27,34,61
056 Naturns,55,,34,36,70
056 Naturns,56,,42,33,75
056 Naturns,57,,23,20,43
056 Naturns,58,,23,20,43
056 Naturns,59,,26,16,42
056 Naturns,60,,23,23,46
056 Naturns,61,,22,19,41
056 Naturns,62,,24,11,35
056 Naturns,63,,21,20,41
056 Naturns,64,,18,15,33
056 Naturns,65,,14,20,34
056 Naturns,66,,12,26,38
056 Naturns,67,,21,25,46
056 Naturns,68,,19,18,37
056 Naturns,69,,19,16,35
056 Naturns,70,,14,20,34
056 Naturns,71,,14,21,35
056 Naturns,72,,17,18,35
056 Naturns,73,,18,17,35
056 Naturns,74,,17,14,31
056 Naturns,75,,7,16,23
056 Naturns,76,,9,20,29
056 Naturns,77,,4,8,12
056 Naturns,78,,4,13,17
056 Naturns,79,,3,6,9
056 Naturns,80,,3,3,6
056 Naturns,81,,4,5,9
056 Naturns,82,,1,10,11
056 Naturns,83,,6,14,20
056 Naturns,84,,5,16,21
056 Naturns,85,,4,8,12
056 Naturns,86,,6,9,15
056 Naturns,87,,8,4,12
056 Naturns,88,,2,10,12
056 Naturns,89,,-,3,3
056 Naturns,90,,2,7,9
056 Naturns,91,,3,2,5
056 Naturns,92,,1,2,3
056 Naturns,93,,1,5,6
056 Naturns,94,,-,1,1
056 Naturns,96,,-,1,1
056 Naturns,97,,1,1,2
056 Naturns,100,,1,-,1
056 Naturns,Insgesamt,,2.497,2.478,4.975
057 Natz-Schabs,0,,16,17,33
057 Natz-Schabs,1,,22,19,41
057 Natz-Schabs,2,,15,12,27
057 Natz-Schabs,3,,18,16,34
057 Natz-Schabs,4,,15,18,33
057 Natz-Schabs,5,,17,14,31
057 Natz-Schabs,6,,23,20,43
057 Natz-Schabs,7,,15,25,40
057 Natz-Schabs,8,,14,25,39
057 Natz-Schabs,9,,23,17,40
057 Natz-Schabs,10,,20,21,41
057 Natz-Schabs,11,,17,21,38
057 Natz-Schabs,12,,20,22,42
057 Natz-Schabs,13,,17,18,35
057 Natz-Schabs,14,,21,19,40
057 Natz-Schabs,15,,10,19,29
057 Natz-Schabs,16,,18,23,41
057 Natz-Schabs,17,,22,11,33
057 Natz-Schabs,18,,13,14,27
057 Natz-Schabs,19,,12,11,23
057 Natz-Schabs,20,,12,10,22
057 Natz-Schabs,21,,9,11,20
057 Natz-Schabs,22,,13,17,30
057 Natz-Schabs,23,,14,21,35
057 Natz-Schabs,24,,15,18,33
057 Natz-Schabs,25,,18,18,36
057 Natz-Schabs,26,,19,18,37
057 Natz-Schabs,27,,26,23,49
057 Natz-Schabs,28,,24,15,39
057 Natz-Schabs,29,,24,14,38
057 Natz-Schabs,30,,28,26,54
057 Natz-Schabs,31,,28,16,44
057 Natz-Schabs,32,,28,32,60
057 Natz-Schabs,33,,27,25,52
057 Natz-Schabs,34,,24,21,45
057 Natz-Schabs,35,,18,21,39
057 Natz-Schabs,36,,18,18,36
057 Natz-Schabs,37,,26,23,49
057 Natz-Schabs,38,,21,19,40
057 Natz-Schabs,39,,21,18,39
057 Natz-Schabs,40,,18,19,37
057 Natz-Schabs,41,,18,21,39
057 Natz-Schabs,42,,20,16,36
057 Natz-Schabs,43,,13,12,25
057 Natz-Schabs,44,,17,14,31
057 Natz-Schabs,45,,15,9,24
057 Natz-Schabs,46,,12,10,22
057 Natz-Schabs,47,,19,16,35
057 Natz-Schabs,48,,22,14,36
057 Natz-Schabs,49,,12,14,26
057 Natz-Schabs,50,,11,13,24
057 Natz-Schabs,51,,14,10,24
057 Natz-Schabs,52,,10,9,19
057 Natz-Schabs,53,,13,13,26
057 Natz-Schabs,54,,9,8,17
057 Natz-Schabs,55,,14,7,21
057 Natz-Schabs,56,,14,9,23
057 Natz-Schabs,57,,3,8,11
057 Natz-Schabs,58,,2,6,8
057 Natz-Schabs,59,,5,6,11
057 Natz-Schabs,60,,12,9,21
057 Natz-Schabs,61,,10,4,14
057 Natz-Schabs,62,,9,7,16
057 Natz-Schabs,63,,7,3,10
057 Natz-Schabs,64,,8,12,20
057 Natz-Schabs,65,,6,9,15
057 Natz-Schabs,66,,8,6,14
057 Natz-Schabs,67,,6,7,13
057 Natz-Schabs,68,,11,2,13
057 Natz-Schabs,69,,5,10,15
057 Natz-Schabs,70,,2,5,7
057 Natz-Schabs,71,,4,8,12
057 Natz-Schabs,72,,4,6,10
057 Natz-Schabs,73,,2,7,9
057 Natz-Schabs,74,,2,9,11
057 Natz-Schabs,75,,6,4,10
057 Natz-Schabs,76,,5,5,10
057 Natz-Schabs,77,,3,10,13
057 Natz-Schabs,78,,-,2,2
057 Natz-Schabs,79,,1,4,5
057 Natz-Schabs,80,,2,2,4
057 Natz-Schabs,81,,3,-,3
057 Natz-Schabs,82,,1,2,3
057 Natz-Schabs,83,,1,1,2
057 Natz-Schabs,84,,2,-,2
057 Natz-Schabs,85,,1,3,4
057 Natz-Schabs,86,,1,1,2
057 Natz-Schabs,88,,2,-,2
057 Natz-Schabs,89,,1,1,2
057 Natz-Schabs,91,,2,-,2
057 Natz-Schabs,Insgesamt,,1.149,1.119,2.268
058 Welschnofen,0,,13,9,22
058 Welschnofen,1,,8,11,19
058 Welschnofen,2,,14,12,26
058 Welschnofen,3,,11,12,23
058 Welschnofen,4,,11,8,19
058 Welschnofen,5,,14,12,26
058 Welschnofen,6,,13,11,24
058 Welschnofen,7,,10,13,23
058 Welschnofen,8,,13,8,21
058 Welschnofen,9,,13,15,28
058 Welschnofen,10,,9,9,18
058 Welschnofen,11,,6,12,18
058 Welschnofen,12,,11,7,18
058 Welschnofen,13,,7,8,15
058 Welschnofen,14,,10,13,23
058 Welschnofen,15,,10,17,27
058 Welschnofen,16,,12,10,22
058 Welschnofen,17,,12,7,19
058 Welschnofen,18,,11,3,14
058 Welschnofen,19,,13,12,25
058 Welschnofen,20,,11,17,28
058 Welschnofen,21,,18,10,28
058 Welschnofen,22,,15,11,26
058 Welschnofen,23,,14,15,29
058 Welschnofen,24,,12,14,26
058 Welschnofen,25,,11,12,23
058 Welschnofen,26,,10,14,24
058 Welschnofen,27,,14,14,28
058 Welschnofen,28,,13,15,28
058 Welschnofen,29,,18,17,35
058 Welschnofen,30,,17,14,31
058 Welschnofen,31,,23,14,37
058 Welschnofen,32,,20,16,36
058 Welschnofen,33,,13,9,22
058 Welschnofen,34,,18,17,35
058 Welschnofen,35,,12,15,27
058 Welschnofen,36,,18,19,37
058 Welschnofen,37,,22,8,30
058 Welschnofen,38,,13,11,24
058 Welschnofen,39,,17,10,27
058 Welschnofen,40,,10,13,23
058 Welschnofen,41,,10,12,22
058 Welschnofen,42,,15,14,29
058 Welschnofen,43,,15,11,26
058 Welschnofen,44,,11,14,25
058 Welschnofen,45,,11,9,20
058 Welschnofen,46,,18,6,24
058 Welschnofen,47,,8,7,15
058 Welschnofen,48,,13,13,26
058 Welschnofen,49,,10,11,21
058 Welschnofen,50,,9,7,16
058 Welschnofen,51,,10,10,20
058 Welschnofen,52,,8,6,14
058 Welschnofen,53,,7,11,18
058 Welschnofen,54,,14,11,25
058 Welschnofen,55,,14,13,27
058 Welschnofen,56,,11,7,18
058 Welschnofen,57,,7,7,14
058 Welschnofen,58,,11,7,18
058 Welschnofen,59,,7,6,13
058 Welschnofen,60,,9,4,13
058 Welschnofen,61,,6,12,18
058 Welschnofen,62,,7,6,13
058 Welschnofen,63,,12,10,22
058 Welschnofen,64,,10,14,24
058 Welschnofen,65,,8,7,15
058 Welschnofen,66,,6,9,15
058 Welschnofen,67,,8,10,18
058 Welschnofen,68,,11,12,23
058 Welschnofen,69,,7,6,13
058 Welschnofen,70,,4,4,8
058 Welschnofen,71,,6,7,13
058 Welschnofen,72,,8,6,14
058 Welschnofen,73,,5,15,20
058 Welschnofen,74,,7,10,17
058 Welschnofen,75,,6,7,13
058 Welschnofen,76,,3,11,14
058 Welschnofen,77,,3,8,11
058 Welschnofen,78,,2,6,8
058 Welschnofen,79,,2,2,4
058 Welschnofen,80,,1,1,2
058 Welschnofen,81,,2,5,7
058 Welschnofen,82,,1,4,5
058 Welschnofen,83,,3,4,7
058 Welschnofen,84,,1,10,11
058 Welschnofen,85,,3,7,10
058 Welschnofen,86,,2,3,5
058 Welschnofen,87,,2,6,8
058 Welschnofen,88,,2,2,4
058 Welschnofen,89,,2,-,2
058 Welschnofen,90,,-,2,2
058 Welschnofen,91,,-,2,2
058 Welschnofen,92,,1,-,1
058 Welschnofen,93,,1,1,2
058 Welschnofen,95,,1,2,3
058 Welschnofen,97,,-,1,1
058 Welschnofen,Insgesamt,,901,892,1.793
059 Deutschnofen,0,,22,25,47
059 Deutschnofen,1,,20,28,48
059 Deutschnofen,2,,26,26,52
059 Deutschnofen,3,,30,17,47
059 Deutschnofen,4,,22,27,49
059 Deutschnofen,5,,31,28,59
059 Deutschnofen,6,,20,20,40
059 Deutschnofen,7,,35,28,63
059 Deutschnofen,8,,22,22,44
059 Deutschnofen,9,,22,33,55
059 Deutschnofen,10,,20,25,45
059 Deutschnofen,11,,28,18,46
059 Deutschnofen,12,,26,20,46
059 Deutschnofen,13,,35,27,62
059 Deutschnofen,14,,22,22,44
059 Deutschnofen,15,,20,34,54
059 Deutschnofen,16,,20,17,37
059 Deutschnofen,17,,28,18,46
059 Deutschnofen,18,,22,27,49
059 Deutschnofen,19,,23,19,42
059 Deutschnofen,20,,31,22,53
059 Deutschnofen,21,,12,19,31
059 Deutschnofen,22,,19,25,44
059 Deutschnofen,23,,28,30,58
059 Deutschnofen,24,,16,29,45
059 Deutschnofen,25,,22,31,53
059 Deutschnofen,26,,27,23,50
059 Deutschnofen,27,,29,25,54
059 Deutschnofen,28,,39,27,66
059 Deutschnofen,29,,24,27,51
059 Deutschnofen,30,,31,32,63
059 Deutschnofen,31,,30,34,64
059 Deutschnofen,32,,39,23,62
059 Deutschnofen,33,,33,27,60
059 Deutschnofen,34,,30,24,54
059 Deutschnofen,35,,25,28,53
059 Deutschnofen,36,,36,22,58
059 Deutschnofen,37,,42,25,67
059 Deutschnofen,38,,24,22,46
059 Deutschnofen,39,,25,30,55
059 Deutschnofen,40,,22,26,48
059 Deutschnofen,41,,33,26,59
059 Deutschnofen,42,,28,23,51
059 Deutschnofen,43,,25,19,44
059 Deutschnofen,44,,23,17,40
059 Deutschnofen,45,,24,23,47
059 Deutschnofen,46,,24,14,38
059 Deutschnofen,47,,17,21,38
059 Deutschnofen,48,,24,13,37
059 Deutschnofen,49,,25,18,43
059 Deutschnofen,50,,13,14,27
059 Deutschnofen,51,,16,23,39
059 Deutschnofen,52,,18,15,33
059 Deutschnofen,53,,15,18,33
059 Deutschnofen,54,,26,19,45
059 Deutschnofen,55,,19,16,35
059 Deutschnofen,56,,14,25,39
059 Deutschnofen,57,,13,19,32
059 Deutschnofen,58,,26,14,40
059 Deutschnofen,59,,16,23,39
059 Deutschnofen,60,,11,8,19
059 Deutschnofen,61,,15,10,25
059 Deutschnofen,62,,11,12,23
059 Deutschnofen,63,,16,13,29
059 Deutschnofen,64,,9,14,23
059 Deutschnofen,65,,17,14,31
059 Deutschnofen,66,,14,9,23
059 Deutschnofen,67,,13,11,24
059 Deutschnofen,68,,11,11,22
059 Deutschnofen,69,,12,24,36
059 Deutschnofen,70,,10,15,25
059 Deutschnofen,71,,17,11,28
059 Deutschnofen,72,,11,24,35
059 Deutschnofen,73,,7,13,20
059 Deutschnofen,74,,8,12,20
059 Deutschnofen,75,,11,20,31
059 Deutschnofen,76,,7,18,25
059 Deutschnofen,77,,5,12,17
059 Deutschnofen,78,,2,6,8
059 Deutschnofen,79,,3,7,10
059 Deutschnofen,80,,1,5,6
059 Deutschnofen,81,,4,4,8
059 Deutschnofen,82,,6,7,13
059 Deutschnofen,83,,4,12,16
059 Deutschnofen,84,,7,11,18
059 Deutschnofen,85,,3,8,11
059 Deutschnofen,86,,2,8,10
059 Deutschnofen,87,,3,6,9
059 Deutschnofen,88,,-,4,4
059 Deutschnofen,89,,3,1,4
059 Deutschnofen,90,,2,-,2
059 Deutschnofen,91,,2,2,4
059 Deutschnofen,92,,-,1,1
059 Deutschnofen,93,,1,2,3
059 Deutschnofen,94,,1,-,1
059 Deutschnofen,95,,-,1,1
059 Deutschnofen,96,,-,2,2
059 Deutschnofen,Insgesamt,,1.726,1.730,3.456
060 Auer,0,,20,20,40
060 Auer,1,,15,22,37
060 Auer,2,,21,15,36
060 Auer,3,,19,16,35
060 Auer,4,,12,22,34
060 Auer,5,,16,20,36
060 Auer,6,,23,13,36
060 Auer,7,,16,16,32
060 Auer,8,,19,18,37
060 Auer,9,,18,24,42
060 Auer,10,,21,14,35
060 Auer,11,,15,15,30
060 Auer,12,,22,17,39
060 Auer,13,,14,9,23
060 Auer,14,,16,15,31
060 Auer,15,,18,24,42
060 Auer,16,,13,15,28
060 Auer,17,,14,11,25
060 Auer,18,,17,17,34
060 Auer,19,,11,8,19
060 Auer,20,,13,17,30
060 Auer,21,,17,22,39
060 Auer,22,,11,14,25
060 Auer,23,,21,21,42
060 Auer,24,,25,15,40
060 Auer,25,,12,23,35
060 Auer,26,,24,21,45
060 Auer,27,,24,16,40
060 Auer,28,,19,27,46
060 Auer,29,,25,34,59
060 Auer,30,,26,25,51
060 Auer,31,,29,36,65
060 Auer,32,,32,27,59
060 Auer,33,,32,19,51
060 Auer,34,,31,32,63
060 Auer,35,,22,23,45
060 Auer,36,,38,31,69
060 Auer,37,,23,32,55
060 Auer,38,,32,29,61
060 Auer,39,,31,20,51
060 Auer,40,,24,27,51
060 Auer,41,,30,27,57
060 Auer,42,,16,25,41
060 Auer,43,,18,12,30
060 Auer,44,,15,20,35
060 Auer,45,,21,19,40
060 Auer,46,,16,20,36
060 Auer,47,,15,23,38
060 Auer,48,,12,13,25
060 Auer,49,,26,15,41
060 Auer,50,,16,22,38
060 Auer,51,,19,24,43
060 Auer,52,,14,13,27
060 Auer,53,,22,16,38
060 Auer,54,,17,20,37
060 Auer,55,,17,20,37
060 Auer,56,,22,15,37
060 Auer,57,,14,9,23
060 Auer,58,,14,19,33
060 Auer,59,,18,21,39
060 Auer,60,,12,14,26
060 Auer,61,,9,11,20
060 Auer,62,,9,15,24
060 Auer,63,,20,17,37
060 Auer,64,,6,10,16
060 Auer,65,,4,18,22
060 Auer,66,,13,10,23
060 Auer,67,,11,10,21
060 Auer,68,,12,15,27
060 Auer,69,,12,13,25
060 Auer,70,,10,14,24
060 Auer,71,,7,17,24
060 Auer,72,,16,12,28
060 Auer,73,,12,9,21
060 Auer,74,,10,15,25
060 Auer,75,,5,18,23
060 Auer,76,,5,12,17
060 Auer,77,,7,12,19
060 Auer,78,,6,3,9
060 Auer,79,,2,9,11
060 Auer,80,,4,5,9
060 Auer,81,,2,3,5
060 Auer,82,,2,3,5
060 Auer,83,,1,4,5
060 Auer,84,,4,7,11
060 Auer,85,,1,6,7
060 Auer,86,,1,3,4
060 Auer,87,,1,1,2
060 Auer,88,,2,3,5
060 Auer,89,,1,2,3
060 Auer,90,,1,3,4
060 Auer,91,,-,1,1
060 Auer,93,,-,2,2
060 Auer,94,,-,2,2
060 Auer,102,,-,1,1
060 Auer,Insgesamt,,1.401,1.495,2.896
061 St.Ulrich,0,,30,32,62
061 St.Ulrich,1,,31,21,52
061 St.Ulrich,2,,34,32,66
061 St.Ulrich,3,,27,30,57
061 St.Ulrich,4,,22,29,51
061 St.Ulrich,5,,35,32,67
061 St.Ulrich,6,,31,32,63
061 St.Ulrich,7,,29,22,51
061 St.Ulrich,8,,17,25,42
061 St.Ulrich,9,,18,23,41
061 St.Ulrich,10,,27,18,45
061 St.Ulrich,11,,18,18,36
061 St.Ulrich,12,,24,21,45
061 St.Ulrich,13,,23,18,41
061 St.Ulrich,14,,20,20,40
061 St.Ulrich,15,,24,26,50
061 St.Ulrich,16,,21,24,45
061 St.Ulrich,17,,24,29,53
061 St.Ulrich,18,,30,22,52
061 St.Ulrich,19,,22,25,47
061 St.Ulrich,20,,24,23,47
061 St.Ulrich,21,,33,35,68
061 St.Ulrich,22,,36,31,67
061 St.Ulrich,23,,38,26,64
061 St.Ulrich,24,,40,25,65
061 St.Ulrich,25,,45,42,87
061 St.Ulrich,26,,37,38,75
061 St.Ulrich,27,,41,30,71
061 St.Ulrich,28,,50,41,91
061 St.Ulrich,29,,46,41,87
061 St.Ulrich,30,,33,35,68
061 St.Ulrich,31,,43,34,77
061 St.Ulrich,32,,33,35,68
061 St.Ulrich,33,,41,42,83
061 St.Ulrich,34,,40,34,74
061 St.Ulrich,35,,31,35,66
061 St.Ulrich,36,,31,24,55
061 St.Ulrich,37,,36,29,65
061 St.Ulrich,38,,39,25,64
061 St.Ulrich,39,,24,18,42
061 St.Ulrich,40,,26,35,61
061 St.Ulrich,41,,18,28,46
061 St.Ulrich,42,,27,37,64
061 St.Ulrich,43,,25,34,59
061 St.Ulrich,44,,29,17,46
061 St.Ulrich,45,,15,27,42
061 St.Ulrich,46,,26,24,50
061 St.Ulrich,47,,25,24,49
061 St.Ulrich,48,,19,28,47
061 St.Ulrich,49,,31,31,62
061 St.Ulrich,50,,23,23,46
061 St.Ulrich,51,,39,26,65
061 St.Ulrich,52,,21,19,40
061 St.Ulrich,53,,31,32,63
061 St.Ulrich,54,,41,39,80
061 St.Ulrich,55,,33,37,70
061 St.Ulrich,56,,43,45,88
061 St.Ulrich,57,,33,29,62
061 St.Ulrich,58,,20,20,40
061 St.Ulrich,59,,27,28,55
061 St.Ulrich,60,,24,27,51
061 St.Ulrich,61,,26,17,43
061 St.Ulrich,62,,15,23,38
061 St.Ulrich,63,,21,12,33
061 St.Ulrich,64,,20,14,34
061 St.Ulrich,65,,16,22,38
061 St.Ulrich,66,,21,17,38
061 St.Ulrich,67,,21,10,31
061 St.Ulrich,68,,19,7,26
061 St.Ulrich,69,,18,13,31
061 St.Ulrich,70,,18,19,37
061 St.Ulrich,71,,11,16,27
061 St.Ulrich,72,,14,12,26
061 St.Ulrich,73,,10,22,32
061 St.Ulrich,74,,12,26,38
061 St.Ulrich,75,,6,20,26
061 St.Ulrich,76,,10,17,27
061 St.Ulrich,77,,12,19,31
061 St.Ulrich,78,,8,13,21
061 St.Ulrich,79,,7,10,17
061 St.Ulrich,80,,2,8,10
061 St.Ulrich,81,,6,7,13
061 St.Ulrich,82,,4,11,15
061 St.Ulrich,83,,12,13,25
061 St.Ulrich,84,,10,23,33
061 St.Ulrich,85,,10,16,26
061 St.Ulrich,86,,1,11,12
061 St.Ulrich,87,,6,6,12
061 St.Ulrich,88,,6,2,8
061 St.Ulrich,89,,3,1,4
061 St.Ulrich,90,,1,8,9
061 St.Ulrich,91,,-,4,4
061 St.Ulrich,92,,3,3,6
061 St.Ulrich,93,,-,4,4
061 St.Ulrich,94,,2,-,2
061 St.Ulrich,95,,-,1,1
061 St.Ulrich,Insgesamt,,2.175,2.179,4.354
062 Partschins,0,,22,24,46
062 Partschins,1,,14,17,31
062 Partschins,2,,25,14,39
062 Partschins,3,,20,17,37
062 Partschins,4,,25,16,41
062 Partschins,5,,20,17,37
062 Partschins,6,,24,27,51
062 Partschins,7,,23,23,46
062 Partschins,8,,12,23,35
062 Partschins,9,,20,27,47
062 Partschins,10,,17,13,30
062 Partschins,11,,23,20,43
062 Partschins,12,,11,15,26
062 Partschins,13,,20,21,41
062 Partschins,14,,16,22,38
062 Partschins,15,,18,20,38
062 Partschins,16,,20,27,47
062 Partschins,17,,25,17,42
062 Partschins,18,,14,14,28
062 Partschins,19,,17,21,38
062 Partschins,20,,29,18,47
062 Partschins,21,,17,15,32
062 Partschins,22,,28,22,50
062 Partschins,23,,20,13,33
062 Partschins,24,,26,22,48
062 Partschins,25,,25,28,53
062 Partschins,26,,25,26,51
062 Partschins,27,,24,24,48
062 Partschins,28,,33,31,64
062 Partschins,29,,24,28,52
062 Partschins,30,,31,21,52
062 Partschins,31,,36,33,69
062 Partschins,32,,30,34,64
062 Partschins,33,,27,41,68
062 Partschins,34,,36,26,62
062 Partschins,35,,33,23,56
062 Partschins,36,,19,28,47
062 Partschins,37,,24,38,62
062 Partschins,38,,27,17,44
062 Partschins,39,,23,17,40
062 Partschins,40,,20,25,45
062 Partschins,41,,25,19,44
062 Partschins,42,,24,27,51
062 Partschins,43,,9,27,36
062 Partschins,44,,24,14,38
062 Partschins,45,,17,14,31
062 Partschins,46,,19,14,33
062 Partschins,47,,15,21,36
062 Partschins,48,,9,11,20
062 Partschins,49,,18,17,35
062 Partschins,50,,20,17,37
062 Partschins,51,,32,29,61
062 Partschins,52,,13,15,28
062 Partschins,53,,16,18,34
062 Partschins,54,,23,27,50
062 Partschins,55,,14,18,32
062 Partschins,56,,23,30,53
062 Partschins,57,,14,14,28
062 Partschins,58,,11,15,26
062 Partschins,59,,20,15,35
062 Partschins,60,,14,16,30
062 Partschins,61,,14,19,33
062 Partschins,62,,11,10,21
062 Partschins,63,,12,17,29
062 Partschins,64,,15,15,30
062 Partschins,65,,15,10,25
062 Partschins,66,,16,22,38
062 Partschins,67,,14,12,26
062 Partschins,68,,13,11,24
062 Partschins,69,,13,15,28
062 Partschins,70,,11,12,23
062 Partschins,71,,11,10,21
062 Partschins,72,,10,13,23
062 Partschins,73,,5,15,20
062 Partschins,74,,10,12,22
062 Partschins,75,,7,8,15
062 Partschins,76,,16,10,26
062 Partschins,77,,5,9,14
062 Partschins,78,,5,10,15
062 Partschins,79,,2,3,5
062 Partschins,80,,2,6,8
062 Partschins,81,,2,3,5
062 Partschins,82,,3,1,4
062 Partschins,83,,6,8,14
062 Partschins,84,,2,10,12
062 Partschins,85,,1,9,10
062 Partschins,86,,7,3,10
062 Partschins,87,,1,9,10
062 Partschins,88,,-,3,3
062 Partschins,89,,1,2,3
062 Partschins,90,,-,1,1
062 Partschins,91,,3,2,5
062 Partschins,92,,1,1,2
062 Partschins,93,,-,1,1
062 Partschins,94,,1,1,2
062 Partschins,95,,-,2,2
062 Partschins,Insgesamt,,1.538,1.598,3.136
063 Percha,0,,11,14,25
063 Percha,1,,9,5,14
063 Percha,2,,7,7,14
063 Percha,3,,10,11,21
063 Percha,4,,7,10,17
063 Percha,5,,14,6,20
063 Percha,6,,9,9,18
063 Percha,7,,8,7,15
063 Percha,8,,6,8,14
063 Percha,9,,6,5,11
063 Percha,10,,9,17,26
063 Percha,11,,5,7,12
063 Percha,12,,8,13,21
063 Percha,13,,17,9,26
063 Percha,14,,14,9,23
063 Percha,15,,6,11,17
063 Percha,16,,9,6,15
063 Percha,17,,11,5,16
063 Percha,18,,5,12,17
063 Percha,19,,8,11,19
063 Percha,20,,9,8,17
063 Percha,21,,15,10,25
063 Percha,22,,10,6,16
063 Percha,23,,5,10,15
063 Percha,24,,11,7,18
063 Percha,25,,12,16,28
063 Percha,26,,16,8,24
063 Percha,27,,8,13,21
063 Percha,28,,17,14,31
063 Percha,29,,14,14,28
063 Percha,30,,11,12,23
063 Percha,31,,20,7,27
063 Percha,32,,13,19,32
063 Percha,33,,16,12,28
063 Percha,34,,11,16,27
063 Percha,35,,15,11,26
063 Percha,36,,12,11,23
063 Percha,37,,10,7,17
063 Percha,38,,6,8,14
063 Percha,39,,9,8,17
063 Percha,40,,9,5,14
063 Percha,41,,6,12,18
063 Percha,42,,12,11,23
063 Percha,43,,4,4,8
063 Percha,44,,8,7,15
063 Percha,45,,4,8,12
063 Percha,46,,7,7,14
063 Percha,47,,6,8,14
063 Percha,48,,9,5,14
063 Percha,49,,5,4,9
063 Percha,50,,5,7,12
063 Percha,51,,8,8,16
063 Percha,52,,8,5,13
063 Percha,53,,12,4,16
063 Percha,54,,8,7,15
063 Percha,55,,10,7,17
063 Percha,56,,9,6,15
063 Percha,57,,5,5,10
063 Percha,58,,7,6,13
063 Percha,59,,5,10,15
063 Percha,60,,1,5,6
063 Percha,61,,4,5,9
063 Percha,62,,4,5,9
063 Percha,63,,5,6,11
063 Percha,64,,5,5,10
063 Percha,65,,5,3,8
063 Percha,66,,7,2,9
063 Percha,67,,10,4,14
063 Percha,68,,5,5,10
063 Percha,69,,4,4,8
063 Percha,70,,6,4,10
063 Percha,71,,3,8,11
063 Percha,72,,4,6,10
063 Percha,73,,2,3,5
063 Percha,74,,2,5,7
063 Percha,75,,3,2,5
063 Percha,76,,1,2,3
063 Percha,77,,1,3,4
063 Percha,78,,-,1,1
063 Percha,79,,1,1,2
063 Percha,81,,1,1,2
063 Percha,82,,1,1,2
063 Percha,83,,-,4,4
063 Percha,85,,-,4,4
063 Percha,87,,1,-,1
063 Percha,102,,-,1,1
063 Percha,Insgesamt,,642,625,1.267
064 Plaus,0,,7,3,10
064 Plaus,1,,6,2,8
064 Plaus,2,,2,3,5
064 Plaus,3,,3,2,5
064 Plaus,4,,6,3,9
064 Plaus,5,,5,5,10
064 Plaus,6,,3,8,11
064 Plaus,7,,4,2,6
064 Plaus,8,,2,6,8
064 Plaus,9,,3,2,5
064 Plaus,10,,4,2,6
064 Plaus,11,,-,4,4
064 Plaus,12,,2,4,6
064 Plaus,13,,4,1,5
064 Plaus,14,,2,1,3
064 Plaus,15,,-,3,3
064 Plaus,16,,2,2,4
064 Plaus,17,,-,5,5
064 Plaus,18,,1,3,4
064 Plaus,19,,3,6,9
064 Plaus,20,,1,3,4
064 Plaus,21,,3,1,4
064 Plaus,22,,7,-,7
064 Plaus,23,,4,3,7
064 Plaus,24,,5,2,7
064 Plaus,25,,4,5,9
064 Plaus,26,,4,6,10
064 Plaus,27,,6,5,11
064 Plaus,28,,7,8,15
064 Plaus,29,,3,7,10
064 Plaus,30,,11,5,16
064 Plaus,31,,3,6,9
064 Plaus,32,,9,2,11
064 Plaus,33,,9,9,18
064 Plaus,34,,1,6,7
064 Plaus,35,,6,4,10
064 Plaus,36,,5,2,7
064 Plaus,37,,1,5,6
064 Plaus,38,,8,1,9
064 Plaus,39,,3,3,6
064 Plaus,40,,2,2,4
064 Plaus,41,,7,1,8
064 Plaus,42,,3,3,6
064 Plaus,43,,1,1,2
064 Plaus,44,,3,4,7
064 Plaus,45,,6,2,8
064 Plaus,46,,4,3,7
064 Plaus,47,,1,2,3
064 Plaus,48,,3,3,6
064 Plaus,49,,1,3,4
064 Plaus,50,,3,4,7
064 Plaus,51,,6,3,9
064 Plaus,52,,3,1,4
064 Plaus,53,,2,3,5
064 Plaus,54,,4,1,5
064 Plaus,55,,-,4,4
064 Plaus,56,,4,4,8
064 Plaus,57,,3,2,5
064 Plaus,58,,3,2,5
064 Plaus,59,,1,1,2
064 Plaus,60,,3,4,7
064 Plaus,62,,2,2,4
064 Plaus,63,,4,3,7
064 Plaus,64,,1,3,4
064 Plaus,65,,1,3,4
064 Plaus,66,,2,1,3
064 Plaus,67,,-,1,1
064 Plaus,68,,1,1,2
064 Plaus,69,,1,-,1
064 Plaus,70,,1,1,2
064 Plaus,71,,1,2,3
064 Plaus,72,,1,-,1
064 Plaus,73,,-,4,4
064 Plaus,74,,-,4,4
064 Plaus,75,,1,2,3
064 Plaus,76,,1,1,2
064 Plaus,77,,2,1,3
064 Plaus,78,,-,2,2
064 Plaus,79,,-,2,2
064 Plaus,83,,-,1,1
064 Plaus,84,,1,1,2
064 Plaus,85,,1,1,2
064 Plaus,86,,-,1,1
064 Plaus,89,,3,-,3
064 Plaus,Insgesamt,,246,240,486
065 Waidbruck,0,,3,2,5
065 Waidbruck,1,,2,-,2
065 Waidbruck,2,,1,2,3
065 Waidbruck,3,,3,3,6
065 Waidbruck,4,,1,1,2
065 Waidbruck,5,,-,1,1
065 Waidbruck,6,,1,1,2
065 Waidbruck,7,,1,1,2
065 Waidbruck,8,,-,1,1
065 Waidbruck,9,,-,3,3
065 Waidbruck,10,,-,1,1
065 Waidbruck,11,,1,2,3
065 Waidbruck,13,,2,1,3
065 Waidbruck,14,,2,-,2
065 Waidbruck,16,,-,3,3
065 Waidbruck,17,,3,-,3
065 Waidbruck,18,,1,-,1
065 Waidbruck,19,,2,-,2
065 Waidbruck,20,,2,1,3
065 Waidbruck,21,,1,1,2
065 Waidbruck,23,,4,-,4
065 Waidbruck,24,,2,1,3
065 Waidbruck,25,,-,2,2
065 Waidbruck,26,,2,-,2
065 Waidbruck,27,,3,3,6
065 Waidbruck,28,,2,4,6
065 Waidbruck,29,,3,-,3
065 Waidbruck,30,,2,4,6
065 Waidbruck,31,,2,3,5
065 Waidbruck,32,,3,-,3
065 Waidbruck,33,,3,-,3
065 Waidbruck,34,,-,1,1
065 Waidbruck,35,,3,1,4
065 Waidbruck,36,,-,1,1
065 Waidbruck,37,,1,1,2
065 Waidbruck,38,,3,4,7
065 Waidbruck,39,,1,1,2
065 Waidbruck,40,,1,1,2
065 Waidbruck,41,,1,-,1
065 Waidbruck,42,,2,1,3
065 Waidbruck,43,,-,1,1
065 Waidbruck,44,,1,1,2
065 Waidbruck,45,,2,1,3
065 Waidbruck,46,,-,1,1
065 Waidbruck,51,,-,3,3
065 Waidbruck,52,,1,1,2
065 Waidbruck,53,,1,3,4
065 Waidbruck,55,,1,-,1
065 Waidbruck,56,,1,2,3
065 Waidbruck,57,,-,3,3
065 Waidbruck,58,,1,-,1
065 Waidbruck,59,,-,3,3
065 Waidbruck,60,,2,1,3
065 Waidbruck,61,,2,1,3
065 Waidbruck,62,,-,3,3
065 Waidbruck,63,,3,1,4
065 Waidbruck,64,,2,1,3
065 Waidbruck,65,,1,4,5
065 Waidbruck,66,,3,-,3
065 Waidbruck,67,,2,-,2
065 Waidbruck,68,,-,1,1
065 Waidbruck,69,,1,-,1
065 Waidbruck,70,,3,1,4
065 Waidbruck,71,,-,1,1
065 Waidbruck,72,,1,1,2
065 Waidbruck,74,,-,2,2
065 Waidbruck,75,,1,1,2
065 Waidbruck,77,,-,3,3
065 Waidbruck,78,,-,2,2
065 Waidbruck,82,,2,-,2
065 Waidbruck,83,,-,1,1
065 Waidbruck,85,,1,-,1
065 Waidbruck,92,,-,1,1
065 Waidbruck,Insgesamt,,96,96,192
066 Burgstall,0,,7,3,10
066 Burgstall,1,,2,10,12
066 Burgstall,2,,9,6,15
066 Burgstall,3,,5,7,12
066 Burgstall,4,,4,11,15
066 Burgstall,5,,7,5,12
066 Burgstall,6,,6,11,17
066 Burgstall,7,,12,8,20
066 Burgstall,8,,8,4,12
066 Burgstall,9,,6,6,12
066 Burgstall,10,,9,9,18
066 Burgstall,11,,10,4,14
066 Burgstall,12,,6,10,16
066 Burgstall,13,,9,12,21
066 Burgstall,14,,6,7,13
066 Burgstall,15,,14,7,21
066 Burgstall,16,,6,8,14
066 Burgstall,17,,10,4,14
066 Burgstall,18,,4,8,12
066 Burgstall,19,,6,7,13
066 Burgstall,20,,2,11,13
066 Burgstall,21,,9,7,16
066 Burgstall,22,,16,8,24
066 Burgstall,23,,5,11,16
066 Burgstall,24,,11,13,24
066 Burgstall,25,,10,17,27
066 Burgstall,26,,13,6,19
066 Burgstall,27,,8,7,15
066 Burgstall,28,,13,7,20
066 Burgstall,29,,13,11,24
066 Burgstall,30,,9,15,24
066 Burgstall,31,,19,11,30
066 Burgstall,32,,19,15,34
066 Burgstall,33,,17,11,28
066 Burgstall,34,,16,11,27
066 Burgstall,35,,17,9,26
066 Burgstall,36,,12,14,26
066 Burgstall,37,,9,8,17
066 Burgstall,38,,4,8,12
066 Burgstall,39,,11,10,21
066 Burgstall,40,,8,7,15
066 Burgstall,41,,13,9,22
066 Burgstall,42,,6,8,14
066 Burgstall,43,,9,12,21
066 Burgstall,44,,7,10,17
066 Burgstall,45,,8,13,21
066 Burgstall,46,,12,8,20
066 Burgstall,47,,11,10,21
066 Burgstall,48,,8,7,15
066 Burgstall,49,,6,12,18
066 Burgstall,50,,7,8,15
066 Burgstall,51,,9,8,17
066 Burgstall,52,,6,10,16
066 Burgstall,53,,11,8,19
066 Burgstall,54,,9,7,16
066 Burgstall,55,,5,6,11
066 Burgstall,56,,8,5,13
066 Burgstall,57,,5,13,18
066 Burgstall,58,,5,9,14
066 Burgstall,59,,11,14,25
066 Burgstall,60,,5,9,14
066 Burgstall,61,,5,6,11
066 Burgstall,62,,7,3,10
066 Burgstall,63,,10,7,17
066 Burgstall,64,,9,4,13
066 Burgstall,65,,4,8,12
066 Burgstall,66,,6,3,9
066 Burgstall,67,,6,7,13
066 Burgstall,68,,2,4,6
066 Burgstall,69,,4,9,13
066 Burgstall,70,,2,12,14
066 Burgstall,71,,5,10,15
066 Burgstall,72,,7,5,12
066 Burgstall,73,,1,9,10
066 Burgstall,74,,5,3,8
066 Burgstall,75,,7,5,12
066 Burgstall,76,,3,3,6
066 Burgstall,77,,4,4,8
066 Burgstall,78,,1,5,6
066 Burgstall,79,,-,1,1
066 Burgstall,80,,2,1,3
066 Burgstall,81,,2,3,5
066 Burgstall,82,,3,4,7
066 Burgstall,83,,3,4,7
066 Burgstall,84,,2,4,6
066 Burgstall,85,,-,5,5
066 Burgstall,86,,1,4,5
066 Burgstall,87,,1,1,2
066 Burgstall,88,,-,3,3
066 Burgstall,89,,1,-,1
066 Burgstall,90,,1,-,1
066 Burgstall,91,,1,-,1
066 Burgstall,95,,-,1,1
066 Burgstall,96,,1,-,1
066 Burgstall,Insgesamt,,654,688,1.342
067 Prad am Stilfser Joch,0,,21,18,39
067 Prad am Stilfser Joch,1,,17,17,34
067 Prad am Stilfser Joch,2,,22,12,34
067 Prad am Stilfser Joch,3,,21,24,45
067 Prad am Stilfser Joch,4,,26,27,53
067 Prad am Stilfser Joch,5,,17,20,37
067 Prad am Stilfser Joch,6,,18,12,30
067 Prad am Stilfser Joch,7,,19,21,40
067 Prad am Stilfser Joch,8,,20,22,42
067 Prad am Stilfser Joch,9,,31,16,47
067 Prad am Stilfser Joch,10,,11,19,30
067 Prad am Stilfser Joch,11,,26,26,52
067 Prad am Stilfser Joch,12,,30,22,52
067 Prad am Stilfser Joch,13,,31,29,60
067 Prad am Stilfser Joch,14,,28,25,53
067 Prad am Stilfser Joch,15,,28,22,50
067 Prad am Stilfser Joch,16,,24,24,48
067 Prad am Stilfser Joch,17,,27,23,50
067 Prad am Stilfser Joch,18,,19,9,28
067 Prad am Stilfser Joch,19,,21,19,40
067 Prad am Stilfser Joch,20,,20,35,55
067 Prad am Stilfser Joch,21,,22,22,44
067 Prad am Stilfser Joch,22,,23,14,37
067 Prad am Stilfser Joch,23,,33,25,58
067 Prad am Stilfser Joch,24,,23,30,53
067 Prad am Stilfser Joch,25,,31,23,54
067 Prad am Stilfser Joch,26,,34,25,59
067 Prad am Stilfser Joch,27,,30,24,54
067 Prad am Stilfser Joch,28,,26,27,53
067 Prad am Stilfser Joch,29,,32,31,63
067 Prad am Stilfser Joch,30,,24,24,48
067 Prad am Stilfser Joch,31,,36,29,65
067 Prad am Stilfser Joch,32,,32,25,57
067 Prad am Stilfser Joch,33,,29,28,57
067 Prad am Stilfser Joch,34,,24,11,35
067 Prad am Stilfser Joch,35,,29,30,59
067 Prad am Stilfser Joch,36,,20,28,48
067 Prad am Stilfser Joch,37,,19,26,45
067 Prad am Stilfser Joch,38,,31,12,43
067 Prad am Stilfser Joch,39,,24,31,55
067 Prad am Stilfser Joch,40,,24,24,48
067 Prad am Stilfser Joch,41,,25,23,48
067 Prad am Stilfser Joch,42,,28,16,44
067 Prad am Stilfser Joch,43,,29,18,47
067 Prad am Stilfser Joch,44,,28,17,45
067 Prad am Stilfser Joch,45,,14,21,35
067 Prad am Stilfser Joch,46,,20,22,42
067 Prad am Stilfser Joch,47,,22,17,39
067 Prad am Stilfser Joch,48,,24,20,44
067 Prad am Stilfser Joch,49,,18,12,30
067 Prad am Stilfser Joch,50,,16,14,30
067 Prad am Stilfser Joch,51,,16,15,31
067 Prad am Stilfser Joch,52,,18,11,29
067 Prad am Stilfser Joch,53,,12,15,27
067 Prad am Stilfser Joch,54,,25,18,43
067 Prad am Stilfser Joch,55,,19,17,36
067 Prad am Stilfser Joch,56,,22,11,33
067 Prad am Stilfser Joch,57,,10,16,26
067 Prad am Stilfser Joch,58,,14,13,27
067 Prad am Stilfser Joch,59,,19,14,33
067 Prad am Stilfser Joch,60,,12,12,24
067 Prad am Stilfser Joch,61,,12,11,23
067 Prad am Stilfser Joch,62,,15,15,30
067 Prad am Stilfser Joch,63,,9,25,34
067 Prad am Stilfser Joch,64,,12,10,22
067 Prad am Stilfser Joch,65,,13,19,32
067 Prad am Stilfser Joch,66,,8,16,24
067 Prad am Stilfser Joch,67,,13,14,27
067 Prad am Stilfser Joch,68,,9,12,21
067 Prad am Stilfser Joch,69,,8,9,17
067 Prad am Stilfser Joch,70,,9,10,19
067 Prad am Stilfser Joch,71,,10,14,24
067 Prad am Stilfser Joch,72,,12,9,21
067 Prad am Stilfser Joch,73,,7,13,20
067 Prad am Stilfser Joch,74,,4,13,17
067 Prad am Stilfser Joch,75,,6,13,19
067 Prad am Stilfser Joch,76,,7,7,14
067 Prad am Stilfser Joch,77,,6,7,13
067 Prad am Stilfser Joch,78,,8,4,12
067 Prad am Stilfser Joch,79,,2,5,7
067 Prad am Stilfser Joch,80,,-,5,5
067 Prad am Stilfser Joch,81,,1,5,6
067 Prad am Stilfser Joch,82,,5,2,7
067 Prad am Stilfser Joch,83,,3,12,15
067 Prad am Stilfser Joch,84,,-,4,4
067 Prad am Stilfser Joch,85,,5,9,14
067 Prad am Stilfser Joch,86,,1,4,5
067 Prad am Stilfser Joch,87,,2,8,10
067 Prad am Stilfser Joch,88,,1,4,5
067 Prad am Stilfser Joch,89,,2,4,6
067 Prad am Stilfser Joch,90,,3,4,7
067 Prad am Stilfser Joch,91,,1,-,1
067 Prad am Stilfser Joch,92,,-,2,2
067 Prad am Stilfser Joch,93,,-,2,2
067 Prad am Stilfser Joch,94,,-,1,1
067 Prad am Stilfser Joch,96,,-,2,2
067 Prad am Stilfser Joch,Insgesamt,,1.608,1.547,3.155
068 Prettau,0,,3,4,7
068 Prettau,1,,1,2,3
068 Prettau,2,,6,6,12
068 Prettau,3,,5,7,12
068 Prettau,4,,4,8,12
068 Prettau,5,,3,3,6
068 Prettau,6,,1,4,5
068 Prettau,7,,1,7,8
068 Prettau,8,,-,4,4
068 Prettau,9,,5,3,8
068 Prettau,10,,5,1,6
068 Prettau,11,,2,2,4
068 Prettau,12,,2,1,3
068 Prettau,13,,3,6,9
068 Prettau,14,,4,2,6
068 Prettau,15,,2,2,4
068 Prettau,16,,2,1,3
068 Prettau,17,,4,2,6
068 Prettau,18,,5,2,7
068 Prettau,19,,1,-,1
068 Prettau,20,,4,4,8
068 Prettau,21,,1,1,2
068 Prettau,22,,6,4,10
068 Prettau,23,,6,2,8
068 Prettau,24,,8,9,17
068 Prettau,25,,11,6,17
068 Prettau,26,,5,4,9
068 Prettau,27,,4,6,10
068 Prettau,28,,9,7,16
068 Prettau,29,,6,5,11
068 Prettau,30,,10,8,18
068 Prettau,31,,5,3,8
068 Prettau,32,,4,12,16
068 Prettau,33,,8,6,14
068 Prettau,34,,6,8,14
068 Prettau,35,,3,6,9
068 Prettau,36,,6,5,11
068 Prettau,37,,9,4,13
068 Prettau,38,,5,2,7
068 Prettau,39,,7,-,7
068 Prettau,40,,2,1,3
068 Prettau,41,,6,5,11
068 Prettau,42,,6,5,11
068 Prettau,43,,6,2,8
068 Prettau,44,,4,3,7
068 Prettau,45,,4,3,7
068 Prettau,46,,2,2,4
068 Prettau,47,,2,2,4
068 Prettau,48,,2,3,5
068 Prettau,49,,3,2,5
068 Prettau,50,,4,5,9
068 Prettau,51,,9,4,13
068 Prettau,52,,2,3,5
068 Prettau,53,,7,5,12
068 Prettau,54,,4,2,6
068 Prettau,55,,3,2,5
068 Prettau,56,,3,3,6
068 Prettau,57,,4,5,9
068 Prettau,58,,4,4,8
068 Prettau,59,,5,7,12
068 Prettau,60,,3,6,9
068 Prettau,61,,4,3,7
068 Prettau,62,,6,3,9
068 Prettau,63,,1,3,4
068 Prettau,64,,4,3,7
068 Prettau,65,,4,-,4
068 Prettau,66,,2,1,3
068 Prettau,67,,5,4,9
068 Prettau,68,,4,6,10
068 Prettau,69,,-,3,3
068 Prettau,70,,3,1,4
068 Prettau,71,,1,8,9
068 Prettau,72,,1,3,4
068 Prettau,73,,4,1,5
068 Prettau,74,,1,5,6
068 Prettau,75,,2,1,3
068 Prettau,76,,1,2,3
068 Prettau,77,,4,4,8
068 Prettau,78,,3,2,5
068 Prettau,79,,1,3,4
068 Prettau,80,,2,1,3
068 Prettau,81,,2,3,5
068 Prettau,82,,-,1,1
068 Prettau,83,,-,5,5
068 Prettau,84,,1,6,7
068 Prettau,85,,-,2,2
068 Prettau,86,,-,4,4
068 Prettau,88,,-,1,1
068 Prettau,89,,1,-,1
068 Prettau,91,,-,1,1
068 Prettau,92,,-,2,2
068 Prettau,97,,-,1,1
068 Prettau,Insgesamt,,324,326,650
069 Proveis,0,,1,2,3
069 Proveis,1,,2,1,3
069 Proveis,2,,-,4,4
069 Proveis,3,,2,-,2
069 Proveis,4,,2,1,3
069 Proveis,5,,3,1,4
069 Proveis,6,,3,2,5
069 Proveis,8,,1,1,2
069 Proveis,9,,2,3,5
069 Proveis,10,,2,2,4
069 Proveis,11,,3,1,4
069 Proveis,12,,5,-,5
069 Proveis,13,,3,3,6
069 Proveis,14,,3,3,6
069 Proveis,15,,1,-,1
069 Proveis,16,,2,3,5
069 Proveis,18,,3,1,4
069 Proveis,19,,3,2,5
069 Proveis,20,,2,2,4
069 Proveis,21,,1,3,4
069 Proveis,22,,2,3,5
069 Proveis,23,,6,2,8
069 Proveis,24,,2,-,2
069 Proveis,25,,-,3,3
069 Proveis,26,,1,2,3
069 Proveis,27,,4,2,6
069 Proveis,28,,4,3,7
069 Proveis,29,,5,1,6
069 Proveis,30,,2,1,3
069 Proveis,31,,2,1,3
069 Proveis,32,,1,1,2
069 Proveis,33,,3,-,3
069 Proveis,34,,4,2,6
069 Proveis,35,,4,2,6
069 Proveis,36,,4,1,5
069 Proveis,37,,1,4,5
069 Proveis,38,,4,-,4
069 Proveis,39,,1,3,4
069 Proveis,40,,2,3,5
069 Proveis,41,,4,1,5
069 Proveis,42,,3,4,7
069 Proveis,43,,3,2,5
069 Proveis,44,,2,1,3
069 Proveis,45,,3,3,6
069 Proveis,46,,2,-,2
069 Proveis,47,,1,1,2
069 Proveis,48,,1,-,1
069 Proveis,49,,2,1,3
069 Proveis,50,,1,2,3
069 Proveis,51,,3,-,3
069 Proveis,52,,1,1,2
069 Proveis,53,,2,-,2
069 Proveis,54,,2,1,3
069 Proveis,55,,2,1,3
069 Proveis,56,,1,1,2
069 Proveis,57,,3,-,3
069 Proveis,58,,1,3,4
069 Proveis,59,,-,2,2
069 Proveis,60,,1,1,2
069 Proveis,61,,2,1,3
069 Proveis,62,,1,1,2
069 Proveis,63,,-,1,1
069 Proveis,64,,-,2,2
069 Proveis,65,,1,1,2
069 Proveis,66,,2,1,3
069 Proveis,67,,-,1,1
069 Proveis,68,,3,3,6
069 Proveis,69,,4,1,5
069 Proveis,70,,2,2,4
069 Proveis,71,,1,1,2
069 Proveis,72,,-,3,3
069 Proveis,73,,3,-,3
069 Proveis,74,,1,-,1
069 Proveis,75,,2,2,4
069 Proveis,76,,-,6,6
069 Proveis,77,,-,1,1
069 Proveis,80,,-,1,1
069 Proveis,82,,-,1,1
069 Proveis,83,,-,2,2
069 Proveis,84,,-,1,1
069 Proveis,90,,1,-,1
069 Proveis,Insgesamt,,157,126,283
070 Ratschings,0,,34,36,70
070 Ratschings,1,,26,34,60
070 Ratschings,2,,26,27,53
070 Ratschings,3,,21,28,49
070 Ratschings,4,,29,21,50
070 Ratschings,5,,36,31,67
070 Ratschings,6,,26,18,44
070 Ratschings,7,,32,28,60
070 Ratschings,8,,24,19,43
070 Ratschings,9,,36,27,63
070 Ratschings,10,,27,32,59
070 Ratschings,11,,30,26,56
070 Ratschings,12,,29,33,62
070 Ratschings,13,,28,18,46
070 Ratschings,14,,31,21,52
070 Ratschings,15,,36,24,60
070 Ratschings,16,,29,31,60
070 Ratschings,17,,23,23,46
070 Ratschings,18,,34,22,56
070 Ratschings,19,,31,21,52
070 Ratschings,20,,33,21,54
070 Ratschings,21,,25,29,54
070 Ratschings,22,,31,27,58
070 Ratschings,23,,38,26,64
070 Ratschings,24,,27,34,61
070 Ratschings,25,,31,35,66
070 Ratschings,26,,37,41,78
070 Ratschings,27,,28,34,62
070 Ratschings,28,,33,41,74
070 Ratschings,29,,44,36,80
070 Ratschings,30,,37,37,74
070 Ratschings,31,,46,38,84
070 Ratschings,32,,35,49,84
070 Ratschings,33,,49,39,88
070 Ratschings,34,,46,24,70
070 Ratschings,35,,35,37,72
070 Ratschings,36,,32,27,59
070 Ratschings,37,,39,23,62
070 Ratschings,38,,39,26,65
070 Ratschings,39,,30,20,50
070 Ratschings,40,,33,18,51
070 Ratschings,41,,37,19,56
070 Ratschings,42,,16,32,48
070 Ratschings,43,,29,15,44
070 Ratschings,44,,21,25,46
070 Ratschings,45,,21,19,40
070 Ratschings,46,,15,15,30
070 Ratschings,47,,23,20,43
070 Ratschings,48,,23,24,47
070 Ratschings,49,,32,20,52
070 Ratschings,50,,16,14,30
070 Ratschings,51,,24,8,32
070 Ratschings,52,,19,20,39
070 Ratschings,53,,21,11,32
070 Ratschings,54,,15,13,28
070 Ratschings,55,,20,19,39
070 Ratschings,56,,25,21,46
070 Ratschings,57,,20,17,37
070 Ratschings,58,,19,19,38
070 Ratschings,59,,15,21,36
070 Ratschings,60,,20,10,30
070 Ratschings,61,,15,13,28
070 Ratschings,62,,19,17,36
070 Ratschings,63,,14,11,25
070 Ratschings,64,,16,19,35
070 Ratschings,65,,16,14,30
070 Ratschings,66,,12,13,25
070 Ratschings,67,,14,19,33
070 Ratschings,68,,12,23,35
070 Ratschings,69,,11,15,26
070 Ratschings,70,,19,14,33
070 Ratschings,71,,14,16,30
070 Ratschings,72,,14,9,23
070 Ratschings,73,,14,14,28
070 Ratschings,74,,13,10,23
070 Ratschings,75,,8,13,21
070 Ratschings,76,,9,14,23
070 Ratschings,77,,5,14,19
070 Ratschings,78,,4,5,9
070 Ratschings,79,,-,10,10
070 Ratschings,80,,-,1,1
070 Ratschings,81,,3,3,6
070 Ratschings,82,,4,8,12
070 Ratschings,83,,4,5,9
070 Ratschings,84,,5,5,10
070 Ratschings,85,,3,7,10
070 Ratschings,86,,2,4,6
070 Ratschings,87,,1,-,1
070 Ratschings,88,,1,3,4
070 Ratschings,89,,2,2,4
070 Ratschings,91,,-,2,2
070 Ratschings,92,,1,1,2
070 Ratschings,Insgesamt,,2.022,1.848,3.870
071 Rasen-Antholz,0,,23,21,44
071 Rasen-Antholz,1,,26,15,41
071 Rasen-Antholz,2,,11,17,28
071 Rasen-Antholz,3,,20,11,31
071 Rasen-Antholz,4,,21,17,38
071 Rasen-Antholz,5,,30,19,49
071 Rasen-Antholz,6,,17,16,33
071 Rasen-Antholz,7,,14,26,40
071 Rasen-Antholz,8,,19,18,37
071 Rasen-Antholz,9,,20,16,36
071 Rasen-Antholz,10,,27,10,37
071 Rasen-Antholz,11,,16,21,37
071 Rasen-Antholz,12,,23,13,36
071 Rasen-Antholz,13,,18,18,36
071 Rasen-Antholz,14,,14,18,32
071 Rasen-Antholz,15,,21,24,45
071 Rasen-Antholz,16,,15,15,30
071 Rasen-Antholz,17,,19,11,30
071 Rasen-Antholz,18,,17,19,36
071 Rasen-Antholz,19,,16,17,33
071 Rasen-Antholz,20,,16,22,38
071 Rasen-Antholz,21,,20,22,42
071 Rasen-Antholz,22,,22,28,50
071 Rasen-Antholz,23,,31,27,58
071 Rasen-Antholz,24,,35,21,56
071 Rasen-Antholz,25,,36,15,51
071 Rasen-Antholz,26,,30,23,53
071 Rasen-Antholz,27,,27,32,59
071 Rasen-Antholz,28,,33,32,65
071 Rasen-Antholz,29,,30,29,59
071 Rasen-Antholz,30,,30,28,58
071 Rasen-Antholz,31,,28,19,47
071 Rasen-Antholz,32,,34,27,61
071 Rasen-Antholz,33,,30,20,50
071 Rasen-Antholz,34,,24,22,46
071 Rasen-Antholz,35,,28,19,47
071 Rasen-Antholz,36,,20,26,46
071 Rasen-Antholz,37,,22,22,44
071 Rasen-Antholz,38,,27,22,49
071 Rasen-Antholz,39,,24,16,40
071 Rasen-Antholz,40,,22,12,34
071 Rasen-Antholz,41,,18,16,34
071 Rasen-Antholz,42,,18,16,34
071 Rasen-Antholz,43,,14,12,26
071 Rasen-Antholz,44,,18,11,29
071 Rasen-Antholz,45,,12,14,26
071 Rasen-Antholz,46,,14,12,26
071 Rasen-Antholz,47,,16,10,26
071 Rasen-Antholz,48,,14,9,23
071 Rasen-Antholz,49,,14,9,23
071 Rasen-Antholz,50,,10,13,23
071 Rasen-Antholz,51,,11,15,26
071 Rasen-Antholz,52,,11,9,20
071 Rasen-Antholz,53,,9,9,18
071 Rasen-Antholz,54,,13,14,27
071 Rasen-Antholz,55,,11,14,25
071 Rasen-Antholz,56,,14,13,27
071 Rasen-Antholz,57,,11,17,28
071 Rasen-Antholz,58,,17,13,30
071 Rasen-Antholz,59,,15,8,23
071 Rasen-Antholz,60,,10,12,22
071 Rasen-Antholz,61,,10,12,22
071 Rasen-Antholz,62,,10,8,18
071 Rasen-Antholz,63,,12,10,22
071 Rasen-Antholz,64,,13,15,28
071 Rasen-Antholz,65,,16,12,28
071 Rasen-Antholz,66,,14,14,28
071 Rasen-Antholz,67,,5,11,16
071 Rasen-Antholz,68,,13,4,17
071 Rasen-Antholz,69,,5,4,9
071 Rasen-Antholz,70,,14,11,25
071 Rasen-Antholz,71,,9,6,15
071 Rasen-Antholz,72,,7,13,20
071 Rasen-Antholz,73,,7,13,20
071 Rasen-Antholz,74,,4,12,16
071 Rasen-Antholz,75,,5,6,11
071 Rasen-Antholz,76,,10,6,16
071 Rasen-Antholz,77,,3,6,9
071 Rasen-Antholz,78,,6,7,13
071 Rasen-Antholz,79,,2,3,5
071 Rasen-Antholz,80,,4,4,8
071 Rasen-Antholz,81,,-,3,3
071 Rasen-Antholz,82,,3,4,7
071 Rasen-Antholz,83,,1,5,6
071 Rasen-Antholz,84,,1,4,5
071 Rasen-Antholz,85,,2,4,6
071 Rasen-Antholz,86,,1,2,3
071 Rasen-Antholz,87,,-,3,3
071 Rasen-Antholz,88,,2,5,7
071 Rasen-Antholz,89,,1,3,4
071 Rasen-Antholz,90,,1,2,3
071 Rasen-Antholz,91,,-,2,2
071 Rasen-Antholz,92,,-,1,1
071 Rasen-Antholz,95,,1,-,1
071 Rasen-Antholz,Insgesamt,,1.408,1.287,2.695
072 Ritten,0,,57,55,112
072 Ritten,1,,46,53,99
072 Ritten,2,,57,50,107
072 Ritten,3,,57,48,105
072 Ritten,4,,59,53,112
072 Ritten,5,,52,68,120
072 Ritten,6,,61,45,106
072 Ritten,7,,60,46,106
072 Ritten,8,,53,46,99
072 Ritten,9,,56,51,107
072 Ritten,10,,49,43,92
072 Ritten,11,,49,43,92
072 Ritten,12,,45,48,93
072 Ritten,13,,46,29,75
072 Ritten,14,,52,42,94
072 Ritten,15,,38,46,84
072 Ritten,16,,45,47,92
072 Ritten,17,,46,34,80
072 Ritten,18,,50,42,92
072 Ritten,19,,42,36,78
072 Ritten,20,,60,39,99
072 Ritten,21,,42,44,86
072 Ritten,22,,57,39,96
072 Ritten,23,,67,59,126
072 Ritten,24,,51,54,105
072 Ritten,25,,53,49,102
072 Ritten,26,,57,74,131
072 Ritten,27,,52,72,124
072 Ritten,28,,48,59,107
072 Ritten,29,,67,63,130
072 Ritten,30,,70,53,123
072 Ritten,31,,56,50,106
072 Ritten,32,,76,48,124
072 Ritten,33,,68,58,126
072 Ritten,34,,61,56,117
072 Ritten,35,,59,62,121
072 Ritten,36,,51,62,113
072 Ritten,37,,63,57,120
072 Ritten,38,,63,51,114
072 Ritten,39,,39,43,82
072 Ritten,40,,46,39,85
072 Ritten,41,,48,43,91
072 Ritten,42,,50,40,90
072 Ritten,43,,39,32,71
072 Ritten,44,,45,32,77
072 Ritten,45,,41,45,86
072 Ritten,46,,44,35,79
072 Ritten,47,,36,42,78
072 Ritten,48,,35,42,77
072 Ritten,49,,51,33,84
072 Ritten,50,,32,27,59
072 Ritten,51,,31,38,69
072 Ritten,52,,22,23,45
072 Ritten,53,,33,41,74
072 Ritten,54,,40,41,81
072 Ritten,55,,46,37,83
072 Ritten,56,,36,38,74
072 Ritten,57,,40,23,63
072 Ritten,58,,38,32,70
072 Ritten,59,,34,34,68
072 Ritten,60,,31,24,55
072 Ritten,61,,26,25,51
072 Ritten,62,,25,34,59
072 Ritten,63,,25,27,52
072 Ritten,64,,20,27,47
072 Ritten,65,,27,24,51
072 Ritten,66,,18,32,50
072 Ritten,67,,18,22,40
072 Ritten,68,,27,19,46
072 Ritten,69,,22,11,33
072 Ritten,70,,24,19,43
072 Ritten,71,,16,21,37
072 Ritten,72,,20,39,59
072 Ritten,73,,19,32,51
072 Ritten,74,,20,26,46
072 Ritten,75,,7,29,36
072 Ritten,76,,14,24,38
072 Ritten,77,,12,27,39
072 Ritten,78,,5,15,20
072 Ritten,79,,4,8,12
072 Ritten,80,,5,12,17
072 Ritten,81,,1,4,5
072 Ritten,82,,7,9,16
072 Ritten,83,,9,14,23
072 Ritten,84,,8,18,26
072 Ritten,85,,6,16,22
072 Ritten,86,,4,12,16
072 Ritten,87,,8,8,16
072 Ritten,88,,6,4,10
072 Ritten,89,,1,8,9
072 Ritten,90,,2,6,8
072 Ritten,91,,-,2,2
072 Ritten,92,,1,1,2
072 Ritten,93,,-,1,1
072 Ritten,94,,2,4,6
072 Ritten,95,,-,1,1
072 Ritten,100,,1,-,1
072 Ritten,Insgesamt,,3.408,3.339,6.747
073 Riffian,0,,8,9,17
073 Riffian,1,,6,8,14
073 Riffian,2,,7,11,18
073 Riffian,3,,8,7,15
073 Riffian,4,,7,7,14
073 Riffian,5,,9,10,19
073 Riffian,6,,9,12,21
073 Riffian,7,,7,7,14
073 Riffian,8,,12,5,17
073 Riffian,9,,6,12,18
073 Riffian,10,,7,10,17
073 Riffian,11,,8,6,14
073 Riffian,12,,8,2,10
073 Riffian,13,,8,7,15
073 Riffian,14,,9,7,16
073 Riffian,15,,10,11,21
073 Riffian,16,,10,8,18
073 Riffian,17,,5,4,9
073 Riffian,18,,7,9,16
073 Riffian,19,,9,4,13
073 Riffian,20,,11,8,19
073 Riffian,21,,9,2,11
073 Riffian,22,,6,13,19
073 Riffian,23,,10,4,14
073 Riffian,24,,11,10,21
073 Riffian,25,,10,18,28
073 Riffian,26,,12,18,30
073 Riffian,27,,6,10,16
073 Riffian,28,,12,13,25
073 Riffian,29,,13,17,30
073 Riffian,30,,13,14,27
073 Riffian,31,,9,8,17
073 Riffian,32,,13,7,20
073 Riffian,33,,12,8,20
073 Riffian,34,,14,10,24
073 Riffian,35,,11,8,19
073 Riffian,36,,8,9,17
073 Riffian,37,,13,4,17
073 Riffian,38,,7,15,22
073 Riffian,39,,7,6,13
073 Riffian,40,,6,12,18
073 Riffian,41,,11,4,15
073 Riffian,42,,6,11,17
073 Riffian,43,,9,6,15
073 Riffian,44,,10,4,14
073 Riffian,45,,7,3,10
073 Riffian,46,,7,10,17
073 Riffian,47,,4,3,7
073 Riffian,48,,6,6,12
073 Riffian,49,,7,6,13
073 Riffian,50,,4,4,8
073 Riffian,51,,2,6,8
073 Riffian,52,,6,3,9
073 Riffian,53,,8,8,16
073 Riffian,54,,7,7,14
073 Riffian,55,,12,7,19
073 Riffian,56,,9,3,12
073 Riffian,57,,4,3,7
073 Riffian,58,,4,9,13
073 Riffian,59,,10,4,14
073 Riffian,60,,4,6,10
073 Riffian,61,,2,4,6
073 Riffian,62,,1,3,4
073 Riffian,63,,1,4,5
073 Riffian,64,,7,5,12
073 Riffian,65,,4,4,8
073 Riffian,66,,5,9,14
073 Riffian,67,,5,3,8
073 Riffian,68,,3,7,10
073 Riffian,69,,2,3,5
073 Riffian,70,,5,6,11
073 Riffian,71,,6,2,8
073 Riffian,72,,5,3,8
073 Riffian,73,,5,7,12
073 Riffian,74,,4,7,11
073 Riffian,75,,3,2,5
073 Riffian,76,,1,4,5
073 Riffian,77,,4,3,7
073 Riffian,78,,-,1,1
073 Riffian,79,,1,1,2
073 Riffian,80,,-,3,3
073 Riffian,81,,1,-,1
073 Riffian,82,,1,1,2
073 Riffian,83,,1,7,8
073 Riffian,84,,2,4,6
073 Riffian,85,,1,2,3
073 Riffian,86,,1,-,1
073 Riffian,87,,2,-,2
073 Riffian,88,,-,1,1
073 Riffian,89,,2,2,4
073 Riffian,91,,1,-,1
073 Riffian,95,,1,-,1
073 Riffian,Insgesamt,,587,581,1.168
074 Mühlbach,0,,16,16,32
074 Mühlbach,1,,15,17,32
074 Mühlbach,2,,10,16,26
074 Mühlbach,3,,20,13,33
074 Mühlbach,4,,18,17,35
074 Mühlbach,5,,13,24,37
074 Mühlbach,6,,12,17,29
074 Mühlbach,7,,12,14,26
074 Mühlbach,8,,14,19,33
074 Mühlbach,9,,20,15,35
074 Mühlbach,10,,22,12,34
074 Mühlbach,11,,18,8,26
074 Mühlbach,12,,16,16,32
074 Mühlbach,13,,16,21,37
074 Mühlbach,14,,18,17,35
074 Mühlbach,15,,25,24,49
074 Mühlbach,16,,23,17,40
074 Mühlbach,17,,17,15,32
074 Mühlbach,18,,18,11,29
074 Mühlbach,19,,24,23,47
074 Mühlbach,20,,21,14,35
074 Mühlbach,21,,17,32,49
074 Mühlbach,22,,19,21,40
074 Mühlbach,23,,18,16,34
074 Mühlbach,24,,24,17,41
074 Mühlbach,25,,22,16,38
074 Mühlbach,26,,25,23,48
074 Mühlbach,27,,25,13,38
074 Mühlbach,28,,26,36,62
074 Mühlbach,29,,36,21,57
074 Mühlbach,30,,23,21,44
074 Mühlbach,31,,26,15,41
074 Mühlbach,32,,20,26,46
074 Mühlbach,33,,16,20,36
074 Mühlbach,34,,23,17,40
074 Mühlbach,35,,23,16,39
074 Mühlbach,36,,24,22,46
074 Mühlbach,37,,22,14,36
074 Mühlbach,38,,22,19,41
074 Mühlbach,39,,18,12,30
074 Mühlbach,40,,17,19,36
074 Mühlbach,41,,21,22,43
074 Mühlbach,42,,18,18,36
074 Mühlbach,43,,15,19,34
074 Mühlbach,44,,20,17,37
074 Mühlbach,45,,17,23,40
074 Mühlbach,46,,15,21,36
074 Mühlbach,47,,19,16,35
074 Mühlbach,48,,12,14,26
074 Mühlbach,49,,18,12,30
074 Mühlbach,50,,11,17,28
074 Mühlbach,51,,26,13,39
074 Mühlbach,52,,9,9,18
074 Mühlbach,53,,15,13,28
074 Mühlbach,54,,13,12,25
074 Mühlbach,55,,15,13,28
074 Mühlbach,56,,18,16,34
074 Mühlbach,57,,15,11,26
074 Mühlbach,58,,13,16,29
074 Mühlbach,59,,15,6,21
074 Mühlbach,60,,5,11,16
074 Mühlbach,61,,9,7,16
074 Mühlbach,62,,8,11,19
074 Mühlbach,63,,14,12,26
074 Mühlbach,64,,11,11,22
074 Mühlbach,65,,8,10,18
074 Mühlbach,66,,8,13,21
074 Mühlbach,67,,17,9,26
074 Mühlbach,68,,9,4,13
074 Mühlbach,69,,15,20,35
074 Mühlbach,70,,8,9,17
074 Mühlbach,71,,10,12,22
074 Mühlbach,72,,6,7,13
074 Mühlbach,73,,6,7,13
074 Mühlbach,74,,5,12,17
074 Mühlbach,75,,6,12,18
074 Mühlbach,76,,4,7,11
074 Mühlbach,77,,6,10,16
074 Mühlbach,78,,2,10,12
074 Mühlbach,79,,1,3,4
074 Mühlbach,80,,3,4,7
074 Mühlbach,81,,1,1,2
074 Mühlbach,82,,2,2,4
074 Mühlbach,83,,5,9,14
074 Mühlbach,84,,3,8,11
074 Mühlbach,85,,-,3,3
074 Mühlbach,86,,-,4,4
074 Mühlbach,87,,2,6,8
074 Mühlbach,88,,1,2,3
074 Mühlbach,89,,-,1,1
074 Mühlbach,90,,1,2,3
074 Mühlbach,91,,-,4,4
074 Mühlbach,92,,1,2,3
074 Mühlbach,94,,-,1,1
074 Mühlbach,Insgesamt,,1.296,1.276,2.572
075 Rodeneck,0,,8,5,13
075 Rodeneck,1,,12,11,23
075 Rodeneck,2,,5,11,16
075 Rodeneck,3,,7,11,18
075 Rodeneck,4,,7,7,14
075 Rodeneck,5,,9,10,19
075 Rodeneck,6,,6,9,15
075 Rodeneck,7,,12,8,20
075 Rodeneck,8,,7,6,13
075 Rodeneck,9,,13,9,22
075 Rodeneck,10,,5,5,10
075 Rodeneck,11,,9,12,21
075 Rodeneck,12,,12,9,21
075 Rodeneck,13,,16,11,27
075 Rodeneck,14,,11,6,17
075 Rodeneck,15,,7,6,13
075 Rodeneck,16,,10,6,16
075 Rodeneck,17,,6,9,15
075 Rodeneck,18,,8,7,15
075 Rodeneck,19,,6,8,14
075 Rodeneck,20,,8,8,16
075 Rodeneck,21,,8,5,13
075 Rodeneck,22,,9,7,16
075 Rodeneck,23,,7,5,12
075 Rodeneck,24,,16,7,23
075 Rodeneck,25,,9,11,20
075 Rodeneck,26,,13,6,19
075 Rodeneck,27,,9,13,22
075 Rodeneck,28,,15,10,25
075 Rodeneck,29,,9,12,21
075 Rodeneck,30,,14,9,23
075 Rodeneck,31,,13,8,21
075 Rodeneck,32,,8,8,16
075 Rodeneck,33,,11,10,21
075 Rodeneck,34,,9,10,19
075 Rodeneck,35,,9,13,22
075 Rodeneck,36,,9,12,21
075 Rodeneck,37,,6,11,17
075 Rodeneck,38,,12,5,17
075 Rodeneck,39,,8,5,13
075 Rodeneck,40,,6,7,13
075 Rodeneck,41,,10,4,14
075 Rodeneck,42,,7,6,13
075 Rodeneck,43,,11,3,14
075 Rodeneck,44,,4,2,6
075 Rodeneck,45,,8,5,13
075 Rodeneck,46,,3,2,5
075 Rodeneck,47,,1,7,8
075 Rodeneck,48,,4,7,11
075 Rodeneck,49,,4,7,11
075 Rodeneck,50,,6,4,10
075 Rodeneck,51,,10,6,16
075 Rodeneck,52,,-,5,5
075 Rodeneck,53,,5,5,10
075 Rodeneck,54,,3,2,5
075 Rodeneck,55,,3,6,9
075 Rodeneck,56,,10,3,13
075 Rodeneck,57,,5,4,9
075 Rodeneck,58,,3,9,12
075 Rodeneck,59,,4,3,7
075 Rodeneck,60,,3,4,7
075 Rodeneck,61,,5,5,10
075 Rodeneck,62,,5,2,7
075 Rodeneck,63,,1,12,13
075 Rodeneck,64,,3,2,5
075 Rodeneck,65,,5,5,10
075 Rodeneck,66,,7,5,12
075 Rodeneck,67,,5,3,8
075 Rodeneck,68,,7,3,10
075 Rodeneck,69,,5,5,10
075 Rodeneck,70,,5,6,11
075 Rodeneck,71,,4,6,10
075 Rodeneck,72,,3,9,12
075 Rodeneck,73,,5,5,10
075 Rodeneck,74,,2,4,6
075 Rodeneck,75,,3,3,6
075 Rodeneck,76,,3,1,4
075 Rodeneck,77,,2,2,4
075 Rodeneck,78,,5,2,7
075 Rodeneck,79,,-,3,3
075 Rodeneck,80,,-,1,1
075 Rodeneck,81,,1,1,2
075 Rodeneck,82,,1,3,4
075 Rodeneck,83,,2,1,3
075 Rodeneck,84,,1,1,2
075 Rodeneck,85,,2,2,4
075 Rodeneck,86,,-,2,2
075 Rodeneck,87,,3,-,3
075 Rodeneck,89,,-,1,1
075 Rodeneck,90,,-,1,1
075 Rodeneck,94,,1,-,1
075 Rodeneck,Insgesamt,,574,538,1.112
076 Salurn,0,,13,13,26
076 Salurn,1,,19,20,39
076 Salurn,2,,23,10,33
076 Salurn,3,,22,21,43
076 Salurn,4,,15,13,28
076 Salurn,5,,24,17,41
076 Salurn,6,,9,13,22
076 Salurn,7,,10,9,19
076 Salurn,8,,17,15,32
076 Salurn,9,,14,19,33
076 Salurn,10,,18,12,30
076 Salurn,11,,12,16,28
076 Salurn,12,,19,16,35
076 Salurn,13,,12,14,26
076 Salurn,14,,11,16,27
076 Salurn,15,,17,13,30
076 Salurn,16,,17,13,30
076 Salurn,17,,19,15,34
076 Salurn,18,,11,14,25
076 Salurn,19,,14,10,24
076 Salurn,20,,19,15,34
076 Salurn,21,,9,17,26
076 Salurn,22,,13,20,33
076 Salurn,23,,14,18,32
076 Salurn,24,,17,20,37
076 Salurn,25,,15,26,41
076 Salurn,26,,27,16,43
076 Salurn,27,,27,26,53
076 Salurn,28,,24,24,48
076 Salurn,29,,26,17,43
076 Salurn,30,,20,25,45
076 Salurn,31,,28,22,50
076 Salurn,32,,28,24,52
076 Salurn,33,,36,25,61
076 Salurn,34,,37,23,60
076 Salurn,35,,31,21,52
076 Salurn,36,,32,30,62
076 Salurn,37,,23,29,52
076 Salurn,38,,24,25,49
076 Salurn,39,,27,19,46
076 Salurn,40,,17,25,42
076 Salurn,41,,20,15,35
076 Salurn,42,,18,19,37
076 Salurn,43,,25,19,44
076 Salurn,44,,19,15,34
076 Salurn,45,,27,19,46
076 Salurn,46,,29,19,48
076 Salurn,47,,24,17,41
076 Salurn,48,,25,12,37
076 Salurn,49,,16,23,39
076 Salurn,50,,19,16,35
076 Salurn,51,,19,17,36
076 Salurn,52,,16,10,26
076 Salurn,53,,21,21,42
076 Salurn,54,,18,17,35
076 Salurn,55,,19,16,35
076 Salurn,56,,16,16,32
076 Salurn,57,,14,10,24
076 Salurn,58,,11,12,23
076 Salurn,59,,5,13,18
076 Salurn,60,,10,10,20
076 Salurn,61,,14,22,36
076 Salurn,62,,19,16,35
076 Salurn,63,,13,6,19
076 Salurn,64,,12,10,22
076 Salurn,65,,10,21,31
076 Salurn,66,,7,12,19
076 Salurn,67,,12,11,23
076 Salurn,68,,23,13,36
076 Salurn,69,,11,23,34
076 Salurn,70,,6,24,30
076 Salurn,71,,8,16,24
076 Salurn,72,,7,24,31
076 Salurn,73,,12,16,28
076 Salurn,74,,9,10,19
076 Salurn,75,,13,22,35
076 Salurn,76,,8,16,24
076 Salurn,77,,14,12,26
076 Salurn,78,,7,13,20
076 Salurn,79,,6,3,9
076 Salurn,80,,2,5,7
076 Salurn,81,,4,9,13
076 Salurn,82,,7,8,15
076 Salurn,83,,6,12,18
076 Salurn,84,,3,6,9
076 Salurn,85,,4,8,12
076 Salurn,86,,3,7,10
076 Salurn,87,,5,4,9
076 Salurn,88,,4,5,9
076 Salurn,89,,2,5,7
076 Salurn,90,,1,5,6
076 Salurn,91,,1,2,3
076 Salurn,92,,-,1,1
076 Salurn,93,,-,1,1
076 Salurn,94,,-,2,2
076 Salurn,95,,-,1,1
076 Salurn,Insgesamt,,1.434,1.443,2.877
077 Innichen,0,,18,15,33
077 Innichen,1,,15,21,36
077 Innichen,2,,22,12,34
077 Innichen,3,,15,18,33
077 Innichen,4,,21,22,43
077 Innichen,5,,25,19,44
077 Innichen,6,,23,24,47
077 Innichen,7,,17,13,30
077 Innichen,8,,19,23,42
077 Innichen,9,,29,20,49
077 Innichen,10,,21,19,40
077 Innichen,11,,23,18,41
077 Innichen,12,,20,20,40
077 Innichen,13,,20,21,41
077 Innichen,14,,22,16,38
077 Innichen,15,,18,23,41
077 Innichen,16,,15,19,34
077 Innichen,17,,23,17,40
077 Innichen,18,,25,22,47
077 Innichen,19,,9,16,25
077 Innichen,20,,15,20,35
077 Innichen,21,,19,26,45
077 Innichen,22,,23,6,29
077 Innichen,23,,24,24,48
077 Innichen,24,,27,27,54
077 Innichen,25,,26,25,51
077 Innichen,26,,19,24,43
077 Innichen,27,,27,29,56
077 Innichen,28,,29,28,57
077 Innichen,29,,34,30,64
077 Innichen,30,,20,25,45
077 Innichen,31,,31,30,61
077 Innichen,32,,36,32,68
077 Innichen,33,,36,31,67
077 Innichen,34,,34,31,65
077 Innichen,35,,35,26,61
077 Innichen,36,,27,31,58
077 Innichen,37,,39,19,58
077 Innichen,38,,28,25,53
077 Innichen,39,,21,25,46
077 Innichen,40,,20,25,45
077 Innichen,41,,26,16,42
077 Innichen,42,,25,18,43
077 Innichen,43,,23,13,36
077 Innichen,44,,24,18,42
077 Innichen,45,,13,26,39
077 Innichen,46,,12,19,31
077 Innichen,47,,18,20,38
077 Innichen,48,,22,17,39
077 Innichen,49,,18,12,30
077 Innichen,50,,14,16,30
077 Innichen,51,,16,15,31
077 Innichen,52,,13,9,22
077 Innichen,53,,8,13,21
077 Innichen,54,,23,10,33
077 Innichen,55,,17,17,34
077 Innichen,56,,14,16,30
077 Innichen,57,,10,22,32
077 Innichen,58,,14,13,27
077 Innichen,59,,8,11,19
077 Innichen,60,,11,13,24
077 Innichen,61,,10,17,27
077 Innichen,62,,9,20,29
077 Innichen,63,,11,14,25
077 Innichen,64,,12,10,22
077 Innichen,65,,20,16,36
077 Innichen,66,,16,21,37
077 Innichen,67,,17,11,28
077 Innichen,68,,15,17,32
077 Innichen,69,,13,21,34
077 Innichen,70,,10,12,22
077 Innichen,71,,19,13,32
077 Innichen,72,,10,22,32
077 Innichen,73,,11,4,15
077 Innichen,74,,9,14,23
077 Innichen,75,,6,16,22
077 Innichen,76,,9,15,24
077 Innichen,77,,8,13,21
077 Innichen,78,,3,5,8
077 Innichen,79,,2,6,8
077 Innichen,80,,3,4,7
077 Innichen,81,,3,4,7
077 Innichen,82,,4,5,9
077 Innichen,83,,3,6,9
077 Innichen,84,,6,8,14
077 Innichen,85,,2,7,9
077 Innichen,86,,1,1,2
077 Innichen,87,,1,4,5
077 Innichen,88,,3,3,6
077 Innichen,89,,2,4,6
077 Innichen,90,,1,2,3
077 Innichen,91,,1,1,2
077 Innichen,92,,-,1,1
077 Innichen,93,,-,2,2
077 Innichen,94,,-,2,2
077 Innichen,95,,-,2,2
077 Innichen,96,,-,1,1
077 Innichen,Insgesamt,,1.539,1.555,3.094
079 Jenesien,0,,17,20,37
079 Jenesien,1,,21,11,32
079 Jenesien,2,,28,17,45
079 Jenesien,3,,22,22,44
079 Jenesien,4,,15,20,35
079 Jenesien,5,,26,21,47
079 Jenesien,6,,17,21,38
079 Jenesien,7,,18,15,33
079 Jenesien,8,,19,12,31
079 Jenesien,9,,23,16,39
079 Jenesien,10,,13,19,32
079 Jenesien,11,,16,16,32
079 Jenesien,12,,13,4,17
079 Jenesien,13,,19,14,33
079 Jenesien,14,,17,19,36
079 Jenesien,15,,13,24,37
079 Jenesien,16,,6,20,26
079 Jenesien,17,,14,21,35
079 Jenesien,18,,21,19,40
079 Jenesien,19,,12,14,26
079 Jenesien,20,,18,23,41
079 Jenesien,21,,15,13,28
079 Jenesien,22,,12,13,25
079 Jenesien,23,,17,18,35
079 Jenesien,24,,19,22,41
079 Jenesien,25,,15,22,37
079 Jenesien,26,,29,18,47
079 Jenesien,27,,28,24,52
079 Jenesien,28,,31,16,47
079 Jenesien,29,,21,28,49
079 Jenesien,30,,16,20,36
079 Jenesien,31,,30,27,57
079 Jenesien,32,,32,27,59
079 Jenesien,33,,36,31,67
079 Jenesien,34,,30,22,52
079 Jenesien,35,,26,21,47
079 Jenesien,36,,28,20,48
079 Jenesien,37,,23,12,35
079 Jenesien,38,,22,14,36
079 Jenesien,39,,24,8,32
079 Jenesien,40,,15,15,30
079 Jenesien,41,,17,14,31
079 Jenesien,42,,9,11,20
079 Jenesien,43,,15,15,30
079 Jenesien,44,,15,9,24
079 Jenesien,45,,15,20,35
079 Jenesien,46,,11,9,20
079 Jenesien,47,,11,21,32
079 Jenesien,48,,12,14,26
079 Jenesien,49,,12,7,19
079 Jenesien,50,,14,13,27
079 Jenesien,51,,8,11,19
079 Jenesien,52,,7,15,22
079 Jenesien,53,,13,14,27
079 Jenesien,54,,18,10,28
079 Jenesien,55,,15,10,25
079 Jenesien,56,,16,20,36
079 Jenesien,57,,17,11,28
079 Jenesien,58,,15,18,33
079 Jenesien,59,,22,9,31
079 Jenesien,60,,11,16,27
079 Jenesien,61,,7,19,26
079 Jenesien,62,,7,7,14
079 Jenesien,63,,9,7,16
079 Jenesien,64,,16,11,27
079 Jenesien,65,,8,11,19
079 Jenesien,66,,10,9,19
079 Jenesien,67,,7,15,22
079 Jenesien,68,,11,16,27
079 Jenesien,69,,15,10,25
079 Jenesien,70,,8,10,18
079 Jenesien,71,,11,14,25
079 Jenesien,72,,4,14,18
079 Jenesien,73,,8,11,19
079 Jenesien,74,,9,10,19
079 Jenesien,75,,7,12,19
079 Jenesien,76,,4,7,11
079 Jenesien,77,,3,9,12
079 Jenesien,78,,2,5,7
079 Jenesien,79,,-,1,1
079 Jenesien,80,,2,1,3
079 Jenesien,81,,2,2,4
079 Jenesien,82,,2,5,7
079 Jenesien,83,,4,5,9
079 Jenesien,84,,1,8,9
079 Jenesien,85,,1,5,6
079 Jenesien,86,,3,6,9
079 Jenesien,87,,-,4,4
079 Jenesien,88,,3,1,4
079 Jenesien,89,,3,4,7
079 Jenesien,91,,1,2,3
079 Jenesien,92,,-,1,1
079 Jenesien,93,,-,2,2
079 Jenesien,94,,1,-,1
079 Jenesien,Insgesamt,,1.279,1.270,2.549
080 St.Leonhard in Pass.,0,,23,21,44
080 St.Leonhard in Pass.,1,,28,21,49
080 St.Leonhard in Pass.,2,,21,14,35
080 St.Leonhard in Pass.,3,,28,22,50
080 St.Leonhard in Pass.,4,,25,20,45
080 St.Leonhard in Pass.,5,,23,20,43
080 St.Leonhard in Pass.,6,,25,20,45
080 St.Leonhard in Pass.,7,,24,22,46
080 St.Leonhard in Pass.,8,,36,31,67
080 St.Leonhard in Pass.,9,,22,25,47
080 St.Leonhard in Pass.,10,,31,25,56
080 St.Leonhard in Pass.,11,,34,35,69
080 St.Leonhard in Pass.,12,,23,27,50
080 St.Leonhard in Pass.,13,,30,26,56
080 St.Leonhard in Pass.,14,,29,27,56
080 St.Leonhard in Pass.,15,,31,22,53
080 St.Leonhard in Pass.,16,,23,31,54
080 St.Leonhard in Pass.,17,,29,34,63
080 St.Leonhard in Pass.,18,,27,24,51
080 St.Leonhard in Pass.,19,,31,20,51
080 St.Leonhard in Pass.,20,,36,29,65
080 St.Leonhard in Pass.,21,,20,27,47
080 St.Leonhard in Pass.,22,,29,14,43
080 St.Leonhard in Pass.,23,,34,37,71
080 St.Leonhard in Pass.,24,,32,36,68
080 St.Leonhard in Pass.,25,,34,30,64
080 St.Leonhard in Pass.,26,,32,22,54
080 St.Leonhard in Pass.,27,,28,29,57
080 St.Leonhard in Pass.,28,,27,29,56
080 St.Leonhard in Pass.,29,,31,26,57
080 St.Leonhard in Pass.,30,,31,24,55
080 St.Leonhard in Pass.,31,,36,37,73
080 St.Leonhard in Pass.,32,,29,31,60
080 St.Leonhard in Pass.,33,,24,32,56
080 St.Leonhard in Pass.,34,,29,30,59
080 St.Leonhard in Pass.,35,,25,32,57
080 St.Leonhard in Pass.,36,,30,25,55
080 St.Leonhard in Pass.,37,,31,20,51
080 St.Leonhard in Pass.,38,,23,26,49
080 St.Leonhard in Pass.,39,,23,21,44
080 St.Leonhard in Pass.,40,,23,27,50
080 St.Leonhard in Pass.,41,,24,17,41
080 St.Leonhard in Pass.,42,,26,20,46
080 St.Leonhard in Pass.,43,,21,16,37
080 St.Leonhard in Pass.,44,,30,25,55
080 St.Leonhard in Pass.,45,,20,27,47
080 St.Leonhard in Pass.,46,,27,16,43
080 St.Leonhard in Pass.,47,,19,15,34
080 St.Leonhard in Pass.,48,,25,12,37
080 St.Leonhard in Pass.,49,,23,14,37
080 St.Leonhard in Pass.,50,,20,16,36
080 St.Leonhard in Pass.,51,,16,19,35
080 St.Leonhard in Pass.,52,,10,11,21
080 St.Leonhard in Pass.,53,,17,15,32
080 St.Leonhard in Pass.,54,,11,26,37
080 St.Leonhard in Pass.,55,,9,16,25
080 St.Leonhard in Pass.,56,,15,15,30
080 St.Leonhard in Pass.,57,,24,14,38
080 St.Leonhard in Pass.,58,,21,19,40
080 St.Leonhard in Pass.,59,,14,12,26
080 St.Leonhard in Pass.,60,,20,9,29
080 St.Leonhard in Pass.,61,,19,11,30
080 St.Leonhard in Pass.,62,,13,14,27
080 St.Leonhard in Pass.,63,,11,14,25
080 St.Leonhard in Pass.,64,,13,17,30
080 St.Leonhard in Pass.,65,,14,14,28
080 St.Leonhard in Pass.,66,,8,15,23
080 St.Leonhard in Pass.,67,,9,10,19
080 St.Leonhard in Pass.,68,,12,10,22
080 St.Leonhard in Pass.,69,,8,14,22
080 St.Leonhard in Pass.,70,,7,16,23
080 St.Leonhard in Pass.,71,,9,13,22
080 St.Leonhard in Pass.,72,,8,12,20
080 St.Leonhard in Pass.,73,,6,12,18
080 St.Leonhard in Pass.,74,,7,14,21
080 St.Leonhard in Pass.,75,,7,11,18
080 St.Leonhard in Pass.,76,,3,7,10
080 St.Leonhard in Pass.,77,,5,10,15
080 St.Leonhard in Pass.,78,,6,3,9
080 St.Leonhard in Pass.,79,,2,5,7
080 St.Leonhard in Pass.,80,,-,6,6
080 St.Leonhard in Pass.,81,,2,1,3
080 St.Leonhard in Pass.,82,,2,4,6
080 St.Leonhard in Pass.,83,,3,10,13
080 St.Leonhard in Pass.,84,,-,5,5
080 St.Leonhard in Pass.,85,,1,9,10
080 St.Leonhard in Pass.,86,,4,5,9
080 St.Leonhard in Pass.,87,,-,2,2
080 St.Leonhard in Pass.,88,,2,3,5
080 St.Leonhard in Pass.,89,,3,1,4
080 St.Leonhard in Pass.,90,,1,5,6
080 St.Leonhard in Pass.,91,,2,2,4
080 St.Leonhard in Pass.,92,,1,3,4
080 St.Leonhard in Pass.,93,,-,3,3
080 St.Leonhard in Pass.,95,,-,1,1
080 St.Leonhard in Pass.,Insgesamt,,1.730,1.687,3.417
081 St.Lorenzen,0,,16,26,42
081 St.Lorenzen,1,,26,25,51
081 St.Lorenzen,2,,25,12,37
081 St.Lorenzen,3,,30,19,49
081 St.Lorenzen,4,,23,30,53
081 St.Lorenzen,5,,26,20,46
081 St.Lorenzen,6,,21,15,36
081 St.Lorenzen,7,,25,22,47
081 St.Lorenzen,8,,20,17,37
081 St.Lorenzen,9,,19,26,45
081 St.Lorenzen,10,,19,22,41
081 St.Lorenzen,11,,23,21,44
081 St.Lorenzen,12,,24,22,46
081 St.Lorenzen,13,,25,26,51
081 St.Lorenzen,14,,22,20,42
081 St.Lorenzen,15,,30,18,48
081 St.Lorenzen,16,,21,20,41
081 St.Lorenzen,17,,13,17,30
081 St.Lorenzen,18,,24,26,50
081 St.Lorenzen,19,,21,24,45
081 St.Lorenzen,20,,27,22,49
081 St.Lorenzen,21,,25,21,46
081 St.Lorenzen,22,,22,24,46
081 St.Lorenzen,23,,18,28,46
081 St.Lorenzen,24,,35,23,58
081 St.Lorenzen,25,,34,25,59
081 St.Lorenzen,26,,33,22,55
081 St.Lorenzen,27,,24,29,53
081 St.Lorenzen,28,,29,28,57
081 St.Lorenzen,29,,44,36,80
081 St.Lorenzen,30,,37,32,69
081 St.Lorenzen,31,,35,35,70
081 St.Lorenzen,32,,38,23,61
081 St.Lorenzen,33,,31,22,53
081 St.Lorenzen,34,,35,31,66
081 St.Lorenzen,35,,27,33,60
081 St.Lorenzen,36,,23,36,59
081 St.Lorenzen,37,,32,24,56
081 St.Lorenzen,38,,30,27,57
081 St.Lorenzen,39,,27,31,58
081 St.Lorenzen,40,,26,25,51
081 St.Lorenzen,41,,27,27,54
081 St.Lorenzen,42,,18,18,36
081 St.Lorenzen,43,,19,19,38
081 St.Lorenzen,44,,24,16,40
081 St.Lorenzen,45,,20,12,32
081 St.Lorenzen,46,,17,15,32
081 St.Lorenzen,47,,15,18,33
081 St.Lorenzen,48,,11,21,32
081 St.Lorenzen,49,,14,12,26
081 St.Lorenzen,50,,21,9,30
081 St.Lorenzen,51,,22,9,31
081 St.Lorenzen,52,,14,20,34
081 St.Lorenzen,53,,16,16,32
081 St.Lorenzen,54,,15,15,30
081 St.Lorenzen,55,,19,25,44
081 St.Lorenzen,56,,21,18,39
081 St.Lorenzen,57,,14,13,27
081 St.Lorenzen,58,,15,19,34
081 St.Lorenzen,59,,14,13,27
081 St.Lorenzen,60,,18,17,35
081 St.Lorenzen,61,,13,16,29
081 St.Lorenzen,62,,14,18,32
081 St.Lorenzen,63,,16,14,30
081 St.Lorenzen,64,,13,14,27
081 St.Lorenzen,65,,15,13,28
081 St.Lorenzen,66,,11,16,27
081 St.Lorenzen,67,,11,11,22
081 St.Lorenzen,68,,12,20,32
081 St.Lorenzen,69,,17,17,34
081 St.Lorenzen,70,,12,7,19
081 St.Lorenzen,71,,11,14,25
081 St.Lorenzen,72,,11,20,31
081 St.Lorenzen,73,,5,12,17
081 St.Lorenzen,74,,11,12,23
081 St.Lorenzen,75,,7,9,16
081 St.Lorenzen,76,,7,6,13
081 St.Lorenzen,77,,2,10,12
081 St.Lorenzen,78,,7,10,17
081 St.Lorenzen,79,,3,8,11
081 St.Lorenzen,80,,-,6,6
081 St.Lorenzen,81,,2,5,7
081 St.Lorenzen,82,,2,4,6
081 St.Lorenzen,83,,7,5,12
081 St.Lorenzen,84,,2,2,4
081 St.Lorenzen,85,,4,5,9
081 St.Lorenzen,86,,3,3,6
081 St.Lorenzen,87,,2,6,8
081 St.Lorenzen,88,,2,2,4
081 St.Lorenzen,89,,-,3,3
081 St.Lorenzen,90,,1,5,6
081 St.Lorenzen,91,,-,1,1
081 St.Lorenzen,92,,-,2,2
081 St.Lorenzen,93,,1,1,2
081 St.Lorenzen,94,,-,2,2
081 St.Lorenzen,97,,-,1,1
081 St.Lorenzen,Insgesamt,,1.663,1.637,3.300
082 St.Martin in Thurn,0,,16,12,28
082 St.Martin in Thurn,1,,24,15,39
082 St.Martin in Thurn,2,,14,13,27
082 St.Martin in Thurn,3,,14,8,22
082 St.Martin in Thurn,4,,9,9,18
082 St.Martin in Thurn,5,,16,14,30
082 St.Martin in Thurn,6,,11,10,21
082 St.Martin in Thurn,7,,6,15,21
082 St.Martin in Thurn,8,,17,15,32
082 St.Martin in Thurn,9,,8,6,14
082 St.Martin in Thurn,10,,14,12,26
082 St.Martin in Thurn,11,,13,10,23
082 St.Martin in Thurn,12,,12,13,25
082 St.Martin in Thurn,13,,8,6,14
082 St.Martin in Thurn,14,,14,9,23
082 St.Martin in Thurn,15,,14,12,26
082 St.Martin in Thurn,16,,16,8,24
082 St.Martin in Thurn,17,,9,13,22
082 St.Martin in Thurn,18,,9,11,20
082 St.Martin in Thurn,19,,18,9,27
082 St.Martin in Thurn,20,,14,13,27
082 St.Martin in Thurn,21,,12,11,23
082 St.Martin in Thurn,22,,8,15,23
082 St.Martin in Thurn,23,,6,10,16
082 St.Martin in Thurn,24,,12,10,22
082 St.Martin in Thurn,25,,11,11,22
082 St.Martin in Thurn,26,,13,15,28
082 St.Martin in Thurn,27,,14,10,24
082 St.Martin in Thurn,28,,14,13,27
082 St.Martin in Thurn,29,,13,19,32
082 St.Martin in Thurn,30,,12,11,23
082 St.Martin in Thurn,31,,15,21,36
082 St.Martin in Thurn,32,,14,20,34
082 St.Martin in Thurn,33,,12,13,25
082 St.Martin in Thurn,34,,16,14,30
082 St.Martin in Thurn,35,,15,14,29
082 St.Martin in Thurn,36,,14,21,35
082 St.Martin in Thurn,37,,15,6,21
082 St.Martin in Thurn,38,,13,12,25
082 St.Martin in Thurn,39,,13,8,21
082 St.Martin in Thurn,40,,12,9,21
082 St.Martin in Thurn,41,,7,7,14
082 St.Martin in Thurn,42,,13,9,22
082 St.Martin in Thurn,43,,8,8,16
082 St.Martin in Thurn,44,,6,11,17
082 St.Martin in Thurn,45,,3,3,6
082 St.Martin in Thurn,46,,7,8,15
082 St.Martin in Thurn,47,,11,6,17
082 St.Martin in Thurn,48,,5,7,12
082 St.Martin in Thurn,49,,9,7,16
082 St.Martin in Thurn,50,,9,6,15
082 St.Martin in Thurn,51,,9,7,16
082 St.Martin in Thurn,52,,7,4,11
082 St.Martin in Thurn,53,,11,8,19
082 St.Martin in Thurn,54,,4,8,12
082 St.Martin in Thurn,55,,7,5,12
082 St.Martin in Thurn,56,,7,8,15
082 St.Martin in Thurn,57,,4,5,9
082 St.Martin in Thurn,58,,5,7,12
082 St.Martin in Thurn,59,,10,6,16
082 St.Martin in Thurn,60,,7,13,20
082 St.Martin in Thurn,61,,4,6,10
082 St.Martin in Thurn,62,,7,5,12
082 St.Martin in Thurn,63,,8,4,12
082 St.Martin in Thurn,64,,2,11,13
082 St.Martin in Thurn,65,,8,7,15
082 St.Martin in Thurn,66,,11,7,18
082 St.Martin in Thurn,67,,7,7,14
082 St.Martin in Thurn,68,,6,8,14
082 St.Martin in Thurn,69,,3,7,10
082 St.Martin in Thurn,70,,5,6,11
082 St.Martin in Thurn,71,,9,7,16
082 St.Martin in Thurn,72,,8,3,11
082 St.Martin in Thurn,73,,8,9,17
082 St.Martin in Thurn,74,,3,8,11
082 St.Martin in Thurn,75,,9,5,14
082 St.Martin in Thurn,76,,7,4,11
082 St.Martin in Thurn,77,,7,7,14
082 St.Martin in Thurn,78,,2,4,6
082 St.Martin in Thurn,79,,2,-,2
082 St.Martin in Thurn,80,,4,2,6
082 St.Martin in Thurn,81,,1,1,2
082 St.Martin in Thurn,82,,1,1,2
082 St.Martin in Thurn,83,,1,3,4
082 St.Martin in Thurn,84,,1,2,3
082 St.Martin in Thurn,85,,1,1,2
082 St.Martin in Thurn,86,,1,2,3
082 St.Martin in Thurn,87,,3,2,5
082 St.Martin in Thurn,88,,1,2,3
082 St.Martin in Thurn,89,,2,-,2
082 St.Martin in Thurn,90,,-,1,1
082 St.Martin in Thurn,93,,2,1,3
082 St.Martin in Thurn,Insgesamt,,813,772,1.585
083 St.Martin in Passeier,0,,24,22,46
083 St.Martin in Passeier,1,,24,24,48
083 St.Martin in Passeier,2,,21,17,38
083 St.Martin in Passeier,3,,19,23,42
083 St.Martin in Passeier,4,,19,22,41
083 St.Martin in Passeier,5,,28,18,46
083 St.Martin in Passeier,6,,21,22,43
083 St.Martin in Passeier,7,,19,25,44
083 St.Martin in Passeier,8,,19,21,40
083 St.Martin in Passeier,9,,17,15,32
083 St.Martin in Passeier,10,,18,23,41
083 St.Martin in Passeier,11,,22,23,45
083 St.Martin in Passeier,12,,16,21,37
083 St.Martin in Passeier,13,,15,23,38
083 St.Martin in Passeier,14,,17,9,26
083 St.Martin in Passeier,15,,20,20,40
083 St.Martin in Passeier,16,,23,20,43
083 St.Martin in Passeier,17,,20,22,42
083 St.Martin in Passeier,18,,21,12,33
083 St.Martin in Passeier,19,,31,17,48
083 St.Martin in Passeier,20,,20,19,39
083 St.Martin in Passeier,21,,22,21,43
083 St.Martin in Passeier,22,,24,20,44
083 St.Martin in Passeier,23,,21,24,45
083 St.Martin in Passeier,24,,22,30,52
083 St.Martin in Passeier,25,,31,26,57
083 St.Martin in Passeier,26,,30,27,57
083 St.Martin in Passeier,27,,27,29,56
083 St.Martin in Passeier,28,,29,31,60
083 St.Martin in Passeier,29,,22,28,50
083 St.Martin in Passeier,30,,19,26,45
083 St.Martin in Passeier,31,,29,31,60
083 St.Martin in Passeier,32,,33,28,61
083 St.Martin in Passeier,33,,22,22,44
083 St.Martin in Passeier,34,,35,19,54
083 St.Martin in Passeier,35,,22,29,51
083 St.Martin in Passeier,36,,35,21,56
083 St.Martin in Passeier,37,,21,27,48
083 St.Martin in Passeier,38,,28,22,50
083 St.Martin in Passeier,39,,24,21,45
083 St.Martin in Passeier,40,,27,11,38
083 St.Martin in Passeier,41,,22,16,38
083 St.Martin in Passeier,42,,33,14,47
083 St.Martin in Passeier,43,,16,8,24
083 St.Martin in Passeier,44,,22,18,40
083 St.Martin in Passeier,45,,6,21,27
083 St.Martin in Passeier,46,,21,14,35
083 St.Martin in Passeier,47,,12,16,28
083 St.Martin in Passeier,48,,11,8,19
083 St.Martin in Passeier,49,,13,10,23
083 St.Martin in Passeier,50,,14,13,27
083 St.Martin in Passeier,51,,15,11,26
083 St.Martin in Passeier,52,,12,13,25
083 St.Martin in Passeier,53,,18,12,30
083 St.Martin in Passeier,54,,15,11,26
083 St.Martin in Passeier,55,,15,14,29
083 St.Martin in Passeier,56,,11,14,25
083 St.Martin in Passeier,57,,5,13,18
083 St.Martin in Passeier,58,,6,14,20
083 St.Martin in Passeier,59,,14,9,23
083 St.Martin in Passeier,60,,14,18,32
083 St.Martin in Passeier,61,,15,15,30
083 St.Martin in Passeier,62,,7,13,20
083 St.Martin in Passeier,63,,20,9,29
083 St.Martin in Passeier,64,,15,9,24
083 St.Martin in Passeier,65,,11,12,23
083 St.Martin in Passeier,66,,7,12,19
083 St.Martin in Passeier,67,,9,14,23
083 St.Martin in Passeier,68,,13,9,22
083 St.Martin in Passeier,69,,9,8,17
083 St.Martin in Passeier,70,,13,6,19
083 St.Martin in Passeier,71,,5,13,18
083 St.Martin in Passeier,72,,9,8,17
083 St.Martin in Passeier,73,,6,14,20
083 St.Martin in Passeier,74,,4,10,14
083 St.Martin in Passeier,75,,8,7,15
083 St.Martin in Passeier,76,,7,12,19
083 St.Martin in Passeier,77,,3,5,8
083 St.Martin in Passeier,78,,2,5,7
083 St.Martin in Passeier,79,,1,4,5
083 St.Martin in Passeier,80,,2,5,7
083 St.Martin in Passeier,81,,1,2,3
083 St.Martin in Passeier,82,,4,1,5
083 St.Martin in Passeier,83,,1,8,9
083 St.Martin in Passeier,84,,3,5,8
083 St.Martin in Passeier,85,,1,5,6
083 St.Martin in Passeier,86,,2,2,4
083 St.Martin in Passeier,87,,1,2,3
083 St.Martin in Passeier,88,,1,-,1
083 St.Martin in Passeier,89,,2,2,4
083 St.Martin in Passeier,90,,-,1,1
083 St.Martin in Passeier,91,,1,2,3
083 St.Martin in Passeier,Insgesamt,,1.435,1.398,2.833
084 St.Pankraz,0,,12,12,24
084 St.Pankraz,1,,12,10,22
084 St.Pankraz,2,,8,5,13
084 St.Pankraz,3,,11,8,19
084 St.Pankraz,4,,6,9,15
084 St.Pankraz,5,,6,5,11
084 St.Pankraz,6,,11,13,24
084 St.Pankraz,7,,9,4,13
084 St.Pankraz,8,,12,15,27
084 St.Pankraz,9,,14,7,21
084 St.Pankraz,10,,9,7,16
084 St.Pankraz,11,,9,6,15
084 St.Pankraz,12,,9,8,17
084 St.Pankraz,13,,9,5,14
084 St.Pankraz,14,,10,7,17
084 St.Pankraz,15,,12,9,21
084 St.Pankraz,16,,9,12,21
084 St.Pankraz,17,,12,9,21
084 St.Pankraz,18,,6,8,14
084 St.Pankraz,19,,15,11,26
084 St.Pankraz,20,,8,16,24
084 St.Pankraz,21,,6,8,14
084 St.Pankraz,22,,10,8,18
084 St.Pankraz,23,,14,14,28
084 St.Pankraz,24,,14,10,24
084 St.Pankraz,25,,10,11,21
084 St.Pankraz,26,,17,12,29
084 St.Pankraz,27,,12,9,21
084 St.Pankraz,28,,20,13,33
084 St.Pankraz,29,,23,19,42
084 St.Pankraz,30,,10,14,24
084 St.Pankraz,31,,18,9,27
084 St.Pankraz,32,,23,14,37
084 St.Pankraz,33,,15,15,30
084 St.Pankraz,34,,11,12,23
084 St.Pankraz,35,,17,8,25
084 St.Pankraz,36,,13,12,25
084 St.Pankraz,37,,12,5,17
084 St.Pankraz,38,,17,13,30
084 St.Pankraz,39,,8,9,17
084 St.Pankraz,40,,12,9,21
084 St.Pankraz,41,,10,16,26
084 St.Pankraz,42,,7,4,11
084 St.Pankraz,43,,10,9,19
084 St.Pankraz,44,,10,9,19
084 St.Pankraz,45,,16,9,25
084 St.Pankraz,46,,4,3,7
084 St.Pankraz,47,,11,7,18
084 St.Pankraz,48,,7,6,13
084 St.Pankraz,49,,7,4,11
084 St.Pankraz,50,,7,8,15
084 St.Pankraz,51,,6,9,15
084 St.Pankraz,52,,3,6,9
084 St.Pankraz,53,,4,8,12
084 St.Pankraz,54,,11,14,25
084 St.Pankraz,55,,8,13,21
084 St.Pankraz,56,,8,11,19
084 St.Pankraz,57,,9,8,17
084 St.Pankraz,58,,11,7,18
084 St.Pankraz,59,,5,11,16
084 St.Pankraz,60,,8,10,18
084 St.Pankraz,61,,7,5,12
084 St.Pankraz,62,,5,9,14
084 St.Pankraz,63,,9,7,16
084 St.Pankraz,64,,8,3,11
084 St.Pankraz,65,,8,10,18
084 St.Pankraz,66,,9,5,14
084 St.Pankraz,67,,8,7,15
084 St.Pankraz,68,,11,9,20
084 St.Pankraz,69,,8,10,18
084 St.Pankraz,70,,7,6,13
084 St.Pankraz,71,,9,7,16
084 St.Pankraz,72,,8,7,15
084 St.Pankraz,73,,8,11,19
084 St.Pankraz,74,,10,4,14
084 St.Pankraz,75,,10,10,20
084 St.Pankraz,76,,2,12,14
084 St.Pankraz,77,,3,9,12
084 St.Pankraz,78,,4,5,9
084 St.Pankraz,79,,3,5,8
084 St.Pankraz,80,,1,3,4
084 St.Pankraz,81,,3,-,3
084 St.Pankraz,82,,3,4,7
084 St.Pankraz,83,,1,5,6
084 St.Pankraz,84,,1,1,2
084 St.Pankraz,85,,4,3,7
084 St.Pankraz,86,,1,2,3
084 St.Pankraz,87,,1,3,4
084 St.Pankraz,88,,3,5,8
084 St.Pankraz,89,,-,3,3
084 St.Pankraz,91,,1,2,3
084 St.Pankraz,92,,1,1,2
084 St.Pankraz,93,,1,1,2
084 St.Pankraz,99,,-,2,2
084 St.Pankraz,Insgesamt,,811,758,1.569
085 St.Christina in Gröden,0,,14,12,26
085 St.Christina in Gröden,1,,14,8,22
085 St.Christina in Gröden,2,,14,10,24
085 St.Christina in Gröden,3,,9,14,23
085 St.Christina in Gröden,4,,13,14,27
085 St.Christina in Gröden,5,,14,14,28
085 St.Christina in Gröden,6,,12,17,29
085 St.Christina in Gröden,7,,7,15,22
085 St.Christina in Gröden,8,,6,6,12
085 St.Christina in Gröden,9,,11,9,20
085 St.Christina in Gröden,10,,12,6,18
085 St.Christina in Gröden,11,,11,8,19
085 St.Christina in Gröden,12,,6,11,17
085 St.Christina in Gröden,13,,10,5,15
085 St.Christina in Gröden,14,,18,13,31
085 St.Christina in Gröden,15,,12,5,17
085 St.Christina in Gröden,16,,9,13,22
085 St.Christina in Gröden,17,,10,12,22
085 St.Christina in Gröden,18,,12,10,22
085 St.Christina in Gröden,19,,6,9,15
085 St.Christina in Gröden,20,,3,8,11
085 St.Christina in Gröden,21,,13,12,25
085 St.Christina in Gröden,22,,11,11,22
085 St.Christina in Gröden,23,,5,17,22
085 St.Christina in Gröden,24,,6,13,19
085 St.Christina in Gröden,25,,18,10,28
085 St.Christina in Gröden,26,,8,16,24
085 St.Christina in Gröden,27,,24,18,42
085 St.Christina in Gröden,28,,17,9,26
085 St.Christina in Gröden,29,,20,20,40
085 St.Christina in Gröden,30,,15,19,34
085 St.Christina in Gröden,31,,21,14,35
085 St.Christina in Gröden,32,,16,18,34
085 St.Christina in Gröden,33,,12,21,33
085 St.Christina in Gröden,34,,14,17,31
085 St.Christina in Gröden,35,,20,18,38
085 St.Christina in Gröden,36,,20,13,33
085 St.Christina in Gröden,37,,18,19,37
085 St.Christina in Gröden,38,,11,10,21
085 St.Christina in Gröden,39,,7,12,19
085 St.Christina in Gröden,40,,18,11,29
085 St.Christina in Gröden,41,,11,10,21
085 St.Christina in Gröden,42,,9,9,18
085 St.Christina in Gröden,43,,16,14,30
085 St.Christina in Gröden,44,,9,9,18
085 St.Christina in Gröden,45,,6,5,11
085 St.Christina in Gröden,46,,11,5,16
085 St.Christina in Gröden,47,,6,6,12
085 St.Christina in Gröden,48,,7,11,18
085 St.Christina in Gröden,49,,8,6,14
085 St.Christina in Gröden,50,,6,9,15
085 St.Christina in Gröden,51,,9,13,22
085 St.Christina in Gröden,52,,6,6,12
085 St.Christina in Gröden,53,,5,11,16
085 St.Christina in Gröden,54,,13,15,28
085 St.Christina in Gröden,55,,10,6,16
085 St.Christina in Gröden,56,,13,7,20
085 St.Christina in Gröden,57,,10,11,21
085 St.Christina in Gröden,58,,11,11,22
085 St.Christina in Gröden,59,,7,8,15
085 St.Christina in Gröden,60,,9,7,16
085 St.Christina in Gröden,61,,15,10,25
085 St.Christina in Gröden,62,,14,5,19
085 St.Christina in Gröden,63,,8,12,20
085 St.Christina in Gröden,64,,6,14,20
085 St.Christina in Gröden,65,,9,10,19
085 St.Christina in Gröden,66,,6,9,15
085 St.Christina in Gröden,67,,14,5,19
085 St.Christina in Gröden,68,,5,10,15
085 St.Christina in Gröden,69,,6,5,11
085 St.Christina in Gröden,70,,5,6,11
085 St.Christina in Gröden,71,,9,7,16
085 St.Christina in Gröden,72,,7,10,17
085 St.Christina in Gröden,73,,3,5,8
085 St.Christina in Gröden,74,,6,3,9
085 St.Christina in Gröden,75,,1,10,11
085 St.Christina in Gröden,76,,4,3,7
085 St.Christina in Gröden,77,,5,6,11
085 St.Christina in Gröden,78,,4,1,5
085 St.Christina in Gröden,79,,-,1,1
085 St.Christina in Gröden,80,,1,2,3
085 St.Christina in Gröden,81,,-,3,3
085 St.Christina in Gröden,82,,5,1,6
085 St.Christina in Gröden,83,,3,4,7
085 St.Christina in Gröden,84,,4,-,4
085 St.Christina in Gröden,85,,1,2,3
085 St.Christina in Gröden,86,,-,2,2
085 St.Christina in Gröden,87,,1,3,4
085 St.Christina in Gröden,88,,2,2,4
085 St.Christina in Gröden,89,,-,1,1
085 St.Christina in Gröden,90,,1,2,3
085 St.Christina in Gröden,91,,-,1,1
085 St.Christina in Gröden,93,,-,1,1
085 St.Christina in Gröden,Insgesamt,,844,852,1.696
086 Sarntal,0,,45,47,92
086 Sarntal,1,,51,43,94
086 Sarntal,2,,41,40,81
086 Sarntal,3,,33,42,75
086 Sarntal,4,,32,38,70
086 Sarntal,5,,45,38,83
086 Sarntal,6,,43,41,84
086 Sarntal,7,,45,30,75
086 Sarntal,8,,53,37,90
086 Sarntal,9,,46,41,87
086 Sarntal,10,,36,32,68
086 Sarntal,11,,40,43,83
086 Sarntal,12,,43,39,82
086 Sarntal,13,,39,42,81
086 Sarntal,14,,51,42,93
086 Sarntal,15,,63,51,114
086 Sarntal,16,,44,58,102
086 Sarntal,17,,59,50,109
086 Sarntal,18,,56,48,104
086 Sarntal,19,,56,53,109
086 Sarntal,20,,60,46,106
086 Sarntal,21,,49,40,89
086 Sarntal,22,,67,51,118
086 Sarntal,23,,50,66,116
086 Sarntal,24,,62,62,124
086 Sarntal,25,,72,46,118
086 Sarntal,26,,53,50,103
086 Sarntal,27,,66,62,128
086 Sarntal,28,,65,60,125
086 Sarntal,29,,51,46,97
086 Sarntal,30,,52,51,103
086 Sarntal,31,,52,57,109
086 Sarntal,32,,66,53,119
086 Sarntal,33,,65,61,126
086 Sarntal,34,,45,47,92
086 Sarntal,35,,63,33,96
086 Sarntal,36,,42,49,91
086 Sarntal,37,,64,45,109
086 Sarntal,38,,46,38,84
086 Sarntal,39,,53,43,96
086 Sarntal,40,,38,45,83
086 Sarntal,41,,40,30,70
086 Sarntal,42,,41,37,78
086 Sarntal,43,,37,29,66
086 Sarntal,44,,41,31,72
086 Sarntal,45,,38,41,79
086 Sarntal,46,,46,34,80
086 Sarntal,47,,38,36,74
086 Sarntal,48,,52,25,77
086 Sarntal,49,,36,38,74
086 Sarntal,50,,41,28,69
086 Sarntal,51,,37,37,74
086 Sarntal,52,,30,31,61
086 Sarntal,53,,27,31,58
086 Sarntal,54,,42,41,83
086 Sarntal,55,,43,40,83
086 Sarntal,56,,33,34,67
086 Sarntal,57,,31,44,75
086 Sarntal,58,,40,32,72
086 Sarntal,59,,36,29,65
086 Sarntal,60,,26,34,60
086 Sarntal,61,,22,25,47
086 Sarntal,62,,25,25,50
086 Sarntal,63,,28,22,50
086 Sarntal,64,,25,24,49
086 Sarntal,65,,32,26,58
086 Sarntal,66,,20,25,45
086 Sarntal,67,,22,26,48
086 Sarntal,68,,21,30,51
086 Sarntal,69,,25,30,55
086 Sarntal,70,,19,34,53
086 Sarntal,71,,24,17,41
086 Sarntal,72,,22,26,48
086 Sarntal,73,,17,29,46
086 Sarntal,74,,15,28,43
086 Sarntal,75,,18,34,52
086 Sarntal,76,,11,18,29
086 Sarntal,77,,16,20,36
086 Sarntal,78,,8,20,28
086 Sarntal,79,,6,13,19
086 Sarntal,80,,3,12,15
086 Sarntal,81,,3,10,13
086 Sarntal,82,,4,8,12
086 Sarntal,83,,11,11,22
086 Sarntal,84,,11,13,24
086 Sarntal,85,,9,13,22
086 Sarntal,86,,7,12,19
086 Sarntal,87,,3,12,15
086 Sarntal,88,,4,6,10
086 Sarntal,89,,1,5,6
086 Sarntal,90,,3,7,10
086 Sarntal,91,,4,2,6
086 Sarntal,92,,3,1,4
086 Sarntal,93,,1,3,4
086 Sarntal,94,,-,1,1
086 Sarntal,95,,1,2,3
086 Sarntal,96,,-,3,3
086 Sarntal,Insgesamt,,3.301,3.181,6.482
087 Schenna,0,,15,17,32
087 Schenna,1,,18,18,36
087 Schenna,2,,19,17,36
087 Schenna,3,,21,17,38
087 Schenna,4,,15,8,23
087 Schenna,5,,15,19,34
087 Schenna,6,,11,20,31
087 Schenna,7,,18,15,33
087 Schenna,8,,21,9,30
087 Schenna,9,,20,19,39
087 Schenna,10,,21,16,37
087 Schenna,11,,18,12,30
087 Schenna,12,,15,16,31
087 Schenna,13,,16,13,29
087 Schenna,14,,17,15,32
087 Schenna,15,,11,17,28
087 Schenna,16,,22,8,30
087 Schenna,17,,19,17,36
087 Schenna,18,,23,21,44
087 Schenna,19,,15,20,35
087 Schenna,20,,18,19,37
087 Schenna,21,,24,19,43
087 Schenna,22,,15,27,42
087 Schenna,23,,31,27,58
087 Schenna,24,,28,23,51
087 Schenna,25,,24,21,45
087 Schenna,26,,30,25,55
087 Schenna,27,,24,22,46
087 Schenna,28,,25,19,44
087 Schenna,29,,21,22,43
087 Schenna,30,,33,23,56
087 Schenna,31,,12,21,33
087 Schenna,32,,25,30,55
087 Schenna,33,,22,24,46
087 Schenna,34,,28,18,46
087 Schenna,35,,25,12,37
087 Schenna,36,,27,21,48
087 Schenna,37,,34,24,58
087 Schenna,38,,16,13,29
087 Schenna,39,,21,18,39
087 Schenna,40,,11,20,31
087 Schenna,41,,17,16,33
087 Schenna,42,,14,15,29
087 Schenna,43,,15,18,33
087 Schenna,44,,16,17,33
087 Schenna,45,,15,16,31
087 Schenna,46,,15,13,28
087 Schenna,47,,21,15,36
087 Schenna,48,,20,20,40
087 Schenna,49,,15,15,30
087 Schenna,50,,15,17,32
087 Schenna,51,,18,23,41
087 Schenna,52,,15,13,28
087 Schenna,53,,17,10,27
087 Schenna,54,,24,10,34
087 Schenna,55,,12,19,31
087 Schenna,56,,14,13,27
087 Schenna,57,,10,9,19
087 Schenna,58,,13,15,28
087 Schenna,59,,15,19,34
087 Schenna,60,,7,10,17
087 Schenna,61,,11,11,22
087 Schenna,62,,13,9,22
087 Schenna,63,,13,15,28
087 Schenna,64,,6,10,16
087 Schenna,65,,11,15,26
087 Schenna,66,,13,13,26
087 Schenna,67,,12,10,22
087 Schenna,68,,9,12,21
087 Schenna,69,,7,11,18
087 Schenna,70,,5,15,20
087 Schenna,71,,8,7,15
087 Schenna,72,,5,13,18
087 Schenna,73,,11,8,19
087 Schenna,74,,8,5,13
087 Schenna,75,,9,6,15
087 Schenna,76,,8,15,23
087 Schenna,77,,8,5,13
087 Schenna,78,,3,7,10
087 Schenna,79,,2,5,7
087 Schenna,80,,1,5,6
087 Schenna,81,,4,1,5
087 Schenna,82,,4,4,8
087 Schenna,83,,5,5,10
087 Schenna,84,,2,3,5
087 Schenna,85,,7,2,9
087 Schenna,87,,1,2,3
087 Schenna,88,,2,4,6
087 Schenna,89,,-,2,2
087 Schenna,90,,1,1,2
087 Schenna,91,,-,1,1
087 Schenna,95,,-,1,1
087 Schenna,Insgesamt,,1.341,1.288,2.629
088 Mühlwald,0,,10,9,19
088 Mühlwald,1,,14,13,27
088 Mühlwald,2,,13,5,18
088 Mühlwald,3,,10,5,15
088 Mühlwald,4,,14,12,26
088 Mühlwald,5,,5,6,11
088 Mühlwald,6,,11,7,18
088 Mühlwald,7,,9,6,15
088 Mühlwald,8,,16,8,24
088 Mühlwald,9,,7,3,10
088 Mühlwald,10,,9,14,23
088 Mühlwald,11,,6,7,13
088 Mühlwald,12,,12,18,30
088 Mühlwald,13,,11,19,30
088 Mühlwald,14,,12,11,23
088 Mühlwald,15,,8,17,25
088 Mühlwald,16,,15,14,29
088 Mühlwald,17,,21,6,27
088 Mühlwald,18,,8,19,27
088 Mühlwald,19,,12,14,26
088 Mühlwald,20,,8,8,16
088 Mühlwald,21,,15,12,27
088 Mühlwald,22,,11,10,21
088 Mühlwald,23,,10,8,18
088 Mühlwald,24,,16,10,26
088 Mühlwald,25,,10,13,23
088 Mühlwald,26,,21,14,35
088 Mühlwald,27,,10,10,20
088 Mühlwald,28,,17,17,34
088 Mühlwald,29,,18,11,29
088 Mühlwald,30,,17,14,31
088 Mühlwald,31,,16,8,24
088 Mühlwald,32,,18,12,30
088 Mühlwald,33,,16,8,24
088 Mühlwald,34,,12,10,22
088 Mühlwald,35,,9,13,22
088 Mühlwald,36,,6,10,16
088 Mühlwald,37,,16,9,25
088 Mühlwald,38,,14,5,19
088 Mühlwald,39,,10,7,17
088 Mühlwald,40,,14,12,26
088 Mühlwald,41,,7,8,15
088 Mühlwald,42,,8,7,15
088 Mühlwald,43,,10,4,14
088 Mühlwald,44,,13,9,22
088 Mühlwald,45,,10,8,18
088 Mühlwald,46,,10,4,14
088 Mühlwald,47,,5,9,14
088 Mühlwald,48,,9,4,13
088 Mühlwald,49,,12,4,16
088 Mühlwald,50,,10,7,17
088 Mühlwald,51,,9,3,12
088 Mühlwald,52,,6,4,10
088 Mühlwald,53,,8,4,12
088 Mühlwald,54,,12,2,14
088 Mühlwald,55,,6,7,13
088 Mühlwald,56,,4,8,12
088 Mühlwald,57,,3,8,11
088 Mühlwald,58,,6,11,17
088 Mühlwald,59,,10,4,14
088 Mühlwald,60,,12,3,15
088 Mühlwald,61,,6,4,10
088 Mühlwald,62,,5,4,9
088 Mühlwald,63,,3,10,13
088 Mühlwald,64,,4,11,15
088 Mühlwald,65,,1,2,3
088 Mühlwald,66,,8,6,14
088 Mühlwald,67,,5,6,11
088 Mühlwald,68,,10,11,21
088 Mühlwald,69,,4,4,8
088 Mühlwald,70,,10,3,13
088 Mühlwald,71,,4,6,10
088 Mühlwald,72,,5,4,9
088 Mühlwald,73,,7,5,12
088 Mühlwald,74,,1,5,6
088 Mühlwald,75,,1,6,7
088 Mühlwald,76,,-,6,6
088 Mühlwald,77,,2,3,5
088 Mühlwald,78,,3,2,5
088 Mühlwald,79,,1,4,5
088 Mühlwald,80,,4,2,6
088 Mühlwald,81,,-,1,1
088 Mühlwald,82,,-,3,3
088 Mühlwald,83,,1,3,4
088 Mühlwald,84,,-,4,4
088 Mühlwald,86,,1,2,3
088 Mühlwald,87,,-,1,1
088 Mühlwald,89,,1,-,1
088 Mühlwald,90,,1,-,1
088 Mühlwald,91,,-,2,2
088 Mühlwald,92,,-,1,1
088 Mühlwald,95,,1,-,1
088 Mühlwald,Insgesamt,,766,673,1.439
089 Wolkenstein in Gröden,0,,22,28,50
089 Wolkenstein in Gröden,1,,12,11,23
089 Wolkenstein in Gröden,2,,18,12,30
089 Wolkenstein in Gröden,3,,16,17,33
089 Wolkenstein in Gröden,4,,13,13,26
089 Wolkenstein in Gröden,5,,20,12,32
089 Wolkenstein in Gröden,6,,19,14,33
089 Wolkenstein in Gröden,7,,12,12,24
089 Wolkenstein in Gröden,8,,17,14,31
089 Wolkenstein in Gröden,9,,15,16,31
089 Wolkenstein in Gröden,10,,11,19,30
089 Wolkenstein in Gröden,11,,16,13,29
089 Wolkenstein in Gröden,12,,16,10,26
089 Wolkenstein in Gröden,13,,13,11,24
089 Wolkenstein in Gröden,14,,17,9,26
089 Wolkenstein in Gröden,15,,11,17,28
089 Wolkenstein in Gröden,16,,15,12,27
089 Wolkenstein in Gröden,17,,15,17,32
089 Wolkenstein in Gröden,18,,7,15,22
089 Wolkenstein in Gröden,19,,8,11,19
089 Wolkenstein in Gröden,20,,12,12,24
089 Wolkenstein in Gröden,21,,18,19,37
089 Wolkenstein in Gröden,22,,22,20,42
089 Wolkenstein in Gröden,23,,11,16,27
089 Wolkenstein in Gröden,24,,27,25,52
089 Wolkenstein in Gröden,25,,13,18,31
089 Wolkenstein in Gröden,26,,21,26,47
089 Wolkenstein in Gröden,27,,18,26,44
089 Wolkenstein in Gröden,28,,27,21,48
089 Wolkenstein in Gröden,29,,30,25,55
089 Wolkenstein in Gröden,30,,31,26,57
089 Wolkenstein in Gröden,31,,27,22,49
089 Wolkenstein in Gröden,32,,24,30,54
089 Wolkenstein in Gröden,33,,32,22,54
089 Wolkenstein in Gröden,34,,22,18,40
089 Wolkenstein in Gröden,35,,19,24,43
089 Wolkenstein in Gröden,36,,26,26,52
089 Wolkenstein in Gröden,37,,22,23,45
089 Wolkenstein in Gröden,38,,18,16,34
089 Wolkenstein in Gröden,39,,19,18,37
089 Wolkenstein in Gröden,40,,19,16,35
089 Wolkenstein in Gröden,41,,12,13,25
089 Wolkenstein in Gröden,42,,14,11,25
089 Wolkenstein in Gröden,43,,17,10,27
089 Wolkenstein in Gröden,44,,8,14,22
089 Wolkenstein in Gröden,45,,12,7,19
089 Wolkenstein in Gröden,46,,15,11,26
089 Wolkenstein in Gröden,47,,7,18,25
089 Wolkenstein in Gröden,48,,17,12,29
089 Wolkenstein in Gröden,49,,14,13,27
089 Wolkenstein in Gröden,50,,12,17,29
089 Wolkenstein in Gröden,51,,16,19,35
089 Wolkenstein in Gröden,52,,6,13,19
089 Wolkenstein in Gröden,53,,14,11,25
089 Wolkenstein in Gröden,54,,21,16,37
089 Wolkenstein in Gröden,55,,15,13,28
089 Wolkenstein in Gröden,56,,18,19,37
089 Wolkenstein in Gröden,57,,18,18,36
089 Wolkenstein in Gröden,58,,20,17,37
089 Wolkenstein in Gröden,59,,22,8,30
089 Wolkenstein in Gröden,60,,12,18,30
089 Wolkenstein in Gröden,61,,10,15,25
089 Wolkenstein in Gröden,62,,15,10,25
089 Wolkenstein in Gröden,63,,18,10,28
089 Wolkenstein in Gröden,64,,7,11,18
089 Wolkenstein in Gröden,65,,6,10,16
089 Wolkenstein in Gröden,66,,12,10,22
089 Wolkenstein in Gröden,67,,10,12,22
089 Wolkenstein in Gröden,68,,10,7,17
089 Wolkenstein in Gröden,69,,7,13,20
089 Wolkenstein in Gröden,70,,12,8,20
089 Wolkenstein in Gröden,71,,9,6,15
089 Wolkenstein in Gröden,72,,8,8,16
089 Wolkenstein in Gröden,73,,3,13,16
089 Wolkenstein in Gröden,74,,7,5,12
089 Wolkenstein in Gröden,75,,6,10,16
089 Wolkenstein in Gröden,76,,2,6,8
089 Wolkenstein in Gröden,77,,5,4,9
089 Wolkenstein in Gröden,78,,1,3,4
089 Wolkenstein in Gröden,79,,-,2,2
089 Wolkenstein in Gröden,80,,1,4,5
089 Wolkenstein in Gröden,81,,-,3,3
089 Wolkenstein in Gröden,82,,1,4,5
089 Wolkenstein in Gröden,83,,4,4,8
089 Wolkenstein in Gröden,84,,1,2,3
089 Wolkenstein in Gröden,85,,1,6,7
089 Wolkenstein in Gröden,86,,1,5,6
089 Wolkenstein in Gröden,87,,3,4,7
089 Wolkenstein in Gröden,88,,2,2,4
089 Wolkenstein in Gröden,89,,2,4,6
089 Wolkenstein in Gröden,90,,-,1,1
089 Wolkenstein in Gröden,92,,1,1,2
089 Wolkenstein in Gröden,93,,-,2,2
089 Wolkenstein in Gröden,94,,-,1,1
089 Wolkenstein in Gröden,Insgesamt,,1.206,1.216,2.422
091 Schnals,0,,13,8,21
091 Schnals,1,,5,13,18
091 Schnals,2,,6,9,15
091 Schnals,3,,4,9,13
091 Schnals,4,,12,4,16
091 Schnals,5,,13,11,24
091 Schnals,6,,14,9,23
091 Schnals,7,,5,7,12
091 Schnals,8,,21,9,30
091 Schnals,9,,10,5,15
091 Schnals,10,,12,11,23
091 Schnals,11,,10,10,20
091 Schnals,12,,7,10,17
091 Schnals,13,,12,16,28
091 Schnals,14,,10,10,20
091 Schnals,15,,12,8,20
091 Schnals,16,,16,10,26
091 Schnals,17,,14,12,26
091 Schnals,18,,12,9,21
091 Schnals,19,,12,8,20
091 Schnals,20,,8,9,17
091 Schnals,21,,12,5,17
091 Schnals,22,,8,11,19
091 Schnals,23,,15,10,25
091 Schnals,24,,7,11,18
091 Schnals,25,,9,9,18
091 Schnals,26,,12,12,24
091 Schnals,27,,10,11,21
091 Schnals,28,,15,11,26
091 Schnals,29,,10,13,23
091 Schnals,30,,18,14,32
091 Schnals,31,,16,13,29
091 Schnals,32,,18,7,25
091 Schnals,33,,6,10,16
091 Schnals,34,,11,16,27
091 Schnals,35,,16,11,27
091 Schnals,36,,11,14,25
091 Schnals,37,,11,8,19
091 Schnals,38,,15,12,27
091 Schnals,39,,14,12,26
091 Schnals,40,,12,5,17
091 Schnals,41,,14,6,20
091 Schnals,42,,11,6,17
091 Schnals,43,,10,9,19
091 Schnals,44,,12,8,20
091 Schnals,45,,14,8,22
091 Schnals,46,,12,8,20
091 Schnals,47,,11,6,17
091 Schnals,48,,11,10,21
091 Schnals,49,,3,2,5
091 Schnals,50,,11,8,19
091 Schnals,51,,5,6,11
091 Schnals,52,,9,4,13
091 Schnals,53,,5,7,12
091 Schnals,54,,7,10,17
091 Schnals,55,,4,5,9
091 Schnals,56,,5,5,10
091 Schnals,57,,8,7,15
091 Schnals,58,,7,7,14
091 Schnals,59,,3,11,14
091 Schnals,60,,7,5,12
091 Schnals,61,,6,6,12
091 Schnals,62,,5,5,10
091 Schnals,63,,3,4,7
091 Schnals,64,,7,5,12
091 Schnals,65,,3,9,12
091 Schnals,66,,3,5,8
091 Schnals,67,,2,5,7
091 Schnals,68,,8,6,14
091 Schnals,69,,2,7,9
091 Schnals,70,,4,7,11
091 Schnals,71,,9,4,13
091 Schnals,72,,7,10,17
091 Schnals,73,,4,7,11
091 Schnals,74,,1,2,3
091 Schnals,75,,8,4,12
091 Schnals,76,,1,6,7
091 Schnals,77,,3,7,10
091 Schnals,78,,2,1,3
091 Schnals,79,,3,3,6
091 Schnals,80,,-,4,4
091 Schnals,81,,1,3,4
091 Schnals,82,,4,2,6
091 Schnals,83,,2,2,4
091 Schnals,84,,-,2,2
091 Schnals,85,,2,2,4
091 Schnals,86,,-,2,2
091 Schnals,87,,-,2,2
091 Schnals,88,,-,2,2
091 Schnals,92,,-,2,2
091 Schnals,94,,-,1,1
091 Schnals,95,,1,-,1
091 Schnals,Insgesamt,,734,677,1.411
092 Sexten,0,,11,11,22
092 Sexten,1,,12,12,24
092 Sexten,2,,14,15,29
092 Sexten,3,,15,11,26
092 Sexten,4,,8,3,11
092 Sexten,5,,13,10,23
092 Sexten,6,,13,11,24
092 Sexten,7,,10,20,30
092 Sexten,8,,9,9,18
092 Sexten,9,,9,6,15
092 Sexten,10,,13,9,22
092 Sexten,11,,7,9,16
092 Sexten,12,,12,11,23
092 Sexten,13,,7,11,18
092 Sexten,14,,11,9,20
092 Sexten,15,,11,19,30
092 Sexten,16,,14,13,27
092 Sexten,17,,16,8,24
092 Sexten,18,,11,18,29
092 Sexten,19,,10,15,25
092 Sexten,20,,10,7,17
092 Sexten,21,,17,12,29
092 Sexten,22,,9,10,19
092 Sexten,23,,8,8,16
092 Sexten,24,,10,10,20
092 Sexten,25,,15,13,28
092 Sexten,26,,14,20,34
092 Sexten,27,,14,20,34
092 Sexten,28,,23,14,37
092 Sexten,29,,15,18,33
092 Sexten,30,,24,17,41
092 Sexten,31,,17,19,36
092 Sexten,32,,21,20,41
092 Sexten,33,,19,17,36
092 Sexten,34,,31,18,49
092 Sexten,35,,15,15,30
092 Sexten,36,,22,14,36
092 Sexten,37,,19,9,28
092 Sexten,38,,15,16,31
092 Sexten,39,,22,17,39
092 Sexten,40,,18,14,32
092 Sexten,41,,15,15,30
092 Sexten,42,,13,13,26
092 Sexten,43,,11,11,22
092 Sexten,44,,6,11,17
092 Sexten,45,,6,11,17
092 Sexten,46,,7,8,15
092 Sexten,47,,13,7,20
092 Sexten,48,,9,5,14
092 Sexten,49,,10,6,16
092 Sexten,50,,13,4,17
092 Sexten,51,,6,9,15
092 Sexten,52,,10,4,14
092 Sexten,53,,7,12,19
092 Sexten,54,,8,6,14
092 Sexten,55,,5,7,12
092 Sexten,56,,10,15,25
092 Sexten,57,,8,14,22
092 Sexten,58,,7,10,17
092 Sexten,59,,15,12,27
092 Sexten,60,,12,9,21
092 Sexten,61,,9,11,20
092 Sexten,62,,12,15,27
092 Sexten,63,,13,7,20
092 Sexten,64,,6,12,18
092 Sexten,65,,6,8,14
092 Sexten,66,,12,13,25
092 Sexten,67,,10,12,22
092 Sexten,68,,8,13,21
092 Sexten,69,,11,13,24
092 Sexten,70,,13,18,31
092 Sexten,71,,8,4,12
092 Sexten,72,,10,13,23
092 Sexten,73,,7,10,17
092 Sexten,74,,8,11,19
092 Sexten,75,,8,12,20
092 Sexten,76,,4,10,14
092 Sexten,77,,3,5,8
092 Sexten,78,,3,4,7
092 Sexten,79,,-,1,1
092 Sexten,80,,2,2,4
092 Sexten,81,,2,2,4
092 Sexten,82,,3,-,3
092 Sexten,83,,2,2,4
092 Sexten,84,,-,6,6
092 Sexten,85,,3,5,8
092 Sexten,86,,-,1,1
092 Sexten,87,,-,1,1
092 Sexten,88,,-,1,1
092 Sexten,89,,-,4,4
092 Sexten,90,,1,1,2
092 Sexten,91,,-,2,2
092 Sexten,92,,-,2,2
092 Sexten,94,,-,1,1
092 Sexten,99,,-,1,1
092 Sexten,Insgesamt,,939,950,1.889
093 Schlanders,0,,54,49,103
093 Schlanders,1,,46,35,81
093 Schlanders,2,,35,28,63
093 Schlanders,3,,39,38,77
093 Schlanders,4,,41,45,86
093 Schlanders,5,,34,39,73
093 Schlanders,6,,38,34,72
093 Schlanders,7,,49,44,93
093 Schlanders,8,,38,37,75
093 Schlanders,9,,32,45,77
093 Schlanders,10,,36,32,68
093 Schlanders,11,,36,34,70
093 Schlanders,12,,40,38,78
093 Schlanders,13,,35,37,72
093 Schlanders,14,,32,34,66
093 Schlanders,15,,53,38,91
093 Schlanders,16,,47,36,83
093 Schlanders,17,,35,35,70
093 Schlanders,18,,37,38,75
093 Schlanders,19,,53,30,83
093 Schlanders,20,,34,36,70
093 Schlanders,21,,36,26,62
093 Schlanders,22,,43,40,83
093 Schlanders,23,,52,39,91
093 Schlanders,24,,51,41,92
093 Schlanders,25,,46,40,86
093 Schlanders,26,,55,45,100
093 Schlanders,27,,47,46,93
093 Schlanders,28,,59,38,97
093 Schlanders,29,,47,35,82
093 Schlanders,30,,58,45,103
093 Schlanders,31,,51,54,105
093 Schlanders,32,,51,49,100
093 Schlanders,33,,44,45,89
093 Schlanders,34,,56,57,113
093 Schlanders,35,,52,46,98
093 Schlanders,36,,49,54,103
093 Schlanders,37,,50,45,95
093 Schlanders,38,,48,39,87
093 Schlanders,39,,53,55,108
093 Schlanders,40,,45,37,82
093 Schlanders,41,,28,34,62
093 Schlanders,42,,33,36,69
093 Schlanders,43,,31,32,63
093 Schlanders,44,,33,35,68
093 Schlanders,45,,32,26,58
093 Schlanders,46,,31,31,62
093 Schlanders,47,,26,32,58
093 Schlanders,48,,29,35,64
093 Schlanders,49,,35,30,65
093 Schlanders,50,,24,25,49
093 Schlanders,51,,30,21,51
093 Schlanders,52,,31,18,49
093 Schlanders,53,,29,33,62
093 Schlanders,54,,30,31,61
093 Schlanders,55,,39,37,76
093 Schlanders,56,,36,37,73
093 Schlanders,57,,29,30,59
093 Schlanders,58,,30,35,65
093 Schlanders,59,,21,20,41
093 Schlanders,60,,27,26,53
093 Schlanders,61,,23,24,47
093 Schlanders,62,,19,28,47
093 Schlanders,63,,23,27,50
093 Schlanders,64,,23,34,57
093 Schlanders,65,,23,20,43
093 Schlanders,66,,26,21,47
093 Schlanders,67,,26,30,56
093 Schlanders,68,,14,20,34
093 Schlanders,69,,20,25,45
093 Schlanders,70,,19,27,46
093 Schlanders,71,,18,27,45
093 Schlanders,72,,14,21,35
093 Schlanders,73,,18,22,40
093 Schlanders,74,,11,20,31
093 Schlanders,75,,12,19,31
093 Schlanders,76,,9,11,20
093 Schlanders,77,,4,23,27
093 Schlanders,78,,9,17,26
093 Schlanders,79,,9,19,28
093 Schlanders,80,,11,3,14
093 Schlanders,81,,4,12,16
093 Schlanders,82,,6,5,11
093 Schlanders,83,,7,18,25
093 Schlanders,84,,7,12,19
093 Schlanders,85,,7,13,20
093 Schlanders,86,,4,15,19
093 Schlanders,87,,3,11,14
093 Schlanders,88,,2,7,9
093 Schlanders,89,,2,7,9
093 Schlanders,90,,1,1,2
093 Schlanders,91,,3,5,8
093 Schlanders,92,,1,2,3
093 Schlanders,93,,3,3,6
093 Schlanders,94,,-,5,5
093 Schlanders,95,,-,1,1
093 Schlanders,96,,-,1,1
093 Schlanders,97,,-,1,1
093 Schlanders,Insgesamt,,2.822,2.819,5.641
094 Schluderns,0,,14,11,25
094 Schluderns,1,,10,17,27
094 Schluderns,2,,9,13,22
094 Schluderns,3,,16,19,35
094 Schluderns,4,,17,7,24
094 Schluderns,5,,8,8,16
094 Schluderns,6,,10,9,19
094 Schluderns,7,,22,7,29
094 Schluderns,8,,15,13,28
094 Schluderns,9,,11,13,24
094 Schluderns,10,,6,11,17
094 Schluderns,11,,14,22,36
094 Schluderns,12,,18,11,29
094 Schluderns,13,,17,14,31
094 Schluderns,14,,13,8,21
094 Schluderns,15,,10,11,21
094 Schluderns,16,,20,14,34
094 Schluderns,17,,8,10,18
094 Schluderns,18,,7,19,26
094 Schluderns,19,,12,14,26
094 Schluderns,20,,12,16,28
094 Schluderns,21,,9,14,23
094 Schluderns,22,,14,6,20
094 Schluderns,23,,20,11,31
094 Schluderns,24,,23,15,38
094 Schluderns,25,,14,14,28
094 Schluderns,26,,13,16,29
094 Schluderns,27,,11,14,25
094 Schluderns,28,,20,11,31
094 Schluderns,29,,18,14,32
094 Schluderns,30,,17,13,30
094 Schluderns,31,,17,22,39
094 Schluderns,32,,25,10,35
094 Schluderns,33,,25,12,37
094 Schluderns,34,,16,21,37
094 Schluderns,35,,13,22,35
094 Schluderns,36,,18,18,36
094 Schluderns,37,,13,7,20
094 Schluderns,38,,11,23,34
094 Schluderns,39,,9,12,21
094 Schluderns,40,,15,6,21
094 Schluderns,41,,13,19,32
094 Schluderns,42,,18,10,28
094 Schluderns,43,,12,6,18
094 Schluderns,44,,11,6,17
094 Schluderns,45,,8,5,13
094 Schluderns,46,,11,3,14
094 Schluderns,47,,6,14,20
094 Schluderns,48,,13,9,22
094 Schluderns,49,,12,8,20
094 Schluderns,50,,7,4,11
094 Schluderns,51,,8,10,18
094 Schluderns,52,,6,3,9
094 Schluderns,53,,4,12,16
094 Schluderns,54,,3,7,10
094 Schluderns,55,,7,8,15
094 Schluderns,56,,11,14,25
094 Schluderns,57,,8,5,13
094 Schluderns,58,,13,8,21
094 Schluderns,59,,10,10,20
094 Schluderns,60,,8,8,16
094 Schluderns,61,,4,7,11
094 Schluderns,62,,6,10,16
094 Schluderns,63,,11,12,23
094 Schluderns,64,,4,10,14
094 Schluderns,65,,11,9,20
094 Schluderns,66,,4,7,11
094 Schluderns,67,,8,10,18
094 Schluderns,68,,11,7,18
094 Schluderns,69,,7,10,17
094 Schluderns,70,,9,1,10
094 Schluderns,71,,5,15,20
094 Schluderns,72,,3,6,9
094 Schluderns,73,,5,5,10
094 Schluderns,74,,2,5,7
094 Schluderns,75,,9,6,15
094 Schluderns,76,,2,9,11
094 Schluderns,77,,1,3,4
094 Schluderns,78,,3,7,10
094 Schluderns,79,,3,2,5
094 Schluderns,80,,2,2,4
094 Schluderns,81,,3,5,8
094 Schluderns,82,,1,3,4
094 Schluderns,83,,2,5,7
094 Schluderns,84,,1,2,3
094 Schluderns,85,,1,7,8
094 Schluderns,86,,1,2,3
094 Schluderns,87,,1,1,2
094 Schluderns,88,,2,2,4
094 Schluderns,89,,1,1,2
094 Schluderns,90,,-,1,1
094 Schluderns,91,,1,-,1
094 Schluderns,92,,-,3,3
094 Schluderns,Insgesamt,,903,892,1.795
095 Stilfs,0,,10,10,20
095 Stilfs,1,,12,1,13
095 Stilfs,2,,6,7,13
095 Stilfs,3,,8,7,15
095 Stilfs,4,,5,16,21
095 Stilfs,5,,4,10,14
095 Stilfs,6,,13,5,18
095 Stilfs,7,,17,7,24
095 Stilfs,8,,9,6,15
095 Stilfs,9,,6,4,10
095 Stilfs,10,,6,6,12
095 Stilfs,11,,9,8,17
095 Stilfs,12,,13,5,18
095 Stilfs,13,,15,5,20
095 Stilfs,14,,8,7,15
095 Stilfs,15,,12,5,17
095 Stilfs,16,,10,3,13
095 Stilfs,17,,8,4,12
095 Stilfs,18,,6,9,15
095 Stilfs,19,,10,7,17
095 Stilfs,20,,10,13,23
095 Stilfs,21,,14,4,18
095 Stilfs,22,,10,10,20
095 Stilfs,23,,10,8,18
095 Stilfs,24,,4,21,25
095 Stilfs,25,,14,9,23
095 Stilfs,26,,13,13,26
095 Stilfs,27,,11,15,26
095 Stilfs,28,,11,14,25
095 Stilfs,29,,13,11,24
095 Stilfs,30,,11,9,20
095 Stilfs,31,,15,9,24
095 Stilfs,32,,13,13,26
095 Stilfs,33,,13,5,18
095 Stilfs,34,,9,5,14
095 Stilfs,35,,10,14,24
095 Stilfs,36,,12,4,16
095 Stilfs,37,,10,7,17
095 Stilfs,38,,10,8,18
095 Stilfs,39,,6,12,18
095 Stilfs,40,,11,6,17
095 Stilfs,41,,5,12,17
095 Stilfs,42,,6,4,10
095 Stilfs,43,,14,9,23
095 Stilfs,44,,11,4,15
095 Stilfs,45,,11,5,16
095 Stilfs,46,,14,10,24
095 Stilfs,47,,4,10,14
095 Stilfs,48,,8,3,11
095 Stilfs,49,,9,10,19
095 Stilfs,50,,5,5,10
095 Stilfs,51,,10,10,20
095 Stilfs,52,,2,4,6
095 Stilfs,53,,14,7,21
095 Stilfs,54,,9,8,17
095 Stilfs,55,,7,13,20
095 Stilfs,56,,9,4,13
095 Stilfs,57,,8,12,20
095 Stilfs,58,,6,12,18
095 Stilfs,59,,6,6,12
095 Stilfs,60,,8,7,15
095 Stilfs,61,,4,11,15
095 Stilfs,62,,3,9,12
095 Stilfs,63,,5,4,9
095 Stilfs,64,,5,6,11
095 Stilfs,65,,7,7,14
095 Stilfs,66,,5,4,9
095 Stilfs,67,,7,9,16
095 Stilfs,68,,6,1,7
095 Stilfs,69,,4,10,14
095 Stilfs,70,,6,10,16
095 Stilfs,71,,7,5,12
095 Stilfs,72,,8,3,11
095 Stilfs,73,,2,12,14
095 Stilfs,74,,5,5,10
095 Stilfs,75,,3,6,9
095 Stilfs,76,,2,6,8
095 Stilfs,77,,2,10,12
095 Stilfs,78,,4,1,5
095 Stilfs,79,,3,3,6
095 Stilfs,80,,-,3,3
095 Stilfs,81,,1,4,5
095 Stilfs,82,,1,3,4
095 Stilfs,83,,3,4,7
095 Stilfs,84,,-,1,1
095 Stilfs,85,,1,5,6
095 Stilfs,86,,1,4,5
095 Stilfs,87,,1,4,5
095 Stilfs,88,,2,3,5
095 Stilfs,89,,-,2,2
095 Stilfs,90,,1,2,3
095 Stilfs,91,,-,2,2
095 Stilfs,98,,1,-,1
095 Stilfs,Insgesamt,,683,656,1.339
096 Terenten,0,,6,10,16
096 Terenten,1,,11,10,21
096 Terenten,2,,10,8,18
096 Terenten,3,,14,16,30
096 Terenten,4,,7,14,21
096 Terenten,5,,10,9,19
096 Terenten,6,,7,16,23
096 Terenten,7,,14,18,32
096 Terenten,8,,14,7,21
096 Terenten,9,,10,8,18
096 Terenten,10,,17,6,23
096 Terenten,11,,10,10,20
096 Terenten,12,,11,14,25
096 Terenten,13,,13,12,25
096 Terenten,14,,13,16,29
096 Terenten,15,,12,9,21
096 Terenten,16,,13,6,19
096 Terenten,17,,11,13,24
096 Terenten,18,,10,10,20
096 Terenten,19,,16,15,31
096 Terenten,20,,11,10,21
096 Terenten,21,,17,10,27
096 Terenten,22,,17,9,26
096 Terenten,23,,16,12,28
096 Terenten,24,,4,17,21
096 Terenten,25,,17,10,27
096 Terenten,26,,14,13,27
096 Terenten,27,,22,14,36
096 Terenten,28,,15,13,28
096 Terenten,29,,11,16,27
096 Terenten,30,,14,16,30
096 Terenten,31,,13,15,28
096 Terenten,32,,16,10,26
096 Terenten,33,,15,16,31
096 Terenten,34,,24,14,38
096 Terenten,35,,20,12,32
096 Terenten,36,,11,15,26
096 Terenten,37,,11,9,20
096 Terenten,38,,13,11,24
096 Terenten,39,,13,8,21
096 Terenten,40,,13,8,21
096 Terenten,41,,11,12,23
096 Terenten,42,,12,10,22
096 Terenten,43,,16,11,27
096 Terenten,44,,8,6,14
096 Terenten,45,,7,7,14
096 Terenten,46,,5,6,11
096 Terenten,47,,10,7,17
096 Terenten,48,,10,4,14
096 Terenten,49,,10,8,18
096 Terenten,50,,7,3,10
096 Terenten,51,,7,4,11
096 Terenten,52,,7,3,10
096 Terenten,53,,3,6,9
096 Terenten,54,,8,4,12
096 Terenten,55,,4,5,9
096 Terenten,56,,7,4,11
096 Terenten,57,,7,5,12
096 Terenten,58,,2,6,8
096 Terenten,59,,7,9,16
096 Terenten,60,,7,5,12
096 Terenten,61,,5,9,14
096 Terenten,62,,7,5,12
096 Terenten,63,,2,5,7
096 Terenten,64,,6,3,9
096 Terenten,65,,4,4,8
096 Terenten,66,,7,11,18
096 Terenten,67,,7,7,14
096 Terenten,68,,6,4,10
096 Terenten,69,,8,7,15
096 Terenten,70,,2,4,6
096 Terenten,71,,3,10,13
096 Terenten,72,,6,3,9
096 Terenten,73,,1,7,8
096 Terenten,74,,4,4,8
096 Terenten,75,,4,1,5
096 Terenten,76,,2,5,7
096 Terenten,77,,4,3,7
096 Terenten,78,,1,3,4
096 Terenten,79,,1,3,4
096 Terenten,80,,1,1,2
096 Terenten,81,,1,2,3
096 Terenten,82,,-,1,1
096 Terenten,83,,3,3,6
096 Terenten,84,,1,2,3
096 Terenten,85,,-,1,1
096 Terenten,86,,1,-,1
096 Terenten,87,,1,2,3
096 Terenten,88,,-,1,1
096 Terenten,89,,-,2,2
096 Terenten,90,,-,1,1
096 Terenten,91,,1,-,1
096 Terenten,92,,1,-,1
096 Terenten,97,,1,-,1
096 Terenten,Insgesamt,,782,724,1.506
097 Terlan,0,,24,33,57
097 Terlan,1,,16,22,38
097 Terlan,2,,28,22,50
097 Terlan,3,,18,15,33
097 Terlan,4,,20,19,39
097 Terlan,5,,25,28,53
097 Terlan,6,,24,19,43
097 Terlan,7,,11,20,31
097 Terlan,8,,23,27,50
097 Terlan,9,,21,16,37
097 Terlan,10,,23,15,38
097 Terlan,11,,17,22,39
097 Terlan,12,,26,17,43
097 Terlan,13,,11,11,22
097 Terlan,14,,24,16,40
097 Terlan,15,,21,18,39
097 Terlan,16,,16,15,31
097 Terlan,17,,25,23,48
097 Terlan,18,,15,26,41
097 Terlan,19,,14,16,30
097 Terlan,20,,25,19,44
097 Terlan,21,,28,24,52
097 Terlan,22,,22,13,35
097 Terlan,23,,26,28,54
097 Terlan,24,,19,23,42
097 Terlan,25,,39,18,57
097 Terlan,26,,25,26,51
097 Terlan,27,,28,34,62
097 Terlan,28,,34,27,61
097 Terlan,29,,34,31,65
097 Terlan,30,,28,30,58
097 Terlan,31,,35,22,57
097 Terlan,32,,27,28,55
097 Terlan,33,,29,30,59
097 Terlan,34,,27,30,57
097 Terlan,35,,29,34,63
097 Terlan,36,,42,22,64
097 Terlan,37,,25,30,55
097 Terlan,38,,20,22,42
097 Terlan,39,,30,28,58
097 Terlan,40,,17,29,46
097 Terlan,41,,26,29,55
097 Terlan,42,,21,24,45
097 Terlan,43,,24,19,43
097 Terlan,44,,16,23,39
097 Terlan,45,,21,22,43
097 Terlan,46,,20,19,39
097 Terlan,47,,22,22,44
097 Terlan,48,,21,15,36
097 Terlan,49,,22,23,45
097 Terlan,50,,14,19,33
097 Terlan,51,,17,25,42
097 Terlan,52,,21,21,42
097 Terlan,53,,23,25,48
097 Terlan,54,,19,29,48
097 Terlan,55,,36,19,55
097 Terlan,56,,18,26,44
097 Terlan,57,,21,15,36
097 Terlan,58,,17,20,37
097 Terlan,59,,22,18,40
097 Terlan,60,,15,18,33
097 Terlan,61,,10,14,24
097 Terlan,62,,16,24,40
097 Terlan,63,,7,24,31
097 Terlan,64,,16,16,32
097 Terlan,65,,17,11,28
097 Terlan,66,,23,15,38
097 Terlan,67,,16,16,32
097 Terlan,68,,14,15,29
097 Terlan,69,,15,13,28
097 Terlan,70,,13,13,26
097 Terlan,71,,13,24,37
097 Terlan,72,,12,14,26
097 Terlan,73,,9,15,24
097 Terlan,74,,8,24,32
097 Terlan,75,,10,13,23
097 Terlan,76,,9,15,24
097 Terlan,77,,2,9,11
097 Terlan,78,,-,10,10
097 Terlan,79,,6,3,9
097 Terlan,80,,1,4,5
097 Terlan,81,,-,6,6
097 Terlan,82,,3,6,9
097 Terlan,83,,-,11,11
097 Terlan,84,,6,10,16
097 Terlan,85,,2,7,9
097 Terlan,86,,2,12,14
097 Terlan,87,,2,5,7
097 Terlan,88,,4,3,7
097 Terlan,89,,1,2,3
097 Terlan,90,,-,4,4
097 Terlan,91,,1,1,2
097 Terlan,92,,1,1,2
097 Terlan,93,,1,1,2
097 Terlan,Insgesamt,,1.647,1.740,3.387
098 Tramin a.d. Weinstr.,0,,28,20,48
098 Tramin a.d. Weinstr.,1,,22,29,51
098 Tramin a.d. Weinstr.,2,,18,21,39
098 Tramin a.d. Weinstr.,3,,21,25,46
098 Tramin a.d. Weinstr.,4,,17,15,32
098 Tramin a.d. Weinstr.,5,,20,26,46
098 Tramin a.d. Weinstr.,6,,18,11,29
098 Tramin a.d. Weinstr.,7,,26,21,47
098 Tramin a.d. Weinstr.,8,,11,31,42
098 Tramin a.d. Weinstr.,9,,12,25,37
098 Tramin a.d. Weinstr.,10,,18,24,42
098 Tramin a.d. Weinstr.,11,,10,16,26
098 Tramin a.d. Weinstr.,12,,19,22,41
098 Tramin a.d. Weinstr.,13,,20,16,36
098 Tramin a.d. Weinstr.,14,,15,14,29
098 Tramin a.d. Weinstr.,15,,25,17,42
098 Tramin a.d. Weinstr.,16,,29,19,48
098 Tramin a.d. Weinstr.,17,,19,13,32
098 Tramin a.d. Weinstr.,18,,14,15,29
098 Tramin a.d. Weinstr.,19,,11,18,29
098 Tramin a.d. Weinstr.,20,,17,21,38
098 Tramin a.d. Weinstr.,21,,21,18,39
098 Tramin a.d. Weinstr.,22,,20,16,36
098 Tramin a.d. Weinstr.,23,,21,13,34
098 Tramin a.d. Weinstr.,24,,19,16,35
098 Tramin a.d. Weinstr.,25,,16,24,40
098 Tramin a.d. Weinstr.,26,,26,33,59
098 Tramin a.d. Weinstr.,27,,24,23,47
098 Tramin a.d. Weinstr.,28,,31,27,58
098 Tramin a.d. Weinstr.,29,,26,26,52
098 Tramin a.d. Weinstr.,30,,23,29,52
098 Tramin a.d. Weinstr.,31,,29,29,58
098 Tramin a.d. Weinstr.,32,,32,29,61
098 Tramin a.d. Weinstr.,33,,25,27,52
098 Tramin a.d. Weinstr.,34,,26,30,56
098 Tramin a.d. Weinstr.,35,,22,15,37
098 Tramin a.d. Weinstr.,36,,35,26,61
098 Tramin a.d. Weinstr.,37,,31,32,63
098 Tramin a.d. Weinstr.,38,,20,32,52
098 Tramin a.d. Weinstr.,39,,24,23,47
098 Tramin a.d. Weinstr.,40,,18,18,36
098 Tramin a.d. Weinstr.,41,,23,19,42
098 Tramin a.d. Weinstr.,42,,17,19,36
098 Tramin a.d. Weinstr.,43,,17,17,34
098 Tramin a.d. Weinstr.,44,,17,14,31
098 Tramin a.d. Weinstr.,45,,20,18,38
098 Tramin a.d. Weinstr.,46,,9,14,23
098 Tramin a.d. Weinstr.,47,,17,17,34
098 Tramin a.d. Weinstr.,48,,16,15,31
098 Tramin a.d. Weinstr.,49,,18,18,36
098 Tramin a.d. Weinstr.,50,,14,23,37
098 Tramin a.d. Weinstr.,51,,29,18,47
098 Tramin a.d. Weinstr.,52,,9,9,18
098 Tramin a.d. Weinstr.,53,,24,23,47
098 Tramin a.d. Weinstr.,54,,19,21,40
098 Tramin a.d. Weinstr.,55,,21,19,40
098 Tramin a.d. Weinstr.,56,,13,24,37
098 Tramin a.d. Weinstr.,57,,21,17,38
098 Tramin a.d. Weinstr.,58,,14,14,28
098 Tramin a.d. Weinstr.,59,,10,21,31
098 Tramin a.d. Weinstr.,60,,15,13,28
098 Tramin a.d. Weinstr.,61,,14,15,29
098 Tramin a.d. Weinstr.,62,,16,15,31
098 Tramin a.d. Weinstr.,63,,13,13,26
098 Tramin a.d. Weinstr.,64,,11,16,27
098 Tramin a.d. Weinstr.,65,,13,20,33
098 Tramin a.d. Weinstr.,66,,10,21,31
098 Tramin a.d. Weinstr.,67,,25,17,42
098 Tramin a.d. Weinstr.,68,,14,15,29
098 Tramin a.d. Weinstr.,69,,18,18,36
098 Tramin a.d. Weinstr.,70,,19,16,35
098 Tramin a.d. Weinstr.,71,,19,20,39
098 Tramin a.d. Weinstr.,72,,13,23,36
098 Tramin a.d. Weinstr.,73,,7,15,22
098 Tramin a.d. Weinstr.,74,,11,19,30
098 Tramin a.d. Weinstr.,75,,8,17,25
098 Tramin a.d. Weinstr.,76,,16,13,29
098 Tramin a.d. Weinstr.,77,,7,18,25
098 Tramin a.d. Weinstr.,78,,5,14,19
098 Tramin a.d. Weinstr.,79,,4,3,7
098 Tramin a.d. Weinstr.,80,,1,7,8
098 Tramin a.d. Weinstr.,81,,3,3,6
098 Tramin a.d. Weinstr.,82,,2,6,8
098 Tramin a.d. Weinstr.,83,,8,10,18
098 Tramin a.d. Weinstr.,84,,4,3,7
098 Tramin a.d. Weinstr.,85,,3,5,8
098 Tramin a.d. Weinstr.,86,,-,11,11
098 Tramin a.d. Weinstr.,87,,3,8,11
098 Tramin a.d. Weinstr.,88,,-,4,4
098 Tramin a.d. Weinstr.,89,,2,6,8
098 Tramin a.d. Weinstr.,90,,-,7,7
098 Tramin a.d. Weinstr.,91,,-,2,2
098 Tramin a.d. Weinstr.,92,,-,1,1
098 Tramin a.d. Weinstr.,93,,-,5,5
098 Tramin a.d. Weinstr.,96,,-,1,1
098 Tramin a.d. Weinstr.,97,,-,2,2
098 Tramin a.d. Weinstr.,Insgesamt,,1.491,1.647,3.138
099 Tisens,0,,4,4,8
099 Tisens,1,,9,8,17
099 Tisens,2,,10,4,14
099 Tisens,3,,10,12,22
099 Tisens,4,,5,9,14
099 Tisens,5,,5,16,21
099 Tisens,6,,16,8,24
099 Tisens,7,,10,14,24
099 Tisens,8,,12,9,21
099 Tisens,9,,7,12,19
099 Tisens,10,,13,8,21
099 Tisens,11,,15,7,22
099 Tisens,12,,8,6,14
099 Tisens,13,,13,12,25
099 Tisens,14,,18,5,23
099 Tisens,15,,10,14,24
099 Tisens,16,,4,18,22
099 Tisens,17,,14,12,26
099 Tisens,18,,9,7,16
099 Tisens,19,,12,11,23
099 Tisens,20,,12,7,19
099 Tisens,21,,9,4,13
099 Tisens,22,,16,14,30
099 Tisens,23,,8,9,17
099 Tisens,24,,10,11,21
099 Tisens,25,,6,10,16
099 Tisens,26,,15,15,30
099 Tisens,27,,18,14,32
099 Tisens,28,,16,14,30
099 Tisens,29,,17,17,34
099 Tisens,30,,16,19,35
099 Tisens,31,,19,12,31
099 Tisens,32,,18,24,42
099 Tisens,33,,16,5,21
099 Tisens,34,,17,14,31
099 Tisens,35,,22,5,27
099 Tisens,36,,15,12,27
099 Tisens,37,,17,7,24
099 Tisens,38,,13,10,23
099 Tisens,39,,9,12,21
099 Tisens,40,,17,20,37
099 Tisens,41,,9,12,21
099 Tisens,42,,17,9,26
099 Tisens,43,,8,8,16
099 Tisens,44,,13,9,22
099 Tisens,45,,7,12,19
099 Tisens,46,,10,10,20
099 Tisens,47,,9,7,16
099 Tisens,48,,5,7,12
099 Tisens,49,,13,9,22
099 Tisens,50,,7,8,15
099 Tisens,51,,8,7,15
099 Tisens,52,,4,7,11
099 Tisens,53,,10,10,20
099 Tisens,54,,12,10,22
099 Tisens,55,,9,8,17
099 Tisens,56,,8,14,22
099 Tisens,57,,6,8,14
099 Tisens,58,,13,10,23
099 Tisens,59,,7,12,19
099 Tisens,60,,5,5,10
099 Tisens,61,,7,8,15
099 Tisens,62,,5,11,16
099 Tisens,63,,9,7,16
099 Tisens,64,,2,12,14
099 Tisens,65,,9,10,19
099 Tisens,66,,8,9,17
099 Tisens,67,,5,15,20
099 Tisens,68,,10,11,21
099 Tisens,69,,13,13,26
099 Tisens,70,,15,10,25
099 Tisens,71,,6,9,15
099 Tisens,72,,5,6,11
099 Tisens,73,,3,6,9
099 Tisens,74,,4,12,16
099 Tisens,75,,7,6,13
099 Tisens,76,,7,7,14
099 Tisens,77,,5,8,13
099 Tisens,78,,3,9,12
099 Tisens,79,,4,6,10
099 Tisens,80,,3,5,8
099 Tisens,81,,1,4,5
099 Tisens,82,,2,4,6
099 Tisens,83,,1,6,7
099 Tisens,84,,4,4,8
099 Tisens,85,,3,5,8
099 Tisens,86,,3,3,6
099 Tisens,87,,1,5,6
099 Tisens,89,,-,4,4
099 Tisens,90,,1,2,3
099 Tisens,91,,1,-,1
099 Tisens,92,,-,3,3
099 Tisens,94,,-,1,1
099 Tisens,96,,-,1,1
099 Tisens,97,,1,-,1
099 Tisens,Insgesamt,,838,855,1.693
100 Tiers,0,,5,8,13
100 Tiers,1,,7,4,11
100 Tiers,2,,6,11,17
100 Tiers,3,,5,6,11
100 Tiers,4,,5,-,5
100 Tiers,5,,6,3,9
100 Tiers,6,,4,2,6
100 Tiers,7,,6,4,10
100 Tiers,8,,4,6,10
100 Tiers,9,,6,8,14
100 Tiers,10,,5,4,9
100 Tiers,11,,9,5,14
100 Tiers,12,,5,6,11
100 Tiers,13,,3,8,11
100 Tiers,14,,7,6,13
100 Tiers,15,,6,6,12
100 Tiers,16,,5,4,9
100 Tiers,17,,2,4,6
100 Tiers,18,,1,9,10
100 Tiers,19,,8,7,15
100 Tiers,20,,6,3,9
100 Tiers,21,,-,3,3
100 Tiers,22,,7,4,11
100 Tiers,23,,4,4,8
100 Tiers,24,,7,7,14
100 Tiers,25,,11,8,19
100 Tiers,26,,5,7,12
100 Tiers,27,,6,10,16
100 Tiers,28,,12,9,21
100 Tiers,29,,5,6,11
100 Tiers,30,,9,11,20
100 Tiers,31,,11,6,17
100 Tiers,32,,6,7,13
100 Tiers,33,,9,2,11
100 Tiers,34,,6,11,17
100 Tiers,35,,4,7,11
100 Tiers,36,,6,4,10
100 Tiers,37,,3,6,9
100 Tiers,38,,11,4,15
100 Tiers,39,,7,4,11
100 Tiers,40,,5,7,12
100 Tiers,41,,11,7,18
100 Tiers,42,,5,3,8
100 Tiers,43,,8,5,13
100 Tiers,44,,6,4,10
100 Tiers,45,,3,4,7
100 Tiers,46,,1,3,4
100 Tiers,47,,6,5,11
100 Tiers,48,,2,5,7
100 Tiers,49,,5,5,10
100 Tiers,50,,1,2,3
100 Tiers,51,,5,4,9
100 Tiers,52,,10,3,13
100 Tiers,53,,-,5,5
100 Tiers,54,,8,10,18
100 Tiers,55,,2,5,7
100 Tiers,56,,5,7,12
100 Tiers,57,,2,3,5
100 Tiers,58,,5,7,12
100 Tiers,59,,6,5,11
100 Tiers,60,,7,5,12
100 Tiers,61,,4,7,11
100 Tiers,62,,7,2,9
100 Tiers,63,,2,5,7
100 Tiers,64,,7,3,10
100 Tiers,65,,4,5,9
100 Tiers,66,,7,3,10
100 Tiers,67,,5,1,6
100 Tiers,68,,3,3,6
100 Tiers,69,,4,3,7
100 Tiers,70,,4,4,8
100 Tiers,71,,4,2,6
100 Tiers,72,,5,6,11
100 Tiers,73,,3,7,10
100 Tiers,74,,3,3,6
100 Tiers,75,,3,2,5
100 Tiers,76,,1,10,11
100 Tiers,77,,2,4,6
100 Tiers,78,,3,2,5
100 Tiers,79,,1,1,2
100 Tiers,80,,3,2,5
100 Tiers,82,,1,2,3
100 Tiers,83,,2,1,3
100 Tiers,84,,2,2,4
100 Tiers,85,,1,2,3
100 Tiers,86,,1,2,3
100 Tiers,87,,3,2,5
100 Tiers,88,,1,1,2
100 Tiers,89,,1,1,2
100 Tiers,90,,-,1,1
100 Tiers,94,,1,-,1
100 Tiers,95,,-,1,1
100 Tiers,Insgesamt,,431,428,859
101 Tirol,0,,20,18,38
101 Tirol,1,,23,19,42
101 Tirol,2,,11,17,28
101 Tirol,3,,14,16,30
101 Tirol,4,,23,8,31
101 Tirol,5,,12,13,25
101 Tirol,6,,8,9,17
101 Tirol,7,,15,11,26
101 Tirol,8,,10,19,29
101 Tirol,9,,10,17,27
101 Tirol,10,,16,9,25
101 Tirol,11,,10,12,22
101 Tirol,12,,11,16,27
101 Tirol,13,,16,11,27
101 Tirol,14,,18,15,33
101 Tirol,15,,13,13,26
101 Tirol,16,,17,23,40
101 Tirol,17,,19,9,28
101 Tirol,18,,20,7,27
101 Tirol,19,,11,14,25
101 Tirol,20,,15,18,33
101 Tirol,21,,17,11,28
101 Tirol,22,,19,24,43
101 Tirol,23,,15,24,39
101 Tirol,24,,21,20,41
101 Tirol,25,,24,18,42
101 Tirol,26,,24,13,37
101 Tirol,27,,17,13,30
101 Tirol,28,,22,22,44
101 Tirol,29,,23,23,46
101 Tirol,30,,23,25,48
101 Tirol,31,,21,20,41
101 Tirol,32,,24,22,46
101 Tirol,33,,28,21,49
101 Tirol,34,,24,13,37
101 Tirol,35,,24,17,41
101 Tirol,36,,17,25,42
101 Tirol,37,,25,13,38
101 Tirol,38,,16,10,26
101 Tirol,39,,17,18,35
101 Tirol,40,,22,17,39
101 Tirol,41,,10,16,26
101 Tirol,42,,13,14,27
101 Tirol,43,,14,15,29
101 Tirol,44,,19,19,38
101 Tirol,45,,14,10,24
101 Tirol,46,,14,18,32
101 Tirol,47,,16,13,29
101 Tirol,48,,22,17,39
101 Tirol,49,,20,15,35
101 Tirol,50,,9,17,26
101 Tirol,51,,14,9,23
101 Tirol,52,,13,14,27
101 Tirol,53,,19,18,37
101 Tirol,54,,12,12,24
101 Tirol,55,,12,22,34
101 Tirol,56,,15,19,34
101 Tirol,57,,11,15,26
101 Tirol,58,,16,15,31
101 Tirol,59,,9,9,18
101 Tirol,60,,11,15,26
101 Tirol,61,,8,12,20
101 Tirol,62,,13,12,25
101 Tirol,63,,15,6,21
101 Tirol,64,,8,13,21
101 Tirol,65,,7,10,17
101 Tirol,66,,8,8,16
101 Tirol,67,,7,9,16
101 Tirol,68,,13,15,28
101 Tirol,69,,10,9,19
101 Tirol,70,,11,8,19
101 Tirol,71,,6,13,19
101 Tirol,72,,6,10,16
101 Tirol,73,,9,12,21
101 Tirol,74,,5,6,11
101 Tirol,75,,5,7,12
101 Tirol,76,,8,10,18
101 Tirol,77,,4,9,13
101 Tirol,78,,3,6,9
101 Tirol,79,,2,6,8
101 Tirol,80,,2,1,3
101 Tirol,81,,2,6,8
101 Tirol,82,,3,6,9
101 Tirol,83,,4,8,12
101 Tirol,84,,4,7,11
101 Tirol,85,,1,3,4
101 Tirol,86,,3,7,10
101 Tirol,87,,2,4,6
101 Tirol,88,,1,6,7
101 Tirol,89,,1,3,4
101 Tirol,90,,1,2,3
101 Tirol,91,,2,1,3
101 Tirol,92,,-,1,1
101 Tirol,93,,1,-,1
101 Tirol,Insgesamt,,1.193,1.201,2.394
102 Truden im Naturpark,0,,4,5,9
102 Truden im Naturpark,1,,5,6,11
102 Truden im Naturpark,2,,4,4,8
102 Truden im Naturpark,3,,5,6,11
102 Truden im Naturpark,4,,8,3,11
102 Truden im Naturpark,5,,8,5,13
102 Truden im Naturpark,6,,6,6,12
102 Truden im Naturpark,7,,4,5,9
102 Truden im Naturpark,8,,10,6,16
102 Truden im Naturpark,9,,8,8,16
102 Truden im Naturpark,10,,6,4,10
102 Truden im Naturpark,11,,1,5,6
102 Truden im Naturpark,12,,8,6,14
102 Truden im Naturpark,13,,10,4,14
102 Truden im Naturpark,14,,6,5,11
102 Truden im Naturpark,15,,12,3,15
102 Truden im Naturpark,16,,4,8,12
102 Truden im Naturpark,17,,4,4,8
102 Truden im Naturpark,18,,7,5,12
102 Truden im Naturpark,19,,7,6,13
102 Truden im Naturpark,20,,4,5,9
102 Truden im Naturpark,21,,12,9,21
102 Truden im Naturpark,22,,8,4,12
102 Truden im Naturpark,23,,4,6,10
102 Truden im Naturpark,24,,7,9,16
102 Truden im Naturpark,25,,5,9,14
102 Truden im Naturpark,26,,3,6,9
102 Truden im Naturpark,27,,2,5,7
102 Truden im Naturpark,28,,8,10,18
102 Truden im Naturpark,29,,8,11,19
102 Truden im Naturpark,30,,11,8,19
102 Truden im Naturpark,31,,6,6,12
102 Truden im Naturpark,32,,6,6,12
102 Truden im Naturpark,33,,9,5,14
102 Truden im Naturpark,34,,10,7,17
102 Truden im Naturpark,35,,6,7,13
102 Truden im Naturpark,36,,7,6,13
102 Truden im Naturpark,37,,10,12,22
102 Truden im Naturpark,38,,7,9,16
102 Truden im Naturpark,39,,5,8,13
102 Truden im Naturpark,40,,6,10,16
102 Truden im Naturpark,41,,7,5,12
102 Truden im Naturpark,42,,7,11,18
102 Truden im Naturpark,43,,7,5,12
102 Truden im Naturpark,44,,9,5,14
102 Truden im Naturpark,45,,7,7,14
102 Truden im Naturpark,46,,9,6,15
102 Truden im Naturpark,47,,2,2,4
102 Truden im Naturpark,48,,5,3,8
102 Truden im Naturpark,49,,2,7,9
102 Truden im Naturpark,50,,6,1,7
102 Truden im Naturpark,51,,8,6,14
102 Truden im Naturpark,52,,4,2,6
102 Truden im Naturpark,53,,4,5,9
102 Truden im Naturpark,54,,5,4,9
102 Truden im Naturpark,55,,6,3,9
102 Truden im Naturpark,56,,5,6,11
102 Truden im Naturpark,57,,3,4,7
102 Truden im Naturpark,58,,8,3,11
102 Truden im Naturpark,59,,7,7,14
102 Truden im Naturpark,60,,3,4,7
102 Truden im Naturpark,61,,5,4,9
102 Truden im Naturpark,62,,4,3,7
102 Truden im Naturpark,63,,5,1,6
102 Truden im Naturpark,64,,7,7,14
102 Truden im Naturpark,65,,4,4,8
102 Truden im Naturpark,66,,7,4,11
102 Truden im Naturpark,67,,5,10,15
102 Truden im Naturpark,68,,-,7,7
102 Truden im Naturpark,69,,3,6,9
102 Truden im Naturpark,70,,7,6,13
102 Truden im Naturpark,71,,2,8,10
102 Truden im Naturpark,72,,2,8,10
102 Truden im Naturpark,73,,-,8,8
102 Truden im Naturpark,74,,4,7,11
102 Truden im Naturpark,75,,6,4,10
102 Truden im Naturpark,76,,3,7,10
102 Truden im Naturpark,77,,-,9,9
102 Truden im Naturpark,78,,1,3,4
102 Truden im Naturpark,79,,1,2,3
102 Truden im Naturpark,80,,1,1,2
102 Truden im Naturpark,82,,2,1,3
102 Truden im Naturpark,83,,-,5,5
102 Truden im Naturpark,84,,-,1,1
102 Truden im Naturpark,85,,1,1,2
102 Truden im Naturpark,86,,-,2,2
102 Truden im Naturpark,87,,1,2,3
102 Truden im Naturpark,88,,-,2,2
102 Truden im Naturpark,91,,1,3,4
102 Truden im Naturpark,95,,-,1,1
102 Truden im Naturpark,Insgesamt,,457,485,942
103 Taufers im Münstertal,0,,2,5,7
103 Taufers im Münstertal,1,,7,5,12
103 Taufers im Münstertal,2,,9,10,19
103 Taufers im Münstertal,3,,5,10,15
103 Taufers im Münstertal,4,,4,5,9
103 Taufers im Münstertal,5,,10,9,19
103 Taufers im Münstertal,6,,7,13,20
103 Taufers im Münstertal,7,,7,7,14
103 Taufers im Münstertal,8,,6,3,9
103 Taufers im Münstertal,9,,6,7,13
103 Taufers im Münstertal,10,,4,6,10
103 Taufers im Münstertal,11,,4,4,8
103 Taufers im Münstertal,12,,4,3,7
103 Taufers im Münstertal,13,,5,7,12
103 Taufers im Münstertal,14,,5,6,11
103 Taufers im Münstertal,15,,5,11,16
103 Taufers im Münstertal,16,,9,2,11
103 Taufers im Münstertal,17,,8,5,13
103 Taufers im Münstertal,18,,6,2,8
103 Taufers im Münstertal,19,,7,5,12
103 Taufers im Münstertal,20,,6,5,11
103 Taufers im Münstertal,21,,2,4,6
103 Taufers im Münstertal,22,,10,1,11
103 Taufers im Münstertal,23,,6,7,13
103 Taufers im Münstertal,24,,4,6,10
103 Taufers im Münstertal,25,,7,7,14
103 Taufers im Münstertal,26,,10,14,24
103 Taufers im Münstertal,27,,9,7,16
103 Taufers im Münstertal,28,,10,11,21
103 Taufers im Münstertal,29,,10,8,18
103 Taufers im Münstertal,30,,5,6,11
103 Taufers im Münstertal,31,,10,10,20
103 Taufers im Münstertal,32,,18,9,27
103 Taufers im Münstertal,33,,8,13,21
103 Taufers im Münstertal,34,,13,10,23
103 Taufers im Münstertal,35,,11,10,21
103 Taufers im Münstertal,36,,9,7,16
103 Taufers im Münstertal,37,,14,7,21
103 Taufers im Münstertal,38,,6,9,15
103 Taufers im Münstertal,39,,5,6,11
103 Taufers im Münstertal,40,,10,6,16
103 Taufers im Münstertal,41,,11,10,21
103 Taufers im Münstertal,42,,3,3,6
103 Taufers im Münstertal,43,,3,7,10
103 Taufers im Münstertal,44,,6,3,9
103 Taufers im Münstertal,45,,6,2,8
103 Taufers im Münstertal,46,,5,4,9
103 Taufers im Münstertal,47,,7,1,8
103 Taufers im Münstertal,48,,6,1,7
103 Taufers im Münstertal,49,,6,1,7
103 Taufers im Münstertal,50,,3,7,10
103 Taufers im Münstertal,51,,4,3,7
103 Taufers im Münstertal,52,,3,3,6
103 Taufers im Münstertal,53,,1,-,1
103 Taufers im Münstertal,54,,7,5,12
103 Taufers im Münstertal,55,,5,5,10
103 Taufers im Münstertal,56,,4,6,10
103 Taufers im Münstertal,57,,4,3,7
103 Taufers im Münstertal,58,,4,4,8
103 Taufers im Münstertal,59,,8,10,18
103 Taufers im Münstertal,60,,4,5,9
103 Taufers im Münstertal,61,,2,8,10
103 Taufers im Münstertal,62,,7,2,9
103 Taufers im Münstertal,63,,3,8,11
103 Taufers im Münstertal,64,,6,5,11
103 Taufers im Münstertal,65,,6,3,9
103 Taufers im Münstertal,66,,9,3,12
103 Taufers im Münstertal,67,,4,4,8
103 Taufers im Münstertal,68,,4,6,10
103 Taufers im Münstertal,69,,5,5,10
103 Taufers im Münstertal,70,,3,3,6
103 Taufers im Münstertal,71,,4,6,10
103 Taufers im Münstertal,72,,1,7,8
103 Taufers im Münstertal,73,,2,7,9
103 Taufers im Münstertal,74,,4,6,10
103 Taufers im Münstertal,75,,3,3,6
103 Taufers im Münstertal,76,,5,-,5
103 Taufers im Münstertal,77,,4,3,7
103 Taufers im Münstertal,78,,2,4,6
103 Taufers im Münstertal,79,,-,1,1
103 Taufers im Münstertal,80,,2,5,7
103 Taufers im Münstertal,81,,1,1,2
103 Taufers im Münstertal,82,,2,2,4
103 Taufers im Münstertal,83,,1,-,1
103 Taufers im Münstertal,84,,-,3,3
103 Taufers im Münstertal,85,,-,2,2
103 Taufers im Münstertal,86,,1,-,1
103 Taufers im Münstertal,87,,1,1,2
103 Taufers im Münstertal,88,,-,2,2
103 Taufers im Münstertal,89,,-,5,5
103 Taufers im Münstertal,90,,-,1,1
103 Taufers im Münstertal,93,,-,2,2
103 Taufers im Münstertal,96,,-,1,1
103 Taufers im Münstertal,Insgesamt,,485,480,965
104 Ulten,0,,15,21,36
104 Ulten,1,,11,12,23
104 Ulten,2,,12,18,30
104 Ulten,3,,19,15,34
104 Ulten,4,,24,15,39
104 Ulten,5,,17,17,34
104 Ulten,6,,25,29,54
104 Ulten,7,,17,18,35
104 Ulten,8,,18,28,46
104 Ulten,9,,18,18,36
104 Ulten,10,,20,18,38
104 Ulten,11,,22,13,35
104 Ulten,12,,14,16,30
104 Ulten,13,,22,20,42
104 Ulten,14,,22,21,43
104 Ulten,15,,15,27,42
104 Ulten,16,,19,18,37
104 Ulten,17,,22,21,43
104 Ulten,18,,18,20,38
104 Ulten,19,,22,16,38
104 Ulten,20,,24,13,37
104 Ulten,21,,17,24,41
104 Ulten,22,,26,26,52
104 Ulten,23,,21,30,51
104 Ulten,24,,29,21,50
104 Ulten,25,,27,27,54
104 Ulten,26,,28,22,50
104 Ulten,27,,26,32,58
104 Ulten,28,,30,20,50
104 Ulten,29,,30,26,56
104 Ulten,30,,15,26,41
104 Ulten,31,,20,18,38
104 Ulten,32,,28,24,52
104 Ulten,33,,28,21,49
104 Ulten,34,,28,25,53
104 Ulten,35,,33,24,57
104 Ulten,36,,31,19,50
104 Ulten,37,,30,20,50
104 Ulten,38,,23,22,45
104 Ulten,39,,28,16,44
104 Ulten,40,,37,24,61
104 Ulten,41,,18,14,32
104 Ulten,42,,14,12,26
104 Ulten,43,,20,18,38
104 Ulten,44,,25,14,39
104 Ulten,45,,17,14,31
104 Ulten,46,,19,18,37
104 Ulten,47,,21,14,35
104 Ulten,48,,17,11,28
104 Ulten,49,,15,13,28
104 Ulten,50,,18,8,26
104 Ulten,51,,17,15,32
104 Ulten,52,,10,12,22
104 Ulten,53,,14,22,36
104 Ulten,54,,17,15,32
104 Ulten,55,,12,19,31
104 Ulten,56,,16,13,29
104 Ulten,57,,18,10,28
104 Ulten,58,,22,16,38
104 Ulten,59,,8,11,19
104 Ulten,60,,11,11,22
104 Ulten,61,,9,11,20
104 Ulten,62,,12,13,25
104 Ulten,63,,12,14,26
104 Ulten,64,,6,13,19
104 Ulten,65,,15,8,23
104 Ulten,66,,11,10,21
104 Ulten,67,,15,18,33
104 Ulten,68,,8,16,24
104 Ulten,69,,11,17,28
104 Ulten,70,,15,19,34
104 Ulten,71,,10,15,25
104 Ulten,72,,17,17,34
104 Ulten,73,,13,12,25
104 Ulten,74,,14,26,40
104 Ulten,75,,12,13,25
104 Ulten,76,,12,16,28
104 Ulten,77,,11,16,27
104 Ulten,78,,5,14,19
104 Ulten,79,,3,5,8
104 Ulten,80,,1,3,4
104 Ulten,81,,1,5,6
104 Ulten,82,,4,1,5
104 Ulten,83,,4,10,14
104 Ulten,84,,6,9,15
104 Ulten,85,,5,9,14
104 Ulten,86,,3,9,12
104 Ulten,87,,4,8,12
104 Ulten,88,,3,6,9
104 Ulten,89,,3,3,6
104 Ulten,90,,1,2,3
104 Ulten,91,,2,2,4
104 Ulten,92,,1,1,2
104 Ulten,98,,-,1,1
104 Ulten,99,,-,1,1
104 Ulten,Insgesamt,,1.509,1.484,2.993
105 Pfatten,0,,4,1,5
105 Pfatten,1,,8,5,13
105 Pfatten,2,,4,3,7
105 Pfatten,3,,11,11,22
105 Pfatten,4,,3,4,7
105 Pfatten,5,,6,5,11
105 Pfatten,6,,6,6,12
105 Pfatten,7,,8,8,16
105 Pfatten,8,,5,7,12
105 Pfatten,9,,3,6,9
105 Pfatten,10,,5,4,9
105 Pfatten,11,,6,7,13
105 Pfatten,12,,5,5,10
105 Pfatten,13,,3,5,8
105 Pfatten,14,,5,4,9
105 Pfatten,15,,5,2,7
105 Pfatten,16,,7,3,10
105 Pfatten,17,,1,5,6
105 Pfatten,18,,2,5,7
105 Pfatten,19,,5,5,10
105 Pfatten,20,,3,4,7
105 Pfatten,21,,9,3,12
105 Pfatten,22,,5,3,8
105 Pfatten,23,,8,6,14
105 Pfatten,24,,6,4,10
105 Pfatten,25,,4,8,12
105 Pfatten,26,,6,7,13
105 Pfatten,27,,8,8,16
105 Pfatten,28,,5,6,11
105 Pfatten,29,,4,9,13
105 Pfatten,30,,14,5,19
105 Pfatten,31,,10,6,16
105 Pfatten,32,,12,9,21
105 Pfatten,33,,9,8,17
105 Pfatten,34,,9,11,20
105 Pfatten,35,,11,13,24
105 Pfatten,36,,9,12,21
105 Pfatten,37,,8,10,18
105 Pfatten,38,,6,15,21
105 Pfatten,39,,8,8,16
105 Pfatten,40,,15,5,20
105 Pfatten,41,,7,8,15
105 Pfatten,42,,9,4,13
105 Pfatten,43,,9,3,12
105 Pfatten,44,,9,5,14
105 Pfatten,45,,4,6,10
105 Pfatten,46,,4,4,8
105 Pfatten,47,,5,8,13
105 Pfatten,48,,4,2,6
105 Pfatten,49,,5,2,7
105 Pfatten,50,,6,9,15
105 Pfatten,51,,6,6,12
105 Pfatten,52,,5,5,10
105 Pfatten,53,,4,2,6
105 Pfatten,54,,3,2,5
105 Pfatten,55,,6,3,9
105 Pfatten,56,,5,7,12
105 Pfatten,57,,3,5,8
105 Pfatten,58,,4,1,5
105 Pfatten,59,,4,4,8
105 Pfatten,60,,6,2,8
105 Pfatten,61,,3,6,9
105 Pfatten,62,,9,2,11
105 Pfatten,63,,5,6,11
105 Pfatten,64,,2,3,5
105 Pfatten,65,,1,3,4
105 Pfatten,66,,3,4,7
105 Pfatten,67,,3,3,6
105 Pfatten,68,,-,6,6
105 Pfatten,69,,3,1,4
105 Pfatten,70,,2,2,4
105 Pfatten,71,,3,5,8
105 Pfatten,72,,4,5,9
105 Pfatten,73,,1,5,6
105 Pfatten,74,,3,2,5
105 Pfatten,75,,3,1,4
105 Pfatten,76,,1,1,2
105 Pfatten,77,,1,1,2
105 Pfatten,78,,1,-,1
105 Pfatten,79,,-,1,1
105 Pfatten,80,,1,1,2
105 Pfatten,81,,-,2,2
105 Pfatten,82,,-,3,3
105 Pfatten,83,,1,1,2
105 Pfatten,84,,3,2,5
105 Pfatten,85,,-,2,2
105 Pfatten,88,,1,1,2
105 Pfatten,90,,-,2,2
105 Pfatten,95,,-,1,1
105 Pfatten,Insgesamt,,433,421,854
106 Olang,0,,18,18,36
106 Olang,1,,25,20,45
106 Olang,2,,18,8,26
106 Olang,3,,20,12,32
106 Olang,4,,17,23,40
106 Olang,5,,13,15,28
106 Olang,6,,25,17,42
106 Olang,7,,22,25,47
106 Olang,8,,17,19,36
106 Olang,9,,15,17,32
106 Olang,10,,23,18,41
106 Olang,11,,17,17,34
106 Olang,12,,12,22,34
106 Olang,13,,21,14,35
106 Olang,14,,18,22,40
106 Olang,15,,20,23,43
106 Olang,16,,17,23,40
106 Olang,17,,22,28,50
106 Olang,18,,20,16,36
106 Olang,19,,22,16,38
106 Olang,20,,29,24,53
106 Olang,21,,19,21,40
106 Olang,22,,24,20,44
106 Olang,23,,18,24,42
106 Olang,24,,28,26,54
106 Olang,25,,23,19,42
106 Olang,26,,28,20,48
106 Olang,27,,22,24,46
106 Olang,28,,23,27,50
106 Olang,29,,25,26,51
106 Olang,30,,24,24,48
106 Olang,31,,28,22,50
106 Olang,32,,17,25,42
106 Olang,33,,17,31,48
106 Olang,34,,25,21,46
106 Olang,35,,25,14,39
106 Olang,36,,17,26,43
106 Olang,37,,22,25,47
106 Olang,38,,20,17,37
106 Olang,39,,22,13,35
106 Olang,40,,26,13,39
106 Olang,41,,14,27,41
106 Olang,42,,15,17,32
106 Olang,43,,13,19,32
106 Olang,44,,15,19,34
106 Olang,45,,19,13,32
106 Olang,46,,10,13,23
106 Olang,47,,31,16,47
106 Olang,48,,25,13,38
106 Olang,49,,19,21,40
106 Olang,50,,15,24,39
106 Olang,51,,17,14,31
106 Olang,52,,19,12,31
106 Olang,53,,18,7,25
106 Olang,54,,10,17,27
106 Olang,55,,15,15,30
106 Olang,56,,16,13,29
106 Olang,57,,18,12,30
106 Olang,58,,11,8,19
106 Olang,59,,8,14,22
106 Olang,60,,10,9,19
106 Olang,61,,10,8,18
106 Olang,62,,9,15,24
106 Olang,63,,12,9,21
106 Olang,64,,11,14,25
106 Olang,65,,10,14,24
106 Olang,66,,7,6,13
106 Olang,67,,16,9,25
106 Olang,68,,13,14,27
106 Olang,69,,7,12,19
106 Olang,70,,9,11,20
106 Olang,71,,8,13,21
106 Olang,72,,5,6,11
106 Olang,73,,5,8,13
106 Olang,74,,8,5,13
106 Olang,75,,7,6,13
106 Olang,76,,9,5,14
106 Olang,77,,6,7,13
106 Olang,78,,2,5,7
106 Olang,79,,1,4,5
106 Olang,80,,1,5,6
106 Olang,81,,1,1,2
106 Olang,82,,4,9,13
106 Olang,83,,2,8,10
106 Olang,84,,3,5,8
106 Olang,85,,2,7,9
106 Olang,86,,2,5,7
106 Olang,87,,1,4,5
106 Olang,88,,1,2,3
106 Olang,89,,1,1,2
106 Olang,90,,3,2,5
106 Olang,91,,1,1,2
106 Olang,92,,-,1,1
106 Olang,93,,-,1,1
106 Olang,94,,-,1,1
106 Olang,96,,-,1,1
106 Olang,Insgesamt,,1.359,1.363,2.722
107 Pfitsch,0,,18,12,30
107 Pfitsch,1,,7,18,25
107 Pfitsch,2,,18,12,30
107 Pfitsch,3,,18,20,38
107 Pfitsch,4,,15,9,24
107 Pfitsch,5,,15,15,30
107 Pfitsch,6,,18,15,33
107 Pfitsch,7,,17,18,35
107 Pfitsch,8,,11,20,31
107 Pfitsch,9,,15,15,30
107 Pfitsch,10,,14,17,31
107 Pfitsch,11,,16,8,24
107 Pfitsch,12,,17,10,27
107 Pfitsch,13,,25,12,37
107 Pfitsch,14,,20,21,41
107 Pfitsch,15,,29,14,43
107 Pfitsch,16,,24,18,42
107 Pfitsch,17,,20,24,44
107 Pfitsch,18,,27,21,48
107 Pfitsch,19,,24,17,41
107 Pfitsch,20,,17,24,41
107 Pfitsch,21,,23,22,45
107 Pfitsch,22,,16,19,35
107 Pfitsch,23,,14,23,37
107 Pfitsch,24,,21,13,34
107 Pfitsch,25,,14,25,39
107 Pfitsch,26,,28,24,52
107 Pfitsch,27,,26,19,45
107 Pfitsch,28,,27,23,50
107 Pfitsch,29,,23,25,48
107 Pfitsch,30,,23,20,43
107 Pfitsch,31,,29,17,46
107 Pfitsch,32,,20,17,37
107 Pfitsch,33,,13,27,40
107 Pfitsch,34,,19,19,38
107 Pfitsch,35,,26,21,47
107 Pfitsch,36,,19,18,37
107 Pfitsch,37,,19,24,43
107 Pfitsch,38,,14,20,34
107 Pfitsch,39,,25,19,44
107 Pfitsch,40,,24,22,46
107 Pfitsch,41,,17,17,34
107 Pfitsch,42,,16,16,32
107 Pfitsch,43,,23,22,45
107 Pfitsch,44,,22,14,36
107 Pfitsch,45,,21,26,47
107 Pfitsch,46,,22,13,35
107 Pfitsch,47,,23,18,41
107 Pfitsch,48,,18,20,38
107 Pfitsch,49,,9,9,18
107 Pfitsch,50,,11,13,24
107 Pfitsch,51,,16,14,30
107 Pfitsch,52,,13,12,25
107 Pfitsch,53,,13,17,30
107 Pfitsch,54,,22,11,33
107 Pfitsch,55,,25,14,39
107 Pfitsch,56,,17,19,36
107 Pfitsch,57,,13,16,29
107 Pfitsch,58,,17,9,26
107 Pfitsch,59,,5,14,19
107 Pfitsch,60,,10,10,20
107 Pfitsch,61,,10,13,23
107 Pfitsch,62,,9,8,17
107 Pfitsch,63,,12,5,17
107 Pfitsch,64,,12,13,25
107 Pfitsch,65,,4,16,20
107 Pfitsch,66,,11,14,25
107 Pfitsch,67,,9,18,27
107 Pfitsch,68,,17,12,29
107 Pfitsch,69,,7,14,21
107 Pfitsch,70,,12,14,26
107 Pfitsch,71,,9,13,22
107 Pfitsch,72,,12,10,22
107 Pfitsch,73,,7,19,26
107 Pfitsch,74,,9,14,23
107 Pfitsch,75,,10,8,18
107 Pfitsch,76,,9,8,17
107 Pfitsch,77,,1,9,10
107 Pfitsch,78,,4,9,13
107 Pfitsch,79,,-,5,5
107 Pfitsch,80,,2,5,7
107 Pfitsch,81,,1,3,4
107 Pfitsch,82,,3,7,10
107 Pfitsch,83,,-,6,6
107 Pfitsch,84,,2,5,7
107 Pfitsch,85,,2,3,5
107 Pfitsch,86,,2,4,6
107 Pfitsch,87,,3,-,3
107 Pfitsch,88,,2,3,5
107 Pfitsch,89,,-,8,8
107 Pfitsch,90,,2,1,3
107 Pfitsch,92,,-,3,3
107 Pfitsch,93,,-,1,1
107 Pfitsch,94,,-,1,1
107 Pfitsch,96,,-,1,1
107 Pfitsch,Insgesamt,,1.324,1.334,2.658
108 Ahrntal,0,,40,45,85
108 Ahrntal,1,,41,51,92
108 Ahrntal,2,,39,28,67
108 Ahrntal,3,,23,28,51
108 Ahrntal,4,,43,38,81
108 Ahrntal,5,,42,33,75
108 Ahrntal,6,,29,36,65
108 Ahrntal,7,,42,32,74
108 Ahrntal,8,,40,33,73
108 Ahrntal,9,,28,33,61
108 Ahrntal,10,,37,40,77
108 Ahrntal,11,,39,50,89
108 Ahrntal,12,,36,45,81
108 Ahrntal,13,,41,34,75
108 Ahrntal,14,,44,48,92
108 Ahrntal,15,,39,45,84
108 Ahrntal,16,,49,40,89
108 Ahrntal,17,,39,39,78
108 Ahrntal,18,,45,40,85
108 Ahrntal,19,,33,45,78
108 Ahrntal,20,,45,48,93
108 Ahrntal,21,,43,53,96
108 Ahrntal,22,,49,51,100
108 Ahrntal,23,,45,50,95
108 Ahrntal,24,,45,54,99
108 Ahrntal,25,,57,57,114
108 Ahrntal,26,,76,43,119
108 Ahrntal,27,,57,47,104
108 Ahrntal,28,,52,53,105
108 Ahrntal,29,,57,55,112
108 Ahrntal,30,,47,49,96
108 Ahrntal,31,,63,42,105
108 Ahrntal,32,,55,46,101
108 Ahrntal,33,,57,45,102
108 Ahrntal,34,,47,47,94
108 Ahrntal,35,,39,45,84
108 Ahrntal,36,,36,39,75
108 Ahrntal,37,,41,33,74
108 Ahrntal,38,,44,39,83
108 Ahrntal,39,,48,26,74
108 Ahrntal,40,,28,40,68
108 Ahrntal,41,,37,21,58
108 Ahrntal,42,,37,25,62
108 Ahrntal,43,,33,23,56
108 Ahrntal,44,,28,31,59
108 Ahrntal,45,,29,31,60
108 Ahrntal,46,,34,26,60
108 Ahrntal,47,,31,23,54
108 Ahrntal,48,,34,31,65
108 Ahrntal,49,,29,30,59
108 Ahrntal,50,,26,16,42
108 Ahrntal,51,,16,22,38
108 Ahrntal,52,,20,14,34
108 Ahrntal,53,,20,18,38
108 Ahrntal,54,,23,32,55
108 Ahrntal,55,,30,31,61
108 Ahrntal,56,,31,32,63
108 Ahrntal,57,,31,24,55
108 Ahrntal,58,,27,24,51
108 Ahrntal,59,,37,31,68
108 Ahrntal,60,,26,23,49
108 Ahrntal,61,,22,16,38
108 Ahrntal,62,,25,35,60
108 Ahrntal,63,,22,20,42
108 Ahrntal,64,,20,19,39
108 Ahrntal,65,,22,27,49
108 Ahrntal,66,,36,26,62
108 Ahrntal,67,,22,23,45
108 Ahrntal,68,,21,19,40
108 Ahrntal,69,,15,27,42
108 Ahrntal,70,,19,19,38
108 Ahrntal,71,,24,14,38
108 Ahrntal,72,,16,19,35
108 Ahrntal,73,,15,18,33
108 Ahrntal,74,,10,15,25
108 Ahrntal,75,,12,17,29
108 Ahrntal,76,,7,11,18
108 Ahrntal,77,,5,10,15
108 Ahrntal,78,,11,6,17
108 Ahrntal,79,,2,10,12
108 Ahrntal,80,,4,7,11
108 Ahrntal,81,,-,3,3
108 Ahrntal,82,,4,12,16
108 Ahrntal,83,,11,10,21
108 Ahrntal,84,,4,5,9
108 Ahrntal,85,,4,10,14
108 Ahrntal,86,,3,11,14
108 Ahrntal,87,,5,6,11
108 Ahrntal,88,,5,3,8
108 Ahrntal,89,,-,7,7
108 Ahrntal,90,,-,5,5
108 Ahrntal,91,,1,5,6
108 Ahrntal,92,,1,3,4
108 Ahrntal,93,,1,1,2
108 Ahrntal,94,,-,2,2
108 Ahrntal,95,,-,1,1
108 Ahrntal,96,,-,1,1
108 Ahrntal,Insgesamt,,2.748,2.696,5.444
109 Gsies,0,,13,15,28
109 Gsies,1,,12,18,30
109 Gsies,2,,15,17,32
109 Gsies,3,,11,19,30
109 Gsies,4,,18,21,39
109 Gsies,5,,17,10,27
109 Gsies,6,,17,25,42
109 Gsies,7,,16,13,29
109 Gsies,8,,9,12,21
109 Gsies,9,,7,14,21
109 Gsies,10,,18,18,36
109 Gsies,11,,12,17,29
109 Gsies,12,,17,14,31
109 Gsies,13,,12,8,20
109 Gsies,14,,18,10,28
109 Gsies,15,,18,19,37
109 Gsies,16,,15,18,33
109 Gsies,17,,24,21,45
109 Gsies,18,,10,16,26
109 Gsies,19,,14,16,30
109 Gsies,20,,17,20,37
109 Gsies,21,,16,19,35
109 Gsies,22,,20,29,49
109 Gsies,23,,21,19,40
109 Gsies,24,,18,18,36
109 Gsies,25,,8,18,26
109 Gsies,26,,23,27,50
109 Gsies,27,,31,14,45
109 Gsies,28,,25,11,36
109 Gsies,29,,16,16,32
109 Gsies,30,,16,13,29
109 Gsies,31,,15,21,36
109 Gsies,32,,23,6,29
109 Gsies,33,,13,20,33
109 Gsies,34,,14,17,31
109 Gsies,35,,19,10,29
109 Gsies,36,,10,13,23
109 Gsies,37,,18,16,34
109 Gsies,38,,14,14,28
109 Gsies,39,,16,15,31
109 Gsies,40,,12,14,26
109 Gsies,41,,17,7,24
109 Gsies,42,,17,11,28
109 Gsies,43,,16,6,22
109 Gsies,44,,17,6,23
109 Gsies,45,,18,11,29
109 Gsies,46,,16,13,29
109 Gsies,47,,8,8,16
109 Gsies,48,,15,15,30
109 Gsies,49,,9,10,19
109 Gsies,50,,20,7,27
109 Gsies,51,,16,10,26
109 Gsies,52,,4,11,15
109 Gsies,53,,9,13,22
109 Gsies,54,,10,9,19
109 Gsies,55,,6,13,19
109 Gsies,56,,6,11,17
109 Gsies,57,,9,10,19
109 Gsies,58,,6,9,15
109 Gsies,59,,7,9,16
109 Gsies,60,,11,9,20
109 Gsies,61,,4,10,14
109 Gsies,62,,5,9,14
109 Gsies,63,,6,9,15
109 Gsies,64,,7,5,12
109 Gsies,65,,10,6,16
109 Gsies,66,,9,10,19
109 Gsies,67,,13,6,19
109 Gsies,68,,4,6,10
109 Gsies,69,,8,9,17
109 Gsies,70,,3,12,15
109 Gsies,71,,5,4,9
109 Gsies,72,,9,5,14
109 Gsies,73,,6,8,14
109 Gsies,74,,5,8,13
109 Gsies,75,,11,8,19
109 Gsies,76,,2,11,13
109 Gsies,77,,4,4,8
109 Gsies,78,,4,4,8
109 Gsies,79,,1,4,5
109 Gsies,80,,1,3,4
109 Gsies,81,,2,3,5
109 Gsies,82,,3,2,5
109 Gsies,83,,3,3,6
109 Gsies,84,,1,5,6
109 Gsies,85,,4,6,10
109 Gsies,86,,2,6,8
109 Gsies,87,,1,2,3
109 Gsies,88,,1,2,3
109 Gsies,89,,2,5,7
109 Gsies,90,,-,3,3
109 Gsies,91,,1,-,1
109 Gsies,92,,1,1,2
109 Gsies,97,,-,1,1
109 Gsies,Insgesamt,,1.033,1.049,2.082
110 Vintl,0,,22,19,41
110 Vintl,1,,21,21,42
110 Vintl,2,,36,26,62
110 Vintl,3,,18,18,36
110 Vintl,4,,23,19,42
110 Vintl,5,,30,20,50
110 Vintl,6,,22,29,51
110 Vintl,7,,28,22,50
110 Vintl,8,,26,17,43
110 Vintl,9,,21,19,40
110 Vintl,10,,20,23,43
110 Vintl,11,,21,18,39
110 Vintl,12,,10,15,25
110 Vintl,13,,27,10,37
110 Vintl,14,,25,17,42
110 Vintl,15,,20,21,41
110 Vintl,16,,20,25,45
110 Vintl,17,,33,19,52
110 Vintl,18,,32,16,48
110 Vintl,19,,21,32,53
110 Vintl,20,,19,25,44
110 Vintl,21,,20,28,48
110 Vintl,22,,26,23,49
110 Vintl,23,,30,29,59
110 Vintl,24,,19,24,43
110 Vintl,25,,34,22,56
110 Vintl,26,,31,32,63
110 Vintl,27,,24,21,45
110 Vintl,28,,28,27,55
110 Vintl,29,,21,24,45
110 Vintl,30,,31,36,67
110 Vintl,31,,31,35,66
110 Vintl,32,,35,34,69
110 Vintl,33,,35,27,62
110 Vintl,34,,30,27,57
110 Vintl,35,,31,25,56
110 Vintl,36,,29,30,59
110 Vintl,37,,19,21,40
110 Vintl,38,,27,23,50
110 Vintl,39,,19,11,30
110 Vintl,40,,23,27,50
110 Vintl,41,,27,20,47
110 Vintl,42,,20,16,36
110 Vintl,43,,17,22,39
110 Vintl,44,,23,9,32
110 Vintl,45,,18,18,36
110 Vintl,46,,21,16,37
110 Vintl,47,,25,18,43
110 Vintl,48,,20,18,38
110 Vintl,49,,13,13,26
110 Vintl,50,,21,15,36
110 Vintl,51,,17,13,30
110 Vintl,52,,19,18,37
110 Vintl,53,,13,6,19
110 Vintl,54,,21,12,33
110 Vintl,55,,11,13,24
110 Vintl,56,,6,16,22
110 Vintl,57,,8,20,28
110 Vintl,58,,18,16,34
110 Vintl,59,,14,6,20
110 Vintl,60,,10,10,20
110 Vintl,61,,14,10,24
110 Vintl,62,,9,12,21
110 Vintl,63,,16,8,24
110 Vintl,64,,8,18,26
110 Vintl,65,,12,16,28
110 Vintl,66,,14,12,26
110 Vintl,67,,9,15,24
110 Vintl,68,,11,20,31
110 Vintl,69,,16,10,26
110 Vintl,70,,12,16,28
110 Vintl,71,,20,9,29
110 Vintl,72,,8,10,18
110 Vintl,73,,9,11,20
110 Vintl,74,,14,13,27
110 Vintl,75,,6,8,14
110 Vintl,76,,11,8,19
110 Vintl,77,,3,8,11
110 Vintl,78,,5,7,12
110 Vintl,79,,1,2,3
110 Vintl,80,,3,4,7
110 Vintl,81,,2,3,5
110 Vintl,82,,3,5,8
110 Vintl,83,,2,6,8
110 Vintl,84,,-,9,9
110 Vintl,85,,1,3,4
110 Vintl,86,,-,8,8
110 Vintl,87,,2,2,4
110 Vintl,88,,2,1,3
110 Vintl,89,,2,4,6
110 Vintl,90,,2,2,4
110 Vintl,93,,-,1,1
110 Vintl,Insgesamt,,1.597,1.513,3.110
111 Vahrn,0,,25,19,44
111 Vahrn,1,,36,17,53
111 Vahrn,2,,21,21,42
111 Vahrn,3,,20,26,46
111 Vahrn,4,,20,21,41
111 Vahrn,5,,22,23,45
111 Vahrn,6,,21,21,42
111 Vahrn,7,,16,26,42
111 Vahrn,8,,32,19,51
111 Vahrn,9,,23,19,42
111 Vahrn,10,,20,18,38
111 Vahrn,11,,20,16,36
111 Vahrn,12,,26,27,53
111 Vahrn,13,,19,22,41
111 Vahrn,14,,26,25,51
111 Vahrn,15,,24,26,50
111 Vahrn,16,,27,18,45
111 Vahrn,17,,17,24,41
111 Vahrn,18,,19,26,45
111 Vahrn,19,,21,18,39
111 Vahrn,20,,17,22,39
111 Vahrn,21,,36,21,57
111 Vahrn,22,,28,19,47
111 Vahrn,23,,24,35,59
111 Vahrn,24,,28,32,60
111 Vahrn,25,,21,27,48
111 Vahrn,26,,30,40,70
111 Vahrn,27,,39,27,66
111 Vahrn,28,,26,38,64
111 Vahrn,29,,31,39,70
111 Vahrn,30,,48,23,71
111 Vahrn,31,,29,31,60
111 Vahrn,32,,38,36,74
111 Vahrn,33,,40,37,77
111 Vahrn,34,,31,34,65
111 Vahrn,35,,32,38,70
111 Vahrn,36,,26,22,48
111 Vahrn,37,,34,28,62
111 Vahrn,38,,32,23,55
111 Vahrn,39,,21,21,42
111 Vahrn,40,,31,33,64
111 Vahrn,41,,22,18,40
111 Vahrn,42,,29,27,56
111 Vahrn,43,,23,31,54
111 Vahrn,44,,23,27,50
111 Vahrn,45,,21,18,39
111 Vahrn,46,,23,11,34
111 Vahrn,47,,18,17,35
111 Vahrn,48,,22,28,50
111 Vahrn,49,,21,14,35
111 Vahrn,50,,15,22,37
111 Vahrn,51,,19,23,42
111 Vahrn,52,,10,16,26
111 Vahrn,53,,21,20,41
111 Vahrn,54,,23,20,43
111 Vahrn,55,,19,22,41
111 Vahrn,56,,20,26,46
111 Vahrn,57,,21,15,36
111 Vahrn,58,,19,19,38
111 Vahrn,59,,16,10,26
111 Vahrn,60,,19,19,38
111 Vahrn,61,,13,18,31
111 Vahrn,62,,12,15,27
111 Vahrn,63,,13,17,30
111 Vahrn,64,,10,13,23
111 Vahrn,65,,14,13,27
111 Vahrn,66,,15,16,31
111 Vahrn,67,,14,17,31
111 Vahrn,68,,9,19,28
111 Vahrn,69,,10,13,23
111 Vahrn,70,,14,20,34
111 Vahrn,71,,11,7,18
111 Vahrn,72,,9,18,27
111 Vahrn,73,,10,19,29
111 Vahrn,74,,10,12,22
111 Vahrn,75,,6,15,21
111 Vahrn,76,,8,10,18
111 Vahrn,77,,4,6,10
111 Vahrn,78,,3,5,8
111 Vahrn,79,,6,5,11
111 Vahrn,80,,5,6,11
111 Vahrn,81,,2,1,3
111 Vahrn,82,,-,7,7
111 Vahrn,83,,4,6,10
111 Vahrn,84,,2,5,7
111 Vahrn,85,,1,9,10
111 Vahrn,86,,1,4,5
111 Vahrn,87,,-,3,3
111 Vahrn,88,,-,3,3
111 Vahrn,89,,-,2,2
111 Vahrn,90,,-,1,1
111 Vahrn,91,,-,1,1
111 Vahrn,92,,-,1,1
111 Vahrn,93,,-,1,1
111 Vahrn,95,,1,-,1
111 Vahrn,96,,-,1,1
111 Vahrn,Insgesamt,,1.708,1.770,3.478
112 Vöran,0,,14,6,20
112 Vöran,1,,9,7,16
112 Vöran,2,,5,10,15
112 Vöran,3,,6,8,14
112 Vöran,4,,7,5,12
112 Vöran,5,,7,4,11
112 Vöran,6,,7,2,9
112 Vöran,7,,6,8,14
112 Vöran,8,,11,5,16
112 Vöran,9,,8,7,15
112 Vöran,10,,12,6,18
112 Vöran,11,,6,7,13
112 Vöran,12,,9,12,21
112 Vöran,13,,10,4,14
112 Vöran,14,,6,6,12
112 Vöran,15,,7,9,16
112 Vöran,16,,10,10,20
112 Vöran,17,,4,5,9
112 Vöran,18,,3,5,8
112 Vöran,19,,10,9,19
112 Vöran,20,,12,6,18
112 Vöran,21,,6,6,12
112 Vöran,22,,6,7,13
112 Vöran,23,,11,8,19
112 Vöran,24,,7,4,11
112 Vöran,25,,9,10,19
112 Vöran,26,,7,11,18
112 Vöran,27,,12,5,17
112 Vöran,28,,7,5,12
112 Vöran,29,,16,3,19
112 Vöran,30,,6,7,13
112 Vöran,31,,10,7,17
112 Vöran,32,,4,4,8
112 Vöran,33,,10,5,15
112 Vöran,34,,7,6,13
112 Vöran,35,,12,14,26
112 Vöran,36,,5,7,12
112 Vöran,37,,7,6,13
112 Vöran,38,,5,8,13
112 Vöran,39,,7,5,12
112 Vöran,40,,4,9,13
112 Vöran,41,,2,2,4
112 Vöran,42,,5,2,7
112 Vöran,43,,6,6,12
112 Vöran,44,,5,4,9
112 Vöran,45,,9,2,11
112 Vöran,46,,2,-,2
112 Vöran,47,,7,4,11
112 Vöran,48,,6,4,10
112 Vöran,49,,3,4,7
112 Vöran,50,,5,5,10
112 Vöran,51,,4,2,6
112 Vöran,52,,-,3,3
112 Vöran,53,,4,3,7
112 Vöran,54,,3,5,8
112 Vöran,55,,6,4,10
112 Vöran,56,,4,6,10
112 Vöran,57,,2,5,7
112 Vöran,58,,3,3,6
112 Vöran,59,,8,4,12
112 Vöran,60,,2,2,4
112 Vöran,61,,6,3,9
112 Vöran,62,,3,1,4
112 Vöran,63,,1,6,7
112 Vöran,64,,5,6,11
112 Vöran,65,,4,5,9
112 Vöran,66,,5,2,7
112 Vöran,67,,5,1,6
112 Vöran,68,,1,3,4
112 Vöran,69,,5,1,6
112 Vöran,70,,-,3,3
112 Vöran,71,,-,3,3
112 Vöran,72,,3,4,7
112 Vöran,73,,1,2,3
112 Vöran,74,,3,2,5
112 Vöran,75,,2,-,2
112 Vöran,76,,3,1,4
112 Vöran,77,,-,3,3
112 Vöran,78,,-,1,1
112 Vöran,79,,-,1,1
112 Vöran,81,,1,2,3
112 Vöran,83,,-,1,1
112 Vöran,84,,-,1,1
112 Vöran,85,,-,1,1
112 Vöran,87,,2,1,3
112 Vöran,88,,-,2,2
112 Vöran,89,,1,-,1
112 Vöran,90,,-,1,1
112 Vöran,93,,-,1,1
112 Vöran,Insgesamt,,464,406,870
113 Niederdorf,0,,11,12,23
113 Niederdorf,1,,4,7,11
113 Niederdorf,2,,5,10,15
113 Niederdorf,3,,12,8,20
113 Niederdorf,4,,9,6,15
113 Niederdorf,5,,6,8,14
113 Niederdorf,6,,7,11,18
113 Niederdorf,7,,14,10,24
113 Niederdorf,8,,8,7,15
113 Niederdorf,9,,6,7,13
113 Niederdorf,10,,2,11,13
113 Niederdorf,11,,4,7,11
113 Niederdorf,12,,7,5,12
113 Niederdorf,13,,11,5,16
113 Niederdorf,14,,7,8,15
113 Niederdorf,15,,3,11,14
113 Niederdorf,16,,10,7,17
113 Niederdorf,17,,9,4,13
113 Niederdorf,18,,8,4,12
113 Niederdorf,19,,5,3,8
113 Niederdorf,20,,6,4,10
113 Niederdorf,21,,11,8,19
113 Niederdorf,22,,6,9,15
113 Niederdorf,23,,10,9,19
113 Niederdorf,24,,12,6,18
113 Niederdorf,25,,13,6,19
113 Niederdorf,26,,14,11,25
113 Niederdorf,27,,12,12,24
113 Niederdorf,28,,21,13,34
113 Niederdorf,29,,14,11,25
113 Niederdorf,30,,17,17,34
113 Niederdorf,31,,22,9,31
113 Niederdorf,32,,9,15,24
113 Niederdorf,33,,22,15,37
113 Niederdorf,34,,11,9,20
113 Niederdorf,35,,18,9,27
113 Niederdorf,36,,15,12,27
113 Niederdorf,37,,11,10,21
113 Niederdorf,38,,12,8,20
113 Niederdorf,39,,6,5,11
113 Niederdorf,40,,12,10,22
113 Niederdorf,41,,10,9,19
113 Niederdorf,42,,10,7,17
113 Niederdorf,43,,11,6,17
113 Niederdorf,44,,5,3,8
113 Niederdorf,45,,8,5,13
113 Niederdorf,46,,2,3,5
113 Niederdorf,47,,7,4,11
113 Niederdorf,48,,11,4,15
113 Niederdorf,49,,6,8,14
113 Niederdorf,50,,8,8,16
113 Niederdorf,51,,6,7,13
113 Niederdorf,52,,2,6,8
113 Niederdorf,53,,11,5,16
113 Niederdorf,54,,5,10,15
113 Niederdorf,55,,6,11,17
113 Niederdorf,56,,5,6,11
113 Niederdorf,57,,4,9,13
113 Niederdorf,58,,1,4,5
113 Niederdorf,59,,6,8,14
113 Niederdorf,60,,6,7,13
113 Niederdorf,61,,6,8,14
113 Niederdorf,62,,7,7,14
113 Niederdorf,63,,3,12,15
113 Niederdorf,64,,6,8,14
113 Niederdorf,65,,8,7,15
113 Niederdorf,66,,9,7,16
113 Niederdorf,67,,6,10,16
113 Niederdorf,68,,5,8,13
113 Niederdorf,69,,5,6,11
113 Niederdorf,70,,8,10,18
113 Niederdorf,71,,3,6,9
113 Niederdorf,72,,1,7,8
113 Niederdorf,73,,6,11,17
113 Niederdorf,74,,2,3,5
113 Niederdorf,75,,6,9,15
113 Niederdorf,76,,5,4,9
113 Niederdorf,77,,2,4,6
113 Niederdorf,78,,2,5,7
113 Niederdorf,79,,1,4,5
113 Niederdorf,80,,1,3,4
113 Niederdorf,81,,1,3,4
113 Niederdorf,82,,-,3,3
113 Niederdorf,83,,3,1,4
113 Niederdorf,84,,1,1,2
113 Niederdorf,85,,-,4,4
113 Niederdorf,86,,3,3,6
113 Niederdorf,87,,1,4,5
113 Niederdorf,88,,1,4,5
113 Niederdorf,89,,-,3,3
113 Niederdorf,90,,-,1,1
113 Niederdorf,91,,1,1,2
113 Niederdorf,92,,-,2,2
113 Niederdorf,93,,1,1,2
113 Niederdorf,94,,-,3,3
113 Niederdorf,95,,-,1,1
113 Niederdorf,96,,-,1,1
113 Niederdorf,Insgesamt,,656,664,1.320
114 Villanders,0,,13,13,26
114 Villanders,1,,15,6,21
114 Villanders,2,,19,7,26
114 Villanders,3,,11,14,25
114 Villanders,4,,8,18,26
114 Villanders,5,,13,9,22
114 Villanders,6,,19,17,36
114 Villanders,7,,16,14,30
114 Villanders,8,,12,10,22
114 Villanders,9,,9,12,21
114 Villanders,10,,5,16,21
114 Villanders,11,,9,8,17
114 Villanders,12,,10,10,20
114 Villanders,13,,12,12,24
114 Villanders,14,,13,6,19
114 Villanders,15,,15,11,26
114 Villanders,16,,19,14,33
114 Villanders,17,,10,17,27
114 Villanders,18,,16,6,22
114 Villanders,19,,13,13,26
114 Villanders,20,,15,15,30
114 Villanders,21,,13,14,27
114 Villanders,22,,10,15,25
114 Villanders,23,,13,18,31
114 Villanders,24,,12,17,29
114 Villanders,25,,13,15,28
114 Villanders,26,,17,24,41
114 Villanders,27,,18,13,31
114 Villanders,28,,25,20,45
114 Villanders,29,,21,14,35
114 Villanders,30,,18,22,40
114 Villanders,31,,23,15,38
114 Villanders,32,,22,18,40
114 Villanders,33,,18,16,34
114 Villanders,34,,15,14,29
114 Villanders,35,,20,11,31
114 Villanders,36,,14,12,26
114 Villanders,37,,20,8,28
114 Villanders,38,,14,11,25
114 Villanders,39,,16,9,25
114 Villanders,40,,8,6,14
114 Villanders,41,,12,10,22
114 Villanders,42,,10,16,26
114 Villanders,43,,10,5,15
114 Villanders,44,,10,7,17
114 Villanders,45,,10,8,18
114 Villanders,46,,11,6,17
114 Villanders,47,,8,9,17
114 Villanders,48,,10,8,18
114 Villanders,49,,6,11,17
114 Villanders,50,,7,8,15
114 Villanders,51,,10,11,21
114 Villanders,52,,6,3,9
114 Villanders,53,,5,9,14
114 Villanders,54,,8,8,16
114 Villanders,55,,11,8,19
114 Villanders,56,,8,9,17
114 Villanders,57,,9,14,23
114 Villanders,58,,9,6,15
114 Villanders,59,,10,7,17
114 Villanders,60,,5,9,14
114 Villanders,61,,6,7,13
114 Villanders,62,,2,8,10
114 Villanders,63,,1,9,10
114 Villanders,64,,12,9,21
114 Villanders,65,,9,10,19
114 Villanders,66,,6,8,14
114 Villanders,67,,10,7,17
114 Villanders,68,,4,10,14
114 Villanders,69,,7,10,17
114 Villanders,70,,9,6,15
114 Villanders,71,,6,6,12
114 Villanders,72,,2,7,9
114 Villanders,73,,5,5,10
114 Villanders,74,,6,2,8
114 Villanders,75,,5,6,11
114 Villanders,76,,4,13,17
114 Villanders,77,,5,5,10
114 Villanders,78,,1,3,4
114 Villanders,79,,2,-,2
114 Villanders,80,,-,2,2
114 Villanders,81,,1,3,4
114 Villanders,82,,-,4,4
114 Villanders,83,,2,6,8
114 Villanders,84,,1,3,4
114 Villanders,85,,4,6,10
114 Villanders,86,,1,5,6
114 Villanders,87,,1,3,4
114 Villanders,88,,2,4,6
114 Villanders,89,,2,2,4
114 Villanders,90,,1,2,3
114 Villanders,91,,2,-,2
114 Villanders,92,,-,1,1
114 Villanders,93,,-,1,1
114 Villanders,94,,-,1,1
114 Villanders,95,,-,1,1
114 Villanders,96,,-,1,1
114 Villanders,Insgesamt,,896,888,1.784
115 Sterzing,0,,30,36,66
115 Sterzing,1,,29,37,66
115 Sterzing,2,,25,27,52
115 Sterzing,3,,34,19,53
115 Sterzing,4,,29,29,58
115 Sterzing,5,,29,34,63
115 Sterzing,6,,32,35,67
115 Sterzing,7,,21,32,53
115 Sterzing,8,,37,22,59
115 Sterzing,9,,26,26,52
115 Sterzing,10,,27,25,52
115 Sterzing,11,,33,32,65
115 Sterzing,12,,18,29,47
115 Sterzing,13,,34,24,58
115 Sterzing,14,,25,30,55
115 Sterzing,15,,25,36,61
115 Sterzing,16,,45,33,78
115 Sterzing,17,,29,38,67
115 Sterzing,18,,31,40,71
115 Sterzing,19,,46,25,71
115 Sterzing,20,,36,34,70
115 Sterzing,21,,34,33,67
115 Sterzing,22,,57,50,107
115 Sterzing,23,,53,40,93
115 Sterzing,24,,49,53,102
115 Sterzing,25,,61,49,110
115 Sterzing,26,,61,48,109
115 Sterzing,27,,56,60,116
115 Sterzing,28,,52,44,96
115 Sterzing,29,,71,50,121
115 Sterzing,30,,65,51,116
115 Sterzing,31,,54,64,118
115 Sterzing,32,,64,47,111
115 Sterzing,33,,54,37,91
115 Sterzing,34,,59,47,106
115 Sterzing,35,,42,45,87
115 Sterzing,36,,42,45,87
115 Sterzing,37,,43,45,88
115 Sterzing,38,,47,37,84
115 Sterzing,39,,37,42,79
115 Sterzing,40,,36,47,83
115 Sterzing,41,,45,30,75
115 Sterzing,42,,36,43,79
115 Sterzing,43,,35,36,71
115 Sterzing,44,,30,39,69
115 Sterzing,45,,41,37,78
115 Sterzing,46,,37,40,77
115 Sterzing,47,,33,38,71
115 Sterzing,48,,33,51,84
115 Sterzing,49,,43,44,87
115 Sterzing,50,,38,29,67
115 Sterzing,51,,47,43,90
115 Sterzing,52,,38,36,74
115 Sterzing,53,,30,27,57
115 Sterzing,54,,43,45,88
115 Sterzing,55,,33,34,67
115 Sterzing,56,,34,30,64
115 Sterzing,57,,42,31,73
115 Sterzing,58,,36,29,65
115 Sterzing,59,,33,27,60
115 Sterzing,60,,26,36,62
115 Sterzing,61,,25,44,69
115 Sterzing,62,,20,23,43
115 Sterzing,63,,22,26,48
115 Sterzing,64,,32,33,65
115 Sterzing,65,,21,18,39
115 Sterzing,66,,25,33,58
115 Sterzing,67,,11,26,37
115 Sterzing,68,,22,21,43
115 Sterzing,69,,23,31,54
115 Sterzing,70,,23,22,45
115 Sterzing,71,,17,24,41
115 Sterzing,72,,11,23,34
115 Sterzing,73,,13,24,37
115 Sterzing,74,,16,22,38
115 Sterzing,75,,19,27,46
115 Sterzing,76,,6,24,30
115 Sterzing,77,,7,14,21
115 Sterzing,78,,7,11,18
115 Sterzing,79,,6,6,12
115 Sterzing,80,,7,6,13
115 Sterzing,81,,4,8,12
115 Sterzing,82,,4,8,12
115 Sterzing,83,,3,17,20
115 Sterzing,84,,2,15,17
115 Sterzing,85,,1,14,15
115 Sterzing,86,,2,9,11
115 Sterzing,87,,2,4,6
115 Sterzing,88,,2,6,8
115 Sterzing,89,,3,4,7
115 Sterzing,90,,1,3,4
115 Sterzing,91,,1,7,8
115 Sterzing,92,,-,2,2
115 Sterzing,93,,-,1,1
115 Sterzing,95,,-,1,1
115 Sterzing,96,,-,2,2
115 Sterzing,97,,-,1,1
115 Sterzing,101,,1,-,1
115 Sterzing,Insgesamt,,2.770,2.862,5.632
116 Feldthurns,0,,21,17,38
116 Feldthurns,1,,17,18,35
116 Feldthurns,2,,18,21,39
116 Feldthurns,3,,18,15,33
116 Feldthurns,4,,28,20,48
116 Feldthurns,5,,17,18,35
116 Feldthurns,6,,11,14,25
116 Feldthurns,7,,12,19,31
116 Feldthurns,8,,19,15,34
116 Feldthurns,9,,18,20,38
116 Feldthurns,10,,22,13,35
116 Feldthurns,11,,16,19,35
116 Feldthurns,12,,14,20,34
116 Feldthurns,13,,17,20,37
116 Feldthurns,14,,24,25,49
116 Feldthurns,15,,16,22,38
116 Feldthurns,16,,21,19,40
116 Feldthurns,17,,11,25,36
116 Feldthurns,18,,14,16,30
116 Feldthurns,19,,30,23,53
116 Feldthurns,20,,18,17,35
116 Feldthurns,21,,27,22,49
116 Feldthurns,22,,17,18,35
116 Feldthurns,23,,21,30,51
116 Feldthurns,24,,21,24,45
116 Feldthurns,25,,30,21,51
116 Feldthurns,26,,18,21,39
116 Feldthurns,27,,14,25,39
116 Feldthurns,28,,26,26,52
116 Feldthurns,29,,19,26,45
116 Feldthurns,30,,25,22,47
116 Feldthurns,31,,19,22,41
116 Feldthurns,32,,23,27,50
116 Feldthurns,33,,27,20,47
116 Feldthurns,34,,25,16,41
116 Feldthurns,35,,17,17,34
116 Feldthurns,36,,19,20,39
116 Feldthurns,37,,18,11,29
116 Feldthurns,38,,17,16,33
116 Feldthurns,39,,16,20,36
116 Feldthurns,40,,14,14,28
116 Feldthurns,41,,12,18,30
116 Feldthurns,42,,15,13,28
116 Feldthurns,43,,14,16,30
116 Feldthurns,44,,18,12,30
116 Feldthurns,45,,24,16,40
116 Feldthurns,46,,15,11,26
116 Feldthurns,47,,12,15,27
116 Feldthurns,48,,6,15,21
116 Feldthurns,49,,14,11,25
116 Feldthurns,50,,15,8,23
116 Feldthurns,51,,10,9,19
116 Feldthurns,52,,13,14,27
116 Feldthurns,53,,22,11,33
116 Feldthurns,54,,13,13,26
116 Feldthurns,55,,9,10,19
116 Feldthurns,56,,8,4,12
116 Feldthurns,57,,9,7,16
116 Feldthurns,58,,8,11,19
116 Feldthurns,59,,11,8,19
116 Feldthurns,60,,4,9,13
116 Feldthurns,61,,8,12,20
116 Feldthurns,62,,11,11,22
116 Feldthurns,63,,5,5,10
116 Feldthurns,64,,7,6,13
116 Feldthurns,65,,9,11,20
116 Feldthurns,66,,5,7,12
116 Feldthurns,67,,7,15,22
116 Feldthurns,68,,5,12,17
116 Feldthurns,69,,9,4,13
116 Feldthurns,70,,4,6,10
116 Feldthurns,71,,4,11,15
116 Feldthurns,72,,7,10,17
116 Feldthurns,73,,4,9,13
116 Feldthurns,74,,8,10,18
116 Feldthurns,75,,2,10,12
116 Feldthurns,76,,4,9,13
116 Feldthurns,77,,11,10,21
116 Feldthurns,78,,5,5,10
116 Feldthurns,79,,3,1,4
116 Feldthurns,80,,2,2,4
116 Feldthurns,81,,-,4,4
116 Feldthurns,82,,2,7,9
116 Feldthurns,83,,2,5,7
116 Feldthurns,84,,1,4,5
116 Feldthurns,85,,2,4,6
116 Feldthurns,86,,2,2,4
116 Feldthurns,88,,2,-,2
116 Feldthurns,89,,1,-,1
116 Feldthurns,91,,-,1,1
116 Feldthurns,92,,-,1,1
116 Feldthurns,93,,-,1,1
116 Feldthurns,Insgesamt,,1.179,1.240,2.419
117 Wengen,0,,13,7,20
117 Wengen,1,,9,9,18
117 Wengen,2,,11,10,21
117 Wengen,3,,14,7,21
117 Wengen,4,,10,7,17
117 Wengen,5,,10,7,17
117 Wengen,6,,17,5,22
117 Wengen,7,,12,8,20
117 Wengen,8,,5,7,12
117 Wengen,9,,7,9,16
117 Wengen,10,,11,5,16
117 Wengen,11,,9,8,17
117 Wengen,12,,9,6,15
117 Wengen,13,,14,8,22
117 Wengen,14,,13,5,18
117 Wengen,15,,11,5,16
117 Wengen,16,,6,9,15
117 Wengen,17,,9,10,19
117 Wengen,18,,14,7,21
117 Wengen,19,,6,8,14
117 Wengen,20,,10,8,18
117 Wengen,21,,6,10,16
117 Wengen,22,,16,9,25
117 Wengen,23,,10,9,19
117 Wengen,24,,16,13,29
117 Wengen,25,,13,19,32
117 Wengen,26,,13,15,28
117 Wengen,27,,12,15,27
117 Wengen,28,,11,15,26
117 Wengen,29,,18,10,28
117 Wengen,30,,12,9,21
117 Wengen,31,,12,7,19
117 Wengen,32,,9,10,19
117 Wengen,33,,12,7,19
117 Wengen,34,,11,13,24
117 Wengen,35,,14,8,22
117 Wengen,36,,9,9,18
117 Wengen,37,,11,12,23
117 Wengen,38,,8,7,15
117 Wengen,39,,5,8,13
117 Wengen,40,,7,11,18
117 Wengen,41,,6,6,12
117 Wengen,42,,8,6,14
117 Wengen,43,,10,5,15
117 Wengen,44,,7,2,9
117 Wengen,45,,6,7,13
117 Wengen,46,,10,5,15
117 Wengen,47,,3,6,9
117 Wengen,48,,5,9,14
117 Wengen,49,,2,12,14
117 Wengen,50,,6,3,9
117 Wengen,51,,5,3,8
117 Wengen,52,,5,3,8
117 Wengen,53,,9,8,17
117 Wengen,54,,3,7,10
117 Wengen,55,,8,7,15
117 Wengen,56,,4,4,8
117 Wengen,57,,7,8,15
117 Wengen,58,,6,3,9
117 Wengen,59,,5,4,9
117 Wengen,60,,7,7,14
117 Wengen,61,,2,2,4
117 Wengen,62,,4,7,11
117 Wengen,63,,2,9,11
117 Wengen,64,,5,2,7
117 Wengen,65,,3,8,11
117 Wengen,66,,5,2,7
117 Wengen,67,,5,3,8
117 Wengen,68,,2,9,11
117 Wengen,69,,5,4,9
117 Wengen,70,,4,5,9
117 Wengen,71,,4,6,10
117 Wengen,72,,3,4,7
117 Wengen,73,,3,5,8
117 Wengen,74,,3,7,10
117 Wengen,75,,3,6,9
117 Wengen,76,,6,9,15
117 Wengen,77,,3,5,8
117 Wengen,78,,2,2,4
117 Wengen,79,,1,-,1
117 Wengen,80,,2,1,3
117 Wengen,82,,1,2,3
117 Wengen,83,,1,-,1
117 Wengen,84,,1,3,4
117 Wengen,85,,2,1,3
117 Wengen,86,,1,1,2
117 Wengen,87,,1,1,2
117 Wengen,88,,-,1,1
117 Wengen,89,,-,4,4
117 Wengen,91,,1,-,1
117 Wengen,92,,1,-,1
117 Wengen,93,,-,2,2
117 Wengen,Insgesamt,,643,597,1.240
118 U.L.Frau i.W.-St.Felix,0,,4,4,8
118 U.L.Frau i.W.-St.Felix,1,,9,5,14
118 U.L.Frau i.W.-St.Felix,2,,4,9,13
118 U.L.Frau i.W.-St.Felix,3,,7,8,15
118 U.L.Frau i.W.-St.Felix,4,,9,5,14
118 U.L.Frau i.W.-St.Felix,5,,6,4,10
118 U.L.Frau i.W.-St.Felix,6,,11,8,19
118 U.L.Frau i.W.-St.Felix,7,,7,5,12
118 U.L.Frau i.W.-St.Felix,8,,9,7,16
118 U.L.Frau i.W.-St.Felix,9,,8,6,14
118 U.L.Frau i.W.-St.Felix,10,,4,7,11
118 U.L.Frau i.W.-St.Felix,11,,8,4,12
118 U.L.Frau i.W.-St.Felix,12,,5,7,12
118 U.L.Frau i.W.-St.Felix,13,,7,6,13
118 U.L.Frau i.W.-St.Felix,14,,2,10,12
118 U.L.Frau i.W.-St.Felix,15,,3,6,9
118 U.L.Frau i.W.-St.Felix,16,,6,3,9
118 U.L.Frau i.W.-St.Felix,17,,3,6,9
118 U.L.Frau i.W.-St.Felix,18,,2,2,4
118 U.L.Frau i.W.-St.Felix,19,,1,3,4
118 U.L.Frau i.W.-St.Felix,20,,5,4,9
118 U.L.Frau i.W.-St.Felix,21,,4,8,12
118 U.L.Frau i.W.-St.Felix,22,,7,3,10
118 U.L.Frau i.W.-St.Felix,23,,5,4,9
118 U.L.Frau i.W.-St.Felix,24,,4,4,8
118 U.L.Frau i.W.-St.Felix,25,,8,3,11
118 U.L.Frau i.W.-St.Felix,26,,2,5,7
118 U.L.Frau i.W.-St.Felix,27,,6,7,13
118 U.L.Frau i.W.-St.Felix,28,,8,5,13
118 U.L.Frau i.W.-St.Felix,29,,7,9,16
118 U.L.Frau i.W.-St.Felix,30,,3,5,8
118 U.L.Frau i.W.-St.Felix,31,,9,8,17
118 U.L.Frau i.W.-St.Felix,32,,10,5,15
118 U.L.Frau i.W.-St.Felix,33,,5,8,13
118 U.L.Frau i.W.-St.Felix,34,,17,8,25
118 U.L.Frau i.W.-St.Felix,35,,8,10,18
118 U.L.Frau i.W.-St.Felix,36,,4,4,8
118 U.L.Frau i.W.-St.Felix,37,,8,9,17
118 U.L.Frau i.W.-St.Felix,38,,5,6,11
118 U.L.Frau i.W.-St.Felix,39,,4,3,7
118 U.L.Frau i.W.-St.Felix,40,,3,5,8
118 U.L.Frau i.W.-St.Felix,41,,5,8,13
118 U.L.Frau i.W.-St.Felix,42,,4,4,8
118 U.L.Frau i.W.-St.Felix,43,,7,4,11
118 U.L.Frau i.W.-St.Felix,44,,3,3,6
118 U.L.Frau i.W.-St.Felix,45,,6,3,9
118 U.L.Frau i.W.-St.Felix,46,,6,3,9
118 U.L.Frau i.W.-St.Felix,47,,3,3,6
118 U.L.Frau i.W.-St.Felix,48,,5,-,5
118 U.L.Frau i.W.-St.Felix,49,,5,2,7
118 U.L.Frau i.W.-St.Felix,50,,2,6,8
118 U.L.Frau i.W.-St.Felix,51,,2,4,6
118 U.L.Frau i.W.-St.Felix,52,,4,2,6
118 U.L.Frau i.W.-St.Felix,53,,5,-,5
118 U.L.Frau i.W.-St.Felix,54,,7,4,11
118 U.L.Frau i.W.-St.Felix,55,,5,4,9
118 U.L.Frau i.W.-St.Felix,56,,5,8,13
118 U.L.Frau i.W.-St.Felix,57,,4,1,5
118 U.L.Frau i.W.-St.Felix,58,,1,4,5
118 U.L.Frau i.W.-St.Felix,59,,3,4,7
118 U.L.Frau i.W.-St.Felix,60,,3,-,3
118 U.L.Frau i.W.-St.Felix,61,,4,2,6
118 U.L.Frau i.W.-St.Felix,62,,3,4,7
118 U.L.Frau i.W.-St.Felix,63,,3,3,6
118 U.L.Frau i.W.-St.Felix,64,,6,5,11
118 U.L.Frau i.W.-St.Felix,65,,6,1,7
118 U.L.Frau i.W.-St.Felix,66,,4,1,5
118 U.L.Frau i.W.-St.Felix,67,,4,5,9
118 U.L.Frau i.W.-St.Felix,68,,2,3,5
118 U.L.Frau i.W.-St.Felix,69,,3,5,8
118 U.L.Frau i.W.-St.Felix,70,,3,4,7
118 U.L.Frau i.W.-St.Felix,71,,2,3,5
118 U.L.Frau i.W.-St.Felix,72,,5,6,11
118 U.L.Frau i.W.-St.Felix,73,,6,4,10
118 U.L.Frau i.W.-St.Felix,74,,2,6,8
118 U.L.Frau i.W.-St.Felix,75,,1,2,3
118 U.L.Frau i.W.-St.Felix,76,,1,3,4
118 U.L.Frau i.W.-St.Felix,77,,-,1,1
118 U.L.Frau i.W.-St.Felix,78,,1,2,3
118 U.L.Frau i.W.-St.Felix,79,,1,-,1
118 U.L.Frau i.W.-St.Felix,80,,1,-,1
118 U.L.Frau i.W.-St.Felix,82,,1,1,2
118 U.L.Frau i.W.-St.Felix,83,,3,2,5
118 U.L.Frau i.W.-St.Felix,84,,2,3,5
118 U.L.Frau i.W.-St.Felix,85,,2,2,4
118 U.L.Frau i.W.-St.Felix,86,,1,-,1
118 U.L.Frau i.W.-St.Felix,87,,1,2,3
118 U.L.Frau i.W.-St.Felix,89,,-,1,1
118 U.L.Frau i.W.-St.Felix,90,,1,-,1
118 U.L.Frau i.W.-St.Felix,92,,1,-,1
118 U.L.Frau i.W.-St.Felix,Insgesamt,,402,376,778
Insgesamt,,,224.863,231.265,456.128
