Gemeinde,Altersklassen,Geschlecht,Männer,Frauen,Insgesamt
001 Aldein,0,,16,17,33
001 Aldein,1,,9,17,26
001 Aldein,2,,17,9,26
001 Aldein,3,,8,8,16
001 Aldein,4,,8,12,20
001 Aldein,5,,14,7,21
001 Aldein,6,,13,11,24
001 Aldein,7,,9,13,22
001 Aldein,8,,7,8,15
001 Aldein,9,,7,6,13
001 Aldein,10,,9,17,26
001 Aldein,11,,11,9,20
001 Aldein,12,,11,8,19
001 Aldein,13,,11,10,21
001 Aldein,14,,12,12,24
001 Aldein,15,,10,7,17
001 Aldein,16,,14,12,26
001 Aldein,17,,15,7,22
001 Aldein,18,,10,16,26
001 Aldein,19,,10,15,25
001 Aldein,20,,10,20,30
001 Aldein,21,,10,8,18
001 Aldein,22,,7,22,29
001 Aldein,23,,14,17,31
001 Aldein,24,,18,18,36
001 Aldein,25,,11,17,28
001 Aldein,26,,16,11,27
001 Aldein,27,,19,11,30
001 Aldein,28,,18,20,38
001 Aldein,29,,17,17,34
001 Aldein,30,,23,10,33
001 Aldein,31,,11,17,28
001 Aldein,32,,8,16,24
001 Aldein,33,,7,21,28
001 Aldein,34,,17,12,29
001 Aldein,35,,16,10,26
001 Aldein,36,,15,7,22
001 Aldein,37,,10,15,25
001 Aldein,38,,15,17,32
001 Aldein,39,,17,9,26
001 Aldein,40,,12,13,25
001 Aldein,41,,8,5,13
001 Aldein,42,,9,10,19
001 Aldein,43,,10,10,20
001 Aldein,44,,8,10,18
001 Aldein,45,,10,7,17
001 Aldein,46,,8,9,17
001 Aldein,47,,9,5,14
001 Aldein,48,,15,10,25
001 Aldein,49,,5,12,17
001 Aldein,50,,9,6,15
001 Aldein,51,,10,9,19
001 Aldein,52,,5,11,16
001 Aldein,53,,7,11,18
001 Aldein,54,,7,5,12
001 Aldein,55,,6,6,12
001 Aldein,56,,11,11,22
001 Aldein,57,,8,13,21
001 Aldein,58,,7,12,19
001 Aldein,59,,9,8,17
001 Aldein,60,,4,9,13
001 Aldein,61,,6,8,14
001 Aldein,62,,8,9,17
001 Aldein,63,,9,6,15
001 Aldein,64,,4,4,8
001 Aldein,65,,15,5,20
001 Aldein,66,,8,3,11
001 Aldein,67,,5,8,13
001 Aldein,68,,10,4,14
001 Aldein,69,,6,6,12
001 Aldein,70,,9,10,19
001 Aldein,71,,6,3,9
001 Aldein,72,,6,6,12
001 Aldein,73,,2,7,9
001 Aldein,74,,3,6,9
001 Aldein,75,,3,8,11
001 Aldein,76,,2,6,8
001 Aldein,77,,2,9,11
001 Aldein,78,,5,12,17
001 Aldein,79,,5,2,7
001 Aldein,80,,1,4,5
001 Aldein,81,,2,3,5
001 Aldein,82,,-,1,1
001 Aldein,83,,2,2,4
001 Aldein,84,,2,-,2
001 Aldein,85,,-,3,3
001 Aldein,86,,1,5,6
001 Aldein,87,,3,3,6
001 Aldein,88,,1,1,2
001 Aldein,89,,2,1,3
001 Aldein,90,,1,1,2
001 Aldein,91,,-,2,2
001 Aldein,92,,-,1,1
001 Aldein,93,,-,2,2
001 Aldein,95,,-,1,1
001 Aldein,97,,-,1,1
002 Andrian,0,,2,9,11
002 Andrian,1,,5,2,7
002 Andrian,2,,9,5,14
002 Andrian,3,,2,10,12
002 Andrian,4,,8,4,12
002 Andrian,5,,4,4,8
002 Andrian,6,,5,6,11
002 Andrian,7,,6,6,12
002 Andrian,8,,7,7,14
002 Andrian,9,,5,4,9
002 Andrian,10,,4,3,7
002 Andrian,11,,12,6,18
002 Andrian,12,,6,7,13
002 Andrian,13,,8,6,14
002 Andrian,14,,1,4,5
002 Andrian,15,,6,4,10
002 Andrian,16,,5,2,7
002 Andrian,17,,10,6,16
002 Andrian,18,,1,3,4
002 Andrian,19,,5,2,7
002 Andrian,20,,5,3,8
002 Andrian,21,,4,4,8
002 Andrian,22,,5,3,8
002 Andrian,23,,6,4,10
002 Andrian,24,,4,2,6
002 Andrian,25,,6,5,11
002 Andrian,26,,4,8,12
002 Andrian,27,,4,5,9
002 Andrian,28,,6,11,17
002 Andrian,29,,9,8,17
002 Andrian,30,,5,6,11
002 Andrian,31,,8,7,15
002 Andrian,32,,8,7,15
002 Andrian,33,,10,8,18
002 Andrian,34,,10,7,17
002 Andrian,35,,7,7,14
002 Andrian,36,,6,11,17
002 Andrian,37,,6,6,12
002 Andrian,38,,7,2,9
002 Andrian,39,,7,4,11
002 Andrian,40,,5,4,9
002 Andrian,41,,8,8,16
002 Andrian,42,,5,8,13
002 Andrian,43,,5,9,14
002 Andrian,44,,1,4,5
002 Andrian,45,,7,2,9
002 Andrian,46,,7,6,13
002 Andrian,47,,2,3,5
002 Andrian,48,,4,3,7
002 Andrian,49,,7,6,13
002 Andrian,50,,4,2,6
002 Andrian,51,,6,3,9
002 Andrian,52,,5,4,9
002 Andrian,53,,4,7,11
002 Andrian,54,,1,2,3
002 Andrian,55,,1,3,4
002 Andrian,56,,5,7,12
002 Andrian,57,,4,5,9
002 Andrian,58,,5,3,8
002 Andrian,59,,4,7,11
002 Andrian,60,,1,8,9
002 Andrian,61,,4,4,8
002 Andrian,62,,5,4,9
002 Andrian,63,,2,3,5
002 Andrian,64,,3,3,6
002 Andrian,65,,5,3,8
002 Andrian,66,,3,4,7
002 Andrian,67,,7,5,12
002 Andrian,68,,4,5,9
002 Andrian,69,,3,1,4
002 Andrian,70,,2,1,3
002 Andrian,71,,2,4,6
002 Andrian,72,,1,2,3
002 Andrian,73,,4,4,8
002 Andrian,74,,2,1,3
002 Andrian,75,,2,4,6
002 Andrian,76,,1,2,3
002 Andrian,77,,1,5,6
002 Andrian,78,,1,4,5
002 Andrian,79,,1,1,2
002 Andrian,80,,2,3,5
002 Andrian,81,,2,2,4
002 Andrian,83,,1,-,1
002 Andrian,84,,1,2,3
002 Andrian,85,,1,2,3
002 Andrian,86,,1,2,3
002 Andrian,87,,-,2,2
002 Andrian,89,,-,1,1
002 Andrian,90,,1,1,2
002 Andrian,92,,1,1,2
002 Andrian,96,,-,1,1
003 Altrei,0,,3,-,3
003 Altrei,1,,4,1,5
003 Altrei,2,,1,1,2
003 Altrei,3,,-,3,3
003 Altrei,4,,1,1,2
003 Altrei,5,,3,2,5
003 Altrei,6,,3,-,3
003 Altrei,7,,6,2,8
003 Altrei,8,,1,1,2
003 Altrei,9,,3,2,5
003 Altrei,10,,2,2,4
003 Altrei,11,,4,4,8
003 Altrei,12,,2,1,3
003 Altrei,13,,3,3,6
003 Altrei,14,,2,2,4
003 Altrei,15,,3,1,4
003 Altrei,16,,4,2,6
003 Altrei,17,,2,2,4
003 Altrei,18,,3,2,5
003 Altrei,19,,3,4,7
003 Altrei,20,,-,1,1
003 Altrei,21,,2,5,7
003 Altrei,22,,-,4,4
003 Altrei,23,,2,3,5
003 Altrei,24,,2,1,3
003 Altrei,25,,1,2,3
003 Altrei,26,,2,3,5
003 Altrei,27,,3,1,4
003 Altrei,28,,5,4,9
003 Altrei,29,,1,3,4
003 Altrei,30,,3,5,8
003 Altrei,31,,-,3,3
003 Altrei,32,,3,-,3
003 Altrei,33,,3,5,8
003 Altrei,34,,2,5,7
003 Altrei,35,,3,5,8
003 Altrei,36,,3,3,6
003 Altrei,37,,9,1,10
003 Altrei,38,,2,3,5
003 Altrei,39,,5,3,8
003 Altrei,40,,4,2,6
003 Altrei,41,,1,3,4
003 Altrei,42,,1,3,4
003 Altrei,43,,5,1,6
003 Altrei,44,,3,3,6
003 Altrei,45,,1,1,2
003 Altrei,46,,3,2,5
003 Altrei,47,,6,3,9
003 Altrei,48,,6,3,9
003 Altrei,49,,1,2,3
003 Altrei,50,,1,-,1
003 Altrei,51,,3,3,6
003 Altrei,52,,2,2,4
003 Altrei,53,,1,3,4
003 Altrei,54,,4,-,4
003 Altrei,55,,2,3,5
003 Altrei,56,,1,3,4
003 Altrei,57,,3,1,4
003 Altrei,58,,1,2,3
003 Altrei,59,,2,4,6
003 Altrei,60,,1,3,4
003 Altrei,61,,1,-,1
003 Altrei,62,,2,1,3
003 Altrei,63,,2,1,3
003 Altrei,64,,3,2,5
003 Altrei,65,,-,2,2
003 Altrei,66,,3,3,6
003 Altrei,67,,-,3,3
003 Altrei,68,,-,2,2
003 Altrei,69,,5,2,7
003 Altrei,70,,2,3,5
003 Altrei,71,,-,2,2
003 Altrei,72,,3,4,7
003 Altrei,73,,2,4,6
003 Altrei,74,,-,3,3
003 Altrei,75,,1,3,4
003 Altrei,76,,1,2,3
003 Altrei,77,,2,2,4
003 Altrei,78,,-,2,2
003 Altrei,79,,2,1,3
003 Altrei,80,,-,1,1
003 Altrei,81,,-,1,1
003 Altrei,82,,-,3,3
003 Altrei,84,,-,1,1
003 Altrei,85,,1,3,4
003 Altrei,86,,1,1,2
003 Altrei,87,,3,-,3
003 Altrei,88,,-,2,2
003 Altrei,91,,-,1,1
003 Altrei,93,,1,-,1
003 Altrei,100,,-,1,1
004 Eppan a.d. Weinstr.,0,,72,62,134
004 Eppan a.d. Weinstr.,1,,86,79,165
004 Eppan a.d. Weinstr.,2,,75,69,144
004 Eppan a.d. Weinstr.,3,,78,73,151
004 Eppan a.d. Weinstr.,4,,71,60,131
004 Eppan a.d. Weinstr.,5,,71,71,142
004 Eppan a.d. Weinstr.,6,,74,85,159
004 Eppan a.d. Weinstr.,7,,65,71,136
004 Eppan a.d. Weinstr.,8,,76,60,136
004 Eppan a.d. Weinstr.,9,,82,62,144
004 Eppan a.d. Weinstr.,10,,77,58,135
004 Eppan a.d. Weinstr.,11,,76,81,157
004 Eppan a.d. Weinstr.,12,,70,61,131
004 Eppan a.d. Weinstr.,13,,79,69,148
004 Eppan a.d. Weinstr.,14,,78,55,133
004 Eppan a.d. Weinstr.,15,,77,75,152
004 Eppan a.d. Weinstr.,16,,62,63,125
004 Eppan a.d. Weinstr.,17,,67,64,131
004 Eppan a.d. Weinstr.,18,,54,68,122
004 Eppan a.d. Weinstr.,19,,78,67,145
004 Eppan a.d. Weinstr.,20,,69,63,132
004 Eppan a.d. Weinstr.,21,,78,72,150
004 Eppan a.d. Weinstr.,22,,81,49,130
004 Eppan a.d. Weinstr.,23,,70,67,137
004 Eppan a.d. Weinstr.,24,,83,82,165
004 Eppan a.d. Weinstr.,25,,71,84,155
004 Eppan a.d. Weinstr.,26,,84,84,168
004 Eppan a.d. Weinstr.,27,,88,112,200
004 Eppan a.d. Weinstr.,28,,114,98,212
004 Eppan a.d. Weinstr.,29,,128,122,250
004 Eppan a.d. Weinstr.,30,,126,118,244
004 Eppan a.d. Weinstr.,31,,109,102,211
004 Eppan a.d. Weinstr.,32,,125,115,240
004 Eppan a.d. Weinstr.,33,,117,137,254
004 Eppan a.d. Weinstr.,34,,109,111,220
004 Eppan a.d. Weinstr.,35,,122,113,235
004 Eppan a.d. Weinstr.,36,,100,128,228
004 Eppan a.d. Weinstr.,37,,117,110,227
004 Eppan a.d. Weinstr.,38,,124,100,224
004 Eppan a.d. Weinstr.,39,,104,114,218
004 Eppan a.d. Weinstr.,40,,120,106,226
004 Eppan a.d. Weinstr.,41,,103,98,201
004 Eppan a.d. Weinstr.,42,,97,93,190
004 Eppan a.d. Weinstr.,43,,88,74,162
004 Eppan a.d. Weinstr.,44,,83,93,176
004 Eppan a.d. Weinstr.,45,,64,92,156
004 Eppan a.d. Weinstr.,46,,88,73,161
004 Eppan a.d. Weinstr.,47,,71,81,152
004 Eppan a.d. Weinstr.,48,,81,65,146
004 Eppan a.d. Weinstr.,49,,64,72,136
004 Eppan a.d. Weinstr.,50,,66,65,131
004 Eppan a.d. Weinstr.,51,,84,68,152
004 Eppan a.d. Weinstr.,52,,71,82,153
004 Eppan a.d. Weinstr.,53,,86,72,158
004 Eppan a.d. Weinstr.,54,,64,51,115
004 Eppan a.d. Weinstr.,55,,71,83,154
004 Eppan a.d. Weinstr.,56,,98,82,180
004 Eppan a.d. Weinstr.,57,,99,81,180
004 Eppan a.d. Weinstr.,58,,69,108,177
004 Eppan a.d. Weinstr.,59,,80,64,144
004 Eppan a.d. Weinstr.,60,,61,83,144
004 Eppan a.d. Weinstr.,61,,60,53,113
004 Eppan a.d. Weinstr.,62,,49,57,106
004 Eppan a.d. Weinstr.,63,,49,52,101
004 Eppan a.d. Weinstr.,64,,45,47,92
004 Eppan a.d. Weinstr.,65,,36,59,95
004 Eppan a.d. Weinstr.,66,,57,60,117
004 Eppan a.d. Weinstr.,67,,51,51,102
004 Eppan a.d. Weinstr.,68,,43,63,106
004 Eppan a.d. Weinstr.,69,,55,69,124
004 Eppan a.d. Weinstr.,70,,51,54,105
004 Eppan a.d. Weinstr.,71,,43,49,92
004 Eppan a.d. Weinstr.,72,,36,50,86
004 Eppan a.d. Weinstr.,73,,44,48,92
004 Eppan a.d. Weinstr.,74,,42,61,103
004 Eppan a.d. Weinstr.,75,,28,70,98
004 Eppan a.d. Weinstr.,76,,26,47,73
004 Eppan a.d. Weinstr.,77,,24,47,71
004 Eppan a.d. Weinstr.,78,,30,50,80
004 Eppan a.d. Weinstr.,79,,19,33,52
004 Eppan a.d. Weinstr.,80,,19,30,49
004 Eppan a.d. Weinstr.,81,,12,19,31
004 Eppan a.d. Weinstr.,82,,13,14,27
004 Eppan a.d. Weinstr.,83,,10,18,28
004 Eppan a.d. Weinstr.,84,,14,15,29
004 Eppan a.d. Weinstr.,85,,13,34,47
004 Eppan a.d. Weinstr.,86,,9,27,36
004 Eppan a.d. Weinstr.,87,,7,22,29
004 Eppan a.d. Weinstr.,88,,7,28,35
004 Eppan a.d. Weinstr.,89,,2,16,18
004 Eppan a.d. Weinstr.,90,,3,9,12
004 Eppan a.d. Weinstr.,91,,1,11,12
004 Eppan a.d. Weinstr.,92,,3,10,13
004 Eppan a.d. Weinstr.,93,,3,3,6
004 Eppan a.d. Weinstr.,94,,1,3,4
004 Eppan a.d. Weinstr.,95,,-,4,4
004 Eppan a.d. Weinstr.,96,,-,3,3
004 Eppan a.d. Weinstr.,97,,-,2,2
004 Eppan a.d. Weinstr.,99,,1,-,1
005 Hafling,0,,4,2,6
005 Hafling,1,,1,7,8
005 Hafling,2,,1,10,11
005 Hafling,3,,11,4,15
005 Hafling,4,,7,5,12
005 Hafling,5,,4,6,10
005 Hafling,6,,3,7,10
005 Hafling,7,,3,5,8
005 Hafling,8,,8,2,10
005 Hafling,9,,5,6,11
005 Hafling,10,,4,2,6
005 Hafling,11,,2,7,9
005 Hafling,12,,4,3,7
005 Hafling,13,,5,3,8
005 Hafling,14,,5,5,10
005 Hafling,15,,5,7,12
005 Hafling,16,,3,-,3
005 Hafling,17,,7,4,11
005 Hafling,18,,4,4,8
005 Hafling,19,,4,10,14
005 Hafling,20,,4,5,9
005 Hafling,21,,3,4,7
005 Hafling,22,,3,2,5
005 Hafling,23,,5,5,10
005 Hafling,24,,7,4,11
005 Hafling,25,,8,6,14
005 Hafling,26,,9,2,11
005 Hafling,27,,8,1,9
005 Hafling,28,,9,5,14
005 Hafling,29,,5,8,13
005 Hafling,30,,7,10,17
005 Hafling,31,,4,9,13
005 Hafling,32,,7,3,10
005 Hafling,33,,11,7,18
005 Hafling,34,,6,10,16
005 Hafling,35,,4,2,6
005 Hafling,36,,6,3,9
005 Hafling,37,,4,4,8
005 Hafling,38,,7,4,11
005 Hafling,39,,9,7,16
005 Hafling,40,,6,5,11
005 Hafling,41,,2,4,6
005 Hafling,42,,1,5,6
005 Hafling,43,,3,9,12
005 Hafling,44,,7,3,10
005 Hafling,45,,3,1,4
005 Hafling,46,,2,3,5
005 Hafling,47,,4,2,6
005 Hafling,48,,2,3,5
005 Hafling,49,,4,3,7
005 Hafling,50,,5,3,8
005 Hafling,51,,8,2,10
005 Hafling,52,,3,4,7
005 Hafling,53,,1,4,5
005 Hafling,54,,5,2,7
005 Hafling,55,,1,2,3
005 Hafling,56,,5,5,10
005 Hafling,57,,5,3,8
005 Hafling,58,,5,4,9
005 Hafling,59,,2,1,3
005 Hafling,60,,3,5,8
005 Hafling,61,,2,3,5
005 Hafling,62,,4,2,6
005 Hafling,63,,1,1,2
005 Hafling,64,,1,1,2
005 Hafling,65,,1,2,3
005 Hafling,66,,6,3,9
005 Hafling,67,,3,4,7
005 Hafling,68,,3,7,10
005 Hafling,69,,2,4,6
005 Hafling,70,,4,1,5
005 Hafling,71,,5,3,8
005 Hafling,72,,4,5,9
005 Hafling,73,,1,2,3
005 Hafling,74,,2,-,2
005 Hafling,75,,1,3,4
005 Hafling,76,,1,-,1
005 Hafling,77,,-,3,3
005 Hafling,78,,-,4,4
005 Hafling,79,,3,1,4
005 Hafling,80,,1,2,3
005 Hafling,82,,-,1,1
005 Hafling,83,,1,2,3
005 Hafling,84,,1,-,1
005 Hafling,85,,1,-,1
005 Hafling,86,,-,3,3
005 Hafling,87,,-,1,1
005 Hafling,88,,1,2,3
005 Hafling,90,,2,-,2
005 Hafling,93,,-,1,1
006 Abtei,0,,21,24,45
006 Abtei,1,,13,12,25
006 Abtei,2,,24,22,46
006 Abtei,3,,29,14,43
006 Abtei,4,,24,25,49
006 Abtei,5,,17,14,31
006 Abtei,6,,16,19,35
006 Abtei,7,,24,16,40
006 Abtei,8,,21,12,33
006 Abtei,9,,22,16,38
006 Abtei,10,,15,14,29
006 Abtei,11,,14,9,23
006 Abtei,12,,18,12,30
006 Abtei,13,,17,18,35
006 Abtei,14,,11,14,25
006 Abtei,15,,11,20,31
006 Abtei,16,,14,11,25
006 Abtei,17,,18,19,37
006 Abtei,18,,17,18,35
006 Abtei,19,,23,15,38
006 Abtei,20,,10,22,32
006 Abtei,21,,22,27,49
006 Abtei,22,,20,27,47
006 Abtei,23,,25,24,49
006 Abtei,24,,18,26,44
006 Abtei,25,,20,25,45
006 Abtei,26,,24,24,48
006 Abtei,27,,40,28,68
006 Abtei,28,,16,33,49
006 Abtei,29,,29,33,62
006 Abtei,30,,27,34,61
006 Abtei,31,,23,33,56
006 Abtei,32,,36,36,72
006 Abtei,33,,21,29,50
006 Abtei,34,,34,25,59
006 Abtei,35,,24,30,54
006 Abtei,36,,30,27,57
006 Abtei,37,,23,29,52
006 Abtei,38,,21,28,49
006 Abtei,39,,26,20,46
006 Abtei,40,,26,23,49
006 Abtei,41,,18,24,42
006 Abtei,42,,18,15,33
006 Abtei,43,,21,17,38
006 Abtei,44,,20,15,35
006 Abtei,45,,11,14,25
006 Abtei,46,,15,18,33
006 Abtei,47,,12,12,24
006 Abtei,48,,12,12,24
006 Abtei,49,,15,20,35
006 Abtei,50,,13,18,31
006 Abtei,51,,26,17,43
006 Abtei,52,,16,15,31
006 Abtei,53,,25,19,44
006 Abtei,54,,15,20,35
006 Abtei,55,,14,18,32
006 Abtei,56,,14,11,25
006 Abtei,57,,21,11,32
006 Abtei,58,,17,24,41
006 Abtei,59,,19,20,39
006 Abtei,60,,17,13,30
006 Abtei,61,,16,18,34
006 Abtei,62,,6,19,25
006 Abtei,63,,21,10,31
006 Abtei,64,,13,20,33
006 Abtei,65,,15,18,33
006 Abtei,66,,11,16,27
006 Abtei,67,,9,6,15
006 Abtei,68,,13,13,26
006 Abtei,69,,18,12,30
006 Abtei,70,,10,8,18
006 Abtei,71,,8,15,23
006 Abtei,72,,8,9,17
006 Abtei,73,,9,7,16
006 Abtei,74,,10,7,17
006 Abtei,75,,6,10,16
006 Abtei,76,,7,13,20
006 Abtei,77,,7,6,13
006 Abtei,78,,5,6,11
006 Abtei,79,,4,14,18
006 Abtei,80,,2,5,7
006 Abtei,81,,2,4,6
006 Abtei,82,,-,4,4
006 Abtei,83,,1,3,4
006 Abtei,84,,1,4,5
006 Abtei,85,,1,3,4
006 Abtei,86,,3,2,5
006 Abtei,87,,2,6,8
006 Abtei,88,,1,4,5
006 Abtei,89,,1,5,6
006 Abtei,90,,2,4,6
006 Abtei,91,,-,3,3
006 Abtei,92,,-,1,1
006 Abtei,93,,-,1,1
006 Abtei,97,,1,-,1
006 Abtei,99,,-,1,1
007 Barbian,0,,9,8,17
007 Barbian,1,,15,8,23
007 Barbian,2,,11,5,16
007 Barbian,3,,8,11,19
007 Barbian,4,,10,8,18
007 Barbian,5,,7,4,11
007 Barbian,6,,10,12,22
007 Barbian,7,,11,7,18
007 Barbian,8,,11,10,21
007 Barbian,9,,14,13,27
007 Barbian,10,,8,13,21
007 Barbian,11,,11,5,16
007 Barbian,12,,7,6,13
007 Barbian,13,,13,7,20
007 Barbian,14,,8,9,17
007 Barbian,15,,9,7,16
007 Barbian,16,,11,7,18
007 Barbian,17,,9,5,14
007 Barbian,18,,14,13,27
007 Barbian,19,,8,7,15
007 Barbian,20,,18,13,31
007 Barbian,21,,10,9,19
007 Barbian,22,,6,17,23
007 Barbian,23,,7,12,19
007 Barbian,24,,9,9,18
007 Barbian,25,,14,12,26
007 Barbian,26,,10,17,27
007 Barbian,27,,24,14,38
007 Barbian,28,,15,14,29
007 Barbian,29,,10,12,22
007 Barbian,30,,17,3,20
007 Barbian,31,,11,10,21
007 Barbian,32,,8,8,16
007 Barbian,33,,11,15,26
007 Barbian,34,,9,10,19
007 Barbian,35,,14,13,27
007 Barbian,36,,14,12,26
007 Barbian,37,,15,13,28
007 Barbian,38,,19,10,29
007 Barbian,39,,13,15,28
007 Barbian,40,,12,9,21
007 Barbian,41,,7,8,15
007 Barbian,42,,15,7,22
007 Barbian,43,,5,9,14
007 Barbian,44,,10,8,18
007 Barbian,45,,5,15,20
007 Barbian,46,,10,8,18
007 Barbian,47,,7,5,12
007 Barbian,48,,7,10,17
007 Barbian,49,,12,11,23
007 Barbian,50,,5,5,10
007 Barbian,51,,4,4,8
007 Barbian,52,,6,10,16
007 Barbian,53,,17,7,24
007 Barbian,54,,7,4,11
007 Barbian,55,,12,8,20
007 Barbian,56,,9,6,15
007 Barbian,57,,11,12,23
007 Barbian,58,,8,12,20
007 Barbian,59,,8,3,11
007 Barbian,60,,6,6,12
007 Barbian,61,,5,10,15
007 Barbian,62,,8,8,16
007 Barbian,63,,3,6,9
007 Barbian,64,,3,8,11
007 Barbian,65,,6,5,11
007 Barbian,66,,8,5,13
007 Barbian,67,,4,7,11
007 Barbian,68,,4,9,13
007 Barbian,69,,7,6,13
007 Barbian,70,,8,8,16
007 Barbian,71,,5,10,15
007 Barbian,72,,5,4,9
007 Barbian,73,,4,3,7
007 Barbian,74,,9,3,12
007 Barbian,75,,4,6,10
007 Barbian,76,,3,10,13
007 Barbian,77,,3,6,9
007 Barbian,78,,3,3,6
007 Barbian,79,,4,3,7
007 Barbian,80,,1,4,5
007 Barbian,81,,2,1,3
007 Barbian,82,,-,1,1
007 Barbian,83,,1,1,2
007 Barbian,84,,-,5,5
007 Barbian,85,,4,6,10
007 Barbian,86,,-,4,4
007 Barbian,88,,3,1,4
007 Barbian,89,,3,1,4
007 Barbian,90,,-,1,1
007 Barbian,91,,-,1,1
007 Barbian,95,,-,1,1
008 Bozen,0,,464,433,897
008 Bozen,1,,417,427,844
008 Bozen,2,,443,369,812
008 Bozen,3,,412,419,831
008 Bozen,4,,405,364,769
008 Bozen,5,,436,412,848
008 Bozen,6,,403,389,792
008 Bozen,7,,408,376,784
008 Bozen,8,,457,376,833
008 Bozen,9,,435,388,823
008 Bozen,10,,417,380,797
008 Bozen,11,,403,397,800
008 Bozen,12,,343,378,721
008 Bozen,13,,369,353,722
008 Bozen,14,,398,369,767
008 Bozen,15,,377,373,750
008 Bozen,16,,410,346,756
008 Bozen,17,,409,388,797
008 Bozen,18,,405,390,795
008 Bozen,19,,447,386,833
008 Bozen,20,,409,423,832
008 Bozen,21,,455,424,879
008 Bozen,22,,495,440,935
008 Bozen,23,,522,523,1.045
008 Bozen,24,,628,591,1.219
008 Bozen,25,,660,636,1.296
008 Bozen,26,,685,738,1.423
008 Bozen,27,,790,716,1.506
008 Bozen,28,,885,795,1.680
008 Bozen,29,,850,722,1.572
008 Bozen,30,,901,794,1.695
008 Bozen,31,,834,742,1.576
008 Bozen,32,,834,785,1.619
008 Bozen,33,,895,825,1.720
008 Bozen,34,,914,827,1.741
008 Bozen,35,,911,884,1.795
008 Bozen,36,,794,778,1.572
008 Bozen,37,,795,780,1.575
008 Bozen,38,,792,712,1.504
008 Bozen,39,,710,674,1.384
008 Bozen,40,,705,666,1.371
008 Bozen,41,,696,677,1.373
008 Bozen,42,,652,704,1.356
008 Bozen,43,,655,648,1.303
008 Bozen,44,,656,632,1.288
008 Bozen,45,,646,588,1.234
008 Bozen,46,,562,603,1.165
008 Bozen,47,,570,640,1.210
008 Bozen,48,,559,641,1.200
008 Bozen,49,,621,678,1.299
008 Bozen,50,,645,656,1.301
008 Bozen,51,,677,729,1.406
008 Bozen,52,,682,816,1.498
008 Bozen,53,,764,892,1.656
008 Bozen,54,,579,611,1.190
008 Bozen,55,,631,753,1.384
008 Bozen,56,,664,748,1.412
008 Bozen,57,,689,749,1.438
008 Bozen,58,,757,789,1.546
008 Bozen,59,,717,768,1.485
008 Bozen,60,,630,757,1.387
008 Bozen,61,,691,687,1.378
008 Bozen,62,,585,610,1.195
008 Bozen,63,,544,599,1.143
008 Bozen,64,,520,604,1.124
008 Bozen,65,,531,600,1.131
008 Bozen,66,,456,599,1.055
008 Bozen,67,,487,610,1.097
008 Bozen,68,,488,598,1.086
008 Bozen,69,,494,613,1.107
008 Bozen,70,,398,596,994
008 Bozen,71,,422,550,972
008 Bozen,72,,389,548,937
008 Bozen,73,,450,540,990
008 Bozen,74,,349,576,925
008 Bozen,75,,337,559,896
008 Bozen,76,,364,561,925
008 Bozen,77,,342,589,931
008 Bozen,78,,281,544,825
008 Bozen,79,,270,532,802
008 Bozen,80,,146,329,475
008 Bozen,81,,95,206,301
008 Bozen,82,,108,208,316
008 Bozen,83,,109,220,329
008 Bozen,84,,144,310,454
008 Bozen,85,,138,283,421
008 Bozen,86,,131,285,416
008 Bozen,87,,111,263,374
008 Bozen,88,,75,219,294
008 Bozen,89,,64,157,221
008 Bozen,90,,45,140,185
008 Bozen,91,,40,119,159
008 Bozen,92,,14,89,103
008 Bozen,93,,17,72,89
008 Bozen,94,,9,42,51
008 Bozen,95,,4,36,40
008 Bozen,96,,1,31,32
008 Bozen,97,,4,16,20
008 Bozen,98,,2,9,11
008 Bozen,99,,1,6,7
008 Bozen,100,,1,3,4
008 Bozen,101,,1,3,4
008 Bozen,102,,1,2,3
008 Bozen,103,,-,1,1
009 Prags,0,,5,5,10
009 Prags,1,,1,5,6
009 Prags,2,,4,4,8
009 Prags,3,,2,4,6
009 Prags,4,,2,2,4
009 Prags,5,,4,5,9
009 Prags,6,,7,4,11
009 Prags,7,,6,3,9
009 Prags,8,,9,2,11
009 Prags,9,,4,2,6
009 Prags,10,,9,3,12
009 Prags,11,,2,3,5
009 Prags,12,,3,3,6
009 Prags,13,,6,5,11
009 Prags,14,,8,2,10
009 Prags,15,,4,3,7
009 Prags,16,,3,7,10
009 Prags,17,,3,5,8
009 Prags,18,,1,6,7
009 Prags,19,,4,2,6
009 Prags,20,,2,1,3
009 Prags,21,,6,3,9
009 Prags,22,,4,3,7
009 Prags,23,,6,2,8
009 Prags,24,,2,6,8
009 Prags,25,,4,3,7
009 Prags,26,,7,8,15
009 Prags,27,,4,-,4
009 Prags,28,,5,3,8
009 Prags,29,,5,5,10
009 Prags,30,,6,5,11
009 Prags,31,,7,8,15
009 Prags,32,,5,8,13
009 Prags,33,,8,4,12
009 Prags,34,,8,8,16
009 Prags,35,,6,5,11
009 Prags,36,,7,5,12
009 Prags,37,,4,5,9
009 Prags,38,,5,10,15
009 Prags,39,,7,3,10
009 Prags,40,,12,5,17
009 Prags,41,,6,2,8
009 Prags,42,,5,4,9
009 Prags,43,,3,5,8
009 Prags,44,,3,4,7
009 Prags,45,,6,4,10
009 Prags,46,,4,2,6
009 Prags,47,,2,5,7
009 Prags,48,,3,1,4
009 Prags,49,,5,1,6
009 Prags,50,,1,2,3
009 Prags,51,,5,1,6
009 Prags,52,,1,-,1
009 Prags,53,,2,4,6
009 Prags,54,,2,2,4
009 Prags,55,,4,5,9
009 Prags,56,,1,4,5
009 Prags,57,,4,4,8
009 Prags,58,,5,2,7
009 Prags,59,,1,3,4
009 Prags,60,,3,5,8
009 Prags,61,,4,3,7
009 Prags,62,,1,3,4
009 Prags,63,,2,3,5
009 Prags,64,,2,4,6
009 Prags,65,,3,2,5
009 Prags,66,,5,2,7
009 Prags,67,,5,7,12
009 Prags,68,,1,4,5
009 Prags,69,,2,1,3
009 Prags,70,,3,1,4
009 Prags,71,,3,2,5
009 Prags,72,,3,7,10
009 Prags,73,,3,4,7
009 Prags,74,,1,5,6
009 Prags,75,,4,2,6
009 Prags,76,,-,5,5
009 Prags,77,,3,2,5
009 Prags,78,,2,3,5
009 Prags,79,,1,1,2
009 Prags,80,,1,3,4
009 Prags,81,,-,1,1
009 Prags,82,,2,2,4
009 Prags,83,,-,1,1
009 Prags,84,,1,1,2
009 Prags,85,,-,1,1
009 Prags,86,,-,1,1
009 Prags,87,,-,1,1
009 Prags,88,,-,1,1
009 Prags,90,,1,-,1
009 Prags,91,,-,1,1
010 Brenner,0,,11,15,26
010 Brenner,1,,18,4,22
010 Brenner,2,,14,6,20
010 Brenner,3,,7,10,17
010 Brenner,4,,9,7,16
010 Brenner,5,,21,13,34
010 Brenner,6,,10,9,19
010 Brenner,7,,10,8,18
010 Brenner,8,,7,19,26
010 Brenner,9,,11,8,19
010 Brenner,10,,15,4,19
010 Brenner,11,,11,5,16
010 Brenner,12,,6,10,16
010 Brenner,13,,11,11,22
010 Brenner,14,,19,9,28
010 Brenner,15,,15,18,33
010 Brenner,16,,18,19,37
010 Brenner,17,,14,7,21
010 Brenner,18,,8,15,23
010 Brenner,19,,10,15,25
010 Brenner,20,,12,9,21
010 Brenner,21,,16,11,27
010 Brenner,22,,18,12,30
010 Brenner,23,,18,12,30
010 Brenner,24,,15,19,34
010 Brenner,25,,18,11,29
010 Brenner,26,,15,19,34
010 Brenner,27,,21,24,45
010 Brenner,28,,30,14,44
010 Brenner,29,,27,20,47
010 Brenner,30,,20,18,38
010 Brenner,31,,17,21,38
010 Brenner,32,,21,19,40
010 Brenner,33,,19,13,32
010 Brenner,34,,24,20,44
010 Brenner,35,,26,16,42
010 Brenner,36,,15,21,36
010 Brenner,37,,19,13,32
010 Brenner,38,,26,13,39
010 Brenner,39,,25,14,39
010 Brenner,40,,21,13,34
010 Brenner,41,,18,10,28
010 Brenner,42,,18,18,36
010 Brenner,43,,18,13,31
010 Brenner,44,,15,9,24
010 Brenner,45,,10,16,26
010 Brenner,46,,10,16,26
010 Brenner,47,,20,10,30
010 Brenner,48,,19,11,30
010 Brenner,49,,14,13,27
010 Brenner,50,,18,16,34
010 Brenner,51,,5,8,13
010 Brenner,52,,21,13,34
010 Brenner,53,,11,17,28
010 Brenner,54,,8,8,16
010 Brenner,55,,20,13,33
010 Brenner,56,,22,14,36
010 Brenner,57,,7,9,16
010 Brenner,58,,11,12,23
010 Brenner,59,,12,12,24
010 Brenner,60,,13,7,20
010 Brenner,61,,11,17,28
010 Brenner,62,,9,14,23
010 Brenner,63,,13,6,19
010 Brenner,64,,7,6,13
010 Brenner,65,,10,9,19
010 Brenner,66,,7,8,15
010 Brenner,67,,2,4,6
010 Brenner,68,,10,11,21
010 Brenner,69,,8,12,20
010 Brenner,70,,12,10,22
010 Brenner,71,,10,11,21
010 Brenner,72,,8,4,12
010 Brenner,73,,11,10,21
010 Brenner,74,,4,11,15
010 Brenner,75,,3,10,13
010 Brenner,76,,5,10,15
010 Brenner,77,,1,9,10
010 Brenner,78,,3,4,7
010 Brenner,79,,5,9,14
010 Brenner,80,,3,2,5
010 Brenner,81,,2,1,3
010 Brenner,82,,1,6,7
010 Brenner,83,,2,-,2
010 Brenner,84,,2,3,5
010 Brenner,85,,1,6,7
010 Brenner,86,,-,4,4
010 Brenner,87,,-,4,4
010 Brenner,88,,4,1,5
010 Brenner,89,,1,3,4
010 Brenner,90,,-,2,2
010 Brenner,91,,1,-,1
010 Brenner,93,,-,1,1
010 Brenner,94,,1,-,1
010 Brenner,95,,-,1,1
010 Brenner,97,,-,1,1
011 Brixen,0,,125,114,239
011 Brixen,1,,112,140,252
011 Brixen,2,,106,92,198
011 Brixen,3,,114,107,221
011 Brixen,4,,106,106,212
011 Brixen,5,,117,113,230
011 Brixen,6,,99,98,197
011 Brixen,7,,111,116,227
011 Brixen,8,,107,105,212
011 Brixen,9,,97,104,201
011 Brixen,10,,107,89,196
011 Brixen,11,,109,96,205
011 Brixen,12,,98,89,187
011 Brixen,13,,97,109,206
011 Brixen,14,,114,90,204
011 Brixen,15,,113,86,199
011 Brixen,16,,111,121,232
011 Brixen,17,,115,101,216
011 Brixen,18,,108,95,203
011 Brixen,19,,96,101,197
011 Brixen,20,,119,94,213
011 Brixen,21,,83,99,182
011 Brixen,22,,116,105,221
011 Brixen,23,,129,113,242
011 Brixen,24,,108,105,213
011 Brixen,25,,128,126,254
011 Brixen,26,,141,139,280
011 Brixen,27,,136,138,274
011 Brixen,28,,144,153,297
011 Brixen,29,,168,155,323
011 Brixen,30,,183,188,371
011 Brixen,31,,173,168,341
011 Brixen,32,,171,158,329
011 Brixen,33,,178,185,363
011 Brixen,34,,185,149,334
011 Brixen,35,,181,181,362
011 Brixen,36,,152,168,320
011 Brixen,37,,162,157,319
011 Brixen,38,,135,165,300
011 Brixen,39,,156,145,301
011 Brixen,40,,146,139,285
011 Brixen,41,,161,111,272
011 Brixen,42,,134,133,267
011 Brixen,43,,108,137,245
011 Brixen,44,,119,95,214
011 Brixen,45,,100,107,207
011 Brixen,46,,85,104,189
011 Brixen,47,,107,100,207
011 Brixen,48,,102,105,207
011 Brixen,49,,110,102,212
011 Brixen,50,,82,122,204
011 Brixen,51,,117,120,237
011 Brixen,52,,90,110,200
011 Brixen,53,,107,112,219
011 Brixen,54,,69,98,167
011 Brixen,55,,119,107,226
011 Brixen,56,,137,122,259
011 Brixen,57,,96,98,194
011 Brixen,58,,111,122,233
011 Brixen,59,,88,124,212
011 Brixen,60,,102,108,210
011 Brixen,61,,94,99,193
011 Brixen,62,,89,100,189
011 Brixen,63,,73,92,165
011 Brixen,64,,80,85,165
011 Brixen,65,,85,99,184
011 Brixen,66,,82,70,152
011 Brixen,67,,75,84,159
011 Brixen,68,,78,89,167
011 Brixen,69,,78,99,177
011 Brixen,70,,61,104,165
011 Brixen,71,,70,80,150
011 Brixen,72,,50,98,148
011 Brixen,73,,52,80,132
011 Brixen,74,,61,84,145
011 Brixen,75,,53,86,139
011 Brixen,76,,51,67,118
011 Brixen,77,,44,87,131
011 Brixen,78,,37,84,121
011 Brixen,79,,38,69,107
011 Brixen,80,,26,51,77
011 Brixen,81,,18,36,54
011 Brixen,82,,16,42,58
011 Brixen,83,,11,28,39
011 Brixen,84,,13,34,47
011 Brixen,85,,24,47,71
011 Brixen,86,,11,46,57
011 Brixen,87,,17,43,60
011 Brixen,88,,8,41,49
011 Brixen,89,,12,38,50
011 Brixen,90,,8,18,26
011 Brixen,91,,7,21,28
011 Brixen,92,,3,16,19
011 Brixen,93,,1,12,13
011 Brixen,94,,3,7,10
011 Brixen,95,,1,3,4
011 Brixen,97,,-,4,4
011 Brixen,98,,-,7,7
011 Brixen,99,,-,4,4
012 Branzoll,0,,10,14,24
012 Branzoll,1,,12,10,22
012 Branzoll,2,,12,20,32
012 Branzoll,3,,15,9,24
012 Branzoll,4,,12,11,23
012 Branzoll,5,,16,8,24
012 Branzoll,6,,16,14,30
012 Branzoll,7,,12,11,23
012 Branzoll,8,,11,17,28
012 Branzoll,9,,8,17,25
012 Branzoll,10,,11,12,23
012 Branzoll,11,,15,12,27
012 Branzoll,12,,12,5,17
012 Branzoll,13,,8,12,20
012 Branzoll,14,,12,14,26
012 Branzoll,15,,14,11,25
012 Branzoll,16,,12,11,23
012 Branzoll,17,,15,12,27
012 Branzoll,18,,14,13,27
012 Branzoll,19,,8,14,22
012 Branzoll,20,,11,5,16
012 Branzoll,21,,10,15,25
012 Branzoll,22,,10,14,24
012 Branzoll,23,,13,12,25
012 Branzoll,24,,15,10,25
012 Branzoll,25,,16,21,37
012 Branzoll,26,,23,16,39
012 Branzoll,27,,17,12,29
012 Branzoll,28,,17,17,34
012 Branzoll,29,,18,26,44
012 Branzoll,30,,22,18,40
012 Branzoll,31,,21,19,40
012 Branzoll,32,,22,20,42
012 Branzoll,33,,20,22,42
012 Branzoll,34,,19,24,43
012 Branzoll,35,,31,24,55
012 Branzoll,36,,19,17,36
012 Branzoll,37,,19,17,36
012 Branzoll,38,,30,27,57
012 Branzoll,39,,22,20,42
012 Branzoll,40,,12,23,35
012 Branzoll,41,,20,16,36
012 Branzoll,42,,27,18,45
012 Branzoll,43,,14,16,30
012 Branzoll,44,,16,17,33
012 Branzoll,45,,22,15,37
012 Branzoll,46,,13,21,34
012 Branzoll,47,,14,18,32
012 Branzoll,48,,15,15,30
012 Branzoll,49,,18,15,33
012 Branzoll,50,,15,15,30
012 Branzoll,51,,14,17,31
012 Branzoll,52,,13,15,28
012 Branzoll,53,,14,19,33
012 Branzoll,54,,15,8,23
012 Branzoll,55,,10,11,21
012 Branzoll,56,,15,13,28
012 Branzoll,57,,19,7,26
012 Branzoll,58,,18,12,30
012 Branzoll,59,,11,13,24
012 Branzoll,60,,16,13,29
012 Branzoll,61,,9,11,20
012 Branzoll,62,,5,11,16
012 Branzoll,63,,10,10,20
012 Branzoll,64,,7,10,17
012 Branzoll,65,,5,12,17
012 Branzoll,66,,20,12,32
012 Branzoll,67,,10,11,21
012 Branzoll,68,,3,10,13
012 Branzoll,69,,9,17,26
012 Branzoll,70,,7,11,18
012 Branzoll,71,,7,11,18
012 Branzoll,72,,4,8,12
012 Branzoll,73,,11,11,22
012 Branzoll,74,,5,6,11
012 Branzoll,75,,4,9,13
012 Branzoll,76,,10,11,21
012 Branzoll,77,,4,5,9
012 Branzoll,78,,5,10,15
012 Branzoll,79,,1,6,7
012 Branzoll,80,,2,6,8
012 Branzoll,81,,3,5,8
012 Branzoll,82,,-,3,3
012 Branzoll,83,,3,1,4
012 Branzoll,84,,3,3,6
012 Branzoll,85,,-,5,5
012 Branzoll,86,,3,6,9
012 Branzoll,87,,1,4,5
012 Branzoll,88,,2,3,5
012 Branzoll,89,,1,2,3
012 Branzoll,90,,1,4,5
012 Branzoll,91,,-,2,2
012 Branzoll,92,,3,-,3
012 Branzoll,93,,1,-,1
012 Branzoll,94,,-,1,1
013 Bruneck,0,,100,93,193
013 Bruneck,1,,92,86,178
013 Bruneck,2,,106,65,171
013 Bruneck,3,,78,83,161
013 Bruneck,4,,62,74,136
013 Bruneck,5,,89,73,162
013 Bruneck,6,,74,73,147
013 Bruneck,7,,88,71,159
013 Bruneck,8,,83,54,137
013 Bruneck,9,,84,71,155
013 Bruneck,10,,74,76,150
013 Bruneck,11,,62,73,135
013 Bruneck,12,,59,60,119
013 Bruneck,13,,103,69,172
013 Bruneck,14,,75,66,141
013 Bruneck,15,,75,71,146
013 Bruneck,16,,66,73,139
013 Bruneck,17,,70,73,143
013 Bruneck,18,,84,87,171
013 Bruneck,19,,97,90,187
013 Bruneck,20,,86,95,181
013 Bruneck,21,,111,86,197
013 Bruneck,22,,99,81,180
013 Bruneck,23,,91,96,187
013 Bruneck,24,,95,111,206
013 Bruneck,25,,112,94,206
013 Bruneck,26,,118,121,239
013 Bruneck,27,,120,118,238
013 Bruneck,28,,136,126,262
013 Bruneck,29,,116,137,253
013 Bruneck,30,,125,116,241
013 Bruneck,31,,116,139,255
013 Bruneck,32,,132,113,245
013 Bruneck,33,,130,112,242
013 Bruneck,34,,137,131,268
013 Bruneck,35,,130,128,258
013 Bruneck,36,,122,116,238
013 Bruneck,37,,120,109,229
013 Bruneck,38,,113,96,209
013 Bruneck,39,,102,114,216
013 Bruneck,40,,106,101,207
013 Bruneck,41,,104,103,207
013 Bruneck,42,,82,100,182
013 Bruneck,43,,85,91,176
013 Bruneck,44,,84,80,164
013 Bruneck,45,,91,87,178
013 Bruneck,46,,70,99,169
013 Bruneck,47,,85,99,184
013 Bruneck,48,,74,90,164
013 Bruneck,49,,87,94,181
013 Bruneck,50,,87,90,177
013 Bruneck,51,,84,109,193
013 Bruneck,52,,96,69,165
013 Bruneck,53,,99,85,184
013 Bruneck,54,,59,68,127
013 Bruneck,55,,92,92,184
013 Bruneck,56,,100,88,188
013 Bruneck,57,,95,89,184
013 Bruneck,58,,80,94,174
013 Bruneck,59,,82,86,168
013 Bruneck,60,,86,90,176
013 Bruneck,61,,60,51,111
013 Bruneck,62,,56,62,118
013 Bruneck,63,,57,55,112
013 Bruneck,64,,50,51,101
013 Bruneck,65,,50,50,100
013 Bruneck,66,,58,65,123
013 Bruneck,67,,60,51,111
013 Bruneck,68,,41,54,95
013 Bruneck,69,,43,65,108
013 Bruneck,70,,40,59,99
013 Bruneck,71,,47,61,108
013 Bruneck,72,,33,52,85
013 Bruneck,73,,31,40,71
013 Bruneck,74,,31,47,78
013 Bruneck,75,,21,63,84
013 Bruneck,76,,38,49,87
013 Bruneck,77,,32,49,81
013 Bruneck,78,,24,33,57
013 Bruneck,79,,21,43,64
013 Bruneck,80,,16,34,50
013 Bruneck,81,,8,24,32
013 Bruneck,82,,6,21,27
013 Bruneck,83,,6,30,36
013 Bruneck,84,,9,22,31
013 Bruneck,85,,12,23,35
013 Bruneck,86,,8,37,45
013 Bruneck,87,,13,25,38
013 Bruneck,88,,5,22,27
013 Bruneck,89,,7,18,25
013 Bruneck,90,,10,14,24
013 Bruneck,91,,4,14,18
013 Bruneck,92,,4,9,13
013 Bruneck,93,,3,10,13
013 Bruneck,94,,3,3,6
013 Bruneck,95,,1,1,2
013 Bruneck,96,,1,4,5
013 Bruneck,97,,-,3,3
013 Bruneck,99,,-,1,1
013 Bruneck,102,,-,1,1
014 Kuens,0,,3,2,5
014 Kuens,1,,2,4,6
014 Kuens,2,,1,2,3
014 Kuens,3,,5,2,7
014 Kuens,4,,2,3,5
014 Kuens,5,,1,4,5
014 Kuens,6,,3,3,6
014 Kuens,7,,3,2,5
014 Kuens,8,,2,2,4
014 Kuens,9,,3,2,5
014 Kuens,10,,3,2,5
014 Kuens,11,,1,3,4
014 Kuens,12,,3,-,3
014 Kuens,13,,1,-,1
014 Kuens,15,,1,-,1
014 Kuens,16,,2,2,4
014 Kuens,17,,2,-,2
014 Kuens,18,,2,-,2
014 Kuens,19,,3,2,5
014 Kuens,20,,1,1,2
014 Kuens,21,,2,-,2
014 Kuens,22,,2,2,4
014 Kuens,23,,3,2,5
014 Kuens,24,,4,1,5
014 Kuens,25,,4,6,10
014 Kuens,26,,-,4,4
014 Kuens,27,,4,2,6
014 Kuens,28,,1,5,6
014 Kuens,29,,7,2,9
014 Kuens,30,,4,2,6
014 Kuens,31,,3,4,7
014 Kuens,32,,4,8,12
014 Kuens,33,,3,4,7
014 Kuens,34,,8,1,9
014 Kuens,35,,5,5,10
014 Kuens,36,,10,2,12
014 Kuens,37,,5,2,7
014 Kuens,38,,-,4,4
014 Kuens,39,,-,1,1
014 Kuens,40,,1,-,1
014 Kuens,41,,1,4,5
014 Kuens,42,,3,-,3
014 Kuens,43,,3,-,3
014 Kuens,44,,1,2,3
014 Kuens,46,,1,1,2
014 Kuens,47,,-,2,2
014 Kuens,48,,1,-,1
014 Kuens,49,,1,3,4
014 Kuens,50,,2,2,4
014 Kuens,51,,2,1,3
014 Kuens,52,,1,1,2
014 Kuens,53,,1,2,3
014 Kuens,54,,3,1,4
014 Kuens,56,,-,2,2
014 Kuens,57,,-,4,4
014 Kuens,58,,-,2,2
014 Kuens,59,,-,1,1
014 Kuens,60,,4,2,6
014 Kuens,61,,3,2,5
014 Kuens,62,,1,3,4
014 Kuens,63,,2,2,4
014 Kuens,64,,1,3,4
014 Kuens,65,,-,1,1
014 Kuens,66,,2,1,3
014 Kuens,67,,4,2,6
014 Kuens,68,,3,2,5
014 Kuens,69,,3,2,5
014 Kuens,70,,1,-,1
014 Kuens,71,,1,-,1
014 Kuens,72,,1,1,2
014 Kuens,73,,1,-,1
014 Kuens,77,,-,2,2
014 Kuens,80,,-,1,1
014 Kuens,83,,1,1,2
014 Kuens,84,,1,-,1
014 Kuens,86,,-,1,1
014 Kuens,87,,1,-,1
014 Kuens,89,,1,-,1
014 Kuens,91,,-,1,1
014 Kuens,92,,-,1,1
015 Kaltern a.d. Weinstr.,0,,42,29,71
015 Kaltern a.d. Weinstr.,1,,37,40,77
015 Kaltern a.d. Weinstr.,2,,40,44,84
015 Kaltern a.d. Weinstr.,3,,34,41,75
015 Kaltern a.d. Weinstr.,4,,38,37,75
015 Kaltern a.d. Weinstr.,5,,32,38,70
015 Kaltern a.d. Weinstr.,6,,30,37,67
015 Kaltern a.d. Weinstr.,7,,40,36,76
015 Kaltern a.d. Weinstr.,8,,29,42,71
015 Kaltern a.d. Weinstr.,9,,35,36,71
015 Kaltern a.d. Weinstr.,10,,54,24,78
015 Kaltern a.d. Weinstr.,11,,39,35,74
015 Kaltern a.d. Weinstr.,12,,41,31,72
015 Kaltern a.d. Weinstr.,13,,52,41,93
015 Kaltern a.d. Weinstr.,14,,48,36,84
015 Kaltern a.d. Weinstr.,15,,38,34,72
015 Kaltern a.d. Weinstr.,16,,42,38,80
015 Kaltern a.d. Weinstr.,17,,42,44,86
015 Kaltern a.d. Weinstr.,18,,45,35,80
015 Kaltern a.d. Weinstr.,19,,42,39,81
015 Kaltern a.d. Weinstr.,20,,43,38,81
015 Kaltern a.d. Weinstr.,21,,41,31,72
015 Kaltern a.d. Weinstr.,22,,28,40,68
015 Kaltern a.d. Weinstr.,23,,37,48,85
015 Kaltern a.d. Weinstr.,24,,33,44,77
015 Kaltern a.d. Weinstr.,25,,51,43,94
015 Kaltern a.d. Weinstr.,26,,37,47,84
015 Kaltern a.d. Weinstr.,27,,45,55,100
015 Kaltern a.d. Weinstr.,28,,51,41,92
015 Kaltern a.d. Weinstr.,29,,59,57,116
015 Kaltern a.d. Weinstr.,30,,54,64,118
015 Kaltern a.d. Weinstr.,31,,64,65,129
015 Kaltern a.d. Weinstr.,32,,59,55,114
015 Kaltern a.d. Weinstr.,33,,56,64,120
015 Kaltern a.d. Weinstr.,34,,53,61,114
015 Kaltern a.d. Weinstr.,35,,84,56,140
015 Kaltern a.d. Weinstr.,36,,57,55,112
015 Kaltern a.d. Weinstr.,37,,60,62,122
015 Kaltern a.d. Weinstr.,38,,65,60,125
015 Kaltern a.d. Weinstr.,39,,53,62,115
015 Kaltern a.d. Weinstr.,40,,52,49,101
015 Kaltern a.d. Weinstr.,41,,60,56,116
015 Kaltern a.d. Weinstr.,42,,51,56,107
015 Kaltern a.d. Weinstr.,43,,62,44,106
015 Kaltern a.d. Weinstr.,44,,54,38,92
015 Kaltern a.d. Weinstr.,45,,36,46,82
015 Kaltern a.d. Weinstr.,46,,35,37,72
015 Kaltern a.d. Weinstr.,47,,39,53,92
015 Kaltern a.d. Weinstr.,48,,34,33,67
015 Kaltern a.d. Weinstr.,49,,43,34,77
015 Kaltern a.d. Weinstr.,50,,30,37,67
015 Kaltern a.d. Weinstr.,51,,40,39,79
015 Kaltern a.d. Weinstr.,52,,36,58,94
015 Kaltern a.d. Weinstr.,53,,50,39,89
015 Kaltern a.d. Weinstr.,54,,38,37,75
015 Kaltern a.d. Weinstr.,55,,43,45,88
015 Kaltern a.d. Weinstr.,56,,36,37,73
015 Kaltern a.d. Weinstr.,57,,37,42,79
015 Kaltern a.d. Weinstr.,58,,42,43,85
015 Kaltern a.d. Weinstr.,59,,32,41,73
015 Kaltern a.d. Weinstr.,60,,25,34,59
015 Kaltern a.d. Weinstr.,61,,41,43,84
015 Kaltern a.d. Weinstr.,62,,30,34,64
015 Kaltern a.d. Weinstr.,63,,21,25,46
015 Kaltern a.d. Weinstr.,64,,27,27,54
015 Kaltern a.d. Weinstr.,65,,28,26,54
015 Kaltern a.d. Weinstr.,66,,30,37,67
015 Kaltern a.d. Weinstr.,67,,30,31,61
015 Kaltern a.d. Weinstr.,68,,27,38,65
015 Kaltern a.d. Weinstr.,69,,33,41,74
015 Kaltern a.d. Weinstr.,70,,27,32,59
015 Kaltern a.d. Weinstr.,71,,24,35,59
015 Kaltern a.d. Weinstr.,72,,23,40,63
015 Kaltern a.d. Weinstr.,73,,21,32,53
015 Kaltern a.d. Weinstr.,74,,20,39,59
015 Kaltern a.d. Weinstr.,75,,20,32,52
015 Kaltern a.d. Weinstr.,76,,14,34,48
015 Kaltern a.d. Weinstr.,77,,20,33,53
015 Kaltern a.d. Weinstr.,78,,18,37,55
015 Kaltern a.d. Weinstr.,79,,12,28,40
015 Kaltern a.d. Weinstr.,80,,8,18,26
015 Kaltern a.d. Weinstr.,81,,8,10,18
015 Kaltern a.d. Weinstr.,82,,2,13,15
015 Kaltern a.d. Weinstr.,83,,2,8,10
015 Kaltern a.d. Weinstr.,84,,3,17,20
015 Kaltern a.d. Weinstr.,85,,5,14,19
015 Kaltern a.d. Weinstr.,86,,9,18,27
015 Kaltern a.d. Weinstr.,87,,7,23,30
015 Kaltern a.d. Weinstr.,88,,2,10,12
015 Kaltern a.d. Weinstr.,89,,3,6,9
015 Kaltern a.d. Weinstr.,90,,4,9,13
015 Kaltern a.d. Weinstr.,91,,2,4,6
015 Kaltern a.d. Weinstr.,92,,-,5,5
015 Kaltern a.d. Weinstr.,93,,-,2,2
015 Kaltern a.d. Weinstr.,94,,-,3,3
015 Kaltern a.d. Weinstr.,95,,1,2,3
015 Kaltern a.d. Weinstr.,96,,1,2,3
016 Freienfeld,0,,16,21,37
016 Freienfeld,1,,14,15,29
016 Freienfeld,2,,23,15,38
016 Freienfeld,3,,22,13,35
016 Freienfeld,4,,13,13,26
016 Freienfeld,5,,13,9,22
016 Freienfeld,6,,15,11,26
016 Freienfeld,7,,19,21,40
016 Freienfeld,8,,10,13,23
016 Freienfeld,9,,19,18,37
016 Freienfeld,10,,26,21,47
016 Freienfeld,11,,19,14,33
016 Freienfeld,12,,17,15,32
016 Freienfeld,13,,15,13,28
016 Freienfeld,14,,15,14,29
016 Freienfeld,15,,23,15,38
016 Freienfeld,16,,21,19,40
016 Freienfeld,17,,14,16,30
016 Freienfeld,18,,22,21,43
016 Freienfeld,19,,18,15,33
016 Freienfeld,20,,19,18,37
016 Freienfeld,21,,13,17,30
016 Freienfeld,22,,13,18,31
016 Freienfeld,23,,17,10,27
016 Freienfeld,24,,17,24,41
016 Freienfeld,25,,20,19,39
016 Freienfeld,26,,23,20,43
016 Freienfeld,27,,20,26,46
016 Freienfeld,28,,22,21,43
016 Freienfeld,29,,21,13,34
016 Freienfeld,30,,22,22,44
016 Freienfeld,31,,22,23,45
016 Freienfeld,32,,19,28,47
016 Freienfeld,33,,24,18,42
016 Freienfeld,34,,24,15,39
016 Freienfeld,35,,24,19,43
016 Freienfeld,36,,22,16,38
016 Freienfeld,37,,27,30,57
016 Freienfeld,38,,24,21,45
016 Freienfeld,39,,24,21,45
016 Freienfeld,40,,31,15,46
016 Freienfeld,41,,18,18,36
016 Freienfeld,42,,15,17,32
016 Freienfeld,43,,22,15,37
016 Freienfeld,44,,19,9,28
016 Freienfeld,45,,18,18,36
016 Freienfeld,46,,18,10,28
016 Freienfeld,47,,12,19,31
016 Freienfeld,48,,15,12,27
016 Freienfeld,49,,20,11,31
016 Freienfeld,50,,18,13,31
016 Freienfeld,51,,20,12,32
016 Freienfeld,52,,6,12,18
016 Freienfeld,53,,11,16,27
016 Freienfeld,54,,13,2,15
016 Freienfeld,55,,12,6,18
016 Freienfeld,56,,16,10,26
016 Freienfeld,57,,12,9,21
016 Freienfeld,58,,11,11,22
016 Freienfeld,59,,14,4,18
016 Freienfeld,60,,10,10,20
016 Freienfeld,61,,13,11,24
016 Freienfeld,62,,8,11,19
016 Freienfeld,63,,10,13,23
016 Freienfeld,64,,8,12,20
016 Freienfeld,65,,5,7,12
016 Freienfeld,66,,12,8,20
016 Freienfeld,67,,12,10,22
016 Freienfeld,68,,9,9,18
016 Freienfeld,69,,9,8,17
016 Freienfeld,70,,6,8,14
016 Freienfeld,71,,8,7,15
016 Freienfeld,72,,7,9,16
016 Freienfeld,73,,8,15,23
016 Freienfeld,74,,8,10,18
016 Freienfeld,75,,5,6,11
016 Freienfeld,76,,2,16,18
016 Freienfeld,77,,3,10,13
016 Freienfeld,78,,1,3,4
016 Freienfeld,79,,8,5,13
016 Freienfeld,80,,3,4,7
016 Freienfeld,81,,2,5,7
016 Freienfeld,82,,-,5,5
016 Freienfeld,83,,1,3,4
016 Freienfeld,84,,1,4,5
016 Freienfeld,85,,3,8,11
016 Freienfeld,86,,2,3,5
016 Freienfeld,87,,1,2,3
016 Freienfeld,88,,3,5,8
016 Freienfeld,89,,3,2,5
016 Freienfeld,90,,1,1,2
016 Freienfeld,91,,-,3,3
016 Freienfeld,92,,1,3,4
016 Freienfeld,97,,-,1,1
017 Sand in Taufers,0,,36,38,74
017 Sand in Taufers,1,,30,35,65
017 Sand in Taufers,2,,33,35,68
017 Sand in Taufers,3,,25,31,56
017 Sand in Taufers,4,,28,30,58
017 Sand in Taufers,5,,37,33,70
017 Sand in Taufers,6,,25,33,58
017 Sand in Taufers,7,,33,36,69
017 Sand in Taufers,8,,25,33,58
017 Sand in Taufers,9,,25,31,56
017 Sand in Taufers,10,,28,29,57
017 Sand in Taufers,11,,28,29,57
017 Sand in Taufers,12,,22,23,45
017 Sand in Taufers,13,,22,20,42
017 Sand in Taufers,14,,23,25,48
017 Sand in Taufers,15,,31,25,56
017 Sand in Taufers,16,,35,29,64
017 Sand in Taufers,17,,23,38,61
017 Sand in Taufers,18,,34,33,67
017 Sand in Taufers,19,,32,35,67
017 Sand in Taufers,20,,31,37,68
017 Sand in Taufers,21,,38,35,73
017 Sand in Taufers,22,,36,37,73
017 Sand in Taufers,23,,42,36,78
017 Sand in Taufers,24,,43,42,85
017 Sand in Taufers,25,,58,40,98
017 Sand in Taufers,26,,56,38,94
017 Sand in Taufers,27,,51,54,105
017 Sand in Taufers,28,,44,45,89
017 Sand in Taufers,29,,35,50,85
017 Sand in Taufers,30,,56,38,94
017 Sand in Taufers,31,,47,40,87
017 Sand in Taufers,32,,29,44,73
017 Sand in Taufers,33,,51,32,83
017 Sand in Taufers,34,,47,32,79
017 Sand in Taufers,35,,49,44,93
017 Sand in Taufers,36,,51,48,99
017 Sand in Taufers,37,,35,37,72
017 Sand in Taufers,38,,46,40,86
017 Sand in Taufers,39,,44,34,78
017 Sand in Taufers,40,,41,36,77
017 Sand in Taufers,41,,38,21,59
017 Sand in Taufers,42,,22,38,60
017 Sand in Taufers,43,,29,36,65
017 Sand in Taufers,44,,24,22,46
017 Sand in Taufers,45,,28,27,55
017 Sand in Taufers,46,,34,24,58
017 Sand in Taufers,47,,18,29,47
017 Sand in Taufers,48,,29,22,51
017 Sand in Taufers,49,,34,35,69
017 Sand in Taufers,50,,30,22,52
017 Sand in Taufers,51,,22,25,47
017 Sand in Taufers,52,,25,29,54
017 Sand in Taufers,53,,28,26,54
017 Sand in Taufers,54,,29,9,38
017 Sand in Taufers,55,,18,30,48
017 Sand in Taufers,56,,29,31,60
017 Sand in Taufers,57,,30,35,65
017 Sand in Taufers,58,,27,32,59
017 Sand in Taufers,59,,24,20,44
017 Sand in Taufers,60,,26,31,57
017 Sand in Taufers,61,,19,27,46
017 Sand in Taufers,62,,30,12,42
017 Sand in Taufers,63,,17,25,42
017 Sand in Taufers,64,,32,18,50
017 Sand in Taufers,65,,15,14,29
017 Sand in Taufers,66,,16,18,34
017 Sand in Taufers,67,,12,18,30
017 Sand in Taufers,68,,15,14,29
017 Sand in Taufers,69,,15,19,34
017 Sand in Taufers,70,,17,14,31
017 Sand in Taufers,71,,12,15,27
017 Sand in Taufers,72,,17,13,30
017 Sand in Taufers,73,,11,20,31
017 Sand in Taufers,74,,11,14,25
017 Sand in Taufers,75,,8,18,26
017 Sand in Taufers,76,,13,12,25
017 Sand in Taufers,77,,13,18,31
017 Sand in Taufers,78,,8,16,24
017 Sand in Taufers,79,,8,11,19
017 Sand in Taufers,80,,7,10,17
017 Sand in Taufers,81,,3,7,10
017 Sand in Taufers,82,,5,10,15
017 Sand in Taufers,83,,-,5,5
017 Sand in Taufers,84,,3,8,11
017 Sand in Taufers,85,,6,13,19
017 Sand in Taufers,86,,-,10,10
017 Sand in Taufers,87,,2,6,8
017 Sand in Taufers,88,,2,8,10
017 Sand in Taufers,89,,-,2,2
017 Sand in Taufers,90,,2,7,9
017 Sand in Taufers,91,,2,1,3
017 Sand in Taufers,92,,1,4,5
017 Sand in Taufers,93,,1,1,2
017 Sand in Taufers,94,,1,-,1
017 Sand in Taufers,98,,1,-,1
018 Kastelbell-Tschars,0,,25,11,36
018 Kastelbell-Tschars,1,,17,11,28
018 Kastelbell-Tschars,2,,10,8,18
018 Kastelbell-Tschars,3,,12,16,28
018 Kastelbell-Tschars,4,,14,11,25
018 Kastelbell-Tschars,5,,12,15,27
018 Kastelbell-Tschars,6,,13,16,29
018 Kastelbell-Tschars,7,,14,13,27
018 Kastelbell-Tschars,8,,19,14,33
018 Kastelbell-Tschars,9,,16,10,26
018 Kastelbell-Tschars,10,,16,11,27
018 Kastelbell-Tschars,11,,19,7,26
018 Kastelbell-Tschars,12,,19,15,34
018 Kastelbell-Tschars,13,,18,21,39
018 Kastelbell-Tschars,14,,21,15,36
018 Kastelbell-Tschars,15,,8,10,18
018 Kastelbell-Tschars,16,,14,23,37
018 Kastelbell-Tschars,17,,24,15,39
018 Kastelbell-Tschars,18,,15,23,38
018 Kastelbell-Tschars,19,,18,18,36
018 Kastelbell-Tschars,20,,16,16,32
018 Kastelbell-Tschars,21,,14,24,38
018 Kastelbell-Tschars,22,,10,16,26
018 Kastelbell-Tschars,23,,19,18,37
018 Kastelbell-Tschars,24,,15,12,27
018 Kastelbell-Tschars,25,,20,14,34
018 Kastelbell-Tschars,26,,24,18,42
018 Kastelbell-Tschars,27,,16,17,33
018 Kastelbell-Tschars,28,,17,13,30
018 Kastelbell-Tschars,29,,15,18,33
018 Kastelbell-Tschars,30,,25,22,47
018 Kastelbell-Tschars,31,,15,16,31
018 Kastelbell-Tschars,32,,15,21,36
018 Kastelbell-Tschars,33,,22,11,33
018 Kastelbell-Tschars,34,,23,15,38
018 Kastelbell-Tschars,35,,23,14,37
018 Kastelbell-Tschars,36,,23,21,44
018 Kastelbell-Tschars,37,,8,22,30
018 Kastelbell-Tschars,38,,20,18,38
018 Kastelbell-Tschars,39,,24,21,45
018 Kastelbell-Tschars,40,,25,20,45
018 Kastelbell-Tschars,41,,18,14,32
018 Kastelbell-Tschars,42,,15,11,26
018 Kastelbell-Tschars,43,,13,18,31
018 Kastelbell-Tschars,44,,17,20,37
018 Kastelbell-Tschars,45,,9,13,22
018 Kastelbell-Tschars,46,,9,16,25
018 Kastelbell-Tschars,47,,13,17,30
018 Kastelbell-Tschars,48,,16,11,27
018 Kastelbell-Tschars,49,,14,13,27
018 Kastelbell-Tschars,50,,11,7,18
018 Kastelbell-Tschars,51,,14,9,23
018 Kastelbell-Tschars,52,,10,8,18
018 Kastelbell-Tschars,53,,15,13,28
018 Kastelbell-Tschars,54,,10,4,14
018 Kastelbell-Tschars,55,,12,7,19
018 Kastelbell-Tschars,56,,10,8,18
018 Kastelbell-Tschars,57,,10,12,22
018 Kastelbell-Tschars,58,,10,8,18
018 Kastelbell-Tschars,59,,8,10,18
018 Kastelbell-Tschars,60,,13,13,26
018 Kastelbell-Tschars,61,,8,15,23
018 Kastelbell-Tschars,62,,11,10,21
018 Kastelbell-Tschars,63,,11,16,27
018 Kastelbell-Tschars,64,,11,11,22
018 Kastelbell-Tschars,65,,5,16,21
018 Kastelbell-Tschars,66,,18,13,31
018 Kastelbell-Tschars,67,,7,14,21
018 Kastelbell-Tschars,68,,10,14,24
018 Kastelbell-Tschars,69,,23,16,39
018 Kastelbell-Tschars,70,,11,14,25
018 Kastelbell-Tschars,71,,8,11,19
018 Kastelbell-Tschars,72,,10,9,19
018 Kastelbell-Tschars,73,,14,16,30
018 Kastelbell-Tschars,74,,13,13,26
018 Kastelbell-Tschars,75,,5,11,16
018 Kastelbell-Tschars,76,,11,10,21
018 Kastelbell-Tschars,77,,7,9,16
018 Kastelbell-Tschars,78,,4,7,11
018 Kastelbell-Tschars,79,,5,9,14
018 Kastelbell-Tschars,80,,2,5,7
018 Kastelbell-Tschars,81,,1,4,5
018 Kastelbell-Tschars,82,,2,3,5
018 Kastelbell-Tschars,83,,-,3,3
018 Kastelbell-Tschars,84,,6,3,9
018 Kastelbell-Tschars,85,,3,6,9
018 Kastelbell-Tschars,86,,7,4,11
018 Kastelbell-Tschars,87,,1,4,5
018 Kastelbell-Tschars,88,,1,4,5
018 Kastelbell-Tschars,89,,-,3,3
018 Kastelbell-Tschars,90,,1,-,1
018 Kastelbell-Tschars,91,,-,5,5
018 Kastelbell-Tschars,92,,-,1,1
018 Kastelbell-Tschars,95,,1,-,1
018 Kastelbell-Tschars,97,,-,1,1
019 Kastelruth,0,,32,41,73
019 Kastelruth,1,,52,50,102
019 Kastelruth,2,,51,55,106
019 Kastelruth,3,,42,37,79
019 Kastelruth,4,,57,42,99
019 Kastelruth,5,,32,31,63
019 Kastelruth,6,,40,36,76
019 Kastelruth,7,,36,50,86
019 Kastelruth,8,,35,40,75
019 Kastelruth,9,,37,36,73
019 Kastelruth,10,,46,39,85
019 Kastelruth,11,,26,24,50
019 Kastelruth,12,,36,41,77
019 Kastelruth,13,,33,23,56
019 Kastelruth,14,,27,32,59
019 Kastelruth,15,,35,28,63
019 Kastelruth,16,,34,42,76
019 Kastelruth,17,,44,33,77
019 Kastelruth,18,,36,39,75
019 Kastelruth,19,,44,37,81
019 Kastelruth,20,,30,43,73
019 Kastelruth,21,,31,36,67
019 Kastelruth,22,,38,36,74
019 Kastelruth,23,,44,47,91
019 Kastelruth,24,,51,35,86
019 Kastelruth,25,,55,51,106
019 Kastelruth,26,,42,64,106
019 Kastelruth,27,,60,40,100
019 Kastelruth,28,,60,46,106
019 Kastelruth,29,,50,60,110
019 Kastelruth,30,,64,61,125
019 Kastelruth,31,,64,56,120
019 Kastelruth,32,,67,65,132
019 Kastelruth,33,,70,51,121
019 Kastelruth,34,,44,73,117
019 Kastelruth,35,,55,40,95
019 Kastelruth,36,,54,34,88
019 Kastelruth,37,,36,48,84
019 Kastelruth,38,,50,44,94
019 Kastelruth,39,,49,41,90
019 Kastelruth,40,,46,43,89
019 Kastelruth,41,,47,41,88
019 Kastelruth,42,,38,36,74
019 Kastelruth,43,,34,29,63
019 Kastelruth,44,,37,36,73
019 Kastelruth,45,,37,29,66
019 Kastelruth,46,,29,31,60
019 Kastelruth,47,,39,24,63
019 Kastelruth,48,,29,25,54
019 Kastelruth,49,,41,18,59
019 Kastelruth,50,,20,34,54
019 Kastelruth,51,,28,38,66
019 Kastelruth,52,,35,33,68
019 Kastelruth,53,,22,39,61
019 Kastelruth,54,,24,20,44
019 Kastelruth,55,,20,45,65
019 Kastelruth,56,,41,36,77
019 Kastelruth,57,,35,30,65
019 Kastelruth,58,,35,46,81
019 Kastelruth,59,,28,37,65
019 Kastelruth,60,,28,29,57
019 Kastelruth,61,,30,27,57
019 Kastelruth,62,,26,24,50
019 Kastelruth,63,,33,21,54
019 Kastelruth,64,,32,30,62
019 Kastelruth,65,,24,23,47
019 Kastelruth,66,,35,27,62
019 Kastelruth,67,,21,37,58
019 Kastelruth,68,,39,27,66
019 Kastelruth,69,,14,28,42
019 Kastelruth,70,,27,28,55
019 Kastelruth,71,,14,20,34
019 Kastelruth,72,,23,31,54
019 Kastelruth,73,,16,26,42
019 Kastelruth,74,,13,22,35
019 Kastelruth,75,,20,23,43
019 Kastelruth,76,,9,21,30
019 Kastelruth,77,,13,16,29
019 Kastelruth,78,,11,21,32
019 Kastelruth,79,,12,19,31
019 Kastelruth,80,,12,8,20
019 Kastelruth,81,,6,13,19
019 Kastelruth,82,,4,7,11
019 Kastelruth,83,,2,6,8
019 Kastelruth,84,,3,13,16
019 Kastelruth,85,,10,8,18
019 Kastelruth,86,,6,9,15
019 Kastelruth,87,,7,10,17
019 Kastelruth,88,,5,11,16
019 Kastelruth,89,,1,7,8
019 Kastelruth,90,,1,7,8
019 Kastelruth,91,,2,3,5
019 Kastelruth,92,,2,5,7
019 Kastelruth,93,,1,4,5
019 Kastelruth,94,,-,2,2
019 Kastelruth,95,,1,1,2
019 Kastelruth,96,,-,1,1
019 Kastelruth,98,,-,1,1
020 Tscherms,0,,6,4,10
020 Tscherms,1,,5,9,14
020 Tscherms,2,,7,8,15
020 Tscherms,3,,5,5,10
020 Tscherms,4,,9,10,19
020 Tscherms,5,,10,15,25
020 Tscherms,6,,7,7,14
020 Tscherms,7,,11,6,17
020 Tscherms,8,,4,8,12
020 Tscherms,9,,7,5,12
020 Tscherms,10,,3,5,8
020 Tscherms,11,,4,16,20
020 Tscherms,12,,11,5,16
020 Tscherms,13,,9,7,16
020 Tscherms,14,,12,10,22
020 Tscherms,15,,12,5,17
020 Tscherms,16,,10,10,20
020 Tscherms,17,,5,8,13
020 Tscherms,18,,9,7,16
020 Tscherms,19,,6,6,12
020 Tscherms,20,,3,8,11
020 Tscherms,21,,2,7,9
020 Tscherms,22,,7,1,8
020 Tscherms,23,,8,6,14
020 Tscherms,24,,5,4,9
020 Tscherms,25,,7,3,10
020 Tscherms,26,,9,11,20
020 Tscherms,27,,8,2,10
020 Tscherms,28,,9,11,20
020 Tscherms,29,,7,3,10
020 Tscherms,30,,12,17,29
020 Tscherms,31,,16,8,24
020 Tscherms,32,,11,12,23
020 Tscherms,33,,9,9,18
020 Tscherms,34,,13,16,29
020 Tscherms,35,,13,12,25
020 Tscherms,36,,18,12,30
020 Tscherms,37,,13,8,21
020 Tscherms,38,,10,10,20
020 Tscherms,39,,10,13,23
020 Tscherms,40,,7,17,24
020 Tscherms,41,,10,8,18
020 Tscherms,42,,9,9,18
020 Tscherms,43,,8,8,16
020 Tscherms,44,,12,9,21
020 Tscherms,45,,8,7,15
020 Tscherms,46,,8,3,11
020 Tscherms,47,,13,5,18
020 Tscherms,48,,6,12,18
020 Tscherms,49,,8,7,15
020 Tscherms,50,,4,3,7
020 Tscherms,51,,7,5,12
020 Tscherms,52,,8,7,15
020 Tscherms,53,,4,7,11
020 Tscherms,54,,5,7,12
020 Tscherms,55,,6,9,15
020 Tscherms,56,,7,6,13
020 Tscherms,57,,8,3,11
020 Tscherms,58,,11,8,19
020 Tscherms,59,,5,5,10
020 Tscherms,60,,4,4,8
020 Tscherms,61,,6,2,8
020 Tscherms,62,,5,8,13
020 Tscherms,63,,5,6,11
020 Tscherms,64,,5,6,11
020 Tscherms,65,,2,9,11
020 Tscherms,66,,5,2,7
020 Tscherms,67,,6,5,11
020 Tscherms,68,,2,3,5
020 Tscherms,69,,3,5,8
020 Tscherms,70,,3,4,7
020 Tscherms,71,,5,5,10
020 Tscherms,72,,9,5,14
020 Tscherms,73,,4,2,6
020 Tscherms,74,,5,6,11
020 Tscherms,75,,4,6,10
020 Tscherms,76,,1,3,4
020 Tscherms,77,,2,7,9
020 Tscherms,78,,6,4,10
020 Tscherms,79,,6,3,9
020 Tscherms,80,,-,2,2
020 Tscherms,81,,3,2,5
020 Tscherms,82,,1,2,3
020 Tscherms,83,,1,1,2
020 Tscherms,84,,1,2,3
020 Tscherms,85,,2,3,5
020 Tscherms,86,,-,5,5
020 Tscherms,87,,3,-,3
020 Tscherms,88,,-,2,2
020 Tscherms,89,,1,1,2
020 Tscherms,91,,-,1,1
020 Tscherms,93,,-,1,1
021 Kiens,0,,14,17,31
021 Kiens,1,,20,6,26
021 Kiens,2,,18,13,31
021 Kiens,3,,16,19,35
021 Kiens,4,,14,23,37
021 Kiens,5,,17,19,36
021 Kiens,6,,18,16,34
021 Kiens,7,,26,17,43
021 Kiens,8,,12,25,37
021 Kiens,9,,14,20,34
021 Kiens,10,,14,17,31
021 Kiens,11,,13,14,27
021 Kiens,12,,12,12,24
021 Kiens,13,,18,11,29
021 Kiens,14,,19,13,32
021 Kiens,15,,16,11,27
021 Kiens,16,,13,19,32
021 Kiens,17,,21,17,38
021 Kiens,18,,14,21,35
021 Kiens,19,,17,22,39
021 Kiens,20,,16,21,37
021 Kiens,21,,29,16,45
021 Kiens,22,,18,15,33
021 Kiens,23,,29,21,50
021 Kiens,24,,19,22,41
021 Kiens,25,,20,19,39
021 Kiens,26,,31,26,57
021 Kiens,27,,25,23,48
021 Kiens,28,,32,29,61
021 Kiens,29,,22,26,48
021 Kiens,30,,32,25,57
021 Kiens,31,,43,20,63
021 Kiens,32,,25,25,50
021 Kiens,33,,25,22,47
021 Kiens,34,,20,21,41
021 Kiens,35,,33,23,56
021 Kiens,36,,20,21,41
021 Kiens,37,,31,18,49
021 Kiens,38,,22,24,46
021 Kiens,39,,20,20,40
021 Kiens,40,,26,16,42
021 Kiens,41,,14,13,27
021 Kiens,42,,10,18,28
021 Kiens,43,,19,13,32
021 Kiens,44,,16,11,27
021 Kiens,45,,11,16,27
021 Kiens,46,,14,23,37
021 Kiens,47,,11,9,20
021 Kiens,48,,12,13,25
021 Kiens,49,,18,11,29
021 Kiens,50,,9,15,24
021 Kiens,51,,13,17,30
021 Kiens,52,,16,14,30
021 Kiens,53,,19,13,32
021 Kiens,54,,8,12,20
021 Kiens,55,,11,13,24
021 Kiens,56,,22,12,34
021 Kiens,57,,19,12,31
021 Kiens,58,,20,11,31
021 Kiens,59,,14,15,29
021 Kiens,60,,15,9,24
021 Kiens,61,,14,14,28
021 Kiens,62,,11,13,24
021 Kiens,63,,11,11,22
021 Kiens,64,,5,19,24
021 Kiens,65,,9,14,23
021 Kiens,66,,12,7,19
021 Kiens,67,,16,12,28
021 Kiens,68,,17,9,26
021 Kiens,69,,9,13,22
021 Kiens,70,,7,9,16
021 Kiens,71,,4,6,10
021 Kiens,72,,8,7,15
021 Kiens,73,,3,4,7
021 Kiens,74,,6,4,10
021 Kiens,75,,5,7,12
021 Kiens,76,,9,7,16
021 Kiens,77,,4,5,9
021 Kiens,78,,2,7,9
021 Kiens,79,,5,4,9
021 Kiens,80,,1,4,5
021 Kiens,81,,1,2,3
021 Kiens,82,,1,3,4
021 Kiens,83,,-,3,3
021 Kiens,84,,2,3,5
021 Kiens,85,,2,5,7
021 Kiens,86,,4,3,7
021 Kiens,87,,1,4,5
021 Kiens,88,,2,-,2
021 Kiens,89,,3,2,5
021 Kiens,90,,1,-,1
021 Kiens,92,,1,3,4
021 Kiens,93,,1,-,1
022 Klausen,0,,28,22,50
022 Klausen,1,,19,26,45
022 Klausen,2,,37,33,70
022 Klausen,3,,27,27,54
022 Klausen,4,,35,23,58
022 Klausen,5,,17,33,50
022 Klausen,6,,29,22,51
022 Klausen,7,,38,25,63
022 Klausen,8,,33,30,63
022 Klausen,9,,34,22,56
022 Klausen,10,,28,27,55
022 Klausen,11,,28,30,58
022 Klausen,12,,20,34,54
022 Klausen,13,,34,30,64
022 Klausen,14,,35,36,71
022 Klausen,15,,34,26,60
022 Klausen,16,,25,38,63
022 Klausen,17,,38,34,72
022 Klausen,18,,35,30,65
022 Klausen,19,,27,33,60
022 Klausen,20,,30,39,69
022 Klausen,21,,37,41,78
022 Klausen,22,,33,32,65
022 Klausen,23,,36,21,57
022 Klausen,24,,38,35,73
022 Klausen,25,,34,24,58
022 Klausen,26,,43,28,71
022 Klausen,27,,34,42,76
022 Klausen,28,,45,35,80
022 Klausen,29,,41,45,86
022 Klausen,30,,49,47,96
022 Klausen,31,,52,39,91
022 Klausen,32,,45,44,89
022 Klausen,33,,61,40,101
022 Klausen,34,,45,38,83
022 Klausen,35,,39,45,84
022 Klausen,36,,37,36,73
022 Klausen,37,,30,40,70
022 Klausen,38,,51,37,88
022 Klausen,39,,41,28,69
022 Klausen,40,,31,36,67
022 Klausen,41,,27,28,55
022 Klausen,42,,31,27,58
022 Klausen,43,,27,25,52
022 Klausen,44,,30,30,60
022 Klausen,45,,31,40,71
022 Klausen,46,,21,30,51
022 Klausen,47,,26,15,41
022 Klausen,48,,32,27,59
022 Klausen,49,,30,23,53
022 Klausen,50,,29,25,54
022 Klausen,51,,30,26,56
022 Klausen,52,,30,20,50
022 Klausen,53,,29,21,50
022 Klausen,54,,13,16,29
022 Klausen,55,,21,18,39
022 Klausen,56,,22,29,51
022 Klausen,57,,22,27,49
022 Klausen,58,,28,20,48
022 Klausen,59,,25,23,48
022 Klausen,60,,26,20,46
022 Klausen,61,,16,20,36
022 Klausen,62,,17,18,35
022 Klausen,63,,21,23,44
022 Klausen,64,,13,22,35
022 Klausen,65,,17,17,34
022 Klausen,66,,23,17,40
022 Klausen,67,,12,22,34
022 Klausen,68,,12,15,27
022 Klausen,69,,11,19,30
022 Klausen,70,,23,23,46
022 Klausen,71,,7,18,25
022 Klausen,72,,10,15,25
022 Klausen,73,,15,13,28
022 Klausen,74,,13,9,22
022 Klausen,75,,13,17,30
022 Klausen,76,,5,18,23
022 Klausen,77,,8,17,25
022 Klausen,78,,4,14,18
022 Klausen,79,,4,15,19
022 Klausen,80,,2,13,15
022 Klausen,81,,3,10,13
022 Klausen,82,,3,10,13
022 Klausen,83,,3,4,7
022 Klausen,84,,5,4,9
022 Klausen,85,,4,8,12
022 Klausen,86,,1,17,18
022 Klausen,87,,2,5,7
022 Klausen,88,,5,7,12
022 Klausen,89,,3,3,6
022 Klausen,90,,2,5,7
022 Klausen,91,,1,6,7
022 Klausen,92,,-,2,2
022 Klausen,93,,-,2,2
022 Klausen,95,,1,1,2
022 Klausen,97,,1,-,1
023 Karneid,0,,25,28,53
023 Karneid,1,,18,20,38
023 Karneid,2,,31,21,52
023 Karneid,3,,21,17,38
023 Karneid,4,,22,19,41
023 Karneid,5,,22,23,45
023 Karneid,6,,21,21,42
023 Karneid,7,,22,19,41
023 Karneid,8,,17,20,37
023 Karneid,9,,23,16,39
023 Karneid,10,,16,17,33
023 Karneid,11,,18,20,38
023 Karneid,12,,12,21,33
023 Karneid,13,,19,19,38
023 Karneid,14,,21,12,33
023 Karneid,15,,25,16,41
023 Karneid,16,,19,9,28
023 Karneid,17,,22,15,37
023 Karneid,18,,28,28,56
023 Karneid,19,,22,22,44
023 Karneid,20,,24,24,48
023 Karneid,21,,23,12,35
023 Karneid,22,,18,15,33
023 Karneid,23,,22,29,51
023 Karneid,24,,21,24,45
023 Karneid,25,,30,22,52
023 Karneid,26,,27,21,48
023 Karneid,27,,26,34,60
023 Karneid,28,,31,33,64
023 Karneid,29,,36,17,53
023 Karneid,30,,16,26,42
023 Karneid,31,,43,34,77
023 Karneid,32,,35,39,74
023 Karneid,33,,36,35,71
023 Karneid,34,,29,26,55
023 Karneid,35,,35,28,63
023 Karneid,36,,36,23,59
023 Karneid,37,,30,34,64
023 Karneid,38,,26,20,46
023 Karneid,39,,30,28,58
023 Karneid,40,,29,18,47
023 Karneid,41,,20,20,40
023 Karneid,42,,19,18,37
023 Karneid,43,,20,18,38
023 Karneid,44,,16,9,25
023 Karneid,45,,16,15,31
023 Karneid,46,,24,17,41
023 Karneid,47,,11,21,32
023 Karneid,48,,19,12,31
023 Karneid,49,,22,15,37
023 Karneid,50,,10,14,24
023 Karneid,51,,16,25,41
023 Karneid,52,,7,16,23
023 Karneid,53,,11,20,31
023 Karneid,54,,13,15,28
023 Karneid,55,,12,13,25
023 Karneid,56,,21,14,35
023 Karneid,57,,17,25,42
023 Karneid,58,,23,15,38
023 Karneid,59,,14,17,31
023 Karneid,60,,17,17,34
023 Karneid,61,,20,10,30
023 Karneid,62,,9,9,18
023 Karneid,63,,11,12,23
023 Karneid,64,,12,15,27
023 Karneid,65,,17,15,32
023 Karneid,66,,10,14,24
023 Karneid,67,,14,5,19
023 Karneid,68,,18,11,29
023 Karneid,69,,7,8,15
023 Karneid,70,,12,9,21
023 Karneid,71,,9,9,18
023 Karneid,72,,4,9,13
023 Karneid,73,,9,10,19
023 Karneid,74,,5,7,12
023 Karneid,75,,9,13,22
023 Karneid,76,,5,4,9
023 Karneid,77,,3,8,11
023 Karneid,78,,2,5,7
023 Karneid,79,,6,10,16
023 Karneid,80,,8,3,11
023 Karneid,81,,1,6,7
023 Karneid,82,,1,4,5
023 Karneid,83,,1,4,5
023 Karneid,84,,1,2,3
023 Karneid,85,,2,2,4
023 Karneid,86,,-,4,4
023 Karneid,87,,1,5,6
023 Karneid,88,,-,4,4
023 Karneid,89,,3,4,7
023 Karneid,90,,1,2,3
023 Karneid,91,,-,5,5
023 Karneid,93,,-,2,2
023 Karneid,94,,-,1,1
023 Karneid,95,,-,1,1
024 Kurtatsch a.d.Weinstr.,0,,14,10,24
024 Kurtatsch a.d.Weinstr.,1,,16,13,29
024 Kurtatsch a.d.Weinstr.,2,,13,13,26
024 Kurtatsch a.d.Weinstr.,3,,24,16,40
024 Kurtatsch a.d.Weinstr.,4,,20,11,31
024 Kurtatsch a.d.Weinstr.,5,,15,6,21
024 Kurtatsch a.d.Weinstr.,6,,24,19,43
024 Kurtatsch a.d.Weinstr.,7,,21,11,32
024 Kurtatsch a.d.Weinstr.,8,,15,16,31
024 Kurtatsch a.d.Weinstr.,9,,10,8,18
024 Kurtatsch a.d.Weinstr.,10,,10,17,27
024 Kurtatsch a.d.Weinstr.,11,,7,13,20
024 Kurtatsch a.d.Weinstr.,12,,11,12,23
024 Kurtatsch a.d.Weinstr.,13,,9,10,19
024 Kurtatsch a.d.Weinstr.,14,,13,10,23
024 Kurtatsch a.d.Weinstr.,15,,16,9,25
024 Kurtatsch a.d.Weinstr.,16,,14,8,22
024 Kurtatsch a.d.Weinstr.,17,,11,20,31
024 Kurtatsch a.d.Weinstr.,18,,10,11,21
024 Kurtatsch a.d.Weinstr.,19,,8,15,23
024 Kurtatsch a.d.Weinstr.,20,,9,8,17
024 Kurtatsch a.d.Weinstr.,21,,7,13,20
024 Kurtatsch a.d.Weinstr.,22,,10,15,25
024 Kurtatsch a.d.Weinstr.,23,,11,14,25
024 Kurtatsch a.d.Weinstr.,24,,11,11,22
024 Kurtatsch a.d.Weinstr.,25,,7,14,21
024 Kurtatsch a.d.Weinstr.,26,,13,14,27
024 Kurtatsch a.d.Weinstr.,27,,11,16,27
024 Kurtatsch a.d.Weinstr.,28,,15,18,33
024 Kurtatsch a.d.Weinstr.,29,,12,24,36
024 Kurtatsch a.d.Weinstr.,30,,22,16,38
024 Kurtatsch a.d.Weinstr.,31,,26,12,38
024 Kurtatsch a.d.Weinstr.,32,,20,19,39
024 Kurtatsch a.d.Weinstr.,33,,30,18,48
024 Kurtatsch a.d.Weinstr.,34,,22,26,48
024 Kurtatsch a.d.Weinstr.,35,,13,26,39
024 Kurtatsch a.d.Weinstr.,36,,19,22,41
024 Kurtatsch a.d.Weinstr.,37,,25,7,32
024 Kurtatsch a.d.Weinstr.,38,,19,17,36
024 Kurtatsch a.d.Weinstr.,39,,19,21,40
024 Kurtatsch a.d.Weinstr.,40,,18,12,30
024 Kurtatsch a.d.Weinstr.,41,,14,16,30
024 Kurtatsch a.d.Weinstr.,42,,11,12,23
024 Kurtatsch a.d.Weinstr.,43,,10,9,19
024 Kurtatsch a.d.Weinstr.,44,,12,16,28
024 Kurtatsch a.d.Weinstr.,45,,15,8,23
024 Kurtatsch a.d.Weinstr.,46,,17,19,36
024 Kurtatsch a.d.Weinstr.,47,,13,8,21
024 Kurtatsch a.d.Weinstr.,48,,9,14,23
024 Kurtatsch a.d.Weinstr.,49,,14,5,19
024 Kurtatsch a.d.Weinstr.,50,,11,9,20
024 Kurtatsch a.d.Weinstr.,51,,8,7,15
024 Kurtatsch a.d.Weinstr.,52,,12,8,20
024 Kurtatsch a.d.Weinstr.,53,,12,8,20
024 Kurtatsch a.d.Weinstr.,54,,7,8,15
024 Kurtatsch a.d.Weinstr.,55,,5,8,13
024 Kurtatsch a.d.Weinstr.,56,,10,6,16
024 Kurtatsch a.d.Weinstr.,57,,10,12,22
024 Kurtatsch a.d.Weinstr.,58,,7,9,16
024 Kurtatsch a.d.Weinstr.,59,,11,11,22
024 Kurtatsch a.d.Weinstr.,60,,5,15,20
024 Kurtatsch a.d.Weinstr.,61,,11,11,22
024 Kurtatsch a.d.Weinstr.,62,,5,11,16
024 Kurtatsch a.d.Weinstr.,63,,9,7,16
024 Kurtatsch a.d.Weinstr.,64,,5,10,15
024 Kurtatsch a.d.Weinstr.,65,,8,11,19
024 Kurtatsch a.d.Weinstr.,66,,8,5,13
024 Kurtatsch a.d.Weinstr.,67,,11,15,26
024 Kurtatsch a.d.Weinstr.,68,,8,12,20
024 Kurtatsch a.d.Weinstr.,69,,12,15,27
024 Kurtatsch a.d.Weinstr.,70,,9,12,21
024 Kurtatsch a.d.Weinstr.,71,,8,8,16
024 Kurtatsch a.d.Weinstr.,72,,11,6,17
024 Kurtatsch a.d.Weinstr.,73,,8,6,14
024 Kurtatsch a.d.Weinstr.,74,,4,10,14
024 Kurtatsch a.d.Weinstr.,75,,8,11,19
024 Kurtatsch a.d.Weinstr.,76,,7,21,28
024 Kurtatsch a.d.Weinstr.,77,,1,5,6
024 Kurtatsch a.d.Weinstr.,78,,5,8,13
024 Kurtatsch a.d.Weinstr.,79,,6,6,12
024 Kurtatsch a.d.Weinstr.,80,,2,2,4
024 Kurtatsch a.d.Weinstr.,81,,-,1,1
024 Kurtatsch a.d.Weinstr.,82,,-,5,5
024 Kurtatsch a.d.Weinstr.,83,,-,2,2
024 Kurtatsch a.d.Weinstr.,84,,2,1,3
024 Kurtatsch a.d.Weinstr.,85,,3,2,5
024 Kurtatsch a.d.Weinstr.,86,,1,4,5
024 Kurtatsch a.d.Weinstr.,87,,3,6,9
024 Kurtatsch a.d.Weinstr.,88,,-,4,4
024 Kurtatsch a.d.Weinstr.,89,,-,1,1
024 Kurtatsch a.d.Weinstr.,90,,-,2,2
024 Kurtatsch a.d.Weinstr.,91,,1,2,3
024 Kurtatsch a.d.Weinstr.,92,,-,2,2
024 Kurtatsch a.d.Weinstr.,93,,2,-,2
024 Kurtatsch a.d.Weinstr.,94,,-,1,1
024 Kurtatsch a.d.Weinstr.,95,,1,-,1
024 Kurtatsch a.d.Weinstr.,96,,-,1,1
025 Kurtinig a.d. Weinstr.,0,,2,3,5
025 Kurtinig a.d. Weinstr.,1,,2,5,7
025 Kurtinig a.d. Weinstr.,2,,3,4,7
025 Kurtinig a.d. Weinstr.,3,,1,2,3
025 Kurtinig a.d. Weinstr.,4,,4,2,6
025 Kurtinig a.d. Weinstr.,5,,2,4,6
025 Kurtinig a.d. Weinstr.,6,,4,4,8
025 Kurtinig a.d. Weinstr.,7,,2,3,5
025 Kurtinig a.d. Weinstr.,8,,5,2,7
025 Kurtinig a.d. Weinstr.,9,,3,2,5
025 Kurtinig a.d. Weinstr.,10,,6,4,10
025 Kurtinig a.d. Weinstr.,11,,6,4,10
025 Kurtinig a.d. Weinstr.,12,,5,6,11
025 Kurtinig a.d. Weinstr.,13,,5,5,10
025 Kurtinig a.d. Weinstr.,14,,2,3,5
025 Kurtinig a.d. Weinstr.,15,,3,2,5
025 Kurtinig a.d. Weinstr.,16,,3,4,7
025 Kurtinig a.d. Weinstr.,17,,6,5,11
025 Kurtinig a.d. Weinstr.,18,,6,5,11
025 Kurtinig a.d. Weinstr.,19,,4,3,7
025 Kurtinig a.d. Weinstr.,20,,4,9,13
025 Kurtinig a.d. Weinstr.,21,,2,4,6
025 Kurtinig a.d. Weinstr.,22,,5,-,5
025 Kurtinig a.d. Weinstr.,23,,3,-,3
025 Kurtinig a.d. Weinstr.,24,,2,5,7
025 Kurtinig a.d. Weinstr.,25,,3,1,4
025 Kurtinig a.d. Weinstr.,26,,5,1,6
025 Kurtinig a.d. Weinstr.,27,,2,5,7
025 Kurtinig a.d. Weinstr.,28,,4,3,7
025 Kurtinig a.d. Weinstr.,29,,7,2,9
025 Kurtinig a.d. Weinstr.,30,,6,5,11
025 Kurtinig a.d. Weinstr.,31,,4,3,7
025 Kurtinig a.d. Weinstr.,32,,5,4,9
025 Kurtinig a.d. Weinstr.,33,,2,5,7
025 Kurtinig a.d. Weinstr.,34,,4,4,8
025 Kurtinig a.d. Weinstr.,35,,7,5,12
025 Kurtinig a.d. Weinstr.,36,,5,7,12
025 Kurtinig a.d. Weinstr.,37,,4,5,9
025 Kurtinig a.d. Weinstr.,38,,7,9,16
025 Kurtinig a.d. Weinstr.,39,,5,5,10
025 Kurtinig a.d. Weinstr.,40,,11,5,16
025 Kurtinig a.d. Weinstr.,41,,3,8,11
025 Kurtinig a.d. Weinstr.,42,,8,8,16
025 Kurtinig a.d. Weinstr.,43,,4,3,7
025 Kurtinig a.d. Weinstr.,44,,3,1,4
025 Kurtinig a.d. Weinstr.,45,,7,2,9
025 Kurtinig a.d. Weinstr.,46,,5,4,9
025 Kurtinig a.d. Weinstr.,47,,2,4,6
025 Kurtinig a.d. Weinstr.,48,,2,4,6
025 Kurtinig a.d. Weinstr.,49,,2,3,5
025 Kurtinig a.d. Weinstr.,50,,3,3,6
025 Kurtinig a.d. Weinstr.,51,,4,5,9
025 Kurtinig a.d. Weinstr.,52,,5,1,6
025 Kurtinig a.d. Weinstr.,53,,-,5,5
025 Kurtinig a.d. Weinstr.,54,,3,2,5
025 Kurtinig a.d. Weinstr.,55,,3,2,5
025 Kurtinig a.d. Weinstr.,56,,4,2,6
025 Kurtinig a.d. Weinstr.,57,,2,2,4
025 Kurtinig a.d. Weinstr.,58,,3,1,4
025 Kurtinig a.d. Weinstr.,59,,2,2,4
025 Kurtinig a.d. Weinstr.,60,,5,3,8
025 Kurtinig a.d. Weinstr.,61,,2,2,4
025 Kurtinig a.d. Weinstr.,62,,2,3,5
025 Kurtinig a.d. Weinstr.,63,,6,3,9
025 Kurtinig a.d. Weinstr.,64,,-,6,6
025 Kurtinig a.d. Weinstr.,65,,1,4,5
025 Kurtinig a.d. Weinstr.,66,,1,2,3
025 Kurtinig a.d. Weinstr.,67,,3,4,7
025 Kurtinig a.d. Weinstr.,68,,3,2,5
025 Kurtinig a.d. Weinstr.,69,,4,4,8
025 Kurtinig a.d. Weinstr.,70,,1,3,4
025 Kurtinig a.d. Weinstr.,71,,2,4,6
025 Kurtinig a.d. Weinstr.,72,,2,4,6
025 Kurtinig a.d. Weinstr.,73,,5,1,6
025 Kurtinig a.d. Weinstr.,74,,-,5,5
025 Kurtinig a.d. Weinstr.,75,,2,5,7
025 Kurtinig a.d. Weinstr.,76,,1,1,2
025 Kurtinig a.d. Weinstr.,77,,1,3,4
025 Kurtinig a.d. Weinstr.,78,,2,1,3
025 Kurtinig a.d. Weinstr.,79,,2,1,3
025 Kurtinig a.d. Weinstr.,80,,-,2,2
025 Kurtinig a.d. Weinstr.,81,,1,1,2
025 Kurtinig a.d. Weinstr.,82,,-,1,1
025 Kurtinig a.d. Weinstr.,84,,-,3,3
025 Kurtinig a.d. Weinstr.,85,,-,2,2
025 Kurtinig a.d. Weinstr.,86,,1,-,1
025 Kurtinig a.d. Weinstr.,87,,1,1,2
025 Kurtinig a.d. Weinstr.,90,,1,1,2
025 Kurtinig a.d. Weinstr.,95,,-,2,2
026 Corvara,0,,9,7,16
026 Corvara,1,,9,7,16
026 Corvara,2,,4,6,10
026 Corvara,3,,8,4,12
026 Corvara,4,,8,9,17
026 Corvara,5,,6,4,10
026 Corvara,6,,7,3,10
026 Corvara,7,,6,11,17
026 Corvara,8,,2,6,8
026 Corvara,9,,9,6,15
026 Corvara,10,,5,5,10
026 Corvara,11,,6,3,9
026 Corvara,12,,10,7,17
026 Corvara,13,,3,-,3
026 Corvara,14,,6,8,14
026 Corvara,15,,8,3,11
026 Corvara,16,,7,7,14
026 Corvara,17,,8,11,19
026 Corvara,18,,15,2,17
026 Corvara,19,,11,7,18
026 Corvara,20,,11,7,18
026 Corvara,21,,10,3,13
026 Corvara,22,,16,7,23
026 Corvara,23,,11,4,15
026 Corvara,24,,10,20,30
026 Corvara,25,,7,15,22
026 Corvara,26,,12,9,21
026 Corvara,27,,7,7,14
026 Corvara,28,,11,7,18
026 Corvara,29,,11,12,23
026 Corvara,30,,16,11,27
026 Corvara,31,,8,12,20
026 Corvara,32,,15,21,36
026 Corvara,33,,13,16,29
026 Corvara,34,,15,16,31
026 Corvara,35,,8,7,15
026 Corvara,36,,12,11,23
026 Corvara,37,,13,11,24
026 Corvara,38,,8,7,15
026 Corvara,39,,15,13,28
026 Corvara,40,,7,8,15
026 Corvara,41,,12,6,18
026 Corvara,42,,7,5,12
026 Corvara,43,,3,9,12
026 Corvara,44,,12,8,20
026 Corvara,45,,8,8,16
026 Corvara,46,,6,13,19
026 Corvara,47,,5,8,13
026 Corvara,48,,6,8,14
026 Corvara,49,,7,8,15
026 Corvara,50,,3,9,12
026 Corvara,51,,5,5,10
026 Corvara,52,,4,10,14
026 Corvara,53,,14,11,25
026 Corvara,54,,5,5,10
026 Corvara,55,,8,9,17
026 Corvara,56,,6,10,16
026 Corvara,57,,5,9,14
026 Corvara,58,,15,12,27
026 Corvara,59,,9,7,16
026 Corvara,60,,10,4,14
026 Corvara,61,,4,8,12
026 Corvara,62,,5,8,13
026 Corvara,63,,6,8,14
026 Corvara,64,,8,5,13
026 Corvara,65,,9,8,17
026 Corvara,66,,5,4,9
026 Corvara,67,,7,4,11
026 Corvara,68,,7,12,19
026 Corvara,69,,7,3,10
026 Corvara,70,,5,6,11
026 Corvara,71,,2,2,4
026 Corvara,72,,6,4,10
026 Corvara,73,,3,3,6
026 Corvara,74,,1,3,4
026 Corvara,75,,3,1,4
026 Corvara,76,,5,3,8
026 Corvara,77,,3,5,8
026 Corvara,78,,4,1,5
026 Corvara,79,,4,1,5
026 Corvara,80,,2,4,6
026 Corvara,81,,1,1,2
026 Corvara,82,,1,2,3
026 Corvara,83,,-,1,1
026 Corvara,85,,1,3,4
026 Corvara,86,,1,6,7
026 Corvara,87,,2,5,7
026 Corvara,88,,2,-,2
026 Corvara,89,,1,1,2
026 Corvara,90,,-,2,2
026 Corvara,91,,-,1,1
026 Corvara,92,,-,1,1
026 Corvara,93,,-,2,2
026 Corvara,96,,1,-,1
027 Graun im Vinschgau,0,,14,9,23
027 Graun im Vinschgau,1,,10,17,27
027 Graun im Vinschgau,2,,14,16,30
027 Graun im Vinschgau,3,,22,17,39
027 Graun im Vinschgau,4,,19,17,36
027 Graun im Vinschgau,5,,19,11,30
027 Graun im Vinschgau,6,,21,14,35
027 Graun im Vinschgau,7,,17,16,33
027 Graun im Vinschgau,8,,11,13,24
027 Graun im Vinschgau,9,,18,20,38
027 Graun im Vinschgau,10,,26,19,45
027 Graun im Vinschgau,11,,23,11,34
027 Graun im Vinschgau,12,,16,12,28
027 Graun im Vinschgau,13,,8,8,16
027 Graun im Vinschgau,14,,19,10,29
027 Graun im Vinschgau,15,,20,15,35
027 Graun im Vinschgau,16,,7,16,23
027 Graun im Vinschgau,17,,19,18,37
027 Graun im Vinschgau,18,,22,17,39
027 Graun im Vinschgau,19,,24,14,38
027 Graun im Vinschgau,20,,14,23,37
027 Graun im Vinschgau,21,,19,14,33
027 Graun im Vinschgau,22,,20,20,40
027 Graun im Vinschgau,23,,15,19,34
027 Graun im Vinschgau,24,,22,19,41
027 Graun im Vinschgau,25,,21,11,32
027 Graun im Vinschgau,26,,21,21,42
027 Graun im Vinschgau,27,,23,22,45
027 Graun im Vinschgau,28,,24,12,36
027 Graun im Vinschgau,29,,25,17,42
027 Graun im Vinschgau,30,,29,20,49
027 Graun im Vinschgau,31,,17,22,39
027 Graun im Vinschgau,32,,30,22,52
027 Graun im Vinschgau,33,,20,24,44
027 Graun im Vinschgau,34,,17,19,36
027 Graun im Vinschgau,35,,21,23,44
027 Graun im Vinschgau,36,,22,18,40
027 Graun im Vinschgau,37,,23,24,47
027 Graun im Vinschgau,38,,21,14,35
027 Graun im Vinschgau,39,,21,22,43
027 Graun im Vinschgau,40,,24,11,35
027 Graun im Vinschgau,41,,20,16,36
027 Graun im Vinschgau,42,,13,13,26
027 Graun im Vinschgau,43,,15,11,26
027 Graun im Vinschgau,44,,16,10,26
027 Graun im Vinschgau,45,,17,17,34
027 Graun im Vinschgau,46,,18,8,26
027 Graun im Vinschgau,47,,17,10,27
027 Graun im Vinschgau,48,,13,15,28
027 Graun im Vinschgau,49,,12,12,24
027 Graun im Vinschgau,50,,8,21,29
027 Graun im Vinschgau,51,,12,12,24
027 Graun im Vinschgau,52,,5,11,16
027 Graun im Vinschgau,53,,8,7,15
027 Graun im Vinschgau,54,,9,8,17
027 Graun im Vinschgau,55,,11,8,19
027 Graun im Vinschgau,56,,10,13,23
027 Graun im Vinschgau,57,,9,13,22
027 Graun im Vinschgau,58,,15,10,25
027 Graun im Vinschgau,59,,14,9,23
027 Graun im Vinschgau,60,,12,13,25
027 Graun im Vinschgau,61,,11,12,23
027 Graun im Vinschgau,62,,11,3,14
027 Graun im Vinschgau,63,,15,14,29
027 Graun im Vinschgau,64,,9,9,18
027 Graun im Vinschgau,65,,13,9,22
027 Graun im Vinschgau,66,,8,7,15
027 Graun im Vinschgau,67,,13,7,20
027 Graun im Vinschgau,68,,13,11,24
027 Graun im Vinschgau,69,,6,9,15
027 Graun im Vinschgau,70,,14,15,29
027 Graun im Vinschgau,71,,11,12,23
027 Graun im Vinschgau,72,,6,9,15
027 Graun im Vinschgau,73,,9,14,23
027 Graun im Vinschgau,74,,6,5,11
027 Graun im Vinschgau,75,,9,9,18
027 Graun im Vinschgau,76,,6,15,21
027 Graun im Vinschgau,77,,9,8,17
027 Graun im Vinschgau,78,,6,13,19
027 Graun im Vinschgau,79,,6,3,9
027 Graun im Vinschgau,80,,1,7,8
027 Graun im Vinschgau,81,,3,2,5
027 Graun im Vinschgau,82,,-,3,3
027 Graun im Vinschgau,83,,1,2,3
027 Graun im Vinschgau,84,,1,4,5
027 Graun im Vinschgau,85,,5,6,11
027 Graun im Vinschgau,86,,1,4,5
027 Graun im Vinschgau,87,,1,3,4
027 Graun im Vinschgau,88,,1,6,7
027 Graun im Vinschgau,89,,2,-,2
027 Graun im Vinschgau,90,,-,2,2
027 Graun im Vinschgau,91,,-,4,4
027 Graun im Vinschgau,92,,1,2,3
027 Graun im Vinschgau,95,,1,-,1
027 Graun im Vinschgau,96,,-,1,1
028 Toblach,0,,19,19,38
028 Toblach,1,,23,10,33
028 Toblach,2,,25,16,41
028 Toblach,3,,30,22,52
028 Toblach,4,,18,10,28
028 Toblach,5,,22,17,39
028 Toblach,6,,19,20,39
028 Toblach,7,,16,16,32
028 Toblach,8,,16,28,44
028 Toblach,9,,17,23,40
028 Toblach,10,,10,17,27
028 Toblach,11,,14,24,38
028 Toblach,12,,31,16,47
028 Toblach,13,,15,21,36
028 Toblach,14,,24,23,47
028 Toblach,15,,21,27,48
028 Toblach,16,,21,20,41
028 Toblach,17,,24,28,52
028 Toblach,18,,25,23,48
028 Toblach,19,,23,19,42
028 Toblach,20,,23,25,48
028 Toblach,21,,25,26,51
028 Toblach,22,,15,28,43
028 Toblach,23,,26,27,53
028 Toblach,24,,25,22,47
028 Toblach,25,,30,21,51
028 Toblach,26,,37,25,62
028 Toblach,27,,35,36,71
028 Toblach,28,,34,23,57
028 Toblach,29,,25,23,48
028 Toblach,30,,32,28,60
028 Toblach,31,,34,27,61
028 Toblach,32,,29,25,54
028 Toblach,33,,28,27,55
028 Toblach,34,,32,28,60
028 Toblach,35,,37,32,69
028 Toblach,36,,33,27,60
028 Toblach,37,,38,28,66
028 Toblach,38,,23,30,53
028 Toblach,39,,21,17,38
028 Toblach,40,,39,26,65
028 Toblach,41,,22,15,37
028 Toblach,42,,28,20,48
028 Toblach,43,,18,25,43
028 Toblach,44,,19,25,44
028 Toblach,45,,23,21,44
028 Toblach,46,,19,25,44
028 Toblach,47,,18,17,35
028 Toblach,48,,28,12,40
028 Toblach,49,,15,16,31
028 Toblach,50,,21,15,36
028 Toblach,51,,14,25,39
028 Toblach,52,,20,14,34
028 Toblach,53,,13,15,28
028 Toblach,54,,12,16,28
028 Toblach,55,,19,11,30
028 Toblach,56,,15,18,33
028 Toblach,57,,13,20,33
028 Toblach,58,,17,12,29
028 Toblach,59,,14,13,27
028 Toblach,60,,15,13,28
028 Toblach,61,,16,8,24
028 Toblach,62,,5,11,16
028 Toblach,63,,11,16,27
028 Toblach,64,,8,19,27
028 Toblach,65,,16,17,33
028 Toblach,66,,10,11,21
028 Toblach,67,,13,17,30
028 Toblach,68,,18,15,33
028 Toblach,69,,10,11,21
028 Toblach,70,,11,17,28
028 Toblach,71,,15,13,28
028 Toblach,72,,10,15,25
028 Toblach,73,,10,15,25
028 Toblach,74,,16,9,25
028 Toblach,75,,9,9,18
028 Toblach,76,,10,9,19
028 Toblach,77,,5,18,23
028 Toblach,78,,7,11,18
028 Toblach,79,,4,9,13
028 Toblach,80,,5,15,20
028 Toblach,81,,4,5,9
028 Toblach,82,,5,4,9
028 Toblach,83,,3,6,9
028 Toblach,84,,1,10,11
028 Toblach,85,,2,7,9
028 Toblach,86,,2,6,8
028 Toblach,87,,1,3,4
028 Toblach,88,,2,4,6
028 Toblach,89,,1,5,6
028 Toblach,90,,1,3,4
028 Toblach,91,,2,3,5
028 Toblach,92,,1,1,2
028 Toblach,93,,1,2,3
028 Toblach,94,,-,1,1
028 Toblach,95,,-,1,1
028 Toblach,98,,-,1,1
028 Toblach,109,,1,-,1
029 Neumarkt,0,,15,23,38
029 Neumarkt,1,,20,33,53
029 Neumarkt,2,,18,14,32
029 Neumarkt,3,,18,21,39
029 Neumarkt,4,,18,23,41
029 Neumarkt,5,,23,24,47
029 Neumarkt,6,,22,34,56
029 Neumarkt,7,,21,25,46
029 Neumarkt,8,,26,19,45
029 Neumarkt,9,,29,23,52
029 Neumarkt,10,,23,32,55
029 Neumarkt,11,,23,22,45
029 Neumarkt,12,,28,29,57
029 Neumarkt,13,,21,17,38
029 Neumarkt,14,,24,15,39
029 Neumarkt,15,,15,23,38
029 Neumarkt,16,,14,23,37
029 Neumarkt,17,,22,23,45
029 Neumarkt,18,,24,19,43
029 Neumarkt,19,,19,18,37
029 Neumarkt,20,,22,18,40
029 Neumarkt,21,,33,21,54
029 Neumarkt,22,,15,15,30
029 Neumarkt,23,,30,29,59
029 Neumarkt,24,,30,27,57
029 Neumarkt,25,,23,34,57
029 Neumarkt,26,,27,25,52
029 Neumarkt,27,,33,36,69
029 Neumarkt,28,,33,43,76
029 Neumarkt,29,,34,26,60
029 Neumarkt,30,,32,29,61
029 Neumarkt,31,,33,47,80
029 Neumarkt,32,,43,38,81
029 Neumarkt,33,,50,40,90
029 Neumarkt,34,,50,34,84
029 Neumarkt,35,,51,40,91
029 Neumarkt,36,,42,39,81
029 Neumarkt,37,,51,31,82
029 Neumarkt,38,,31,35,66
029 Neumarkt,39,,49,51,100
029 Neumarkt,40,,49,36,85
029 Neumarkt,41,,29,36,65
029 Neumarkt,42,,34,29,63
029 Neumarkt,43,,32,25,57
029 Neumarkt,44,,43,41,84
029 Neumarkt,45,,39,25,64
029 Neumarkt,46,,22,19,41
029 Neumarkt,47,,27,21,48
029 Neumarkt,48,,21,22,43
029 Neumarkt,49,,25,21,46
029 Neumarkt,50,,20,26,46
029 Neumarkt,51,,20,22,42
029 Neumarkt,52,,27,29,56
029 Neumarkt,53,,36,30,66
029 Neumarkt,54,,26,24,50
029 Neumarkt,55,,25,15,40
029 Neumarkt,56,,25,22,47
029 Neumarkt,57,,24,25,49
029 Neumarkt,58,,38,25,63
029 Neumarkt,59,,32,34,66
029 Neumarkt,60,,20,28,48
029 Neumarkt,61,,19,19,38
029 Neumarkt,62,,25,21,46
029 Neumarkt,63,,21,19,40
029 Neumarkt,64,,21,22,43
029 Neumarkt,65,,17,23,40
029 Neumarkt,66,,19,19,38
029 Neumarkt,67,,20,22,42
029 Neumarkt,68,,25,30,55
029 Neumarkt,69,,17,26,43
029 Neumarkt,70,,15,18,33
029 Neumarkt,71,,9,21,30
029 Neumarkt,72,,21,20,41
029 Neumarkt,73,,21,21,42
029 Neumarkt,74,,16,21,37
029 Neumarkt,75,,12,16,28
029 Neumarkt,76,,16,28,44
029 Neumarkt,77,,10,17,27
029 Neumarkt,78,,7,27,34
029 Neumarkt,79,,9,20,29
029 Neumarkt,80,,4,11,15
029 Neumarkt,81,,6,4,10
029 Neumarkt,82,,4,8,12
029 Neumarkt,83,,3,7,10
029 Neumarkt,84,,1,7,8
029 Neumarkt,85,,8,10,18
029 Neumarkt,86,,5,6,11
029 Neumarkt,87,,3,8,11
029 Neumarkt,88,,2,8,10
029 Neumarkt,89,,3,5,8
029 Neumarkt,90,,4,4,8
029 Neumarkt,91,,2,4,6
029 Neumarkt,92,,-,1,1
029 Neumarkt,93,,1,2,3
029 Neumarkt,94,,1,-,1
029 Neumarkt,95,,-,1,1
029 Neumarkt,96,,-,2,2
030 Pfalzen,0,,18,15,33
030 Pfalzen,1,,16,12,28
030 Pfalzen,2,,12,14,26
030 Pfalzen,3,,13,14,27
030 Pfalzen,4,,25,16,41
030 Pfalzen,5,,12,14,26
030 Pfalzen,6,,12,16,28
030 Pfalzen,7,,13,22,35
030 Pfalzen,8,,15,20,35
030 Pfalzen,9,,19,11,30
030 Pfalzen,10,,16,20,36
030 Pfalzen,11,,12,8,20
030 Pfalzen,12,,11,23,34
030 Pfalzen,13,,18,18,36
030 Pfalzen,14,,22,13,35
030 Pfalzen,15,,16,10,26
030 Pfalzen,16,,11,11,22
030 Pfalzen,17,,18,19,37
030 Pfalzen,18,,18,19,37
030 Pfalzen,19,,22,17,39
030 Pfalzen,20,,15,20,35
030 Pfalzen,21,,16,19,35
030 Pfalzen,22,,20,19,39
030 Pfalzen,23,,17,11,28
030 Pfalzen,24,,10,18,28
030 Pfalzen,25,,22,19,41
030 Pfalzen,26,,15,20,35
030 Pfalzen,27,,17,16,33
030 Pfalzen,28,,22,19,41
030 Pfalzen,29,,18,20,38
030 Pfalzen,30,,28,15,43
030 Pfalzen,31,,25,28,53
030 Pfalzen,32,,21,23,44
030 Pfalzen,33,,22,23,45
030 Pfalzen,34,,25,24,49
030 Pfalzen,35,,26,16,42
030 Pfalzen,36,,27,18,45
030 Pfalzen,37,,19,25,44
030 Pfalzen,38,,23,16,39
030 Pfalzen,39,,19,14,33
030 Pfalzen,40,,13,14,27
030 Pfalzen,41,,16,20,36
030 Pfalzen,42,,23,18,41
030 Pfalzen,43,,15,14,29
030 Pfalzen,44,,15,11,26
030 Pfalzen,45,,13,13,26
030 Pfalzen,46,,14,11,25
030 Pfalzen,47,,10,10,20
030 Pfalzen,48,,16,16,32
030 Pfalzen,49,,10,11,21
030 Pfalzen,50,,14,6,20
030 Pfalzen,51,,9,10,19
030 Pfalzen,52,,12,4,16
030 Pfalzen,53,,8,9,17
030 Pfalzen,54,,7,9,16
030 Pfalzen,55,,11,6,17
030 Pfalzen,56,,8,12,20
030 Pfalzen,57,,6,13,19
030 Pfalzen,58,,12,8,20
030 Pfalzen,59,,13,9,22
030 Pfalzen,60,,10,6,16
030 Pfalzen,61,,11,11,22
030 Pfalzen,62,,7,6,13
030 Pfalzen,63,,2,9,11
030 Pfalzen,64,,8,5,13
030 Pfalzen,65,,8,12,20
030 Pfalzen,66,,7,8,15
030 Pfalzen,67,,10,6,16
030 Pfalzen,68,,13,7,20
030 Pfalzen,69,,10,11,21
030 Pfalzen,70,,11,7,18
030 Pfalzen,71,,4,6,10
030 Pfalzen,72,,6,5,11
030 Pfalzen,73,,5,4,9
030 Pfalzen,74,,7,4,11
030 Pfalzen,75,,4,11,15
030 Pfalzen,76,,6,8,14
030 Pfalzen,77,,4,3,7
030 Pfalzen,78,,-,7,7
030 Pfalzen,79,,4,7,11
030 Pfalzen,80,,4,4,8
030 Pfalzen,81,,1,1,2
030 Pfalzen,82,,1,2,3
030 Pfalzen,83,,-,2,2
030 Pfalzen,84,,2,-,2
030 Pfalzen,85,,2,6,8
030 Pfalzen,86,,1,3,4
030 Pfalzen,87,,-,2,2
030 Pfalzen,88,,-,2,2
030 Pfalzen,89,,-,4,4
030 Pfalzen,90,,3,1,4
030 Pfalzen,91,,2,1,3
031 Völs am Schlern,0,,22,17,39
031 Völs am Schlern,1,,27,27,54
031 Völs am Schlern,2,,18,22,40
031 Völs am Schlern,3,,16,21,37
031 Völs am Schlern,4,,20,22,42
031 Völs am Schlern,5,,22,10,32
031 Völs am Schlern,6,,17,17,34
031 Völs am Schlern,7,,20,16,36
031 Völs am Schlern,8,,15,20,35
031 Völs am Schlern,9,,20,18,38
031 Völs am Schlern,10,,18,15,33
031 Völs am Schlern,11,,17,14,31
031 Völs am Schlern,12,,17,15,32
031 Völs am Schlern,13,,21,12,33
031 Völs am Schlern,14,,18,14,32
031 Völs am Schlern,15,,15,6,21
031 Völs am Schlern,16,,12,22,34
031 Völs am Schlern,17,,20,22,42
031 Völs am Schlern,18,,26,18,44
031 Völs am Schlern,19,,29,13,42
031 Völs am Schlern,20,,19,27,46
031 Völs am Schlern,21,,24,18,42
031 Völs am Schlern,22,,21,22,43
031 Völs am Schlern,23,,23,20,43
031 Völs am Schlern,24,,22,20,42
031 Völs am Schlern,25,,27,23,50
031 Völs am Schlern,26,,29,31,60
031 Völs am Schlern,27,,34,30,64
031 Völs am Schlern,28,,36,35,71
031 Völs am Schlern,29,,25,28,53
031 Völs am Schlern,30,,36,36,72
031 Völs am Schlern,31,,28,35,63
031 Völs am Schlern,32,,31,24,55
031 Völs am Schlern,33,,43,25,68
031 Völs am Schlern,34,,28,27,55
031 Völs am Schlern,35,,27,24,51
031 Völs am Schlern,36,,35,29,64
031 Völs am Schlern,37,,27,18,45
031 Völs am Schlern,38,,24,21,45
031 Völs am Schlern,39,,26,22,48
031 Völs am Schlern,40,,20,12,32
031 Völs am Schlern,41,,24,16,40
031 Völs am Schlern,42,,22,18,40
031 Völs am Schlern,43,,18,18,36
031 Völs am Schlern,44,,16,13,29
031 Völs am Schlern,45,,19,25,44
031 Völs am Schlern,46,,17,24,41
031 Völs am Schlern,47,,18,18,36
031 Völs am Schlern,48,,19,19,38
031 Völs am Schlern,49,,22,16,38
031 Völs am Schlern,50,,17,8,25
031 Völs am Schlern,51,,16,14,30
031 Völs am Schlern,52,,16,18,34
031 Völs am Schlern,53,,14,12,26
031 Völs am Schlern,54,,11,13,24
031 Völs am Schlern,55,,16,10,26
031 Völs am Schlern,56,,13,23,36
031 Völs am Schlern,57,,16,14,30
031 Völs am Schlern,58,,21,19,40
031 Völs am Schlern,59,,11,18,29
031 Völs am Schlern,60,,14,11,25
031 Völs am Schlern,61,,14,12,26
031 Völs am Schlern,62,,11,9,20
031 Völs am Schlern,63,,11,21,32
031 Völs am Schlern,64,,17,12,29
031 Völs am Schlern,65,,15,9,24
031 Völs am Schlern,66,,8,13,21
031 Völs am Schlern,67,,15,8,23
031 Völs am Schlern,68,,13,15,28
031 Völs am Schlern,69,,7,14,21
031 Völs am Schlern,70,,7,12,19
031 Völs am Schlern,71,,8,12,20
031 Völs am Schlern,72,,11,11,22
031 Völs am Schlern,73,,12,6,18
031 Völs am Schlern,74,,11,10,21
031 Völs am Schlern,75,,12,13,25
031 Völs am Schlern,76,,5,6,11
031 Völs am Schlern,77,,5,8,13
031 Völs am Schlern,78,,3,12,15
031 Völs am Schlern,79,,4,7,11
031 Völs am Schlern,80,,1,9,10
031 Völs am Schlern,81,,2,5,7
031 Völs am Schlern,82,,1,6,7
031 Völs am Schlern,83,,4,2,6
031 Völs am Schlern,84,,2,6,8
031 Völs am Schlern,85,,5,4,9
031 Völs am Schlern,86,,6,2,8
031 Völs am Schlern,87,,3,3,6
031 Völs am Schlern,88,,1,6,7
031 Völs am Schlern,89,,1,2,3
031 Völs am Schlern,90,,2,1,3
031 Völs am Schlern,91,,-,4,4
031 Völs am Schlern,92,,-,4,4
031 Völs am Schlern,94,,-,1,1
031 Völs am Schlern,95,,-,1,1
031 Völs am Schlern,97,,-,1,1
032 Franzensfeste,0,,5,5,10
032 Franzensfeste,1,,4,4,8
032 Franzensfeste,2,,5,2,7
032 Franzensfeste,3,,6,4,10
032 Franzensfeste,4,,4,1,5
032 Franzensfeste,5,,5,5,10
032 Franzensfeste,6,,5,4,9
032 Franzensfeste,7,,5,9,14
032 Franzensfeste,8,,5,3,8
032 Franzensfeste,9,,1,4,5
032 Franzensfeste,10,,5,4,9
032 Franzensfeste,11,,4,3,7
032 Franzensfeste,12,,4,3,7
032 Franzensfeste,13,,5,4,9
032 Franzensfeste,14,,3,8,11
032 Franzensfeste,15,,3,4,7
032 Franzensfeste,16,,7,4,11
032 Franzensfeste,17,,2,7,9
032 Franzensfeste,18,,7,4,11
032 Franzensfeste,19,,4,9,13
032 Franzensfeste,20,,12,6,18
032 Franzensfeste,21,,5,5,10
032 Franzensfeste,22,,3,3,6
032 Franzensfeste,23,,3,5,8
032 Franzensfeste,24,,9,9,18
032 Franzensfeste,25,,6,8,14
032 Franzensfeste,26,,2,6,8
032 Franzensfeste,27,,4,11,15
032 Franzensfeste,28,,8,2,10
032 Franzensfeste,29,,10,8,18
032 Franzensfeste,30,,7,4,11
032 Franzensfeste,31,,8,8,16
032 Franzensfeste,32,,9,5,14
032 Franzensfeste,33,,7,7,14
032 Franzensfeste,34,,9,4,13
032 Franzensfeste,35,,15,10,25
032 Franzensfeste,36,,6,8,14
032 Franzensfeste,37,,10,2,12
032 Franzensfeste,38,,5,10,15
032 Franzensfeste,39,,5,7,12
032 Franzensfeste,40,,8,9,17
032 Franzensfeste,41,,11,3,14
032 Franzensfeste,42,,3,5,8
032 Franzensfeste,43,,5,7,12
032 Franzensfeste,44,,9,7,16
032 Franzensfeste,45,,4,11,15
032 Franzensfeste,46,,8,6,14
032 Franzensfeste,47,,6,3,9
032 Franzensfeste,48,,7,1,8
032 Franzensfeste,49,,10,3,13
032 Franzensfeste,50,,2,4,6
032 Franzensfeste,51,,5,5,10
032 Franzensfeste,52,,3,4,7
032 Franzensfeste,53,,8,5,13
032 Franzensfeste,54,,4,8,12
032 Franzensfeste,55,,5,9,14
032 Franzensfeste,56,,4,2,6
032 Franzensfeste,57,,5,1,6
032 Franzensfeste,58,,5,3,8
032 Franzensfeste,59,,4,4,8
032 Franzensfeste,60,,7,4,11
032 Franzensfeste,61,,2,4,6
032 Franzensfeste,62,,7,6,13
032 Franzensfeste,63,,4,2,6
032 Franzensfeste,64,,3,3,6
032 Franzensfeste,65,,3,3,6
032 Franzensfeste,66,,3,5,8
032 Franzensfeste,67,,3,6,9
032 Franzensfeste,68,,2,8,10
032 Franzensfeste,69,,7,4,11
032 Franzensfeste,70,,4,8,12
032 Franzensfeste,71,,2,2,4
032 Franzensfeste,72,,3,7,10
032 Franzensfeste,73,,4,9,13
032 Franzensfeste,74,,4,1,5
032 Franzensfeste,75,,6,5,11
032 Franzensfeste,76,,4,8,12
032 Franzensfeste,77,,5,5,10
032 Franzensfeste,78,,2,4,6
032 Franzensfeste,79,,1,4,5
032 Franzensfeste,80,,2,1,3
032 Franzensfeste,81,,-,2,2
032 Franzensfeste,82,,1,-,1
032 Franzensfeste,84,,1,3,4
032 Franzensfeste,85,,1,3,4
032 Franzensfeste,86,,1,1,2
032 Franzensfeste,87,,-,1,1
032 Franzensfeste,88,,-,1,1
032 Franzensfeste,89,,1,-,1
032 Franzensfeste,90,,-,2,2
032 Franzensfeste,91,,-,1,1
032 Franzensfeste,93,,1,-,1
032 Franzensfeste,95,,-,1,1
033 Villnöss,0,,17,32,49
033 Villnöss,1,,24,21,45
033 Villnöss,2,,18,24,42
033 Villnöss,3,,23,20,43
033 Villnöss,4,,16,13,29
033 Villnöss,5,,15,12,27
033 Villnöss,6,,17,11,28
033 Villnöss,7,,12,14,26
033 Villnöss,8,,21,16,37
033 Villnöss,9,,13,12,25
033 Villnöss,10,,11,7,18
033 Villnöss,11,,16,23,39
033 Villnöss,12,,16,19,35
033 Villnöss,13,,10,16,26
033 Villnöss,14,,17,17,34
033 Villnöss,15,,15,14,29
033 Villnöss,16,,17,14,31
033 Villnöss,17,,11,15,26
033 Villnöss,18,,12,18,30
033 Villnöss,19,,20,9,29
033 Villnöss,20,,12,12,24
033 Villnöss,21,,15,13,28
033 Villnöss,22,,18,15,33
033 Villnöss,23,,15,12,27
033 Villnöss,24,,23,15,38
033 Villnöss,25,,21,22,43
033 Villnöss,26,,14,19,33
033 Villnöss,27,,18,23,41
033 Villnöss,28,,27,28,55
033 Villnöss,29,,20,30,50
033 Villnöss,30,,31,20,51
033 Villnöss,31,,27,21,48
033 Villnöss,32,,23,20,43
033 Villnöss,33,,26,21,47
033 Villnöss,34,,31,25,56
033 Villnöss,35,,33,25,58
033 Villnöss,36,,30,18,48
033 Villnöss,37,,26,20,46
033 Villnöss,38,,24,15,39
033 Villnöss,39,,19,13,32
033 Villnöss,40,,11,11,22
033 Villnöss,41,,8,15,23
033 Villnöss,42,,13,12,25
033 Villnöss,43,,14,16,30
033 Villnöss,44,,12,2,14
033 Villnöss,45,,16,13,29
033 Villnöss,46,,13,13,26
033 Villnöss,47,,15,11,26
033 Villnöss,48,,9,9,18
033 Villnöss,49,,7,10,17
033 Villnöss,50,,10,14,24
033 Villnöss,51,,9,9,18
033 Villnöss,52,,11,11,22
033 Villnöss,53,,8,5,13
033 Villnöss,54,,7,4,11
033 Villnöss,55,,9,14,23
033 Villnöss,56,,13,10,23
033 Villnöss,57,,13,18,31
033 Villnöss,58,,13,10,23
033 Villnöss,59,,9,18,27
033 Villnöss,60,,12,13,25
033 Villnöss,61,,13,9,22
033 Villnöss,62,,11,14,25
033 Villnöss,63,,5,16,21
033 Villnöss,64,,5,10,15
033 Villnöss,65,,12,9,21
033 Villnöss,66,,11,11,22
033 Villnöss,67,,15,14,29
033 Villnöss,68,,10,11,21
033 Villnöss,69,,12,11,23
033 Villnöss,70,,10,12,22
033 Villnöss,71,,16,7,23
033 Villnöss,72,,8,11,19
033 Villnöss,73,,5,9,14
033 Villnöss,74,,9,7,16
033 Villnöss,75,,5,13,18
033 Villnöss,76,,7,12,19
033 Villnöss,77,,4,13,17
033 Villnöss,78,,1,8,9
033 Villnöss,79,,2,7,9
033 Villnöss,80,,3,5,8
033 Villnöss,81,,1,3,4
033 Villnöss,82,,3,4,7
033 Villnöss,83,,1,1,2
033 Villnöss,84,,3,3,6
033 Villnöss,85,,5,3,8
033 Villnöss,86,,2,3,5
033 Villnöss,87,,1,2,3
033 Villnöss,88,,1,1,2
033 Villnöss,89,,1,3,4
033 Villnöss,90,,1,4,5
033 Villnöss,91,,-,4,4
033 Villnöss,93,,2,-,2
033 Villnöss,94,,-,1,1
033 Villnöss,99,,1,-,1
034 Gais,0,,19,26,45
034 Gais,1,,23,22,45
034 Gais,2,,23,13,36
034 Gais,3,,9,21,30
034 Gais,4,,24,19,43
034 Gais,5,,21,24,45
034 Gais,6,,13,19,32
034 Gais,7,,19,27,46
034 Gais,8,,25,29,54
034 Gais,9,,14,20,34
034 Gais,10,,16,13,29
034 Gais,11,,20,16,36
034 Gais,12,,16,20,36
034 Gais,13,,17,18,35
034 Gais,14,,21,16,37
034 Gais,15,,23,15,38
034 Gais,16,,20,18,38
034 Gais,17,,18,18,36
034 Gais,18,,22,19,41
034 Gais,19,,23,20,43
034 Gais,20,,25,14,39
034 Gais,21,,18,17,35
034 Gais,22,,16,20,36
034 Gais,23,,24,19,43
034 Gais,24,,21,18,39
034 Gais,25,,27,31,58
034 Gais,26,,27,22,49
034 Gais,27,,23,40,63
034 Gais,28,,29,24,53
034 Gais,29,,28,24,52
034 Gais,30,,33,36,69
034 Gais,31,,24,24,48
034 Gais,32,,22,28,50
034 Gais,33,,32,19,51
034 Gais,34,,31,28,59
034 Gais,35,,27,29,56
034 Gais,36,,15,14,29
034 Gais,37,,31,19,50
034 Gais,38,,20,28,48
034 Gais,39,,19,11,30
034 Gais,40,,19,22,41
034 Gais,41,,25,19,44
034 Gais,42,,11,15,26
034 Gais,43,,27,20,47
034 Gais,44,,15,12,27
034 Gais,45,,16,13,29
034 Gais,46,,15,13,28
034 Gais,47,,15,15,30
034 Gais,48,,17,19,36
034 Gais,49,,21,20,41
034 Gais,50,,16,11,27
034 Gais,51,,24,14,38
034 Gais,52,,22,13,35
034 Gais,53,,15,18,33
034 Gais,54,,11,9,20
034 Gais,55,,12,13,25
034 Gais,56,,13,16,29
034 Gais,57,,15,14,29
034 Gais,58,,20,14,34
034 Gais,59,,18,13,31
034 Gais,60,,12,16,28
034 Gais,61,,15,15,30
034 Gais,62,,18,16,34
034 Gais,63,,10,13,23
034 Gais,64,,14,12,26
034 Gais,65,,7,6,13
034 Gais,66,,4,10,14
034 Gais,67,,9,11,20
034 Gais,68,,11,8,19
034 Gais,69,,5,13,18
034 Gais,70,,5,5,10
034 Gais,71,,10,8,18
034 Gais,72,,6,10,16
034 Gais,73,,14,10,24
034 Gais,74,,6,6,12
034 Gais,75,,5,8,13
034 Gais,76,,7,12,19
034 Gais,77,,3,6,9
034 Gais,78,,3,5,8
034 Gais,79,,2,2,4
034 Gais,80,,1,6,7
034 Gais,81,,2,6,8
034 Gais,82,,1,5,6
034 Gais,83,,-,4,4
034 Gais,84,,-,3,3
034 Gais,85,,1,5,6
034 Gais,86,,4,2,6
034 Gais,87,,-,2,2
034 Gais,88,,1,3,4
034 Gais,89,,1,1,2
034 Gais,90,,-,2,2
034 Gais,91,,-,1,1
035 Gargazon,0,,13,7,20
035 Gargazon,1,,13,5,18
035 Gargazon,2,,7,13,20
035 Gargazon,3,,8,6,14
035 Gargazon,4,,11,5,16
035 Gargazon,5,,3,7,10
035 Gargazon,6,,10,7,17
035 Gargazon,7,,11,8,19
035 Gargazon,8,,17,10,27
035 Gargazon,9,,4,11,15
035 Gargazon,10,,9,6,15
035 Gargazon,11,,9,4,13
035 Gargazon,12,,6,10,16
035 Gargazon,13,,5,10,15
035 Gargazon,14,,10,4,14
035 Gargazon,15,,11,3,14
035 Gargazon,16,,4,7,11
035 Gargazon,17,,5,8,13
035 Gargazon,18,,10,5,15
035 Gargazon,19,,6,11,17
035 Gargazon,20,,6,8,14
035 Gargazon,21,,2,8,10
035 Gargazon,22,,4,5,9
035 Gargazon,23,,5,3,8
035 Gargazon,24,,9,6,15
035 Gargazon,25,,7,11,18
035 Gargazon,26,,11,5,16
035 Gargazon,27,,9,15,24
035 Gargazon,28,,11,16,27
035 Gargazon,29,,11,9,20
035 Gargazon,30,,13,12,25
035 Gargazon,31,,17,17,34
035 Gargazon,32,,18,20,38
035 Gargazon,33,,12,11,23
035 Gargazon,34,,12,9,21
035 Gargazon,35,,14,13,27
035 Gargazon,36,,14,16,30
035 Gargazon,37,,10,10,20
035 Gargazon,38,,10,12,22
035 Gargazon,39,,8,12,20
035 Gargazon,40,,15,11,26
035 Gargazon,41,,9,7,16
035 Gargazon,42,,18,10,28
035 Gargazon,43,,12,6,18
035 Gargazon,44,,7,2,9
035 Gargazon,45,,9,11,20
035 Gargazon,46,,15,9,24
035 Gargazon,47,,3,7,10
035 Gargazon,48,,10,7,17
035 Gargazon,49,,7,7,14
035 Gargazon,50,,6,10,16
035 Gargazon,51,,9,8,17
035 Gargazon,52,,4,10,14
035 Gargazon,53,,7,13,20
035 Gargazon,54,,7,4,11
035 Gargazon,55,,2,5,7
035 Gargazon,56,,3,8,11
035 Gargazon,57,,9,10,19
035 Gargazon,58,,11,10,21
035 Gargazon,59,,5,14,19
035 Gargazon,60,,10,6,16
035 Gargazon,61,,9,7,16
035 Gargazon,62,,7,12,19
035 Gargazon,63,,5,4,9
035 Gargazon,64,,14,2,16
035 Gargazon,65,,8,5,13
035 Gargazon,66,,3,10,13
035 Gargazon,67,,7,2,9
035 Gargazon,68,,5,7,12
035 Gargazon,69,,4,6,10
035 Gargazon,70,,2,10,12
035 Gargazon,71,,4,5,9
035 Gargazon,72,,5,5,10
035 Gargazon,73,,5,4,9
035 Gargazon,74,,5,6,11
035 Gargazon,75,,1,4,5
035 Gargazon,76,,5,6,11
035 Gargazon,77,,3,7,10
035 Gargazon,78,,6,6,12
035 Gargazon,79,,4,2,6
035 Gargazon,80,,2,2,4
035 Gargazon,81,,1,2,3
035 Gargazon,82,,-,2,2
035 Gargazon,83,,-,2,2
035 Gargazon,84,,2,3,5
035 Gargazon,85,,2,1,3
035 Gargazon,86,,2,4,6
035 Gargazon,87,,2,4,6
035 Gargazon,90,,-,2,2
035 Gargazon,91,,-,1,1
035 Gargazon,93,,-,1,1
035 Gargazon,95,,-,1,1
036 Glurns,0,,5,5,10
036 Glurns,1,,9,4,13
036 Glurns,2,,4,7,11
036 Glurns,3,,7,5,12
036 Glurns,4,,7,4,11
036 Glurns,5,,1,3,4
036 Glurns,6,,8,7,15
036 Glurns,7,,4,8,12
036 Glurns,8,,6,3,9
036 Glurns,9,,8,6,14
036 Glurns,10,,4,3,7
036 Glurns,11,,6,9,15
036 Glurns,12,,6,6,12
036 Glurns,13,,5,8,13
036 Glurns,14,,3,3,6
036 Glurns,15,,7,6,13
036 Glurns,16,,9,6,15
036 Glurns,17,,11,9,20
036 Glurns,18,,6,8,14
036 Glurns,19,,13,8,21
036 Glurns,20,,6,8,14
036 Glurns,21,,5,9,14
036 Glurns,22,,5,4,9
036 Glurns,23,,10,4,14
036 Glurns,24,,7,7,14
036 Glurns,25,,7,9,16
036 Glurns,26,,3,3,6
036 Glurns,27,,5,7,12
036 Glurns,28,,5,7,12
036 Glurns,29,,2,-,2
036 Glurns,30,,5,5,10
036 Glurns,31,,8,5,13
036 Glurns,32,,7,10,17
036 Glurns,33,,5,7,12
036 Glurns,34,,-,6,6
036 Glurns,35,,8,3,11
036 Glurns,36,,6,9,15
036 Glurns,37,,4,6,10
036 Glurns,38,,4,6,10
036 Glurns,39,,8,8,16
036 Glurns,40,,12,9,21
036 Glurns,41,,5,10,15
036 Glurns,42,,6,11,17
036 Glurns,43,,7,5,12
036 Glurns,44,,11,7,18
036 Glurns,45,,12,4,16
036 Glurns,46,,9,9,18
036 Glurns,47,,5,10,15
036 Glurns,48,,8,10,18
036 Glurns,49,,6,5,11
036 Glurns,50,,6,3,9
036 Glurns,51,,7,5,12
036 Glurns,52,,10,7,17
036 Glurns,53,,10,2,12
036 Glurns,54,,7,1,8
036 Glurns,55,,4,4,8
036 Glurns,56,,1,4,5
036 Glurns,57,,5,5,10
036 Glurns,58,,5,2,7
036 Glurns,59,,5,1,6
036 Glurns,60,,1,3,4
036 Glurns,61,,4,4,8
036 Glurns,62,,5,5,10
036 Glurns,63,,-,1,1
036 Glurns,64,,2,4,6
036 Glurns,65,,1,6,7
036 Glurns,66,,1,1,2
036 Glurns,67,,8,3,11
036 Glurns,68,,4,2,6
036 Glurns,69,,5,2,7
036 Glurns,70,,5,7,12
036 Glurns,71,,1,3,4
036 Glurns,72,,1,3,4
036 Glurns,73,,-,2,2
036 Glurns,74,,1,6,7
036 Glurns,75,,2,2,4
036 Glurns,76,,-,1,1
036 Glurns,77,,1,-,1
036 Glurns,78,,2,3,5
036 Glurns,79,,1,2,3
036 Glurns,80,,1,3,4
036 Glurns,81,,-,3,3
036 Glurns,82,,1,2,3
036 Glurns,84,,-,4,4
036 Glurns,85,,-,3,3
036 Glurns,86,,1,4,5
036 Glurns,87,,-,3,3
036 Glurns,88,,1,3,4
036 Glurns,89,,-,1,1
036 Glurns,90,,-,1,1
036 Glurns,92,,-,1,1
037 Latsch,0,,27,21,48
037 Latsch,1,,28,23,51
037 Latsch,2,,35,40,75
037 Latsch,3,,36,36,72
037 Latsch,4,,46,33,79
037 Latsch,5,,39,24,63
037 Latsch,6,,34,29,63
037 Latsch,7,,33,36,69
037 Latsch,8,,28,34,62
037 Latsch,9,,34,50,84
037 Latsch,10,,34,30,64
037 Latsch,11,,39,33,72
037 Latsch,12,,31,38,69
037 Latsch,13,,34,24,58
037 Latsch,14,,32,34,66
037 Latsch,15,,33,36,69
037 Latsch,16,,26,31,57
037 Latsch,17,,30,47,77
037 Latsch,18,,26,37,63
037 Latsch,19,,32,36,68
037 Latsch,20,,37,26,63
037 Latsch,21,,30,22,52
037 Latsch,22,,27,34,61
037 Latsch,23,,22,19,41
037 Latsch,24,,35,30,65
037 Latsch,25,,28,28,56
037 Latsch,26,,32,37,69
037 Latsch,27,,33,38,71
037 Latsch,28,,37,36,73
037 Latsch,29,,38,38,76
037 Latsch,30,,39,41,80
037 Latsch,31,,43,56,99
037 Latsch,32,,46,49,95
037 Latsch,33,,32,50,82
037 Latsch,34,,50,50,100
037 Latsch,35,,59,41,100
037 Latsch,36,,54,49,103
037 Latsch,37,,43,45,88
037 Latsch,38,,48,40,88
037 Latsch,39,,41,52,93
037 Latsch,40,,46,44,90
037 Latsch,41,,37,30,67
037 Latsch,42,,25,31,56
037 Latsch,43,,32,33,65
037 Latsch,44,,37,28,65
037 Latsch,45,,33,23,56
037 Latsch,46,,29,21,50
037 Latsch,47,,42,20,62
037 Latsch,48,,21,33,54
037 Latsch,49,,32,16,48
037 Latsch,50,,16,22,38
037 Latsch,51,,16,21,37
037 Latsch,52,,19,16,35
037 Latsch,53,,18,22,40
037 Latsch,54,,20,18,38
037 Latsch,55,,25,13,38
037 Latsch,56,,26,23,49
037 Latsch,57,,29,23,52
037 Latsch,58,,17,27,44
037 Latsch,59,,22,25,47
037 Latsch,60,,17,19,36
037 Latsch,61,,18,29,47
037 Latsch,62,,14,29,43
037 Latsch,63,,21,14,35
037 Latsch,64,,28,15,43
037 Latsch,65,,22,26,48
037 Latsch,66,,21,21,42
037 Latsch,67,,24,21,45
037 Latsch,68,,19,18,37
037 Latsch,69,,21,20,41
037 Latsch,70,,19,17,36
037 Latsch,71,,18,20,38
037 Latsch,72,,17,31,48
037 Latsch,73,,21,15,36
037 Latsch,74,,19,22,41
037 Latsch,75,,10,18,28
037 Latsch,76,,12,22,34
037 Latsch,77,,10,24,34
037 Latsch,78,,15,18,33
037 Latsch,79,,10,11,21
037 Latsch,80,,7,13,20
037 Latsch,81,,3,5,8
037 Latsch,82,,4,7,11
037 Latsch,83,,1,5,6
037 Latsch,84,,4,5,9
037 Latsch,85,,3,6,9
037 Latsch,86,,3,10,13
037 Latsch,87,,5,2,7
037 Latsch,88,,3,4,7
037 Latsch,89,,2,3,5
037 Latsch,90,,1,4,5
037 Latsch,91,,3,5,8
037 Latsch,92,,1,-,1
037 Latsch,93,,1,5,6
038 Algund,0,,35,23,58
038 Algund,1,,23,19,42
038 Algund,2,,20,20,40
038 Algund,3,,18,19,37
038 Algund,4,,32,23,55
038 Algund,5,,26,13,39
038 Algund,6,,26,19,45
038 Algund,7,,30,18,48
038 Algund,8,,26,21,47
038 Algund,9,,29,17,46
038 Algund,10,,20,29,49
038 Algund,11,,20,24,44
038 Algund,12,,27,21,48
038 Algund,13,,21,32,53
038 Algund,14,,24,20,44
038 Algund,15,,21,20,41
038 Algund,16,,23,29,52
038 Algund,17,,25,21,46
038 Algund,18,,22,22,44
038 Algund,19,,27,28,55
038 Algund,20,,18,20,38
038 Algund,21,,16,29,45
038 Algund,22,,17,28,45
038 Algund,23,,23,24,47
038 Algund,24,,23,18,41
038 Algund,25,,22,30,52
038 Algund,26,,27,17,44
038 Algund,27,,29,34,63
038 Algund,28,,24,30,54
038 Algund,29,,49,26,75
038 Algund,30,,36,32,68
038 Algund,31,,37,30,67
038 Algund,32,,36,35,71
038 Algund,33,,33,41,74
038 Algund,34,,31,39,70
038 Algund,35,,44,28,72
038 Algund,36,,35,43,78
038 Algund,37,,35,38,73
038 Algund,38,,28,43,71
038 Algund,39,,29,43,72
038 Algund,40,,35,30,65
038 Algund,41,,39,31,70
038 Algund,42,,27,28,55
038 Algund,43,,32,30,62
038 Algund,44,,24,27,51
038 Algund,45,,30,21,51
038 Algund,46,,18,31,49
038 Algund,47,,26,24,50
038 Algund,48,,27,28,55
038 Algund,49,,21,25,46
038 Algund,50,,26,27,53
038 Algund,51,,26,21,47
038 Algund,52,,23,21,44
038 Algund,53,,35,27,62
038 Algund,54,,23,25,48
038 Algund,55,,26,26,52
038 Algund,56,,22,21,43
038 Algund,57,,18,36,54
038 Algund,58,,23,25,48
038 Algund,59,,16,25,41
038 Algund,60,,26,30,56
038 Algund,61,,23,24,47
038 Algund,62,,16,13,29
038 Algund,63,,18,29,47
038 Algund,64,,16,20,36
038 Algund,65,,22,24,46
038 Algund,66,,23,23,46
038 Algund,67,,18,23,41
038 Algund,68,,15,25,40
038 Algund,69,,15,24,39
038 Algund,70,,14,23,37
038 Algund,71,,14,21,35
038 Algund,72,,13,19,32
038 Algund,73,,17,21,38
038 Algund,74,,12,16,28
038 Algund,75,,7,18,25
038 Algund,76,,7,12,19
038 Algund,77,,12,20,32
038 Algund,78,,13,15,28
038 Algund,79,,15,13,28
038 Algund,80,,8,14,22
038 Algund,81,,7,8,15
038 Algund,82,,4,6,10
038 Algund,83,,2,7,9
038 Algund,84,,6,6,12
038 Algund,85,,6,9,15
038 Algund,86,,2,7,9
038 Algund,87,,4,11,15
038 Algund,88,,1,12,13
038 Algund,89,,7,9,16
038 Algund,90,,3,4,7
038 Algund,91,,4,6,10
038 Algund,92,,1,3,4
038 Algund,93,,-,5,5
038 Algund,94,,1,3,4
038 Algund,97,,-,1,1
038 Algund,102,,-,1,1
039 Lajen,0,,15,16,31
039 Lajen,1,,20,15,35
039 Lajen,2,,12,21,33
039 Lajen,3,,17,9,26
039 Lajen,4,,8,10,18
039 Lajen,5,,12,12,24
039 Lajen,6,,13,13,26
039 Lajen,7,,15,10,25
039 Lajen,8,,19,18,37
039 Lajen,9,,8,10,18
039 Lajen,10,,17,14,31
039 Lajen,11,,13,9,22
039 Lajen,12,,13,6,19
039 Lajen,13,,18,13,31
039 Lajen,14,,19,11,30
039 Lajen,15,,8,13,21
039 Lajen,16,,9,18,27
039 Lajen,17,,20,15,35
039 Lajen,18,,10,22,32
039 Lajen,19,,20,19,39
039 Lajen,20,,19,12,31
039 Lajen,21,,23,17,40
039 Lajen,22,,18,11,29
039 Lajen,23,,18,13,31
039 Lajen,24,,19,25,44
039 Lajen,25,,27,17,44
039 Lajen,26,,16,17,33
039 Lajen,27,,19,23,42
039 Lajen,28,,17,23,40
039 Lajen,29,,21,23,44
039 Lajen,30,,28,20,48
039 Lajen,31,,18,21,39
039 Lajen,32,,24,21,45
039 Lajen,33,,22,15,37
039 Lajen,34,,29,15,44
039 Lajen,35,,21,16,37
039 Lajen,36,,16,10,26
039 Lajen,37,,27,14,41
039 Lajen,38,,12,24,36
039 Lajen,39,,11,10,21
039 Lajen,40,,15,22,37
039 Lajen,41,,19,13,32
039 Lajen,42,,14,11,25
039 Lajen,43,,11,13,24
039 Lajen,44,,13,11,24
039 Lajen,45,,5,13,18
039 Lajen,46,,9,8,17
039 Lajen,47,,8,11,19
039 Lajen,48,,9,13,22
039 Lajen,49,,13,16,29
039 Lajen,50,,5,13,18
039 Lajen,51,,10,15,25
039 Lajen,52,,14,6,20
039 Lajen,53,,11,11,22
039 Lajen,54,,13,9,22
039 Lajen,55,,11,8,19
039 Lajen,56,,12,13,25
039 Lajen,57,,20,12,32
039 Lajen,58,,17,16,33
039 Lajen,59,,15,11,26
039 Lajen,60,,17,10,27
039 Lajen,61,,7,16,23
039 Lajen,62,,7,8,15
039 Lajen,63,,7,8,15
039 Lajen,64,,8,9,17
039 Lajen,65,,8,8,16
039 Lajen,66,,5,13,18
039 Lajen,67,,10,4,14
039 Lajen,68,,5,8,13
039 Lajen,69,,8,4,12
039 Lajen,70,,5,5,10
039 Lajen,71,,8,10,18
039 Lajen,72,,8,11,19
039 Lajen,73,,10,6,16
039 Lajen,74,,6,9,15
039 Lajen,75,,7,7,14
039 Lajen,76,,7,8,15
039 Lajen,77,,4,7,11
039 Lajen,78,,5,9,14
039 Lajen,79,,2,3,5
039 Lajen,80,,3,3,6
039 Lajen,81,,1,3,4
039 Lajen,82,,1,2,3
039 Lajen,83,,-,2,2
039 Lajen,84,,2,3,5
039 Lajen,85,,1,3,4
039 Lajen,86,,2,2,4
039 Lajen,87,,2,2,4
039 Lajen,88,,2,-,2
039 Lajen,89,,-,1,1
039 Lajen,90,,2,2,4
039 Lajen,91,,1,3,4
039 Lajen,92,,-,2,2
039 Lajen,93,,1,2,3
039 Lajen,96,,-,2,2
040 Leifers,0,,87,94,181
040 Leifers,1,,83,100,183
040 Leifers,2,,107,89,196
040 Leifers,3,,98,83,181
040 Leifers,4,,93,94,187
040 Leifers,5,,86,89,175
040 Leifers,6,,77,69,146
040 Leifers,7,,83,74,157
040 Leifers,8,,86,78,164
040 Leifers,9,,92,79,171
040 Leifers,10,,66,79,145
040 Leifers,11,,72,81,153
040 Leifers,12,,62,69,131
040 Leifers,13,,78,83,161
040 Leifers,14,,76,63,139
040 Leifers,15,,73,69,142
040 Leifers,16,,75,92,167
040 Leifers,17,,58,61,119
040 Leifers,18,,69,62,131
040 Leifers,19,,69,67,136
040 Leifers,20,,67,78,145
040 Leifers,21,,80,73,153
040 Leifers,22,,92,93,185
040 Leifers,23,,102,78,180
040 Leifers,24,,100,104,204
040 Leifers,25,,145,121,266
040 Leifers,26,,130,114,244
040 Leifers,27,,131,125,256
040 Leifers,28,,132,134,266
040 Leifers,29,,125,131,256
040 Leifers,30,,156,122,278
040 Leifers,31,,136,159,295
040 Leifers,32,,152,137,289
040 Leifers,33,,154,131,285
040 Leifers,34,,166,139,305
040 Leifers,35,,166,155,321
040 Leifers,36,,140,148,288
040 Leifers,37,,139,122,261
040 Leifers,38,,126,147,273
040 Leifers,39,,139,120,259
040 Leifers,40,,121,107,228
040 Leifers,41,,92,108,200
040 Leifers,42,,99,113,212
040 Leifers,43,,143,129,272
040 Leifers,44,,106,123,229
040 Leifers,45,,91,104,195
040 Leifers,46,,112,119,231
040 Leifers,47,,106,95,201
040 Leifers,48,,106,90,196
040 Leifers,49,,96,87,183
040 Leifers,50,,98,99,197
040 Leifers,51,,113,102,215
040 Leifers,52,,104,101,205
040 Leifers,53,,124,154,278
040 Leifers,54,,81,85,166
040 Leifers,55,,101,91,192
040 Leifers,56,,98,92,190
040 Leifers,57,,96,96,192
040 Leifers,58,,88,83,171
040 Leifers,59,,96,95,191
040 Leifers,60,,98,92,190
040 Leifers,61,,93,80,173
040 Leifers,62,,63,84,147
040 Leifers,63,,64,68,132
040 Leifers,64,,58,70,128
040 Leifers,65,,71,65,136
040 Leifers,66,,63,65,128
040 Leifers,67,,71,81,152
040 Leifers,68,,57,65,122
040 Leifers,69,,59,68,127
040 Leifers,70,,47,62,109
040 Leifers,71,,49,43,92
040 Leifers,72,,41,66,107
040 Leifers,73,,37,54,91
040 Leifers,74,,30,52,82
040 Leifers,75,,30,54,84
040 Leifers,76,,31,41,72
040 Leifers,77,,31,42,73
040 Leifers,78,,22,28,50
040 Leifers,79,,18,26,44
040 Leifers,80,,15,36,51
040 Leifers,81,,6,21,27
040 Leifers,82,,3,14,17
040 Leifers,83,,7,15,22
040 Leifers,84,,4,17,21
040 Leifers,85,,7,25,32
040 Leifers,86,,12,18,30
040 Leifers,87,,9,25,34
040 Leifers,88,,5,18,23
040 Leifers,89,,3,16,19
040 Leifers,90,,7,7,14
040 Leifers,91,,3,5,8
040 Leifers,92,,2,4,6
040 Leifers,93,,1,5,6
040 Leifers,94,,1,5,6
040 Leifers,95,,1,4,5
040 Leifers,96,,1,2,3
040 Leifers,99,,-,1,1
041 Lana,0,,72,53,125
041 Lana,1,,56,57,113
041 Lana,2,,55,61,116
041 Lana,3,,65,69,134
041 Lana,4,,58,59,117
041 Lana,5,,58,69,127
041 Lana,6,,57,52,109
041 Lana,7,,57,60,117
041 Lana,8,,50,57,107
041 Lana,9,,45,59,104
041 Lana,10,,45,72,117
041 Lana,11,,59,45,104
041 Lana,12,,68,44,112
041 Lana,13,,54,48,102
041 Lana,14,,60,55,115
041 Lana,15,,58,48,106
041 Lana,16,,62,57,119
041 Lana,17,,63,49,112
041 Lana,18,,46,61,107
041 Lana,19,,50,46,96
041 Lana,20,,52,64,116
041 Lana,21,,60,49,109
041 Lana,22,,69,51,120
041 Lana,23,,56,55,111
041 Lana,24,,60,59,119
041 Lana,25,,70,65,135
041 Lana,26,,62,85,147
041 Lana,27,,89,76,165
041 Lana,28,,70,82,152
041 Lana,29,,70,90,160
041 Lana,30,,116,80,196
041 Lana,31,,75,85,160
041 Lana,32,,91,92,183
041 Lana,33,,86,98,184
041 Lana,34,,87,87,174
041 Lana,35,,95,92,187
041 Lana,36,,97,84,181
041 Lana,37,,86,76,162
041 Lana,38,,82,85,167
041 Lana,39,,77,72,149
041 Lana,40,,82,73,155
041 Lana,41,,72,84,156
041 Lana,42,,75,71,146
041 Lana,43,,60,58,118
041 Lana,44,,64,70,134
041 Lana,45,,61,61,122
041 Lana,46,,56,64,120
041 Lana,47,,48,58,106
041 Lana,48,,55,61,116
041 Lana,49,,51,55,106
041 Lana,50,,53,53,106
041 Lana,51,,55,64,119
041 Lana,52,,54,43,97
041 Lana,53,,64,61,125
041 Lana,54,,43,50,93
041 Lana,55,,50,56,106
041 Lana,56,,65,57,122
041 Lana,57,,61,68,129
041 Lana,58,,52,48,100
041 Lana,59,,40,47,87
041 Lana,60,,55,54,109
041 Lana,61,,46,56,102
041 Lana,62,,36,39,75
041 Lana,63,,44,49,93
041 Lana,64,,38,39,77
041 Lana,65,,41,45,86
041 Lana,66,,35,43,78
041 Lana,67,,32,34,66
041 Lana,68,,29,45,74
041 Lana,69,,27,39,66
041 Lana,70,,24,38,62
041 Lana,71,,38,31,69
041 Lana,72,,32,37,69
041 Lana,73,,27,40,67
041 Lana,74,,32,41,73
041 Lana,75,,12,24,36
041 Lana,76,,19,30,49
041 Lana,77,,26,38,64
041 Lana,78,,15,37,52
041 Lana,79,,20,35,55
041 Lana,80,,11,29,40
041 Lana,81,,3,13,16
041 Lana,82,,3,19,22
041 Lana,83,,4,6,10
041 Lana,84,,16,21,37
041 Lana,85,,12,14,26
041 Lana,86,,7,26,33
041 Lana,87,,7,13,20
041 Lana,88,,6,17,23
041 Lana,89,,4,13,17
041 Lana,90,,3,9,12
041 Lana,91,,3,9,12
041 Lana,92,,1,6,7
041 Lana,93,,3,5,8
041 Lana,94,,1,2,3
041 Lana,95,,-,1,1
041 Lana,96,,1,3,4
041 Lana,99,,1,-,1
041 Lana,100,,1,-,1
042 Laas,0,,20,13,33
042 Laas,1,,27,29,56
042 Laas,2,,27,26,53
042 Laas,3,,32,34,66
042 Laas,4,,33,24,57
042 Laas,5,,25,26,51
042 Laas,6,,23,20,43
042 Laas,7,,15,26,41
042 Laas,8,,25,20,45
042 Laas,9,,20,25,45
042 Laas,10,,21,23,44
042 Laas,11,,23,19,42
042 Laas,12,,28,22,50
042 Laas,13,,33,21,54
042 Laas,14,,28,28,56
042 Laas,15,,28,25,53
042 Laas,16,,22,38,60
042 Laas,17,,33,24,57
042 Laas,18,,24,28,52
042 Laas,19,,17,23,40
042 Laas,20,,30,31,61
042 Laas,21,,32,22,54
042 Laas,22,,24,21,45
042 Laas,23,,23,28,51
042 Laas,24,,29,24,53
042 Laas,25,,38,25,63
042 Laas,26,,29,33,62
042 Laas,27,,26,26,52
042 Laas,28,,28,28,56
042 Laas,29,,38,26,64
042 Laas,30,,37,41,78
042 Laas,31,,42,24,66
042 Laas,32,,32,25,57
042 Laas,33,,35,27,62
042 Laas,34,,37,33,70
042 Laas,35,,30,32,62
042 Laas,36,,28,27,55
042 Laas,37,,32,27,59
042 Laas,38,,28,27,55
042 Laas,39,,34,23,57
042 Laas,40,,35,28,63
042 Laas,41,,29,24,53
042 Laas,42,,20,26,46
042 Laas,43,,24,18,42
042 Laas,44,,17,14,31
042 Laas,45,,16,24,40
042 Laas,46,,25,12,37
042 Laas,47,,29,25,54
042 Laas,48,,15,16,31
042 Laas,49,,21,24,45
042 Laas,50,,20,20,40
042 Laas,51,,17,21,38
042 Laas,52,,28,13,41
042 Laas,53,,13,14,27
042 Laas,54,,15,13,28
042 Laas,55,,12,15,27
042 Laas,56,,13,16,29
042 Laas,57,,17,19,36
042 Laas,58,,16,21,37
042 Laas,59,,23,25,48
042 Laas,60,,15,25,40
042 Laas,61,,20,13,33
042 Laas,62,,16,15,31
042 Laas,63,,23,14,37
042 Laas,64,,18,21,39
042 Laas,65,,13,19,32
042 Laas,66,,21,12,33
042 Laas,67,,17,18,35
042 Laas,68,,20,23,43
042 Laas,69,,18,20,38
042 Laas,70,,16,12,28
042 Laas,71,,15,13,28
042 Laas,72,,15,19,34
042 Laas,73,,17,11,28
042 Laas,74,,12,13,25
042 Laas,75,,10,20,30
042 Laas,76,,16,10,26
042 Laas,77,,9,21,30
042 Laas,78,,5,7,12
042 Laas,79,,8,11,19
042 Laas,80,,5,10,15
042 Laas,81,,6,4,10
042 Laas,82,,3,3,6
042 Laas,83,,2,4,6
042 Laas,84,,-,2,2
042 Laas,85,,2,7,9
042 Laas,86,,2,7,9
042 Laas,87,,3,7,10
042 Laas,88,,-,5,5
042 Laas,89,,4,3,7
042 Laas,90,,-,3,3
042 Laas,91,,-,2,2
042 Laas,92,,-,1,1
042 Laas,93,,-,1,1
042 Laas,94,,-,2,2
042 Laas,99,,-,1,1
043 Laurein,0,,3,3,6
043 Laurein,1,,2,3,5
043 Laurein,2,,4,5,9
043 Laurein,3,,1,2,3
043 Laurein,4,,3,3,6
043 Laurein,5,,2,4,6
043 Laurein,6,,1,5,6
043 Laurein,7,,1,1,2
043 Laurein,8,,1,1,2
043 Laurein,9,,4,-,4
043 Laurein,10,,3,2,5
043 Laurein,11,,1,-,1
043 Laurein,12,,2,2,4
043 Laurein,13,,4,2,6
043 Laurein,14,,2,2,4
043 Laurein,15,,1,2,3
043 Laurein,17,,2,2,4
043 Laurein,18,,3,1,4
043 Laurein,19,,2,-,2
043 Laurein,20,,2,-,2
043 Laurein,21,,2,5,7
043 Laurein,22,,1,2,3
043 Laurein,23,,5,1,6
043 Laurein,24,,-,6,6
043 Laurein,25,,1,5,6
043 Laurein,26,,5,1,6
043 Laurein,27,,1,3,4
043 Laurein,28,,6,6,12
043 Laurein,29,,4,3,7
043 Laurein,30,,5,5,10
043 Laurein,31,,-,2,2
043 Laurein,32,,5,7,12
043 Laurein,33,,6,3,9
043 Laurein,34,,5,2,7
043 Laurein,35,,4,2,6
043 Laurein,36,,1,2,3
043 Laurein,37,,1,2,3
043 Laurein,38,,5,5,10
043 Laurein,39,,1,1,2
043 Laurein,40,,4,4,8
043 Laurein,41,,3,2,5
043 Laurein,42,,7,-,7
043 Laurein,44,,2,-,2
043 Laurein,45,,4,1,5
043 Laurein,46,,2,1,3
043 Laurein,47,,2,2,4
043 Laurein,49,,2,1,3
043 Laurein,50,,3,2,5
043 Laurein,51,,2,-,2
043 Laurein,52,,2,3,5
043 Laurein,53,,-,1,1
043 Laurein,54,,-,1,1
043 Laurein,55,,-,1,1
043 Laurein,56,,1,-,1
043 Laurein,57,,2,-,2
043 Laurein,59,,4,2,6
043 Laurein,60,,3,3,6
043 Laurein,61,,1,1,2
043 Laurein,62,,2,1,3
043 Laurein,63,,1,2,3
043 Laurein,64,,1,3,4
043 Laurein,65,,2,5,7
043 Laurein,66,,1,3,4
043 Laurein,67,,3,2,5
043 Laurein,68,,1,3,4
043 Laurein,69,,2,5,7
043 Laurein,70,,3,-,3
043 Laurein,71,,5,1,6
043 Laurein,72,,5,1,6
043 Laurein,73,,2,2,4
043 Laurein,74,,4,2,6
043 Laurein,75,,-,2,2
043 Laurein,76,,1,-,1
043 Laurein,77,,-,3,3
043 Laurein,78,,1,-,1
043 Laurein,79,,2,2,4
043 Laurein,80,,-,1,1
043 Laurein,83,,1,-,1
043 Laurein,85,,-,2,2
043 Laurein,86,,1,1,2
043 Laurein,87,,1,-,1
043 Laurein,88,,-,1,1
043 Laurein,89,,1,1,2
043 Laurein,92,,1,-,1
043 Laurein,93,,-,1,1
044 Lüsen,0,,6,9,15
044 Lüsen,1,,8,10,18
044 Lüsen,2,,15,7,22
044 Lüsen,3,,8,14,22
044 Lüsen,4,,9,12,21
044 Lüsen,5,,14,13,27
044 Lüsen,6,,9,10,19
044 Lüsen,7,,11,9,20
044 Lüsen,8,,8,10,18
044 Lüsen,9,,6,11,17
044 Lüsen,10,,18,8,26
044 Lüsen,11,,10,9,19
044 Lüsen,12,,7,8,15
044 Lüsen,13,,12,12,24
044 Lüsen,14,,3,3,6
044 Lüsen,15,,9,18,27
044 Lüsen,16,,6,11,17
044 Lüsen,17,,15,10,25
044 Lüsen,18,,11,14,25
044 Lüsen,19,,15,13,28
044 Lüsen,20,,8,10,18
044 Lüsen,21,,16,20,36
044 Lüsen,22,,7,9,16
044 Lüsen,23,,14,10,24
044 Lüsen,24,,12,12,24
044 Lüsen,25,,17,12,29
044 Lüsen,26,,9,7,16
044 Lüsen,27,,10,10,20
044 Lüsen,28,,16,12,28
044 Lüsen,29,,18,16,34
044 Lüsen,30,,9,11,20
044 Lüsen,31,,11,15,26
044 Lüsen,32,,14,21,35
044 Lüsen,33,,14,14,28
044 Lüsen,34,,18,14,32
044 Lüsen,35,,15,9,24
044 Lüsen,36,,13,8,21
044 Lüsen,37,,9,13,22
044 Lüsen,38,,12,10,22
044 Lüsen,39,,8,13,21
044 Lüsen,40,,7,4,11
044 Lüsen,41,,12,12,24
044 Lüsen,42,,9,9,18
044 Lüsen,43,,9,9,18
044 Lüsen,44,,7,7,14
044 Lüsen,45,,14,5,19
044 Lüsen,46,,8,10,18
044 Lüsen,47,,10,4,14
044 Lüsen,48,,5,7,12
044 Lüsen,49,,6,7,13
044 Lüsen,50,,8,12,20
044 Lüsen,51,,8,2,10
044 Lüsen,52,,7,4,11
044 Lüsen,53,,10,5,15
044 Lüsen,54,,4,9,13
044 Lüsen,55,,4,6,10
044 Lüsen,56,,7,7,14
044 Lüsen,57,,2,6,8
044 Lüsen,58,,7,4,11
044 Lüsen,59,,5,9,14
044 Lüsen,60,,9,7,16
044 Lüsen,61,,8,4,12
044 Lüsen,62,,8,5,13
044 Lüsen,63,,6,9,15
044 Lüsen,64,,7,5,12
044 Lüsen,65,,4,5,9
044 Lüsen,66,,7,3,10
044 Lüsen,67,,3,11,14
044 Lüsen,68,,8,5,13
044 Lüsen,69,,4,6,10
044 Lüsen,70,,6,8,14
044 Lüsen,71,,8,8,16
044 Lüsen,72,,6,4,10
044 Lüsen,73,,2,8,10
044 Lüsen,74,,4,7,11
044 Lüsen,75,,4,3,7
044 Lüsen,76,,5,4,9
044 Lüsen,77,,2,4,6
044 Lüsen,78,,2,7,9
044 Lüsen,79,,3,6,9
044 Lüsen,80,,3,2,5
044 Lüsen,81,,-,4,4
044 Lüsen,82,,1,2,3
044 Lüsen,83,,-,2,2
044 Lüsen,84,,-,3,3
044 Lüsen,85,,2,2,4
044 Lüsen,86,,3,4,7
044 Lüsen,87,,2,1,3
044 Lüsen,90,,1,1,2
044 Lüsen,95,,1,-,1
045 Margreid a.d. Weinstr.,0,,9,9,18
045 Margreid a.d. Weinstr.,1,,4,12,16
045 Margreid a.d. Weinstr.,2,,9,13,22
045 Margreid a.d. Weinstr.,3,,4,3,7
045 Margreid a.d. Weinstr.,4,,1,7,8
045 Margreid a.d. Weinstr.,5,,6,7,13
045 Margreid a.d. Weinstr.,6,,3,13,16
045 Margreid a.d. Weinstr.,7,,4,2,6
045 Margreid a.d. Weinstr.,8,,7,6,13
045 Margreid a.d. Weinstr.,9,,6,10,16
045 Margreid a.d. Weinstr.,10,,7,6,13
045 Margreid a.d. Weinstr.,11,,8,6,14
045 Margreid a.d. Weinstr.,12,,8,5,13
045 Margreid a.d. Weinstr.,13,,6,11,17
045 Margreid a.d. Weinstr.,14,,11,-,11
045 Margreid a.d. Weinstr.,15,,4,13,17
045 Margreid a.d. Weinstr.,16,,6,9,15
045 Margreid a.d. Weinstr.,17,,8,9,17
045 Margreid a.d. Weinstr.,18,,14,2,16
045 Margreid a.d. Weinstr.,19,,2,1,3
045 Margreid a.d. Weinstr.,20,,9,4,13
045 Margreid a.d. Weinstr.,21,,8,4,12
045 Margreid a.d. Weinstr.,22,,8,7,15
045 Margreid a.d. Weinstr.,23,,11,11,22
045 Margreid a.d. Weinstr.,24,,8,5,13
045 Margreid a.d. Weinstr.,25,,3,10,13
045 Margreid a.d. Weinstr.,26,,10,11,21
045 Margreid a.d. Weinstr.,27,,9,7,16
045 Margreid a.d. Weinstr.,28,,10,9,19
045 Margreid a.d. Weinstr.,29,,10,9,19
045 Margreid a.d. Weinstr.,30,,10,9,19
045 Margreid a.d. Weinstr.,31,,23,15,38
045 Margreid a.d. Weinstr.,32,,14,17,31
045 Margreid a.d. Weinstr.,33,,21,12,33
045 Margreid a.d. Weinstr.,34,,12,6,18
045 Margreid a.d. Weinstr.,35,,7,8,15
045 Margreid a.d. Weinstr.,36,,12,12,24
045 Margreid a.d. Weinstr.,37,,7,12,19
045 Margreid a.d. Weinstr.,38,,14,12,26
045 Margreid a.d. Weinstr.,39,,15,9,24
045 Margreid a.d. Weinstr.,40,,10,13,23
045 Margreid a.d. Weinstr.,41,,8,6,14
045 Margreid a.d. Weinstr.,42,,10,4,14
045 Margreid a.d. Weinstr.,43,,13,5,18
045 Margreid a.d. Weinstr.,44,,8,6,14
045 Margreid a.d. Weinstr.,45,,6,5,11
045 Margreid a.d. Weinstr.,46,,9,7,16
045 Margreid a.d. Weinstr.,47,,6,9,15
045 Margreid a.d. Weinstr.,48,,3,8,11
045 Margreid a.d. Weinstr.,49,,6,6,12
045 Margreid a.d. Weinstr.,50,,9,5,14
045 Margreid a.d. Weinstr.,51,,7,8,15
045 Margreid a.d. Weinstr.,52,,6,7,13
045 Margreid a.d. Weinstr.,53,,5,5,10
045 Margreid a.d. Weinstr.,54,,6,7,13
045 Margreid a.d. Weinstr.,55,,4,6,10
045 Margreid a.d. Weinstr.,56,,7,4,11
045 Margreid a.d. Weinstr.,57,,11,5,16
045 Margreid a.d. Weinstr.,58,,7,7,14
045 Margreid a.d. Weinstr.,59,,5,3,8
045 Margreid a.d. Weinstr.,60,,3,4,7
045 Margreid a.d. Weinstr.,61,,4,7,11
045 Margreid a.d. Weinstr.,62,,5,4,9
045 Margreid a.d. Weinstr.,63,,7,5,12
045 Margreid a.d. Weinstr.,64,,2,7,9
045 Margreid a.d. Weinstr.,65,,5,3,8
045 Margreid a.d. Weinstr.,66,,4,5,9
045 Margreid a.d. Weinstr.,67,,4,7,11
045 Margreid a.d. Weinstr.,68,,6,6,12
045 Margreid a.d. Weinstr.,69,,7,4,11
045 Margreid a.d. Weinstr.,70,,2,4,6
045 Margreid a.d. Weinstr.,71,,7,3,10
045 Margreid a.d. Weinstr.,72,,3,6,9
045 Margreid a.d. Weinstr.,73,,5,7,12
045 Margreid a.d. Weinstr.,74,,3,3,6
045 Margreid a.d. Weinstr.,75,,1,5,6
045 Margreid a.d. Weinstr.,76,,3,6,9
045 Margreid a.d. Weinstr.,77,,1,3,4
045 Margreid a.d. Weinstr.,78,,1,4,5
045 Margreid a.d. Weinstr.,79,,1,1,2
045 Margreid a.d. Weinstr.,80,,3,6,9
045 Margreid a.d. Weinstr.,81,,1,1,2
045 Margreid a.d. Weinstr.,82,,-,1,1
045 Margreid a.d. Weinstr.,83,,2,3,5
045 Margreid a.d. Weinstr.,84,,-,2,2
045 Margreid a.d. Weinstr.,85,,-,1,1
045 Margreid a.d. Weinstr.,86,,2,2,4
045 Margreid a.d. Weinstr.,87,,1,2,3
045 Margreid a.d. Weinstr.,88,,-,4,4
045 Margreid a.d. Weinstr.,89,,-,2,2
045 Margreid a.d. Weinstr.,90,,1,-,1
045 Margreid a.d. Weinstr.,92,,-,1,1
045 Margreid a.d. Weinstr.,93,,-,2,2
046 Mals,0,,31,28,59
046 Mals,1,,36,31,67
046 Mals,2,,37,32,69
046 Mals,3,,32,24,56
046 Mals,4,,33,41,74
046 Mals,5,,38,30,68
046 Mals,6,,33,31,64
046 Mals,7,,32,31,63
046 Mals,8,,34,32,66
046 Mals,9,,37,27,64
046 Mals,10,,41,35,76
046 Mals,11,,31,25,56
046 Mals,12,,31,29,60
046 Mals,13,,30,32,62
046 Mals,14,,36,35,71
046 Mals,15,,38,35,73
046 Mals,16,,30,31,61
046 Mals,17,,36,32,68
046 Mals,18,,36,37,73
046 Mals,19,,34,32,66
046 Mals,20,,31,30,61
046 Mals,21,,41,36,77
046 Mals,22,,31,25,56
046 Mals,23,,36,26,62
046 Mals,24,,42,37,79
046 Mals,25,,43,30,73
046 Mals,26,,29,42,71
046 Mals,27,,36,47,83
046 Mals,28,,37,50,87
046 Mals,29,,49,44,93
046 Mals,30,,47,41,88
046 Mals,31,,57,42,99
046 Mals,32,,44,29,73
046 Mals,33,,58,44,102
046 Mals,34,,50,40,90
046 Mals,35,,49,44,93
046 Mals,36,,50,53,103
046 Mals,37,,39,29,68
046 Mals,38,,51,38,89
046 Mals,39,,31,39,70
046 Mals,40,,31,34,65
046 Mals,41,,32,23,55
046 Mals,42,,41,34,75
046 Mals,43,,36,26,62
046 Mals,44,,30,26,56
046 Mals,45,,20,20,40
046 Mals,46,,33,30,63
046 Mals,47,,28,22,50
046 Mals,48,,33,22,55
046 Mals,49,,36,20,56
046 Mals,50,,19,27,46
046 Mals,51,,28,16,44
046 Mals,52,,23,21,44
046 Mals,53,,24,28,52
046 Mals,54,,13,19,32
046 Mals,55,,29,14,43
046 Mals,56,,26,18,44
046 Mals,57,,25,23,48
046 Mals,58,,20,19,39
046 Mals,59,,22,28,50
046 Mals,60,,26,25,51
046 Mals,61,,22,21,43
046 Mals,62,,14,30,44
046 Mals,63,,21,17,38
046 Mals,64,,16,18,34
046 Mals,65,,16,20,36
046 Mals,66,,18,22,40
046 Mals,67,,19,13,32
046 Mals,68,,14,18,32
046 Mals,69,,26,19,45
046 Mals,70,,24,18,42
046 Mals,71,,24,16,40
046 Mals,72,,21,16,37
046 Mals,73,,10,22,32
046 Mals,74,,15,21,36
046 Mals,75,,10,19,29
046 Mals,76,,7,16,23
046 Mals,77,,15,17,32
046 Mals,78,,12,15,27
046 Mals,79,,6,20,26
046 Mals,80,,6,22,28
046 Mals,81,,3,8,11
046 Mals,82,,5,3,8
046 Mals,83,,2,7,9
046 Mals,84,,5,10,15
046 Mals,85,,5,8,13
046 Mals,86,,10,19,29
046 Mals,87,,5,5,10
046 Mals,88,,2,4,6
046 Mals,89,,1,5,6
046 Mals,90,,2,2,4
046 Mals,91,,2,3,5
046 Mals,92,,2,-,2
046 Mals,93,,1,-,1
046 Mals,95,,-,1,1
046 Mals,99,,-,1,1
046 Mals,100,,-,1,1
047 Enneberg,0,,24,16,40
047 Enneberg,1,,21,12,33
047 Enneberg,2,,24,14,38
047 Enneberg,3,,17,13,30
047 Enneberg,4,,21,8,29
047 Enneberg,5,,20,14,34
047 Enneberg,6,,20,17,37
047 Enneberg,7,,15,15,30
047 Enneberg,8,,16,24,40
047 Enneberg,9,,15,17,32
047 Enneberg,10,,20,17,37
047 Enneberg,11,,22,15,37
047 Enneberg,12,,17,13,30
047 Enneberg,13,,18,10,28
047 Enneberg,14,,23,16,39
047 Enneberg,15,,19,19,38
047 Enneberg,16,,15,16,31
047 Enneberg,17,,24,20,44
047 Enneberg,18,,22,20,42
047 Enneberg,19,,24,19,43
047 Enneberg,20,,11,21,32
047 Enneberg,21,,13,25,38
047 Enneberg,22,,20,22,42
047 Enneberg,23,,13,18,31
047 Enneberg,24,,13,28,41
047 Enneberg,25,,25,31,56
047 Enneberg,26,,21,25,46
047 Enneberg,27,,22,28,50
047 Enneberg,28,,31,31,62
047 Enneberg,29,,27,21,48
047 Enneberg,30,,28,18,46
047 Enneberg,31,,21,19,40
047 Enneberg,32,,24,22,46
047 Enneberg,33,,21,25,46
047 Enneberg,34,,27,22,49
047 Enneberg,35,,23,25,48
047 Enneberg,36,,23,20,43
047 Enneberg,37,,15,16,31
047 Enneberg,38,,20,18,38
047 Enneberg,39,,14,17,31
047 Enneberg,40,,23,14,37
047 Enneberg,41,,21,8,29
047 Enneberg,42,,16,14,30
047 Enneberg,43,,14,17,31
047 Enneberg,44,,15,13,28
047 Enneberg,45,,14,11,25
047 Enneberg,46,,17,20,37
047 Enneberg,47,,14,18,32
047 Enneberg,48,,17,11,28
047 Enneberg,49,,11,16,27
047 Enneberg,50,,17,8,25
047 Enneberg,51,,15,13,28
047 Enneberg,52,,9,11,20
047 Enneberg,53,,15,17,32
047 Enneberg,54,,6,13,19
047 Enneberg,55,,20,15,35
047 Enneberg,56,,18,11,29
047 Enneberg,57,,12,20,32
047 Enneberg,58,,14,10,24
047 Enneberg,59,,13,8,21
047 Enneberg,60,,18,11,29
047 Enneberg,61,,14,20,34
047 Enneberg,62,,16,13,29
047 Enneberg,63,,13,13,26
047 Enneberg,64,,14,16,30
047 Enneberg,65,,8,11,19
047 Enneberg,66,,12,9,21
047 Enneberg,67,,9,17,26
047 Enneberg,68,,12,11,23
047 Enneberg,69,,16,16,32
047 Enneberg,70,,10,6,16
047 Enneberg,71,,10,14,24
047 Enneberg,72,,12,9,21
047 Enneberg,73,,8,9,17
047 Enneberg,74,,11,7,18
047 Enneberg,75,,5,10,15
047 Enneberg,76,,7,13,20
047 Enneberg,77,,8,7,15
047 Enneberg,78,,3,11,14
047 Enneberg,79,,7,5,12
047 Enneberg,80,,2,4,6
047 Enneberg,81,,5,3,8
047 Enneberg,82,,-,8,8
047 Enneberg,83,,1,9,10
047 Enneberg,84,,1,5,6
047 Enneberg,85,,3,5,8
047 Enneberg,86,,3,5,8
047 Enneberg,87,,-,6,6
047 Enneberg,88,,3,4,7
047 Enneberg,89,,3,3,6
047 Enneberg,90,,3,1,4
047 Enneberg,91,,-,3,3
047 Enneberg,92,,1,1,2
047 Enneberg,93,,1,-,1
047 Enneberg,94,,-,2,2
047 Enneberg,95,,-,2,2
048 Marling,0,,15,9,24
048 Marling,1,,14,8,22
048 Marling,2,,11,10,21
048 Marling,3,,14,13,27
048 Marling,4,,19,10,29
048 Marling,5,,9,8,17
048 Marling,6,,15,10,25
048 Marling,7,,18,14,32
048 Marling,8,,12,11,23
048 Marling,9,,9,15,24
048 Marling,10,,10,17,27
048 Marling,11,,11,14,25
048 Marling,12,,5,10,15
048 Marling,13,,12,10,22
048 Marling,14,,11,15,26
048 Marling,15,,11,6,17
048 Marling,16,,10,10,20
048 Marling,17,,12,8,20
048 Marling,18,,14,12,26
048 Marling,19,,12,8,20
048 Marling,20,,16,16,32
048 Marling,21,,16,13,29
048 Marling,22,,12,17,29
048 Marling,23,,16,19,35
048 Marling,24,,15,14,29
048 Marling,25,,11,12,23
048 Marling,26,,15,20,35
048 Marling,27,,13,16,29
048 Marling,28,,27,14,41
048 Marling,29,,14,17,31
048 Marling,30,,23,22,45
048 Marling,31,,27,17,44
048 Marling,32,,19,17,36
048 Marling,33,,23,25,48
048 Marling,34,,24,17,41
048 Marling,35,,25,17,42
048 Marling,36,,31,28,59
048 Marling,37,,22,20,42
048 Marling,38,,22,14,36
048 Marling,39,,19,19,38
048 Marling,40,,16,15,31
048 Marling,41,,17,11,28
048 Marling,42,,11,12,23
048 Marling,43,,11,13,24
048 Marling,44,,9,6,15
048 Marling,45,,16,11,27
048 Marling,46,,11,16,27
048 Marling,47,,13,15,28
048 Marling,48,,7,13,20
048 Marling,49,,18,16,34
048 Marling,50,,19,17,36
048 Marling,51,,9,16,25
048 Marling,52,,18,12,30
048 Marling,53,,14,15,29
048 Marling,54,,19,12,31
048 Marling,55,,15,15,30
048 Marling,56,,11,17,28
048 Marling,57,,12,12,24
048 Marling,58,,22,18,40
048 Marling,59,,12,13,25
048 Marling,60,,15,17,32
048 Marling,61,,13,13,26
048 Marling,62,,12,16,28
048 Marling,63,,14,8,22
048 Marling,64,,8,15,23
048 Marling,65,,13,11,24
048 Marling,66,,8,13,21
048 Marling,67,,11,9,20
048 Marling,68,,13,10,23
048 Marling,69,,6,11,17
048 Marling,70,,8,8,16
048 Marling,71,,9,4,13
048 Marling,72,,10,10,20
048 Marling,73,,6,14,20
048 Marling,74,,6,16,22
048 Marling,75,,4,9,13
048 Marling,76,,6,8,14
048 Marling,77,,4,5,9
048 Marling,78,,5,9,14
048 Marling,79,,-,3,3
048 Marling,80,,4,6,10
048 Marling,81,,1,5,6
048 Marling,82,,2,2,4
048 Marling,83,,1,3,4
048 Marling,84,,3,4,7
048 Marling,85,,2,5,7
048 Marling,86,,2,5,7
048 Marling,87,,2,6,8
048 Marling,89,,-,2,2
048 Marling,90,,2,2,4
048 Marling,91,,3,1,4
048 Marling,92,,1,4,5
048 Marling,93,,1,-,1
048 Marling,94,,-,3,3
048 Marling,95,,1,1,2
049 Martell,0,,2,7,9
049 Martell,1,,5,6,11
049 Martell,2,,5,7,12
049 Martell,3,,4,6,10
049 Martell,4,,8,7,15
049 Martell,5,,7,9,16
049 Martell,6,,7,7,14
049 Martell,7,,5,5,10
049 Martell,8,,8,6,14
049 Martell,9,,6,5,11
049 Martell,10,,9,3,12
049 Martell,11,,4,1,5
049 Martell,12,,8,3,11
049 Martell,13,,-,4,4
049 Martell,14,,6,7,13
049 Martell,15,,6,4,10
049 Martell,16,,9,4,13
049 Martell,17,,6,6,12
049 Martell,18,,8,5,13
049 Martell,19,,9,5,14
049 Martell,20,,8,8,16
049 Martell,21,,3,5,8
049 Martell,22,,5,5,10
049 Martell,23,,5,8,13
049 Martell,24,,2,6,8
049 Martell,25,,6,10,16
049 Martell,26,,8,6,14
049 Martell,27,,4,8,12
049 Martell,28,,12,5,17
049 Martell,29,,6,4,10
049 Martell,30,,6,14,20
049 Martell,31,,9,7,16
049 Martell,32,,5,8,13
049 Martell,33,,14,5,19
049 Martell,34,,17,9,26
049 Martell,35,,9,9,18
049 Martell,36,,14,2,16
049 Martell,37,,11,8,19
049 Martell,38,,7,5,12
049 Martell,39,,10,3,13
049 Martell,40,,7,6,13
049 Martell,41,,7,6,13
049 Martell,42,,7,3,10
049 Martell,43,,4,4,8
049 Martell,44,,7,2,9
049 Martell,45,,7,6,13
049 Martell,46,,5,4,9
049 Martell,47,,5,3,8
049 Martell,48,,6,8,14
049 Martell,49,,3,4,7
049 Martell,50,,4,2,6
049 Martell,51,,6,4,10
049 Martell,52,,5,3,8
049 Martell,53,,3,-,3
049 Martell,54,,6,1,7
049 Martell,55,,1,3,4
049 Martell,56,,2,3,5
049 Martell,57,,5,6,11
049 Martell,58,,4,4,8
049 Martell,59,,6,2,8
049 Martell,60,,2,5,7
049 Martell,61,,1,6,7
049 Martell,62,,3,5,8
049 Martell,63,,3,4,7
049 Martell,64,,4,9,13
049 Martell,65,,9,1,10
049 Martell,66,,6,5,11
049 Martell,67,,2,4,6
049 Martell,68,,6,1,7
049 Martell,69,,7,4,11
049 Martell,70,,5,3,8
049 Martell,71,,3,6,9
049 Martell,72,,3,3,6
049 Martell,73,,3,9,12
049 Martell,74,,2,3,5
049 Martell,75,,4,7,11
049 Martell,76,,1,7,8
049 Martell,77,,2,2,4
049 Martell,78,,1,2,3
049 Martell,79,,-,1,1
049 Martell,80,,1,1,2
049 Martell,81,,2,3,5
049 Martell,82,,1,-,1
049 Martell,83,,-,1,1
049 Martell,84,,4,4,8
049 Martell,85,,-,1,1
049 Martell,86,,1,-,1
049 Martell,87,,1,-,1
049 Martell,88,,3,3,6
049 Martell,89,,-,1,1
049 Martell,90,,-,1,1
049 Martell,92,,-,1,1
050 Mölten,0,,9,17,26
050 Mölten,1,,8,16,24
050 Mölten,2,,10,8,18
050 Mölten,3,,16,10,26
050 Mölten,4,,10,10,20
050 Mölten,5,,12,4,16
050 Mölten,6,,13,10,23
050 Mölten,7,,7,13,20
050 Mölten,8,,11,6,17
050 Mölten,9,,12,5,17
050 Mölten,10,,12,6,18
050 Mölten,11,,7,8,15
050 Mölten,12,,9,8,17
050 Mölten,13,,10,6,16
050 Mölten,14,,7,13,20
050 Mölten,15,,6,3,9
050 Mölten,16,,7,15,22
050 Mölten,17,,9,6,15
050 Mölten,18,,13,6,19
050 Mölten,19,,12,8,20
050 Mölten,20,,11,9,20
050 Mölten,21,,10,7,17
050 Mölten,22,,7,11,18
050 Mölten,23,,7,18,25
050 Mölten,24,,16,11,27
050 Mölten,25,,13,9,22
050 Mölten,26,,12,13,25
050 Mölten,27,,12,7,19
050 Mölten,28,,14,12,26
050 Mölten,29,,15,12,27
050 Mölten,30,,16,14,30
050 Mölten,31,,15,17,32
050 Mölten,32,,19,13,32
050 Mölten,33,,15,12,27
050 Mölten,34,,11,15,26
050 Mölten,35,,23,12,35
050 Mölten,36,,16,6,22
050 Mölten,37,,11,9,20
050 Mölten,38,,17,9,26
050 Mölten,39,,6,7,13
050 Mölten,40,,14,4,18
050 Mölten,41,,2,11,13
050 Mölten,42,,5,2,7
050 Mölten,43,,4,7,11
050 Mölten,44,,15,7,22
050 Mölten,45,,7,5,12
050 Mölten,46,,6,7,13
050 Mölten,47,,6,4,10
050 Mölten,48,,6,4,10
050 Mölten,49,,8,9,17
050 Mölten,50,,6,5,11
050 Mölten,51,,4,4,8
050 Mölten,52,,4,7,11
050 Mölten,53,,10,2,12
050 Mölten,54,,5,5,10
050 Mölten,55,,2,6,8
050 Mölten,56,,13,8,21
050 Mölten,57,,6,10,16
050 Mölten,58,,10,3,13
050 Mölten,59,,5,7,12
050 Mölten,60,,5,7,12
050 Mölten,61,,2,3,5
050 Mölten,62,,5,6,11
050 Mölten,63,,5,6,11
050 Mölten,64,,10,6,16
050 Mölten,65,,9,6,15
050 Mölten,66,,10,9,19
050 Mölten,67,,3,5,8
050 Mölten,68,,10,2,12
050 Mölten,69,,6,5,11
050 Mölten,70,,3,7,10
050 Mölten,71,,3,6,9
050 Mölten,72,,4,4,8
050 Mölten,73,,3,5,8
050 Mölten,74,,2,4,6
050 Mölten,75,,2,2,4
050 Mölten,76,,7,6,13
050 Mölten,77,,4,2,6
050 Mölten,78,,1,7,8
050 Mölten,79,,2,7,9
050 Mölten,80,,-,5,5
050 Mölten,81,,2,2,4
050 Mölten,82,,1,1,2
050 Mölten,83,,2,2,4
050 Mölten,84,,-,2,2
050 Mölten,85,,-,6,6
050 Mölten,86,,3,2,5
050 Mölten,87,,-,1,1
050 Mölten,88,,-,1,1
050 Mölten,89,,-,1,1
050 Mölten,90,,-,3,3
050 Mölten,93,,-,1,1
051 Meran,0,,151,184,335
051 Meran,1,,138,134,272
051 Meran,2,,182,149,331
051 Meran,3,,174,144,318
051 Meran,4,,154,144,298
051 Meran,5,,156,154,310
051 Meran,6,,120,132,252
051 Meran,7,,164,136,300
051 Meran,8,,145,164,309
051 Meran,9,,148,154,302
051 Meran,10,,164,144,308
051 Meran,11,,164,115,279
051 Meran,12,,156,135,291
051 Meran,13,,153,110,263
051 Meran,14,,124,170,294
051 Meran,15,,152,141,293
051 Meran,16,,139,145,284
051 Meran,17,,142,144,286
051 Meran,18,,162,149,311
051 Meran,19,,151,133,284
051 Meran,20,,136,159,295
051 Meran,21,,170,164,334
051 Meran,22,,171,195,366
051 Meran,23,,183,206,389
051 Meran,24,,209,208,417
051 Meran,25,,252,242,494
051 Meran,26,,240,230,470
051 Meran,27,,252,241,493
051 Meran,28,,269,252,521
051 Meran,29,,278,278,556
051 Meran,30,,300,294,594
051 Meran,31,,307,304,611
051 Meran,32,,313,303,616
051 Meran,33,,319,281,600
051 Meran,34,,333,294,627
051 Meran,35,,337,298,635
051 Meran,36,,343,257,600
051 Meran,37,,253,267,520
051 Meran,38,,309,292,601
051 Meran,39,,293,259,552
051 Meran,40,,273,240,513
051 Meran,41,,256,224,480
051 Meran,42,,235,239,474
051 Meran,43,,221,208,429
051 Meran,44,,199,220,419
051 Meran,45,,184,224,408
051 Meran,46,,191,218,409
051 Meran,47,,226,226,452
051 Meran,48,,214,208,422
051 Meran,49,,203,227,430
051 Meran,50,,229,249,478
051 Meran,51,,224,259,483
051 Meran,52,,231,285,516
051 Meran,53,,252,302,554
051 Meran,54,,217,224,441
051 Meran,55,,219,244,463
051 Meran,56,,274,246,520
051 Meran,57,,273,304,577
051 Meran,58,,239,280,519
051 Meran,59,,210,223,433
051 Meran,60,,217,257,474
051 Meran,61,,203,238,441
051 Meran,62,,202,233,435
051 Meran,63,,184,209,393
051 Meran,64,,182,213,395
051 Meran,65,,173,194,367
051 Meran,66,,163,184,347
051 Meran,67,,145,213,358
051 Meran,68,,136,191,327
051 Meran,69,,152,194,346
051 Meran,70,,133,154,287
051 Meran,71,,140,209,349
051 Meran,72,,124,172,296
051 Meran,73,,127,198,325
051 Meran,74,,99,179,278
051 Meran,75,,103,190,293
051 Meran,76,,90,184,274
051 Meran,77,,95,210,305
051 Meran,78,,70,196,266
051 Meran,79,,91,185,276
051 Meran,80,,62,135,197
051 Meran,81,,54,94,148
051 Meran,82,,44,84,128
051 Meran,83,,32,82,114
051 Meran,84,,49,103,152
051 Meran,85,,50,128,178
051 Meran,86,,50,110,160
051 Meran,87,,45,105,150
051 Meran,88,,28,83,111
051 Meran,89,,29,75,104
051 Meran,90,,27,69,96
051 Meran,91,,25,44,69
051 Meran,92,,10,28,38
051 Meran,93,,9,35,44
051 Meran,94,,2,19,21
051 Meran,95,,2,24,26
051 Meran,96,,2,14,16
051 Meran,97,,4,6,10
051 Meran,98,,2,5,7
051 Meran,99,,1,1,2
051 Meran,100,,-,2,2
051 Meran,101,,-,2,2
051 Meran,105,,-,1,1
052 Welsberg-Taisten,0,,21,19,40
052 Welsberg-Taisten,1,,17,11,28
052 Welsberg-Taisten,2,,22,20,42
052 Welsberg-Taisten,3,,15,17,32
052 Welsberg-Taisten,4,,17,13,30
052 Welsberg-Taisten,5,,12,15,27
052 Welsberg-Taisten,6,,14,19,33
052 Welsberg-Taisten,7,,10,9,19
052 Welsberg-Taisten,8,,19,18,37
052 Welsberg-Taisten,9,,12,17,29
052 Welsberg-Taisten,10,,7,17,24
052 Welsberg-Taisten,11,,14,16,30
052 Welsberg-Taisten,12,,16,14,30
052 Welsberg-Taisten,13,,10,14,24
052 Welsberg-Taisten,14,,9,13,22
052 Welsberg-Taisten,15,,25,14,39
052 Welsberg-Taisten,16,,19,18,37
052 Welsberg-Taisten,17,,19,15,34
052 Welsberg-Taisten,18,,9,13,22
052 Welsberg-Taisten,19,,16,18,34
052 Welsberg-Taisten,20,,24,15,39
052 Welsberg-Taisten,21,,20,15,35
052 Welsberg-Taisten,22,,12,19,31
052 Welsberg-Taisten,23,,17,15,32
052 Welsberg-Taisten,24,,15,22,37
052 Welsberg-Taisten,25,,27,18,45
052 Welsberg-Taisten,26,,26,9,35
052 Welsberg-Taisten,27,,17,27,44
052 Welsberg-Taisten,28,,32,22,54
052 Welsberg-Taisten,29,,26,22,48
052 Welsberg-Taisten,30,,20,20,40
052 Welsberg-Taisten,31,,23,12,35
052 Welsberg-Taisten,32,,30,20,50
052 Welsberg-Taisten,33,,25,26,51
052 Welsberg-Taisten,34,,25,20,45
052 Welsberg-Taisten,35,,31,22,53
052 Welsberg-Taisten,36,,24,24,48
052 Welsberg-Taisten,37,,19,25,44
052 Welsberg-Taisten,38,,20,18,38
052 Welsberg-Taisten,39,,13,15,28
052 Welsberg-Taisten,40,,23,20,43
052 Welsberg-Taisten,41,,26,18,44
052 Welsberg-Taisten,42,,12,19,31
052 Welsberg-Taisten,43,,21,19,40
052 Welsberg-Taisten,44,,18,12,30
052 Welsberg-Taisten,45,,17,13,30
052 Welsberg-Taisten,46,,19,13,32
052 Welsberg-Taisten,47,,19,11,30
052 Welsberg-Taisten,48,,17,9,26
052 Welsberg-Taisten,49,,17,15,32
052 Welsberg-Taisten,50,,14,13,27
052 Welsberg-Taisten,51,,17,16,33
052 Welsberg-Taisten,52,,10,10,20
052 Welsberg-Taisten,53,,12,13,25
052 Welsberg-Taisten,54,,10,13,23
052 Welsberg-Taisten,55,,13,11,24
052 Welsberg-Taisten,56,,13,13,26
052 Welsberg-Taisten,57,,10,12,22
052 Welsberg-Taisten,58,,19,20,39
052 Welsberg-Taisten,59,,7,13,20
052 Welsberg-Taisten,60,,14,13,27
052 Welsberg-Taisten,61,,14,10,24
052 Welsberg-Taisten,62,,10,8,18
052 Welsberg-Taisten,63,,11,10,21
052 Welsberg-Taisten,64,,3,16,19
052 Welsberg-Taisten,65,,17,16,33
052 Welsberg-Taisten,66,,12,11,23
052 Welsberg-Taisten,67,,11,13,24
052 Welsberg-Taisten,68,,9,12,21
052 Welsberg-Taisten,69,,10,9,19
052 Welsberg-Taisten,70,,11,12,23
052 Welsberg-Taisten,71,,7,21,28
052 Welsberg-Taisten,72,,11,12,23
052 Welsberg-Taisten,73,,8,7,15
052 Welsberg-Taisten,74,,1,8,9
052 Welsberg-Taisten,75,,7,12,19
052 Welsberg-Taisten,76,,6,11,17
052 Welsberg-Taisten,77,,6,8,14
052 Welsberg-Taisten,78,,5,10,15
052 Welsberg-Taisten,79,,5,9,14
052 Welsberg-Taisten,80,,-,8,8
052 Welsberg-Taisten,81,,4,1,5
052 Welsberg-Taisten,82,,2,4,6
052 Welsberg-Taisten,83,,3,1,4
052 Welsberg-Taisten,84,,5,5,10
052 Welsberg-Taisten,85,,4,1,5
052 Welsberg-Taisten,86,,-,5,5
052 Welsberg-Taisten,87,,1,4,5
052 Welsberg-Taisten,88,,-,5,5
052 Welsberg-Taisten,89,,1,5,6
052 Welsberg-Taisten,90,,-,5,5
052 Welsberg-Taisten,91,,-,2,2
052 Welsberg-Taisten,92,,1,2,3
052 Welsberg-Taisten,93,,-,1,1
052 Welsberg-Taisten,95,,-,1,1
052 Welsberg-Taisten,99,,1,-,1
052 Welsberg-Taisten,111,,-,1,1
053 Montan,0,,6,11,17
053 Montan,1,,7,10,17
053 Montan,2,,6,8,14
053 Montan,3,,12,10,22
053 Montan,4,,14,15,29
053 Montan,5,,12,5,17
053 Montan,6,,5,8,13
053 Montan,7,,7,10,17
053 Montan,8,,13,10,23
053 Montan,9,,10,8,18
053 Montan,10,,10,10,20
053 Montan,11,,12,14,26
053 Montan,12,,9,17,26
053 Montan,13,,14,5,19
053 Montan,14,,10,9,19
053 Montan,15,,7,3,10
053 Montan,16,,10,5,15
053 Montan,17,,9,7,16
053 Montan,18,,10,7,17
053 Montan,19,,4,4,8
053 Montan,20,,10,9,19
053 Montan,21,,9,6,15
053 Montan,22,,6,5,11
053 Montan,23,,6,4,10
053 Montan,24,,10,9,19
053 Montan,25,,8,9,17
053 Montan,26,,11,3,14
053 Montan,27,,11,3,14
053 Montan,28,,14,10,24
053 Montan,29,,11,12,23
053 Montan,30,,11,15,26
053 Montan,31,,12,17,29
053 Montan,32,,10,12,22
053 Montan,33,,11,14,25
053 Montan,34,,26,13,39
053 Montan,35,,18,13,31
053 Montan,36,,12,17,29
053 Montan,37,,12,15,27
053 Montan,38,,18,11,29
053 Montan,39,,12,12,24
053 Montan,40,,11,11,22
053 Montan,41,,14,9,23
053 Montan,42,,16,11,27
053 Montan,43,,7,14,21
053 Montan,44,,7,11,18
053 Montan,45,,13,11,24
053 Montan,46,,11,8,19
053 Montan,47,,12,3,15
053 Montan,48,,7,6,13
053 Montan,49,,4,4,8
053 Montan,50,,9,3,12
053 Montan,51,,5,6,11
053 Montan,52,,7,9,16
053 Montan,53,,5,2,7
053 Montan,54,,3,4,7
053 Montan,55,,2,5,7
053 Montan,56,,5,7,12
053 Montan,57,,6,6,12
053 Montan,58,,8,4,12
053 Montan,59,,9,7,16
053 Montan,60,,8,9,17
053 Montan,61,,9,9,18
053 Montan,62,,2,7,9
053 Montan,63,,7,11,18
053 Montan,64,,1,9,10
053 Montan,65,,4,6,10
053 Montan,66,,16,5,21
053 Montan,67,,5,8,13
053 Montan,68,,9,11,20
053 Montan,69,,11,12,23
053 Montan,70,,8,9,17
053 Montan,71,,9,3,12
053 Montan,72,,7,5,12
053 Montan,73,,8,9,17
053 Montan,74,,5,8,13
053 Montan,75,,3,8,11
053 Montan,76,,6,11,17
053 Montan,77,,5,9,14
053 Montan,78,,6,4,10
053 Montan,79,,2,8,10
053 Montan,80,,2,5,7
053 Montan,81,,1,4,5
053 Montan,82,,2,5,7
053 Montan,83,,-,3,3
053 Montan,84,,1,8,9
053 Montan,85,,3,4,7
053 Montan,86,,1,5,6
053 Montan,87,,1,3,4
053 Montan,88,,1,3,4
053 Montan,89,,2,-,2
053 Montan,90,,-,2,2
053 Montan,91,,-,4,4
053 Montan,92,,1,1,2
053 Montan,96,,-,1,1
053 Montan,98,,-,1,1
054 Moos in Passeier,0,,25,9,34
054 Moos in Passeier,1,,13,18,31
054 Moos in Passeier,2,,13,16,29
054 Moos in Passeier,3,,18,19,37
054 Moos in Passeier,4,,9,12,21
054 Moos in Passeier,5,,18,21,39
054 Moos in Passeier,6,,19,13,32
054 Moos in Passeier,7,,18,18,36
054 Moos in Passeier,8,,18,21,39
054 Moos in Passeier,9,,16,13,29
054 Moos in Passeier,10,,18,19,37
054 Moos in Passeier,11,,14,20,34
054 Moos in Passeier,12,,16,14,30
054 Moos in Passeier,13,,17,15,32
054 Moos in Passeier,14,,19,13,32
054 Moos in Passeier,15,,23,21,44
054 Moos in Passeier,16,,16,14,30
054 Moos in Passeier,17,,18,22,40
054 Moos in Passeier,18,,20,19,39
054 Moos in Passeier,19,,20,22,42
054 Moos in Passeier,20,,21,16,37
054 Moos in Passeier,21,,26,19,45
054 Moos in Passeier,22,,22,20,42
054 Moos in Passeier,23,,14,14,28
054 Moos in Passeier,24,,27,22,49
054 Moos in Passeier,25,,26,13,39
054 Moos in Passeier,26,,13,27,40
054 Moos in Passeier,27,,22,15,37
054 Moos in Passeier,28,,22,18,40
054 Moos in Passeier,29,,23,12,35
054 Moos in Passeier,30,,22,17,39
054 Moos in Passeier,31,,18,24,42
054 Moos in Passeier,32,,22,20,42
054 Moos in Passeier,33,,27,21,48
054 Moos in Passeier,34,,22,10,32
054 Moos in Passeier,35,,26,10,36
054 Moos in Passeier,36,,16,17,33
054 Moos in Passeier,37,,12,22,34
054 Moos in Passeier,38,,9,8,17
054 Moos in Passeier,39,,18,17,35
054 Moos in Passeier,40,,19,15,34
054 Moos in Passeier,41,,14,16,30
054 Moos in Passeier,42,,21,8,29
054 Moos in Passeier,43,,9,8,17
054 Moos in Passeier,44,,10,9,19
054 Moos in Passeier,45,,17,8,25
054 Moos in Passeier,46,,7,9,16
054 Moos in Passeier,47,,8,5,13
054 Moos in Passeier,48,,12,10,22
054 Moos in Passeier,49,,8,9,17
054 Moos in Passeier,50,,17,9,26
054 Moos in Passeier,51,,6,7,13
054 Moos in Passeier,52,,20,10,30
054 Moos in Passeier,53,,9,8,17
054 Moos in Passeier,54,,8,7,15
054 Moos in Passeier,55,,9,9,18
054 Moos in Passeier,56,,15,12,27
054 Moos in Passeier,57,,6,12,18
054 Moos in Passeier,58,,11,15,26
054 Moos in Passeier,59,,9,10,19
054 Moos in Passeier,60,,5,7,12
054 Moos in Passeier,61,,11,9,20
054 Moos in Passeier,62,,6,6,12
054 Moos in Passeier,63,,8,8,16
054 Moos in Passeier,64,,9,8,17
054 Moos in Passeier,65,,10,14,24
054 Moos in Passeier,66,,9,10,19
054 Moos in Passeier,67,,9,4,13
054 Moos in Passeier,68,,11,8,19
054 Moos in Passeier,69,,11,8,19
054 Moos in Passeier,70,,8,13,21
054 Moos in Passeier,71,,4,10,14
054 Moos in Passeier,72,,8,6,14
054 Moos in Passeier,73,,10,3,13
054 Moos in Passeier,74,,9,7,16
054 Moos in Passeier,75,,3,8,11
054 Moos in Passeier,76,,4,3,7
054 Moos in Passeier,77,,2,5,7
054 Moos in Passeier,78,,2,3,5
054 Moos in Passeier,79,,2,3,5
054 Moos in Passeier,80,,1,4,5
054 Moos in Passeier,81,,1,1,2
054 Moos in Passeier,82,,3,2,5
054 Moos in Passeier,83,,1,3,4
054 Moos in Passeier,84,,2,1,3
054 Moos in Passeier,85,,1,6,7
054 Moos in Passeier,86,,1,2,3
054 Moos in Passeier,87,,1,2,3
054 Moos in Passeier,88,,1,-,1
054 Moos in Passeier,89,,-,2,2
054 Moos in Passeier,90,,-,1,1
054 Moos in Passeier,91,,1,-,1
054 Moos in Passeier,93,,-,1,1
055 Nals,0,,17,8,25
055 Nals,1,,14,8,22
055 Nals,2,,15,4,19
055 Nals,3,,12,10,22
055 Nals,4,,9,7,16
055 Nals,5,,11,9,20
055 Nals,6,,7,12,19
055 Nals,7,,14,9,23
055 Nals,8,,8,11,19
055 Nals,9,,10,8,18
055 Nals,10,,11,8,19
055 Nals,11,,9,11,20
055 Nals,12,,11,11,22
055 Nals,13,,5,2,7
055 Nals,14,,13,5,18
055 Nals,15,,8,10,18
055 Nals,16,,5,8,13
055 Nals,17,,7,13,20
055 Nals,18,,10,9,19
055 Nals,19,,14,9,23
055 Nals,20,,8,6,14
055 Nals,21,,10,7,17
055 Nals,22,,6,4,10
055 Nals,23,,10,15,25
055 Nals,24,,4,8,12
055 Nals,25,,18,10,28
055 Nals,26,,9,7,16
055 Nals,27,,9,14,23
055 Nals,28,,13,12,25
055 Nals,29,,19,13,32
055 Nals,30,,9,14,23
055 Nals,31,,13,19,32
055 Nals,32,,14,14,28
055 Nals,33,,14,10,24
055 Nals,34,,22,16,38
055 Nals,35,,21,18,39
055 Nals,36,,12,22,34
055 Nals,37,,15,14,29
055 Nals,38,,15,14,29
055 Nals,39,,11,9,20
055 Nals,40,,14,13,27
055 Nals,41,,17,16,33
055 Nals,42,,9,9,18
055 Nals,43,,7,9,16
055 Nals,44,,19,15,34
055 Nals,45,,6,8,14
055 Nals,46,,6,7,13
055 Nals,47,,7,7,14
055 Nals,48,,4,12,16
055 Nals,49,,6,10,16
055 Nals,50,,11,9,20
055 Nals,51,,12,12,24
055 Nals,52,,12,5,17
055 Nals,53,,6,13,19
055 Nals,54,,7,11,18
055 Nals,55,,6,11,17
055 Nals,56,,12,6,18
055 Nals,57,,5,8,13
055 Nals,58,,12,5,17
055 Nals,59,,7,10,17
055 Nals,60,,10,9,19
055 Nals,61,,7,8,15
055 Nals,62,,3,13,16
055 Nals,63,,5,4,9
055 Nals,64,,7,6,13
055 Nals,65,,6,6,12
055 Nals,66,,10,11,21
055 Nals,67,,6,4,10
055 Nals,68,,3,7,10
055 Nals,69,,4,6,10
055 Nals,70,,9,8,17
055 Nals,71,,7,8,15
055 Nals,72,,6,6,12
055 Nals,73,,8,6,14
055 Nals,74,,6,5,11
055 Nals,75,,3,2,5
055 Nals,76,,1,6,7
055 Nals,77,,3,7,10
055 Nals,78,,2,9,11
055 Nals,79,,1,1,2
055 Nals,80,,1,5,6
055 Nals,81,,2,-,2
055 Nals,82,,1,-,1
055 Nals,83,,-,1,1
055 Nals,84,,4,3,7
055 Nals,85,,-,5,5
055 Nals,86,,1,1,2
055 Nals,87,,2,2,4
055 Nals,88,,-,3,3
055 Nals,89,,1,2,3
055 Nals,90,,-,1,1
055 Nals,91,,-,1,1
055 Nals,93,,-,1,1
055 Nals,94,,-,1,1
056 Naturns,0,,30,27,57
056 Naturns,1,,31,33,64
056 Naturns,2,,23,19,42
056 Naturns,3,,33,34,67
056 Naturns,4,,48,33,81
056 Naturns,5,,36,38,74
056 Naturns,6,,34,39,73
056 Naturns,7,,32,41,73
056 Naturns,8,,44,39,83
056 Naturns,9,,35,31,66
056 Naturns,10,,38,24,62
056 Naturns,11,,43,35,78
056 Naturns,12,,34,19,53
056 Naturns,13,,29,26,55
056 Naturns,14,,37,25,62
056 Naturns,15,,37,19,56
056 Naturns,16,,29,35,64
056 Naturns,17,,37,28,65
056 Naturns,18,,36,48,84
056 Naturns,19,,33,29,62
056 Naturns,20,,40,38,78
056 Naturns,21,,35,40,75
056 Naturns,22,,33,37,70
056 Naturns,23,,33,34,67
056 Naturns,24,,32,38,70
056 Naturns,25,,42,38,80
056 Naturns,26,,43,38,81
056 Naturns,27,,42,41,83
056 Naturns,28,,42,43,85
056 Naturns,29,,44,43,87
056 Naturns,30,,41,48,89
056 Naturns,31,,48,39,87
056 Naturns,32,,46,47,93
056 Naturns,33,,53,43,96
056 Naturns,34,,41,51,92
056 Naturns,35,,46,37,83
056 Naturns,36,,40,47,87
056 Naturns,37,,43,46,89
056 Naturns,38,,39,47,86
056 Naturns,39,,56,39,95
056 Naturns,40,,43,40,83
056 Naturns,41,,30,35,65
056 Naturns,42,,33,34,67
056 Naturns,43,,42,35,77
056 Naturns,44,,32,32,64
056 Naturns,45,,40,33,73
056 Naturns,46,,32,29,61
056 Naturns,47,,37,37,74
056 Naturns,48,,35,37,72
056 Naturns,49,,27,33,60
056 Naturns,50,,27,20,47
056 Naturns,51,,32,26,58
056 Naturns,52,,17,18,35
056 Naturns,53,,27,31,58
056 Naturns,54,,27,18,45
056 Naturns,55,,21,19,40
056 Naturns,56,,27,35,62
056 Naturns,57,,33,35,68
056 Naturns,58,,42,31,73
056 Naturns,59,,21,20,41
056 Naturns,60,,20,20,40
056 Naturns,61,,24,17,41
056 Naturns,62,,23,23,46
056 Naturns,63,,21,20,41
056 Naturns,64,,22,11,33
056 Naturns,65,,21,20,41
056 Naturns,66,,18,14,32
056 Naturns,67,,12,20,32
056 Naturns,68,,12,24,36
056 Naturns,69,,20,24,44
056 Naturns,70,,16,18,34
056 Naturns,71,,18,16,34
056 Naturns,72,,14,20,34
056 Naturns,73,,13,19,32
056 Naturns,74,,14,17,31
056 Naturns,75,,17,17,34
056 Naturns,76,,14,13,27
056 Naturns,77,,7,16,23
056 Naturns,78,,9,19,28
056 Naturns,79,,4,8,12
056 Naturns,80,,4,12,16
056 Naturns,81,,3,5,8
056 Naturns,82,,3,2,5
056 Naturns,83,,4,4,8
056 Naturns,84,,1,10,11
056 Naturns,85,,5,10,15
056 Naturns,86,,5,15,20
056 Naturns,87,,3,7,10
056 Naturns,88,,5,8,13
056 Naturns,89,,6,1,7
056 Naturns,90,,1,8,9
056 Naturns,91,,-,2,2
056 Naturns,92,,1,4,5
056 Naturns,93,,1,1,2
056 Naturns,94,,1,2,3
056 Naturns,95,,-,1,1
056 Naturns,98,,-,1,1
056 Naturns,99,,1,-,1
057 Natz-Schabs,0,,15,17,32
057 Natz-Schabs,1,,21,17,38
057 Natz-Schabs,2,,17,17,34
057 Natz-Schabs,3,,23,16,39
057 Natz-Schabs,4,,16,13,29
057 Natz-Schabs,5,,20,16,36
057 Natz-Schabs,6,,15,18,33
057 Natz-Schabs,7,,15,14,29
057 Natz-Schabs,8,,22,22,44
057 Natz-Schabs,9,,13,27,40
057 Natz-Schabs,10,,14,23,37
057 Natz-Schabs,11,,23,18,41
057 Natz-Schabs,12,,20,20,40
057 Natz-Schabs,13,,18,21,39
057 Natz-Schabs,14,,19,21,40
057 Natz-Schabs,15,,18,16,34
057 Natz-Schabs,16,,19,19,38
057 Natz-Schabs,17,,11,20,31
057 Natz-Schabs,18,,18,22,40
057 Natz-Schabs,19,,23,12,35
057 Natz-Schabs,20,,13,14,27
057 Natz-Schabs,21,,12,12,24
057 Natz-Schabs,22,,14,11,25
057 Natz-Schabs,23,,11,14,25
057 Natz-Schabs,24,,14,17,31
057 Natz-Schabs,25,,13,19,32
057 Natz-Schabs,26,,16,21,37
057 Natz-Schabs,27,,17,20,37
057 Natz-Schabs,28,,23,18,41
057 Natz-Schabs,29,,26,25,51
057 Natz-Schabs,30,,26,16,42
057 Natz-Schabs,31,,32,13,45
057 Natz-Schabs,32,,27,27,54
057 Natz-Schabs,33,,29,15,44
057 Natz-Schabs,34,,28,32,60
057 Natz-Schabs,35,,31,24,55
057 Natz-Schabs,36,,24,25,49
057 Natz-Schabs,37,,15,20,35
057 Natz-Schabs,38,,18,18,36
057 Natz-Schabs,39,,27,22,49
057 Natz-Schabs,40,,22,19,41
057 Natz-Schabs,41,,23,18,41
057 Natz-Schabs,42,,19,19,38
057 Natz-Schabs,43,,20,20,40
057 Natz-Schabs,44,,20,16,36
057 Natz-Schabs,45,,11,13,24
057 Natz-Schabs,46,,17,15,32
057 Natz-Schabs,47,,14,9,23
057 Natz-Schabs,48,,13,9,22
057 Natz-Schabs,49,,18,16,34
057 Natz-Schabs,50,,20,14,34
057 Natz-Schabs,51,,12,13,25
057 Natz-Schabs,52,,11,13,24
057 Natz-Schabs,53,,15,10,25
057 Natz-Schabs,54,,9,7,16
057 Natz-Schabs,55,,13,12,25
057 Natz-Schabs,56,,9,8,17
057 Natz-Schabs,57,,13,7,20
057 Natz-Schabs,58,,14,9,23
057 Natz-Schabs,59,,4,8,12
057 Natz-Schabs,60,,2,7,9
057 Natz-Schabs,61,,6,6,12
057 Natz-Schabs,62,,13,7,20
057 Natz-Schabs,63,,10,4,14
057 Natz-Schabs,64,,9,7,16
057 Natz-Schabs,65,,7,3,10
057 Natz-Schabs,66,,8,12,20
057 Natz-Schabs,67,,6,7,13
057 Natz-Schabs,68,,8,4,12
057 Natz-Schabs,69,,5,7,12
057 Natz-Schabs,70,,11,2,13
057 Natz-Schabs,71,,4,7,11
057 Natz-Schabs,72,,2,5,7
057 Natz-Schabs,73,,4,7,11
057 Natz-Schabs,74,,3,6,9
057 Natz-Schabs,75,,2,7,9
057 Natz-Schabs,76,,2,9,11
057 Natz-Schabs,77,,5,4,9
057 Natz-Schabs,78,,5,3,8
057 Natz-Schabs,79,,2,9,11
057 Natz-Schabs,80,,-,2,2
057 Natz-Schabs,81,,1,4,5
057 Natz-Schabs,82,,1,2,3
057 Natz-Schabs,83,,1,-,1
057 Natz-Schabs,84,,1,1,2
057 Natz-Schabs,85,,-,1,1
057 Natz-Schabs,86,,2,-,2
057 Natz-Schabs,87,,-,4,4
057 Natz-Schabs,88,,1,1,2
057 Natz-Schabs,90,,2,-,2
057 Natz-Schabs,91,,1,1,2
057 Natz-Schabs,93,,1,-,1
058 Welschnofen,0,,8,13,21
058 Welschnofen,1,,13,7,20
058 Welschnofen,2,,11,11,22
058 Welschnofen,3,,7,11,18
058 Welschnofen,4,,14,13,27
058 Welschnofen,5,,10,12,22
058 Welschnofen,6,,11,10,21
058 Welschnofen,7,,13,11,24
058 Welschnofen,8,,13,11,24
058 Welschnofen,9,,10,14,24
058 Welschnofen,10,,13,8,21
058 Welschnofen,11,,12,15,27
058 Welschnofen,12,,9,10,19
058 Welschnofen,13,,6,11,17
058 Welschnofen,14,,11,7,18
058 Welschnofen,15,,7,8,15
058 Welschnofen,16,,10,13,23
058 Welschnofen,17,,10,17,27
058 Welschnofen,18,,12,10,22
058 Welschnofen,19,,12,7,19
058 Welschnofen,20,,11,3,14
058 Welschnofen,21,,13,14,27
058 Welschnofen,22,,10,17,27
058 Welschnofen,23,,18,12,30
058 Welschnofen,24,,16,11,27
058 Welschnofen,25,,13,16,29
058 Welschnofen,26,,12,14,26
058 Welschnofen,27,,11,12,23
058 Welschnofen,28,,12,14,26
058 Welschnofen,29,,13,12,25
058 Welschnofen,30,,15,14,29
058 Welschnofen,31,,19,20,39
058 Welschnofen,32,,18,15,33
058 Welschnofen,33,,18,14,32
058 Welschnofen,34,,21,15,36
058 Welschnofen,35,,12,8,20
058 Welschnofen,36,,19,18,37
058 Welschnofen,37,,12,14,26
058 Welschnofen,38,,16,17,33
058 Welschnofen,39,,20,8,28
058 Welschnofen,40,,13,12,25
058 Welschnofen,41,,17,10,27
058 Welschnofen,42,,9,13,22
058 Welschnofen,43,,10,12,22
058 Welschnofen,44,,15,14,29
058 Welschnofen,45,,14,11,25
058 Welschnofen,46,,10,14,24
058 Welschnofen,47,,11,8,19
058 Welschnofen,48,,18,8,26
058 Welschnofen,49,,8,8,16
058 Welschnofen,50,,13,13,26
058 Welschnofen,51,,9,11,20
058 Welschnofen,52,,9,7,16
058 Welschnofen,53,,10,10,20
058 Welschnofen,54,,9,6,15
058 Welschnofen,55,,7,11,18
058 Welschnofen,56,,14,10,24
058 Welschnofen,57,,12,13,25
058 Welschnofen,58,,11,7,18
058 Welschnofen,59,,8,7,15
058 Welschnofen,60,,11,7,18
058 Welschnofen,61,,7,7,14
058 Welschnofen,62,,9,4,13
058 Welschnofen,63,,5,14,19
058 Welschnofen,64,,8,6,14
058 Welschnofen,65,,13,10,23
058 Welschnofen,66,,10,14,24
058 Welschnofen,67,,7,7,14
058 Welschnofen,68,,5,9,14
058 Welschnofen,69,,8,8,16
058 Welschnofen,70,,10,12,22
058 Welschnofen,71,,7,6,13
058 Welschnofen,72,,4,4,8
058 Welschnofen,73,,5,7,12
058 Welschnofen,74,,7,6,13
058 Welschnofen,75,,5,14,19
058 Welschnofen,76,,7,8,15
058 Welschnofen,77,,6,7,13
058 Welschnofen,78,,3,11,14
058 Welschnofen,79,,3,7,10
058 Welschnofen,80,,1,6,7
058 Welschnofen,81,,2,2,4
058 Welschnofen,82,,1,1,2
058 Welschnofen,83,,2,5,7
058 Welschnofen,84,,1,4,5
058 Welschnofen,85,,3,3,6
058 Welschnofen,86,,-,9,9
058 Welschnofen,87,,2,7,9
058 Welschnofen,88,,2,2,4
058 Welschnofen,89,,2,4,6
058 Welschnofen,90,,1,3,4
058 Welschnofen,91,,2,-,2
058 Welschnofen,92,,-,2,2
058 Welschnofen,93,,-,2,2
058 Welschnofen,95,,-,1,1
058 Welschnofen,97,,1,1,2
058 Welschnofen,99,,-,1,1
059 Deutschnofen,0,,30,23,53
059 Deutschnofen,1,,33,13,46
059 Deutschnofen,2,,23,27,50
059 Deutschnofen,3,,17,28,45
059 Deutschnofen,4,,26,25,51
059 Deutschnofen,5,,30,15,45
059 Deutschnofen,6,,22,27,49
059 Deutschnofen,7,,32,28,60
059 Deutschnofen,8,,19,20,39
059 Deutschnofen,9,,35,28,63
059 Deutschnofen,10,,23,21,44
059 Deutschnofen,11,,24,33,57
059 Deutschnofen,12,,20,25,45
059 Deutschnofen,13,,28,18,46
059 Deutschnofen,14,,26,19,45
059 Deutschnofen,15,,34,27,61
059 Deutschnofen,16,,22,22,44
059 Deutschnofen,17,,21,35,56
059 Deutschnofen,18,,20,17,37
059 Deutschnofen,19,,28,20,48
059 Deutschnofen,20,,22,27,49
059 Deutschnofen,21,,23,19,42
059 Deutschnofen,22,,32,23,55
059 Deutschnofen,23,,13,17,30
059 Deutschnofen,24,,19,28,47
059 Deutschnofen,25,,28,34,62
059 Deutschnofen,26,,17,27,44
059 Deutschnofen,27,,22,32,54
059 Deutschnofen,28,,27,23,50
059 Deutschnofen,29,,28,25,53
059 Deutschnofen,30,,44,27,71
059 Deutschnofen,31,,25,26,51
059 Deutschnofen,32,,30,29,59
059 Deutschnofen,33,,32,33,65
059 Deutschnofen,34,,40,23,63
059 Deutschnofen,35,,31,26,57
059 Deutschnofen,36,,31,27,58
059 Deutschnofen,37,,26,27,53
059 Deutschnofen,38,,35,22,57
059 Deutschnofen,39,,42,25,67
059 Deutschnofen,40,,25,20,45
059 Deutschnofen,41,,24,31,55
059 Deutschnofen,42,,23,26,49
059 Deutschnofen,43,,34,26,60
059 Deutschnofen,44,,29,23,52
059 Deutschnofen,45,,26,20,46
059 Deutschnofen,46,,22,18,40
059 Deutschnofen,47,,24,22,46
059 Deutschnofen,48,,22,14,36
059 Deutschnofen,49,,18,21,39
059 Deutschnofen,50,,24,13,37
059 Deutschnofen,51,,25,18,43
059 Deutschnofen,52,,13,14,27
059 Deutschnofen,53,,19,22,41
059 Deutschnofen,54,,17,16,33
059 Deutschnofen,55,,16,18,34
059 Deutschnofen,56,,26,21,47
059 Deutschnofen,57,,20,16,36
059 Deutschnofen,58,,15,24,39
059 Deutschnofen,59,,13,19,32
059 Deutschnofen,60,,27,14,41
059 Deutschnofen,61,,16,23,39
059 Deutschnofen,62,,11,8,19
059 Deutschnofen,63,,15,10,25
059 Deutschnofen,64,,9,13,22
059 Deutschnofen,65,,16,12,28
059 Deutschnofen,66,,9,14,23
059 Deutschnofen,67,,15,15,30
059 Deutschnofen,68,,12,9,21
059 Deutschnofen,69,,12,11,23
059 Deutschnofen,70,,10,11,21
059 Deutschnofen,71,,10,23,33
059 Deutschnofen,72,,10,15,25
059 Deutschnofen,73,,17,11,28
059 Deutschnofen,74,,11,22,33
059 Deutschnofen,75,,7,13,20
059 Deutschnofen,76,,8,12,20
059 Deutschnofen,77,,10,19,29
059 Deutschnofen,78,,7,17,24
059 Deutschnofen,79,,5,12,17
059 Deutschnofen,80,,2,6,8
059 Deutschnofen,81,,4,7,11
059 Deutschnofen,82,,1,5,6
059 Deutschnofen,83,,4,3,7
059 Deutschnofen,84,,6,7,13
059 Deutschnofen,85,,3,8,11
059 Deutschnofen,86,,5,10,15
059 Deutschnofen,87,,1,8,9
059 Deutschnofen,88,,1,7,8
059 Deutschnofen,89,,3,3,6
059 Deutschnofen,90,,-,2,2
059 Deutschnofen,91,,3,-,3
059 Deutschnofen,92,,2,-,2
059 Deutschnofen,93,,1,2,3
059 Deutschnofen,95,,-,1,1
059 Deutschnofen,96,,1,-,1
059 Deutschnofen,98,,-,1,1
060 Auer,0,,20,22,42
060 Auer,1,,15,18,33
060 Auer,2,,19,18,37
060 Auer,3,,16,22,38
060 Auer,4,,20,14,34
060 Auer,5,,20,17,37
060 Auer,6,,12,24,36
060 Auer,7,,18,20,38
060 Auer,8,,23,13,36
060 Auer,9,,16,16,32
060 Auer,10,,20,18,38
060 Auer,11,,17,24,41
060 Auer,12,,21,15,36
060 Auer,13,,15,15,30
060 Auer,14,,21,18,39
060 Auer,15,,14,9,23
060 Auer,16,,14,16,30
060 Auer,17,,19,24,43
060 Auer,18,,13,16,29
060 Auer,19,,13,11,24
060 Auer,20,,17,17,34
060 Auer,21,,12,8,20
060 Auer,22,,13,16,29
060 Auer,23,,16,23,39
060 Auer,24,,11,11,22
060 Auer,25,,22,27,49
060 Auer,26,,26,15,41
060 Auer,27,,18,22,40
060 Auer,28,,26,21,47
060 Auer,29,,22,14,36
060 Auer,30,,21,26,47
060 Auer,31,,26,33,59
060 Auer,32,,28,22,50
060 Auer,33,,28,38,66
060 Auer,34,,30,27,57
060 Auer,35,,29,19,48
060 Auer,36,,33,35,68
060 Auer,37,,21,24,45
060 Auer,38,,38,32,70
060 Auer,39,,23,33,56
060 Auer,40,,35,28,63
060 Auer,41,,31,20,51
060 Auer,42,,24,26,50
060 Auer,43,,31,27,58
060 Auer,44,,15,25,40
060 Auer,45,,19,11,30
060 Auer,46,,15,20,35
060 Auer,47,,21,19,40
060 Auer,48,,17,21,38
060 Auer,49,,15,22,37
060 Auer,50,,12,13,25
060 Auer,51,,26,15,41
060 Auer,52,,15,22,37
060 Auer,53,,18,23,41
060 Auer,54,,13,13,26
060 Auer,55,,21,16,37
060 Auer,56,,17,19,36
060 Auer,57,,16,20,36
060 Auer,58,,22,16,38
060 Auer,59,,13,9,22
060 Auer,60,,13,18,31
060 Auer,61,,18,21,39
060 Auer,62,,13,13,26
060 Auer,63,,9,10,19
060 Auer,64,,10,15,25
060 Auer,65,,18,15,33
060 Auer,66,,6,10,16
060 Auer,67,,4,17,21
060 Auer,68,,13,10,23
060 Auer,69,,10,10,20
060 Auer,70,,9,15,24
060 Auer,71,,12,12,24
060 Auer,72,,9,14,23
060 Auer,73,,7,16,23
060 Auer,74,,15,11,26
060 Auer,75,,11,9,20
060 Auer,76,,9,15,24
060 Auer,77,,4,18,22
060 Auer,78,,5,12,17
060 Auer,79,,7,10,17
060 Auer,80,,6,3,9
060 Auer,81,,2,9,11
060 Auer,82,,3,5,8
060 Auer,83,,2,3,5
060 Auer,84,,2,3,5
060 Auer,85,,1,4,5
060 Auer,86,,3,7,10
060 Auer,87,,1,5,6
060 Auer,88,,-,1,1
060 Auer,89,,2,1,3
060 Auer,90,,1,3,4
060 Auer,91,,-,1,1
060 Auer,92,,1,2,3
060 Auer,96,,-,1,1
060 Auer,104,,-,1,1
061 St.Ulrich,0,,42,28,70
061 St.Ulrich,1,,39,33,72
061 St.Ulrich,2,,28,30,58
061 St.Ulrich,3,,28,22,50
061 St.Ulrich,4,,32,32,64
061 St.Ulrich,5,,27,30,57
061 St.Ulrich,6,,21,31,52
061 St.Ulrich,7,,35,32,67
061 St.Ulrich,8,,31,33,64
061 St.Ulrich,9,,29,21,50
061 St.Ulrich,10,,16,25,41
061 St.Ulrich,11,,18,21,39
061 St.Ulrich,12,,27,18,45
061 St.Ulrich,13,,18,18,36
061 St.Ulrich,14,,24,21,45
061 St.Ulrich,15,,23,18,41
061 St.Ulrich,16,,20,19,39
061 St.Ulrich,17,,24,26,50
061 St.Ulrich,18,,21,24,45
061 St.Ulrich,19,,24,29,53
061 St.Ulrich,20,,30,24,54
061 St.Ulrich,21,,22,24,46
061 St.Ulrich,22,,24,21,45
061 St.Ulrich,23,,33,36,69
061 St.Ulrich,24,,35,30,65
061 St.Ulrich,25,,37,28,65
061 St.Ulrich,26,,39,25,64
061 St.Ulrich,27,,45,40,85
061 St.Ulrich,28,,39,39,78
061 St.Ulrich,29,,39,32,71
061 St.Ulrich,30,,53,41,94
061 St.Ulrich,31,,48,42,90
061 St.Ulrich,32,,37,40,77
061 St.Ulrich,33,,40,33,73
061 St.Ulrich,34,,34,33,67
061 St.Ulrich,35,,40,44,84
061 St.Ulrich,36,,38,32,70
061 St.Ulrich,37,,32,36,68
061 St.Ulrich,38,,30,21,51
061 St.Ulrich,39,,34,29,63
061 St.Ulrich,40,,40,26,66
061 St.Ulrich,41,,23,18,41
061 St.Ulrich,42,,26,35,61
061 St.Ulrich,43,,18,30,48
061 St.Ulrich,44,,27,37,64
061 St.Ulrich,45,,25,35,60
061 St.Ulrich,46,,29,17,46
061 St.Ulrich,47,,15,26,41
061 St.Ulrich,48,,26,24,50
061 St.Ulrich,49,,24,23,47
061 St.Ulrich,50,,18,28,46
061 St.Ulrich,51,,31,30,61
061 St.Ulrich,52,,23,23,46
061 St.Ulrich,53,,38,26,64
061 St.Ulrich,54,,20,19,39
061 St.Ulrich,55,,31,32,63
061 St.Ulrich,56,,41,39,80
061 St.Ulrich,57,,33,37,70
061 St.Ulrich,58,,40,45,85
061 St.Ulrich,59,,32,28,60
061 St.Ulrich,60,,20,21,41
061 St.Ulrich,61,,27,27,54
061 St.Ulrich,62,,24,27,51
061 St.Ulrich,63,,24,17,41
061 St.Ulrich,64,,15,24,39
061 St.Ulrich,65,,20,13,33
061 St.Ulrich,66,,20,14,34
061 St.Ulrich,67,,15,22,37
061 St.Ulrich,68,,20,16,36
061 St.Ulrich,69,,21,10,31
061 St.Ulrich,70,,19,5,24
061 St.Ulrich,71,,19,13,32
061 St.Ulrich,72,,18,17,35
061 St.Ulrich,73,,11,16,27
061 St.Ulrich,74,,13,10,23
061 St.Ulrich,75,,10,21,31
061 St.Ulrich,76,,12,25,37
061 St.Ulrich,77,,6,20,26
061 St.Ulrich,78,,10,17,27
061 St.Ulrich,79,,10,19,29
061 St.Ulrich,80,,6,12,18
061 St.Ulrich,81,,6,10,16
061 St.Ulrich,82,,2,7,9
061 St.Ulrich,83,,5,6,11
061 St.Ulrich,84,,3,9,12
061 St.Ulrich,85,,9,11,20
061 St.Ulrich,86,,8,20,28
061 St.Ulrich,87,,6,13,19
061 St.Ulrich,88,,-,9,9
061 St.Ulrich,89,,6,3,9
061 St.Ulrich,90,,4,1,5
061 St.Ulrich,91,,2,1,3
061 St.Ulrich,92,,-,5,5
061 St.Ulrich,93,,-,3,3
061 St.Ulrich,94,,1,-,1
061 St.Ulrich,95,,-,1,1
061 St.Ulrich,96,,2,-,2
062 Partschins,0,,15,13,28
062 Partschins,1,,16,12,28
062 Partschins,2,,21,21,42
062 Partschins,3,,13,18,31
062 Partschins,4,,23,15,38
062 Partschins,5,,22,17,39
062 Partschins,6,,23,17,40
062 Partschins,7,,19,17,36
062 Partschins,8,,24,25,49
062 Partschins,9,,23,24,47
062 Partschins,10,,11,24,35
062 Partschins,11,,19,27,46
062 Partschins,12,,17,14,31
062 Partschins,13,,23,19,42
062 Partschins,14,,11,15,26
062 Partschins,15,,18,20,38
062 Partschins,16,,17,22,39
062 Partschins,17,,19,20,39
062 Partschins,18,,21,27,48
062 Partschins,19,,25,17,42
062 Partschins,20,,15,15,30
062 Partschins,21,,15,18,33
062 Partschins,22,,28,19,47
062 Partschins,23,,18,18,36
062 Partschins,24,,24,22,46
062 Partschins,25,,22,13,35
062 Partschins,26,,28,22,50
062 Partschins,27,,27,27,54
062 Partschins,28,,26,26,52
062 Partschins,29,,30,26,56
062 Partschins,30,,31,27,58
062 Partschins,31,,24,28,52
062 Partschins,32,,30,24,54
062 Partschins,33,,36,36,72
062 Partschins,34,,31,34,65
062 Partschins,35,,27,40,67
062 Partschins,36,,39,26,65
062 Partschins,37,,30,25,55
062 Partschins,38,,20,26,46
062 Partschins,39,,22,36,58
062 Partschins,40,,28,18,46
062 Partschins,41,,21,17,38
062 Partschins,42,,23,25,48
062 Partschins,43,,23,19,42
062 Partschins,44,,25,28,53
062 Partschins,45,,11,27,38
062 Partschins,46,,23,14,37
062 Partschins,47,,17,14,31
062 Partschins,48,,19,16,35
062 Partschins,49,,16,20,36
062 Partschins,50,,8,12,20
062 Partschins,51,,18,17,35
062 Partschins,52,,18,17,35
062 Partschins,53,,31,27,58
062 Partschins,54,,14,16,30
062 Partschins,55,,17,18,35
062 Partschins,56,,23,28,51
062 Partschins,57,,14,17,31
062 Partschins,58,,23,31,54
062 Partschins,59,,14,13,27
062 Partschins,60,,12,16,28
062 Partschins,61,,20,15,35
062 Partschins,62,,15,17,32
062 Partschins,63,,12,18,30
062 Partschins,64,,11,10,21
062 Partschins,65,,13,16,29
062 Partschins,66,,15,16,31
062 Partschins,67,,15,10,25
062 Partschins,68,,15,21,36
062 Partschins,69,,14,11,25
062 Partschins,70,,13,11,24
062 Partschins,71,,12,15,27
062 Partschins,72,,11,11,22
062 Partschins,73,,10,10,20
062 Partschins,74,,9,12,21
062 Partschins,75,,5,14,19
062 Partschins,76,,9,12,21
062 Partschins,77,,7,9,16
062 Partschins,78,,16,9,25
062 Partschins,79,,3,8,11
062 Partschins,80,,5,9,14
062 Partschins,81,,2,3,5
062 Partschins,82,,2,5,7
062 Partschins,83,,1,3,4
062 Partschins,84,,3,1,4
062 Partschins,85,,5,7,12
062 Partschins,86,,2,9,11
062 Partschins,87,,1,7,8
062 Partschins,88,,4,2,6
062 Partschins,89,,1,8,9
062 Partschins,90,,-,4,4
062 Partschins,91,,1,1,2
062 Partschins,92,,-,1,1
062 Partschins,93,,3,-,3
062 Partschins,94,,1,1,2
062 Partschins,95,,-,1,1
062 Partschins,96,,-,1,1
062 Partschins,97,,-,1,1
063 Percha,0,,5,8,13
063 Percha,1,,7,10,17
063 Percha,2,,10,16,26
063 Percha,3,,9,5,14
063 Percha,4,,8,7,15
063 Percha,5,,9,11,20
063 Percha,6,,7,9,16
063 Percha,7,,13,6,19
063 Percha,8,,10,9,19
063 Percha,9,,8,7,15
063 Percha,10,,6,8,14
063 Percha,11,,6,5,11
063 Percha,12,,9,17,26
063 Percha,13,,5,7,12
063 Percha,14,,8,13,21
063 Percha,15,,18,9,27
063 Percha,16,,14,9,23
063 Percha,17,,6,11,17
063 Percha,18,,9,6,15
063 Percha,19,,11,5,16
063 Percha,20,,5,12,17
063 Percha,21,,7,11,18
063 Percha,22,,8,7,15
063 Percha,23,,15,9,24
063 Percha,24,,8,6,14
063 Percha,25,,5,10,15
063 Percha,26,,9,7,16
063 Percha,27,,12,13,25
063 Percha,28,,15,9,24
063 Percha,29,,8,12,20
063 Percha,30,,17,12,29
063 Percha,31,,15,14,29
063 Percha,32,,11,13,24
063 Percha,33,,18,6,24
063 Percha,34,,14,21,35
063 Percha,35,,17,10,27
063 Percha,36,,11,16,27
063 Percha,37,,15,11,26
063 Percha,38,,11,11,22
063 Percha,39,,10,6,16
063 Percha,40,,6,8,14
063 Percha,41,,9,8,17
063 Percha,42,,9,4,13
063 Percha,43,,7,12,19
063 Percha,44,,12,11,23
063 Percha,45,,4,4,8
063 Percha,46,,8,6,14
063 Percha,47,,4,8,12
063 Percha,48,,7,7,14
063 Percha,49,,6,8,14
063 Percha,50,,9,5,14
063 Percha,51,,5,4,9
063 Percha,52,,4,7,11
063 Percha,53,,7,8,15
063 Percha,54,,8,5,13
063 Percha,55,,12,4,16
063 Percha,56,,8,7,15
063 Percha,57,,10,7,17
063 Percha,58,,9,6,15
063 Percha,59,,5,5,10
063 Percha,60,,7,5,12
063 Percha,61,,5,9,14
063 Percha,62,,1,5,6
063 Percha,63,,4,5,9
063 Percha,64,,4,5,9
063 Percha,65,,6,6,12
063 Percha,66,,4,5,9
063 Percha,67,,5,3,8
063 Percha,68,,7,2,9
063 Percha,69,,10,4,14
063 Percha,70,,3,5,8
063 Percha,71,,3,3,6
063 Percha,72,,6,4,10
063 Percha,73,,2,8,10
063 Percha,74,,4,6,10
063 Percha,75,,2,2,4
063 Percha,76,,1,5,6
063 Percha,77,,3,2,5
063 Percha,78,,1,2,3
063 Percha,79,,-,2,2
063 Percha,81,,1,1,2
063 Percha,83,,1,1,2
063 Percha,84,,1,1,2
063 Percha,85,,-,4,4
063 Percha,87,,-,3,3
063 Percha,89,,1,-,1
064 Plaus,0,,8,4,12
064 Plaus,1,,4,6,10
064 Plaus,2,,6,3,9
064 Plaus,3,,5,2,7
064 Plaus,4,,2,3,5
064 Plaus,5,,3,1,4
064 Plaus,6,,7,3,10
064 Plaus,7,,5,5,10
064 Plaus,8,,3,8,11
064 Plaus,9,,4,2,6
064 Plaus,10,,3,6,9
064 Plaus,11,,3,2,5
064 Plaus,12,,4,2,6
064 Plaus,13,,-,4,4
064 Plaus,14,,2,4,6
064 Plaus,15,,4,1,5
064 Plaus,16,,2,1,3
064 Plaus,17,,-,4,4
064 Plaus,18,,2,2,4
064 Plaus,19,,1,5,6
064 Plaus,20,,1,3,4
064 Plaus,21,,3,5,8
064 Plaus,22,,1,3,4
064 Plaus,23,,3,3,6
064 Plaus,24,,6,-,6
064 Plaus,25,,4,3,7
064 Plaus,26,,6,2,8
064 Plaus,27,,6,3,9
064 Plaus,28,,4,5,9
064 Plaus,29,,5,5,10
064 Plaus,30,,8,7,15
064 Plaus,31,,2,8,10
064 Plaus,32,,12,7,19
064 Plaus,33,,5,6,11
064 Plaus,34,,10,2,12
064 Plaus,35,,7,8,15
064 Plaus,36,,2,5,7
064 Plaus,37,,5,4,9
064 Plaus,38,,6,2,8
064 Plaus,39,,1,5,6
064 Plaus,40,,8,1,9
064 Plaus,41,,3,3,6
064 Plaus,42,,2,2,4
064 Plaus,43,,5,1,6
064 Plaus,44,,3,3,6
064 Plaus,45,,1,1,2
064 Plaus,46,,3,4,7
064 Plaus,47,,5,2,7
064 Plaus,48,,4,3,7
064 Plaus,49,,1,2,3
064 Plaus,50,,4,3,7
064 Plaus,51,,1,3,4
064 Plaus,52,,3,5,8
064 Plaus,53,,6,3,9
064 Plaus,54,,4,1,5
064 Plaus,55,,2,3,5
064 Plaus,56,,5,1,6
064 Plaus,57,,-,4,4
064 Plaus,58,,4,4,8
064 Plaus,59,,3,2,5
064 Plaus,60,,3,2,5
064 Plaus,61,,1,1,2
064 Plaus,62,,3,4,7
064 Plaus,64,,2,2,4
064 Plaus,65,,4,3,7
064 Plaus,66,,1,3,4
064 Plaus,67,,1,3,4
064 Plaus,68,,1,1,2
064 Plaus,69,,-,1,1
064 Plaus,70,,1,1,2
064 Plaus,71,,1,-,1
064 Plaus,72,,1,1,2
064 Plaus,73,,1,2,3
064 Plaus,74,,1,-,1
064 Plaus,75,,-,4,4
064 Plaus,76,,-,4,4
064 Plaus,77,,1,2,3
064 Plaus,78,,-,1,1
064 Plaus,79,,2,1,3
064 Plaus,80,,-,2,2
064 Plaus,81,,-,2,2
064 Plaus,87,,1,1,2
064 Plaus,88,,-,1,1
064 Plaus,91,,1,-,1
065 Waidbruck,0,,1,1,2
065 Waidbruck,2,,3,2,5
065 Waidbruck,3,,2,-,2
065 Waidbruck,4,,1,3,4
065 Waidbruck,5,,3,3,6
065 Waidbruck,6,,1,1,2
065 Waidbruck,7,,-,2,2
065 Waidbruck,8,,1,1,2
065 Waidbruck,9,,1,1,2
065 Waidbruck,10,,1,1,2
065 Waidbruck,11,,-,2,2
065 Waidbruck,12,,1,1,2
065 Waidbruck,13,,1,1,2
065 Waidbruck,14,,1,1,2
065 Waidbruck,15,,2,2,4
065 Waidbruck,16,,1,-,1
065 Waidbruck,18,,-,3,3
065 Waidbruck,19,,2,1,3
065 Waidbruck,20,,1,-,1
065 Waidbruck,21,,2,-,2
065 Waidbruck,22,,1,1,2
065 Waidbruck,23,,-,1,1
065 Waidbruck,24,,-,1,1
065 Waidbruck,25,,3,-,3
065 Waidbruck,26,,-,1,1
065 Waidbruck,27,,-,1,1
065 Waidbruck,28,,2,-,2
065 Waidbruck,29,,5,1,6
065 Waidbruck,30,,1,3,4
065 Waidbruck,31,,3,-,3
065 Waidbruck,32,,2,5,7
065 Waidbruck,33,,3,3,6
065 Waidbruck,34,,2,1,3
065 Waidbruck,35,,3,-,3
065 Waidbruck,36,,-,1,1
065 Waidbruck,37,,3,1,4
065 Waidbruck,38,,-,1,1
065 Waidbruck,39,,2,1,3
065 Waidbruck,40,,3,2,5
065 Waidbruck,41,,-,1,1
065 Waidbruck,42,,1,1,2
065 Waidbruck,43,,2,-,2
065 Waidbruck,44,,2,1,3
065 Waidbruck,46,,2,1,3
065 Waidbruck,47,,2,2,4
065 Waidbruck,48,,-,2,2
065 Waidbruck,53,,-,3,3
065 Waidbruck,54,,1,1,2
065 Waidbruck,55,,2,2,4
065 Waidbruck,56,,-,1,1
065 Waidbruck,57,,1,-,1
065 Waidbruck,58,,1,2,3
065 Waidbruck,59,,-,3,3
065 Waidbruck,60,,1,-,1
065 Waidbruck,61,,-,3,3
065 Waidbruck,62,,2,1,3
065 Waidbruck,63,,2,1,3
065 Waidbruck,64,,-,3,3
065 Waidbruck,65,,3,1,4
065 Waidbruck,66,,2,-,2
065 Waidbruck,67,,1,4,5
065 Waidbruck,68,,1,-,1
065 Waidbruck,69,,2,-,2
065 Waidbruck,70,,-,1,1
065 Waidbruck,71,,1,-,1
065 Waidbruck,72,,3,1,4
065 Waidbruck,73,,-,1,1
065 Waidbruck,74,,1,1,2
065 Waidbruck,76,,-,2,2
065 Waidbruck,77,,-,1,1
065 Waidbruck,79,,-,3,3
065 Waidbruck,80,,-,2,2
065 Waidbruck,84,,2,-,2
065 Waidbruck,85,,-,1,1
065 Waidbruck,94,,-,1,1
066 Burgstall,0,,9,9,18
066 Burgstall,1,,8,10,18
066 Burgstall,2,,7,3,10
066 Burgstall,3,,2,9,11
066 Burgstall,4,,9,6,15
066 Burgstall,5,,5,5,10
066 Burgstall,6,,5,11,16
066 Burgstall,7,,7,4,11
066 Burgstall,8,,8,11,19
066 Burgstall,9,,12,8,20
066 Burgstall,10,,9,4,13
066 Burgstall,11,,6,5,11
066 Burgstall,12,,9,8,17
066 Burgstall,13,,9,4,13
066 Burgstall,14,,5,10,15
066 Burgstall,15,,10,11,21
066 Burgstall,16,,6,8,14
066 Burgstall,17,,13,7,20
066 Burgstall,18,,5,8,13
066 Burgstall,19,,10,4,14
066 Burgstall,20,,4,8,12
066 Burgstall,21,,7,6,13
066 Burgstall,22,,2,12,14
066 Burgstall,23,,9,6,15
066 Burgstall,24,,14,9,23
066 Burgstall,25,,6,8,14
066 Burgstall,26,,9,11,20
066 Burgstall,27,,9,15,24
066 Burgstall,28,,13,6,19
066 Burgstall,29,,8,9,17
066 Burgstall,30,,12,7,19
066 Burgstall,31,,13,12,25
066 Burgstall,32,,7,15,22
066 Burgstall,33,,18,13,31
066 Burgstall,34,,19,17,36
066 Burgstall,35,,18,10,28
066 Burgstall,36,,16,11,27
066 Burgstall,37,,15,11,26
066 Burgstall,38,,9,14,23
066 Burgstall,39,,13,9,22
066 Burgstall,40,,5,7,12
066 Burgstall,41,,14,11,25
066 Burgstall,42,,7,8,15
066 Burgstall,43,,13,9,22
066 Burgstall,44,,7,8,15
066 Burgstall,45,,9,11,20
066 Burgstall,46,,7,10,17
066 Burgstall,47,,10,13,23
066 Burgstall,48,,11,7,18
066 Burgstall,49,,11,10,21
066 Burgstall,50,,8,7,15
066 Burgstall,51,,6,12,18
066 Burgstall,52,,7,8,15
066 Burgstall,53,,9,8,17
066 Burgstall,54,,6,10,16
066 Burgstall,55,,11,9,20
066 Burgstall,56,,9,7,16
066 Burgstall,57,,5,6,11
066 Burgstall,58,,9,5,14
066 Burgstall,59,,5,13,18
066 Burgstall,60,,5,9,14
066 Burgstall,61,,10,14,24
066 Burgstall,62,,5,9,14
066 Burgstall,63,,5,6,11
066 Burgstall,64,,7,3,10
066 Burgstall,65,,10,7,17
066 Burgstall,66,,9,4,13
066 Burgstall,67,,4,8,12
066 Burgstall,68,,6,3,9
066 Burgstall,69,,6,7,13
066 Burgstall,70,,2,4,6
066 Burgstall,71,,4,9,13
066 Burgstall,72,,2,12,14
066 Burgstall,73,,5,10,15
066 Burgstall,74,,7,5,12
066 Burgstall,75,,1,9,10
066 Burgstall,76,,5,3,8
066 Burgstall,77,,7,5,12
066 Burgstall,78,,3,2,5
066 Burgstall,79,,3,3,6
066 Burgstall,80,,1,4,5
066 Burgstall,81,,-,1,1
066 Burgstall,82,,1,1,2
066 Burgstall,83,,2,3,5
066 Burgstall,84,,2,4,6
066 Burgstall,85,,1,4,5
066 Burgstall,86,,3,1,4
066 Burgstall,87,,-,5,5
066 Burgstall,88,,-,4,4
066 Burgstall,89,,-,1,1
066 Burgstall,90,,-,2,2
066 Burgstall,92,,1,-,1
066 Burgstall,93,,1,-,1
066 Burgstall,97,,-,1,1
066 Burgstall,98,,1,-,1
067 Prad am Stilfser Joch,0,,16,18,34
067 Prad am Stilfser Joch,1,,24,19,43
067 Prad am Stilfser Joch,2,,24,18,42
067 Prad am Stilfser Joch,3,,17,18,35
067 Prad am Stilfser Joch,4,,20,12,32
067 Prad am Stilfser Joch,5,,19,24,43
067 Prad am Stilfser Joch,6,,22,28,50
067 Prad am Stilfser Joch,7,,17,21,38
067 Prad am Stilfser Joch,8,,19,12,31
067 Prad am Stilfser Joch,9,,19,22,41
067 Prad am Stilfser Joch,10,,18,23,41
067 Prad am Stilfser Joch,11,,31,16,47
067 Prad am Stilfser Joch,12,,13,19,32
067 Prad am Stilfser Joch,13,,28,27,55
067 Prad am Stilfser Joch,14,,30,23,53
067 Prad am Stilfser Joch,15,,30,29,59
067 Prad am Stilfser Joch,16,,28,25,53
067 Prad am Stilfser Joch,17,,28,22,50
067 Prad am Stilfser Joch,18,,24,24,48
067 Prad am Stilfser Joch,19,,28,24,52
067 Prad am Stilfser Joch,20,,19,10,29
067 Prad am Stilfser Joch,21,,21,19,40
067 Prad am Stilfser Joch,22,,19,34,53
067 Prad am Stilfser Joch,23,,23,23,46
067 Prad am Stilfser Joch,24,,21,17,38
067 Prad am Stilfser Joch,25,,33,23,56
067 Prad am Stilfser Joch,26,,21,31,52
067 Prad am Stilfser Joch,27,,30,24,54
067 Prad am Stilfser Joch,28,,33,22,55
067 Prad am Stilfser Joch,29,,26,24,50
067 Prad am Stilfser Joch,30,,28,28,56
067 Prad am Stilfser Joch,31,,32,30,62
067 Prad am Stilfser Joch,32,,27,24,51
067 Prad am Stilfser Joch,33,,34,29,63
067 Prad am Stilfser Joch,34,,32,23,55
067 Prad am Stilfser Joch,35,,30,27,57
067 Prad am Stilfser Joch,36,,24,11,35
067 Prad am Stilfser Joch,37,,28,30,58
067 Prad am Stilfser Joch,38,,21,28,49
067 Prad am Stilfser Joch,39,,17,27,44
067 Prad am Stilfser Joch,40,,30,12,42
067 Prad am Stilfser Joch,41,,24,29,53
067 Prad am Stilfser Joch,42,,26,24,50
067 Prad am Stilfser Joch,43,,25,24,49
067 Prad am Stilfser Joch,44,,29,17,46
067 Prad am Stilfser Joch,45,,29,18,47
067 Prad am Stilfser Joch,46,,28,17,45
067 Prad am Stilfser Joch,47,,14,21,35
067 Prad am Stilfser Joch,48,,20,22,42
067 Prad am Stilfser Joch,49,,22,17,39
067 Prad am Stilfser Joch,50,,22,20,42
067 Prad am Stilfser Joch,51,,19,11,30
067 Prad am Stilfser Joch,52,,16,14,30
067 Prad am Stilfser Joch,53,,16,15,31
067 Prad am Stilfser Joch,54,,18,11,29
067 Prad am Stilfser Joch,55,,11,15,26
067 Prad am Stilfser Joch,56,,25,16,41
067 Prad am Stilfser Joch,57,,18,16,34
067 Prad am Stilfser Joch,58,,21,10,31
067 Prad am Stilfser Joch,59,,10,16,26
067 Prad am Stilfser Joch,60,,14,13,27
067 Prad am Stilfser Joch,61,,20,14,34
067 Prad am Stilfser Joch,62,,11,13,24
067 Prad am Stilfser Joch,63,,12,11,23
067 Prad am Stilfser Joch,64,,15,15,30
067 Prad am Stilfser Joch,65,,9,24,33
067 Prad am Stilfser Joch,66,,14,10,24
067 Prad am Stilfser Joch,67,,13,19,32
067 Prad am Stilfser Joch,68,,8,16,24
067 Prad am Stilfser Joch,69,,13,14,27
067 Prad am Stilfser Joch,70,,8,12,20
067 Prad am Stilfser Joch,71,,8,9,17
067 Prad am Stilfser Joch,72,,8,12,20
067 Prad am Stilfser Joch,73,,10,14,24
067 Prad am Stilfser Joch,74,,12,9,21
067 Prad am Stilfser Joch,75,,7,12,19
067 Prad am Stilfser Joch,76,,4,12,16
067 Prad am Stilfser Joch,77,,6,13,19
067 Prad am Stilfser Joch,78,,6,7,13
067 Prad am Stilfser Joch,79,,6,7,13
067 Prad am Stilfser Joch,80,,8,4,12
067 Prad am Stilfser Joch,81,,2,5,7
067 Prad am Stilfser Joch,82,,-,4,4
067 Prad am Stilfser Joch,83,,1,5,6
067 Prad am Stilfser Joch,84,,4,2,6
067 Prad am Stilfser Joch,85,,2,9,11
067 Prad am Stilfser Joch,86,,-,3,3
067 Prad am Stilfser Joch,87,,4,7,11
067 Prad am Stilfser Joch,88,,1,4,5
067 Prad am Stilfser Joch,89,,1,4,5
067 Prad am Stilfser Joch,90,,-,3,3
067 Prad am Stilfser Joch,91,,1,2,3
067 Prad am Stilfser Joch,92,,2,2,4
067 Prad am Stilfser Joch,93,,1,-,1
067 Prad am Stilfser Joch,94,,-,2,2
067 Prad am Stilfser Joch,95,,-,1,1
067 Prad am Stilfser Joch,96,,-,1,1
067 Prad am Stilfser Joch,98,,-,1,1
068 Prettau,0,,6,8,14
068 Prettau,1,,7,5,12
068 Prettau,2,,4,5,9
068 Prettau,3,,1,2,3
068 Prettau,4,,6,6,12
068 Prettau,5,,6,7,13
068 Prettau,6,,4,7,11
068 Prettau,7,,3,3,6
068 Prettau,8,,1,4,5
068 Prettau,9,,1,7,8
068 Prettau,10,,-,4,4
068 Prettau,11,,5,3,8
068 Prettau,12,,5,1,6
068 Prettau,13,,2,2,4
068 Prettau,14,,2,1,3
068 Prettau,15,,3,6,9
068 Prettau,16,,4,2,6
068 Prettau,17,,2,2,4
068 Prettau,18,,2,1,3
068 Prettau,19,,4,2,6
068 Prettau,20,,5,2,7
068 Prettau,21,,1,-,1
068 Prettau,22,,4,4,8
068 Prettau,23,,1,1,2
068 Prettau,24,,5,4,9
068 Prettau,25,,7,2,9
068 Prettau,26,,7,9,16
068 Prettau,27,,10,5,15
068 Prettau,28,,5,4,9
068 Prettau,29,,3,6,9
068 Prettau,30,,8,8,16
068 Prettau,31,,6,5,11
068 Prettau,32,,10,6,16
068 Prettau,33,,6,2,8
068 Prettau,34,,4,13,17
068 Prettau,35,,8,6,14
068 Prettau,36,,6,6,12
068 Prettau,37,,2,6,8
068 Prettau,38,,6,5,11
068 Prettau,39,,7,4,11
068 Prettau,40,,5,2,7
068 Prettau,41,,7,-,7
068 Prettau,42,,4,1,5
068 Prettau,43,,6,5,11
068 Prettau,44,,6,5,11
068 Prettau,45,,6,2,8
068 Prettau,46,,4,3,7
068 Prettau,47,,4,3,7
068 Prettau,48,,2,2,4
068 Prettau,49,,2,2,4
068 Prettau,50,,2,3,5
068 Prettau,51,,3,2,5
068 Prettau,52,,4,5,9
068 Prettau,53,,9,4,13
068 Prettau,54,,1,3,4
068 Prettau,55,,6,5,11
068 Prettau,56,,5,2,7
068 Prettau,57,,3,2,5
068 Prettau,58,,3,3,6
068 Prettau,59,,4,5,9
068 Prettau,60,,4,4,8
068 Prettau,61,,5,7,12
068 Prettau,62,,2,6,8
068 Prettau,63,,4,3,7
068 Prettau,64,,6,3,9
068 Prettau,65,,1,3,4
068 Prettau,66,,4,3,7
068 Prettau,67,,4,-,4
068 Prettau,68,,2,1,3
068 Prettau,69,,5,4,9
068 Prettau,70,,4,5,9
068 Prettau,71,,-,3,3
068 Prettau,72,,3,1,4
068 Prettau,73,,1,7,8
068 Prettau,74,,1,2,3
068 Prettau,75,,2,1,3
068 Prettau,76,,1,4,5
068 Prettau,77,,2,1,3
068 Prettau,78,,1,2,3
068 Prettau,79,,3,4,7
068 Prettau,80,,3,2,5
068 Prettau,81,,1,2,3
068 Prettau,82,,1,-,1
068 Prettau,83,,2,3,5
068 Prettau,84,,-,1,1
068 Prettau,85,,-,4,4
068 Prettau,86,,-,5,5
068 Prettau,87,,-,2,2
068 Prettau,88,,-,4,4
068 Prettau,93,,-,1,1
068 Prettau,94,,-,2,2
068 Prettau,99,,-,1,1
069 Proveis,0,,4,-,4
069 Proveis,1,,2,2,4
069 Proveis,2,,1,2,3
069 Proveis,3,,1,1,2
069 Proveis,4,,-,4,4
069 Proveis,5,,2,-,2
069 Proveis,6,,2,1,3
069 Proveis,7,,3,1,4
069 Proveis,8,,3,2,5
069 Proveis,9,,-,1,1
069 Proveis,10,,1,1,2
069 Proveis,11,,2,3,5
069 Proveis,12,,2,2,4
069 Proveis,13,,3,1,4
069 Proveis,14,,5,-,5
069 Proveis,15,,3,3,6
069 Proveis,16,,3,3,6
069 Proveis,17,,1,-,1
069 Proveis,18,,2,3,5
069 Proveis,20,,3,1,4
069 Proveis,21,,3,2,5
069 Proveis,22,,2,3,5
069 Proveis,23,,1,3,4
069 Proveis,24,,2,2,4
069 Proveis,25,,5,2,7
069 Proveis,26,,2,-,2
069 Proveis,27,,-,3,3
069 Proveis,28,,1,1,2
069 Proveis,29,,4,3,7
069 Proveis,30,,4,3,7
069 Proveis,31,,6,1,7
069 Proveis,32,,2,1,3
069 Proveis,33,,2,1,3
069 Proveis,34,,1,1,2
069 Proveis,35,,3,-,3
069 Proveis,36,,4,2,6
069 Proveis,37,,5,2,7
069 Proveis,38,,4,1,5
069 Proveis,39,,1,4,5
069 Proveis,40,,4,-,4
069 Proveis,41,,1,3,4
069 Proveis,42,,2,3,5
069 Proveis,43,,4,1,5
069 Proveis,44,,3,4,7
069 Proveis,45,,3,2,5
069 Proveis,46,,2,1,3
069 Proveis,47,,3,3,6
069 Proveis,48,,2,-,2
069 Proveis,49,,1,1,2
069 Proveis,50,,1,-,1
069 Proveis,51,,2,1,3
069 Proveis,52,,1,2,3
069 Proveis,53,,3,-,3
069 Proveis,54,,1,1,2
069 Proveis,55,,2,-,2
069 Proveis,56,,2,1,3
069 Proveis,57,,2,1,3
069 Proveis,58,,1,1,2
069 Proveis,59,,3,-,3
069 Proveis,60,,1,3,4
069 Proveis,61,,-,2,2
069 Proveis,62,,2,1,3
069 Proveis,63,,2,1,3
069 Proveis,64,,1,1,2
069 Proveis,65,,-,1,1
069 Proveis,66,,-,2,2
069 Proveis,67,,1,1,2
069 Proveis,68,,2,1,3
069 Proveis,69,,-,1,1
069 Proveis,70,,3,3,6
069 Proveis,71,,4,1,5
069 Proveis,72,,2,2,4
069 Proveis,73,,1,1,2
069 Proveis,74,,-,2,2
069 Proveis,75,,3,-,3
069 Proveis,76,,1,-,1
069 Proveis,77,,2,2,4
069 Proveis,78,,-,6,6
069 Proveis,79,,-,1,1
069 Proveis,82,,-,1,1
069 Proveis,85,,-,2,2
069 Proveis,92,,1,-,1
070 Ratschings,0,,25,18,43
070 Ratschings,1,,29,22,51
070 Ratschings,2,,35,37,72
070 Ratschings,3,,29,34,63
070 Ratschings,4,,26,25,51
070 Ratschings,5,,20,28,48
070 Ratschings,6,,26,22,48
070 Ratschings,7,,38,31,69
070 Ratschings,8,,25,19,44
070 Ratschings,9,,31,27,58
070 Ratschings,10,,25,18,43
070 Ratschings,11,,36,27,63
070 Ratschings,12,,28,31,59
070 Ratschings,13,,30,26,56
070 Ratschings,14,,29,33,62
070 Ratschings,15,,27,19,46
070 Ratschings,16,,31,22,53
070 Ratschings,17,,34,24,58
070 Ratschings,18,,30,31,61
070 Ratschings,19,,23,22,45
070 Ratschings,20,,33,22,55
070 Ratschings,21,,33,23,56
070 Ratschings,22,,35,21,56
070 Ratschings,23,,24,25,49
070 Ratschings,24,,32,29,61
070 Ratschings,25,,36,25,61
070 Ratschings,26,,28,32,60
070 Ratschings,27,,33,40,73
070 Ratschings,28,,38,41,79
070 Ratschings,29,,28,38,66
070 Ratschings,30,,33,39,72
070 Ratschings,31,,46,36,82
070 Ratschings,32,,41,38,79
070 Ratschings,33,,46,41,87
070 Ratschings,34,,35,47,82
070 Ratschings,35,,49,39,88
070 Ratschings,36,,47,24,71
070 Ratschings,37,,36,37,73
070 Ratschings,38,,32,26,58
070 Ratschings,39,,39,23,62
070 Ratschings,40,,38,25,63
070 Ratschings,41,,30,19,49
070 Ratschings,42,,32,17,49
070 Ratschings,43,,35,19,54
070 Ratschings,44,,15,32,47
070 Ratschings,45,,29,15,44
070 Ratschings,46,,21,25,46
070 Ratschings,47,,21,20,41
070 Ratschings,48,,15,15,30
070 Ratschings,49,,25,20,45
070 Ratschings,50,,23,24,47
070 Ratschings,51,,32,20,52
070 Ratschings,52,,19,15,34
070 Ratschings,53,,24,7,31
070 Ratschings,54,,19,20,39
070 Ratschings,55,,21,11,32
070 Ratschings,56,,16,13,29
070 Ratschings,57,,20,19,39
070 Ratschings,58,,25,21,46
070 Ratschings,59,,19,17,36
070 Ratschings,60,,19,18,37
070 Ratschings,61,,15,21,36
070 Ratschings,62,,20,10,30
070 Ratschings,63,,15,13,28
070 Ratschings,64,,18,17,35
070 Ratschings,65,,13,11,24
070 Ratschings,66,,16,19,35
070 Ratschings,67,,16,14,30
070 Ratschings,68,,11,13,24
070 Ratschings,69,,12,18,30
070 Ratschings,70,,12,20,32
070 Ratschings,71,,11,12,23
070 Ratschings,72,,16,14,30
070 Ratschings,73,,14,15,29
070 Ratschings,74,,13,9,22
070 Ratschings,75,,14,14,28
070 Ratschings,76,,11,10,21
070 Ratschings,77,,7,12,19
070 Ratschings,78,,8,13,21
070 Ratschings,79,,2,13,15
070 Ratschings,80,,4,4,8
070 Ratschings,81,,-,7,7
070 Ratschings,83,,2,3,5
070 Ratschings,84,,3,7,10
070 Ratschings,85,,3,4,7
070 Ratschings,86,,4,4,8
070 Ratschings,87,,2,6,8
070 Ratschings,88,,2,3,5
070 Ratschings,90,,-,2,2
070 Ratschings,91,,-,2,2
070 Ratschings,93,,-,2,2
071 Rasen-Antholz,0,,16,18,34
071 Rasen-Antholz,1,,18,13,31
071 Rasen-Antholz,2,,23,21,44
071 Rasen-Antholz,3,,24,14,38
071 Rasen-Antholz,4,,10,16,26
071 Rasen-Antholz,5,,19,11,30
071 Rasen-Antholz,6,,19,14,33
071 Rasen-Antholz,7,,27,20,47
071 Rasen-Antholz,8,,15,15,30
071 Rasen-Antholz,9,,12,26,38
071 Rasen-Antholz,10,,19,18,37
071 Rasen-Antholz,11,,21,16,37
071 Rasen-Antholz,12,,27,9,36
071 Rasen-Antholz,13,,16,20,36
071 Rasen-Antholz,14,,23,14,37
071 Rasen-Antholz,15,,18,17,35
071 Rasen-Antholz,16,,14,19,33
071 Rasen-Antholz,17,,21,24,45
071 Rasen-Antholz,18,,15,15,30
071 Rasen-Antholz,19,,18,11,29
071 Rasen-Antholz,20,,16,18,34
071 Rasen-Antholz,21,,16,17,33
071 Rasen-Antholz,22,,16,22,38
071 Rasen-Antholz,23,,20,23,43
071 Rasen-Antholz,24,,21,26,47
071 Rasen-Antholz,25,,28,22,50
071 Rasen-Antholz,26,,33,23,56
071 Rasen-Antholz,27,,31,15,46
071 Rasen-Antholz,28,,27,22,49
071 Rasen-Antholz,29,,26,32,58
071 Rasen-Antholz,30,,32,29,61
071 Rasen-Antholz,31,,30,30,60
071 Rasen-Antholz,32,,29,27,56
071 Rasen-Antholz,33,,28,19,47
071 Rasen-Antholz,34,,35,25,60
071 Rasen-Antholz,35,,28,19,47
071 Rasen-Antholz,36,,24,21,45
071 Rasen-Antholz,37,,28,19,47
071 Rasen-Antholz,38,,21,26,47
071 Rasen-Antholz,39,,20,22,42
071 Rasen-Antholz,40,,27,19,46
071 Rasen-Antholz,41,,23,16,39
071 Rasen-Antholz,42,,22,12,34
071 Rasen-Antholz,43,,17,16,33
071 Rasen-Antholz,44,,18,15,33
071 Rasen-Antholz,45,,14,12,26
071 Rasen-Antholz,46,,18,11,29
071 Rasen-Antholz,47,,12,15,27
071 Rasen-Antholz,48,,12,12,24
071 Rasen-Antholz,49,,16,8,24
071 Rasen-Antholz,50,,14,9,23
071 Rasen-Antholz,51,,14,10,24
071 Rasen-Antholz,52,,9,13,22
071 Rasen-Antholz,53,,10,15,25
071 Rasen-Antholz,54,,11,10,21
071 Rasen-Antholz,55,,10,8,18
071 Rasen-Antholz,56,,13,14,27
071 Rasen-Antholz,57,,11,14,25
071 Rasen-Antholz,58,,15,13,28
071 Rasen-Antholz,59,,11,17,28
071 Rasen-Antholz,60,,17,13,30
071 Rasen-Antholz,61,,13,8,21
071 Rasen-Antholz,62,,10,12,22
071 Rasen-Antholz,63,,9,12,21
071 Rasen-Antholz,64,,10,8,18
071 Rasen-Antholz,65,,12,10,22
071 Rasen-Antholz,66,,13,15,28
071 Rasen-Antholz,67,,16,11,27
071 Rasen-Antholz,68,,14,14,28
071 Rasen-Antholz,69,,5,11,16
071 Rasen-Antholz,70,,13,4,17
071 Rasen-Antholz,71,,5,3,8
071 Rasen-Antholz,72,,13,10,23
071 Rasen-Antholz,73,,8,6,14
071 Rasen-Antholz,74,,7,13,20
071 Rasen-Antholz,75,,7,12,19
071 Rasen-Antholz,76,,4,12,16
071 Rasen-Antholz,77,,5,6,11
071 Rasen-Antholz,78,,9,6,15
071 Rasen-Antholz,79,,2,7,9
071 Rasen-Antholz,80,,6,7,13
071 Rasen-Antholz,81,,2,3,5
071 Rasen-Antholz,82,,3,4,7
071 Rasen-Antholz,83,,-,3,3
071 Rasen-Antholz,84,,3,3,6
071 Rasen-Antholz,85,,1,5,6
071 Rasen-Antholz,86,,1,3,4
071 Rasen-Antholz,87,,2,2,4
071 Rasen-Antholz,88,,1,3,4
071 Rasen-Antholz,89,,-,1,1
071 Rasen-Antholz,90,,1,2,3
071 Rasen-Antholz,91,,1,3,4
071 Rasen-Antholz,92,,1,2,3
071 Rasen-Antholz,93,,-,1,1
071 Rasen-Antholz,94,,-,1,1
071 Rasen-Antholz,97,,1,-,1
072 Ritten,0,,57,60,117
072 Ritten,1,,41,48,89
072 Ritten,2,,55,57,112
072 Ritten,3,,41,56,97
072 Ritten,4,,57,47,104
072 Ritten,5,,61,52,113
072 Ritten,6,,58,52,110
072 Ritten,7,,53,70,123
072 Ritten,8,,63,48,111
072 Ritten,9,,59,47,106
072 Ritten,10,,53,45,98
072 Ritten,11,,57,52,109
072 Ritten,12,,49,43,92
072 Ritten,13,,49,43,92
072 Ritten,14,,44,47,91
072 Ritten,15,,45,26,71
072 Ritten,16,,52,41,93
072 Ritten,17,,40,47,87
072 Ritten,18,,45,48,93
072 Ritten,19,,45,36,81
072 Ritten,20,,52,43,95
072 Ritten,21,,44,35,79
072 Ritten,22,,62,39,101
072 Ritten,23,,41,44,85
072 Ritten,24,,52,42,94
072 Ritten,25,,66,60,126
072 Ritten,26,,54,54,108
072 Ritten,27,,51,51,102
072 Ritten,28,,53,74,127
072 Ritten,29,,55,69,124
072 Ritten,30,,49,66,115
072 Ritten,31,,67,64,131
072 Ritten,32,,67,54,121
072 Ritten,33,,57,51,108
072 Ritten,34,,79,49,128
072 Ritten,35,,72,57,129
072 Ritten,36,,63,55,118
072 Ritten,37,,60,65,125
072 Ritten,38,,51,61,112
072 Ritten,39,,64,61,125
072 Ritten,40,,65,49,114
072 Ritten,41,,42,44,86
072 Ritten,42,,40,39,79
072 Ritten,43,,47,43,90
072 Ritten,44,,50,38,88
072 Ritten,45,,39,31,70
072 Ritten,46,,49,32,81
072 Ritten,47,,40,44,84
072 Ritten,48,,44,35,79
072 Ritten,49,,36,40,76
072 Ritten,50,,37,42,79
072 Ritten,51,,52,34,86
072 Ritten,52,,33,29,62
072 Ritten,53,,30,40,70
072 Ritten,54,,22,24,46
072 Ritten,55,,34,41,75
072 Ritten,56,,38,39,77
072 Ritten,57,,45,36,81
072 Ritten,58,,38,38,76
072 Ritten,59,,38,23,61
072 Ritten,60,,37,31,68
072 Ritten,61,,34,34,68
072 Ritten,62,,30,25,55
072 Ritten,63,,25,24,49
072 Ritten,64,,23,32,55
072 Ritten,65,,25,27,52
072 Ritten,66,,20,26,46
072 Ritten,67,,25,24,49
072 Ritten,68,,17,32,49
072 Ritten,69,,17,22,39
072 Ritten,70,,24,21,45
072 Ritten,71,,20,11,31
072 Ritten,72,,23,18,41
072 Ritten,73,,15,21,36
072 Ritten,74,,19,38,57
072 Ritten,75,,20,32,52
072 Ritten,76,,20,25,45
072 Ritten,77,,6,29,35
072 Ritten,78,,14,22,36
072 Ritten,79,,11,25,36
072 Ritten,80,,6,15,21
072 Ritten,81,,3,6,9
072 Ritten,82,,4,11,15
072 Ritten,83,,1,4,5
072 Ritten,84,,4,9,13
072 Ritten,85,,6,12,18
072 Ritten,86,,8,12,20
072 Ritten,87,,5,11,16
072 Ritten,88,,4,11,15
072 Ritten,89,,4,6,10
072 Ritten,90,,4,2,6
072 Ritten,91,,1,5,6
072 Ritten,92,,2,4,6
072 Ritten,96,,-,3,3
072 Ritten,97,,-,1,1
073 Riffian,0,,7,13,20
073 Riffian,1,,12,11,23
073 Riffian,2,,7,7,14
073 Riffian,3,,6,7,13
073 Riffian,4,,8,11,19
073 Riffian,5,,5,7,12
073 Riffian,6,,7,8,15
073 Riffian,7,,8,10,18
073 Riffian,8,,9,12,21
073 Riffian,9,,7,7,14
073 Riffian,10,,12,5,17
073 Riffian,11,,6,12,18
073 Riffian,12,,7,9,16
073 Riffian,13,,8,6,14
073 Riffian,14,,8,2,10
073 Riffian,15,,8,7,15
073 Riffian,16,,9,7,16
073 Riffian,17,,10,10,20
073 Riffian,18,,11,7,18
073 Riffian,19,,5,4,9
073 Riffian,20,,7,11,18
073 Riffian,21,,10,4,14
073 Riffian,22,,11,8,19
073 Riffian,23,,9,1,10
073 Riffian,24,,5,14,19
073 Riffian,25,,10,4,14
073 Riffian,26,,12,10,22
073 Riffian,27,,10,19,29
073 Riffian,28,,11,17,28
073 Riffian,29,,6,10,16
073 Riffian,30,,9,13,22
073 Riffian,31,,12,15,27
073 Riffian,32,,13,13,26
073 Riffian,33,,8,7,15
073 Riffian,34,,12,7,19
073 Riffian,35,,12,8,20
073 Riffian,36,,13,10,23
073 Riffian,37,,10,8,18
073 Riffian,38,,9,9,18
073 Riffian,39,,13,4,17
073 Riffian,40,,6,15,21
073 Riffian,41,,7,6,13
073 Riffian,42,,6,13,19
073 Riffian,43,,10,4,14
073 Riffian,44,,6,11,17
073 Riffian,45,,9,6,15
073 Riffian,46,,10,4,14
073 Riffian,47,,7,3,10
073 Riffian,48,,7,10,17
073 Riffian,49,,4,3,7
073 Riffian,50,,6,6,12
073 Riffian,51,,8,6,14
073 Riffian,52,,4,4,8
073 Riffian,53,,2,6,8
073 Riffian,54,,6,3,9
073 Riffian,55,,8,9,17
073 Riffian,56,,7,7,14
073 Riffian,57,,12,7,19
073 Riffian,58,,8,3,11
073 Riffian,59,,4,3,7
073 Riffian,60,,4,9,13
073 Riffian,61,,10,4,14
073 Riffian,62,,4,6,10
073 Riffian,63,,2,4,6
073 Riffian,64,,1,3,4
073 Riffian,65,,1,3,4
073 Riffian,66,,7,5,12
073 Riffian,67,,4,3,7
073 Riffian,68,,5,9,14
073 Riffian,69,,4,3,7
073 Riffian,70,,3,7,10
073 Riffian,71,,3,3,6
073 Riffian,72,,5,5,10
073 Riffian,73,,6,2,8
073 Riffian,74,,5,3,8
073 Riffian,75,,5,6,11
073 Riffian,76,,4,7,11
073 Riffian,77,,3,2,5
073 Riffian,78,,1,4,5
073 Riffian,79,,2,4,6
073 Riffian,80,,-,1,1
073 Riffian,81,,1,1,2
073 Riffian,82,,-,3,3
073 Riffian,83,,1,-,1
073 Riffian,84,,1,-,1
073 Riffian,85,,1,5,6
073 Riffian,86,,1,2,3
073 Riffian,87,,-,1,1
073 Riffian,88,,1,-,1
073 Riffian,89,,1,-,1
073 Riffian,90,,-,1,1
073 Riffian,91,,1,2,3
073 Riffian,93,,1,-,1
074 Mühlbach,0,,21,15,36
074 Mühlbach,1,,12,18,30
074 Mühlbach,2,,16,16,32
074 Mühlbach,3,,15,17,32
074 Mühlbach,4,,9,15,24
074 Mühlbach,5,,19,13,32
074 Mühlbach,6,,18,16,34
074 Mühlbach,7,,13,24,37
074 Mühlbach,8,,12,18,30
074 Mühlbach,9,,12,13,25
074 Mühlbach,10,,14,19,33
074 Mühlbach,11,,20,15,35
074 Mühlbach,12,,20,12,32
074 Mühlbach,13,,17,9,26
074 Mühlbach,14,,16,16,32
074 Mühlbach,15,,15,21,36
074 Mühlbach,16,,20,17,37
074 Mühlbach,17,,25,24,49
074 Mühlbach,18,,23,18,41
074 Mühlbach,19,,17,15,32
074 Mühlbach,20,,18,12,30
074 Mühlbach,21,,24,23,47
074 Mühlbach,22,,21,14,35
074 Mühlbach,23,,19,32,51
074 Mühlbach,24,,19,20,39
074 Mühlbach,25,,17,16,33
074 Mühlbach,26,,24,18,42
074 Mühlbach,27,,22,16,38
074 Mühlbach,28,,22,23,45
074 Mühlbach,29,,27,11,38
074 Mühlbach,30,,24,31,55
074 Mühlbach,31,,37,22,59
074 Mühlbach,32,,22,20,42
074 Mühlbach,33,,26,15,41
074 Mühlbach,34,,18,25,43
074 Mühlbach,35,,17,19,36
074 Mühlbach,36,,22,17,39
074 Mühlbach,37,,23,16,39
074 Mühlbach,38,,24,22,46
074 Mühlbach,39,,21,14,35
074 Mühlbach,40,,22,18,40
074 Mühlbach,41,,18,13,31
074 Mühlbach,42,,17,19,36
074 Mühlbach,43,,20,22,42
074 Mühlbach,44,,18,18,36
074 Mühlbach,45,,14,19,33
074 Mühlbach,46,,19,17,36
074 Mühlbach,47,,15,22,37
074 Mühlbach,48,,13,22,35
074 Mühlbach,49,,18,19,37
074 Mühlbach,50,,11,14,25
074 Mühlbach,51,,17,12,29
074 Mühlbach,52,,11,17,28
074 Mühlbach,53,,25,13,38
074 Mühlbach,54,,10,8,18
074 Mühlbach,55,,15,13,28
074 Mühlbach,56,,13,11,24
074 Mühlbach,57,,17,13,30
074 Mühlbach,58,,18,15,33
074 Mühlbach,59,,14,11,25
074 Mühlbach,60,,13,16,29
074 Mühlbach,61,,15,7,22
074 Mühlbach,62,,5,12,17
074 Mühlbach,63,,7,7,14
074 Mühlbach,64,,7,11,18
074 Mühlbach,65,,13,12,25
074 Mühlbach,66,,9,10,19
074 Mühlbach,67,,8,10,18
074 Mühlbach,68,,8,12,20
074 Mühlbach,69,,13,8,21
074 Mühlbach,70,,9,3,12
074 Mühlbach,71,,13,20,33
074 Mühlbach,72,,7,9,16
074 Mühlbach,73,,9,10,19
074 Mühlbach,74,,6,7,13
074 Mühlbach,75,,6,7,13
074 Mühlbach,76,,5,12,17
074 Mühlbach,77,,5,12,17
074 Mühlbach,78,,4,7,11
074 Mühlbach,79,,6,10,16
074 Mühlbach,80,,2,10,12
074 Mühlbach,81,,1,2,3
074 Mühlbach,82,,2,4,6
074 Mühlbach,83,,1,1,2
074 Mühlbach,84,,-,2,2
074 Mühlbach,85,,3,8,11
074 Mühlbach,86,,3,4,7
074 Mühlbach,87,,-,2,2
074 Mühlbach,88,,-,1,1
074 Mühlbach,89,,1,4,5
074 Mühlbach,90,,1,2,3
074 Mühlbach,92,,-,1,1
074 Mühlbach,93,,-,4,4
074 Mühlbach,94,,1,1,2
075 Rodeneck,0,,7,10,17
075 Rodeneck,1,,11,7,18
075 Rodeneck,2,,10,7,17
075 Rodeneck,3,,13,11,24
075 Rodeneck,4,,6,9,15
075 Rodeneck,5,,8,10,18
075 Rodeneck,6,,7,7,14
075 Rodeneck,7,,8,10,18
075 Rodeneck,8,,6,9,15
075 Rodeneck,9,,13,8,21
075 Rodeneck,10,,7,6,13
075 Rodeneck,11,,13,10,23
075 Rodeneck,12,,6,5,11
075 Rodeneck,13,,9,12,21
075 Rodeneck,14,,12,9,21
075 Rodeneck,15,,16,10,26
075 Rodeneck,16,,11,6,17
075 Rodeneck,17,,7,6,13
075 Rodeneck,18,,10,6,16
075 Rodeneck,19,,6,9,15
075 Rodeneck,20,,8,6,14
075 Rodeneck,21,,6,8,14
075 Rodeneck,22,,8,9,17
075 Rodeneck,23,,8,6,14
075 Rodeneck,24,,9,7,16
075 Rodeneck,25,,7,7,14
075 Rodeneck,26,,14,9,23
075 Rodeneck,27,,9,11,20
075 Rodeneck,28,,12,6,18
075 Rodeneck,29,,11,9,20
075 Rodeneck,30,,17,10,27
075 Rodeneck,31,,11,12,23
075 Rodeneck,32,,13,12,25
075 Rodeneck,33,,13,8,21
075 Rodeneck,34,,8,7,15
075 Rodeneck,35,,10,10,20
075 Rodeneck,36,,9,10,19
075 Rodeneck,37,,9,12,21
075 Rodeneck,38,,9,11,20
075 Rodeneck,39,,5,11,16
075 Rodeneck,40,,12,6,18
075 Rodeneck,41,,8,5,13
075 Rodeneck,42,,6,6,12
075 Rodeneck,43,,9,4,13
075 Rodeneck,44,,7,6,13
075 Rodeneck,45,,11,3,14
075 Rodeneck,46,,4,1,5
075 Rodeneck,47,,8,5,13
075 Rodeneck,48,,3,2,5
075 Rodeneck,49,,2,7,9
075 Rodeneck,50,,4,7,11
075 Rodeneck,51,,4,7,11
075 Rodeneck,52,,6,4,10
075 Rodeneck,53,,10,6,16
075 Rodeneck,54,,-,5,5
075 Rodeneck,55,,5,5,10
075 Rodeneck,56,,3,2,5
075 Rodeneck,57,,3,6,9
075 Rodeneck,58,,9,3,12
075 Rodeneck,59,,5,4,9
075 Rodeneck,60,,3,9,12
075 Rodeneck,61,,3,3,6
075 Rodeneck,62,,3,5,8
075 Rodeneck,63,,5,5,10
075 Rodeneck,64,,5,2,7
075 Rodeneck,65,,1,12,13
075 Rodeneck,66,,3,2,5
075 Rodeneck,67,,5,5,10
075 Rodeneck,68,,6,5,11
075 Rodeneck,69,,4,3,7
075 Rodeneck,70,,7,3,10
075 Rodeneck,71,,5,5,10
075 Rodeneck,72,,5,5,10
075 Rodeneck,73,,4,6,10
075 Rodeneck,74,,3,9,12
075 Rodeneck,75,,5,5,10
075 Rodeneck,76,,2,3,5
075 Rodeneck,77,,2,3,5
075 Rodeneck,78,,3,1,4
075 Rodeneck,79,,2,2,4
075 Rodeneck,80,,4,2,6
075 Rodeneck,81,,-,3,3
075 Rodeneck,82,,-,1,1
075 Rodeneck,83,,1,1,2
075 Rodeneck,84,,1,2,3
075 Rodeneck,85,,1,1,2
075 Rodeneck,86,,1,1,2
075 Rodeneck,87,,1,-,1
075 Rodeneck,88,,-,1,1
075 Rodeneck,89,,3,-,3
075 Rodeneck,91,,-,1,1
075 Rodeneck,92,,-,1,1
075 Rodeneck,96,,1,-,1
076 Salurn,0,,20,10,30
076 Salurn,1,,19,26,45
076 Salurn,2,,14,11,25
076 Salurn,3,,19,19,38
076 Salurn,4,,20,10,30
076 Salurn,5,,20,21,41
076 Salurn,6,,15,13,28
076 Salurn,7,,24,17,41
076 Salurn,8,,11,13,24
076 Salurn,9,,8,9,17
076 Salurn,10,,17,16,33
076 Salurn,11,,14,20,34
076 Salurn,12,,19,12,31
076 Salurn,13,,12,16,28
076 Salurn,14,,19,16,35
076 Salurn,15,,12,13,25
076 Salurn,16,,11,16,27
076 Salurn,17,,16,11,27
076 Salurn,18,,16,14,30
076 Salurn,19,,19,16,35
076 Salurn,20,,10,14,24
076 Salurn,21,,14,11,25
076 Salurn,22,,19,16,35
076 Salurn,23,,11,14,25
076 Salurn,24,,15,21,36
076 Salurn,25,,11,15,26
076 Salurn,26,,14,18,32
076 Salurn,27,,23,25,48
076 Salurn,28,,28,15,43
076 Salurn,29,,24,26,50
076 Salurn,30,,24,24,48
076 Salurn,31,,25,19,44
076 Salurn,32,,19,21,40
076 Salurn,33,,24,23,47
076 Salurn,34,,25,26,51
076 Salurn,35,,35,26,61
076 Salurn,36,,36,22,58
076 Salurn,37,,32,21,53
076 Salurn,38,,30,31,61
076 Salurn,39,,23,26,49
076 Salurn,40,,25,24,49
076 Salurn,41,,27,17,44
076 Salurn,42,,17,23,40
076 Salurn,43,,18,16,34
076 Salurn,44,,16,19,35
076 Salurn,45,,25,19,44
076 Salurn,46,,16,15,31
076 Salurn,47,,28,18,46
076 Salurn,48,,29,18,47
076 Salurn,49,,24,17,41
076 Salurn,50,,26,12,38
076 Salurn,51,,16,21,37
076 Salurn,52,,18,17,35
076 Salurn,53,,21,17,38
076 Salurn,54,,15,10,25
076 Salurn,55,,21,19,40
076 Salurn,56,,17,17,34
076 Salurn,57,,18,16,34
076 Salurn,58,,17,16,33
076 Salurn,59,,14,10,24
076 Salurn,60,,10,11,21
076 Salurn,61,,6,13,19
076 Salurn,62,,10,11,21
076 Salurn,63,,13,22,35
076 Salurn,64,,20,16,36
076 Salurn,65,,11,6,17
076 Salurn,66,,12,9,21
076 Salurn,67,,10,22,32
076 Salurn,68,,7,11,18
076 Salurn,69,,10,10,20
076 Salurn,70,,22,13,35
076 Salurn,71,,11,23,34
076 Salurn,72,,6,24,30
076 Salurn,73,,7,15,22
076 Salurn,74,,6,24,30
076 Salurn,75,,10,16,26
076 Salurn,76,,7,9,16
076 Salurn,77,,12,22,34
076 Salurn,78,,6,17,23
076 Salurn,79,,13,11,24
076 Salurn,80,,7,13,20
076 Salurn,81,,5,3,8
076 Salurn,82,,2,5,7
076 Salurn,83,,3,7,10
076 Salurn,84,,5,6,11
076 Salurn,85,,4,11,15
076 Salurn,86,,3,6,9
076 Salurn,87,,4,8,12
076 Salurn,88,,-,6,6
076 Salurn,89,,2,4,6
076 Salurn,90,,2,2,4
076 Salurn,91,,2,5,7
076 Salurn,92,,-,2,2
076 Salurn,93,,-,2,2
076 Salurn,94,,-,1,1
076 Salurn,96,,-,1,1
077 Innichen,0,,16,19,35
077 Innichen,1,,21,13,34
077 Innichen,2,,19,20,39
077 Innichen,3,,16,19,35
077 Innichen,4,,23,12,35
077 Innichen,5,,17,16,33
077 Innichen,6,,21,22,43
077 Innichen,7,,25,18,43
077 Innichen,8,,22,24,46
077 Innichen,9,,17,14,31
077 Innichen,10,,17,22,39
077 Innichen,11,,29,19,48
077 Innichen,12,,21,19,40
077 Innichen,13,,23,18,41
077 Innichen,14,,20,20,40
077 Innichen,15,,20,20,40
077 Innichen,16,,22,16,38
077 Innichen,17,,18,22,40
077 Innichen,18,,15,19,34
077 Innichen,19,,23,17,40
077 Innichen,20,,25,21,46
077 Innichen,21,,9,16,25
077 Innichen,22,,14,23,37
077 Innichen,23,,17,28,45
077 Innichen,24,,25,8,33
077 Innichen,25,,27,26,53
077 Innichen,26,,23,28,51
077 Innichen,27,,26,31,57
077 Innichen,28,,20,16,36
077 Innichen,29,,27,25,52
077 Innichen,30,,27,28,55
077 Innichen,31,,33,30,63
077 Innichen,32,,18,28,46
077 Innichen,33,,30,33,63
077 Innichen,34,,32,31,63
077 Innichen,35,,36,32,68
077 Innichen,36,,30,29,59
077 Innichen,37,,34,23,57
077 Innichen,38,,24,31,55
077 Innichen,39,,36,18,54
077 Innichen,40,,28,25,53
077 Innichen,41,,21,26,47
077 Innichen,42,,21,25,46
077 Innichen,43,,26,16,42
077 Innichen,44,,25,18,43
077 Innichen,45,,22,13,35
077 Innichen,46,,24,17,41
077 Innichen,47,,13,26,39
077 Innichen,48,,12,18,30
077 Innichen,49,,18,20,38
077 Innichen,50,,21,17,38
077 Innichen,51,,17,12,29
077 Innichen,52,,14,16,30
077 Innichen,53,,15,15,30
077 Innichen,54,,12,9,21
077 Innichen,55,,8,13,21
077 Innichen,56,,23,9,32
077 Innichen,57,,17,17,34
077 Innichen,58,,14,16,30
077 Innichen,59,,10,23,33
077 Innichen,60,,14,13,27
077 Innichen,61,,8,11,19
077 Innichen,62,,12,12,24
077 Innichen,63,,10,19,29
077 Innichen,64,,9,19,28
077 Innichen,65,,11,13,24
077 Innichen,66,,12,10,22
077 Innichen,67,,19,16,35
077 Innichen,68,,14,22,36
077 Innichen,69,,16,12,28
077 Innichen,70,,15,17,32
077 Innichen,71,,12,20,32
077 Innichen,72,,7,12,19
077 Innichen,73,,18,13,31
077 Innichen,74,,8,21,29
077 Innichen,75,,10,4,14
077 Innichen,76,,8,13,21
077 Innichen,77,,5,16,21
077 Innichen,78,,9,14,23
077 Innichen,79,,8,12,20
077 Innichen,80,,3,5,8
077 Innichen,81,,1,5,6
077 Innichen,82,,2,2,4
077 Innichen,83,,2,3,5
077 Innichen,84,,4,5,9
077 Innichen,85,,3,3,6
077 Innichen,86,,4,6,10
077 Innichen,87,,1,6,7
077 Innichen,88,,1,1,2
077 Innichen,89,,1,2,3
077 Innichen,90,,2,1,3
077 Innichen,91,,-,4,4
077 Innichen,92,,1,2,3
077 Innichen,93,,1,1,2
077 Innichen,94,,-,1,1
077 Innichen,95,,-,2,2
077 Innichen,97,,-,2,2
079 Jenesien,0,,23,25,48
079 Jenesien,1,,16,25,41
079 Jenesien,2,,18,21,39
079 Jenesien,3,,24,11,35
079 Jenesien,4,,26,15,41
079 Jenesien,5,,21,23,44
079 Jenesien,6,,15,20,35
079 Jenesien,7,,25,21,46
079 Jenesien,8,,18,21,39
079 Jenesien,9,,18,15,33
079 Jenesien,10,,18,12,30
079 Jenesien,11,,24,16,40
079 Jenesien,12,,13,20,33
079 Jenesien,13,,16,16,32
079 Jenesien,14,,14,5,19
079 Jenesien,15,,19,14,33
079 Jenesien,16,,17,19,36
079 Jenesien,17,,13,24,37
079 Jenesien,18,,6,19,25
079 Jenesien,19,,14,21,35
079 Jenesien,20,,20,18,38
079 Jenesien,21,,12,14,26
079 Jenesien,22,,18,24,42
079 Jenesien,23,,16,12,28
079 Jenesien,24,,12,12,24
079 Jenesien,25,,18,19,37
079 Jenesien,26,,19,25,44
079 Jenesien,27,,18,23,41
079 Jenesien,28,,30,18,48
079 Jenesien,29,,27,25,52
079 Jenesien,30,,27,18,45
079 Jenesien,31,,21,28,49
079 Jenesien,32,,16,20,36
079 Jenesien,33,,33,27,60
079 Jenesien,34,,31,27,58
079 Jenesien,35,,35,33,68
079 Jenesien,36,,29,21,50
079 Jenesien,37,,26,22,48
079 Jenesien,38,,28,19,47
079 Jenesien,39,,26,12,38
079 Jenesien,40,,24,15,39
079 Jenesien,41,,23,10,33
079 Jenesien,42,,14,16,30
079 Jenesien,43,,16,13,29
079 Jenesien,44,,9,11,20
079 Jenesien,45,,16,15,31
079 Jenesien,46,,14,11,25
079 Jenesien,47,,16,19,35
079 Jenesien,48,,11,9,20
079 Jenesien,49,,11,21,32
079 Jenesien,50,,11,13,24
079 Jenesien,51,,12,7,19
079 Jenesien,52,,14,12,26
079 Jenesien,53,,8,12,20
079 Jenesien,54,,8,13,21
079 Jenesien,55,,13,14,27
079 Jenesien,56,,17,10,27
079 Jenesien,57,,15,10,25
079 Jenesien,58,,15,20,35
079 Jenesien,59,,17,11,28
079 Jenesien,60,,15,18,33
079 Jenesien,61,,22,9,31
079 Jenesien,62,,11,16,27
079 Jenesien,63,,6,19,25
079 Jenesien,64,,6,7,13
079 Jenesien,65,,9,7,16
079 Jenesien,66,,17,11,28
079 Jenesien,67,,8,10,18
079 Jenesien,68,,10,9,19
079 Jenesien,69,,7,15,22
079 Jenesien,70,,8,16,24
079 Jenesien,71,,15,11,26
079 Jenesien,72,,8,10,18
079 Jenesien,73,,10,15,25
079 Jenesien,74,,4,14,18
079 Jenesien,75,,8,12,20
079 Jenesien,76,,7,9,16
079 Jenesien,77,,7,10,17
079 Jenesien,78,,3,6,9
079 Jenesien,79,,3,9,12
079 Jenesien,80,,2,5,7
079 Jenesien,81,,-,1,1
079 Jenesien,82,,1,2,3
079 Jenesien,83,,2,1,3
079 Jenesien,84,,2,5,7
079 Jenesien,85,,3,4,7
079 Jenesien,86,,-,6,6
079 Jenesien,87,,1,6,7
079 Jenesien,88,,3,5,8
079 Jenesien,89,,-,1,1
079 Jenesien,90,,2,-,2
079 Jenesien,91,,2,3,5
079 Jenesien,94,,-,1,1
079 Jenesien,95,,-,1,1
079 Jenesien,96,,1,-,1
080 St.Leonhard in Pass.,0,,19,22,41
080 St.Leonhard in Pass.,1,,24,13,37
080 St.Leonhard in Pass.,2,,25,21,46
080 St.Leonhard in Pass.,3,,28,22,50
080 St.Leonhard in Pass.,4,,21,12,33
080 St.Leonhard in Pass.,5,,27,22,49
080 St.Leonhard in Pass.,6,,23,21,44
080 St.Leonhard in Pass.,7,,25,21,46
080 St.Leonhard in Pass.,8,,24,20,44
080 St.Leonhard in Pass.,9,,24,21,45
080 St.Leonhard in Pass.,10,,36,31,67
080 St.Leonhard in Pass.,11,,23,25,48
080 St.Leonhard in Pass.,12,,30,25,55
080 St.Leonhard in Pass.,13,,34,35,69
080 St.Leonhard in Pass.,14,,24,27,51
080 St.Leonhard in Pass.,15,,30,25,55
080 St.Leonhard in Pass.,16,,28,27,55
080 St.Leonhard in Pass.,17,,31,22,53
080 St.Leonhard in Pass.,18,,24,30,54
080 St.Leonhard in Pass.,19,,29,34,63
080 St.Leonhard in Pass.,20,,28,25,53
080 St.Leonhard in Pass.,21,,31,20,51
080 St.Leonhard in Pass.,22,,35,29,64
080 St.Leonhard in Pass.,23,,20,29,49
080 St.Leonhard in Pass.,24,,27,14,41
080 St.Leonhard in Pass.,25,,32,39,71
080 St.Leonhard in Pass.,26,,32,32,64
080 St.Leonhard in Pass.,27,,32,29,61
080 St.Leonhard in Pass.,28,,32,22,54
080 St.Leonhard in Pass.,29,,26,25,51
080 St.Leonhard in Pass.,30,,27,27,54
080 St.Leonhard in Pass.,31,,33,26,59
080 St.Leonhard in Pass.,32,,29,24,53
080 St.Leonhard in Pass.,33,,35,40,75
080 St.Leonhard in Pass.,34,,30,31,61
080 St.Leonhard in Pass.,35,,25,33,58
080 St.Leonhard in Pass.,36,,27,29,56
080 St.Leonhard in Pass.,37,,23,31,54
080 St.Leonhard in Pass.,38,,28,24,52
080 St.Leonhard in Pass.,39,,30,19,49
080 St.Leonhard in Pass.,40,,23,27,50
080 St.Leonhard in Pass.,41,,25,22,47
080 St.Leonhard in Pass.,42,,24,26,50
080 St.Leonhard in Pass.,43,,24,17,41
080 St.Leonhard in Pass.,44,,25,19,44
080 St.Leonhard in Pass.,45,,21,16,37
080 St.Leonhard in Pass.,46,,30,25,55
080 St.Leonhard in Pass.,47,,21,27,48
080 St.Leonhard in Pass.,48,,26,16,42
080 St.Leonhard in Pass.,49,,19,15,34
080 St.Leonhard in Pass.,50,,25,12,37
080 St.Leonhard in Pass.,51,,24,14,38
080 St.Leonhard in Pass.,52,,18,16,34
080 St.Leonhard in Pass.,53,,16,19,35
080 St.Leonhard in Pass.,54,,11,11,22
080 St.Leonhard in Pass.,55,,16,14,30
080 St.Leonhard in Pass.,56,,11,26,37
080 St.Leonhard in Pass.,57,,8,17,25
080 St.Leonhard in Pass.,58,,15,16,31
080 St.Leonhard in Pass.,59,,24,13,37
080 St.Leonhard in Pass.,60,,20,19,39
080 St.Leonhard in Pass.,61,,13,12,25
080 St.Leonhard in Pass.,62,,20,9,29
080 St.Leonhard in Pass.,63,,19,11,30
080 St.Leonhard in Pass.,64,,13,14,27
080 St.Leonhard in Pass.,65,,11,15,26
080 St.Leonhard in Pass.,66,,13,17,30
080 St.Leonhard in Pass.,67,,12,13,25
080 St.Leonhard in Pass.,68,,8,15,23
080 St.Leonhard in Pass.,69,,8,10,18
080 St.Leonhard in Pass.,70,,10,10,20
080 St.Leonhard in Pass.,71,,7,14,21
080 St.Leonhard in Pass.,72,,6,15,21
080 St.Leonhard in Pass.,73,,7,13,20
080 St.Leonhard in Pass.,74,,8,12,20
080 St.Leonhard in Pass.,75,,5,12,17
080 St.Leonhard in Pass.,76,,7,13,20
080 St.Leonhard in Pass.,77,,6,11,17
080 St.Leonhard in Pass.,78,,3,6,9
080 St.Leonhard in Pass.,79,,5,10,15
080 St.Leonhard in Pass.,80,,5,3,8
080 St.Leonhard in Pass.,81,,1,5,6
080 St.Leonhard in Pass.,82,,-,7,7
080 St.Leonhard in Pass.,83,,1,-,1
080 St.Leonhard in Pass.,84,,2,4,6
080 St.Leonhard in Pass.,85,,2,8,10
080 St.Leonhard in Pass.,86,,-,6,6
080 St.Leonhard in Pass.,87,,1,9,10
080 St.Leonhard in Pass.,88,,3,5,8
080 St.Leonhard in Pass.,89,,-,1,1
080 St.Leonhard in Pass.,90,,2,2,4
080 St.Leonhard in Pass.,91,,2,1,3
080 St.Leonhard in Pass.,92,,1,4,5
080 St.Leonhard in Pass.,93,,2,1,3
080 St.Leonhard in Pass.,94,,-,2,2
080 St.Leonhard in Pass.,95,,-,1,1
081 St.Lorenzen,0,,26,33,59
081 St.Lorenzen,1,,27,26,53
081 St.Lorenzen,2,,14,26,40
081 St.Lorenzen,3,,28,26,54
081 St.Lorenzen,4,,24,12,36
081 St.Lorenzen,5,,31,19,50
081 St.Lorenzen,6,,23,29,52
081 St.Lorenzen,7,,25,20,45
081 St.Lorenzen,8,,20,16,36
081 St.Lorenzen,9,,24,21,45
081 St.Lorenzen,10,,20,19,39
081 St.Lorenzen,11,,19,26,45
081 St.Lorenzen,12,,19,23,42
081 St.Lorenzen,13,,23,20,43
081 St.Lorenzen,14,,24,22,46
081 St.Lorenzen,15,,25,26,51
081 St.Lorenzen,16,,22,20,42
081 St.Lorenzen,17,,30,18,48
081 St.Lorenzen,18,,21,20,41
081 St.Lorenzen,19,,14,17,31
081 St.Lorenzen,20,,24,25,49
081 St.Lorenzen,21,,22,24,46
081 St.Lorenzen,22,,26,21,47
081 St.Lorenzen,23,,25,21,46
081 St.Lorenzen,24,,22,22,44
081 St.Lorenzen,25,,21,31,52
081 St.Lorenzen,26,,35,21,56
081 St.Lorenzen,27,,36,29,65
081 St.Lorenzen,28,,33,23,56
081 St.Lorenzen,29,,22,28,50
081 St.Lorenzen,30,,29,29,58
081 St.Lorenzen,31,,42,33,75
081 St.Lorenzen,32,,34,33,67
081 St.Lorenzen,33,,36,35,71
081 St.Lorenzen,34,,39,22,61
081 St.Lorenzen,35,,28,24,52
081 St.Lorenzen,36,,35,31,66
081 St.Lorenzen,37,,24,32,56
081 St.Lorenzen,38,,22,39,61
081 St.Lorenzen,39,,31,21,52
081 St.Lorenzen,40,,31,27,58
081 St.Lorenzen,41,,30,32,62
081 St.Lorenzen,42,,27,25,52
081 St.Lorenzen,43,,27,27,54
081 St.Lorenzen,44,,18,18,36
081 St.Lorenzen,45,,19,20,39
081 St.Lorenzen,46,,24,16,40
081 St.Lorenzen,47,,20,13,33
081 St.Lorenzen,48,,17,15,32
081 St.Lorenzen,49,,15,18,33
081 St.Lorenzen,50,,13,21,34
081 St.Lorenzen,51,,14,13,27
081 St.Lorenzen,52,,22,9,31
081 St.Lorenzen,53,,21,9,30
081 St.Lorenzen,54,,13,19,32
081 St.Lorenzen,55,,15,17,32
081 St.Lorenzen,56,,14,15,29
081 St.Lorenzen,57,,18,25,43
081 St.Lorenzen,58,,21,18,39
081 St.Lorenzen,59,,14,13,27
081 St.Lorenzen,60,,15,19,34
081 St.Lorenzen,61,,15,15,30
081 St.Lorenzen,62,,17,17,34
081 St.Lorenzen,63,,13,16,29
081 St.Lorenzen,64,,10,18,28
081 St.Lorenzen,65,,16,14,30
081 St.Lorenzen,66,,13,12,25
081 St.Lorenzen,67,,14,12,26
081 St.Lorenzen,68,,10,14,24
081 St.Lorenzen,69,,9,10,19
081 St.Lorenzen,70,,11,20,31
081 St.Lorenzen,71,,15,17,32
081 St.Lorenzen,72,,10,7,17
081 St.Lorenzen,73,,11,12,23
081 St.Lorenzen,74,,10,20,30
081 St.Lorenzen,75,,4,12,16
081 St.Lorenzen,76,,11,12,23
081 St.Lorenzen,77,,6,8,14
081 St.Lorenzen,78,,6,6,12
081 St.Lorenzen,79,,2,8,10
081 St.Lorenzen,80,,5,9,14
081 St.Lorenzen,81,,2,8,10
081 St.Lorenzen,82,,-,6,6
081 St.Lorenzen,83,,2,3,5
081 St.Lorenzen,84,,1,3,4
081 St.Lorenzen,85,,5,4,9
081 St.Lorenzen,86,,2,2,4
081 St.Lorenzen,87,,2,3,5
081 St.Lorenzen,88,,1,3,4
081 St.Lorenzen,89,,1,2,3
081 St.Lorenzen,90,,2,1,3
081 St.Lorenzen,91,,-,1,1
081 St.Lorenzen,92,,1,4,5
081 St.Lorenzen,93,,-,1,1
081 St.Lorenzen,94,,-,2,2
081 St.Lorenzen,95,,-,1,1
081 St.Lorenzen,96,,-,1,1
082 St.Martin in Thurn,0,,9,20,29
082 St.Martin in Thurn,1,,10,12,22
082 St.Martin in Thurn,2,,17,11,28
082 St.Martin in Thurn,3,,24,15,39
082 St.Martin in Thurn,4,,15,12,27
082 St.Martin in Thurn,5,,15,8,23
082 St.Martin in Thurn,6,,9,9,18
082 St.Martin in Thurn,7,,16,14,30
082 St.Martin in Thurn,8,,11,11,22
082 St.Martin in Thurn,9,,6,15,21
082 St.Martin in Thurn,10,,17,15,32
082 St.Martin in Thurn,11,,8,6,14
082 St.Martin in Thurn,12,,14,12,26
082 St.Martin in Thurn,13,,13,10,23
082 St.Martin in Thurn,14,,12,13,25
082 St.Martin in Thurn,15,,8,6,14
082 St.Martin in Thurn,16,,14,9,23
082 St.Martin in Thurn,17,,14,12,26
082 St.Martin in Thurn,18,,16,8,24
082 St.Martin in Thurn,19,,9,13,22
082 St.Martin in Thurn,20,,9,11,20
082 St.Martin in Thurn,21,,17,8,25
082 St.Martin in Thurn,22,,14,11,25
082 St.Martin in Thurn,23,,12,9,21
082 St.Martin in Thurn,24,,8,15,23
082 St.Martin in Thurn,25,,6,11,17
082 St.Martin in Thurn,26,,13,12,25
082 St.Martin in Thurn,27,,11,9,20
082 St.Martin in Thurn,28,,15,15,30
082 St.Martin in Thurn,29,,15,13,28
082 St.Martin in Thurn,30,,15,15,30
082 St.Martin in Thurn,31,,13,18,31
082 St.Martin in Thurn,32,,12,10,22
082 St.Martin in Thurn,33,,15,24,39
082 St.Martin in Thurn,34,,14,20,34
082 St.Martin in Thurn,35,,12,15,27
082 St.Martin in Thurn,36,,15,13,28
082 St.Martin in Thurn,37,,15,13,28
082 St.Martin in Thurn,38,,14,21,35
082 St.Martin in Thurn,39,,15,7,22
082 St.Martin in Thurn,40,,12,12,24
082 St.Martin in Thurn,41,,13,8,21
082 St.Martin in Thurn,42,,12,9,21
082 St.Martin in Thurn,43,,7,7,14
082 St.Martin in Thurn,44,,13,9,22
082 St.Martin in Thurn,45,,8,8,16
082 St.Martin in Thurn,46,,6,12,18
082 St.Martin in Thurn,47,,3,3,6
082 St.Martin in Thurn,48,,7,8,15
082 St.Martin in Thurn,49,,11,6,17
082 St.Martin in Thurn,50,,5,7,12
082 St.Martin in Thurn,51,,10,7,17
082 St.Martin in Thurn,52,,9,6,15
082 St.Martin in Thurn,53,,9,8,17
082 St.Martin in Thurn,54,,7,4,11
082 St.Martin in Thurn,55,,11,8,19
082 St.Martin in Thurn,56,,4,8,12
082 St.Martin in Thurn,57,,7,5,12
082 St.Martin in Thurn,58,,7,7,14
082 St.Martin in Thurn,59,,5,5,10
082 St.Martin in Thurn,60,,5,7,12
082 St.Martin in Thurn,61,,10,7,17
082 St.Martin in Thurn,62,,7,13,20
082 St.Martin in Thurn,63,,4,6,10
082 St.Martin in Thurn,64,,7,5,12
082 St.Martin in Thurn,65,,8,4,12
082 St.Martin in Thurn,66,,2,11,13
082 St.Martin in Thurn,67,,8,7,15
082 St.Martin in Thurn,68,,10,7,17
082 St.Martin in Thurn,69,,7,7,14
082 St.Martin in Thurn,70,,6,8,14
082 St.Martin in Thurn,71,,3,7,10
082 St.Martin in Thurn,72,,5,5,10
082 St.Martin in Thurn,73,,9,7,16
082 St.Martin in Thurn,74,,8,3,11
082 St.Martin in Thurn,75,,8,9,17
082 St.Martin in Thurn,76,,3,8,11
082 St.Martin in Thurn,77,,8,5,13
082 St.Martin in Thurn,78,,7,3,10
082 St.Martin in Thurn,79,,7,7,14
082 St.Martin in Thurn,80,,2,4,6
082 St.Martin in Thurn,81,,2,-,2
082 St.Martin in Thurn,82,,4,1,5
082 St.Martin in Thurn,83,,1,1,2
082 St.Martin in Thurn,84,,1,1,2
082 St.Martin in Thurn,85,,-,3,3
082 St.Martin in Thurn,86,,1,1,2
082 St.Martin in Thurn,87,,1,1,2
082 St.Martin in Thurn,88,,1,2,3
082 St.Martin in Thurn,89,,3,2,5
082 St.Martin in Thurn,90,,1,2,3
082 St.Martin in Thurn,91,,2,-,2
082 St.Martin in Thurn,92,,-,1,1
082 St.Martin in Thurn,95,,2,1,3
083 St.Martin in Passeier,0,,9,20,29
083 St.Martin in Passeier,1,,17,20,37
083 St.Martin in Passeier,2,,25,23,48
083 St.Martin in Passeier,3,,21,21,42
083 St.Martin in Passeier,4,,20,18,38
083 St.Martin in Passeier,5,,19,23,42
083 St.Martin in Passeier,6,,19,23,42
083 St.Martin in Passeier,7,,25,16,41
083 St.Martin in Passeier,8,,21,23,44
083 St.Martin in Passeier,9,,20,25,45
083 St.Martin in Passeier,10,,18,21,39
083 St.Martin in Passeier,11,,16,15,31
083 St.Martin in Passeier,12,,18,22,40
083 St.Martin in Passeier,13,,21,23,44
083 St.Martin in Passeier,14,,16,21,37
083 St.Martin in Passeier,15,,16,24,40
083 St.Martin in Passeier,16,,19,10,29
083 St.Martin in Passeier,17,,20,21,41
083 St.Martin in Passeier,18,,22,21,43
083 St.Martin in Passeier,19,,19,21,40
083 St.Martin in Passeier,20,,21,11,32
083 St.Martin in Passeier,21,,30,17,47
083 St.Martin in Passeier,22,,20,18,38
083 St.Martin in Passeier,23,,22,22,44
083 St.Martin in Passeier,24,,24,19,43
083 St.Martin in Passeier,25,,20,23,43
083 St.Martin in Passeier,26,,21,30,51
083 St.Martin in Passeier,27,,28,25,53
083 St.Martin in Passeier,28,,29,26,55
083 St.Martin in Passeier,29,,28,29,57
083 St.Martin in Passeier,30,,28,31,59
083 St.Martin in Passeier,31,,24,23,47
083 St.Martin in Passeier,32,,22,24,46
083 St.Martin in Passeier,33,,27,28,55
083 St.Martin in Passeier,34,,33,26,59
083 St.Martin in Passeier,35,,21,21,42
083 St.Martin in Passeier,36,,36,20,56
083 St.Martin in Passeier,37,,22,28,50
083 St.Martin in Passeier,38,,36,20,56
083 St.Martin in Passeier,39,,21,26,47
083 St.Martin in Passeier,40,,26,21,47
083 St.Martin in Passeier,41,,24,20,44
083 St.Martin in Passeier,42,,25,11,36
083 St.Martin in Passeier,43,,21,16,37
083 St.Martin in Passeier,44,,31,15,46
083 St.Martin in Passeier,45,,16,9,25
083 St.Martin in Passeier,46,,22,18,40
083 St.Martin in Passeier,47,,5,19,24
083 St.Martin in Passeier,48,,21,14,35
083 St.Martin in Passeier,49,,12,16,28
083 St.Martin in Passeier,50,,11,8,19
083 St.Martin in Passeier,51,,11,10,21
083 St.Martin in Passeier,52,,15,13,28
083 St.Martin in Passeier,53,,14,11,25
083 St.Martin in Passeier,54,,11,13,24
083 St.Martin in Passeier,55,,18,12,30
083 St.Martin in Passeier,56,,15,11,26
083 St.Martin in Passeier,57,,15,14,29
083 St.Martin in Passeier,58,,10,14,24
083 St.Martin in Passeier,59,,4,13,17
083 St.Martin in Passeier,60,,6,14,20
083 St.Martin in Passeier,61,,14,8,22
083 St.Martin in Passeier,62,,14,19,33
083 St.Martin in Passeier,63,,14,15,29
083 St.Martin in Passeier,64,,7,13,20
083 St.Martin in Passeier,65,,20,9,29
083 St.Martin in Passeier,66,,15,9,24
083 St.Martin in Passeier,67,,11,11,22
083 St.Martin in Passeier,68,,7,12,19
083 St.Martin in Passeier,69,,8,14,22
083 St.Martin in Passeier,70,,13,9,22
083 St.Martin in Passeier,71,,8,8,16
083 St.Martin in Passeier,72,,14,6,20
083 St.Martin in Passeier,73,,5,12,17
083 St.Martin in Passeier,74,,8,8,16
083 St.Martin in Passeier,75,,6,14,20
083 St.Martin in Passeier,76,,3,9,12
083 St.Martin in Passeier,77,,8,7,15
083 St.Martin in Passeier,78,,7,11,18
083 St.Martin in Passeier,79,,3,5,8
083 St.Martin in Passeier,80,,2,4,6
083 St.Martin in Passeier,81,,1,2,3
083 St.Martin in Passeier,82,,2,5,7
083 St.Martin in Passeier,83,,-,2,2
083 St.Martin in Passeier,84,,3,1,4
083 St.Martin in Passeier,85,,1,4,5
083 St.Martin in Passeier,86,,3,3,6
083 St.Martin in Passeier,87,,1,4,5
083 St.Martin in Passeier,88,,1,2,3
083 St.Martin in Passeier,89,,1,2,3
083 St.Martin in Passeier,91,,1,-,1
083 St.Martin in Passeier,93,,-,1,1
084 St.Pankraz,0,,8,5,13
084 St.Pankraz,1,,12,7,19
084 St.Pankraz,2,,11,11,22
084 St.Pankraz,3,,11,10,21
084 St.Pankraz,4,,10,5,15
084 St.Pankraz,5,,10,8,18
084 St.Pankraz,6,,6,11,17
084 St.Pankraz,7,,7,6,13
084 St.Pankraz,8,,13,13,26
084 St.Pankraz,9,,9,4,13
084 St.Pankraz,10,,11,14,25
084 St.Pankraz,11,,14,8,22
084 St.Pankraz,12,,10,9,19
084 St.Pankraz,13,,9,6,15
084 St.Pankraz,14,,9,8,17
084 St.Pankraz,15,,9,5,14
084 St.Pankraz,16,,10,7,17
084 St.Pankraz,17,,12,9,21
084 St.Pankraz,18,,9,13,22
084 St.Pankraz,19,,12,9,21
084 St.Pankraz,20,,6,7,13
084 St.Pankraz,21,,15,11,26
084 St.Pankraz,22,,8,16,24
084 St.Pankraz,23,,6,9,15
084 St.Pankraz,24,,10,9,19
084 St.Pankraz,25,,14,14,28
084 St.Pankraz,26,,13,10,23
084 St.Pankraz,27,,13,14,27
084 St.Pankraz,28,,17,11,28
084 St.Pankraz,29,,13,9,22
084 St.Pankraz,30,,20,15,35
084 St.Pankraz,31,,22,17,39
084 St.Pankraz,32,,12,15,27
084 St.Pankraz,33,,16,8,24
084 St.Pankraz,34,,23,16,39
084 St.Pankraz,35,,14,15,29
084 St.Pankraz,36,,11,10,21
084 St.Pankraz,37,,17,8,25
084 St.Pankraz,38,,13,12,25
084 St.Pankraz,39,,12,6,18
084 St.Pankraz,40,,18,13,31
084 St.Pankraz,41,,7,9,16
084 St.Pankraz,42,,12,9,21
084 St.Pankraz,43,,10,16,26
084 St.Pankraz,44,,7,5,12
084 St.Pankraz,45,,10,8,18
084 St.Pankraz,46,,10,9,19
084 St.Pankraz,47,,16,10,26
084 St.Pankraz,48,,5,3,8
084 St.Pankraz,49,,12,7,19
084 St.Pankraz,50,,7,6,13
084 St.Pankraz,51,,7,4,11
084 St.Pankraz,52,,7,8,15
084 St.Pankraz,53,,5,9,14
084 St.Pankraz,54,,3,6,9
084 St.Pankraz,55,,5,8,13
084 St.Pankraz,56,,10,15,25
084 St.Pankraz,57,,9,13,22
084 St.Pankraz,58,,9,11,20
084 St.Pankraz,59,,9,7,16
084 St.Pankraz,60,,11,7,18
084 St.Pankraz,61,,5,11,16
084 St.Pankraz,62,,8,10,18
084 St.Pankraz,63,,7,5,12
084 St.Pankraz,64,,5,8,13
084 St.Pankraz,65,,9,7,16
084 St.Pankraz,66,,7,3,10
084 St.Pankraz,67,,8,10,18
084 St.Pankraz,68,,9,5,14
084 St.Pankraz,69,,8,7,15
084 St.Pankraz,70,,11,9,20
084 St.Pankraz,71,,8,10,18
084 St.Pankraz,72,,7,5,12
084 St.Pankraz,73,,8,7,15
084 St.Pankraz,74,,7,8,15
084 St.Pankraz,75,,7,11,18
084 St.Pankraz,76,,11,4,15
084 St.Pankraz,77,,10,8,18
084 St.Pankraz,78,,2,12,14
084 St.Pankraz,79,,2,10,12
084 St.Pankraz,80,,3,3,6
084 St.Pankraz,81,,3,5,8
084 St.Pankraz,82,,1,3,4
084 St.Pankraz,83,,3,-,3
084 St.Pankraz,84,,3,3,6
084 St.Pankraz,85,,1,3,4
084 St.Pankraz,86,,1,1,2
084 St.Pankraz,87,,1,2,3
084 St.Pankraz,88,,1,1,2
084 St.Pankraz,89,,1,2,3
084 St.Pankraz,90,,2,5,7
084 St.Pankraz,91,,-,2,2
084 St.Pankraz,94,,-,1,1
084 St.Pankraz,95,,1,1,2
084 St.Pankraz,101,,-,2,2
085 St.Christina in Gröden,0,,25,12,37
085 St.Christina in Gröden,1,,13,17,30
085 St.Christina in Gröden,2,,12,11,23
085 St.Christina in Gröden,3,,13,9,22
085 St.Christina in Gröden,4,,14,10,24
085 St.Christina in Gröden,5,,8,14,22
085 St.Christina in Gröden,6,,13,13,26
085 St.Christina in Gröden,7,,13,14,27
085 St.Christina in Gröden,8,,12,16,28
085 St.Christina in Gröden,9,,7,14,21
085 St.Christina in Gröden,10,,6,6,12
085 St.Christina in Gröden,11,,11,10,21
085 St.Christina in Gröden,12,,12,6,18
085 St.Christina in Gröden,13,,11,8,19
085 St.Christina in Gröden,14,,5,11,16
085 St.Christina in Gröden,15,,10,5,15
085 St.Christina in Gröden,16,,18,12,30
085 St.Christina in Gröden,17,,12,5,17
085 St.Christina in Gröden,18,,8,13,21
085 St.Christina in Gröden,19,,10,12,22
085 St.Christina in Gröden,20,,12,10,22
085 St.Christina in Gröden,21,,6,9,15
085 St.Christina in Gröden,22,,3,7,10
085 St.Christina in Gröden,23,,13,13,26
085 St.Christina in Gröden,24,,13,12,25
085 St.Christina in Gröden,25,,5,17,22
085 St.Christina in Gröden,26,,7,14,21
085 St.Christina in Gröden,27,,19,13,32
085 St.Christina in Gröden,28,,8,15,23
085 St.Christina in Gröden,29,,24,20,44
085 St.Christina in Gröden,30,,16,11,27
085 St.Christina in Gröden,31,,24,23,47
085 St.Christina in Gröden,32,,15,18,33
085 St.Christina in Gröden,33,,19,16,35
085 St.Christina in Gröden,34,,14,19,33
085 St.Christina in Gröden,35,,12,20,32
085 St.Christina in Gröden,36,,15,16,31
085 St.Christina in Gröden,37,,21,18,39
085 St.Christina in Gröden,38,,20,15,35
085 St.Christina in Gröden,39,,19,18,37
085 St.Christina in Gröden,40,,10,10,20
085 St.Christina in Gröden,41,,7,12,19
085 St.Christina in Gröden,42,,17,11,28
085 St.Christina in Gröden,43,,10,10,20
085 St.Christina in Gröden,44,,9,9,18
085 St.Christina in Gröden,45,,16,14,30
085 St.Christina in Gröden,46,,9,9,18
085 St.Christina in Gröden,47,,6,6,12
085 St.Christina in Gröden,48,,11,5,16
085 St.Christina in Gröden,49,,6,6,12
085 St.Christina in Gröden,50,,7,11,18
085 St.Christina in Gröden,51,,8,6,14
085 St.Christina in Gröden,52,,6,9,15
085 St.Christina in Gröden,53,,9,13,22
085 St.Christina in Gröden,54,,6,6,12
085 St.Christina in Gröden,55,,6,11,17
085 St.Christina in Gröden,56,,13,15,28
085 St.Christina in Gröden,57,,10,7,17
085 St.Christina in Gröden,58,,13,7,20
085 St.Christina in Gröden,59,,10,11,21
085 St.Christina in Gröden,60,,10,11,21
085 St.Christina in Gröden,61,,7,9,16
085 St.Christina in Gröden,62,,9,7,16
085 St.Christina in Gröden,63,,14,11,25
085 St.Christina in Gröden,64,,13,6,19
085 St.Christina in Gröden,65,,8,12,20
085 St.Christina in Gröden,66,,6,14,20
085 St.Christina in Gröden,67,,9,10,19
085 St.Christina in Gröden,68,,5,7,12
085 St.Christina in Gröden,69,,14,5,19
085 St.Christina in Gröden,70,,5,10,15
085 St.Christina in Gröden,71,,6,5,11
085 St.Christina in Gröden,72,,5,6,11
085 St.Christina in Gröden,73,,9,7,16
085 St.Christina in Gröden,74,,7,9,16
085 St.Christina in Gröden,75,,3,4,7
085 St.Christina in Gröden,76,,5,4,9
085 St.Christina in Gröden,77,,-,10,10
085 St.Christina in Gröden,78,,4,4,8
085 St.Christina in Gröden,79,,4,5,9
085 St.Christina in Gröden,80,,4,1,5
085 St.Christina in Gröden,81,,-,1,1
085 St.Christina in Gröden,82,,1,-,1
085 St.Christina in Gröden,83,,-,3,3
085 St.Christina in Gröden,84,,3,1,4
085 St.Christina in Gröden,85,,1,4,5
085 St.Christina in Gröden,86,,4,-,4
085 St.Christina in Gröden,87,,1,2,3
085 St.Christina in Gröden,88,,-,1,1
085 St.Christina in Gröden,89,,-,2,2
085 St.Christina in Gröden,90,,2,2,4
085 St.Christina in Gröden,92,,1,2,3
085 St.Christina in Gröden,95,,-,1,1
086 Sarntal,0,,39,36,75
086 Sarntal,1,,54,47,101
086 Sarntal,2,,44,46,90
086 Sarntal,3,,51,40,91
086 Sarntal,4,,42,42,84
086 Sarntal,5,,34,42,76
086 Sarntal,6,,34,39,73
086 Sarntal,7,,47,35,82
086 Sarntal,8,,43,42,85
086 Sarntal,9,,45,33,78
086 Sarntal,10,,53,36,89
086 Sarntal,11,,45,43,88
086 Sarntal,12,,36,32,68
086 Sarntal,13,,39,43,82
086 Sarntal,14,,43,39,82
086 Sarntal,15,,39,43,82
086 Sarntal,16,,51,42,93
086 Sarntal,17,,62,51,113
086 Sarntal,18,,42,59,101
086 Sarntal,19,,59,48,107
086 Sarntal,20,,56,50,106
086 Sarntal,21,,55,53,108
086 Sarntal,22,,60,43,103
086 Sarntal,23,,51,42,93
086 Sarntal,24,,65,51,116
086 Sarntal,25,,51,66,117
086 Sarntal,26,,62,62,124
086 Sarntal,27,,71,40,111
086 Sarntal,28,,50,50,100
086 Sarntal,29,,62,61,123
086 Sarntal,30,,70,59,129
086 Sarntal,31,,53,46,99
086 Sarntal,32,,55,48,103
086 Sarntal,33,,51,53,104
086 Sarntal,34,,66,51,117
086 Sarntal,35,,64,61,125
086 Sarntal,36,,46,46,92
086 Sarntal,37,,62,33,95
086 Sarntal,38,,40,48,88
086 Sarntal,39,,64,46,110
086 Sarntal,40,,45,39,84
086 Sarntal,41,,54,44,98
086 Sarntal,42,,39,44,83
086 Sarntal,43,,43,31,74
086 Sarntal,44,,41,39,80
086 Sarntal,45,,37,29,66
086 Sarntal,46,,43,31,74
086 Sarntal,47,,38,41,79
086 Sarntal,48,,45,33,78
086 Sarntal,49,,38,36,74
086 Sarntal,50,,51,25,76
086 Sarntal,51,,35,38,73
086 Sarntal,52,,40,28,68
086 Sarntal,53,,37,38,75
086 Sarntal,54,,30,31,61
086 Sarntal,55,,27,31,58
086 Sarntal,56,,42,42,84
086 Sarntal,57,,41,39,80
086 Sarntal,58,,35,34,69
086 Sarntal,59,,31,44,75
086 Sarntal,60,,38,32,70
086 Sarntal,61,,36,28,64
086 Sarntal,62,,26,34,60
086 Sarntal,63,,22,25,47
086 Sarntal,64,,26,25,51
086 Sarntal,65,,28,20,48
086 Sarntal,66,,24,24,48
086 Sarntal,67,,31,27,58
086 Sarntal,68,,20,25,45
086 Sarntal,69,,22,26,48
086 Sarntal,70,,20,30,50
086 Sarntal,71,,25,29,54
086 Sarntal,72,,19,33,52
086 Sarntal,73,,23,15,38
086 Sarntal,74,,22,25,47
086 Sarntal,75,,16,29,45
086 Sarntal,76,,12,25,37
086 Sarntal,77,,16,32,48
086 Sarntal,78,,9,17,26
086 Sarntal,79,,12,19,31
086 Sarntal,80,,4,20,24
086 Sarntal,81,,6,13,19
086 Sarntal,82,,3,10,13
086 Sarntal,83,,2,10,12
086 Sarntal,84,,3,7,10
086 Sarntal,85,,8,8,16
086 Sarntal,86,,10,13,23
086 Sarntal,87,,5,12,17
086 Sarntal,88,,6,9,15
086 Sarntal,89,,2,12,14
086 Sarntal,90,,3,6,9
086 Sarntal,91,,1,4,5
086 Sarntal,92,,2,6,8
086 Sarntal,93,,2,2,4
086 Sarntal,94,,1,1,2
086 Sarntal,95,,-,2,2
086 Sarntal,98,,-,2,2
087 Schenna,0,,21,17,38
087 Schenna,1,,18,11,29
087 Schenna,2,,15,17,32
087 Schenna,3,,18,18,36
087 Schenna,4,,18,17,35
087 Schenna,5,,21,17,38
087 Schenna,6,,15,9,24
087 Schenna,7,,16,16,32
087 Schenna,8,,12,19,31
087 Schenna,9,,19,15,34
087 Schenna,10,,20,9,29
087 Schenna,11,,21,19,40
087 Schenna,12,,22,17,39
087 Schenna,13,,18,13,31
087 Schenna,14,,15,17,32
087 Schenna,15,,16,13,29
087 Schenna,16,,16,14,30
087 Schenna,17,,11,17,28
087 Schenna,18,,24,9,33
087 Schenna,19,,19,19,38
087 Schenna,20,,24,22,46
087 Schenna,21,,15,20,35
087 Schenna,22,,18,20,38
087 Schenna,23,,23,18,41
087 Schenna,24,,17,25,42
087 Schenna,25,,31,24,55
087 Schenna,26,,27,21,48
087 Schenna,27,,26,17,43
087 Schenna,28,,30,26,56
087 Schenna,29,,22,26,48
087 Schenna,30,,25,20,45
087 Schenna,31,,21,24,45
087 Schenna,32,,35,21,56
087 Schenna,33,,13,19,32
087 Schenna,34,,24,29,53
087 Schenna,35,,22,22,44
087 Schenna,36,,29,20,49
087 Schenna,37,,23,13,36
087 Schenna,38,,26,19,45
087 Schenna,39,,34,23,57
087 Schenna,40,,15,15,30
087 Schenna,41,,21,18,39
087 Schenna,42,,11,20,31
087 Schenna,43,,17,16,33
087 Schenna,44,,12,15,27
087 Schenna,45,,15,18,33
087 Schenna,46,,16,16,32
087 Schenna,47,,15,16,31
087 Schenna,48,,14,13,27
087 Schenna,49,,20,15,35
087 Schenna,50,,20,20,40
087 Schenna,51,,16,15,31
087 Schenna,52,,15,17,32
087 Schenna,53,,18,23,41
087 Schenna,54,,14,13,27
087 Schenna,55,,17,10,27
087 Schenna,56,,22,10,32
087 Schenna,57,,12,19,31
087 Schenna,58,,13,13,26
087 Schenna,59,,10,8,18
087 Schenna,60,,12,14,26
087 Schenna,61,,16,19,35
087 Schenna,62,,7,10,17
087 Schenna,63,,9,11,20
087 Schenna,64,,13,8,21
087 Schenna,65,,13,15,28
087 Schenna,66,,6,9,15
087 Schenna,67,,11,13,24
087 Schenna,68,,13,13,26
087 Schenna,69,,12,10,22
087 Schenna,70,,9,12,21
087 Schenna,71,,6,10,16
087 Schenna,72,,5,15,20
087 Schenna,73,,7,7,14
087 Schenna,74,,5,12,17
087 Schenna,75,,10,8,18
087 Schenna,76,,6,5,11
087 Schenna,77,,9,6,15
087 Schenna,78,,7,15,22
087 Schenna,79,,7,4,11
087 Schenna,80,,3,7,10
087 Schenna,81,,2,5,7
087 Schenna,82,,1,5,6
087 Schenna,83,,2,1,3
087 Schenna,84,,3,3,6
087 Schenna,85,,3,5,8
087 Schenna,86,,1,3,4
087 Schenna,87,,4,2,6
087 Schenna,89,,1,2,3
087 Schenna,90,,2,2,4
087 Schenna,91,,-,2,2
087 Schenna,92,,-,1,1
087 Schenna,93,,-,1,1
087 Schenna,95,,-,1,1
087 Schenna,99,,-,1,1
088 Mühlwald,0,,12,10,22
088 Mühlwald,1,,11,13,24
088 Mühlwald,2,,10,8,18
088 Mühlwald,3,,14,13,27
088 Mühlwald,4,,12,4,16
088 Mühlwald,5,,9,6,15
088 Mühlwald,6,,13,12,25
088 Mühlwald,7,,5,6,11
088 Mühlwald,8,,11,7,18
088 Mühlwald,9,,9,6,15
088 Mühlwald,10,,17,8,25
088 Mühlwald,11,,7,3,10
088 Mühlwald,12,,9,14,23
088 Mühlwald,13,,6,7,13
088 Mühlwald,14,,11,18,29
088 Mühlwald,15,,11,19,30
088 Mühlwald,16,,12,10,22
088 Mühlwald,17,,8,17,25
088 Mühlwald,18,,16,14,30
088 Mühlwald,19,,21,5,26
088 Mühlwald,20,,8,20,28
088 Mühlwald,21,,12,14,26
088 Mühlwald,22,,8,9,17
088 Mühlwald,23,,15,12,27
088 Mühlwald,24,,11,10,21
088 Mühlwald,25,,10,9,19
088 Mühlwald,26,,16,9,25
088 Mühlwald,27,,10,11,21
088 Mühlwald,28,,19,14,33
088 Mühlwald,29,,11,9,20
088 Mühlwald,30,,16,17,33
088 Mühlwald,31,,17,9,26
088 Mühlwald,32,,17,14,31
088 Mühlwald,33,,16,8,24
088 Mühlwald,34,,18,12,30
088 Mühlwald,35,,16,8,24
088 Mühlwald,36,,11,10,21
088 Mühlwald,37,,9,12,21
088 Mühlwald,38,,6,10,16
088 Mühlwald,39,,15,9,24
088 Mühlwald,40,,14,5,19
088 Mühlwald,41,,10,7,17
088 Mühlwald,42,,14,12,26
088 Mühlwald,43,,7,8,15
088 Mühlwald,44,,7,7,14
088 Mühlwald,45,,10,4,14
088 Mühlwald,46,,12,9,21
088 Mühlwald,47,,10,8,18
088 Mühlwald,48,,10,4,14
088 Mühlwald,49,,5,9,14
088 Mühlwald,50,,9,3,12
088 Mühlwald,51,,12,4,16
088 Mühlwald,52,,10,7,17
088 Mühlwald,53,,9,3,12
088 Mühlwald,54,,5,4,9
088 Mühlwald,55,,8,4,12
088 Mühlwald,56,,10,2,12
088 Mühlwald,57,,6,7,13
088 Mühlwald,58,,4,8,12
088 Mühlwald,59,,3,8,11
088 Mühlwald,60,,6,11,17
088 Mühlwald,61,,9,4,13
088 Mühlwald,62,,11,3,14
088 Mühlwald,63,,4,3,7
088 Mühlwald,64,,5,4,9
088 Mühlwald,65,,3,10,13
088 Mühlwald,66,,4,10,14
088 Mühlwald,67,,1,2,3
088 Mühlwald,68,,7,6,13
088 Mühlwald,69,,5,6,11
088 Mühlwald,70,,9,9,18
088 Mühlwald,71,,4,4,8
088 Mühlwald,72,,10,3,13
088 Mühlwald,73,,4,6,10
088 Mühlwald,74,,4,4,8
088 Mühlwald,75,,7,5,12
088 Mühlwald,76,,1,6,7
088 Mühlwald,77,,1,5,6
088 Mühlwald,78,,-,6,6
088 Mühlwald,79,,2,2,4
088 Mühlwald,80,,-,2,2
088 Mühlwald,81,,1,3,4
088 Mühlwald,82,,4,2,6
088 Mühlwald,83,,-,1,1
088 Mühlwald,84,,-,3,3
088 Mühlwald,85,,1,3,4
088 Mühlwald,86,,-,2,2
088 Mühlwald,88,,1,2,3
088 Mühlwald,91,,1,-,1
088 Mühlwald,92,,1,-,1
088 Mühlwald,93,,-,2,2
089 Wolkenstein in Gröden,0,,15,20,35
089 Wolkenstein in Gröden,1,,16,22,38
089 Wolkenstein in Gröden,2,,23,28,51
089 Wolkenstein in Gröden,3,,14,12,26
089 Wolkenstein in Gröden,4,,17,11,28
089 Wolkenstein in Gröden,5,,16,17,33
089 Wolkenstein in Gröden,6,,12,13,25
089 Wolkenstein in Gröden,7,,24,12,36
089 Wolkenstein in Gröden,8,,18,15,33
089 Wolkenstein in Gröden,9,,12,12,24
089 Wolkenstein in Gröden,10,,18,14,32
089 Wolkenstein in Gröden,11,,15,16,31
089 Wolkenstein in Gröden,12,,12,19,31
089 Wolkenstein in Gröden,13,,16,14,30
089 Wolkenstein in Gröden,14,,16,10,26
089 Wolkenstein in Gröden,15,,12,11,23
089 Wolkenstein in Gröden,16,,17,9,26
089 Wolkenstein in Gröden,17,,11,17,28
089 Wolkenstein in Gröden,18,,16,12,28
089 Wolkenstein in Gröden,19,,15,16,31
089 Wolkenstein in Gröden,20,,6,14,20
089 Wolkenstein in Gröden,21,,8,12,20
089 Wolkenstein in Gröden,22,,12,13,25
089 Wolkenstein in Gröden,23,,18,19,37
089 Wolkenstein in Gröden,24,,21,21,42
089 Wolkenstein in Gröden,25,,12,17,29
089 Wolkenstein in Gröden,26,,28,23,51
089 Wolkenstein in Gröden,27,,14,15,29
089 Wolkenstein in Gröden,28,,20,26,46
089 Wolkenstein in Gröden,29,,19,24,43
089 Wolkenstein in Gröden,30,,26,20,46
089 Wolkenstein in Gröden,31,,28,24,52
089 Wolkenstein in Gröden,32,,34,25,59
089 Wolkenstein in Gröden,33,,28,21,49
089 Wolkenstein in Gröden,34,,23,30,53
089 Wolkenstein in Gröden,35,,29,22,51
089 Wolkenstein in Gröden,36,,22,19,41
089 Wolkenstein in Gröden,37,,20,24,44
089 Wolkenstein in Gröden,38,,27,27,54
089 Wolkenstein in Gröden,39,,22,23,45
089 Wolkenstein in Gröden,40,,16,17,33
089 Wolkenstein in Gröden,41,,20,17,37
089 Wolkenstein in Gröden,42,,19,16,35
089 Wolkenstein in Gröden,43,,12,13,25
089 Wolkenstein in Gröden,44,,15,11,26
089 Wolkenstein in Gröden,45,,17,10,27
089 Wolkenstein in Gröden,46,,8,14,22
089 Wolkenstein in Gröden,47,,12,6,18
089 Wolkenstein in Gröden,48,,15,11,26
089 Wolkenstein in Gröden,49,,7,17,24
089 Wolkenstein in Gröden,50,,17,12,29
089 Wolkenstein in Gröden,51,,14,14,28
089 Wolkenstein in Gröden,52,,12,17,29
089 Wolkenstein in Gröden,53,,16,19,35
089 Wolkenstein in Gröden,54,,6,14,20
089 Wolkenstein in Gröden,55,,14,11,25
089 Wolkenstein in Gröden,56,,21,16,37
089 Wolkenstein in Gröden,57,,14,13,27
089 Wolkenstein in Gröden,58,,18,19,37
089 Wolkenstein in Gröden,59,,18,18,36
089 Wolkenstein in Gröden,60,,20,17,37
089 Wolkenstein in Gröden,61,,21,7,28
089 Wolkenstein in Gröden,62,,12,19,31
089 Wolkenstein in Gröden,63,,10,15,25
089 Wolkenstein in Gröden,64,,14,10,24
089 Wolkenstein in Gröden,65,,17,10,27
089 Wolkenstein in Gröden,66,,7,11,18
089 Wolkenstein in Gröden,67,,6,10,16
089 Wolkenstein in Gröden,68,,10,10,20
089 Wolkenstein in Gröden,69,,10,12,22
089 Wolkenstein in Gröden,70,,9,7,16
089 Wolkenstein in Gröden,71,,7,11,18
089 Wolkenstein in Gröden,72,,11,8,19
089 Wolkenstein in Gröden,73,,9,6,15
089 Wolkenstein in Gröden,74,,7,7,14
089 Wolkenstein in Gröden,75,,3,13,16
089 Wolkenstein in Gröden,76,,6,6,12
089 Wolkenstein in Gröden,77,,6,10,16
089 Wolkenstein in Gröden,78,,2,6,8
089 Wolkenstein in Gröden,79,,3,4,7
089 Wolkenstein in Gröden,80,,1,3,4
089 Wolkenstein in Gröden,81,,-,2,2
089 Wolkenstein in Gröden,82,,1,4,5
089 Wolkenstein in Gröden,83,,-,3,3
089 Wolkenstein in Gröden,84,,-,4,4
089 Wolkenstein in Gröden,85,,2,3,5
089 Wolkenstein in Gröden,86,,1,2,3
089 Wolkenstein in Gröden,87,,1,6,7
089 Wolkenstein in Gröden,88,,1,5,6
089 Wolkenstein in Gröden,89,,2,2,4
089 Wolkenstein in Gröden,90,,2,2,4
089 Wolkenstein in Gröden,91,,1,3,4
089 Wolkenstein in Gröden,92,,-,1,1
089 Wolkenstein in Gröden,94,,1,1,2
089 Wolkenstein in Gröden,95,,-,2,2
089 Wolkenstein in Gröden,96,,-,1,1
091 Schnals,0,,7,8,15
091 Schnals,1,,6,16,22
091 Schnals,2,,12,8,20
091 Schnals,3,,6,13,19
091 Schnals,4,,4,9,13
091 Schnals,5,,4,7,11
091 Schnals,6,,11,4,15
091 Schnals,7,,13,10,23
091 Schnals,8,,13,9,22
091 Schnals,9,,5,7,12
091 Schnals,10,,20,9,29
091 Schnals,11,,10,5,15
091 Schnals,12,,12,11,23
091 Schnals,13,,10,10,20
091 Schnals,14,,7,9,16
091 Schnals,15,,12,16,28
091 Schnals,16,,10,10,20
091 Schnals,17,,12,8,20
091 Schnals,18,,16,10,26
091 Schnals,19,,14,13,27
091 Schnals,20,,12,10,22
091 Schnals,21,,13,8,21
091 Schnals,22,,8,8,16
091 Schnals,23,,13,3,16
091 Schnals,24,,7,9,16
091 Schnals,25,,15,7,22
091 Schnals,26,,8,10,18
091 Schnals,27,,9,9,18
091 Schnals,28,,11,11,22
091 Schnals,29,,11,11,22
091 Schnals,30,,15,9,24
091 Schnals,31,,10,10,20
091 Schnals,32,,17,10,27
091 Schnals,33,,16,13,29
091 Schnals,34,,18,7,25
091 Schnals,35,,6,8,14
091 Schnals,36,,11,13,24
091 Schnals,37,,16,12,28
091 Schnals,38,,10,14,24
091 Schnals,39,,9,8,17
091 Schnals,40,,15,12,27
091 Schnals,41,,14,12,26
091 Schnals,42,,11,5,16
091 Schnals,43,,14,6,20
091 Schnals,44,,11,6,17
091 Schnals,45,,10,9,19
091 Schnals,46,,12,8,20
091 Schnals,47,,12,7,19
091 Schnals,48,,12,8,20
091 Schnals,49,,11,6,17
091 Schnals,50,,10,10,20
091 Schnals,51,,3,2,5
091 Schnals,52,,11,8,19
091 Schnals,53,,5,6,11
091 Schnals,54,,9,4,13
091 Schnals,55,,4,7,11
091 Schnals,56,,7,10,17
091 Schnals,57,,4,4,8
091 Schnals,58,,5,5,10
091 Schnals,59,,7,7,14
091 Schnals,60,,7,7,14
091 Schnals,61,,2,11,13
091 Schnals,62,,7,5,12
091 Schnals,63,,6,6,12
091 Schnals,64,,4,5,9
091 Schnals,65,,2,4,6
091 Schnals,66,,7,4,11
091 Schnals,67,,3,10,13
091 Schnals,68,,3,5,8
091 Schnals,69,,1,5,6
091 Schnals,70,,8,6,14
091 Schnals,71,,2,7,9
091 Schnals,72,,3,7,10
091 Schnals,73,,9,3,12
091 Schnals,74,,7,10,17
091 Schnals,75,,4,7,11
091 Schnals,76,,1,2,3
091 Schnals,77,,8,4,12
091 Schnals,78,,1,6,7
091 Schnals,79,,2,6,8
091 Schnals,80,,2,1,3
091 Schnals,81,,3,3,6
091 Schnals,82,,-,4,4
091 Schnals,83,,1,2,3
091 Schnals,84,,4,2,6
091 Schnals,85,,1,2,3
091 Schnals,86,,-,2,2
091 Schnals,87,,2,2,4
091 Schnals,88,,-,2,2
091 Schnals,89,,-,2,2
091 Schnals,90,,-,2,2
091 Schnals,94,,-,1,1
091 Schnals,96,,-,1,1
091 Schnals,97,,1,-,1
092 Sexten,0,,9,15,24
092 Sexten,1,,11,8,19
092 Sexten,2,,12,11,23
092 Sexten,3,,13,12,25
092 Sexten,4,,14,15,29
092 Sexten,5,,15,11,26
092 Sexten,6,,8,5,13
092 Sexten,7,,15,10,25
092 Sexten,8,,13,11,24
092 Sexten,9,,10,19,29
092 Sexten,10,,10,9,19
092 Sexten,11,,9,6,15
092 Sexten,12,,13,9,22
092 Sexten,13,,7,9,16
092 Sexten,14,,12,11,23
092 Sexten,15,,7,12,19
092 Sexten,16,,11,9,20
092 Sexten,17,,11,19,30
092 Sexten,18,,15,13,28
092 Sexten,19,,16,8,24
092 Sexten,20,,11,19,30
092 Sexten,21,,9,14,23
092 Sexten,22,,10,7,17
092 Sexten,23,,18,12,30
092 Sexten,24,,10,10,20
092 Sexten,25,,8,8,16
092 Sexten,26,,10,8,18
092 Sexten,27,,15,12,27
092 Sexten,28,,14,21,35
092 Sexten,29,,14,22,36
092 Sexten,30,,23,17,40
092 Sexten,31,,20,18,38
092 Sexten,32,,23,18,41
092 Sexten,33,,17,19,36
092 Sexten,34,,21,18,39
092 Sexten,35,,20,17,37
092 Sexten,36,,30,17,47
092 Sexten,37,,15,15,30
092 Sexten,38,,20,14,34
092 Sexten,39,,19,10,29
092 Sexten,40,,17,16,33
092 Sexten,41,,22,17,39
092 Sexten,42,,16,13,29
092 Sexten,43,,14,14,28
092 Sexten,44,,13,13,26
092 Sexten,45,,11,11,22
092 Sexten,46,,6,11,17
092 Sexten,47,,6,11,17
092 Sexten,48,,7,8,15
092 Sexten,49,,13,7,20
092 Sexten,50,,8,6,14
092 Sexten,51,,10,6,16
092 Sexten,52,,13,4,17
092 Sexten,53,,6,9,15
092 Sexten,54,,9,4,13
092 Sexten,55,,7,12,19
092 Sexten,56,,8,6,14
092 Sexten,57,,5,7,12
092 Sexten,58,,10,15,25
092 Sexten,59,,8,14,22
092 Sexten,60,,7,10,17
092 Sexten,61,,14,12,26
092 Sexten,62,,12,9,21
092 Sexten,63,,9,11,20
092 Sexten,64,,12,15,27
092 Sexten,65,,12,7,19
092 Sexten,66,,5,11,16
092 Sexten,67,,7,8,15
092 Sexten,68,,12,14,26
092 Sexten,69,,10,12,22
092 Sexten,70,,8,13,21
092 Sexten,71,,11,13,24
092 Sexten,72,,12,18,30
092 Sexten,73,,7,4,11
092 Sexten,74,,10,12,22
092 Sexten,75,,6,9,15
092 Sexten,76,,7,10,17
092 Sexten,77,,8,12,20
092 Sexten,78,,4,9,13
092 Sexten,79,,2,5,7
092 Sexten,80,,3,4,7
092 Sexten,81,,-,1,1
092 Sexten,82,,1,2,3
092 Sexten,83,,-,2,2
092 Sexten,84,,1,-,1
092 Sexten,85,,2,2,4
092 Sexten,86,,-,6,6
092 Sexten,87,,2,5,7
092 Sexten,88,,-,1,1
092 Sexten,89,,-,1,1
092 Sexten,90,,-,1,1
092 Sexten,91,,-,3,3
092 Sexten,93,,-,1,1
092 Sexten,94,,-,1,1
092 Sexten,96,,-,1,1
092 Sexten,101,,-,1,1
093 Schlanders,0,,36,39,75
093 Schlanders,1,,41,36,77
093 Schlanders,2,,54,49,103
093 Schlanders,3,,48,38,86
093 Schlanders,4,,34,26,60
093 Schlanders,5,,41,36,77
093 Schlanders,6,,40,45,85
093 Schlanders,7,,33,40,73
093 Schlanders,8,,39,37,76
093 Schlanders,9,,50,41,91
093 Schlanders,10,,37,35,72
093 Schlanders,11,,33,44,77
093 Schlanders,12,,37,29,66
093 Schlanders,13,,36,34,70
093 Schlanders,14,,41,38,79
093 Schlanders,15,,38,37,75
093 Schlanders,16,,31,34,65
093 Schlanders,17,,53,39,92
093 Schlanders,18,,47,36,83
093 Schlanders,19,,34,35,69
093 Schlanders,20,,36,39,75
093 Schlanders,21,,51,30,81
093 Schlanders,22,,36,36,72
093 Schlanders,23,,38,28,66
093 Schlanders,24,,40,38,78
093 Schlanders,25,,48,43,91
093 Schlanders,26,,49,47,96
093 Schlanders,27,,52,39,91
093 Schlanders,28,,53,45,98
093 Schlanders,29,,42,46,88
093 Schlanders,30,,56,44,100
093 Schlanders,31,,51,41,92
093 Schlanders,32,,51,45,96
093 Schlanders,33,,53,53,106
093 Schlanders,34,,57,46,103
093 Schlanders,35,,47,42,89
093 Schlanders,36,,57,62,119
093 Schlanders,37,,56,45,101
093 Schlanders,38,,49,55,104
093 Schlanders,39,,51,45,96
093 Schlanders,40,,48,41,89
093 Schlanders,41,,51,55,106
093 Schlanders,42,,46,38,84
093 Schlanders,43,,28,34,62
093 Schlanders,44,,32,36,68
093 Schlanders,45,,31,33,64
093 Schlanders,46,,32,36,68
093 Schlanders,47,,31,24,55
093 Schlanders,48,,30,31,61
093 Schlanders,49,,25,32,57
093 Schlanders,50,,28,34,62
093 Schlanders,51,,35,27,62
093 Schlanders,52,,24,25,49
093 Schlanders,53,,31,21,52
093 Schlanders,54,,30,18,48
093 Schlanders,55,,29,33,62
093 Schlanders,56,,30,31,61
093 Schlanders,57,,39,37,76
093 Schlanders,58,,36,35,71
093 Schlanders,59,,28,28,56
093 Schlanders,60,,30,37,67
093 Schlanders,61,,20,20,40
093 Schlanders,62,,27,26,53
093 Schlanders,63,,22,27,49
093 Schlanders,64,,18,27,45
093 Schlanders,65,,24,26,50
093 Schlanders,66,,22,33,55
093 Schlanders,67,,23,19,42
093 Schlanders,68,,25,20,45
093 Schlanders,69,,25,30,55
093 Schlanders,70,,14,17,31
093 Schlanders,71,,20,24,44
093 Schlanders,72,,19,27,46
093 Schlanders,73,,17,27,44
093 Schlanders,74,,12,18,30
093 Schlanders,75,,17,19,36
093 Schlanders,76,,11,19,30
093 Schlanders,77,,10,17,27
093 Schlanders,78,,9,11,20
093 Schlanders,79,,4,23,27
093 Schlanders,80,,9,14,23
093 Schlanders,81,,9,18,27
093 Schlanders,82,,8,2,10
093 Schlanders,83,,4,10,14
093 Schlanders,84,,5,4,9
093 Schlanders,85,,7,15,22
093 Schlanders,86,,7,12,19
093 Schlanders,87,,7,12,19
093 Schlanders,88,,3,13,16
093 Schlanders,89,,2,7,9
093 Schlanders,90,,-,7,7
093 Schlanders,91,,1,5,6
093 Schlanders,92,,1,-,1
093 Schlanders,93,,1,5,6
093 Schlanders,94,,-,2,2
093 Schlanders,95,,-,2,2
093 Schlanders,96,,-,3,3
093 Schlanders,98,,-,1,1
094 Schluderns,0,,9,12,21
094 Schluderns,1,,6,8,14
094 Schluderns,2,,14,11,25
094 Schluderns,3,,11,17,28
094 Schluderns,4,,9,12,21
094 Schluderns,5,,16,20,36
094 Schluderns,6,,17,7,24
094 Schluderns,7,,8,8,16
094 Schluderns,8,,9,9,18
094 Schluderns,9,,21,7,28
094 Schluderns,10,,15,13,28
094 Schluderns,11,,11,13,24
094 Schluderns,12,,6,11,17
094 Schluderns,13,,13,21,34
094 Schluderns,14,,19,11,30
094 Schluderns,15,,17,14,31
094 Schluderns,16,,13,8,21
094 Schluderns,17,,10,12,22
094 Schluderns,18,,18,14,32
094 Schluderns,19,,8,7,15
094 Schluderns,20,,7,19,26
094 Schluderns,21,,12,13,25
094 Schluderns,22,,14,18,32
094 Schluderns,23,,9,15,24
094 Schluderns,24,,14,7,21
094 Schluderns,25,,17,11,28
094 Schluderns,26,,22,13,35
094 Schluderns,27,,13,13,26
094 Schluderns,28,,13,15,28
094 Schluderns,29,,10,14,24
094 Schluderns,30,,18,9,27
094 Schluderns,31,,19,15,34
094 Schluderns,32,,17,15,32
094 Schluderns,33,,16,19,35
094 Schluderns,34,,27,10,37
094 Schluderns,35,,26,12,38
094 Schluderns,36,,16,20,36
094 Schluderns,37,,13,22,35
094 Schluderns,38,,19,16,35
094 Schluderns,39,,10,8,18
094 Schluderns,40,,12,21,33
094 Schluderns,41,,9,12,21
094 Schluderns,42,,14,6,20
094 Schluderns,43,,13,17,30
094 Schluderns,44,,17,10,27
094 Schluderns,45,,13,7,20
094 Schluderns,46,,11,6,17
094 Schluderns,47,,8,5,13
094 Schluderns,48,,11,3,14
094 Schluderns,49,,7,14,21
094 Schluderns,50,,13,9,22
094 Schluderns,51,,12,8,20
094 Schluderns,52,,7,5,12
094 Schluderns,53,,8,9,17
094 Schluderns,54,,6,3,9
094 Schluderns,55,,4,12,16
094 Schluderns,56,,3,9,12
094 Schluderns,57,,7,8,15
094 Schluderns,58,,11,14,25
094 Schluderns,59,,8,5,13
094 Schluderns,60,,13,8,21
094 Schluderns,61,,9,10,19
094 Schluderns,62,,8,8,16
094 Schluderns,63,,4,7,11
094 Schluderns,64,,6,10,16
094 Schluderns,65,,11,11,22
094 Schluderns,66,,4,9,13
094 Schluderns,67,,11,9,20
094 Schluderns,68,,4,7,11
094 Schluderns,69,,7,10,17
094 Schluderns,70,,10,7,17
094 Schluderns,71,,7,10,17
094 Schluderns,72,,9,1,10
094 Schluderns,73,,4,14,18
094 Schluderns,74,,3,6,9
094 Schluderns,75,,3,5,8
094 Schluderns,76,,2,5,7
094 Schluderns,77,,8,6,14
094 Schluderns,78,,2,9,11
094 Schluderns,79,,1,3,4
094 Schluderns,80,,3,6,9
094 Schluderns,81,,3,1,4
094 Schluderns,82,,1,2,3
094 Schluderns,83,,3,4,7
094 Schluderns,84,,1,3,4
094 Schluderns,85,,2,5,7
094 Schluderns,86,,1,2,3
094 Schluderns,87,,1,5,6
094 Schluderns,88,,-,1,1
094 Schluderns,89,,-,1,1
094 Schluderns,90,,1,2,3
094 Schluderns,91,,1,1,2
094 Schluderns,92,,-,1,1
094 Schluderns,93,,-,1,1
094 Schluderns,94,,-,2,2
095 Stilfs,0,,3,5,8
095 Stilfs,1,,6,3,9
095 Stilfs,2,,9,11,20
095 Stilfs,3,,12,1,13
095 Stilfs,4,,6,7,13
095 Stilfs,5,,8,7,15
095 Stilfs,6,,5,16,21
095 Stilfs,7,,4,9,13
095 Stilfs,8,,13,5,18
095 Stilfs,9,,17,7,24
095 Stilfs,10,,10,6,16
095 Stilfs,11,,6,4,10
095 Stilfs,12,,6,6,12
095 Stilfs,13,,9,8,17
095 Stilfs,14,,12,5,17
095 Stilfs,15,,15,5,20
095 Stilfs,16,,8,7,15
095 Stilfs,17,,12,4,16
095 Stilfs,18,,10,3,13
095 Stilfs,19,,8,4,12
095 Stilfs,20,,5,8,13
095 Stilfs,21,,10,7,17
095 Stilfs,22,,10,13,23
095 Stilfs,23,,14,4,18
095 Stilfs,24,,11,10,21
095 Stilfs,25,,10,7,17
095 Stilfs,26,,3,20,23
095 Stilfs,27,,13,11,24
095 Stilfs,28,,15,12,27
095 Stilfs,29,,12,15,27
095 Stilfs,30,,12,13,25
095 Stilfs,31,,13,11,24
095 Stilfs,32,,12,9,21
095 Stilfs,33,,15,8,23
095 Stilfs,34,,11,10,21
095 Stilfs,35,,12,5,17
095 Stilfs,36,,9,5,14
095 Stilfs,37,,10,14,24
095 Stilfs,38,,10,3,13
095 Stilfs,39,,10,6,16
095 Stilfs,40,,9,8,17
095 Stilfs,41,,6,12,18
095 Stilfs,42,,9,6,15
095 Stilfs,43,,5,12,17
095 Stilfs,44,,5,4,9
095 Stilfs,45,,13,8,21
095 Stilfs,46,,11,5,16
095 Stilfs,47,,12,5,17
095 Stilfs,48,,14,10,24
095 Stilfs,49,,4,10,14
095 Stilfs,50,,8,3,11
095 Stilfs,51,,9,10,19
095 Stilfs,52,,5,5,10
095 Stilfs,53,,10,10,20
095 Stilfs,54,,2,4,6
095 Stilfs,55,,14,8,22
095 Stilfs,56,,8,8,16
095 Stilfs,57,,7,14,21
095 Stilfs,58,,9,4,13
095 Stilfs,59,,7,11,18
095 Stilfs,60,,6,12,18
095 Stilfs,61,,6,6,12
095 Stilfs,62,,7,6,13
095 Stilfs,63,,3,10,13
095 Stilfs,64,,3,9,12
095 Stilfs,65,,6,4,10
095 Stilfs,66,,4,6,10
095 Stilfs,67,,6,7,13
095 Stilfs,68,,5,4,9
095 Stilfs,69,,7,9,16
095 Stilfs,70,,6,1,7
095 Stilfs,71,,3,8,11
095 Stilfs,72,,6,8,14
095 Stilfs,73,,7,5,12
095 Stilfs,74,,7,3,10
095 Stilfs,75,,1,12,13
095 Stilfs,76,,5,5,10
095 Stilfs,77,,3,5,8
095 Stilfs,78,,2,6,8
095 Stilfs,79,,2,10,12
095 Stilfs,80,,4,1,5
095 Stilfs,81,,2,3,5
095 Stilfs,82,,-,3,3
095 Stilfs,83,,-,3,3
095 Stilfs,84,,1,2,3
095 Stilfs,85,,2,4,6
095 Stilfs,86,,-,1,1
095 Stilfs,87,,1,3,4
095 Stilfs,88,,-,3,3
095 Stilfs,89,,1,3,4
095 Stilfs,90,,-,3,3
095 Stilfs,91,,-,1,1
095 Stilfs,92,,-,1,1
095 Stilfs,93,,-,1,1
096 Terenten,0,,9,19,28
096 Terenten,1,,18,18,36
096 Terenten,2,,9,7,16
096 Terenten,3,,12,11,23
096 Terenten,4,,11,8,19
096 Terenten,5,,13,15,28
096 Terenten,6,,6,14,20
096 Terenten,7,,10,8,18
096 Terenten,8,,6,16,22
096 Terenten,9,,14,17,31
096 Terenten,10,,14,7,21
096 Terenten,11,,10,8,18
096 Terenten,12,,16,6,22
096 Terenten,13,,10,10,20
096 Terenten,14,,11,16,27
096 Terenten,15,,13,12,25
096 Terenten,16,,15,16,31
096 Terenten,17,,12,9,21
096 Terenten,18,,13,6,19
096 Terenten,19,,11,14,25
096 Terenten,20,,10,10,20
096 Terenten,21,,16,17,33
096 Terenten,22,,11,7,18
096 Terenten,23,,17,11,28
096 Terenten,24,,17,10,27
096 Terenten,25,,15,13,28
096 Terenten,26,,4,17,21
096 Terenten,27,,18,11,29
096 Terenten,28,,14,12,26
096 Terenten,29,,22,12,34
096 Terenten,30,,15,11,26
096 Terenten,31,,11,15,26
096 Terenten,32,,14,14,28
096 Terenten,33,,14,18,32
096 Terenten,34,,14,10,24
096 Terenten,35,,14,16,30
096 Terenten,36,,25,14,39
096 Terenten,37,,20,12,32
096 Terenten,38,,11,15,26
096 Terenten,39,,12,9,21
096 Terenten,40,,13,11,24
096 Terenten,41,,13,8,21
096 Terenten,42,,12,9,21
096 Terenten,43,,11,12,23
096 Terenten,44,,12,10,22
096 Terenten,45,,16,11,27
096 Terenten,46,,9,6,15
096 Terenten,47,,7,7,14
096 Terenten,48,,5,6,11
096 Terenten,49,,10,7,17
096 Terenten,50,,9,5,14
096 Terenten,51,,10,8,18
096 Terenten,52,,7,3,10
096 Terenten,53,,7,3,10
096 Terenten,54,,7,3,10
096 Terenten,55,,3,6,9
096 Terenten,56,,8,4,12
096 Terenten,57,,5,5,10
096 Terenten,58,,6,4,10
096 Terenten,59,,7,5,12
096 Terenten,60,,2,6,8
096 Terenten,61,,6,9,15
096 Terenten,62,,7,5,12
096 Terenten,63,,4,9,13
096 Terenten,64,,7,5,12
096 Terenten,65,,2,5,7
096 Terenten,66,,6,3,9
096 Terenten,67,,4,4,8
096 Terenten,68,,6,11,17
096 Terenten,69,,6,7,13
096 Terenten,70,,6,4,10
096 Terenten,71,,8,6,14
096 Terenten,72,,2,4,6
096 Terenten,73,,3,10,13
096 Terenten,74,,6,3,9
096 Terenten,75,,1,7,8
096 Terenten,76,,4,4,8
096 Terenten,77,,4,1,5
096 Terenten,78,,-,5,5
096 Terenten,79,,4,3,7
096 Terenten,80,,1,4,5
096 Terenten,81,,1,3,4
096 Terenten,82,,1,1,2
096 Terenten,83,,1,2,3
096 Terenten,84,,-,1,1
096 Terenten,85,,2,3,5
096 Terenten,86,,1,1,2
096 Terenten,87,,-,1,1
096 Terenten,89,,1,2,3
096 Terenten,90,,-,1,1
096 Terenten,91,,-,2,2
096 Terenten,92,,-,1,1
096 Terenten,93,,1,-,1
096 Terenten,94,,1,-,1
097 Terlan,0,,23,17,40
097 Terlan,1,,17,14,31
097 Terlan,2,,25,26,51
097 Terlan,3,,19,20,39
097 Terlan,4,,27,22,49
097 Terlan,5,,18,16,34
097 Terlan,6,,21,20,41
097 Terlan,7,,24,28,52
097 Terlan,8,,24,19,43
097 Terlan,9,,13,20,33
097 Terlan,10,,23,30,53
097 Terlan,11,,22,17,39
097 Terlan,12,,24,15,39
097 Terlan,13,,18,21,39
097 Terlan,14,,26,18,44
097 Terlan,15,,11,11,22
097 Terlan,16,,25,16,41
097 Terlan,17,,20,16,36
097 Terlan,18,,14,15,29
097 Terlan,19,,25,23,48
097 Terlan,20,,19,26,45
097 Terlan,21,,16,16,32
097 Terlan,22,,27,21,48
097 Terlan,23,,29,24,53
097 Terlan,24,,19,17,36
097 Terlan,25,,28,30,58
097 Terlan,26,,20,27,47
097 Terlan,27,,42,18,60
097 Terlan,28,,32,23,55
097 Terlan,29,,35,34,69
097 Terlan,30,,36,34,70
097 Terlan,31,,39,32,71
097 Terlan,32,,25,36,61
097 Terlan,33,,34,19,53
097 Terlan,34,,25,28,53
097 Terlan,35,,28,31,59
097 Terlan,36,,28,35,63
097 Terlan,37,,30,34,64
097 Terlan,38,,44,25,69
097 Terlan,39,,26,31,57
097 Terlan,40,,19,25,44
097 Terlan,41,,32,26,58
097 Terlan,42,,21,27,48
097 Terlan,43,,32,30,62
097 Terlan,44,,20,22,42
097 Terlan,45,,23,20,43
097 Terlan,46,,18,24,42
097 Terlan,47,,23,23,46
097 Terlan,48,,20,19,39
097 Terlan,49,,22,22,44
097 Terlan,50,,21,15,36
097 Terlan,51,,21,23,44
097 Terlan,52,,14,18,32
097 Terlan,53,,15,27,42
097 Terlan,54,,22,22,44
097 Terlan,55,,23,26,49
097 Terlan,56,,18,29,47
097 Terlan,57,,36,19,55
097 Terlan,58,,20,25,45
097 Terlan,59,,21,15,36
097 Terlan,60,,17,19,36
097 Terlan,61,,22,18,40
097 Terlan,62,,15,19,34
097 Terlan,63,,9,12,21
097 Terlan,64,,15,24,39
097 Terlan,65,,7,23,30
097 Terlan,66,,16,16,32
097 Terlan,67,,16,11,27
097 Terlan,68,,21,15,36
097 Terlan,69,,15,16,31
097 Terlan,70,,13,14,27
097 Terlan,71,,14,13,27
097 Terlan,72,,11,13,24
097 Terlan,73,,13,21,34
097 Terlan,74,,12,13,25
097 Terlan,75,,8,15,23
097 Terlan,76,,8,24,32
097 Terlan,77,,9,13,22
097 Terlan,78,,8,15,23
097 Terlan,79,,2,9,11
097 Terlan,80,,-,10,10
097 Terlan,81,,4,3,7
097 Terlan,82,,1,4,5
097 Terlan,83,,-,5,5
097 Terlan,84,,2,6,8
097 Terlan,85,,-,10,10
097 Terlan,86,,5,10,15
097 Terlan,87,,-,7,7
097 Terlan,88,,-,10,10
097 Terlan,89,,1,5,6
097 Terlan,90,,3,1,4
097 Terlan,91,,1,2,3
097 Terlan,92,,-,3,3
097 Terlan,93,,1,-,1
097 Terlan,94,,-,1,1
098 Tramin a.d. Weinstr.,0,,24,19,43
098 Tramin a.d. Weinstr.,1,,13,17,30
098 Tramin a.d. Weinstr.,2,,34,20,54
098 Tramin a.d. Weinstr.,3,,22,28,50
098 Tramin a.d. Weinstr.,4,,18,21,39
098 Tramin a.d. Weinstr.,5,,22,23,45
098 Tramin a.d. Weinstr.,6,,16,16,32
098 Tramin a.d. Weinstr.,7,,21,26,47
098 Tramin a.d. Weinstr.,8,,18,11,29
098 Tramin a.d. Weinstr.,9,,25,21,46
098 Tramin a.d. Weinstr.,10,,11,31,42
098 Tramin a.d. Weinstr.,11,,12,25,37
098 Tramin a.d. Weinstr.,12,,17,24,41
098 Tramin a.d. Weinstr.,13,,10,16,26
098 Tramin a.d. Weinstr.,14,,19,21,40
098 Tramin a.d. Weinstr.,15,,20,16,36
098 Tramin a.d. Weinstr.,16,,15,14,29
098 Tramin a.d. Weinstr.,17,,25,17,42
098 Tramin a.d. Weinstr.,18,,29,18,47
098 Tramin a.d. Weinstr.,19,,19,13,32
098 Tramin a.d. Weinstr.,20,,14,15,29
098 Tramin a.d. Weinstr.,21,,11,19,30
098 Tramin a.d. Weinstr.,22,,17,23,40
098 Tramin a.d. Weinstr.,23,,21,16,37
098 Tramin a.d. Weinstr.,24,,19,15,34
098 Tramin a.d. Weinstr.,25,,22,13,35
098 Tramin a.d. Weinstr.,26,,18,16,34
098 Tramin a.d. Weinstr.,27,,19,24,43
098 Tramin a.d. Weinstr.,28,,26,31,57
098 Tramin a.d. Weinstr.,29,,24,20,44
098 Tramin a.d. Weinstr.,30,,32,26,58
098 Tramin a.d. Weinstr.,31,,25,25,50
098 Tramin a.d. Weinstr.,32,,24,28,52
098 Tramin a.d. Weinstr.,33,,30,28,58
098 Tramin a.d. Weinstr.,34,,33,30,63
098 Tramin a.d. Weinstr.,35,,24,27,51
098 Tramin a.d. Weinstr.,36,,25,29,54
098 Tramin a.d. Weinstr.,37,,20,15,35
098 Tramin a.d. Weinstr.,38,,34,27,61
098 Tramin a.d. Weinstr.,39,,30,33,63
098 Tramin a.d. Weinstr.,40,,21,32,53
098 Tramin a.d. Weinstr.,41,,23,22,45
098 Tramin a.d. Weinstr.,42,,18,19,37
098 Tramin a.d. Weinstr.,43,,24,19,43
098 Tramin a.d. Weinstr.,44,,17,18,35
098 Tramin a.d. Weinstr.,45,,18,18,36
098 Tramin a.d. Weinstr.,46,,15,15,30
098 Tramin a.d. Weinstr.,47,,19,17,36
098 Tramin a.d. Weinstr.,48,,9,13,22
098 Tramin a.d. Weinstr.,49,,17,18,35
098 Tramin a.d. Weinstr.,50,,17,15,32
098 Tramin a.d. Weinstr.,51,,18,18,36
098 Tramin a.d. Weinstr.,52,,14,23,37
098 Tramin a.d. Weinstr.,53,,28,18,46
098 Tramin a.d. Weinstr.,54,,9,9,18
098 Tramin a.d. Weinstr.,55,,24,23,47
098 Tramin a.d. Weinstr.,56,,19,22,41
098 Tramin a.d. Weinstr.,57,,20,19,39
098 Tramin a.d. Weinstr.,58,,13,25,38
098 Tramin a.d. Weinstr.,59,,22,17,39
098 Tramin a.d. Weinstr.,60,,14,13,27
098 Tramin a.d. Weinstr.,61,,9,21,30
098 Tramin a.d. Weinstr.,62,,15,13,28
098 Tramin a.d. Weinstr.,63,,13,14,27
098 Tramin a.d. Weinstr.,64,,15,13,28
098 Tramin a.d. Weinstr.,65,,12,12,24
098 Tramin a.d. Weinstr.,66,,11,16,27
098 Tramin a.d. Weinstr.,67,,12,19,31
098 Tramin a.d. Weinstr.,68,,9,19,28
098 Tramin a.d. Weinstr.,69,,24,17,41
098 Tramin a.d. Weinstr.,70,,13,15,28
098 Tramin a.d. Weinstr.,71,,17,16,33
098 Tramin a.d. Weinstr.,72,,17,16,33
098 Tramin a.d. Weinstr.,73,,18,20,38
098 Tramin a.d. Weinstr.,74,,13,21,34
098 Tramin a.d. Weinstr.,75,,6,15,21
098 Tramin a.d. Weinstr.,76,,11,19,30
098 Tramin a.d. Weinstr.,77,,7,16,23
098 Tramin a.d. Weinstr.,78,,14,13,27
098 Tramin a.d. Weinstr.,79,,6,16,22
098 Tramin a.d. Weinstr.,80,,4,14,18
098 Tramin a.d. Weinstr.,81,,4,3,7
098 Tramin a.d. Weinstr.,82,,1,3,4
098 Tramin a.d. Weinstr.,83,,2,2,4
098 Tramin a.d. Weinstr.,84,,2,6,8
098 Tramin a.d. Weinstr.,85,,7,10,17
098 Tramin a.d. Weinstr.,86,,3,2,5
098 Tramin a.d. Weinstr.,87,,3,4,7
098 Tramin a.d. Weinstr.,88,,-,10,10
098 Tramin a.d. Weinstr.,89,,2,7,9
098 Tramin a.d. Weinstr.,90,,-,2,2
098 Tramin a.d. Weinstr.,91,,1,5,6
098 Tramin a.d. Weinstr.,92,,-,6,6
098 Tramin a.d. Weinstr.,93,,-,2,2
098 Tramin a.d. Weinstr.,95,,-,3,3
098 Tramin a.d. Weinstr.,99,,-,2,2
099 Tisens,0,,9,9,18
099 Tisens,1,,10,14,24
099 Tisens,2,,3,5,8
099 Tisens,3,,9,8,17
099 Tisens,4,,10,6,16
099 Tisens,5,,12,12,24
099 Tisens,6,,6,10,16
099 Tisens,7,,6,15,21
099 Tisens,8,,16,8,24
099 Tisens,9,,10,15,25
099 Tisens,10,,12,9,21
099 Tisens,11,,7,13,20
099 Tisens,12,,14,9,23
099 Tisens,13,,15,8,23
099 Tisens,14,,9,5,14
099 Tisens,15,,14,12,26
099 Tisens,16,,18,6,24
099 Tisens,17,,10,14,24
099 Tisens,18,,4,18,22
099 Tisens,19,,14,12,26
099 Tisens,20,,10,7,17
099 Tisens,21,,12,13,25
099 Tisens,22,,11,7,18
099 Tisens,23,,9,3,12
099 Tisens,24,,14,14,28
099 Tisens,25,,9,8,17
099 Tisens,26,,10,9,19
099 Tisens,27,,7,12,19
099 Tisens,28,,17,17,34
099 Tisens,29,,17,16,33
099 Tisens,30,,17,13,30
099 Tisens,31,,17,16,33
099 Tisens,32,,18,21,39
099 Tisens,33,,19,12,31
099 Tisens,34,,19,24,43
099 Tisens,35,,16,4,20
099 Tisens,36,,18,14,32
099 Tisens,37,,23,7,30
099 Tisens,38,,16,13,29
099 Tisens,39,,17,7,24
099 Tisens,40,,13,11,24
099 Tisens,41,,9,11,20
099 Tisens,42,,18,20,38
099 Tisens,43,,9,13,22
099 Tisens,44,,18,9,27
099 Tisens,45,,8,6,14
099 Tisens,46,,14,9,23
099 Tisens,47,,7,12,19
099 Tisens,48,,10,10,20
099 Tisens,49,,9,6,15
099 Tisens,50,,5,7,12
099 Tisens,51,,14,9,23
099 Tisens,52,,7,8,15
099 Tisens,53,,8,7,15
099 Tisens,54,,4,7,11
099 Tisens,55,,10,10,20
099 Tisens,56,,12,10,22
099 Tisens,57,,8,8,16
099 Tisens,58,,9,14,23
099 Tisens,59,,6,8,14
099 Tisens,60,,14,10,24
099 Tisens,61,,7,12,19
099 Tisens,62,,5,5,10
099 Tisens,63,,7,8,15
099 Tisens,64,,5,11,16
099 Tisens,65,,9,7,16
099 Tisens,66,,2,12,14
099 Tisens,67,,9,10,19
099 Tisens,68,,8,9,17
099 Tisens,69,,5,15,20
099 Tisens,70,,10,11,21
099 Tisens,71,,13,13,26
099 Tisens,72,,15,10,25
099 Tisens,73,,6,9,15
099 Tisens,74,,5,7,12
099 Tisens,75,,3,6,9
099 Tisens,76,,4,12,16
099 Tisens,77,,7,6,13
099 Tisens,78,,7,7,14
099 Tisens,79,,5,6,11
099 Tisens,80,,2,9,11
099 Tisens,81,,4,3,7
099 Tisens,82,,2,5,7
099 Tisens,83,,1,3,4
099 Tisens,84,,2,4,6
099 Tisens,85,,1,6,7
099 Tisens,86,,2,3,5
099 Tisens,87,,1,6,7
099 Tisens,88,,2,3,5
099 Tisens,89,,1,5,6
099 Tisens,91,,-,4,4
099 Tisens,92,,1,2,3
099 Tisens,94,,-,3,3
099 Tisens,96,,-,1,1
099 Tisens,98,,-,1,1
100 Tiers,0,,6,9,15
100 Tiers,1,,4,8,12
100 Tiers,2,,6,7,13
100 Tiers,3,,8,5,13
100 Tiers,4,,6,13,19
100 Tiers,5,,5,7,12
100 Tiers,6,,5,-,5
100 Tiers,7,,6,3,9
100 Tiers,8,,4,3,7
100 Tiers,9,,6,4,10
100 Tiers,10,,5,6,11
100 Tiers,11,,6,8,14
100 Tiers,12,,5,4,9
100 Tiers,13,,9,5,14
100 Tiers,14,,5,6,11
100 Tiers,15,,3,9,12
100 Tiers,16,,7,6,13
100 Tiers,17,,6,6,12
100 Tiers,18,,5,4,9
100 Tiers,19,,2,4,6
100 Tiers,20,,1,9,10
100 Tiers,21,,8,8,16
100 Tiers,22,,6,3,9
100 Tiers,23,,1,3,4
100 Tiers,24,,7,3,10
100 Tiers,25,,5,5,10
100 Tiers,26,,8,10,18
100 Tiers,27,,10,8,18
100 Tiers,28,,6,8,14
100 Tiers,29,,7,8,15
100 Tiers,30,,12,9,21
100 Tiers,31,,6,6,12
100 Tiers,32,,9,12,21
100 Tiers,33,,14,7,21
100 Tiers,34,,7,8,15
100 Tiers,35,,9,2,11
100 Tiers,36,,6,10,16
100 Tiers,37,,5,7,12
100 Tiers,38,,7,4,11
100 Tiers,39,,3,6,9
100 Tiers,40,,11,5,16
100 Tiers,41,,7,4,11
100 Tiers,42,,5,8,13
100 Tiers,43,,11,7,18
100 Tiers,44,,5,3,8
100 Tiers,45,,8,5,13
100 Tiers,46,,6,5,11
100 Tiers,47,,3,4,7
100 Tiers,48,,1,3,4
100 Tiers,49,,7,5,12
100 Tiers,50,,2,5,7
100 Tiers,51,,5,5,10
100 Tiers,52,,1,2,3
100 Tiers,53,,5,4,9
100 Tiers,54,,10,3,13
100 Tiers,55,,-,5,5
100 Tiers,56,,8,10,18
100 Tiers,57,,2,5,7
100 Tiers,58,,5,7,12
100 Tiers,59,,2,3,5
100 Tiers,60,,5,6,11
100 Tiers,61,,6,5,11
100 Tiers,62,,7,5,12
100 Tiers,63,,4,7,11
100 Tiers,64,,7,2,9
100 Tiers,65,,2,5,7
100 Tiers,66,,7,3,10
100 Tiers,67,,4,5,9
100 Tiers,68,,7,3,10
100 Tiers,69,,5,1,6
100 Tiers,70,,3,3,6
100 Tiers,71,,4,3,7
100 Tiers,72,,4,4,8
100 Tiers,73,,4,2,6
100 Tiers,74,,5,6,11
100 Tiers,75,,2,7,9
100 Tiers,76,,3,3,6
100 Tiers,77,,3,2,5
100 Tiers,78,,-,10,10
100 Tiers,79,,2,3,5
100 Tiers,80,,3,1,4
100 Tiers,81,,1,1,2
100 Tiers,82,,3,1,4
100 Tiers,84,,1,2,3
100 Tiers,85,,2,1,3
100 Tiers,86,,1,1,2
100 Tiers,87,,1,2,3
100 Tiers,88,,1,1,2
100 Tiers,89,,1,2,3
100 Tiers,90,,-,1,1
100 Tiers,91,,1,-,1
100 Tiers,92,,-,1,1
100 Tiers,96,,1,-,1
101 Tirol,0,,18,15,33
101 Tirol,1,,14,14,28
101 Tirol,2,,19,18,37
101 Tirol,3,,22,18,40
101 Tirol,4,,10,17,27
101 Tirol,5,,12,16,28
101 Tirol,6,,22,9,31
101 Tirol,7,,11,14,25
101 Tirol,8,,8,9,17
101 Tirol,9,,15,11,26
101 Tirol,10,,10,19,29
101 Tirol,11,,10,14,24
101 Tirol,12,,15,9,24
101 Tirol,13,,10,12,22
101 Tirol,14,,10,16,26
101 Tirol,15,,16,11,27
101 Tirol,16,,18,14,32
101 Tirol,17,,13,13,26
101 Tirol,18,,17,23,40
101 Tirol,19,,18,9,27
101 Tirol,20,,19,6,25
101 Tirol,21,,9,13,22
101 Tirol,22,,15,19,34
101 Tirol,23,,14,9,23
101 Tirol,24,,18,24,42
101 Tirol,25,,15,18,33
101 Tirol,26,,20,18,38
101 Tirol,27,,24,17,41
101 Tirol,28,,24,13,37
101 Tirol,29,,20,12,32
101 Tirol,30,,23,19,42
101 Tirol,31,,23,21,44
101 Tirol,32,,22,22,44
101 Tirol,33,,22,18,40
101 Tirol,34,,23,24,47
101 Tirol,35,,28,21,49
101 Tirol,36,,20,14,34
101 Tirol,37,,21,18,39
101 Tirol,38,,19,24,43
101 Tirol,39,,24,12,36
101 Tirol,40,,16,10,26
101 Tirol,41,,16,18,34
101 Tirol,42,,21,17,38
101 Tirol,43,,9,15,24
101 Tirol,44,,13,14,27
101 Tirol,45,,14,17,31
101 Tirol,46,,18,17,35
101 Tirol,47,,11,10,21
101 Tirol,48,,15,18,33
101 Tirol,49,,15,13,28
101 Tirol,50,,21,16,37
101 Tirol,51,,21,15,36
101 Tirol,52,,9,17,26
101 Tirol,53,,14,8,22
101 Tirol,54,,12,14,26
101 Tirol,55,,18,17,35
101 Tirol,56,,11,12,23
101 Tirol,57,,12,20,32
101 Tirol,58,,14,19,33
101 Tirol,59,,10,14,24
101 Tirol,60,,13,13,26
101 Tirol,61,,9,9,18
101 Tirol,62,,11,15,26
101 Tirol,63,,9,12,21
101 Tirol,64,,12,11,23
101 Tirol,65,,16,6,22
101 Tirol,66,,8,12,20
101 Tirol,67,,7,8,15
101 Tirol,68,,8,7,15
101 Tirol,69,,6,9,15
101 Tirol,70,,12,15,27
101 Tirol,71,,9,9,18
101 Tirol,72,,9,8,17
101 Tirol,73,,5,12,17
101 Tirol,74,,6,9,15
101 Tirol,75,,9,11,20
101 Tirol,76,,5,7,12
101 Tirol,77,,4,7,11
101 Tirol,78,,7,9,16
101 Tirol,79,,2,8,10
101 Tirol,80,,3,4,7
101 Tirol,81,,2,6,8
101 Tirol,82,,1,1,2
101 Tirol,83,,2,4,6
101 Tirol,84,,3,5,8
101 Tirol,85,,3,6,9
101 Tirol,86,,4,6,10
101 Tirol,87,,1,3,4
101 Tirol,88,,3,6,9
101 Tirol,89,,2,2,4
101 Tirol,90,,-,3,3
101 Tirol,91,,-,3,3
101 Tirol,92,,1,1,2
101 Tirol,93,,1,-,1
101 Tirol,94,,-,1,1
102 Truden im Naturpark,0,,-,3,3
102 Truden im Naturpark,1,,3,8,11
102 Truden im Naturpark,2,,5,6,11
102 Truden im Naturpark,3,,7,6,13
102 Truden im Naturpark,4,,5,7,12
102 Truden im Naturpark,5,,5,6,11
102 Truden im Naturpark,6,,10,4,14
102 Truden im Naturpark,7,,8,4,12
102 Truden im Naturpark,8,,7,6,13
102 Truden im Naturpark,9,,4,5,9
102 Truden im Naturpark,10,,11,6,17
102 Truden im Naturpark,11,,8,10,18
102 Truden im Naturpark,12,,6,5,11
102 Truden im Naturpark,13,,1,6,7
102 Truden im Naturpark,14,,8,6,14
102 Truden im Naturpark,15,,10,4,14
102 Truden im Naturpark,16,,6,5,11
102 Truden im Naturpark,17,,12,3,15
102 Truden im Naturpark,18,,4,8,12
102 Truden im Naturpark,19,,4,4,8
102 Truden im Naturpark,20,,8,5,13
102 Truden im Naturpark,21,,6,6,12
102 Truden im Naturpark,22,,4,3,7
102 Truden im Naturpark,23,,11,9,20
102 Truden im Naturpark,24,,8,3,11
102 Truden im Naturpark,25,,3,7,10
102 Truden im Naturpark,26,,6,10,16
102 Truden im Naturpark,27,,5,9,14
102 Truden im Naturpark,28,,3,6,9
102 Truden im Naturpark,29,,4,7,11
102 Truden im Naturpark,30,,7,9,16
102 Truden im Naturpark,31,,7,12,19
102 Truden im Naturpark,32,,11,7,18
102 Truden im Naturpark,33,,6,6,12
102 Truden im Naturpark,34,,6,6,12
102 Truden im Naturpark,35,,8,6,14
102 Truden im Naturpark,36,,11,8,19
102 Truden im Naturpark,37,,7,7,14
102 Truden im Naturpark,38,,7,6,13
102 Truden im Naturpark,39,,10,12,22
102 Truden im Naturpark,40,,8,9,17
102 Truden im Naturpark,41,,4,8,12
102 Truden im Naturpark,42,,6,10,16
102 Truden im Naturpark,43,,8,5,13
102 Truden im Naturpark,44,,8,11,19
102 Truden im Naturpark,45,,6,5,11
102 Truden im Naturpark,46,,8,5,13
102 Truden im Naturpark,47,,7,6,13
102 Truden im Naturpark,48,,9,6,15
102 Truden im Naturpark,49,,2,2,4
102 Truden im Naturpark,50,,5,3,8
102 Truden im Naturpark,51,,1,7,8
102 Truden im Naturpark,52,,6,1,7
102 Truden im Naturpark,53,,8,6,14
102 Truden im Naturpark,54,,4,2,6
102 Truden im Naturpark,55,,4,5,9
102 Truden im Naturpark,56,,5,4,9
102 Truden im Naturpark,57,,6,3,9
102 Truden im Naturpark,58,,5,6,11
102 Truden im Naturpark,59,,3,4,7
102 Truden im Naturpark,60,,8,3,11
102 Truden im Naturpark,61,,7,7,14
102 Truden im Naturpark,62,,3,4,7
102 Truden im Naturpark,63,,5,4,9
102 Truden im Naturpark,64,,4,3,7
102 Truden im Naturpark,65,,5,-,5
102 Truden im Naturpark,66,,7,7,14
102 Truden im Naturpark,67,,4,4,8
102 Truden im Naturpark,68,,7,3,10
102 Truden im Naturpark,69,,4,10,14
102 Truden im Naturpark,70,,-,7,7
102 Truden im Naturpark,71,,2,6,8
102 Truden im Naturpark,72,,6,7,13
102 Truden im Naturpark,73,,2,8,10
102 Truden im Naturpark,74,,2,7,9
102 Truden im Naturpark,75,,-,7,7
102 Truden im Naturpark,76,,4,7,11
102 Truden im Naturpark,77,,5,4,9
102 Truden im Naturpark,78,,3,7,10
102 Truden im Naturpark,79,,-,9,9
102 Truden im Naturpark,80,,1,3,4
102 Truden im Naturpark,81,,1,2,3
102 Truden im Naturpark,82,,1,1,2
102 Truden im Naturpark,84,,2,1,3
102 Truden im Naturpark,85,,-,5,5
102 Truden im Naturpark,88,,-,1,1
102 Truden im Naturpark,89,,-,2,2
102 Truden im Naturpark,90,,-,2,2
102 Truden im Naturpark,93,,-,3,3
103 Taufers im Münstertal,0,,4,4,8
103 Taufers im Münstertal,1,,8,7,15
103 Taufers im Münstertal,2,,2,5,7
103 Taufers im Münstertal,3,,7,4,11
103 Taufers im Münstertal,4,,9,9,18
103 Taufers im Münstertal,5,,5,10,15
103 Taufers im Münstertal,6,,4,5,9
103 Taufers im Münstertal,7,,10,9,19
103 Taufers im Münstertal,8,,6,13,19
103 Taufers im Münstertal,9,,7,7,14
103 Taufers im Münstertal,10,,6,2,8
103 Taufers im Münstertal,11,,6,8,14
103 Taufers im Münstertal,12,,4,6,10
103 Taufers im Münstertal,13,,4,4,8
103 Taufers im Münstertal,14,,4,3,7
103 Taufers im Münstertal,15,,4,7,11
103 Taufers im Münstertal,16,,5,6,11
103 Taufers im Münstertal,17,,5,11,16
103 Taufers im Münstertal,18,,9,2,11
103 Taufers im Münstertal,19,,8,4,12
103 Taufers im Münstertal,20,,6,3,9
103 Taufers im Münstertal,21,,7,5,12
103 Taufers im Münstertal,22,,5,4,9
103 Taufers im Münstertal,23,,2,5,7
103 Taufers im Münstertal,24,,10,1,11
103 Taufers im Münstertal,25,,5,7,12
103 Taufers im Münstertal,26,,2,5,7
103 Taufers im Münstertal,27,,5,7,12
103 Taufers im Münstertal,28,,9,14,23
103 Taufers im Münstertal,29,,6,8,14
103 Taufers im Münstertal,30,,10,9,19
103 Taufers im Münstertal,31,,9,9,18
103 Taufers im Münstertal,32,,5,6,11
103 Taufers im Münstertal,33,,10,10,20
103 Taufers im Münstertal,34,,15,10,25
103 Taufers im Münstertal,35,,8,12,20
103 Taufers im Münstertal,36,,12,10,22
103 Taufers im Münstertal,37,,11,10,21
103 Taufers im Münstertal,38,,9,8,17
103 Taufers im Münstertal,39,,15,7,22
103 Taufers im Münstertal,40,,6,9,15
103 Taufers im Münstertal,41,,5,6,11
103 Taufers im Münstertal,42,,9,6,15
103 Taufers im Münstertal,43,,11,10,21
103 Taufers im Münstertal,44,,3,3,6
103 Taufers im Münstertal,45,,3,6,9
103 Taufers im Münstertal,46,,6,3,9
103 Taufers im Münstertal,47,,6,2,8
103 Taufers im Münstertal,48,,5,4,9
103 Taufers im Münstertal,49,,7,1,8
103 Taufers im Münstertal,50,,6,1,7
103 Taufers im Münstertal,51,,6,1,7
103 Taufers im Münstertal,52,,3,7,10
103 Taufers im Münstertal,53,,3,3,6
103 Taufers im Münstertal,54,,2,3,5
103 Taufers im Münstertal,55,,1,-,1
103 Taufers im Münstertal,56,,8,5,13
103 Taufers im Münstertal,57,,5,5,10
103 Taufers im Münstertal,58,,4,6,10
103 Taufers im Münstertal,59,,4,3,7
103 Taufers im Münstertal,60,,4,4,8
103 Taufers im Münstertal,61,,8,9,17
103 Taufers im Münstertal,62,,3,5,8
103 Taufers im Münstertal,63,,2,8,10
103 Taufers im Münstertal,64,,7,2,9
103 Taufers im Münstertal,65,,4,8,12
103 Taufers im Münstertal,66,,6,5,11
103 Taufers im Münstertal,67,,6,2,8
103 Taufers im Münstertal,68,,9,3,12
103 Taufers im Münstertal,69,,4,4,8
103 Taufers im Münstertal,70,,4,6,10
103 Taufers im Münstertal,71,,4,3,7
103 Taufers im Münstertal,72,,3,3,6
103 Taufers im Münstertal,73,,3,6,9
103 Taufers im Münstertal,74,,1,7,8
103 Taufers im Münstertal,75,,1,7,8
103 Taufers im Münstertal,76,,4,6,10
103 Taufers im Münstertal,77,,3,3,6
103 Taufers im Münstertal,78,,4,-,4
103 Taufers im Münstertal,79,,3,2,5
103 Taufers im Münstertal,80,,2,4,6
103 Taufers im Münstertal,81,,-,1,1
103 Taufers im Münstertal,82,,2,5,7
103 Taufers im Münstertal,83,,1,1,2
103 Taufers im Münstertal,84,,2,2,4
103 Taufers im Münstertal,85,,1,-,1
103 Taufers im Münstertal,86,,-,1,1
103 Taufers im Münstertal,87,,-,2,2
103 Taufers im Münstertal,89,,1,1,2
103 Taufers im Münstertal,90,,-,2,2
103 Taufers im Münstertal,91,,-,3,3
103 Taufers im Münstertal,95,,-,1,1
103 Taufers im Münstertal,98,,-,1,1
104 Ulten,0,,15,14,29
104 Ulten,1,,18,18,36
104 Ulten,2,,16,21,37
104 Ulten,3,,12,12,24
104 Ulten,4,,12,17,29
104 Ulten,5,,19,16,35
104 Ulten,6,,23,15,38
104 Ulten,7,,16,17,33
104 Ulten,8,,24,30,54
104 Ulten,9,,17,18,35
104 Ulten,10,,18,29,47
104 Ulten,11,,18,18,36
104 Ulten,12,,20,18,38
104 Ulten,13,,21,12,33
104 Ulten,14,,14,16,30
104 Ulten,15,,22,21,43
104 Ulten,16,,22,20,42
104 Ulten,17,,15,27,42
104 Ulten,18,,19,18,37
104 Ulten,19,,22,21,43
104 Ulten,20,,18,18,36
104 Ulten,21,,22,16,38
104 Ulten,22,,23,12,35
104 Ulten,23,,17,23,40
104 Ulten,24,,25,27,52
104 Ulten,25,,21,30,51
104 Ulten,26,,28,21,49
104 Ulten,27,,25,25,50
104 Ulten,28,,28,22,50
104 Ulten,29,,25,32,57
104 Ulten,30,,30,19,49
104 Ulten,31,,28,28,56
104 Ulten,32,,14,25,39
104 Ulten,33,,21,19,40
104 Ulten,34,,27,25,52
104 Ulten,35,,26,21,47
104 Ulten,36,,29,26,55
104 Ulten,37,,32,24,56
104 Ulten,38,,31,18,49
104 Ulten,39,,27,21,48
104 Ulten,40,,24,21,45
104 Ulten,41,,28,16,44
104 Ulten,42,,37,23,60
104 Ulten,43,,18,15,33
104 Ulten,44,,14,13,27
104 Ulten,45,,19,18,37
104 Ulten,46,,25,14,39
104 Ulten,47,,17,13,30
104 Ulten,48,,20,17,37
104 Ulten,49,,21,14,35
104 Ulten,50,,17,10,27
104 Ulten,51,,14,13,27
104 Ulten,52,,18,8,26
104 Ulten,53,,16,16,32
104 Ulten,54,,10,11,21
104 Ulten,55,,14,20,34
104 Ulten,56,,17,16,33
104 Ulten,57,,11,19,30
104 Ulten,58,,15,13,28
104 Ulten,59,,17,10,27
104 Ulten,60,,21,16,37
104 Ulten,61,,8,11,19
104 Ulten,62,,11,11,22
104 Ulten,63,,9,10,19
104 Ulten,64,,11,13,24
104 Ulten,65,,12,14,26
104 Ulten,66,,5,14,19
104 Ulten,67,,15,8,23
104 Ulten,68,,11,10,21
104 Ulten,69,,16,18,34
104 Ulten,70,,8,16,24
104 Ulten,71,,10,17,27
104 Ulten,72,,15,20,35
104 Ulten,73,,11,14,25
104 Ulten,74,,15,17,32
104 Ulten,75,,12,11,23
104 Ulten,76,,12,26,38
104 Ulten,77,,10,12,22
104 Ulten,78,,10,16,26
104 Ulten,79,,10,16,26
104 Ulten,80,,4,14,18
104 Ulten,81,,3,5,8
104 Ulten,82,,1,3,4
104 Ulten,83,,-,5,5
104 Ulten,84,,4,1,5
104 Ulten,85,,2,10,12
104 Ulten,86,,6,7,13
104 Ulten,87,,3,7,10
104 Ulten,88,,3,9,12
104 Ulten,89,,4,7,11
104 Ulten,90,,2,4,6
104 Ulten,91,,1,3,4
104 Ulten,92,,1,1,2
104 Ulten,94,,1,1,2
104 Ulten,101,,-,1,1
105 Pfatten,0,,5,7,12
105 Pfatten,1,,12,5,17
105 Pfatten,2,,2,-,2
105 Pfatten,3,,8,5,13
105 Pfatten,4,,4,3,7
105 Pfatten,5,,11,11,22
105 Pfatten,6,,3,4,7
105 Pfatten,7,,6,5,11
105 Pfatten,8,,6,6,12
105 Pfatten,9,,9,8,17
105 Pfatten,10,,5,6,11
105 Pfatten,11,,2,6,8
105 Pfatten,12,,5,5,10
105 Pfatten,13,,5,7,12
105 Pfatten,14,,5,5,10
105 Pfatten,15,,3,5,8
105 Pfatten,16,,4,4,8
105 Pfatten,17,,6,2,8
105 Pfatten,18,,7,2,9
105 Pfatten,19,,1,5,6
105 Pfatten,20,,2,5,7
105 Pfatten,21,,6,4,10
105 Pfatten,22,,5,2,7
105 Pfatten,23,,8,3,11
105 Pfatten,24,,5,5,10
105 Pfatten,25,,6,6,12
105 Pfatten,26,,6,5,11
105 Pfatten,27,,7,8,15
105 Pfatten,28,,5,9,14
105 Pfatten,29,,8,8,16
105 Pfatten,30,,6,6,12
105 Pfatten,31,,5,9,14
105 Pfatten,32,,12,5,17
105 Pfatten,33,,10,6,16
105 Pfatten,34,,12,9,21
105 Pfatten,35,,7,7,14
105 Pfatten,36,,9,10,19
105 Pfatten,37,,10,13,23
105 Pfatten,38,,9,13,22
105 Pfatten,39,,6,11,17
105 Pfatten,40,,6,14,20
105 Pfatten,41,,8,7,15
105 Pfatten,42,,15,5,20
105 Pfatten,43,,8,7,15
105 Pfatten,44,,8,5,13
105 Pfatten,45,,11,3,14
105 Pfatten,46,,8,6,14
105 Pfatten,47,,3,6,9
105 Pfatten,48,,4,2,6
105 Pfatten,49,,5,7,12
105 Pfatten,50,,4,2,6
105 Pfatten,51,,5,2,7
105 Pfatten,52,,4,9,13
105 Pfatten,53,,6,6,12
105 Pfatten,54,,5,4,9
105 Pfatten,55,,4,1,5
105 Pfatten,56,,3,2,5
105 Pfatten,57,,5,3,8
105 Pfatten,58,,5,6,11
105 Pfatten,59,,3,5,8
105 Pfatten,60,,4,1,5
105 Pfatten,61,,4,4,8
105 Pfatten,62,,5,2,7
105 Pfatten,63,,3,6,9
105 Pfatten,64,,7,2,9
105 Pfatten,65,,5,6,11
105 Pfatten,66,,2,3,5
105 Pfatten,67,,1,4,5
105 Pfatten,68,,2,4,6
105 Pfatten,69,,2,3,5
105 Pfatten,70,,-,6,6
105 Pfatten,71,,1,1,2
105 Pfatten,72,,2,2,4
105 Pfatten,73,,3,5,8
105 Pfatten,74,,3,4,7
105 Pfatten,75,,1,5,6
105 Pfatten,76,,3,2,5
105 Pfatten,77,,3,1,4
105 Pfatten,78,,1,1,2
105 Pfatten,79,,1,1,2
105 Pfatten,80,,1,-,1
105 Pfatten,81,,-,1,1
105 Pfatten,82,,1,1,2
105 Pfatten,83,,-,2,2
105 Pfatten,84,,-,2,2
105 Pfatten,85,,1,1,2
105 Pfatten,86,,1,2,3
105 Pfatten,87,,-,2,2
105 Pfatten,88,,-,1,1
105 Pfatten,90,,1,-,1
105 Pfatten,92,,-,2,2
106 Olang,0,,18,17,35
106 Olang,1,,17,19,36
106 Olang,2,,21,20,41
106 Olang,3,,26,21,47
106 Olang,4,,19,8,27
106 Olang,5,,20,12,32
106 Olang,6,,19,23,42
106 Olang,7,,13,15,28
106 Olang,8,,24,17,41
106 Olang,9,,22,25,47
106 Olang,10,,17,20,37
106 Olang,11,,15,17,32
106 Olang,12,,23,18,41
106 Olang,13,,17,17,34
106 Olang,14,,13,22,35
106 Olang,15,,21,14,35
106 Olang,16,,17,21,38
106 Olang,17,,20,23,43
106 Olang,18,,17,23,40
106 Olang,19,,22,28,50
106 Olang,20,,19,17,36
106 Olang,21,,21,16,37
106 Olang,22,,28,25,53
106 Olang,23,,19,21,40
106 Olang,24,,24,22,46
106 Olang,25,,16,27,43
106 Olang,26,,31,27,58
106 Olang,27,,26,17,43
106 Olang,28,,26,19,45
106 Olang,29,,23,21,44
106 Olang,30,,21,26,47
106 Olang,31,,25,29,54
106 Olang,32,,27,23,50
106 Olang,33,,27,22,49
106 Olang,34,,18,24,42
106 Olang,35,,16,32,48
106 Olang,36,,23,21,44
106 Olang,37,,27,14,41
106 Olang,38,,17,28,45
106 Olang,39,,22,24,46
106 Olang,40,,21,17,38
106 Olang,41,,22,14,36
106 Olang,42,,27,14,41
106 Olang,43,,14,27,41
106 Olang,44,,15,17,32
106 Olang,45,,13,19,32
106 Olang,46,,15,19,34
106 Olang,47,,19,13,32
106 Olang,48,,10,12,22
106 Olang,49,,31,16,47
106 Olang,50,,25,13,38
106 Olang,51,,19,21,40
106 Olang,52,,15,24,39
106 Olang,53,,17,13,30
106 Olang,54,,19,12,31
106 Olang,55,,15,7,22
106 Olang,56,,10,17,27
106 Olang,57,,15,15,30
106 Olang,58,,16,13,29
106 Olang,59,,18,12,30
106 Olang,60,,11,9,20
106 Olang,61,,8,14,22
106 Olang,62,,10,10,20
106 Olang,63,,10,8,18
106 Olang,64,,9,15,24
106 Olang,65,,11,9,20
106 Olang,66,,10,14,24
106 Olang,67,,10,14,24
106 Olang,68,,6,6,12
106 Olang,69,,16,9,25
106 Olang,70,,13,13,26
106 Olang,71,,6,9,15
106 Olang,72,,9,11,20
106 Olang,73,,8,13,21
106 Olang,74,,5,6,11
106 Olang,75,,5,8,13
106 Olang,76,,8,5,13
106 Olang,77,,7,6,13
106 Olang,78,,8,5,13
106 Olang,79,,4,7,11
106 Olang,80,,2,5,7
106 Olang,81,,-,3,3
106 Olang,82,,1,3,4
106 Olang,83,,1,1,2
106 Olang,84,,4,8,12
106 Olang,85,,2,5,7
106 Olang,86,,-,4,4
106 Olang,87,,1,5,6
106 Olang,88,,2,5,7
106 Olang,89,,1,2,3
106 Olang,90,,1,1,2
106 Olang,91,,1,1,2
106 Olang,92,,2,1,3
106 Olang,93,,1,-,1
106 Olang,96,,-,1,1
107 Pfitsch,0,,17,12,29
107 Pfitsch,1,,9,20,29
107 Pfitsch,2,,15,10,25
107 Pfitsch,3,,11,14,25
107 Pfitsch,4,,16,10,26
107 Pfitsch,5,,15,18,33
107 Pfitsch,6,,17,12,29
107 Pfitsch,7,,13,15,28
107 Pfitsch,8,,19,13,32
107 Pfitsch,9,,19,18,37
107 Pfitsch,10,,11,20,31
107 Pfitsch,11,,14,14,28
107 Pfitsch,12,,14,19,33
107 Pfitsch,13,,15,8,23
107 Pfitsch,14,,15,9,24
107 Pfitsch,15,,24,13,37
107 Pfitsch,16,,23,19,42
107 Pfitsch,17,,32,14,46
107 Pfitsch,18,,23,17,40
107 Pfitsch,19,,20,23,43
107 Pfitsch,20,,27,21,48
107 Pfitsch,21,,25,15,40
107 Pfitsch,22,,20,20,40
107 Pfitsch,23,,20,20,40
107 Pfitsch,24,,15,17,32
107 Pfitsch,25,,15,20,35
107 Pfitsch,26,,20,14,34
107 Pfitsch,27,,14,22,36
107 Pfitsch,28,,25,17,42
107 Pfitsch,29,,29,18,47
107 Pfitsch,30,,25,23,48
107 Pfitsch,31,,21,22,43
107 Pfitsch,32,,19,19,38
107 Pfitsch,33,,26,18,44
107 Pfitsch,34,,22,18,40
107 Pfitsch,35,,14,27,41
107 Pfitsch,36,,18,18,36
107 Pfitsch,37,,26,23,49
107 Pfitsch,38,,22,20,42
107 Pfitsch,39,,20,23,43
107 Pfitsch,40,,13,18,31
107 Pfitsch,41,,25,18,43
107 Pfitsch,42,,23,26,49
107 Pfitsch,43,,19,15,34
107 Pfitsch,44,,18,16,34
107 Pfitsch,45,,22,22,44
107 Pfitsch,46,,21,14,35
107 Pfitsch,47,,21,23,44
107 Pfitsch,48,,22,14,36
107 Pfitsch,49,,23,17,40
107 Pfitsch,50,,20,20,40
107 Pfitsch,51,,9,9,18
107 Pfitsch,52,,11,14,25
107 Pfitsch,53,,16,13,29
107 Pfitsch,54,,14,12,26
107 Pfitsch,55,,13,17,30
107 Pfitsch,56,,22,11,33
107 Pfitsch,57,,26,14,40
107 Pfitsch,58,,18,18,36
107 Pfitsch,59,,13,16,29
107 Pfitsch,60,,15,8,23
107 Pfitsch,61,,4,14,18
107 Pfitsch,62,,9,11,20
107 Pfitsch,63,,9,13,22
107 Pfitsch,64,,10,8,18
107 Pfitsch,65,,12,5,17
107 Pfitsch,66,,11,13,24
107 Pfitsch,67,,3,16,19
107 Pfitsch,68,,11,14,25
107 Pfitsch,69,,9,15,24
107 Pfitsch,70,,17,13,30
107 Pfitsch,71,,7,14,21
107 Pfitsch,72,,11,14,25
107 Pfitsch,73,,7,12,19
107 Pfitsch,74,,12,10,22
107 Pfitsch,75,,5,19,24
107 Pfitsch,76,,9,14,23
107 Pfitsch,77,,9,7,16
107 Pfitsch,78,,9,8,17
107 Pfitsch,79,,2,8,10
107 Pfitsch,80,,3,8,11
107 Pfitsch,81,,-,3,3
107 Pfitsch,82,,2,3,5
107 Pfitsch,83,,1,3,4
107 Pfitsch,84,,2,6,8
107 Pfitsch,85,,-,4,4
107 Pfitsch,86,,2,4,6
107 Pfitsch,87,,2,3,5
107 Pfitsch,88,,2,2,4
107 Pfitsch,89,,2,-,2
107 Pfitsch,90,,2,3,5
107 Pfitsch,91,,-,5,5
107 Pfitsch,92,,2,1,3
107 Pfitsch,94,,-,2,2
107 Pfitsch,98,,-,1,1
108 Ahrntal,0,,36,39,75
108 Ahrntal,1,,38,34,72
108 Ahrntal,2,,41,45,86
108 Ahrntal,3,,41,50,91
108 Ahrntal,4,,36,30,66
108 Ahrntal,5,,25,29,54
108 Ahrntal,6,,41,40,81
108 Ahrntal,7,,43,33,76
108 Ahrntal,8,,29,36,65
108 Ahrntal,9,,42,32,74
108 Ahrntal,10,,38,33,71
108 Ahrntal,11,,29,33,62
108 Ahrntal,12,,38,39,77
108 Ahrntal,13,,38,50,88
108 Ahrntal,14,,35,44,79
108 Ahrntal,15,,41,33,74
108 Ahrntal,16,,44,48,92
108 Ahrntal,17,,39,45,84
108 Ahrntal,18,,48,42,90
108 Ahrntal,19,,39,40,79
108 Ahrntal,20,,45,40,85
108 Ahrntal,21,,32,45,77
108 Ahrntal,22,,48,47,95
108 Ahrntal,23,,43,51,94
108 Ahrntal,24,,46,48,94
108 Ahrntal,25,,46,49,95
108 Ahrntal,26,,47,52,99
108 Ahrntal,27,,56,56,112
108 Ahrntal,28,,75,46,121
108 Ahrntal,29,,53,48,101
108 Ahrntal,30,,53,52,105
108 Ahrntal,31,,56,54,110
108 Ahrntal,32,,49,51,100
108 Ahrntal,33,,62,39,101
108 Ahrntal,34,,56,47,103
108 Ahrntal,35,,56,45,101
108 Ahrntal,36,,47,46,93
108 Ahrntal,37,,40,48,88
108 Ahrntal,38,,35,38,73
108 Ahrntal,39,,40,31,71
108 Ahrntal,40,,42,37,79
108 Ahrntal,41,,49,25,74
108 Ahrntal,42,,27,40,67
108 Ahrntal,43,,37,20,57
108 Ahrntal,44,,35,26,61
108 Ahrntal,45,,33,22,55
108 Ahrntal,46,,28,30,58
108 Ahrntal,47,,28,30,58
108 Ahrntal,48,,34,26,60
108 Ahrntal,49,,31,24,55
108 Ahrntal,50,,32,30,62
108 Ahrntal,51,,29,29,58
108 Ahrntal,52,,26,16,42
108 Ahrntal,53,,16,22,38
108 Ahrntal,54,,20,14,34
108 Ahrntal,55,,20,18,38
108 Ahrntal,56,,23,32,55
108 Ahrntal,57,,29,30,59
108 Ahrntal,58,,30,32,62
108 Ahrntal,59,,31,24,55
108 Ahrntal,60,,27,23,50
108 Ahrntal,61,,37,30,67
108 Ahrntal,62,,26,23,49
108 Ahrntal,63,,22,16,38
108 Ahrntal,64,,24,37,61
108 Ahrntal,65,,22,20,42
108 Ahrntal,66,,20,19,39
108 Ahrntal,67,,22,27,49
108 Ahrntal,68,,35,25,60
108 Ahrntal,69,,22,21,43
108 Ahrntal,70,,21,18,39
108 Ahrntal,71,,15,27,42
108 Ahrntal,72,,18,18,36
108 Ahrntal,73,,23,14,37
108 Ahrntal,74,,16,18,34
108 Ahrntal,75,,14,18,32
108 Ahrntal,76,,10,15,25
108 Ahrntal,77,,12,16,28
108 Ahrntal,78,,7,10,17
108 Ahrntal,79,,4,7,11
108 Ahrntal,80,,10,5,15
108 Ahrntal,81,,-,8,8
108 Ahrntal,82,,3,6,9
108 Ahrntal,83,,-,3,3
108 Ahrntal,84,,2,11,13
108 Ahrntal,85,,9,10,19
108 Ahrntal,86,,4,5,9
108 Ahrntal,87,,3,9,12
108 Ahrntal,88,,2,9,11
108 Ahrntal,89,,3,4,7
108 Ahrntal,90,,4,3,7
108 Ahrntal,91,,-,6,6
108 Ahrntal,92,,-,3,3
108 Ahrntal,93,,-,1,1
108 Ahrntal,94,,1,3,4
108 Ahrntal,95,,1,-,1
108 Ahrntal,96,,-,1,1
109 Gsies,0,,20,14,34
109 Gsies,1,,19,6,25
109 Gsies,2,,13,14,27
109 Gsies,3,,10,18,28
109 Gsies,4,,15,14,29
109 Gsies,5,,11,19,30
109 Gsies,6,,18,19,37
109 Gsies,7,,16,10,26
109 Gsies,8,,17,25,42
109 Gsies,9,,16,13,29
109 Gsies,10,,9,12,21
109 Gsies,11,,7,14,21
109 Gsies,12,,18,18,36
109 Gsies,13,,12,17,29
109 Gsies,14,,17,14,31
109 Gsies,15,,12,8,20
109 Gsies,16,,18,10,28
109 Gsies,17,,18,19,37
109 Gsies,18,,14,18,32
109 Gsies,19,,24,20,44
109 Gsies,20,,10,16,26
109 Gsies,21,,14,15,29
109 Gsies,22,,17,17,34
109 Gsies,23,,15,19,34
109 Gsies,24,,19,30,49
109 Gsies,25,,21,18,39
109 Gsies,26,,18,15,33
109 Gsies,27,,9,20,29
109 Gsies,28,,22,21,43
109 Gsies,29,,30,15,45
109 Gsies,30,,26,11,37
109 Gsies,31,,17,14,31
109 Gsies,32,,16,13,29
109 Gsies,33,,13,19,32
109 Gsies,34,,22,6,28
109 Gsies,35,,14,18,32
109 Gsies,36,,14,16,30
109 Gsies,37,,17,10,27
109 Gsies,38,,10,13,23
109 Gsies,39,,18,16,34
109 Gsies,40,,12,14,26
109 Gsies,41,,16,15,31
109 Gsies,42,,12,14,26
109 Gsies,43,,17,7,24
109 Gsies,44,,17,11,28
109 Gsies,45,,16,6,22
109 Gsies,46,,17,6,23
109 Gsies,47,,17,11,28
109 Gsies,48,,16,13,29
109 Gsies,49,,8,8,16
109 Gsies,50,,15,15,30
109 Gsies,51,,9,10,19
109 Gsies,52,,21,7,28
109 Gsies,53,,15,10,25
109 Gsies,54,,4,11,15
109 Gsies,55,,9,13,22
109 Gsies,56,,10,9,19
109 Gsies,57,,6,13,19
109 Gsies,58,,6,11,17
109 Gsies,59,,9,10,19
109 Gsies,60,,6,9,15
109 Gsies,61,,7,9,16
109 Gsies,62,,11,8,19
109 Gsies,63,,4,10,14
109 Gsies,64,,5,9,14
109 Gsies,65,,6,9,15
109 Gsies,66,,6,5,11
109 Gsies,67,,10,6,16
109 Gsies,68,,8,10,18
109 Gsies,69,,13,6,19
109 Gsies,70,,4,6,10
109 Gsies,71,,8,9,17
109 Gsies,72,,3,12,15
109 Gsies,73,,5,4,9
109 Gsies,74,,8,5,13
109 Gsies,75,,6,8,14
109 Gsies,76,,6,8,14
109 Gsies,77,,10,8,18
109 Gsies,78,,2,11,13
109 Gsies,79,,4,4,8
109 Gsies,80,,4,3,7
109 Gsies,81,,1,4,5
109 Gsies,82,,1,2,3
109 Gsies,83,,1,1,2
109 Gsies,84,,3,1,4
109 Gsies,85,,2,3,5
109 Gsies,86,,1,4,5
109 Gsies,87,,4,6,10
109 Gsies,88,,1,5,6
109 Gsies,89,,-,2,2
109 Gsies,90,,1,2,3
109 Gsies,91,,1,4,5
109 Gsies,92,,-,3,3
109 Gsies,93,,1,-,1
109 Gsies,94,,1,1,2
110 Vintl,0,,21,20,41
110 Vintl,1,,26,30,56
110 Vintl,2,,20,20,40
110 Vintl,3,,22,18,40
110 Vintl,4,,35,27,62
110 Vintl,5,,19,18,37
110 Vintl,6,,23,20,43
110 Vintl,7,,29,21,50
110 Vintl,8,,21,30,51
110 Vintl,9,,28,21,49
110 Vintl,10,,26,16,42
110 Vintl,11,,21,19,40
110 Vintl,12,,21,23,44
110 Vintl,13,,21,19,40
110 Vintl,14,,11,15,26
110 Vintl,15,,27,10,37
110 Vintl,16,,24,17,41
110 Vintl,17,,21,21,42
110 Vintl,18,,20,25,45
110 Vintl,19,,34,20,54
110 Vintl,20,,33,17,50
110 Vintl,21,,21,32,53
110 Vintl,22,,17,26,43
110 Vintl,23,,19,27,46
110 Vintl,24,,26,23,49
110 Vintl,25,,30,30,60
110 Vintl,26,,20,21,41
110 Vintl,27,,34,25,59
110 Vintl,28,,31,28,59
110 Vintl,29,,19,20,39
110 Vintl,30,,27,22,49
110 Vintl,31,,23,23,46
110 Vintl,32,,30,36,66
110 Vintl,33,,31,33,64
110 Vintl,34,,34,34,68
110 Vintl,35,,35,26,61
110 Vintl,36,,29,27,56
110 Vintl,37,,32,25,57
110 Vintl,38,,27,30,57
110 Vintl,39,,18,23,41
110 Vintl,40,,25,23,48
110 Vintl,41,,18,11,29
110 Vintl,42,,23,28,51
110 Vintl,43,,25,19,44
110 Vintl,44,,19,15,34
110 Vintl,45,,16,21,37
110 Vintl,46,,23,9,32
110 Vintl,47,,18,19,37
110 Vintl,48,,22,18,40
110 Vintl,49,,25,18,43
110 Vintl,50,,19,18,37
110 Vintl,51,,13,13,26
110 Vintl,52,,21,14,35
110 Vintl,53,,16,13,29
110 Vintl,54,,18,18,36
110 Vintl,55,,11,5,16
110 Vintl,56,,21,12,33
110 Vintl,57,,11,13,24
110 Vintl,58,,6,16,22
110 Vintl,59,,8,20,28
110 Vintl,60,,18,16,34
110 Vintl,61,,14,5,19
110 Vintl,62,,10,9,19
110 Vintl,63,,14,10,24
110 Vintl,64,,9,12,21
110 Vintl,65,,16,8,24
110 Vintl,66,,6,18,24
110 Vintl,67,,12,15,27
110 Vintl,68,,12,12,24
110 Vintl,69,,9,15,24
110 Vintl,70,,11,16,27
110 Vintl,71,,13,10,23
110 Vintl,72,,10,15,25
110 Vintl,73,,16,9,25
110 Vintl,74,,8,10,18
110 Vintl,75,,9,11,20
110 Vintl,76,,14,12,26
110 Vintl,77,,4,8,12
110 Vintl,78,,9,8,17
110 Vintl,79,,3,8,11
110 Vintl,80,,3,6,9
110 Vintl,81,,1,2,3
110 Vintl,82,,2,4,6
110 Vintl,83,,2,3,5
110 Vintl,84,,2,4,6
110 Vintl,85,,2,6,8
110 Vintl,86,,-,7,7
110 Vintl,87,,1,1,2
110 Vintl,88,,-,7,7
110 Vintl,89,,2,2,4
110 Vintl,90,,-,1,1
110 Vintl,91,,2,3,5
110 Vintl,92,,1,2,3
111 Vahrn,0,,25,32,57
111 Vahrn,1,,20,19,39
111 Vahrn,2,,23,20,43
111 Vahrn,3,,34,20,54
111 Vahrn,4,,21,18,39
111 Vahrn,5,,20,25,45
111 Vahrn,6,,20,19,39
111 Vahrn,7,,19,21,40
111 Vahrn,8,,21,21,42
111 Vahrn,9,,17,27,44
111 Vahrn,10,,30,21,51
111 Vahrn,11,,23,20,43
111 Vahrn,12,,20,18,38
111 Vahrn,13,,20,14,34
111 Vahrn,14,,26,29,55
111 Vahrn,15,,20,21,41
111 Vahrn,16,,24,25,49
111 Vahrn,17,,24,26,50
111 Vahrn,18,,26,17,43
111 Vahrn,19,,21,23,44
111 Vahrn,20,,18,26,44
111 Vahrn,21,,21,22,43
111 Vahrn,22,,15,23,38
111 Vahrn,23,,38,23,61
111 Vahrn,24,,30,21,51
111 Vahrn,25,,23,34,57
111 Vahrn,26,,30,35,65
111 Vahrn,27,,30,29,59
111 Vahrn,28,,33,36,69
111 Vahrn,29,,34,29,63
111 Vahrn,30,,30,36,66
111 Vahrn,31,,30,37,67
111 Vahrn,32,,45,23,68
111 Vahrn,33,,32,32,64
111 Vahrn,34,,38,39,77
111 Vahrn,35,,41,37,78
111 Vahrn,36,,34,32,66
111 Vahrn,37,,33,37,70
111 Vahrn,38,,27,21,48
111 Vahrn,39,,35,28,63
111 Vahrn,40,,28,21,49
111 Vahrn,41,,20,20,40
111 Vahrn,42,,28,33,61
111 Vahrn,43,,22,19,41
111 Vahrn,44,,31,28,59
111 Vahrn,45,,23,30,53
111 Vahrn,46,,21,27,48
111 Vahrn,47,,21,17,38
111 Vahrn,48,,21,11,32
111 Vahrn,49,,18,17,35
111 Vahrn,50,,22,27,49
111 Vahrn,51,,19,13,32
111 Vahrn,52,,16,21,37
111 Vahrn,53,,19,24,43
111 Vahrn,54,,10,16,26
111 Vahrn,55,,19,21,40
111 Vahrn,56,,23,20,43
111 Vahrn,57,,19,22,41
111 Vahrn,58,,21,25,46
111 Vahrn,59,,21,15,36
111 Vahrn,60,,19,19,38
111 Vahrn,61,,14,9,23
111 Vahrn,62,,17,19,36
111 Vahrn,63,,13,17,30
111 Vahrn,64,,12,15,27
111 Vahrn,65,,12,15,27
111 Vahrn,66,,9,15,24
111 Vahrn,67,,14,16,30
111 Vahrn,68,,13,16,29
111 Vahrn,69,,15,16,31
111 Vahrn,70,,8,17,25
111 Vahrn,71,,10,12,22
111 Vahrn,72,,11,21,32
111 Vahrn,73,,10,6,16
111 Vahrn,74,,6,16,22
111 Vahrn,75,,8,18,26
111 Vahrn,76,,9,12,21
111 Vahrn,77,,6,14,20
111 Vahrn,78,,9,10,19
111 Vahrn,79,,4,5,9
111 Vahrn,80,,3,3,6
111 Vahrn,81,,4,5,9
111 Vahrn,82,,4,5,9
111 Vahrn,83,,1,-,1
111 Vahrn,84,,-,7,7
111 Vahrn,85,,3,5,8
111 Vahrn,86,,1,5,6
111 Vahrn,87,,1,7,8
111 Vahrn,88,,1,4,5
111 Vahrn,89,,-,3,3
111 Vahrn,90,,-,1,1
111 Vahrn,91,,-,1,1
111 Vahrn,93,,-,1,1
111 Vahrn,94,,-,1,1
111 Vahrn,95,,-,1,1
111 Vahrn,97,,1,-,1
111 Vahrn,98,,-,1,1
112 Vöran,0,,6,2,8
112 Vöran,1,,6,4,10
112 Vöran,2,,13,5,18
112 Vöran,3,,9,6,15
112 Vöran,4,,4,9,13
112 Vöran,5,,5,8,13
112 Vöran,6,,7,7,14
112 Vöran,7,,6,3,9
112 Vöran,8,,8,2,10
112 Vöran,9,,6,7,13
112 Vöran,10,,11,5,16
112 Vöran,11,,8,7,15
112 Vöran,12,,13,6,19
112 Vöran,13,,6,7,13
112 Vöran,14,,9,13,22
112 Vöran,15,,9,4,13
112 Vöran,16,,6,6,12
112 Vöran,17,,7,9,16
112 Vöran,18,,10,9,19
112 Vöran,19,,4,5,9
112 Vöran,20,,3,5,8
112 Vöran,21,,10,10,20
112 Vöran,22,,13,6,19
112 Vöran,23,,6,5,11
112 Vöran,24,,6,7,13
112 Vöran,25,,10,9,19
112 Vöran,26,,8,5,13
112 Vöran,27,,10,9,19
112 Vöran,28,,7,11,18
112 Vöran,29,,10,6,16
112 Vöran,30,,6,4,10
112 Vöran,31,,16,2,18
112 Vöran,32,,6,6,12
112 Vöran,33,,9,7,16
112 Vöran,34,,4,4,8
112 Vöran,35,,10,5,15
112 Vöran,36,,6,6,12
112 Vöran,37,,12,15,27
112 Vöran,38,,6,6,12
112 Vöran,39,,8,6,14
112 Vöran,40,,5,8,13
112 Vöran,41,,7,5,12
112 Vöran,42,,3,9,12
112 Vöran,43,,2,1,3
112 Vöran,44,,5,2,7
112 Vöran,45,,6,6,12
112 Vöran,46,,5,4,9
112 Vöran,47,,9,2,11
112 Vöran,48,,2,-,2
112 Vöran,49,,7,4,11
112 Vöran,50,,6,4,10
112 Vöran,51,,3,4,7
112 Vöran,52,,5,5,10
112 Vöran,53,,4,2,6
112 Vöran,54,,-,3,3
112 Vöran,55,,4,3,7
112 Vöran,56,,3,5,8
112 Vöran,57,,6,4,10
112 Vöran,58,,4,6,10
112 Vöran,59,,2,5,7
112 Vöran,60,,3,3,6
112 Vöran,61,,8,4,12
112 Vöran,62,,2,2,4
112 Vöran,63,,4,4,8
112 Vöran,64,,2,1,3
112 Vöran,65,,1,6,7
112 Vöran,66,,6,6,12
112 Vöran,67,,4,5,9
112 Vöran,68,,5,2,7
112 Vöran,69,,5,1,6
112 Vöran,70,,1,3,4
112 Vöran,71,,5,1,6
112 Vöran,72,,-,2,2
112 Vöran,73,,-,3,3
112 Vöran,74,,3,4,7
112 Vöran,75,,-,2,2
112 Vöran,76,,2,1,3
112 Vöran,77,,2,-,2
112 Vöran,78,,3,1,4
112 Vöran,79,,-,3,3
112 Vöran,80,,-,1,1
112 Vöran,81,,-,1,1
112 Vöran,83,,1,2,3
112 Vöran,86,,-,1,1
112 Vöran,87,,-,1,1
112 Vöran,89,,-,1,1
112 Vöran,90,,-,1,1
112 Vöran,92,,-,1,1
112 Vöran,95,,-,1,1
113 Niederdorf,0,,5,6,11
113 Niederdorf,1,,6,7,13
113 Niederdorf,2,,8,10,18
113 Niederdorf,3,,7,8,15
113 Niederdorf,4,,5,11,16
113 Niederdorf,5,,12,8,20
113 Niederdorf,6,,9,8,17
113 Niederdorf,7,,7,9,16
113 Niederdorf,8,,7,12,19
113 Niederdorf,9,,14,10,24
113 Niederdorf,10,,9,7,16
113 Niederdorf,11,,6,8,14
113 Niederdorf,12,,2,10,12
113 Niederdorf,13,,4,6,10
113 Niederdorf,14,,8,5,13
113 Niederdorf,15,,10,5,15
113 Niederdorf,16,,7,8,15
113 Niederdorf,17,,3,11,14
113 Niederdorf,18,,10,7,17
113 Niederdorf,19,,9,4,13
113 Niederdorf,20,,9,4,13
113 Niederdorf,21,,5,3,8
113 Niederdorf,22,,6,4,10
113 Niederdorf,23,,12,5,17
113 Niederdorf,24,,6,9,15
113 Niederdorf,25,,10,8,18
113 Niederdorf,26,,12,8,20
113 Niederdorf,27,,14,7,21
113 Niederdorf,28,,11,14,25
113 Niederdorf,29,,12,12,24
113 Niederdorf,30,,20,12,32
113 Niederdorf,31,,15,14,29
113 Niederdorf,32,,15,16,31
113 Niederdorf,33,,23,11,34
113 Niederdorf,34,,10,16,26
113 Niederdorf,35,,20,12,32
113 Niederdorf,36,,12,8,20
113 Niederdorf,37,,20,9,29
113 Niederdorf,38,,14,12,26
113 Niederdorf,39,,9,10,19
113 Niederdorf,40,,12,8,20
113 Niederdorf,41,,6,6,12
113 Niederdorf,42,,11,10,21
113 Niederdorf,43,,9,11,20
113 Niederdorf,44,,9,8,17
113 Niederdorf,45,,11,6,17
113 Niederdorf,46,,7,3,10
113 Niederdorf,47,,8,4,12
113 Niederdorf,48,,2,3,5
113 Niederdorf,49,,7,3,10
113 Niederdorf,50,,9,4,13
113 Niederdorf,51,,5,8,13
113 Niederdorf,52,,7,8,15
113 Niederdorf,53,,7,7,14
113 Niederdorf,54,,2,6,8
113 Niederdorf,55,,11,5,16
113 Niederdorf,56,,5,9,14
113 Niederdorf,57,,6,11,17
113 Niederdorf,58,,5,5,10
113 Niederdorf,59,,4,7,11
113 Niederdorf,60,,1,4,5
113 Niederdorf,61,,5,7,12
113 Niederdorf,62,,6,7,13
113 Niederdorf,63,,6,8,14
113 Niederdorf,64,,7,7,14
113 Niederdorf,65,,3,12,15
113 Niederdorf,66,,7,7,14
113 Niederdorf,67,,7,8,15
113 Niederdorf,68,,8,7,15
113 Niederdorf,69,,7,10,17
113 Niederdorf,70,,6,9,15
113 Niederdorf,71,,5,6,11
113 Niederdorf,72,,8,10,18
113 Niederdorf,73,,4,6,10
113 Niederdorf,74,,1,7,8
113 Niederdorf,75,,4,11,15
113 Niederdorf,76,,2,3,5
113 Niederdorf,77,,5,9,14
113 Niederdorf,78,,4,4,8
113 Niederdorf,79,,2,4,6
113 Niederdorf,80,,1,3,4
113 Niederdorf,81,,1,2,3
113 Niederdorf,82,,1,1,2
113 Niederdorf,83,,1,3,4
113 Niederdorf,84,,-,3,3
113 Niederdorf,85,,2,1,3
113 Niederdorf,86,,1,1,2
113 Niederdorf,87,,-,3,3
113 Niederdorf,88,,3,2,5
113 Niederdorf,89,,1,4,5
113 Niederdorf,90,,-,2,2
113 Niederdorf,91,,-,2,2
113 Niederdorf,92,,-,1,1
113 Niederdorf,93,,1,1,2
113 Niederdorf,94,,-,1,1
113 Niederdorf,95,,1,1,2
113 Niederdorf,96,,-,1,1
113 Niederdorf,98,,-,1,1
114 Villanders,0,,11,12,23
114 Villanders,1,,13,9,22
114 Villanders,2,,14,13,27
114 Villanders,3,,15,8,23
114 Villanders,4,,19,6,25
114 Villanders,5,,11,14,25
114 Villanders,6,,8,18,26
114 Villanders,7,,13,9,22
114 Villanders,8,,19,16,35
114 Villanders,9,,16,14,30
114 Villanders,10,,13,10,23
114 Villanders,11,,9,12,21
114 Villanders,12,,6,15,21
114 Villanders,13,,9,8,17
114 Villanders,14,,10,10,20
114 Villanders,15,,12,13,25
114 Villanders,16,,13,6,19
114 Villanders,17,,15,11,26
114 Villanders,18,,19,14,33
114 Villanders,19,,10,18,28
114 Villanders,20,,16,6,22
114 Villanders,21,,13,14,27
114 Villanders,22,,15,15,30
114 Villanders,23,,13,16,29
114 Villanders,24,,9,16,25
114 Villanders,25,,13,19,32
114 Villanders,26,,12,14,26
114 Villanders,27,,13,14,27
114 Villanders,28,,16,23,39
114 Villanders,29,,15,10,25
114 Villanders,30,,26,21,47
114 Villanders,31,,23,15,38
114 Villanders,32,,19,20,39
114 Villanders,33,,24,17,41
114 Villanders,34,,21,16,37
114 Villanders,35,,19,16,35
114 Villanders,36,,15,14,29
114 Villanders,37,,20,11,31
114 Villanders,38,,14,12,26
114 Villanders,39,,19,7,26
114 Villanders,40,,15,11,26
114 Villanders,41,,16,8,24
114 Villanders,42,,8,7,15
114 Villanders,43,,11,11,22
114 Villanders,44,,10,17,27
114 Villanders,45,,10,5,15
114 Villanders,46,,10,7,17
114 Villanders,47,,11,8,19
114 Villanders,48,,11,6,17
114 Villanders,49,,8,8,16
114 Villanders,50,,10,8,18
114 Villanders,51,,6,12,18
114 Villanders,52,,7,8,15
114 Villanders,53,,11,11,22
114 Villanders,54,,6,3,9
114 Villanders,55,,5,9,14
114 Villanders,56,,8,8,16
114 Villanders,57,,10,8,18
114 Villanders,58,,8,9,17
114 Villanders,59,,8,12,20
114 Villanders,60,,9,5,14
114 Villanders,61,,10,7,17
114 Villanders,62,,5,9,14
114 Villanders,63,,6,6,12
114 Villanders,64,,2,8,10
114 Villanders,65,,1,9,10
114 Villanders,66,,11,9,20
114 Villanders,67,,9,10,19
114 Villanders,68,,6,7,13
114 Villanders,69,,10,6,16
114 Villanders,70,,4,10,14
114 Villanders,71,,5,10,15
114 Villanders,72,,8,6,14
114 Villanders,73,,6,5,11
114 Villanders,74,,2,7,9
114 Villanders,75,,5,5,10
114 Villanders,76,,6,2,8
114 Villanders,77,,4,6,10
114 Villanders,78,,3,11,14
114 Villanders,79,,5,5,10
114 Villanders,80,,1,3,4
114 Villanders,81,,1,-,1
114 Villanders,82,,-,2,2
114 Villanders,83,,-,3,3
114 Villanders,84,,-,3,3
114 Villanders,85,,2,6,8
114 Villanders,86,,1,3,4
114 Villanders,87,,3,5,8
114 Villanders,88,,-,5,5
114 Villanders,89,,1,3,4
114 Villanders,90,,1,4,5
114 Villanders,91,,2,2,4
114 Villanders,92,,1,1,2
114 Villanders,93,,2,-,2
114 Villanders,96,,-,1,1
114 Villanders,97,,-,1,1
114 Villanders,98,,-,1,1
115 Sterzing,0,,29,32,61
115 Sterzing,1,,28,31,59
115 Sterzing,2,,31,36,67
115 Sterzing,3,,27,35,62
115 Sterzing,4,,33,29,62
115 Sterzing,5,,32,19,51
115 Sterzing,6,,34,27,61
115 Sterzing,7,,32,32,64
115 Sterzing,8,,34,35,69
115 Sterzing,9,,21,33,54
115 Sterzing,10,,35,24,59
115 Sterzing,11,,27,27,54
115 Sterzing,12,,27,24,51
115 Sterzing,13,,35,32,67
115 Sterzing,14,,17,32,49
115 Sterzing,15,,34,24,58
115 Sterzing,16,,25,29,54
115 Sterzing,17,,26,36,62
115 Sterzing,18,,45,33,78
115 Sterzing,19,,28,40,68
115 Sterzing,20,,29,42,71
115 Sterzing,21,,45,27,72
115 Sterzing,22,,39,37,76
115 Sterzing,23,,34,40,74
115 Sterzing,24,,62,52,114
115 Sterzing,25,,55,39,94
115 Sterzing,26,,54,52,106
115 Sterzing,27,,56,56,112
115 Sterzing,28,,67,47,114
115 Sterzing,29,,57,53,110
115 Sterzing,30,,49,41,90
115 Sterzing,31,,65,50,115
115 Sterzing,32,,65,43,108
115 Sterzing,33,,50,56,106
115 Sterzing,34,,58,49,107
115 Sterzing,35,,53,38,91
115 Sterzing,36,,62,49,111
115 Sterzing,37,,42,47,89
115 Sterzing,38,,43,41,84
115 Sterzing,39,,43,46,89
115 Sterzing,40,,51,41,92
115 Sterzing,41,,41,43,84
115 Sterzing,42,,35,49,84
115 Sterzing,43,,47,30,77
115 Sterzing,44,,35,44,79
115 Sterzing,45,,35,37,72
115 Sterzing,46,,32,39,71
115 Sterzing,47,,41,37,78
115 Sterzing,48,,37,40,77
115 Sterzing,49,,33,40,73
115 Sterzing,50,,31,49,80
115 Sterzing,51,,40,44,84
115 Sterzing,52,,34,30,64
115 Sterzing,53,,47,43,90
115 Sterzing,54,,37,36,73
115 Sterzing,55,,30,28,58
115 Sterzing,56,,44,45,89
115 Sterzing,57,,31,34,65
115 Sterzing,58,,34,29,63
115 Sterzing,59,,43,32,75
115 Sterzing,60,,33,29,62
115 Sterzing,61,,33,28,61
115 Sterzing,62,,23,36,59
115 Sterzing,63,,24,42,66
115 Sterzing,64,,21,23,44
115 Sterzing,65,,22,25,47
115 Sterzing,66,,34,32,66
115 Sterzing,67,,21,18,39
115 Sterzing,68,,24,33,57
115 Sterzing,69,,11,26,37
115 Sterzing,70,,22,19,41
115 Sterzing,71,,20,30,50
115 Sterzing,72,,22,21,43
115 Sterzing,73,,17,23,40
115 Sterzing,74,,7,22,29
115 Sterzing,75,,13,20,33
115 Sterzing,76,,15,20,35
115 Sterzing,77,,16,26,42
115 Sterzing,78,,5,20,25
115 Sterzing,79,,2,14,16
115 Sterzing,80,,6,12,18
115 Sterzing,81,,5,6,11
115 Sterzing,82,,6,5,11
115 Sterzing,83,,4,7,11
115 Sterzing,84,,3,7,10
115 Sterzing,85,,3,14,17
115 Sterzing,86,,2,11,13
115 Sterzing,87,,1,13,14
115 Sterzing,88,,2,4,6
115 Sterzing,89,,1,2,3
115 Sterzing,90,,2,4,6
115 Sterzing,91,,3,3,6
115 Sterzing,92,,1,2,3
115 Sterzing,93,,-,5,5
115 Sterzing,94,,-,1,1
115 Sterzing,95,,-,1,1
115 Sterzing,97,,-,1,1
115 Sterzing,98,,-,1,1
116 Feldthurns,0,,19,20,39
116 Feldthurns,1,,18,20,38
116 Feldthurns,2,,23,15,38
116 Feldthurns,3,,15,18,33
116 Feldthurns,4,,19,19,38
116 Feldthurns,5,,16,17,33
116 Feldthurns,6,,30,20,50
116 Feldthurns,7,,17,19,36
116 Feldthurns,8,,11,14,25
116 Feldthurns,9,,13,19,32
116 Feldthurns,10,,20,16,36
116 Feldthurns,11,,16,20,36
116 Feldthurns,12,,22,13,35
116 Feldthurns,13,,16,19,35
116 Feldthurns,14,,14,19,33
116 Feldthurns,15,,17,20,37
116 Feldthurns,16,,24,25,49
116 Feldthurns,17,,17,21,38
116 Feldthurns,18,,21,19,40
116 Feldthurns,19,,11,24,35
116 Feldthurns,20,,14,16,30
116 Feldthurns,21,,29,23,52
116 Feldthurns,22,,18,16,34
116 Feldthurns,23,,25,22,47
116 Feldthurns,24,,17,18,35
116 Feldthurns,25,,22,30,52
116 Feldthurns,26,,22,20,42
116 Feldthurns,27,,31,23,54
116 Feldthurns,28,,19,24,43
116 Feldthurns,29,,14,23,37
116 Feldthurns,30,,22,28,50
116 Feldthurns,31,,17,28,45
116 Feldthurns,32,,24,21,45
116 Feldthurns,33,,20,22,42
116 Feldthurns,34,,22,28,50
116 Feldthurns,35,,25,20,45
116 Feldthurns,36,,26,18,44
116 Feldthurns,37,,16,16,32
116 Feldthurns,38,,19,19,38
116 Feldthurns,39,,18,11,29
116 Feldthurns,40,,16,16,32
116 Feldthurns,41,,16,20,36
116 Feldthurns,42,,14,13,27
116 Feldthurns,43,,12,18,30
116 Feldthurns,44,,15,13,28
116 Feldthurns,45,,14,15,29
116 Feldthurns,46,,18,12,30
116 Feldthurns,47,,24,16,40
116 Feldthurns,48,,15,11,26
116 Feldthurns,49,,12,15,27
116 Feldthurns,50,,7,15,22
116 Feldthurns,51,,14,11,25
116 Feldthurns,52,,15,8,23
116 Feldthurns,53,,10,9,19
116 Feldthurns,54,,13,13,26
116 Feldthurns,55,,22,11,33
116 Feldthurns,56,,13,13,26
116 Feldthurns,57,,9,9,18
116 Feldthurns,58,,8,4,12
116 Feldthurns,59,,11,7,18
116 Feldthurns,60,,8,12,20
116 Feldthurns,61,,11,8,19
116 Feldthurns,62,,4,11,15
116 Feldthurns,63,,8,12,20
116 Feldthurns,64,,10,11,21
116 Feldthurns,65,,4,5,9
116 Feldthurns,66,,7,5,12
116 Feldthurns,67,,8,11,19
116 Feldthurns,68,,6,7,13
116 Feldthurns,69,,6,14,20
116 Feldthurns,70,,5,12,17
116 Feldthurns,71,,9,4,13
116 Feldthurns,72,,4,6,10
116 Feldthurns,73,,3,10,13
116 Feldthurns,74,,6,10,16
116 Feldthurns,75,,4,9,13
116 Feldthurns,76,,8,11,19
116 Feldthurns,77,,2,10,12
116 Feldthurns,78,,3,9,12
116 Feldthurns,79,,10,10,20
116 Feldthurns,80,,5,5,10
116 Feldthurns,81,,3,-,3
116 Feldthurns,82,,1,1,2
116 Feldthurns,83,,-,4,4
116 Feldthurns,84,,2,7,9
116 Feldthurns,85,,1,4,5
116 Feldthurns,86,,-,4,4
116 Feldthurns,87,,1,4,5
116 Feldthurns,88,,1,2,3
116 Feldthurns,90,,2,-,2
116 Feldthurns,93,,-,1,1
116 Feldthurns,95,,-,1,1
117 Wengen,0,,9,7,16
117 Wengen,1,,8,7,15
117 Wengen,2,,13,8,21
117 Wengen,3,,10,9,19
117 Wengen,4,,11,10,21
117 Wengen,5,,12,7,19
117 Wengen,6,,11,7,18
117 Wengen,7,,10,7,17
117 Wengen,8,,17,6,23
117 Wengen,9,,12,8,20
117 Wengen,10,,5,7,12
117 Wengen,11,,6,9,15
117 Wengen,12,,11,5,16
117 Wengen,13,,8,8,16
117 Wengen,14,,9,6,15
117 Wengen,15,,14,8,22
117 Wengen,16,,13,5,18
117 Wengen,17,,11,5,16
117 Wengen,18,,6,8,14
117 Wengen,19,,9,10,19
117 Wengen,20,,14,7,21
117 Wengen,21,,6,8,14
117 Wengen,22,,11,8,19
117 Wengen,23,,6,10,16
117 Wengen,24,,16,10,26
117 Wengen,25,,10,9,19
117 Wengen,26,,16,13,29
117 Wengen,27,,13,16,29
117 Wengen,28,,12,16,28
117 Wengen,29,,12,16,28
117 Wengen,30,,12,15,27
117 Wengen,31,,18,10,28
117 Wengen,32,,11,11,22
117 Wengen,33,,12,5,17
117 Wengen,34,,9,10,19
117 Wengen,35,,12,6,18
117 Wengen,36,,12,13,25
117 Wengen,37,,14,8,22
117 Wengen,38,,9,9,18
117 Wengen,39,,11,11,22
117 Wengen,40,,7,7,14
117 Wengen,41,,5,8,13
117 Wengen,42,,7,11,18
117 Wengen,43,,5,6,11
117 Wengen,44,,8,6,14
117 Wengen,45,,10,5,15
117 Wengen,46,,7,2,9
117 Wengen,47,,6,7,13
117 Wengen,48,,10,5,15
117 Wengen,49,,3,6,9
117 Wengen,50,,5,9,14
117 Wengen,51,,2,12,14
117 Wengen,52,,6,3,9
117 Wengen,53,,5,3,8
117 Wengen,54,,5,3,8
117 Wengen,55,,9,8,17
117 Wengen,56,,3,7,10
117 Wengen,57,,8,7,15
117 Wengen,58,,4,4,8
117 Wengen,59,,7,8,15
117 Wengen,60,,6,3,9
117 Wengen,61,,5,4,9
117 Wengen,62,,6,7,13
117 Wengen,63,,2,1,3
117 Wengen,64,,3,7,10
117 Wengen,65,,2,9,11
117 Wengen,66,,5,2,7
117 Wengen,67,,3,8,11
117 Wengen,68,,5,2,7
117 Wengen,69,,5,3,8
117 Wengen,70,,2,9,11
117 Wengen,71,,4,4,8
117 Wengen,72,,4,5,9
117 Wengen,73,,4,6,10
117 Wengen,74,,3,4,7
117 Wengen,75,,2,5,7
117 Wengen,76,,3,6,9
117 Wengen,77,,3,5,8
117 Wengen,78,,5,8,13
117 Wengen,79,,3,3,6
117 Wengen,80,,2,1,3
117 Wengen,81,,1,-,1
117 Wengen,82,,2,-,2
117 Wengen,84,,1,2,3
117 Wengen,86,,-,2,2
117 Wengen,87,,1,-,1
117 Wengen,88,,1,-,1
117 Wengen,89,,-,1,1
117 Wengen,90,,-,1,1
117 Wengen,91,,-,3,3
117 Wengen,93,,1,-,1
117 Wengen,94,,1,-,1
117 Wengen,95,,-,1,1
118 U.L.Frau i.W.-St.Felix,0,,6,3,9
118 U.L.Frau i.W.-St.Felix,1,,6,9,15
118 U.L.Frau i.W.-St.Felix,2,,4,4,8
118 U.L.Frau i.W.-St.Felix,3,,8,5,13
118 U.L.Frau i.W.-St.Felix,4,,3,9,12
118 U.L.Frau i.W.-St.Felix,5,,7,8,15
118 U.L.Frau i.W.-St.Felix,6,,8,5,13
118 U.L.Frau i.W.-St.Felix,7,,7,4,11
118 U.L.Frau i.W.-St.Felix,8,,10,8,18
118 U.L.Frau i.W.-St.Felix,9,,8,5,13
118 U.L.Frau i.W.-St.Felix,10,,9,6,15
118 U.L.Frau i.W.-St.Felix,11,,8,6,14
118 U.L.Frau i.W.-St.Felix,12,,4,7,11
118 U.L.Frau i.W.-St.Felix,13,,8,4,12
118 U.L.Frau i.W.-St.Felix,14,,5,7,12
118 U.L.Frau i.W.-St.Felix,15,,6,7,13
118 U.L.Frau i.W.-St.Felix,16,,2,10,12
118 U.L.Frau i.W.-St.Felix,17,,3,6,9
118 U.L.Frau i.W.-St.Felix,18,,6,3,9
118 U.L.Frau i.W.-St.Felix,19,,3,6,9
118 U.L.Frau i.W.-St.Felix,20,,2,2,4
118 U.L.Frau i.W.-St.Felix,21,,1,4,5
118 U.L.Frau i.W.-St.Felix,22,,5,4,9
118 U.L.Frau i.W.-St.Felix,23,,4,7,11
118 U.L.Frau i.W.-St.Felix,24,,8,2,10
118 U.L.Frau i.W.-St.Felix,25,,5,4,9
118 U.L.Frau i.W.-St.Felix,26,,4,4,8
118 U.L.Frau i.W.-St.Felix,27,,8,3,11
118 U.L.Frau i.W.-St.Felix,28,,2,4,6
118 U.L.Frau i.W.-St.Felix,29,,6,7,13
118 U.L.Frau i.W.-St.Felix,30,,7,3,10
118 U.L.Frau i.W.-St.Felix,31,,6,10,16
118 U.L.Frau i.W.-St.Felix,32,,4,5,9
118 U.L.Frau i.W.-St.Felix,33,,7,7,14
118 U.L.Frau i.W.-St.Felix,34,,10,5,15
118 U.L.Frau i.W.-St.Felix,35,,5,8,13
118 U.L.Frau i.W.-St.Felix,36,,17,8,25
118 U.L.Frau i.W.-St.Felix,37,,8,12,20
118 U.L.Frau i.W.-St.Felix,38,,4,4,8
118 U.L.Frau i.W.-St.Felix,39,,8,10,18
118 U.L.Frau i.W.-St.Felix,40,,5,5,10
118 U.L.Frau i.W.-St.Felix,41,,4,2,6
118 U.L.Frau i.W.-St.Felix,42,,3,5,8
118 U.L.Frau i.W.-St.Felix,43,,5,7,12
118 U.L.Frau i.W.-St.Felix,44,,4,4,8
118 U.L.Frau i.W.-St.Felix,45,,7,4,11
118 U.L.Frau i.W.-St.Felix,46,,3,3,6
118 U.L.Frau i.W.-St.Felix,47,,6,3,9
118 U.L.Frau i.W.-St.Felix,48,,6,3,9
118 U.L.Frau i.W.-St.Felix,49,,3,3,6
118 U.L.Frau i.W.-St.Felix,50,,5,-,5
118 U.L.Frau i.W.-St.Felix,51,,4,2,6
118 U.L.Frau i.W.-St.Felix,52,,2,6,8
118 U.L.Frau i.W.-St.Felix,53,,1,5,6
118 U.L.Frau i.W.-St.Felix,54,,3,1,4
118 U.L.Frau i.W.-St.Felix,55,,5,1,6
118 U.L.Frau i.W.-St.Felix,56,,8,4,12
118 U.L.Frau i.W.-St.Felix,57,,4,4,8
118 U.L.Frau i.W.-St.Felix,58,,5,8,13
118 U.L.Frau i.W.-St.Felix,59,,3,1,4
118 U.L.Frau i.W.-St.Felix,60,,1,4,5
118 U.L.Frau i.W.-St.Felix,61,,3,4,7
118 U.L.Frau i.W.-St.Felix,62,,3,-,3
118 U.L.Frau i.W.-St.Felix,63,,5,2,7
118 U.L.Frau i.W.-St.Felix,64,,3,4,7
118 U.L.Frau i.W.-St.Felix,65,,3,3,6
118 U.L.Frau i.W.-St.Felix,66,,5,5,10
118 U.L.Frau i.W.-St.Felix,67,,6,1,7
118 U.L.Frau i.W.-St.Felix,68,,4,1,5
118 U.L.Frau i.W.-St.Felix,69,,4,5,9
118 U.L.Frau i.W.-St.Felix,70,,2,3,5
118 U.L.Frau i.W.-St.Felix,71,,3,5,8
118 U.L.Frau i.W.-St.Felix,72,,3,4,7
118 U.L.Frau i.W.-St.Felix,73,,2,3,5
118 U.L.Frau i.W.-St.Felix,74,,4,5,9
118 U.L.Frau i.W.-St.Felix,75,,6,4,10
118 U.L.Frau i.W.-St.Felix,76,,2,6,8
118 U.L.Frau i.W.-St.Felix,77,,1,2,3
118 U.L.Frau i.W.-St.Felix,78,,-,3,3
118 U.L.Frau i.W.-St.Felix,79,,-,1,1
118 U.L.Frau i.W.-St.Felix,80,,1,2,3
118 U.L.Frau i.W.-St.Felix,82,,1,-,1
118 U.L.Frau i.W.-St.Felix,84,,1,1,2
118 U.L.Frau i.W.-St.Felix,85,,1,1,2
118 U.L.Frau i.W.-St.Felix,86,,2,3,5
118 U.L.Frau i.W.-St.Felix,87,,2,2,4
118 U.L.Frau i.W.-St.Felix,89,,1,2,3
118 U.L.Frau i.W.-St.Felix,91,,-,1,1
118 U.L.Frau i.W.-St.Felix,92,,1,-,1
118 U.L.Frau i.W.-St.Felix,94,,1,-,1
