Gemeinde,Altersklassen,Geschlecht,Männer,Frauen,Insgesamt
001 Aldein,0,,13,5,18
001 Aldein,1,,16,16,32
001 Aldein,2,,8,16,24
001 Aldein,3,,17,9,26
001 Aldein,4,,8,8,16
001 Aldein,5,,9,12,21
001 Aldein,6,,14,7,21
001 Aldein,7,,13,11,24
001 Aldein,8,,9,13,22
001 Aldein,9,,7,8,15
001 Aldein,10,,7,6,13
001 Aldein,11,,9,17,26
001 Aldein,12,,11,9,20
001 Aldein,13,,11,8,19
001 Aldein,14,,11,10,21
001 Aldein,15,,12,12,24
001 Aldein,16,,10,7,17
001 Aldein,17,,14,12,26
001 Aldein,18,,15,7,22
001 Aldein,19,,10,16,26
001 Aldein,20,,10,15,25
001 Aldein,21,,10,17,27
001 Aldein,22,,10,8,18
001 Aldein,23,,7,23,30
001 Aldein,24,,14,16,30
001 Aldein,25,,18,17,35
001 Aldein,26,,11,17,28
001 Aldein,27,,14,9,23
001 Aldein,28,,18,12,30
001 Aldein,29,,18,17,35
001 Aldein,30,,17,16,33
001 Aldein,31,,23,10,33
001 Aldein,32,,13,17,30
001 Aldein,33,,7,16,23
001 Aldein,34,,7,20,27
001 Aldein,35,,17,12,29
001 Aldein,36,,14,10,24
001 Aldein,37,,15,6,21
001 Aldein,38,,10,15,25
001 Aldein,39,,15,17,32
001 Aldein,40,,17,9,26
001 Aldein,41,,12,13,25
001 Aldein,42,,9,5,14
001 Aldein,43,,9,10,19
001 Aldein,44,,10,10,20
001 Aldein,45,,8,10,18
001 Aldein,46,,10,7,17
001 Aldein,47,,8,9,17
001 Aldein,48,,9,5,14
001 Aldein,49,,15,11,26
001 Aldein,50,,5,12,17
001 Aldein,51,,8,6,14
001 Aldein,52,,10,9,19
001 Aldein,53,,5,11,16
001 Aldein,54,,7,11,18
001 Aldein,55,,7,5,12
001 Aldein,56,,6,6,12
001 Aldein,57,,11,11,22
001 Aldein,58,,8,13,21
001 Aldein,59,,7,12,19
001 Aldein,60,,9,8,17
001 Aldein,61,,4,9,13
001 Aldein,62,,6,7,13
001 Aldein,63,,7,9,16
001 Aldein,64,,9,6,15
001 Aldein,65,,4,4,8
001 Aldein,66,,15,5,20
001 Aldein,67,,8,3,11
001 Aldein,68,,5,8,13
001 Aldein,69,,9,4,13
001 Aldein,70,,6,6,12
001 Aldein,71,,9,9,18
001 Aldein,72,,6,3,9
001 Aldein,73,,6,6,12
001 Aldein,74,,1,7,8
001 Aldein,75,,3,6,9
001 Aldein,76,,3,7,10
001 Aldein,77,,2,5,7
001 Aldein,78,,1,9,10
001 Aldein,79,,4,12,16
001 Aldein,80,,4,2,6
001 Aldein,81,,1,4,5
001 Aldein,82,,2,1,3
001 Aldein,83,,-,1,1
001 Aldein,84,,2,1,3
001 Aldein,85,,2,-,2
001 Aldein,86,,-,3,3
001 Aldein,87,,-,5,5
001 Aldein,88,,3,2,5
001 Aldein,89,,1,1,2
001 Aldein,90,,2,1,3
001 Aldein,91,,-,1,1
001 Aldein,92,,-,2,2
001 Aldein,93,,-,1,1
001 Aldein,94,,-,1,1
001 Aldein,96,,-,1,1
002 Andrian,0,,4,4,8
002 Andrian,1,,2,7,9
002 Andrian,2,,5,1,6
002 Andrian,3,,9,5,14
002 Andrian,4,,2,10,12
002 Andrian,5,,9,4,13
002 Andrian,6,,4,4,8
002 Andrian,7,,5,6,11
002 Andrian,8,,6,6,12
002 Andrian,9,,6,7,13
002 Andrian,10,,5,4,9
002 Andrian,11,,4,4,8
002 Andrian,12,,12,6,18
002 Andrian,13,,6,7,13
002 Andrian,14,,8,6,14
002 Andrian,15,,1,4,5
002 Andrian,16,,6,4,10
002 Andrian,17,,5,2,7
002 Andrian,18,,10,6,16
002 Andrian,19,,1,3,4
002 Andrian,20,,5,2,7
002 Andrian,21,,5,3,8
002 Andrian,22,,4,4,8
002 Andrian,23,,5,2,7
002 Andrian,24,,5,4,9
002 Andrian,25,,4,2,6
002 Andrian,26,,5,6,11
002 Andrian,27,,4,6,10
002 Andrian,28,,5,5,10
002 Andrian,29,,6,11,17
002 Andrian,30,,11,7,18
002 Andrian,31,,4,6,10
002 Andrian,32,,8,7,15
002 Andrian,33,,9,9,18
002 Andrian,34,,10,7,17
002 Andrian,35,,10,7,17
002 Andrian,36,,6,8,14
002 Andrian,37,,8,11,19
002 Andrian,38,,6,6,12
002 Andrian,39,,7,2,9
002 Andrian,40,,7,4,11
002 Andrian,41,,5,4,9
002 Andrian,42,,8,8,16
002 Andrian,43,,5,8,13
002 Andrian,44,,6,9,15
002 Andrian,45,,2,4,6
002 Andrian,46,,7,2,9
002 Andrian,47,,7,6,13
002 Andrian,48,,2,3,5
002 Andrian,49,,4,3,7
002 Andrian,50,,6,6,12
002 Andrian,51,,4,2,6
002 Andrian,52,,6,3,9
002 Andrian,53,,5,4,9
002 Andrian,54,,4,7,11
002 Andrian,55,,1,2,3
002 Andrian,56,,1,3,4
002 Andrian,57,,5,7,12
002 Andrian,58,,4,5,9
002 Andrian,59,,6,4,10
002 Andrian,60,,3,8,11
002 Andrian,61,,1,7,8
002 Andrian,62,,4,4,8
002 Andrian,63,,6,4,10
002 Andrian,64,,2,3,5
002 Andrian,65,,3,3,6
002 Andrian,66,,5,3,8
002 Andrian,67,,3,4,7
002 Andrian,68,,7,4,11
002 Andrian,69,,3,5,8
002 Andrian,70,,4,1,5
002 Andrian,71,,2,1,3
002 Andrian,72,,2,4,6
002 Andrian,73,,1,2,3
002 Andrian,74,,4,4,8
002 Andrian,75,,2,1,3
002 Andrian,76,,2,4,6
002 Andrian,77,,1,2,3
002 Andrian,78,,1,5,6
002 Andrian,79,,1,4,5
002 Andrian,80,,1,1,2
002 Andrian,81,,2,3,5
002 Andrian,82,,2,1,3
002 Andrian,84,,1,-,1
002 Andrian,85,,1,2,3
002 Andrian,86,,1,1,2
002 Andrian,87,,1,1,2
002 Andrian,88,,-,2,2
002 Andrian,90,,-,1,1
002 Andrian,93,,-,1,1
002 Andrian,97,,-,1,1
003 Altrei,0,,1,1,2
003 Altrei,1,,3,-,3
003 Altrei,2,,4,1,5
003 Altrei,3,,1,1,2
003 Altrei,4,,-,3,3
003 Altrei,5,,1,1,2
003 Altrei,6,,3,2,5
003 Altrei,7,,3,-,3
003 Altrei,8,,6,2,8
003 Altrei,9,,1,1,2
003 Altrei,10,,3,2,5
003 Altrei,11,,2,2,4
003 Altrei,12,,4,4,8
003 Altrei,13,,1,1,2
003 Altrei,14,,3,3,6
003 Altrei,15,,2,2,4
003 Altrei,16,,3,1,4
003 Altrei,17,,4,2,6
003 Altrei,18,,2,2,4
003 Altrei,19,,3,1,4
003 Altrei,20,,3,4,7
003 Altrei,21,,-,1,1
003 Altrei,22,,2,5,7
003 Altrei,23,,-,4,4
003 Altrei,24,,2,3,5
003 Altrei,25,,2,1,3
003 Altrei,26,,1,2,3
003 Altrei,27,,2,3,5
003 Altrei,28,,3,1,4
003 Altrei,29,,5,5,10
003 Altrei,30,,1,3,4
003 Altrei,31,,3,5,8
003 Altrei,32,,-,3,3
003 Altrei,33,,3,-,3
003 Altrei,34,,3,5,8
003 Altrei,35,,2,5,7
003 Altrei,36,,3,5,8
003 Altrei,37,,2,2,4
003 Altrei,38,,9,1,10
003 Altrei,39,,2,3,5
003 Altrei,40,,5,2,7
003 Altrei,41,,5,2,7
003 Altrei,42,,1,3,4
003 Altrei,43,,1,3,4
003 Altrei,44,,5,1,6
003 Altrei,45,,3,3,6
003 Altrei,46,,1,1,2
003 Altrei,47,,3,2,5
003 Altrei,48,,6,3,9
003 Altrei,49,,6,3,9
003 Altrei,50,,1,2,3
003 Altrei,51,,1,-,1
003 Altrei,52,,3,3,6
003 Altrei,53,,3,2,5
003 Altrei,54,,1,3,4
003 Altrei,55,,4,-,4
003 Altrei,56,,2,3,5
003 Altrei,57,,1,3,4
003 Altrei,58,,3,1,4
003 Altrei,59,,1,2,3
003 Altrei,60,,2,4,6
003 Altrei,61,,1,3,4
003 Altrei,62,,1,-,1
003 Altrei,63,,2,1,3
003 Altrei,64,,2,1,3
003 Altrei,65,,3,2,5
003 Altrei,66,,-,2,2
003 Altrei,67,,3,3,6
003 Altrei,68,,-,3,3
003 Altrei,69,,-,2,2
003 Altrei,70,,4,2,6
003 Altrei,71,,2,3,5
003 Altrei,72,,-,2,2
003 Altrei,73,,3,4,7
003 Altrei,74,,2,4,6
003 Altrei,75,,-,3,3
003 Altrei,76,,1,3,4
003 Altrei,77,,1,2,3
003 Altrei,78,,1,1,2
003 Altrei,79,,-,1,1
003 Altrei,80,,2,1,3
003 Altrei,81,,-,1,1
003 Altrei,82,,-,1,1
003 Altrei,83,,-,3,3
003 Altrei,85,,-,1,1
003 Altrei,86,,-,3,3
003 Altrei,87,,1,1,2
003 Altrei,88,,2,-,2
003 Altrei,89,,-,2,2
003 Altrei,92,,-,1,1
003 Altrei,94,,1,-,1
004 Eppan a.d. Weinstr.,0,,70,90,160
004 Eppan a.d. Weinstr.,1,,70,59,129
004 Eppan a.d. Weinstr.,2,,87,79,166
004 Eppan a.d. Weinstr.,3,,73,70,143
004 Eppan a.d. Weinstr.,4,,78,72,150
004 Eppan a.d. Weinstr.,5,,69,61,130
004 Eppan a.d. Weinstr.,6,,71,71,142
004 Eppan a.d. Weinstr.,7,,79,87,166
004 Eppan a.d. Weinstr.,8,,66,76,142
004 Eppan a.d. Weinstr.,9,,76,62,138
004 Eppan a.d. Weinstr.,10,,84,61,145
004 Eppan a.d. Weinstr.,11,,74,58,132
004 Eppan a.d. Weinstr.,12,,75,82,157
004 Eppan a.d. Weinstr.,13,,70,61,131
004 Eppan a.d. Weinstr.,14,,81,69,150
004 Eppan a.d. Weinstr.,15,,78,54,132
004 Eppan a.d. Weinstr.,16,,76,72,148
004 Eppan a.d. Weinstr.,17,,65,64,129
004 Eppan a.d. Weinstr.,18,,67,64,131
004 Eppan a.d. Weinstr.,19,,55,69,124
004 Eppan a.d. Weinstr.,20,,80,69,149
004 Eppan a.d. Weinstr.,21,,72,65,137
004 Eppan a.d. Weinstr.,22,,76,74,150
004 Eppan a.d. Weinstr.,23,,79,52,131
004 Eppan a.d. Weinstr.,24,,69,68,137
004 Eppan a.d. Weinstr.,25,,86,80,166
004 Eppan a.d. Weinstr.,26,,68,89,157
004 Eppan a.d. Weinstr.,27,,83,88,171
004 Eppan a.d. Weinstr.,28,,92,115,207
004 Eppan a.d. Weinstr.,29,,109,93,202
004 Eppan a.d. Weinstr.,30,,129,120,249
004 Eppan a.d. Weinstr.,31,,124,117,241
004 Eppan a.d. Weinstr.,32,,110,101,211
004 Eppan a.d. Weinstr.,33,,123,113,236
004 Eppan a.d. Weinstr.,34,,126,137,263
004 Eppan a.d. Weinstr.,35,,104,108,212
004 Eppan a.d. Weinstr.,36,,122,118,240
004 Eppan a.d. Weinstr.,37,,100,128,228
004 Eppan a.d. Weinstr.,38,,118,112,230
004 Eppan a.d. Weinstr.,39,,123,101,224
004 Eppan a.d. Weinstr.,40,,105,111,216
004 Eppan a.d. Weinstr.,41,,120,108,228
004 Eppan a.d. Weinstr.,42,,101,98,199
004 Eppan a.d. Weinstr.,43,,95,92,187
004 Eppan a.d. Weinstr.,44,,87,73,160
004 Eppan a.d. Weinstr.,45,,88,90,178
004 Eppan a.d. Weinstr.,46,,68,90,158
004 Eppan a.d. Weinstr.,47,,85,73,158
004 Eppan a.d. Weinstr.,48,,69,81,150
004 Eppan a.d. Weinstr.,49,,80,65,145
004 Eppan a.d. Weinstr.,50,,61,70,131
004 Eppan a.d. Weinstr.,51,,67,65,132
004 Eppan a.d. Weinstr.,52,,83,67,150
004 Eppan a.d. Weinstr.,53,,71,83,154
004 Eppan a.d. Weinstr.,54,,84,74,158
004 Eppan a.d. Weinstr.,55,,62,51,113
004 Eppan a.d. Weinstr.,56,,72,83,155
004 Eppan a.d. Weinstr.,57,,99,82,181
004 Eppan a.d. Weinstr.,58,,99,82,181
004 Eppan a.d. Weinstr.,59,,68,109,177
004 Eppan a.d. Weinstr.,60,,79,63,142
004 Eppan a.d. Weinstr.,61,,63,83,146
004 Eppan a.d. Weinstr.,62,,62,53,115
004 Eppan a.d. Weinstr.,63,,48,57,105
004 Eppan a.d. Weinstr.,64,,48,50,98
004 Eppan a.d. Weinstr.,65,,46,50,96
004 Eppan a.d. Weinstr.,66,,33,58,91
004 Eppan a.d. Weinstr.,67,,56,58,114
004 Eppan a.d. Weinstr.,68,,50,50,100
004 Eppan a.d. Weinstr.,69,,41,63,104
004 Eppan a.d. Weinstr.,70,,53,69,122
004 Eppan a.d. Weinstr.,71,,48,57,105
004 Eppan a.d. Weinstr.,72,,40,45,85
004 Eppan a.d. Weinstr.,73,,37,50,87
004 Eppan a.d. Weinstr.,74,,45,49,94
004 Eppan a.d. Weinstr.,75,,41,60,101
004 Eppan a.d. Weinstr.,76,,28,69,97
004 Eppan a.d. Weinstr.,77,,26,45,71
004 Eppan a.d. Weinstr.,78,,22,45,67
004 Eppan a.d. Weinstr.,79,,28,49,77
004 Eppan a.d. Weinstr.,80,,17,32,49
004 Eppan a.d. Weinstr.,81,,18,30,48
004 Eppan a.d. Weinstr.,82,,10,17,27
004 Eppan a.d. Weinstr.,83,,12,15,27
004 Eppan a.d. Weinstr.,84,,9,18,27
004 Eppan a.d. Weinstr.,85,,11,14,25
004 Eppan a.d. Weinstr.,86,,12,32,44
004 Eppan a.d. Weinstr.,87,,7,19,26
004 Eppan a.d. Weinstr.,88,,6,22,28
004 Eppan a.d. Weinstr.,89,,6,25,31
004 Eppan a.d. Weinstr.,90,,2,14,16
004 Eppan a.d. Weinstr.,91,,3,11,14
004 Eppan a.d. Weinstr.,92,,1,11,12
004 Eppan a.d. Weinstr.,93,,-,7,7
004 Eppan a.d. Weinstr.,94,,3,3,6
004 Eppan a.d. Weinstr.,95,,1,1,2
004 Eppan a.d. Weinstr.,96,,-,2,2
004 Eppan a.d. Weinstr.,97,,-,2,2
004 Eppan a.d. Weinstr.,98,,-,2,2
004 Eppan a.d. Weinstr.,99,,-,1,1
004 Eppan a.d. Weinstr.,100,,1,-,1
005 Hafling,0,,5,10,15
005 Hafling,1,,4,2,6
005 Hafling,2,,2,7,9
005 Hafling,3,,1,10,11
005 Hafling,4,,12,4,16
005 Hafling,5,,7,5,12
005 Hafling,6,,4,6,10
005 Hafling,7,,3,7,10
005 Hafling,8,,3,5,8
005 Hafling,9,,8,3,11
005 Hafling,10,,5,6,11
005 Hafling,11,,4,2,6
005 Hafling,12,,2,7,9
005 Hafling,13,,4,4,8
005 Hafling,14,,5,3,8
005 Hafling,15,,5,5,10
005 Hafling,16,,5,8,13
005 Hafling,17,,3,-,3
005 Hafling,18,,7,4,11
005 Hafling,19,,5,5,10
005 Hafling,20,,4,10,14
005 Hafling,21,,4,5,9
005 Hafling,22,,3,5,8
005 Hafling,23,,3,3,6
005 Hafling,24,,4,6,10
005 Hafling,25,,8,5,13
005 Hafling,26,,8,6,14
005 Hafling,27,,9,3,12
005 Hafling,28,,9,1,10
005 Hafling,29,,9,5,14
005 Hafling,30,,6,6,12
005 Hafling,31,,8,12,20
005 Hafling,32,,4,9,13
005 Hafling,33,,7,2,9
005 Hafling,34,,11,7,18
005 Hafling,35,,7,10,17
005 Hafling,36,,3,2,5
005 Hafling,37,,6,3,9
005 Hafling,38,,4,3,7
005 Hafling,39,,7,4,11
005 Hafling,40,,9,7,16
005 Hafling,41,,6,6,12
005 Hafling,42,,3,4,7
005 Hafling,43,,1,5,6
005 Hafling,44,,3,9,12
005 Hafling,45,,7,3,10
005 Hafling,46,,3,1,4
005 Hafling,47,,3,3,6
005 Hafling,48,,4,2,6
005 Hafling,49,,2,3,5
005 Hafling,50,,4,3,7
005 Hafling,51,,5,3,8
005 Hafling,52,,8,2,10
005 Hafling,53,,3,4,7
005 Hafling,54,,1,4,5
005 Hafling,55,,5,2,7
005 Hafling,56,,1,2,3
005 Hafling,57,,4,5,9
005 Hafling,58,,5,3,8
005 Hafling,59,,5,4,9
005 Hafling,60,,2,2,4
005 Hafling,61,,3,5,8
005 Hafling,62,,3,3,6
005 Hafling,63,,3,2,5
005 Hafling,64,,1,1,2
005 Hafling,65,,1,1,2
005 Hafling,66,,1,2,3
005 Hafling,67,,6,3,9
005 Hafling,68,,3,4,7
005 Hafling,69,,3,7,10
005 Hafling,70,,2,4,6
005 Hafling,71,,4,1,5
005 Hafling,72,,4,3,7
005 Hafling,73,,4,5,9
005 Hafling,74,,1,2,3
005 Hafling,75,,2,-,2
005 Hafling,76,,1,2,3
005 Hafling,77,,1,-,1
005 Hafling,78,,-,3,3
005 Hafling,79,,-,3,3
005 Hafling,80,,3,1,4
005 Hafling,81,,1,2,3
005 Hafling,83,,-,1,1
005 Hafling,84,,1,2,3
005 Hafling,85,,1,-,1
005 Hafling,86,,1,-,1
005 Hafling,87,,-,3,3
005 Hafling,88,,-,1,1
005 Hafling,89,,1,2,3
005 Hafling,94,,-,1,1
006 Abtei,0,,22,30,52
006 Abtei,1,,22,24,46
006 Abtei,2,,13,12,25
006 Abtei,3,,25,22,47
006 Abtei,4,,29,14,43
006 Abtei,5,,24,26,50
006 Abtei,6,,18,14,32
006 Abtei,7,,15,19,34
006 Abtei,8,,24,16,40
006 Abtei,9,,22,12,34
006 Abtei,10,,22,16,38
006 Abtei,11,,15,14,29
006 Abtei,12,,14,9,23
006 Abtei,13,,19,12,31
006 Abtei,14,,17,18,35
006 Abtei,15,,11,13,24
006 Abtei,16,,12,20,32
006 Abtei,17,,14,11,25
006 Abtei,18,,18,19,37
006 Abtei,19,,17,18,35
006 Abtei,20,,23,15,38
006 Abtei,21,,11,23,34
006 Abtei,22,,22,27,49
006 Abtei,23,,19,28,47
006 Abtei,24,,25,24,49
006 Abtei,25,,18,27,45
006 Abtei,26,,20,24,44
006 Abtei,27,,24,25,49
006 Abtei,28,,41,29,70
006 Abtei,29,,17,33,50
006 Abtei,30,,29,32,61
006 Abtei,31,,27,35,62
006 Abtei,32,,24,33,57
006 Abtei,33,,38,36,74
006 Abtei,34,,21,31,52
006 Abtei,35,,33,26,59
006 Abtei,36,,24,30,54
006 Abtei,37,,29,26,55
006 Abtei,38,,23,29,52
006 Abtei,39,,22,28,50
006 Abtei,40,,26,20,46
006 Abtei,41,,26,23,49
006 Abtei,42,,18,23,41
006 Abtei,43,,19,15,34
006 Abtei,44,,21,17,38
006 Abtei,45,,19,15,34
006 Abtei,46,,11,14,25
006 Abtei,47,,14,18,32
006 Abtei,48,,12,12,24
006 Abtei,49,,12,12,24
006 Abtei,50,,15,20,35
006 Abtei,51,,13,18,31
006 Abtei,52,,25,17,42
006 Abtei,53,,15,15,30
006 Abtei,54,,25,19,44
006 Abtei,55,,15,20,35
006 Abtei,56,,14,18,32
006 Abtei,57,,12,11,23
006 Abtei,58,,21,11,32
006 Abtei,59,,17,25,42
006 Abtei,60,,19,20,39
006 Abtei,61,,17,13,30
006 Abtei,62,,16,18,34
006 Abtei,63,,6,19,25
006 Abtei,64,,21,10,31
006 Abtei,65,,13,20,33
006 Abtei,66,,15,17,32
006 Abtei,67,,11,16,27
006 Abtei,68,,9,6,15
006 Abtei,69,,12,13,25
006 Abtei,70,,18,12,30
006 Abtei,71,,8,8,16
006 Abtei,72,,8,15,23
006 Abtei,73,,7,9,16
006 Abtei,74,,9,6,15
006 Abtei,75,,8,7,15
006 Abtei,76,,6,10,16
006 Abtei,77,,7,13,20
006 Abtei,78,,8,6,14
006 Abtei,79,,5,5,10
006 Abtei,80,,4,13,17
006 Abtei,81,,1,5,6
006 Abtei,82,,2,4,6
006 Abtei,83,,-,3,3
006 Abtei,84,,1,4,5
006 Abtei,85,,1,3,4
006 Abtei,86,,1,3,4
006 Abtei,87,,3,1,4
006 Abtei,88,,2,5,7
006 Abtei,89,,1,4,5
006 Abtei,90,,1,3,4
006 Abtei,91,,2,2,4
006 Abtei,92,,-,3,3
006 Abtei,93,,-,1,1
006 Abtei,94,,-,1,1
007 Barbian,0,,13,6,19
007 Barbian,1,,8,10,18
007 Barbian,2,,16,9,25
007 Barbian,3,,12,7,19
007 Barbian,4,,9,10,19
007 Barbian,5,,10,8,18
007 Barbian,6,,7,4,11
007 Barbian,7,,10,12,22
007 Barbian,8,,11,7,18
007 Barbian,9,,11,10,21
007 Barbian,10,,14,13,27
007 Barbian,11,,8,13,21
007 Barbian,12,,11,5,16
007 Barbian,13,,7,6,13
007 Barbian,14,,13,8,21
007 Barbian,15,,7,9,16
007 Barbian,16,,9,7,16
007 Barbian,17,,11,7,18
007 Barbian,18,,9,5,14
007 Barbian,19,,13,13,26
007 Barbian,20,,8,6,14
007 Barbian,21,,18,14,32
007 Barbian,22,,10,10,20
007 Barbian,23,,7,18,25
007 Barbian,24,,7,14,21
007 Barbian,25,,9,9,18
007 Barbian,26,,14,14,28
007 Barbian,27,,8,17,25
007 Barbian,28,,23,15,38
007 Barbian,29,,14,13,27
007 Barbian,30,,10,11,21
007 Barbian,31,,17,3,20
007 Barbian,32,,12,10,22
007 Barbian,33,,8,8,16
007 Barbian,34,,11,14,25
007 Barbian,35,,9,11,20
007 Barbian,36,,15,13,28
007 Barbian,37,,13,13,26
007 Barbian,38,,16,13,29
007 Barbian,39,,19,10,29
007 Barbian,40,,13,15,28
007 Barbian,41,,12,9,21
007 Barbian,42,,7,8,15
007 Barbian,43,,15,7,22
007 Barbian,44,,5,9,14
007 Barbian,45,,9,7,16
007 Barbian,46,,5,15,20
007 Barbian,47,,10,8,18
007 Barbian,48,,7,5,12
007 Barbian,49,,7,11,18
007 Barbian,50,,12,11,23
007 Barbian,51,,6,5,11
007 Barbian,52,,4,4,8
007 Barbian,53,,6,10,16
007 Barbian,54,,18,7,25
007 Barbian,55,,8,4,12
007 Barbian,56,,12,8,20
007 Barbian,57,,9,6,15
007 Barbian,58,,11,12,23
007 Barbian,59,,8,12,20
007 Barbian,60,,8,3,11
007 Barbian,61,,6,5,11
007 Barbian,62,,5,10,15
007 Barbian,63,,8,8,16
007 Barbian,64,,3,6,9
007 Barbian,65,,3,8,11
007 Barbian,66,,6,5,11
007 Barbian,67,,8,5,13
007 Barbian,68,,4,7,11
007 Barbian,69,,4,8,12
007 Barbian,70,,7,6,13
007 Barbian,71,,8,8,16
007 Barbian,72,,5,9,14
007 Barbian,73,,5,4,9
007 Barbian,74,,4,3,7
007 Barbian,75,,9,3,12
007 Barbian,76,,4,6,10
007 Barbian,77,,3,9,12
007 Barbian,78,,3,6,9
007 Barbian,79,,2,3,5
007 Barbian,80,,2,3,5
007 Barbian,81,,1,3,4
007 Barbian,82,,1,1,2
007 Barbian,83,,-,1,1
007 Barbian,84,,1,1,2
007 Barbian,85,,-,4,4
007 Barbian,86,,4,6,10
007 Barbian,87,,-,4,4
007 Barbian,89,,3,1,4
007 Barbian,90,,3,1,4
007 Barbian,91,,-,1,1
007 Barbian,92,,-,1,1
007 Barbian,96,,-,1,1
008 Bozen,0,,410,426,836
008 Bozen,1,,475,439,914
008 Bozen,2,,412,433,845
008 Bozen,3,,453,374,827
008 Bozen,4,,417,432,849
008 Bozen,5,,413,372,785
008 Bozen,6,,441,416,857
008 Bozen,7,,398,387,785
008 Bozen,8,,416,379,795
008 Bozen,9,,458,377,835
008 Bozen,10,,437,393,830
008 Bozen,11,,420,386,806
008 Bozen,12,,407,399,806
008 Bozen,13,,343,377,720
008 Bozen,14,,371,355,726
008 Bozen,15,,399,368,767
008 Bozen,16,,378,373,751
008 Bozen,17,,416,348,764
008 Bozen,18,,410,390,800
008 Bozen,19,,405,391,796
008 Bozen,20,,455,392,847
008 Bozen,21,,415,429,844
008 Bozen,22,,483,432,915
008 Bozen,23,,531,453,984
008 Bozen,24,,532,527,1.059
008 Bozen,25,,636,602,1.238
008 Bozen,26,,689,641,1.330
008 Bozen,27,,712,737,1.449
008 Bozen,28,,805,731,1.536
008 Bozen,29,,900,806,1.706
008 Bozen,30,,861,739,1.600
008 Bozen,31,,911,794,1.705
008 Bozen,32,,812,753,1.565
008 Bozen,33,,826,781,1.607
008 Bozen,34,,894,838,1.732
008 Bozen,35,,916,845,1.761
008 Bozen,36,,915,890,1.805
008 Bozen,37,,799,794,1.593
008 Bozen,38,,782,771,1.553
008 Bozen,39,,808,707,1.515
008 Bozen,40,,712,673,1.385
008 Bozen,41,,702,672,1.374
008 Bozen,42,,700,675,1.375
008 Bozen,43,,639,708,1.347
008 Bozen,44,,649,645,1.294
008 Bozen,45,,641,624,1.265
008 Bozen,46,,632,584,1.216
008 Bozen,47,,554,603,1.157
008 Bozen,48,,560,645,1.205
008 Bozen,49,,546,641,1.187
008 Bozen,50,,621,684,1.305
008 Bozen,51,,635,652,1.287
008 Bozen,52,,673,730,1.403
008 Bozen,53,,672,809,1.481
008 Bozen,54,,757,884,1.641
008 Bozen,55,,568,610,1.178
008 Bozen,56,,619,748,1.367
008 Bozen,57,,656,744,1.400
008 Bozen,58,,679,742,1.421
008 Bozen,59,,743,786,1.529
008 Bozen,60,,711,757,1.468
008 Bozen,61,,624,750,1.374
008 Bozen,62,,677,686,1.363
008 Bozen,63,,573,606,1.179
008 Bozen,64,,530,593,1.123
008 Bozen,65,,508,600,1.108
008 Bozen,66,,529,591,1.120
008 Bozen,67,,456,590,1.046
008 Bozen,68,,470,601,1.071
008 Bozen,69,,475,590,1.065
008 Bozen,70,,486,602,1.088
008 Bozen,71,,378,587,965
008 Bozen,72,,406,540,946
008 Bozen,73,,375,539,914
008 Bozen,74,,431,529,960
008 Bozen,75,,331,569,900
008 Bozen,76,,324,549,873
008 Bozen,77,,335,550,885
008 Bozen,78,,325,579,904
008 Bozen,79,,262,526,788
008 Bozen,80,,254,517,771
008 Bozen,81,,139,315,454
008 Bozen,82,,89,198,287
008 Bozen,83,,99,195,294
008 Bozen,84,,103,206,309
008 Bozen,85,,127,288,415
008 Bozen,86,,119,263,382
008 Bozen,87,,112,259,371
008 Bozen,88,,96,238,334
008 Bozen,89,,60,192,252
008 Bozen,90,,52,142,194
008 Bozen,91,,38,120,158
008 Bozen,92,,31,97,128
008 Bozen,93,,11,64,75
008 Bozen,94,,14,57,71
008 Bozen,95,,7,32,39
008 Bozen,96,,4,28,32
008 Bozen,97,,-,23,23
008 Bozen,98,,4,11,15
008 Bozen,99,,1,6,7
008 Bozen,100,,-,3,3
008 Bozen,101,,-,2,2
008 Bozen,102,,-,3,3
008 Bozen,103,,-,2,2
009 Prags,0,,2,2,4
009 Prags,1,,4,6,10
009 Prags,2,,1,5,6
009 Prags,3,,3,4,7
009 Prags,4,,2,4,6
009 Prags,5,,2,2,4
009 Prags,6,,4,5,9
009 Prags,7,,7,4,11
009 Prags,8,,6,3,9
009 Prags,9,,9,2,11
009 Prags,10,,4,2,6
009 Prags,11,,9,3,12
009 Prags,12,,2,3,5
009 Prags,13,,3,3,6
009 Prags,14,,6,5,11
009 Prags,15,,8,2,10
009 Prags,16,,4,3,7
009 Prags,17,,3,7,10
009 Prags,18,,3,5,8
009 Prags,19,,1,6,7
009 Prags,20,,4,1,5
009 Prags,21,,2,1,3
009 Prags,22,,6,2,8
009 Prags,23,,4,3,7
009 Prags,24,,6,2,8
009 Prags,25,,3,6,9
009 Prags,26,,4,3,7
009 Prags,27,,7,7,14
009 Prags,28,,4,-,4
009 Prags,29,,5,3,8
009 Prags,30,,5,5,10
009 Prags,31,,7,5,12
009 Prags,32,,7,8,15
009 Prags,33,,5,9,14
009 Prags,34,,8,4,12
009 Prags,35,,8,8,16
009 Prags,36,,6,5,11
009 Prags,37,,7,5,12
009 Prags,38,,4,4,8
009 Prags,39,,5,10,15
009 Prags,40,,7,3,10
009 Prags,41,,12,5,17
009 Prags,42,,5,2,7
009 Prags,43,,5,4,9
009 Prags,44,,2,5,7
009 Prags,45,,3,4,7
009 Prags,46,,6,4,10
009 Prags,47,,4,2,6
009 Prags,48,,2,5,7
009 Prags,49,,3,1,4
009 Prags,50,,5,1,6
009 Prags,51,,1,2,3
009 Prags,52,,5,1,6
009 Prags,53,,1,-,1
009 Prags,54,,2,4,6
009 Prags,55,,2,2,4
009 Prags,56,,4,5,9
009 Prags,57,,1,4,5
009 Prags,58,,4,4,8
009 Prags,59,,5,2,7
009 Prags,60,,1,3,4
009 Prags,61,,3,5,8
009 Prags,62,,4,2,6
009 Prags,63,,1,3,4
009 Prags,64,,2,3,5
009 Prags,65,,1,3,4
009 Prags,66,,3,2,5
009 Prags,67,,5,2,7
009 Prags,68,,5,7,12
009 Prags,69,,1,4,5
009 Prags,70,,1,1,2
009 Prags,71,,3,1,4
009 Prags,72,,3,2,5
009 Prags,73,,3,6,9
009 Prags,74,,3,4,7
009 Prags,75,,1,5,6
009 Prags,76,,4,2,6
009 Prags,77,,-,4,4
009 Prags,78,,3,2,5
009 Prags,79,,2,3,5
009 Prags,80,,1,1,2
009 Prags,81,,1,3,4
009 Prags,83,,2,2,4
009 Prags,84,,-,1,1
009 Prags,85,,1,1,2
009 Prags,86,,-,1,1
009 Prags,87,,-,1,1
009 Prags,88,,-,1,1
009 Prags,89,,-,1,1
009 Prags,91,,1,-,1
009 Prags,92,,-,1,1
010 Brenner,0,,14,14,28
010 Brenner,1,,11,16,27
010 Brenner,2,,18,4,22
010 Brenner,3,,14,6,20
010 Brenner,4,,7,10,17
010 Brenner,5,,8,8,16
010 Brenner,6,,21,13,34
010 Brenner,7,,11,9,20
010 Brenner,8,,10,8,18
010 Brenner,9,,7,20,27
010 Brenner,10,,11,8,19
010 Brenner,11,,15,5,20
010 Brenner,12,,12,5,17
010 Brenner,13,,6,9,15
010 Brenner,14,,12,11,23
010 Brenner,15,,19,8,27
010 Brenner,16,,15,18,33
010 Brenner,17,,18,19,37
010 Brenner,18,,14,6,20
010 Brenner,19,,8,14,22
010 Brenner,20,,10,15,25
010 Brenner,21,,12,10,22
010 Brenner,22,,17,13,30
010 Brenner,23,,17,11,28
010 Brenner,24,,17,11,28
010 Brenner,25,,13,21,34
010 Brenner,26,,16,12,28
010 Brenner,27,,13,15,28
010 Brenner,28,,18,23,41
010 Brenner,29,,28,14,42
010 Brenner,30,,27,22,49
010 Brenner,31,,20,17,37
010 Brenner,32,,15,21,36
010 Brenner,33,,14,20,34
010 Brenner,34,,20,13,33
010 Brenner,35,,22,21,43
010 Brenner,36,,25,16,41
010 Brenner,37,,14,20,34
010 Brenner,38,,22,13,35
010 Brenner,39,,25,13,38
010 Brenner,40,,23,12,35
010 Brenner,41,,19,13,32
010 Brenner,42,,18,9,27
010 Brenner,43,,17,19,36
010 Brenner,44,,17,13,30
010 Brenner,45,,15,9,24
010 Brenner,46,,11,16,27
010 Brenner,47,,10,16,26
010 Brenner,48,,20,10,30
010 Brenner,49,,16,11,27
010 Brenner,50,,15,13,28
010 Brenner,51,,17,16,33
010 Brenner,52,,5,9,14
010 Brenner,53,,21,13,34
010 Brenner,54,,10,17,27
010 Brenner,55,,8,8,16
010 Brenner,56,,20,13,33
010 Brenner,57,,22,14,36
010 Brenner,58,,7,9,16
010 Brenner,59,,11,12,23
010 Brenner,60,,12,12,24
010 Brenner,61,,10,7,17
010 Brenner,62,,11,17,28
010 Brenner,63,,9,14,23
010 Brenner,64,,13,7,20
010 Brenner,65,,6,6,12
010 Brenner,66,,10,9,19
010 Brenner,67,,7,8,15
010 Brenner,68,,2,4,6
010 Brenner,69,,8,10,18
010 Brenner,70,,8,12,20
010 Brenner,71,,12,10,22
010 Brenner,72,,8,10,18
010 Brenner,73,,7,4,11
010 Brenner,74,,10,9,19
010 Brenner,75,,4,10,14
010 Brenner,76,,3,10,13
010 Brenner,77,,5,10,15
010 Brenner,78,,1,9,10
010 Brenner,79,,3,4,7
010 Brenner,80,,4,8,12
010 Brenner,81,,3,3,6
010 Brenner,82,,2,1,3
010 Brenner,83,,1,6,7
010 Brenner,84,,2,-,2
010 Brenner,85,,2,3,5
010 Brenner,86,,1,6,7
010 Brenner,87,,-,3,3
010 Brenner,88,,-,4,4
010 Brenner,89,,4,1,5
010 Brenner,90,,-,3,3
010 Brenner,91,,-,2,2
010 Brenner,92,,1,-,1
010 Brenner,94,,-,1,1
010 Brenner,96,,-,1,1
011 Brixen,0,,111,117,228
011 Brixen,1,,128,117,245
011 Brixen,2,,112,139,251
011 Brixen,3,,109,94,203
011 Brixen,4,,113,109,222
011 Brixen,5,,103,108,211
011 Brixen,6,,118,115,233
011 Brixen,7,,100,101,201
011 Brixen,8,,111,116,227
011 Brixen,9,,109,103,212
011 Brixen,10,,97,107,204
011 Brixen,11,,108,89,197
011 Brixen,12,,111,99,210
011 Brixen,13,,99,89,188
011 Brixen,14,,99,110,209
011 Brixen,15,,113,90,203
011 Brixen,16,,115,86,201
011 Brixen,17,,113,121,234
011 Brixen,18,,117,102,219
011 Brixen,19,,108,98,206
011 Brixen,20,,93,101,194
011 Brixen,21,,121,92,213
011 Brixen,22,,85,99,184
011 Brixen,23,,118,106,224
011 Brixen,24,,127,114,241
011 Brixen,25,,105,104,209
011 Brixen,26,,133,131,264
011 Brixen,27,,145,145,290
011 Brixen,28,,140,142,282
011 Brixen,29,,143,152,295
011 Brixen,30,,172,149,321
011 Brixen,31,,183,183,366
011 Brixen,32,,173,177,350
011 Brixen,33,,174,158,332
011 Brixen,34,,177,189,366
011 Brixen,35,,180,151,331
011 Brixen,36,,184,181,365
011 Brixen,37,,155,168,323
011 Brixen,38,,159,156,315
011 Brixen,39,,136,161,297
011 Brixen,40,,152,149,301
011 Brixen,41,,150,140,290
011 Brixen,42,,156,112,268
011 Brixen,43,,137,133,270
011 Brixen,44,,106,138,244
011 Brixen,45,,122,95,217
011 Brixen,46,,96,107,203
011 Brixen,47,,85,104,189
011 Brixen,48,,106,99,205
011 Brixen,49,,99,105,204
011 Brixen,50,,107,101,208
011 Brixen,51,,80,122,202
011 Brixen,52,,116,119,235
011 Brixen,53,,90,112,202
011 Brixen,54,,107,111,218
011 Brixen,55,,69,98,167
011 Brixen,56,,118,106,224
011 Brixen,57,,136,121,257
011 Brixen,58,,96,97,193
011 Brixen,59,,108,121,229
011 Brixen,60,,91,125,216
011 Brixen,61,,101,107,208
011 Brixen,62,,92,99,191
011 Brixen,63,,87,99,186
011 Brixen,64,,72,93,165
011 Brixen,65,,79,84,163
011 Brixen,66,,82,100,182
011 Brixen,67,,80,69,149
011 Brixen,68,,73,84,157
011 Brixen,69,,76,88,164
011 Brixen,70,,73,100,173
011 Brixen,71,,58,101,159
011 Brixen,72,,68,80,148
011 Brixen,73,,50,98,148
011 Brixen,74,,51,77,128
011 Brixen,75,,60,83,143
011 Brixen,76,,51,84,135
011 Brixen,77,,49,67,116
011 Brixen,78,,43,83,126
011 Brixen,79,,32,84,116
011 Brixen,80,,36,65,101
011 Brixen,81,,23,51,74
011 Brixen,82,,17,33,50
011 Brixen,83,,17,40,57
011 Brixen,84,,8,25,33
011 Brixen,85,,10,33,43
011 Brixen,86,,21,45,66
011 Brixen,87,,11,42,53
011 Brixen,88,,11,39,50
011 Brixen,89,,8,37,45
011 Brixen,90,,10,36,46
011 Brixen,91,,7,15,22
011 Brixen,92,,5,20,25
011 Brixen,93,,3,12,15
011 Brixen,94,,1,9,10
011 Brixen,95,,2,3,5
011 Brixen,96,,1,2,3
011 Brixen,98,,-,3,3
011 Brixen,99,,-,4,4
011 Brixen,100,,-,2,2
012 Branzoll,0,,21,11,32
012 Branzoll,1,,10,12,22
012 Branzoll,2,,13,9,22
012 Branzoll,3,,12,21,33
012 Branzoll,4,,17,8,25
012 Branzoll,5,,12,11,23
012 Branzoll,6,,17,7,24
012 Branzoll,7,,16,13,29
012 Branzoll,8,,13,11,24
012 Branzoll,9,,12,16,28
012 Branzoll,10,,8,17,25
012 Branzoll,11,,11,12,23
012 Branzoll,12,,15,13,28
012 Branzoll,13,,11,5,16
012 Branzoll,14,,9,12,21
012 Branzoll,15,,12,14,26
012 Branzoll,16,,14,10,24
012 Branzoll,17,,13,11,24
012 Branzoll,18,,16,12,28
012 Branzoll,19,,15,13,28
012 Branzoll,20,,8,14,22
012 Branzoll,21,,11,5,16
012 Branzoll,22,,10,15,25
012 Branzoll,23,,10,13,23
012 Branzoll,24,,14,12,26
012 Branzoll,25,,13,9,22
012 Branzoll,26,,19,21,40
012 Branzoll,27,,21,17,38
012 Branzoll,28,,18,13,31
012 Branzoll,29,,16,16,32
012 Branzoll,30,,19,27,46
012 Branzoll,31,,24,18,42
012 Branzoll,32,,20,19,39
012 Branzoll,33,,22,22,44
012 Branzoll,34,,20,22,42
012 Branzoll,35,,20,24,44
012 Branzoll,36,,31,25,56
012 Branzoll,37,,19,18,37
012 Branzoll,38,,18,17,35
012 Branzoll,39,,31,26,57
012 Branzoll,40,,23,21,44
012 Branzoll,41,,12,22,34
012 Branzoll,42,,20,15,35
012 Branzoll,43,,25,18,43
012 Branzoll,44,,13,16,29
012 Branzoll,45,,16,18,34
012 Branzoll,46,,22,15,37
012 Branzoll,47,,12,21,33
012 Branzoll,48,,14,18,32
012 Branzoll,49,,15,15,30
012 Branzoll,50,,18,15,33
012 Branzoll,51,,16,15,31
012 Branzoll,52,,15,17,32
012 Branzoll,53,,13,17,30
012 Branzoll,54,,15,21,36
012 Branzoll,55,,14,8,22
012 Branzoll,56,,11,11,22
012 Branzoll,57,,15,13,28
012 Branzoll,58,,19,7,26
012 Branzoll,59,,18,11,29
012 Branzoll,60,,11,13,24
012 Branzoll,61,,16,13,29
012 Branzoll,62,,9,11,20
012 Branzoll,63,,5,11,16
012 Branzoll,64,,10,10,20
012 Branzoll,65,,7,10,17
012 Branzoll,66,,5,12,17
012 Branzoll,67,,19,11,30
012 Branzoll,68,,10,11,21
012 Branzoll,69,,3,10,13
012 Branzoll,70,,9,17,26
012 Branzoll,71,,7,10,17
012 Branzoll,72,,7,11,18
012 Branzoll,73,,4,8,12
012 Branzoll,74,,9,11,20
012 Branzoll,75,,5,6,11
012 Branzoll,76,,4,9,13
012 Branzoll,77,,9,11,20
012 Branzoll,78,,4,5,9
012 Branzoll,79,,5,10,15
012 Branzoll,80,,1,6,7
012 Branzoll,81,,2,6,8
012 Branzoll,82,,3,4,7
012 Branzoll,83,,-,3,3
012 Branzoll,84,,2,1,3
012 Branzoll,85,,2,1,3
012 Branzoll,86,,-,5,5
012 Branzoll,87,,2,7,9
012 Branzoll,88,,1,4,5
012 Branzoll,89,,2,3,5
012 Branzoll,90,,1,2,3
012 Branzoll,91,,1,3,4
012 Branzoll,92,,-,2,2
012 Branzoll,93,,3,-,3
012 Branzoll,94,,1,-,1
012 Branzoll,95,,-,1,1
013 Bruneck,0,,72,85,157
013 Bruneck,1,,97,92,189
013 Bruneck,2,,92,85,177
013 Bruneck,3,,106,64,170
013 Bruneck,4,,76,83,159
013 Bruneck,5,,59,73,132
013 Bruneck,6,,88,74,162
013 Bruneck,7,,73,71,144
013 Bruneck,8,,88,70,158
013 Bruneck,9,,83,54,137
013 Bruneck,10,,84,70,154
013 Bruneck,11,,74,75,149
013 Bruneck,12,,63,73,136
013 Bruneck,13,,59,60,119
013 Bruneck,14,,101,70,171
013 Bruneck,15,,72,67,139
013 Bruneck,16,,76,73,149
013 Bruneck,17,,68,73,141
013 Bruneck,18,,69,70,139
013 Bruneck,19,,85,87,172
013 Bruneck,20,,98,89,187
013 Bruneck,21,,85,94,179
013 Bruneck,22,,113,88,201
013 Bruneck,23,,100,79,179
013 Bruneck,24,,90,94,184
013 Bruneck,25,,100,113,213
013 Bruneck,26,,110,97,207
013 Bruneck,27,,119,116,235
013 Bruneck,28,,123,120,243
013 Bruneck,29,,134,123,257
013 Bruneck,30,,117,134,251
013 Bruneck,31,,124,116,240
013 Bruneck,32,,117,135,252
013 Bruneck,33,,129,113,242
013 Bruneck,34,,129,112,241
013 Bruneck,35,,136,130,266
013 Bruneck,36,,131,127,258
013 Bruneck,37,,122,112,234
013 Bruneck,38,,120,113,233
013 Bruneck,39,,115,99,214
013 Bruneck,40,,103,113,216
013 Bruneck,41,,107,102,209
013 Bruneck,42,,106,101,207
013 Bruneck,43,,85,100,185
013 Bruneck,44,,85,91,176
013 Bruneck,45,,83,79,162
013 Bruneck,46,,89,87,176
013 Bruneck,47,,69,99,168
013 Bruneck,48,,85,98,183
013 Bruneck,49,,74,91,165
013 Bruneck,50,,87,95,182
013 Bruneck,51,,86,90,176
013 Bruneck,52,,81,108,189
013 Bruneck,53,,93,69,162
013 Bruneck,54,,99,82,181
013 Bruneck,55,,59,69,128
013 Bruneck,56,,91,92,183
013 Bruneck,57,,99,88,187
013 Bruneck,58,,96,89,185
013 Bruneck,59,,79,95,174
013 Bruneck,60,,80,86,166
013 Bruneck,61,,87,89,176
013 Bruneck,62,,59,53,112
013 Bruneck,63,,55,60,115
013 Bruneck,64,,58,55,113
013 Bruneck,65,,49,52,101
013 Bruneck,66,,49,50,99
013 Bruneck,67,,55,65,120
013 Bruneck,68,,59,51,110
013 Bruneck,69,,40,54,94
013 Bruneck,70,,43,64,107
013 Bruneck,71,,37,59,96
013 Bruneck,72,,45,63,108
013 Bruneck,73,,31,53,84
013 Bruneck,74,,30,41,71
013 Bruneck,75,,31,47,78
013 Bruneck,76,,20,62,82
013 Bruneck,77,,37,48,85
013 Bruneck,78,,30,48,78
013 Bruneck,79,,22,35,57
013 Bruneck,80,,20,42,62
013 Bruneck,81,,15,31,46
013 Bruneck,82,,7,23,30
013 Bruneck,83,,6,21,27
013 Bruneck,84,,4,29,33
013 Bruneck,85,,8,19,27
013 Bruneck,86,,9,25,34
013 Bruneck,87,,7,34,41
013 Bruneck,88,,11,22,33
013 Bruneck,89,,4,21,25
013 Bruneck,90,,7,15,22
013 Bruneck,91,,9,9,18
013 Bruneck,92,,3,14,17
013 Bruneck,93,,2,6,8
013 Bruneck,94,,2,8,10
013 Bruneck,95,,3,3,6
013 Bruneck,97,,1,4,5
013 Bruneck,98,,-,3,3
013 Bruneck,100,,-,1,1
014 Kuens,0,,2,4,6
014 Kuens,1,,3,2,5
014 Kuens,2,,2,4,6
014 Kuens,3,,1,1,2
014 Kuens,4,,5,2,7
014 Kuens,5,,2,3,5
014 Kuens,6,,1,4,5
014 Kuens,7,,3,3,6
014 Kuens,8,,3,2,5
014 Kuens,9,,2,2,4
014 Kuens,10,,3,2,5
014 Kuens,11,,3,2,5
014 Kuens,12,,1,3,4
014 Kuens,13,,3,-,3
014 Kuens,14,,1,-,1
014 Kuens,16,,1,-,1
014 Kuens,17,,2,2,4
014 Kuens,18,,2,-,2
014 Kuens,19,,2,-,2
014 Kuens,20,,3,2,5
014 Kuens,21,,1,1,2
014 Kuens,22,,2,-,2
014 Kuens,23,,2,3,5
014 Kuens,24,,3,2,5
014 Kuens,25,,5,1,6
014 Kuens,26,,4,7,11
014 Kuens,27,,-,4,4
014 Kuens,28,,4,1,5
014 Kuens,29,,1,3,4
014 Kuens,30,,7,2,9
014 Kuens,31,,4,2,6
014 Kuens,32,,3,4,7
014 Kuens,33,,4,8,12
014 Kuens,34,,3,5,8
014 Kuens,35,,8,1,9
014 Kuens,36,,5,5,10
014 Kuens,37,,9,2,11
014 Kuens,38,,5,3,8
014 Kuens,39,,-,4,4
014 Kuens,41,,1,-,1
014 Kuens,42,,-,4,4
014 Kuens,43,,3,-,3
014 Kuens,44,,3,-,3
014 Kuens,45,,1,2,3
014 Kuens,47,,1,1,2
014 Kuens,48,,-,1,1
014 Kuens,50,,1,3,4
014 Kuens,51,,-,2,2
014 Kuens,52,,2,1,3
014 Kuens,53,,1,1,2
014 Kuens,54,,1,2,3
014 Kuens,55,,3,1,4
014 Kuens,57,,-,2,2
014 Kuens,58,,-,4,4
014 Kuens,59,,-,2,2
014 Kuens,60,,-,1,1
014 Kuens,61,,4,2,6
014 Kuens,62,,3,2,5
014 Kuens,63,,1,3,4
014 Kuens,64,,2,2,4
014 Kuens,65,,1,3,4
014 Kuens,66,,-,1,1
014 Kuens,67,,2,1,3
014 Kuens,68,,4,2,6
014 Kuens,69,,2,2,4
014 Kuens,70,,2,2,4
014 Kuens,71,,1,-,1
014 Kuens,72,,1,-,1
014 Kuens,73,,1,1,2
014 Kuens,74,,1,-,1
014 Kuens,78,,-,2,2
014 Kuens,81,,-,1,1
014 Kuens,84,,-,1,1
014 Kuens,85,,1,-,1
014 Kuens,87,,-,1,1
014 Kuens,88,,1,-,1
014 Kuens,90,,1,-,1
014 Kuens,92,,-,1,1
015 Kaltern a.d. Weinstr.,0,,33,39,72
015 Kaltern a.d. Weinstr.,1,,43,32,75
015 Kaltern a.d. Weinstr.,2,,37,44,81
015 Kaltern a.d. Weinstr.,3,,39,44,83
015 Kaltern a.d. Weinstr.,4,,35,43,78
015 Kaltern a.d. Weinstr.,5,,41,39,80
015 Kaltern a.d. Weinstr.,6,,34,37,71
015 Kaltern a.d. Weinstr.,7,,30,38,68
015 Kaltern a.d. Weinstr.,8,,40,35,75
015 Kaltern a.d. Weinstr.,9,,29,41,70
015 Kaltern a.d. Weinstr.,10,,35,37,72
015 Kaltern a.d. Weinstr.,11,,53,24,77
015 Kaltern a.d. Weinstr.,12,,40,35,75
015 Kaltern a.d. Weinstr.,13,,40,31,71
015 Kaltern a.d. Weinstr.,14,,52,41,93
015 Kaltern a.d. Weinstr.,15,,48,36,84
015 Kaltern a.d. Weinstr.,16,,38,35,73
015 Kaltern a.d. Weinstr.,17,,39,40,79
015 Kaltern a.d. Weinstr.,18,,41,43,84
015 Kaltern a.d. Weinstr.,19,,44,36,80
015 Kaltern a.d. Weinstr.,20,,42,40,82
015 Kaltern a.d. Weinstr.,21,,43,36,79
015 Kaltern a.d. Weinstr.,22,,40,27,67
015 Kaltern a.d. Weinstr.,23,,29,38,67
015 Kaltern a.d. Weinstr.,24,,38,46,84
015 Kaltern a.d. Weinstr.,25,,33,44,77
015 Kaltern a.d. Weinstr.,26,,53,47,100
015 Kaltern a.d. Weinstr.,27,,36,44,80
015 Kaltern a.d. Weinstr.,28,,44,55,99
015 Kaltern a.d. Weinstr.,29,,53,49,102
015 Kaltern a.d. Weinstr.,30,,61,55,116
015 Kaltern a.d. Weinstr.,31,,55,66,121
015 Kaltern a.d. Weinstr.,32,,68,65,133
015 Kaltern a.d. Weinstr.,33,,61,60,121
015 Kaltern a.d. Weinstr.,34,,57,65,122
015 Kaltern a.d. Weinstr.,35,,56,61,117
015 Kaltern a.d. Weinstr.,36,,83,55,138
015 Kaltern a.d. Weinstr.,37,,56,55,111
015 Kaltern a.d. Weinstr.,38,,65,61,126
015 Kaltern a.d. Weinstr.,39,,64,62,126
015 Kaltern a.d. Weinstr.,40,,54,62,116
015 Kaltern a.d. Weinstr.,41,,53,48,101
015 Kaltern a.d. Weinstr.,42,,59,58,117
015 Kaltern a.d. Weinstr.,43,,52,57,109
015 Kaltern a.d. Weinstr.,44,,63,43,106
015 Kaltern a.d. Weinstr.,45,,53,38,91
015 Kaltern a.d. Weinstr.,46,,35,47,82
015 Kaltern a.d. Weinstr.,47,,35,37,72
015 Kaltern a.d. Weinstr.,48,,38,54,92
015 Kaltern a.d. Weinstr.,49,,33,33,66
015 Kaltern a.d. Weinstr.,50,,43,34,77
015 Kaltern a.d. Weinstr.,51,,32,36,68
015 Kaltern a.d. Weinstr.,52,,39,37,76
015 Kaltern a.d. Weinstr.,53,,36,59,95
015 Kaltern a.d. Weinstr.,54,,50,39,89
015 Kaltern a.d. Weinstr.,55,,38,37,75
015 Kaltern a.d. Weinstr.,56,,42,46,88
015 Kaltern a.d. Weinstr.,57,,40,37,77
015 Kaltern a.d. Weinstr.,58,,38,43,81
015 Kaltern a.d. Weinstr.,59,,42,43,85
015 Kaltern a.d. Weinstr.,60,,32,42,74
015 Kaltern a.d. Weinstr.,61,,25,34,59
015 Kaltern a.d. Weinstr.,62,,41,42,83
015 Kaltern a.d. Weinstr.,63,,30,34,64
015 Kaltern a.d. Weinstr.,64,,22,25,47
015 Kaltern a.d. Weinstr.,65,,26,27,53
015 Kaltern a.d. Weinstr.,66,,28,26,54
015 Kaltern a.d. Weinstr.,67,,29,37,66
015 Kaltern a.d. Weinstr.,68,,30,31,61
015 Kaltern a.d. Weinstr.,69,,27,38,65
015 Kaltern a.d. Weinstr.,70,,32,41,73
015 Kaltern a.d. Weinstr.,71,,26,33,59
015 Kaltern a.d. Weinstr.,72,,23,35,58
015 Kaltern a.d. Weinstr.,73,,20,40,60
015 Kaltern a.d. Weinstr.,74,,20,32,52
015 Kaltern a.d. Weinstr.,75,,19,39,58
015 Kaltern a.d. Weinstr.,76,,19,32,51
015 Kaltern a.d. Weinstr.,77,,14,34,48
015 Kaltern a.d. Weinstr.,78,,18,31,49
015 Kaltern a.d. Weinstr.,79,,17,37,54
015 Kaltern a.d. Weinstr.,80,,11,27,38
015 Kaltern a.d. Weinstr.,81,,8,17,25
015 Kaltern a.d. Weinstr.,82,,7,9,16
015 Kaltern a.d. Weinstr.,83,,2,12,14
015 Kaltern a.d. Weinstr.,84,,2,4,6
015 Kaltern a.d. Weinstr.,85,,4,15,19
015 Kaltern a.d. Weinstr.,86,,5,13,18
015 Kaltern a.d. Weinstr.,87,,8,16,24
015 Kaltern a.d. Weinstr.,88,,5,20,25
015 Kaltern a.d. Weinstr.,89,,2,7,9
015 Kaltern a.d. Weinstr.,90,,1,3,4
015 Kaltern a.d. Weinstr.,91,,3,6,9
015 Kaltern a.d. Weinstr.,92,,2,4,6
015 Kaltern a.d. Weinstr.,93,,-,5,5
015 Kaltern a.d. Weinstr.,94,,-,1,1
015 Kaltern a.d. Weinstr.,95,,-,1,1
015 Kaltern a.d. Weinstr.,96,,-,2,2
015 Kaltern a.d. Weinstr.,97,,-,1,1
016 Freienfeld,0,,17,15,32
016 Freienfeld,1,,16,21,37
016 Freienfeld,2,,13,15,28
016 Freienfeld,3,,23,15,38
016 Freienfeld,4,,22,13,35
016 Freienfeld,5,,13,13,26
016 Freienfeld,6,,13,9,22
016 Freienfeld,7,,15,11,26
016 Freienfeld,8,,19,21,40
016 Freienfeld,9,,10,13,23
016 Freienfeld,10,,19,18,37
016 Freienfeld,11,,26,20,46
016 Freienfeld,12,,19,14,33
016 Freienfeld,13,,17,15,32
016 Freienfeld,14,,14,12,26
016 Freienfeld,15,,15,13,28
016 Freienfeld,16,,21,15,36
016 Freienfeld,17,,21,19,40
016 Freienfeld,18,,14,16,30
016 Freienfeld,19,,23,21,44
016 Freienfeld,20,,18,16,34
016 Freienfeld,21,,20,19,39
016 Freienfeld,22,,13,17,30
016 Freienfeld,23,,14,19,33
016 Freienfeld,24,,17,11,28
016 Freienfeld,25,,16,22,38
016 Freienfeld,26,,20,19,39
016 Freienfeld,27,,23,20,43
016 Freienfeld,28,,19,24,43
016 Freienfeld,29,,22,22,44
016 Freienfeld,30,,20,14,34
016 Freienfeld,31,,22,23,45
016 Freienfeld,32,,22,22,44
016 Freienfeld,33,,20,29,49
016 Freienfeld,34,,23,18,41
016 Freienfeld,35,,23,15,38
016 Freienfeld,36,,25,18,43
016 Freienfeld,37,,22,16,38
016 Freienfeld,38,,27,29,56
016 Freienfeld,39,,24,20,44
016 Freienfeld,40,,25,20,45
016 Freienfeld,41,,29,14,43
016 Freienfeld,42,,16,18,34
016 Freienfeld,43,,15,17,32
016 Freienfeld,44,,22,15,37
016 Freienfeld,45,,19,9,28
016 Freienfeld,46,,18,17,35
016 Freienfeld,47,,17,10,27
016 Freienfeld,48,,13,18,31
016 Freienfeld,49,,15,11,26
016 Freienfeld,50,,20,11,31
016 Freienfeld,51,,17,13,30
016 Freienfeld,52,,19,12,31
016 Freienfeld,53,,6,12,18
016 Freienfeld,54,,11,16,27
016 Freienfeld,55,,13,2,15
016 Freienfeld,56,,12,6,18
016 Freienfeld,57,,16,11,27
016 Freienfeld,58,,11,9,20
016 Freienfeld,59,,12,11,23
016 Freienfeld,60,,14,4,18
016 Freienfeld,61,,11,10,21
016 Freienfeld,62,,12,11,23
016 Freienfeld,63,,7,11,18
016 Freienfeld,64,,10,13,23
016 Freienfeld,65,,8,12,20
016 Freienfeld,66,,5,7,12
016 Freienfeld,67,,12,8,20
016 Freienfeld,68,,12,10,22
016 Freienfeld,69,,9,9,18
016 Freienfeld,70,,9,8,17
016 Freienfeld,71,,6,7,13
016 Freienfeld,72,,8,7,15
016 Freienfeld,73,,6,9,15
016 Freienfeld,74,,8,14,22
016 Freienfeld,75,,8,10,18
016 Freienfeld,76,,5,6,11
016 Freienfeld,77,,2,15,17
016 Freienfeld,78,,3,10,13
016 Freienfeld,79,,1,3,4
016 Freienfeld,80,,7,4,11
016 Freienfeld,81,,3,4,7
016 Freienfeld,82,,2,5,7
016 Freienfeld,83,,-,4,4
016 Freienfeld,84,,1,3,4
016 Freienfeld,85,,-,4,4
016 Freienfeld,86,,3,7,10
016 Freienfeld,87,,3,3,6
016 Freienfeld,88,,1,2,3
016 Freienfeld,89,,1,5,6
016 Freienfeld,90,,3,2,5
016 Freienfeld,91,,1,-,1
016 Freienfeld,92,,-,3,3
016 Freienfeld,93,,1,3,4
017 Sand in Taufers,0,,47,26,73
017 Sand in Taufers,1,,38,36,74
017 Sand in Taufers,2,,30,34,64
017 Sand in Taufers,3,,32,35,67
017 Sand in Taufers,4,,25,31,56
017 Sand in Taufers,5,,27,29,56
017 Sand in Taufers,6,,38,34,72
017 Sand in Taufers,7,,26,33,59
017 Sand in Taufers,8,,32,36,68
017 Sand in Taufers,9,,27,33,60
017 Sand in Taufers,10,,25,31,56
017 Sand in Taufers,11,,28,28,56
017 Sand in Taufers,12,,29,28,57
017 Sand in Taufers,13,,22,23,45
017 Sand in Taufers,14,,22,19,41
017 Sand in Taufers,15,,23,25,48
017 Sand in Taufers,16,,31,25,56
017 Sand in Taufers,17,,34,29,63
017 Sand in Taufers,18,,23,38,61
017 Sand in Taufers,19,,34,34,68
017 Sand in Taufers,20,,31,34,65
017 Sand in Taufers,21,,31,35,66
017 Sand in Taufers,22,,37,35,72
017 Sand in Taufers,23,,35,37,72
017 Sand in Taufers,24,,39,37,76
017 Sand in Taufers,25,,43,41,84
017 Sand in Taufers,26,,59,37,96
017 Sand in Taufers,27,,55,39,94
017 Sand in Taufers,28,,54,56,110
017 Sand in Taufers,29,,43,46,89
017 Sand in Taufers,30,,35,52,87
017 Sand in Taufers,31,,57,40,97
017 Sand in Taufers,32,,48,41,89
017 Sand in Taufers,33,,31,44,75
017 Sand in Taufers,34,,50,34,84
017 Sand in Taufers,35,,48,33,81
017 Sand in Taufers,36,,50,43,93
017 Sand in Taufers,37,,52,46,98
017 Sand in Taufers,38,,35,37,72
017 Sand in Taufers,39,,45,40,85
017 Sand in Taufers,40,,42,33,75
017 Sand in Taufers,41,,40,35,75
017 Sand in Taufers,42,,38,22,60
017 Sand in Taufers,43,,22,37,59
017 Sand in Taufers,44,,29,36,65
017 Sand in Taufers,45,,24,22,46
017 Sand in Taufers,46,,29,27,56
017 Sand in Taufers,47,,33,24,57
017 Sand in Taufers,48,,18,29,47
017 Sand in Taufers,49,,28,22,50
017 Sand in Taufers,50,,34,35,69
017 Sand in Taufers,51,,30,21,51
017 Sand in Taufers,52,,21,25,46
017 Sand in Taufers,53,,25,29,54
017 Sand in Taufers,54,,27,26,53
017 Sand in Taufers,55,,29,9,38
017 Sand in Taufers,56,,18,30,48
017 Sand in Taufers,57,,29,29,58
017 Sand in Taufers,58,,30,33,63
017 Sand in Taufers,59,,27,32,59
017 Sand in Taufers,60,,24,21,45
017 Sand in Taufers,61,,26,31,57
017 Sand in Taufers,62,,19,27,46
017 Sand in Taufers,63,,30,12,42
017 Sand in Taufers,64,,15,25,40
017 Sand in Taufers,65,,30,18,48
017 Sand in Taufers,66,,15,14,29
017 Sand in Taufers,67,,16,18,34
017 Sand in Taufers,68,,12,18,30
017 Sand in Taufers,69,,13,14,27
017 Sand in Taufers,70,,15,18,33
017 Sand in Taufers,71,,17,14,31
017 Sand in Taufers,72,,13,15,28
017 Sand in Taufers,73,,17,13,30
017 Sand in Taufers,74,,11,20,31
017 Sand in Taufers,75,,10,14,24
017 Sand in Taufers,76,,8,18,26
017 Sand in Taufers,77,,10,12,22
017 Sand in Taufers,78,,13,18,31
017 Sand in Taufers,79,,8,16,24
017 Sand in Taufers,80,,7,11,18
017 Sand in Taufers,81,,7,10,17
017 Sand in Taufers,82,,3,6,9
017 Sand in Taufers,83,,4,9,13
017 Sand in Taufers,84,,-,5,5
017 Sand in Taufers,85,,3,7,10
017 Sand in Taufers,86,,4,12,16
017 Sand in Taufers,87,,-,9,9
017 Sand in Taufers,88,,2,6,8
017 Sand in Taufers,89,,1,7,8
017 Sand in Taufers,90,,-,1,1
017 Sand in Taufers,91,,2,5,7
017 Sand in Taufers,92,,1,1,2
017 Sand in Taufers,93,,1,4,5
017 Sand in Taufers,94,,1,-,1
017 Sand in Taufers,95,,1,-,1
017 Sand in Taufers,98,,-,1,1
018 Kastelbell-Tschars,0,,12,8,20
018 Kastelbell-Tschars,1,,25,10,35
018 Kastelbell-Tschars,2,,17,9,26
018 Kastelbell-Tschars,3,,10,8,18
018 Kastelbell-Tschars,4,,12,16,28
018 Kastelbell-Tschars,5,,14,11,25
018 Kastelbell-Tschars,6,,12,15,27
018 Kastelbell-Tschars,7,,13,16,29
018 Kastelbell-Tschars,8,,14,13,27
018 Kastelbell-Tschars,9,,19,14,33
018 Kastelbell-Tschars,10,,15,10,25
018 Kastelbell-Tschars,11,,16,11,27
018 Kastelbell-Tschars,12,,19,7,26
018 Kastelbell-Tschars,13,,19,15,34
018 Kastelbell-Tschars,14,,18,21,39
018 Kastelbell-Tschars,15,,21,15,36
018 Kastelbell-Tschars,16,,8,10,18
018 Kastelbell-Tschars,17,,13,23,36
018 Kastelbell-Tschars,18,,24,14,38
018 Kastelbell-Tschars,19,,15,22,37
018 Kastelbell-Tschars,20,,17,18,35
018 Kastelbell-Tschars,21,,16,15,31
018 Kastelbell-Tschars,22,,14,24,38
018 Kastelbell-Tschars,23,,10,17,27
018 Kastelbell-Tschars,24,,18,17,35
018 Kastelbell-Tschars,25,,15,12,27
018 Kastelbell-Tschars,26,,20,15,35
018 Kastelbell-Tschars,27,,22,17,39
018 Kastelbell-Tschars,28,,15,17,32
018 Kastelbell-Tschars,29,,15,12,27
018 Kastelbell-Tschars,30,,14,17,31
018 Kastelbell-Tschars,31,,23,20,43
018 Kastelbell-Tschars,32,,15,13,28
018 Kastelbell-Tschars,33,,14,21,35
018 Kastelbell-Tschars,34,,22,10,32
018 Kastelbell-Tschars,35,,21,15,36
018 Kastelbell-Tschars,36,,23,15,38
018 Kastelbell-Tschars,37,,24,21,45
018 Kastelbell-Tschars,38,,9,22,31
018 Kastelbell-Tschars,39,,20,18,38
018 Kastelbell-Tschars,40,,24,20,44
018 Kastelbell-Tschars,41,,25,20,45
018 Kastelbell-Tschars,42,,16,13,29
018 Kastelbell-Tschars,43,,15,11,26
018 Kastelbell-Tschars,44,,12,18,30
018 Kastelbell-Tschars,45,,16,20,36
018 Kastelbell-Tschars,46,,9,13,22
018 Kastelbell-Tschars,47,,9,16,25
018 Kastelbell-Tschars,48,,13,17,30
018 Kastelbell-Tschars,49,,16,12,28
018 Kastelbell-Tschars,50,,13,14,27
018 Kastelbell-Tschars,51,,11,8,19
018 Kastelbell-Tschars,52,,14,9,23
018 Kastelbell-Tschars,53,,10,8,18
018 Kastelbell-Tschars,54,,14,13,27
018 Kastelbell-Tschars,55,,10,4,14
018 Kastelbell-Tschars,56,,12,7,19
018 Kastelbell-Tschars,57,,9,8,17
018 Kastelbell-Tschars,58,,10,12,22
018 Kastelbell-Tschars,59,,10,8,18
018 Kastelbell-Tschars,60,,8,10,18
018 Kastelbell-Tschars,61,,13,12,25
018 Kastelbell-Tschars,62,,8,15,23
018 Kastelbell-Tschars,63,,11,10,21
018 Kastelbell-Tschars,64,,11,16,27
018 Kastelbell-Tschars,65,,11,11,22
018 Kastelbell-Tschars,66,,5,16,21
018 Kastelbell-Tschars,67,,18,13,31
018 Kastelbell-Tschars,68,,7,14,21
018 Kastelbell-Tschars,69,,10,14,24
018 Kastelbell-Tschars,70,,23,16,39
018 Kastelbell-Tschars,71,,11,14,25
018 Kastelbell-Tschars,72,,8,11,19
018 Kastelbell-Tschars,73,,10,9,19
018 Kastelbell-Tschars,74,,13,16,29
018 Kastelbell-Tschars,75,,12,14,26
018 Kastelbell-Tschars,76,,5,10,15
018 Kastelbell-Tschars,77,,10,10,20
018 Kastelbell-Tschars,78,,6,9,15
018 Kastelbell-Tschars,79,,4,7,11
018 Kastelbell-Tschars,80,,5,9,14
018 Kastelbell-Tschars,81,,2,5,7
018 Kastelbell-Tschars,82,,1,4,5
018 Kastelbell-Tschars,83,,1,3,4
018 Kastelbell-Tschars,84,,-,3,3
018 Kastelbell-Tschars,85,,5,3,8
018 Kastelbell-Tschars,86,,2,6,8
018 Kastelbell-Tschars,87,,7,4,11
018 Kastelbell-Tschars,88,,1,3,4
018 Kastelbell-Tschars,89,,1,4,5
018 Kastelbell-Tschars,90,,-,2,2
018 Kastelbell-Tschars,91,,1,-,1
018 Kastelbell-Tschars,92,,-,3,3
018 Kastelbell-Tschars,93,,-,1,1
018 Kastelbell-Tschars,98,,-,1,1
019 Kastelruth,0,,38,29,67
019 Kastelruth,1,,33,40,73
019 Kastelruth,2,,52,48,100
019 Kastelruth,3,,48,52,100
019 Kastelruth,4,,42,36,78
019 Kastelruth,5,,57,43,100
019 Kastelruth,6,,33,31,64
019 Kastelruth,7,,40,36,76
019 Kastelruth,8,,38,49,87
019 Kastelruth,9,,35,40,75
019 Kastelruth,10,,36,37,73
019 Kastelruth,11,,46,39,85
019 Kastelruth,12,,26,24,50
019 Kastelruth,13,,36,41,77
019 Kastelruth,14,,33,23,56
019 Kastelruth,15,,27,32,59
019 Kastelruth,16,,35,30,65
019 Kastelruth,17,,34,43,77
019 Kastelruth,18,,44,33,77
019 Kastelruth,19,,36,40,76
019 Kastelruth,20,,44,37,81
019 Kastelruth,21,,29,44,73
019 Kastelruth,22,,31,37,68
019 Kastelruth,23,,37,36,73
019 Kastelruth,24,,42,47,89
019 Kastelruth,25,,52,35,87
019 Kastelruth,26,,56,49,105
019 Kastelruth,27,,43,57,100
019 Kastelruth,28,,64,40,104
019 Kastelruth,29,,60,48,108
019 Kastelruth,30,,47,57,104
019 Kastelruth,31,,64,56,120
019 Kastelruth,32,,65,57,122
019 Kastelruth,33,,65,63,128
019 Kastelruth,34,,71,50,121
019 Kastelruth,35,,43,76,119
019 Kastelruth,36,,54,40,94
019 Kastelruth,37,,57,34,91
019 Kastelruth,38,,35,47,82
019 Kastelruth,39,,51,44,95
019 Kastelruth,40,,50,40,90
019 Kastelruth,41,,45,43,88
019 Kastelruth,42,,48,41,89
019 Kastelruth,43,,38,36,74
019 Kastelruth,44,,34,29,63
019 Kastelruth,45,,37,36,73
019 Kastelruth,46,,38,29,67
019 Kastelruth,47,,29,30,59
019 Kastelruth,48,,37,24,61
019 Kastelruth,49,,29,25,54
019 Kastelruth,50,,42,21,63
019 Kastelruth,51,,19,33,52
019 Kastelruth,52,,28,39,67
019 Kastelruth,53,,35,31,66
019 Kastelruth,54,,22,39,61
019 Kastelruth,55,,24,20,44
019 Kastelruth,56,,21,45,66
019 Kastelruth,57,,41,37,78
019 Kastelruth,58,,34,30,64
019 Kastelruth,59,,34,45,79
019 Kastelruth,60,,28,38,66
019 Kastelruth,61,,28,28,56
019 Kastelruth,62,,29,27,56
019 Kastelruth,63,,27,24,51
019 Kastelruth,64,,33,20,53
019 Kastelruth,65,,31,30,61
019 Kastelruth,66,,23,24,47
019 Kastelruth,67,,35,28,63
019 Kastelruth,68,,21,37,58
019 Kastelruth,69,,40,27,67
019 Kastelruth,70,,13,27,40
019 Kastelruth,71,,26,27,53
019 Kastelruth,72,,14,20,34
019 Kastelruth,73,,21,30,51
019 Kastelruth,74,,15,25,40
019 Kastelruth,75,,13,22,35
019 Kastelruth,76,,20,22,42
019 Kastelruth,77,,9,20,29
019 Kastelruth,78,,13,16,29
019 Kastelruth,79,,10,20,30
019 Kastelruth,80,,12,18,30
019 Kastelruth,81,,10,8,18
019 Kastelruth,82,,5,12,17
019 Kastelruth,83,,3,6,9
019 Kastelruth,84,,-,5,5
019 Kastelruth,85,,3,13,16
019 Kastelruth,86,,10,8,18
019 Kastelruth,87,,5,8,13
019 Kastelruth,88,,7,8,15
019 Kastelruth,89,,4,8,12
019 Kastelruth,90,,-,5,5
019 Kastelruth,91,,-,7,7
019 Kastelruth,92,,2,2,4
019 Kastelruth,93,,2,2,4
019 Kastelruth,94,,-,4,4
019 Kastelruth,95,,-,2,2
019 Kastelruth,96,,-,1,1
019 Kastelruth,97,,-,1,1
020 Tscherms,0,,9,5,14
020 Tscherms,1,,6,5,11
020 Tscherms,2,,5,9,14
020 Tscherms,3,,7,8,15
020 Tscherms,4,,5,5,10
020 Tscherms,5,,11,10,21
020 Tscherms,6,,10,15,25
020 Tscherms,7,,7,7,14
020 Tscherms,8,,12,7,19
020 Tscherms,9,,4,9,13
020 Tscherms,10,,7,5,12
020 Tscherms,11,,3,4,7
020 Tscherms,12,,4,16,20
020 Tscherms,13,,11,5,16
020 Tscherms,14,,9,7,16
020 Tscherms,15,,12,11,23
020 Tscherms,16,,12,5,17
020 Tscherms,17,,10,10,20
020 Tscherms,18,,5,8,13
020 Tscherms,19,,9,7,16
020 Tscherms,20,,8,6,14
020 Tscherms,21,,3,6,9
020 Tscherms,22,,2,7,9
020 Tscherms,23,,8,2,10
020 Tscherms,24,,8,8,16
020 Tscherms,25,,6,4,10
020 Tscherms,26,,7,7,14
020 Tscherms,27,,9,11,20
020 Tscherms,28,,9,4,13
020 Tscherms,29,,9,11,20
020 Tscherms,30,,7,4,11
020 Tscherms,31,,12,16,28
020 Tscherms,32,,18,8,26
020 Tscherms,33,,11,13,24
020 Tscherms,34,,12,9,21
020 Tscherms,35,,15,15,30
020 Tscherms,36,,12,12,24
020 Tscherms,37,,19,12,31
020 Tscherms,38,,13,8,21
020 Tscherms,39,,10,10,20
020 Tscherms,40,,10,13,23
020 Tscherms,41,,7,17,24
020 Tscherms,42,,9,9,18
020 Tscherms,43,,9,10,19
020 Tscherms,44,,8,8,16
020 Tscherms,45,,11,9,20
020 Tscherms,46,,8,7,15
020 Tscherms,47,,8,4,12
020 Tscherms,48,,13,5,18
020 Tscherms,49,,6,12,18
020 Tscherms,50,,8,7,15
020 Tscherms,51,,4,3,7
020 Tscherms,52,,7,5,12
020 Tscherms,53,,8,7,15
020 Tscherms,54,,4,8,12
020 Tscherms,55,,5,7,12
020 Tscherms,56,,6,9,15
020 Tscherms,57,,7,6,13
020 Tscherms,58,,8,3,11
020 Tscherms,59,,10,8,18
020 Tscherms,60,,5,5,10
020 Tscherms,61,,4,4,8
020 Tscherms,62,,7,2,9
020 Tscherms,63,,5,8,13
020 Tscherms,64,,5,7,12
020 Tscherms,65,,5,5,10
020 Tscherms,66,,2,9,11
020 Tscherms,67,,5,2,7
020 Tscherms,68,,6,5,11
020 Tscherms,69,,2,3,5
020 Tscherms,70,,3,5,8
020 Tscherms,71,,3,4,7
020 Tscherms,72,,5,5,10
020 Tscherms,73,,9,5,14
020 Tscherms,74,,3,2,5
020 Tscherms,75,,5,6,11
020 Tscherms,76,,4,5,9
020 Tscherms,77,,1,3,4
020 Tscherms,78,,2,7,9
020 Tscherms,79,,6,3,9
020 Tscherms,80,,6,3,9
020 Tscherms,81,,-,2,2
020 Tscherms,82,,2,2,4
020 Tscherms,83,,1,1,2
020 Tscherms,84,,1,1,2
020 Tscherms,85,,1,2,3
020 Tscherms,86,,1,3,4
020 Tscherms,87,,-,4,4
020 Tscherms,88,,2,-,2
020 Tscherms,89,,-,2,2
020 Tscherms,90,,1,1,2
020 Tscherms,92,,-,1,1
021 Kiens,0,,13,21,34
021 Kiens,1,,14,17,31
021 Kiens,2,,20,6,26
021 Kiens,3,,18,13,31
021 Kiens,4,,16,19,35
021 Kiens,5,,14,22,36
021 Kiens,6,,17,19,36
021 Kiens,7,,19,16,35
021 Kiens,8,,26,17,43
021 Kiens,9,,12,25,37
021 Kiens,10,,14,20,34
021 Kiens,11,,14,18,32
021 Kiens,12,,13,14,27
021 Kiens,13,,12,13,25
021 Kiens,14,,18,11,29
021 Kiens,15,,19,13,32
021 Kiens,16,,16,11,27
021 Kiens,17,,13,18,31
021 Kiens,18,,21,17,38
021 Kiens,19,,14,21,35
021 Kiens,20,,17,26,43
021 Kiens,21,,16,20,36
021 Kiens,22,,29,17,46
021 Kiens,23,,19,13,32
021 Kiens,24,,28,22,50
021 Kiens,25,,19,23,42
021 Kiens,26,,20,18,38
021 Kiens,27,,31,25,56
021 Kiens,28,,26,22,48
021 Kiens,29,,32,28,60
021 Kiens,30,,24,27,51
021 Kiens,31,,33,23,56
021 Kiens,32,,44,20,64
021 Kiens,33,,24,25,49
021 Kiens,34,,25,23,48
021 Kiens,35,,20,21,41
021 Kiens,36,,34,24,58
021 Kiens,37,,20,22,42
021 Kiens,38,,30,19,49
021 Kiens,39,,21,24,45
021 Kiens,40,,20,20,40
021 Kiens,41,,26,16,42
021 Kiens,42,,16,13,29
021 Kiens,43,,11,18,29
021 Kiens,44,,19,13,32
021 Kiens,45,,16,11,27
021 Kiens,46,,10,16,26
021 Kiens,47,,14,23,37
021 Kiens,48,,11,8,19
021 Kiens,49,,12,13,25
021 Kiens,50,,16,10,26
021 Kiens,51,,9,15,24
021 Kiens,52,,14,18,32
021 Kiens,53,,15,14,29
021 Kiens,54,,19,13,32
021 Kiens,55,,8,12,20
021 Kiens,56,,11,13,24
021 Kiens,57,,22,12,34
021 Kiens,58,,19,11,30
021 Kiens,59,,20,11,31
021 Kiens,60,,13,15,28
021 Kiens,61,,13,8,21
021 Kiens,62,,13,14,27
021 Kiens,63,,11,13,24
021 Kiens,64,,11,11,22
021 Kiens,65,,4,19,23
021 Kiens,66,,10,14,24
021 Kiens,67,,12,8,20
021 Kiens,68,,15,12,27
021 Kiens,69,,17,9,26
021 Kiens,70,,9,13,22
021 Kiens,71,,7,9,16
021 Kiens,72,,2,6,8
021 Kiens,73,,8,7,15
021 Kiens,74,,3,4,7
021 Kiens,75,,6,4,10
021 Kiens,76,,5,7,12
021 Kiens,77,,9,7,16
021 Kiens,78,,4,5,9
021 Kiens,79,,1,7,8
021 Kiens,80,,5,4,9
021 Kiens,81,,1,3,4
021 Kiens,82,,1,2,3
021 Kiens,83,,1,3,4
021 Kiens,84,,-,3,3
021 Kiens,85,,2,3,5
021 Kiens,86,,2,5,7
021 Kiens,87,,3,3,6
021 Kiens,88,,1,3,4
021 Kiens,89,,2,-,2
021 Kiens,90,,3,2,5
021 Kiens,93,,1,2,3
021 Kiens,94,,1,-,1
022 Klausen,0,,26,31,57
022 Klausen,1,,32,23,55
022 Klausen,2,,19,26,45
022 Klausen,3,,39,32,71
022 Klausen,4,,27,26,53
022 Klausen,5,,35,24,59
022 Klausen,6,,18,33,51
022 Klausen,7,,28,22,50
022 Klausen,8,,39,25,64
022 Klausen,9,,33,30,63
022 Klausen,10,,36,23,59
022 Klausen,11,,28,28,56
022 Klausen,12,,28,31,59
022 Klausen,13,,20,34,54
022 Klausen,14,,34,29,63
022 Klausen,15,,36,36,72
022 Klausen,16,,34,26,60
022 Klausen,17,,24,38,62
022 Klausen,18,,38,34,72
022 Klausen,19,,35,30,65
022 Klausen,20,,26,31,57
022 Klausen,21,,28,39,67
022 Klausen,22,,38,40,78
022 Klausen,23,,36,31,67
022 Klausen,24,,36,22,58
022 Klausen,25,,38,37,75
022 Klausen,26,,34,27,61
022 Klausen,27,,43,25,68
022 Klausen,28,,36,40,76
022 Klausen,29,,44,36,80
022 Klausen,30,,43,46,89
022 Klausen,31,,48,44,92
022 Klausen,32,,53,39,92
022 Klausen,33,,45,45,90
022 Klausen,34,,59,42,101
022 Klausen,35,,43,39,82
022 Klausen,36,,38,45,83
022 Klausen,37,,38,38,76
022 Klausen,38,,32,40,72
022 Klausen,39,,49,37,86
022 Klausen,40,,40,27,67
022 Klausen,41,,30,36,66
022 Klausen,42,,27,28,55
022 Klausen,43,,32,27,59
022 Klausen,44,,28,25,53
022 Klausen,45,,29,30,59
022 Klausen,46,,31,40,71
022 Klausen,47,,21,30,51
022 Klausen,48,,25,15,40
022 Klausen,49,,32,26,58
022 Klausen,50,,30,23,53
022 Klausen,51,,28,25,53
022 Klausen,52,,29,26,55
022 Klausen,53,,29,20,49
022 Klausen,54,,29,21,50
022 Klausen,55,,13,16,29
022 Klausen,56,,21,18,39
022 Klausen,57,,22,29,51
022 Klausen,58,,21,26,47
022 Klausen,59,,27,20,47
022 Klausen,60,,24,23,47
022 Klausen,61,,26,20,46
022 Klausen,62,,16,20,36
022 Klausen,63,,17,18,35
022 Klausen,64,,20,23,43
022 Klausen,65,,12,20,32
022 Klausen,66,,17,17,34
022 Klausen,67,,23,17,40
022 Klausen,68,,12,22,34
022 Klausen,69,,12,15,27
022 Klausen,70,,11,19,30
022 Klausen,71,,23,23,46
022 Klausen,72,,7,18,25
022 Klausen,73,,9,15,24
022 Klausen,74,,13,12,25
022 Klausen,75,,13,9,22
022 Klausen,76,,13,17,30
022 Klausen,77,,5,18,23
022 Klausen,78,,8,17,25
022 Klausen,79,,3,13,16
022 Klausen,80,,4,15,19
022 Klausen,81,,2,12,14
022 Klausen,82,,2,10,12
022 Klausen,83,,3,10,13
022 Klausen,84,,2,4,6
022 Klausen,85,,3,4,7
022 Klausen,86,,4,8,12
022 Klausen,87,,1,14,15
022 Klausen,88,,2,5,7
022 Klausen,89,,3,3,6
022 Klausen,90,,3,3,6
022 Klausen,91,,2,5,7
022 Klausen,92,,1,5,6
022 Klausen,93,,-,1,1
022 Klausen,96,,1,1,2
022 Klausen,98,,1,-,1
023 Karneid,0,,19,15,34
023 Karneid,1,,25,28,53
023 Karneid,2,,18,21,39
023 Karneid,3,,33,20,53
023 Karneid,4,,20,16,36
023 Karneid,5,,22,19,41
023 Karneid,6,,21,23,44
023 Karneid,7,,21,22,43
023 Karneid,8,,22,18,40
023 Karneid,9,,17,20,37
023 Karneid,10,,23,16,39
023 Karneid,11,,16,18,34
023 Karneid,12,,18,19,37
023 Karneid,13,,12,21,33
023 Karneid,14,,19,19,38
023 Karneid,15,,21,13,34
023 Karneid,16,,25,15,40
023 Karneid,17,,19,9,28
023 Karneid,18,,22,15,37
023 Karneid,19,,28,28,56
023 Karneid,20,,21,22,43
023 Karneid,21,,24,26,50
023 Karneid,22,,24,12,36
023 Karneid,23,,18,15,33
023 Karneid,24,,21,28,49
023 Karneid,25,,22,23,45
023 Karneid,26,,30,22,52
023 Karneid,27,,26,22,48
023 Karneid,28,,27,33,60
023 Karneid,29,,30,33,63
023 Karneid,30,,38,17,55
023 Karneid,31,,16,26,42
023 Karneid,32,,41,37,78
023 Karneid,33,,35,37,72
023 Karneid,34,,36,35,71
023 Karneid,35,,28,27,55
023 Karneid,36,,35,26,61
023 Karneid,37,,37,22,59
023 Karneid,38,,30,34,64
023 Karneid,39,,28,20,48
023 Karneid,40,,31,28,59
023 Karneid,41,,31,18,49
023 Karneid,42,,20,20,40
023 Karneid,43,,19,18,37
023 Karneid,44,,20,17,37
023 Karneid,45,,16,9,25
023 Karneid,46,,17,16,33
023 Karneid,47,,24,16,40
023 Karneid,48,,11,20,31
023 Karneid,49,,19,12,31
023 Karneid,50,,22,16,38
023 Karneid,51,,10,15,25
023 Karneid,52,,16,24,40
023 Karneid,53,,8,16,24
023 Karneid,54,,11,20,31
023 Karneid,55,,13,15,28
023 Karneid,56,,13,14,27
023 Karneid,57,,21,14,35
023 Karneid,58,,17,24,41
023 Karneid,59,,23,15,38
023 Karneid,60,,14,17,31
023 Karneid,61,,17,17,34
023 Karneid,62,,20,10,30
023 Karneid,63,,9,9,18
023 Karneid,64,,11,12,23
023 Karneid,65,,12,14,26
023 Karneid,66,,15,15,30
023 Karneid,67,,10,15,25
023 Karneid,68,,14,5,19
023 Karneid,69,,18,11,29
023 Karneid,70,,7,8,15
023 Karneid,71,,12,9,21
023 Karneid,72,,9,9,18
023 Karneid,73,,4,9,13
023 Karneid,74,,9,10,19
023 Karneid,75,,6,7,13
023 Karneid,76,,9,13,22
023 Karneid,77,,5,4,9
023 Karneid,78,,3,8,11
023 Karneid,79,,2,6,8
023 Karneid,80,,6,9,15
023 Karneid,81,,8,3,11
023 Karneid,82,,1,6,7
023 Karneid,83,,1,4,5
023 Karneid,84,,1,3,4
023 Karneid,85,,1,2,3
023 Karneid,86,,1,2,3
023 Karneid,87,,-,4,4
023 Karneid,88,,1,5,6
023 Karneid,89,,-,3,3
023 Karneid,90,,3,4,7
023 Karneid,91,,1,2,3
023 Karneid,92,,-,4,4
023 Karneid,94,,-,2,2
023 Karneid,95,,-,1,1
023 Karneid,96,,-,1,1
024 Kurtatsch a.d.Weinstr.,0,,15,12,27
024 Kurtatsch a.d.Weinstr.,1,,14,9,23
024 Kurtatsch a.d.Weinstr.,2,,16,12,28
024 Kurtatsch a.d.Weinstr.,3,,13,13,26
024 Kurtatsch a.d.Weinstr.,4,,25,16,41
024 Kurtatsch a.d.Weinstr.,5,,21,13,34
024 Kurtatsch a.d.Weinstr.,6,,15,5,20
024 Kurtatsch a.d.Weinstr.,7,,24,19,43
024 Kurtatsch a.d.Weinstr.,8,,21,10,31
024 Kurtatsch a.d.Weinstr.,9,,16,16,32
024 Kurtatsch a.d.Weinstr.,10,,10,7,17
024 Kurtatsch a.d.Weinstr.,11,,10,17,27
024 Kurtatsch a.d.Weinstr.,12,,7,13,20
024 Kurtatsch a.d.Weinstr.,13,,11,12,23
024 Kurtatsch a.d.Weinstr.,14,,9,10,19
024 Kurtatsch a.d.Weinstr.,15,,14,10,24
024 Kurtatsch a.d.Weinstr.,16,,16,8,24
024 Kurtatsch a.d.Weinstr.,17,,16,8,24
024 Kurtatsch a.d.Weinstr.,18,,11,20,31
024 Kurtatsch a.d.Weinstr.,19,,10,11,21
024 Kurtatsch a.d.Weinstr.,20,,7,15,22
024 Kurtatsch a.d.Weinstr.,21,,10,8,18
024 Kurtatsch a.d.Weinstr.,22,,7,14,21
024 Kurtatsch a.d.Weinstr.,23,,10,16,26
024 Kurtatsch a.d.Weinstr.,24,,11,13,24
024 Kurtatsch a.d.Weinstr.,25,,11,12,23
024 Kurtatsch a.d.Weinstr.,26,,7,14,21
024 Kurtatsch a.d.Weinstr.,27,,14,15,29
024 Kurtatsch a.d.Weinstr.,28,,10,17,27
024 Kurtatsch a.d.Weinstr.,29,,15,18,33
024 Kurtatsch a.d.Weinstr.,30,,12,23,35
024 Kurtatsch a.d.Weinstr.,31,,22,15,37
024 Kurtatsch a.d.Weinstr.,32,,26,13,39
024 Kurtatsch a.d.Weinstr.,33,,20,20,40
024 Kurtatsch a.d.Weinstr.,34,,29,17,46
024 Kurtatsch a.d.Weinstr.,35,,24,28,52
024 Kurtatsch a.d.Weinstr.,36,,13,26,39
024 Kurtatsch a.d.Weinstr.,37,,19,22,41
024 Kurtatsch a.d.Weinstr.,38,,23,7,30
024 Kurtatsch a.d.Weinstr.,39,,18,17,35
024 Kurtatsch a.d.Weinstr.,40,,19,21,40
024 Kurtatsch a.d.Weinstr.,41,,17,11,28
024 Kurtatsch a.d.Weinstr.,42,,14,17,31
024 Kurtatsch a.d.Weinstr.,43,,11,11,22
024 Kurtatsch a.d.Weinstr.,44,,9,9,18
024 Kurtatsch a.d.Weinstr.,45,,12,16,28
024 Kurtatsch a.d.Weinstr.,46,,15,8,23
024 Kurtatsch a.d.Weinstr.,47,,17,19,36
024 Kurtatsch a.d.Weinstr.,48,,13,9,22
024 Kurtatsch a.d.Weinstr.,49,,10,14,24
024 Kurtatsch a.d.Weinstr.,50,,14,6,20
024 Kurtatsch a.d.Weinstr.,51,,12,9,21
024 Kurtatsch a.d.Weinstr.,52,,8,8,16
024 Kurtatsch a.d.Weinstr.,53,,12,8,20
024 Kurtatsch a.d.Weinstr.,54,,12,8,20
024 Kurtatsch a.d.Weinstr.,55,,7,8,15
024 Kurtatsch a.d.Weinstr.,56,,5,8,13
024 Kurtatsch a.d.Weinstr.,57,,10,6,16
024 Kurtatsch a.d.Weinstr.,58,,11,12,23
024 Kurtatsch a.d.Weinstr.,59,,7,11,18
024 Kurtatsch a.d.Weinstr.,60,,11,11,22
024 Kurtatsch a.d.Weinstr.,61,,4,15,19
024 Kurtatsch a.d.Weinstr.,62,,11,11,22
024 Kurtatsch a.d.Weinstr.,63,,5,11,16
024 Kurtatsch a.d.Weinstr.,64,,9,8,17
024 Kurtatsch a.d.Weinstr.,65,,5,10,15
024 Kurtatsch a.d.Weinstr.,66,,8,11,19
024 Kurtatsch a.d.Weinstr.,67,,8,6,14
024 Kurtatsch a.d.Weinstr.,68,,11,16,27
024 Kurtatsch a.d.Weinstr.,69,,7,12,19
024 Kurtatsch a.d.Weinstr.,70,,12,15,27
024 Kurtatsch a.d.Weinstr.,71,,9,11,20
024 Kurtatsch a.d.Weinstr.,72,,8,8,16
024 Kurtatsch a.d.Weinstr.,73,,11,6,17
024 Kurtatsch a.d.Weinstr.,74,,8,6,14
024 Kurtatsch a.d.Weinstr.,75,,4,10,14
024 Kurtatsch a.d.Weinstr.,76,,8,10,18
024 Kurtatsch a.d.Weinstr.,77,,7,21,28
024 Kurtatsch a.d.Weinstr.,78,,1,5,6
024 Kurtatsch a.d.Weinstr.,79,,4,8,12
024 Kurtatsch a.d.Weinstr.,80,,6,5,11
024 Kurtatsch a.d.Weinstr.,81,,2,2,4
024 Kurtatsch a.d.Weinstr.,82,,-,1,1
024 Kurtatsch a.d.Weinstr.,83,,-,6,6
024 Kurtatsch a.d.Weinstr.,84,,-,2,2
024 Kurtatsch a.d.Weinstr.,85,,2,1,3
024 Kurtatsch a.d.Weinstr.,86,,3,2,5
024 Kurtatsch a.d.Weinstr.,87,,1,4,5
024 Kurtatsch a.d.Weinstr.,88,,3,5,8
024 Kurtatsch a.d.Weinstr.,89,,-,4,4
024 Kurtatsch a.d.Weinstr.,90,,-,1,1
024 Kurtatsch a.d.Weinstr.,91,,-,2,2
024 Kurtatsch a.d.Weinstr.,92,,1,1,2
024 Kurtatsch a.d.Weinstr.,93,,-,1,1
024 Kurtatsch a.d.Weinstr.,94,,2,-,2
024 Kurtatsch a.d.Weinstr.,95,,-,1,1
024 Kurtatsch a.d.Weinstr.,96,,1,-,1
024 Kurtatsch a.d.Weinstr.,97,,-,1,1
025 Kurtinig a.d. Weinstr.,0,,3,4,7
025 Kurtinig a.d. Weinstr.,1,,3,3,6
025 Kurtinig a.d. Weinstr.,2,,2,5,7
025 Kurtinig a.d. Weinstr.,3,,3,4,7
025 Kurtinig a.d. Weinstr.,4,,1,2,3
025 Kurtinig a.d. Weinstr.,5,,4,2,6
025 Kurtinig a.d. Weinstr.,6,,2,4,6
025 Kurtinig a.d. Weinstr.,7,,4,4,8
025 Kurtinig a.d. Weinstr.,8,,2,3,5
025 Kurtinig a.d. Weinstr.,9,,5,2,7
025 Kurtinig a.d. Weinstr.,10,,3,2,5
025 Kurtinig a.d. Weinstr.,11,,6,4,10
025 Kurtinig a.d. Weinstr.,12,,6,4,10
025 Kurtinig a.d. Weinstr.,13,,5,6,11
025 Kurtinig a.d. Weinstr.,14,,5,5,10
025 Kurtinig a.d. Weinstr.,15,,2,3,5
025 Kurtinig a.d. Weinstr.,16,,3,2,5
025 Kurtinig a.d. Weinstr.,17,,3,4,7
025 Kurtinig a.d. Weinstr.,18,,6,5,11
025 Kurtinig a.d. Weinstr.,19,,6,5,11
025 Kurtinig a.d. Weinstr.,20,,4,3,7
025 Kurtinig a.d. Weinstr.,21,,4,8,12
025 Kurtinig a.d. Weinstr.,22,,2,4,6
025 Kurtinig a.d. Weinstr.,23,,5,-,5
025 Kurtinig a.d. Weinstr.,24,,3,-,3
025 Kurtinig a.d. Weinstr.,25,,2,5,7
025 Kurtinig a.d. Weinstr.,26,,4,3,7
025 Kurtinig a.d. Weinstr.,27,,5,1,6
025 Kurtinig a.d. Weinstr.,28,,3,4,7
025 Kurtinig a.d. Weinstr.,29,,4,3,7
025 Kurtinig a.d. Weinstr.,30,,7,2,9
025 Kurtinig a.d. Weinstr.,31,,7,6,13
025 Kurtinig a.d. Weinstr.,32,,4,3,7
025 Kurtinig a.d. Weinstr.,33,,4,4,8
025 Kurtinig a.d. Weinstr.,34,,2,5,7
025 Kurtinig a.d. Weinstr.,35,,4,4,8
025 Kurtinig a.d. Weinstr.,36,,7,5,12
025 Kurtinig a.d. Weinstr.,37,,6,7,13
025 Kurtinig a.d. Weinstr.,38,,4,5,9
025 Kurtinig a.d. Weinstr.,39,,8,9,17
025 Kurtinig a.d. Weinstr.,40,,5,5,10
025 Kurtinig a.d. Weinstr.,41,,11,5,16
025 Kurtinig a.d. Weinstr.,42,,3,8,11
025 Kurtinig a.d. Weinstr.,43,,9,8,17
025 Kurtinig a.d. Weinstr.,44,,4,3,7
025 Kurtinig a.d. Weinstr.,45,,3,1,4
025 Kurtinig a.d. Weinstr.,46,,7,2,9
025 Kurtinig a.d. Weinstr.,47,,5,4,9
025 Kurtinig a.d. Weinstr.,48,,2,4,6
025 Kurtinig a.d. Weinstr.,49,,2,4,6
025 Kurtinig a.d. Weinstr.,50,,2,3,5
025 Kurtinig a.d. Weinstr.,51,,3,3,6
025 Kurtinig a.d. Weinstr.,52,,4,5,9
025 Kurtinig a.d. Weinstr.,53,,5,1,6
025 Kurtinig a.d. Weinstr.,54,,-,5,5
025 Kurtinig a.d. Weinstr.,55,,3,2,5
025 Kurtinig a.d. Weinstr.,56,,3,2,5
025 Kurtinig a.d. Weinstr.,57,,4,2,6
025 Kurtinig a.d. Weinstr.,58,,2,2,4
025 Kurtinig a.d. Weinstr.,59,,3,1,4
025 Kurtinig a.d. Weinstr.,60,,2,2,4
025 Kurtinig a.d. Weinstr.,61,,5,3,8
025 Kurtinig a.d. Weinstr.,62,,2,2,4
025 Kurtinig a.d. Weinstr.,63,,2,3,5
025 Kurtinig a.d. Weinstr.,64,,6,3,9
025 Kurtinig a.d. Weinstr.,65,,-,6,6
025 Kurtinig a.d. Weinstr.,66,,1,4,5
025 Kurtinig a.d. Weinstr.,67,,1,2,3
025 Kurtinig a.d. Weinstr.,68,,3,4,7
025 Kurtinig a.d. Weinstr.,69,,3,2,5
025 Kurtinig a.d. Weinstr.,70,,4,4,8
025 Kurtinig a.d. Weinstr.,71,,1,3,4
025 Kurtinig a.d. Weinstr.,72,,2,4,6
025 Kurtinig a.d. Weinstr.,73,,2,4,6
025 Kurtinig a.d. Weinstr.,74,,4,1,5
025 Kurtinig a.d. Weinstr.,75,,-,5,5
025 Kurtinig a.d. Weinstr.,76,,2,5,7
025 Kurtinig a.d. Weinstr.,77,,1,1,2
025 Kurtinig a.d. Weinstr.,78,,1,3,4
025 Kurtinig a.d. Weinstr.,79,,2,1,3
025 Kurtinig a.d. Weinstr.,80,,2,1,3
025 Kurtinig a.d. Weinstr.,81,,-,2,2
025 Kurtinig a.d. Weinstr.,82,,1,1,2
025 Kurtinig a.d. Weinstr.,85,,-,3,3
025 Kurtinig a.d. Weinstr.,86,,-,2,2
025 Kurtinig a.d. Weinstr.,87,,1,-,1
025 Kurtinig a.d. Weinstr.,88,,1,1,2
025 Kurtinig a.d. Weinstr.,91,,-,1,1
025 Kurtinig a.d. Weinstr.,96,,-,2,2
026 Corvara,0,,7,5,12
026 Corvara,1,,8,7,15
026 Corvara,2,,8,7,15
026 Corvara,3,,4,6,10
026 Corvara,4,,8,4,12
026 Corvara,5,,7,9,16
026 Corvara,6,,6,4,10
026 Corvara,7,,6,3,9
026 Corvara,8,,6,11,17
026 Corvara,9,,2,6,8
026 Corvara,10,,9,6,15
026 Corvara,11,,5,5,10
026 Corvara,12,,6,3,9
026 Corvara,13,,9,7,16
026 Corvara,14,,3,-,3
026 Corvara,15,,6,8,14
026 Corvara,16,,7,3,10
026 Corvara,17,,7,7,14
026 Corvara,18,,8,11,19
026 Corvara,19,,15,2,17
026 Corvara,20,,11,7,18
026 Corvara,21,,11,8,19
026 Corvara,22,,11,3,14
026 Corvara,23,,16,7,23
026 Corvara,24,,11,4,15
026 Corvara,25,,9,19,28
026 Corvara,26,,7,16,23
026 Corvara,27,,13,9,22
026 Corvara,28,,6,7,13
026 Corvara,29,,11,7,18
026 Corvara,30,,10,12,22
026 Corvara,31,,16,11,27
026 Corvara,32,,8,12,20
026 Corvara,33,,15,21,36
026 Corvara,34,,13,16,29
026 Corvara,35,,16,16,32
026 Corvara,36,,8,7,15
026 Corvara,37,,11,11,22
026 Corvara,38,,13,11,24
026 Corvara,39,,8,7,15
026 Corvara,40,,15,13,28
026 Corvara,41,,7,7,14
026 Corvara,42,,11,6,17
026 Corvara,43,,7,5,12
026 Corvara,44,,3,9,12
026 Corvara,45,,11,8,19
026 Corvara,46,,9,8,17
026 Corvara,47,,6,13,19
026 Corvara,48,,5,8,13
026 Corvara,49,,6,8,14
026 Corvara,50,,7,8,15
026 Corvara,51,,3,9,12
026 Corvara,52,,5,5,10
026 Corvara,53,,4,10,14
026 Corvara,54,,14,11,25
026 Corvara,55,,5,5,10
026 Corvara,56,,9,9,18
026 Corvara,57,,6,10,16
026 Corvara,58,,5,9,14
026 Corvara,59,,15,12,27
026 Corvara,60,,9,7,16
026 Corvara,61,,8,4,12
026 Corvara,62,,4,8,12
026 Corvara,63,,5,8,13
026 Corvara,64,,6,8,14
026 Corvara,65,,8,5,13
026 Corvara,66,,9,8,17
026 Corvara,67,,4,4,8
026 Corvara,68,,7,4,11
026 Corvara,69,,7,12,19
026 Corvara,70,,7,3,10
026 Corvara,71,,5,6,11
026 Corvara,72,,2,2,4
026 Corvara,73,,6,4,10
026 Corvara,74,,3,3,6
026 Corvara,75,,1,3,4
026 Corvara,76,,3,1,4
026 Corvara,77,,5,3,8
026 Corvara,78,,3,5,8
026 Corvara,79,,4,1,5
026 Corvara,80,,4,1,5
026 Corvara,81,,2,3,5
026 Corvara,82,,1,1,2
026 Corvara,83,,1,2,3
026 Corvara,84,,-,1,1
026 Corvara,86,,-,3,3
026 Corvara,87,,1,6,7
026 Corvara,88,,2,5,7
026 Corvara,89,,2,-,2
026 Corvara,90,,-,2,2
026 Corvara,91,,-,1,1
026 Corvara,92,,-,1,1
026 Corvara,93,,-,1,1
026 Corvara,94,,-,2,2
026 Corvara,95,,-,1,1
026 Corvara,97,,1,-,1
027 Graun im Vinschgau,0,,17,17,34
027 Graun im Vinschgau,1,,13,11,24
027 Graun im Vinschgau,2,,11,17,28
027 Graun im Vinschgau,3,,15,16,31
027 Graun im Vinschgau,4,,22,17,39
027 Graun im Vinschgau,5,,19,17,36
027 Graun im Vinschgau,6,,19,12,31
027 Graun im Vinschgau,7,,21,14,35
027 Graun im Vinschgau,8,,17,16,33
027 Graun im Vinschgau,9,,10,13,23
027 Graun im Vinschgau,10,,18,20,38
027 Graun im Vinschgau,11,,26,18,44
027 Graun im Vinschgau,12,,22,11,33
027 Graun im Vinschgau,13,,16,12,28
027 Graun im Vinschgau,14,,8,8,16
027 Graun im Vinschgau,15,,19,10,29
027 Graun im Vinschgau,16,,20,15,35
027 Graun im Vinschgau,17,,7,16,23
027 Graun im Vinschgau,18,,18,18,36
027 Graun im Vinschgau,19,,22,16,38
027 Graun im Vinschgau,20,,24,14,38
027 Graun im Vinschgau,21,,14,22,36
027 Graun im Vinschgau,22,,19,15,34
027 Graun im Vinschgau,23,,19,21,40
027 Graun im Vinschgau,24,,15,19,34
027 Graun im Vinschgau,25,,22,20,42
027 Graun im Vinschgau,26,,22,12,34
027 Graun im Vinschgau,27,,20,20,40
027 Graun im Vinschgau,28,,23,20,43
027 Graun im Vinschgau,29,,21,11,32
027 Graun im Vinschgau,30,,23,15,38
027 Graun im Vinschgau,31,,29,20,49
027 Graun im Vinschgau,32,,17,22,39
027 Graun im Vinschgau,33,,30,22,52
027 Graun im Vinschgau,34,,19,24,43
027 Graun im Vinschgau,35,,18,19,37
027 Graun im Vinschgau,36,,21,23,44
027 Graun im Vinschgau,37,,22,18,40
027 Graun im Vinschgau,38,,23,24,47
027 Graun im Vinschgau,39,,21,14,35
027 Graun im Vinschgau,40,,21,22,43
027 Graun im Vinschgau,41,,22,11,33
027 Graun im Vinschgau,42,,20,16,36
027 Graun im Vinschgau,43,,13,13,26
027 Graun im Vinschgau,44,,15,11,26
027 Graun im Vinschgau,45,,16,9,25
027 Graun im Vinschgau,46,,18,17,35
027 Graun im Vinschgau,47,,18,8,26
027 Graun im Vinschgau,48,,17,10,27
027 Graun im Vinschgau,49,,13,15,28
027 Graun im Vinschgau,50,,11,12,23
027 Graun im Vinschgau,51,,8,21,29
027 Graun im Vinschgau,52,,12,12,24
027 Graun im Vinschgau,53,,5,10,15
027 Graun im Vinschgau,54,,8,7,15
027 Graun im Vinschgau,55,,8,8,16
027 Graun im Vinschgau,56,,11,8,19
027 Graun im Vinschgau,57,,10,13,23
027 Graun im Vinschgau,58,,9,13,22
027 Graun im Vinschgau,59,,15,10,25
027 Graun im Vinschgau,60,,14,9,23
027 Graun im Vinschgau,61,,11,13,24
027 Graun im Vinschgau,62,,11,12,23
027 Graun im Vinschgau,63,,11,3,14
027 Graun im Vinschgau,64,,15,14,29
027 Graun im Vinschgau,65,,9,8,17
027 Graun im Vinschgau,66,,12,9,21
027 Graun im Vinschgau,67,,8,7,15
027 Graun im Vinschgau,68,,13,7,20
027 Graun im Vinschgau,69,,13,11,24
027 Graun im Vinschgau,70,,5,9,14
027 Graun im Vinschgau,71,,14,14,28
027 Graun im Vinschgau,72,,9,12,21
027 Graun im Vinschgau,73,,6,9,15
027 Graun im Vinschgau,74,,9,14,23
027 Graun im Vinschgau,75,,6,5,11
027 Graun im Vinschgau,76,,9,9,18
027 Graun im Vinschgau,77,,4,14,18
027 Graun im Vinschgau,78,,9,8,17
027 Graun im Vinschgau,79,,6,13,19
027 Graun im Vinschgau,80,,5,3,8
027 Graun im Vinschgau,81,,1,6,7
027 Graun im Vinschgau,82,,3,2,5
027 Graun im Vinschgau,83,,-,2,2
027 Graun im Vinschgau,84,,1,2,3
027 Graun im Vinschgau,85,,1,4,5
027 Graun im Vinschgau,86,,4,5,9
027 Graun im Vinschgau,87,,-,4,4
027 Graun im Vinschgau,88,,1,3,4
027 Graun im Vinschgau,89,,1,5,6
027 Graun im Vinschgau,90,,1,-,1
027 Graun im Vinschgau,91,,-,1,1
027 Graun im Vinschgau,92,,-,4,4
027 Graun im Vinschgau,93,,1,2,3
027 Graun im Vinschgau,96,,1,-,1
027 Graun im Vinschgau,97,,-,1,1
028 Toblach,0,,19,18,37
028 Toblach,1,,16,18,34
028 Toblach,2,,20,10,30
028 Toblach,3,,25,16,41
028 Toblach,4,,30,23,53
028 Toblach,5,,18,10,28
028 Toblach,6,,22,18,40
028 Toblach,7,,19,19,38
028 Toblach,8,,16,17,33
028 Toblach,9,,17,28,45
028 Toblach,10,,17,24,41
028 Toblach,11,,10,16,26
028 Toblach,12,,15,24,39
028 Toblach,13,,31,16,47
028 Toblach,14,,16,21,37
028 Toblach,15,,24,23,47
028 Toblach,16,,21,27,48
028 Toblach,17,,21,20,41
028 Toblach,18,,23,28,51
028 Toblach,19,,25,22,47
028 Toblach,20,,24,20,44
028 Toblach,21,,23,25,48
028 Toblach,22,,24,25,49
028 Toblach,23,,15,26,41
028 Toblach,24,,28,32,60
028 Toblach,25,,25,23,48
028 Toblach,26,,30,19,49
028 Toblach,27,,37,25,62
028 Toblach,28,,36,36,72
028 Toblach,29,,34,22,56
028 Toblach,30,,23,21,44
028 Toblach,31,,34,28,62
028 Toblach,32,,36,26,62
028 Toblach,33,,29,25,54
028 Toblach,34,,28,28,56
028 Toblach,35,,32,28,60
028 Toblach,36,,36,34,70
028 Toblach,37,,33,26,59
028 Toblach,38,,36,29,65
028 Toblach,39,,22,30,52
028 Toblach,40,,21,17,38
028 Toblach,41,,39,26,65
028 Toblach,42,,23,15,38
028 Toblach,43,,28,20,48
028 Toblach,44,,17,24,41
028 Toblach,45,,19,25,44
028 Toblach,46,,22,20,42
028 Toblach,47,,20,25,45
028 Toblach,48,,18,18,36
028 Toblach,49,,27,12,39
028 Toblach,50,,15,17,32
028 Toblach,51,,21,14,35
028 Toblach,52,,14,25,39
028 Toblach,53,,20,14,34
028 Toblach,54,,13,15,28
028 Toblach,55,,12,16,28
028 Toblach,56,,19,11,30
028 Toblach,57,,15,18,33
028 Toblach,58,,13,20,33
028 Toblach,59,,17,12,29
028 Toblach,60,,14,13,27
028 Toblach,61,,15,13,28
028 Toblach,62,,16,8,24
028 Toblach,63,,5,10,15
028 Toblach,64,,11,16,27
028 Toblach,65,,8,19,27
028 Toblach,66,,16,17,33
028 Toblach,67,,10,10,20
028 Toblach,68,,13,17,30
028 Toblach,69,,18,15,33
028 Toblach,70,,10,11,21
028 Toblach,71,,11,17,28
028 Toblach,72,,15,13,28
028 Toblach,73,,10,14,24
028 Toblach,74,,10,15,25
028 Toblach,75,,16,9,25
028 Toblach,76,,9,9,18
028 Toblach,77,,10,8,18
028 Toblach,78,,5,17,22
028 Toblach,79,,7,11,18
028 Toblach,80,,4,9,13
028 Toblach,81,,4,14,18
028 Toblach,82,,4,5,9
028 Toblach,83,,4,4,8
028 Toblach,84,,2,6,8
028 Toblach,85,,1,10,11
028 Toblach,86,,1,6,7
028 Toblach,87,,1,6,7
028 Toblach,88,,1,2,3
028 Toblach,89,,1,3,4
028 Toblach,90,,-,4,4
028 Toblach,91,,1,3,4
028 Toblach,92,,1,3,4
028 Toblach,93,,1,1,2
028 Toblach,94,,1,1,2
028 Toblach,95,,-,1,1
028 Toblach,96,,-,1,1
028 Toblach,99,,-,1,1
028 Toblach,110,,1,-,1
029 Neumarkt,0,,25,19,44
029 Neumarkt,1,,13,25,38
029 Neumarkt,2,,21,35,56
029 Neumarkt,3,,17,14,31
029 Neumarkt,4,,19,21,40
029 Neumarkt,5,,21,23,44
029 Neumarkt,6,,23,24,47
029 Neumarkt,7,,22,34,56
029 Neumarkt,8,,20,26,46
029 Neumarkt,9,,24,19,43
029 Neumarkt,10,,28,23,51
029 Neumarkt,11,,23,31,54
029 Neumarkt,12,,22,23,45
029 Neumarkt,13,,28,29,57
029 Neumarkt,14,,21,17,38
029 Neumarkt,15,,25,17,42
029 Neumarkt,16,,15,23,38
029 Neumarkt,17,,14,23,37
029 Neumarkt,18,,23,23,46
029 Neumarkt,19,,25,19,44
029 Neumarkt,20,,20,19,39
029 Neumarkt,21,,23,17,40
029 Neumarkt,22,,33,22,55
029 Neumarkt,23,,15,14,29
029 Neumarkt,24,,27,33,60
029 Neumarkt,25,,31,28,59
029 Neumarkt,26,,26,35,61
029 Neumarkt,27,,22,25,47
029 Neumarkt,28,,35,35,70
029 Neumarkt,29,,32,44,76
029 Neumarkt,30,,33,27,60
029 Neumarkt,31,,29,33,62
029 Neumarkt,32,,35,47,82
029 Neumarkt,33,,43,42,85
029 Neumarkt,34,,51,40,91
029 Neumarkt,35,,49,37,86
029 Neumarkt,36,,51,37,88
029 Neumarkt,37,,41,40,81
029 Neumarkt,38,,49,30,79
029 Neumarkt,39,,30,34,64
029 Neumarkt,40,,48,49,97
029 Neumarkt,41,,48,36,84
029 Neumarkt,42,,30,37,67
029 Neumarkt,43,,35,30,65
029 Neumarkt,44,,32,25,57
029 Neumarkt,45,,42,41,83
029 Neumarkt,46,,39,24,63
029 Neumarkt,47,,22,19,41
029 Neumarkt,48,,26,21,47
029 Neumarkt,49,,21,22,43
029 Neumarkt,50,,24,21,45
029 Neumarkt,51,,20,26,46
029 Neumarkt,52,,20,22,42
029 Neumarkt,53,,27,30,57
029 Neumarkt,54,,36,31,67
029 Neumarkt,55,,26,24,50
029 Neumarkt,56,,24,15,39
029 Neumarkt,57,,25,22,47
029 Neumarkt,58,,23,26,49
029 Neumarkt,59,,38,24,62
029 Neumarkt,60,,32,34,66
029 Neumarkt,61,,20,28,48
029 Neumarkt,62,,19,18,37
029 Neumarkt,63,,25,20,45
029 Neumarkt,64,,20,19,39
029 Neumarkt,65,,21,22,43
029 Neumarkt,66,,16,23,39
029 Neumarkt,67,,19,19,38
029 Neumarkt,68,,21,22,43
029 Neumarkt,69,,25,29,54
029 Neumarkt,70,,16,24,40
029 Neumarkt,71,,14,18,32
029 Neumarkt,72,,8,21,29
029 Neumarkt,73,,21,21,42
029 Neumarkt,74,,19,19,38
029 Neumarkt,75,,16,21,37
029 Neumarkt,76,,11,15,26
029 Neumarkt,77,,15,28,43
029 Neumarkt,78,,10,17,27
029 Neumarkt,79,,7,26,33
029 Neumarkt,80,,8,20,28
029 Neumarkt,81,,5,12,17
029 Neumarkt,82,,5,4,9
029 Neumarkt,83,,3,8,11
029 Neumarkt,84,,3,6,9
029 Neumarkt,85,,2,7,9
029 Neumarkt,86,,6,9,15
029 Neumarkt,87,,5,7,12
029 Neumarkt,88,,3,7,10
029 Neumarkt,89,,2,7,9
029 Neumarkt,90,,2,5,7
029 Neumarkt,91,,3,3,6
029 Neumarkt,92,,2,2,4
029 Neumarkt,93,,-,2,2
029 Neumarkt,94,,1,3,4
029 Neumarkt,96,,-,1,1
030 Pfalzen,0,,14,16,30
030 Pfalzen,1,,17,15,32
030 Pfalzen,2,,17,14,31
030 Pfalzen,3,,12,14,26
030 Pfalzen,4,,14,14,28
030 Pfalzen,5,,23,16,39
030 Pfalzen,6,,12,15,27
030 Pfalzen,7,,11,16,27
030 Pfalzen,8,,13,22,35
030 Pfalzen,9,,15,20,35
030 Pfalzen,10,,19,12,31
030 Pfalzen,11,,16,19,35
030 Pfalzen,12,,13,8,21
030 Pfalzen,13,,12,23,35
030 Pfalzen,14,,18,18,36
030 Pfalzen,15,,22,13,35
030 Pfalzen,16,,15,11,26
030 Pfalzen,17,,12,10,22
030 Pfalzen,18,,18,19,37
030 Pfalzen,19,,18,19,37
030 Pfalzen,20,,22,17,39
030 Pfalzen,21,,15,20,35
030 Pfalzen,22,,16,20,36
030 Pfalzen,23,,20,18,38
030 Pfalzen,24,,18,10,28
030 Pfalzen,25,,10,17,27
030 Pfalzen,26,,21,18,39
030 Pfalzen,27,,15,21,36
030 Pfalzen,28,,17,18,35
030 Pfalzen,29,,22,19,41
030 Pfalzen,30,,19,19,38
030 Pfalzen,31,,30,15,45
030 Pfalzen,32,,24,32,56
030 Pfalzen,33,,22,21,43
030 Pfalzen,34,,24,23,47
030 Pfalzen,35,,24,25,49
030 Pfalzen,36,,23,15,38
030 Pfalzen,37,,26,18,44
030 Pfalzen,38,,19,28,47
030 Pfalzen,39,,22,16,38
030 Pfalzen,40,,19,12,31
030 Pfalzen,41,,13,14,27
030 Pfalzen,42,,16,20,36
030 Pfalzen,43,,23,18,41
030 Pfalzen,44,,15,14,29
030 Pfalzen,45,,15,11,26
030 Pfalzen,46,,13,12,25
030 Pfalzen,47,,13,11,24
030 Pfalzen,48,,10,10,20
030 Pfalzen,49,,16,16,32
030 Pfalzen,50,,11,11,22
030 Pfalzen,51,,14,6,20
030 Pfalzen,52,,9,10,19
030 Pfalzen,53,,12,4,16
030 Pfalzen,54,,8,9,17
030 Pfalzen,55,,7,9,16
030 Pfalzen,56,,10,6,16
030 Pfalzen,57,,8,12,20
030 Pfalzen,58,,6,13,19
030 Pfalzen,59,,12,8,20
030 Pfalzen,60,,13,9,22
030 Pfalzen,61,,10,6,16
030 Pfalzen,62,,11,10,21
030 Pfalzen,63,,7,6,13
030 Pfalzen,64,,2,9,11
030 Pfalzen,65,,8,5,13
030 Pfalzen,66,,8,13,21
030 Pfalzen,67,,7,8,15
030 Pfalzen,68,,9,6,15
030 Pfalzen,69,,13,7,20
030 Pfalzen,70,,9,11,20
030 Pfalzen,71,,11,7,18
030 Pfalzen,72,,4,5,9
030 Pfalzen,73,,6,5,11
030 Pfalzen,74,,5,4,9
030 Pfalzen,75,,7,4,11
030 Pfalzen,76,,3,11,14
030 Pfalzen,77,,6,8,14
030 Pfalzen,78,,4,3,7
030 Pfalzen,79,,-,7,7
030 Pfalzen,80,,3,7,10
030 Pfalzen,81,,4,4,8
030 Pfalzen,82,,1,1,2
030 Pfalzen,83,,1,2,3
030 Pfalzen,84,,-,2,2
030 Pfalzen,85,,2,-,2
030 Pfalzen,86,,2,6,8
030 Pfalzen,87,,1,3,4
030 Pfalzen,88,,1,1,2
030 Pfalzen,89,,-,1,1
030 Pfalzen,90,,-,3,3
030 Pfalzen,91,,3,1,4
030 Pfalzen,92,,2,1,3
031 Völs am Schlern,0,,23,28,51
031 Völs am Schlern,1,,22,16,38
031 Völs am Schlern,2,,27,26,53
031 Völs am Schlern,3,,18,23,41
031 Völs am Schlern,4,,16,20,36
031 Völs am Schlern,5,,20,23,43
031 Völs am Schlern,6,,22,10,32
031 Völs am Schlern,7,,18,17,35
031 Völs am Schlern,8,,21,17,38
031 Völs am Schlern,9,,15,20,35
031 Völs am Schlern,10,,20,18,38
031 Völs am Schlern,11,,19,15,34
031 Völs am Schlern,12,,17,14,31
031 Völs am Schlern,13,,17,15,32
031 Völs am Schlern,14,,21,12,33
031 Völs am Schlern,15,,18,14,32
031 Völs am Schlern,16,,15,7,22
031 Völs am Schlern,17,,13,22,35
031 Völs am Schlern,18,,20,20,40
031 Völs am Schlern,19,,27,18,45
031 Völs am Schlern,20,,29,13,42
031 Völs am Schlern,21,,19,26,45
031 Völs am Schlern,22,,24,18,42
031 Völs am Schlern,23,,21,24,45
031 Völs am Schlern,24,,23,23,46
031 Völs am Schlern,25,,21,21,42
031 Völs am Schlern,26,,27,24,51
031 Völs am Schlern,27,,28,37,65
031 Völs am Schlern,28,,36,28,64
031 Völs am Schlern,29,,36,39,75
031 Völs am Schlern,30,,29,30,59
031 Völs am Schlern,31,,35,34,69
031 Völs am Schlern,32,,28,35,63
031 Völs am Schlern,33,,30,23,53
031 Völs am Schlern,34,,42,25,67
031 Völs am Schlern,35,,26,28,54
031 Völs am Schlern,36,,28,26,54
031 Völs am Schlern,37,,34,29,63
031 Völs am Schlern,38,,28,19,47
031 Völs am Schlern,39,,25,21,46
031 Völs am Schlern,40,,27,23,50
031 Völs am Schlern,41,,21,12,33
031 Völs am Schlern,42,,23,17,40
031 Völs am Schlern,43,,21,18,39
031 Völs am Schlern,44,,19,18,37
031 Völs am Schlern,45,,17,14,31
031 Völs am Schlern,46,,19,25,44
031 Völs am Schlern,47,,16,24,40
031 Völs am Schlern,48,,18,18,36
031 Völs am Schlern,49,,18,19,37
031 Völs am Schlern,50,,22,15,37
031 Völs am Schlern,51,,17,9,26
031 Völs am Schlern,52,,16,14,30
031 Völs am Schlern,53,,16,19,35
031 Völs am Schlern,54,,15,12,27
031 Völs am Schlern,55,,11,13,24
031 Völs am Schlern,56,,16,10,26
031 Völs am Schlern,57,,14,22,36
031 Völs am Schlern,58,,16,15,31
031 Völs am Schlern,59,,20,18,38
031 Völs am Schlern,60,,11,19,30
031 Völs am Schlern,61,,14,10,24
031 Völs am Schlern,62,,14,13,27
031 Völs am Schlern,63,,10,9,19
031 Völs am Schlern,64,,10,21,31
031 Völs am Schlern,65,,17,12,29
031 Völs am Schlern,66,,15,9,24
031 Völs am Schlern,67,,8,14,22
031 Völs am Schlern,68,,14,8,22
031 Völs am Schlern,69,,13,15,28
031 Völs am Schlern,70,,7,13,20
031 Völs am Schlern,71,,8,12,20
031 Völs am Schlern,72,,7,13,20
031 Völs am Schlern,73,,11,11,22
031 Völs am Schlern,74,,12,6,18
031 Völs am Schlern,75,,10,11,21
031 Völs am Schlern,76,,12,13,25
031 Völs am Schlern,77,,5,6,11
031 Völs am Schlern,78,,5,8,13
031 Völs am Schlern,79,,4,12,16
031 Völs am Schlern,80,,4,6,10
031 Völs am Schlern,81,,1,6,7
031 Völs am Schlern,82,,2,5,7
031 Völs am Schlern,83,,1,6,7
031 Völs am Schlern,84,,3,2,5
031 Völs am Schlern,85,,2,6,8
031 Völs am Schlern,86,,5,4,9
031 Völs am Schlern,87,,6,2,8
031 Völs am Schlern,88,,3,3,6
031 Völs am Schlern,89,,1,5,6
031 Völs am Schlern,90,,1,3,4
031 Völs am Schlern,91,,2,1,3
031 Völs am Schlern,92,,-,3,3
031 Völs am Schlern,93,,-,3,3
031 Völs am Schlern,96,,-,1,1
031 Völs am Schlern,98,,-,1,1
032 Franzensfeste,0,,2,5,7
032 Franzensfeste,1,,5,5,10
032 Franzensfeste,2,,5,5,10
032 Franzensfeste,3,,6,2,8
032 Franzensfeste,4,,6,4,10
032 Franzensfeste,5,,5,2,7
032 Franzensfeste,6,,5,6,11
032 Franzensfeste,7,,5,4,9
032 Franzensfeste,8,,5,8,13
032 Franzensfeste,9,,4,4,8
032 Franzensfeste,10,,1,4,5
032 Franzensfeste,11,,5,4,9
032 Franzensfeste,12,,4,2,6
032 Franzensfeste,13,,4,3,7
032 Franzensfeste,14,,5,4,9
032 Franzensfeste,15,,3,9,12
032 Franzensfeste,16,,3,6,9
032 Franzensfeste,17,,9,4,13
032 Franzensfeste,18,,2,7,9
032 Franzensfeste,19,,6,4,10
032 Franzensfeste,20,,5,9,14
032 Franzensfeste,21,,12,6,18
032 Franzensfeste,22,,5,5,10
032 Franzensfeste,23,,2,2,4
032 Franzensfeste,24,,4,5,9
032 Franzensfeste,25,,8,8,16
032 Franzensfeste,26,,6,8,14
032 Franzensfeste,27,,2,8,10
032 Franzensfeste,28,,7,14,21
032 Franzensfeste,29,,9,2,11
032 Franzensfeste,30,,14,7,21
032 Franzensfeste,31,,7,7,14
032 Franzensfeste,32,,8,11,19
032 Franzensfeste,33,,10,5,15
032 Franzensfeste,34,,9,6,15
032 Franzensfeste,35,,9,4,13
032 Franzensfeste,36,,15,10,25
032 Franzensfeste,37,,5,8,13
032 Franzensfeste,38,,10,2,12
032 Franzensfeste,39,,5,10,15
032 Franzensfeste,40,,6,7,13
032 Franzensfeste,41,,7,9,16
032 Franzensfeste,42,,10,3,13
032 Franzensfeste,43,,3,5,8
032 Franzensfeste,44,,6,7,13
032 Franzensfeste,45,,9,7,16
032 Franzensfeste,46,,4,10,14
032 Franzensfeste,47,,6,6,12
032 Franzensfeste,48,,6,5,11
032 Franzensfeste,49,,7,1,8
032 Franzensfeste,50,,11,3,14
032 Franzensfeste,51,,2,4,6
032 Franzensfeste,52,,5,5,10
032 Franzensfeste,53,,3,4,7
032 Franzensfeste,54,,9,5,14
032 Franzensfeste,55,,4,7,11
032 Franzensfeste,56,,5,9,14
032 Franzensfeste,57,,3,2,5
032 Franzensfeste,58,,5,1,6
032 Franzensfeste,59,,5,2,7
032 Franzensfeste,60,,4,4,8
032 Franzensfeste,61,,7,4,11
032 Franzensfeste,62,,1,4,5
032 Franzensfeste,63,,8,6,14
032 Franzensfeste,64,,4,2,6
032 Franzensfeste,65,,3,3,6
032 Franzensfeste,66,,3,3,6
032 Franzensfeste,67,,2,6,8
032 Franzensfeste,68,,3,7,10
032 Franzensfeste,69,,2,8,10
032 Franzensfeste,70,,6,4,10
032 Franzensfeste,71,,4,8,12
032 Franzensfeste,72,,2,2,4
032 Franzensfeste,73,,3,7,10
032 Franzensfeste,74,,4,9,13
032 Franzensfeste,75,,4,1,5
032 Franzensfeste,76,,6,5,11
032 Franzensfeste,77,,4,7,11
032 Franzensfeste,78,,4,5,9
032 Franzensfeste,79,,2,4,6
032 Franzensfeste,80,,1,4,5
032 Franzensfeste,81,,2,1,3
032 Franzensfeste,82,,-,2,2
032 Franzensfeste,83,,1,-,1
032 Franzensfeste,85,,1,3,4
032 Franzensfeste,86,,1,1,2
032 Franzensfeste,87,,1,1,2
032 Franzensfeste,88,,-,1,1
032 Franzensfeste,89,,-,1,1
032 Franzensfeste,90,,1,-,1
032 Franzensfeste,91,,-,2,2
032 Franzensfeste,92,,-,1,1
032 Franzensfeste,96,,-,1,1
033 Villnöss,0,,18,20,38
033 Villnöss,1,,16,32,48
033 Villnöss,2,,22,20,42
033 Villnöss,3,,16,24,40
033 Villnöss,4,,23,19,42
033 Villnöss,5,,16,13,29
033 Villnöss,6,,14,12,26
033 Villnöss,7,,17,10,27
033 Villnöss,8,,12,14,26
033 Villnöss,9,,21,16,37
033 Villnöss,10,,13,12,25
033 Villnöss,11,,11,7,18
033 Villnöss,12,,16,23,39
033 Villnöss,13,,16,19,35
033 Villnöss,14,,11,16,27
033 Villnöss,15,,17,17,34
033 Villnöss,16,,15,14,29
033 Villnöss,17,,17,14,31
033 Villnöss,18,,11,15,26
033 Villnöss,19,,12,18,30
033 Villnöss,20,,20,10,30
033 Villnöss,21,,11,11,22
033 Villnöss,22,,15,13,28
033 Villnöss,23,,19,15,34
033 Villnöss,24,,15,13,28
033 Villnöss,25,,23,16,39
033 Villnöss,26,,21,20,41
033 Villnöss,27,,14,20,34
033 Villnöss,28,,20,26,46
033 Villnöss,29,,27,26,53
033 Villnöss,30,,19,30,49
033 Villnöss,31,,31,22,53
033 Villnöss,32,,29,19,48
033 Villnöss,33,,22,18,40
033 Villnöss,34,,26,21,47
033 Villnöss,35,,30,25,55
033 Villnöss,36,,33,24,57
033 Villnöss,37,,29,19,48
033 Villnöss,38,,27,20,47
033 Villnöss,39,,24,15,39
033 Villnöss,40,,20,13,33
033 Villnöss,41,,11,12,23
033 Villnöss,42,,8,15,23
033 Villnöss,43,,13,12,25
033 Villnöss,44,,14,16,30
033 Villnöss,45,,12,2,14
033 Villnöss,46,,16,13,29
033 Villnöss,47,,13,13,26
033 Villnöss,48,,13,11,24
033 Villnöss,49,,9,8,17
033 Villnöss,50,,7,10,17
033 Villnöss,51,,10,14,24
033 Villnöss,52,,9,9,18
033 Villnöss,53,,11,11,22
033 Villnöss,54,,8,5,13
033 Villnöss,55,,7,4,11
033 Villnöss,56,,9,14,23
033 Villnöss,57,,13,10,23
033 Villnöss,58,,13,18,31
033 Villnöss,59,,13,10,23
033 Villnöss,60,,8,18,26
033 Villnöss,61,,12,13,25
033 Villnöss,62,,12,9,21
033 Villnöss,63,,11,14,25
033 Villnöss,64,,5,16,21
033 Villnöss,65,,5,10,15
033 Villnöss,66,,11,9,20
033 Villnöss,67,,11,11,22
033 Villnöss,68,,15,13,28
033 Villnöss,69,,10,11,21
033 Villnöss,70,,12,10,22
033 Villnöss,71,,10,12,22
033 Villnöss,72,,16,6,22
033 Villnöss,73,,8,11,19
033 Villnöss,74,,4,8,12
033 Villnöss,75,,9,6,15
033 Villnöss,76,,5,13,18
033 Villnöss,77,,7,12,19
033 Villnöss,78,,4,12,16
033 Villnöss,79,,1,8,9
033 Villnöss,80,,1,6,7
033 Villnöss,81,,3,5,8
033 Villnöss,82,,1,2,3
033 Villnöss,83,,2,4,6
033 Villnöss,84,,1,1,2
033 Villnöss,85,,2,3,5
033 Villnöss,86,,5,2,7
033 Villnöss,87,,2,2,4
033 Villnöss,88,,-,1,1
033 Villnöss,89,,1,1,2
033 Villnöss,90,,1,3,4
033 Villnöss,91,,1,3,4
033 Villnöss,92,,-,4,4
033 Villnöss,94,,2,1,3
033 Villnöss,95,,-,1,1
034 Gais,0,,22,19,41
034 Gais,1,,21,29,50
034 Gais,2,,24,21,45
034 Gais,3,,26,12,38
034 Gais,4,,9,22,31
034 Gais,5,,26,17,43
034 Gais,6,,22,24,46
034 Gais,7,,13,18,31
034 Gais,8,,20,28,48
034 Gais,9,,26,29,55
034 Gais,10,,14,20,34
034 Gais,11,,17,13,30
034 Gais,12,,19,16,35
034 Gais,13,,16,20,36
034 Gais,14,,17,18,35
034 Gais,15,,22,16,38
034 Gais,16,,23,15,38
034 Gais,17,,21,19,40
034 Gais,18,,18,18,36
034 Gais,19,,22,19,41
034 Gais,20,,24,20,44
034 Gais,21,,25,14,39
034 Gais,22,,19,17,36
034 Gais,23,,17,22,39
034 Gais,24,,24,21,45
034 Gais,25,,20,19,39
034 Gais,26,,25,29,54
034 Gais,27,,27,26,53
034 Gais,28,,25,37,62
034 Gais,29,,32,24,56
034 Gais,30,,28,26,54
034 Gais,31,,35,34,69
034 Gais,32,,24,25,49
034 Gais,33,,25,29,54
034 Gais,34,,34,19,53
034 Gais,35,,31,27,58
034 Gais,36,,28,30,58
034 Gais,37,,15,16,31
034 Gais,38,,31,18,49
034 Gais,39,,22,28,50
034 Gais,40,,20,12,32
034 Gais,41,,18,22,40
034 Gais,42,,24,19,43
034 Gais,43,,11,15,26
034 Gais,44,,27,20,47
034 Gais,45,,16,12,28
034 Gais,46,,15,13,28
034 Gais,47,,15,13,28
034 Gais,48,,15,16,31
034 Gais,49,,17,19,36
034 Gais,50,,22,20,42
034 Gais,51,,16,11,27
034 Gais,52,,25,14,39
034 Gais,53,,22,13,35
034 Gais,54,,18,17,35
034 Gais,55,,11,9,20
034 Gais,56,,12,13,25
034 Gais,57,,13,16,29
034 Gais,58,,14,14,28
034 Gais,59,,20,14,34
034 Gais,60,,18,13,31
034 Gais,61,,12,16,28
034 Gais,62,,14,14,28
034 Gais,63,,18,16,34
034 Gais,64,,10,13,23
034 Gais,65,,14,12,26
034 Gais,66,,7,6,13
034 Gais,67,,4,10,14
034 Gais,68,,9,11,20
034 Gais,69,,11,8,19
034 Gais,70,,4,13,17
034 Gais,71,,5,5,10
034 Gais,72,,10,8,18
034 Gais,73,,6,9,15
034 Gais,74,,13,9,22
034 Gais,75,,6,6,12
034 Gais,76,,5,8,13
034 Gais,77,,5,11,16
034 Gais,78,,3,4,7
034 Gais,79,,3,5,8
034 Gais,80,,2,2,4
034 Gais,81,,1,3,4
034 Gais,82,,2,5,7
034 Gais,83,,1,3,4
034 Gais,84,,-,3,3
034 Gais,85,,-,3,3
034 Gais,86,,1,4,5
034 Gais,87,,3,2,5
034 Gais,88,,-,2,2
034 Gais,89,,1,2,3
034 Gais,90,,1,1,2
034 Gais,91,,-,1,1
034 Gais,92,,-,1,1
034 Gais,93,,-,1,1
035 Gargazon,0,,10,4,14
035 Gargazon,1,,13,6,19
035 Gargazon,2,,13,5,18
035 Gargazon,3,,6,12,18
035 Gargazon,4,,9,5,14
035 Gargazon,5,,12,5,17
035 Gargazon,6,,3,7,10
035 Gargazon,7,,11,8,19
035 Gargazon,8,,11,7,18
035 Gargazon,9,,17,10,27
035 Gargazon,10,,5,11,16
035 Gargazon,11,,8,6,14
035 Gargazon,12,,9,4,13
035 Gargazon,13,,6,10,16
035 Gargazon,14,,5,10,15
035 Gargazon,15,,10,4,14
035 Gargazon,16,,11,3,14
035 Gargazon,17,,4,7,11
035 Gargazon,18,,5,8,13
035 Gargazon,19,,10,5,15
035 Gargazon,20,,6,11,17
035 Gargazon,21,,6,8,14
035 Gargazon,22,,2,7,9
035 Gargazon,23,,4,6,10
035 Gargazon,24,,5,4,9
035 Gargazon,25,,9,5,14
035 Gargazon,26,,5,11,16
035 Gargazon,27,,8,5,13
035 Gargazon,28,,8,17,25
035 Gargazon,29,,10,13,23
035 Gargazon,30,,10,8,18
035 Gargazon,31,,12,10,22
035 Gargazon,32,,17,15,32
035 Gargazon,33,,16,20,36
035 Gargazon,34,,13,12,25
035 Gargazon,35,,11,9,20
035 Gargazon,36,,15,15,30
035 Gargazon,37,,15,15,30
035 Gargazon,38,,12,12,24
035 Gargazon,39,,9,11,20
035 Gargazon,40,,8,12,20
035 Gargazon,41,,16,11,27
035 Gargazon,42,,7,7,14
035 Gargazon,43,,18,10,28
035 Gargazon,44,,12,6,18
035 Gargazon,45,,8,2,10
035 Gargazon,46,,9,11,20
035 Gargazon,47,,15,9,24
035 Gargazon,48,,3,7,10
035 Gargazon,49,,10,8,18
035 Gargazon,50,,7,6,13
035 Gargazon,51,,6,10,16
035 Gargazon,52,,8,8,16
035 Gargazon,53,,4,10,14
035 Gargazon,54,,7,13,20
035 Gargazon,55,,8,4,12
035 Gargazon,56,,2,5,7
035 Gargazon,57,,3,7,10
035 Gargazon,58,,8,12,20
035 Gargazon,59,,10,9,19
035 Gargazon,60,,5,15,20
035 Gargazon,61,,9,6,15
035 Gargazon,62,,10,7,17
035 Gargazon,63,,8,13,21
035 Gargazon,64,,5,4,9
035 Gargazon,65,,12,2,14
035 Gargazon,66,,8,5,13
035 Gargazon,67,,3,10,13
035 Gargazon,68,,7,2,9
035 Gargazon,69,,5,7,12
035 Gargazon,70,,4,6,10
035 Gargazon,71,,2,10,12
035 Gargazon,72,,4,5,9
035 Gargazon,73,,4,5,9
035 Gargazon,74,,5,4,9
035 Gargazon,75,,5,6,11
035 Gargazon,76,,1,4,5
035 Gargazon,77,,5,6,11
035 Gargazon,78,,3,7,10
035 Gargazon,79,,5,5,10
035 Gargazon,80,,4,1,5
035 Gargazon,81,,2,2,4
035 Gargazon,82,,-,2,2
035 Gargazon,83,,-,2,2
035 Gargazon,84,,-,2,2
035 Gargazon,85,,2,3,5
035 Gargazon,86,,2,2,4
035 Gargazon,87,,2,4,6
035 Gargazon,88,,2,4,6
035 Gargazon,91,,-,1,1
035 Gargazon,94,,-,1,1
035 Gargazon,96,,-,1,1
036 Glurns,0,,4,4,8
036 Glurns,1,,5,5,10
036 Glurns,2,,9,4,13
036 Glurns,3,,4,7,11
036 Glurns,4,,7,5,12
036 Glurns,5,,7,4,11
036 Glurns,6,,2,3,5
036 Glurns,7,,8,7,15
036 Glurns,8,,4,8,12
036 Glurns,9,,6,4,10
036 Glurns,10,,8,6,14
036 Glurns,11,,4,3,7
036 Glurns,12,,6,9,15
036 Glurns,13,,6,6,12
036 Glurns,14,,5,8,13
036 Glurns,15,,3,3,6
036 Glurns,16,,7,6,13
036 Glurns,17,,9,6,15
036 Glurns,18,,11,9,20
036 Glurns,19,,6,8,14
036 Glurns,20,,13,8,21
036 Glurns,21,,6,9,15
036 Glurns,22,,5,10,15
036 Glurns,23,,5,2,7
036 Glurns,24,,9,4,13
036 Glurns,25,,7,7,14
036 Glurns,26,,8,9,17
036 Glurns,27,,3,3,6
036 Glurns,28,,5,6,11
036 Glurns,29,,6,6,12
036 Glurns,30,,3,-,3
036 Glurns,31,,4,5,9
036 Glurns,32,,7,5,12
036 Glurns,33,,7,10,17
036 Glurns,34,,5,7,12
036 Glurns,35,,-,6,6
036 Glurns,36,,8,4,12
036 Glurns,37,,6,9,15
036 Glurns,38,,4,5,9
036 Glurns,39,,4,6,10
036 Glurns,40,,8,8,16
036 Glurns,41,,12,9,21
036 Glurns,42,,5,10,15
036 Glurns,43,,6,11,17
036 Glurns,44,,7,5,12
036 Glurns,45,,10,7,17
036 Glurns,46,,12,4,16
036 Glurns,47,,8,9,17
036 Glurns,48,,5,10,15
036 Glurns,49,,8,10,18
036 Glurns,50,,6,5,11
036 Glurns,51,,6,3,9
036 Glurns,52,,7,5,12
036 Glurns,53,,10,7,17
036 Glurns,54,,9,2,11
036 Glurns,55,,7,1,8
036 Glurns,56,,4,4,8
036 Glurns,57,,1,4,5
036 Glurns,58,,5,5,10
036 Glurns,59,,5,2,7
036 Glurns,60,,5,1,6
036 Glurns,61,,1,3,4
036 Glurns,62,,4,4,8
036 Glurns,63,,5,5,10
036 Glurns,64,,-,1,1
036 Glurns,65,,2,4,6
036 Glurns,66,,1,6,7
036 Glurns,67,,1,1,2
036 Glurns,68,,8,3,11
036 Glurns,69,,4,2,6
036 Glurns,70,,5,2,7
036 Glurns,71,,5,7,12
036 Glurns,72,,1,3,4
036 Glurns,73,,1,3,4
036 Glurns,74,,-,2,2
036 Glurns,75,,1,6,7
036 Glurns,76,,2,2,4
036 Glurns,77,,-,1,1
036 Glurns,78,,1,-,1
036 Glurns,79,,2,3,5
036 Glurns,80,,1,2,3
036 Glurns,81,,1,3,4
036 Glurns,82,,-,2,2
036 Glurns,83,,1,2,3
036 Glurns,85,,-,3,3
036 Glurns,86,,-,3,3
036 Glurns,87,,1,4,5
036 Glurns,88,,-,3,3
036 Glurns,89,,1,3,4
036 Glurns,90,,-,1,1
036 Glurns,91,,-,1,1
036 Glurns,93,,-,1,1
037 Latsch,0,,36,37,73
037 Latsch,1,,27,19,46
037 Latsch,2,,31,24,55
037 Latsch,3,,35,40,75
037 Latsch,4,,36,36,72
037 Latsch,5,,47,33,80
037 Latsch,6,,41,23,64
037 Latsch,7,,34,32,66
037 Latsch,8,,33,36,69
037 Latsch,9,,28,34,62
037 Latsch,10,,34,50,84
037 Latsch,11,,34,30,64
037 Latsch,12,,39,33,72
037 Latsch,13,,31,38,69
037 Latsch,14,,34,24,58
037 Latsch,15,,33,34,67
037 Latsch,16,,33,36,69
037 Latsch,17,,26,33,59
037 Latsch,18,,31,47,78
037 Latsch,19,,26,38,64
037 Latsch,20,,33,36,69
037 Latsch,21,,37,27,64
037 Latsch,22,,31,23,54
037 Latsch,23,,27,34,61
037 Latsch,24,,22,19,41
037 Latsch,25,,35,30,65
037 Latsch,26,,29,27,56
037 Latsch,27,,31,38,69
037 Latsch,28,,32,41,73
037 Latsch,29,,40,41,81
037 Latsch,30,,39,38,77
037 Latsch,31,,44,43,87
037 Latsch,32,,43,58,101
037 Latsch,33,,49,51,100
037 Latsch,34,,33,51,84
037 Latsch,35,,52,49,101
037 Latsch,36,,59,40,99
037 Latsch,37,,53,52,105
037 Latsch,38,,44,45,89
037 Latsch,39,,49,40,89
037 Latsch,40,,42,53,95
037 Latsch,41,,46,44,90
037 Latsch,42,,40,30,70
037 Latsch,43,,27,32,59
037 Latsch,44,,31,33,64
037 Latsch,45,,38,28,66
037 Latsch,46,,33,22,55
037 Latsch,47,,28,21,49
037 Latsch,48,,42,20,62
037 Latsch,49,,20,33,53
037 Latsch,50,,32,16,48
037 Latsch,51,,15,22,37
037 Latsch,52,,16,21,37
037 Latsch,53,,19,16,35
037 Latsch,54,,18,22,40
037 Latsch,55,,20,18,38
037 Latsch,56,,25,13,38
037 Latsch,57,,26,23,49
037 Latsch,58,,29,23,52
037 Latsch,59,,17,27,44
037 Latsch,60,,21,25,46
037 Latsch,61,,18,19,37
037 Latsch,62,,18,30,48
037 Latsch,63,,13,28,41
037 Latsch,64,,20,14,34
037 Latsch,65,,28,16,44
037 Latsch,66,,21,26,47
037 Latsch,67,,21,21,42
037 Latsch,68,,24,21,45
037 Latsch,69,,19,19,38
037 Latsch,70,,21,20,41
037 Latsch,71,,19,17,36
037 Latsch,72,,17,19,36
037 Latsch,73,,17,31,48
037 Latsch,74,,20,15,35
037 Latsch,75,,19,22,41
037 Latsch,76,,10,18,28
037 Latsch,77,,12,22,34
037 Latsch,78,,11,23,34
037 Latsch,79,,15,18,33
037 Latsch,80,,10,9,19
037 Latsch,81,,7,12,19
037 Latsch,82,,2,4,6
037 Latsch,83,,4,7,11
037 Latsch,84,,1,5,6
037 Latsch,85,,3,4,7
037 Latsch,86,,3,6,9
037 Latsch,87,,3,8,11
037 Latsch,88,,3,2,5
037 Latsch,89,,2,3,5
037 Latsch,90,,1,2,3
037 Latsch,91,,1,3,4
037 Latsch,92,,2,2,4
037 Latsch,94,,-,4,4
038 Algund,0,,23,30,53
038 Algund,1,,34,25,59
038 Algund,2,,21,21,42
038 Algund,3,,19,20,39
038 Algund,4,,15,20,35
038 Algund,5,,33,23,56
038 Algund,6,,25,13,38
038 Algund,7,,26,18,44
038 Algund,8,,31,18,49
038 Algund,9,,26,21,47
038 Algund,10,,28,18,46
038 Algund,11,,19,28,47
038 Algund,12,,19,24,43
038 Algund,13,,27,21,48
038 Algund,14,,21,31,52
038 Algund,15,,24,20,44
038 Algund,16,,21,21,42
038 Algund,17,,24,29,53
038 Algund,18,,25,21,46
038 Algund,19,,23,20,43
038 Algund,20,,27,26,53
038 Algund,21,,19,22,41
038 Algund,22,,18,29,47
038 Algund,23,,18,30,48
038 Algund,24,,23,24,47
038 Algund,25,,28,22,50
038 Algund,26,,24,25,49
038 Algund,27,,30,16,46
038 Algund,28,,27,35,62
038 Algund,29,,23,31,54
038 Algund,30,,45,27,72
038 Algund,31,,34,33,67
038 Algund,32,,39,32,71
038 Algund,33,,35,37,72
038 Algund,34,,34,37,71
038 Algund,35,,30,39,69
038 Algund,36,,46,28,74
038 Algund,37,,36,43,79
038 Algund,38,,32,36,68
038 Algund,39,,26,45,71
038 Algund,40,,30,42,72
038 Algund,41,,36,30,66
038 Algund,42,,40,30,70
038 Algund,43,,28,29,57
038 Algund,44,,30,27,57
038 Algund,45,,23,27,50
038 Algund,46,,30,21,51
038 Algund,47,,18,32,50
038 Algund,48,,25,25,50
038 Algund,49,,28,28,56
038 Algund,50,,22,25,47
038 Algund,51,,26,27,53
038 Algund,52,,26,23,49
038 Algund,53,,21,21,42
038 Algund,54,,35,27,62
038 Algund,55,,23,25,48
038 Algund,56,,25,25,50
038 Algund,57,,21,20,41
038 Algund,58,,17,36,53
038 Algund,59,,21,22,43
038 Algund,60,,15,26,41
038 Algund,61,,26,30,56
038 Algund,62,,22,24,46
038 Algund,63,,16,13,29
038 Algund,64,,16,29,45
038 Algund,65,,15,20,35
038 Algund,66,,23,23,46
038 Algund,67,,23,22,45
038 Algund,68,,17,22,39
038 Algund,69,,14,25,39
038 Algund,70,,15,24,39
038 Algund,71,,14,22,36
038 Algund,72,,13,21,34
038 Algund,73,,12,19,31
038 Algund,74,,15,21,36
038 Algund,75,,11,15,26
038 Algund,76,,7,18,25
038 Algund,77,,5,12,17
038 Algund,78,,11,19,30
038 Algund,79,,12,14,26
038 Algund,80,,13,12,25
038 Algund,81,,6,12,18
038 Algund,82,,7,7,14
038 Algund,83,,4,6,10
038 Algund,84,,2,7,9
038 Algund,85,,4,6,10
038 Algund,86,,5,8,13
038 Algund,87,,2,6,8
038 Algund,88,,4,10,14
038 Algund,89,,1,9,10
038 Algund,90,,6,7,13
038 Algund,91,,3,1,4
038 Algund,92,,4,5,9
038 Algund,93,,-,3,3
038 Algund,94,,-,4,4
038 Algund,95,,-,3,3
039 Lajen,0,,24,13,37
039 Lajen,1,,16,17,33
039 Lajen,2,,20,16,36
039 Lajen,3,,13,22,35
039 Lajen,4,,17,9,26
039 Lajen,5,,8,10,18
039 Lajen,6,,12,14,26
039 Lajen,7,,13,13,26
039 Lajen,8,,15,10,25
039 Lajen,9,,19,19,38
039 Lajen,10,,8,10,18
039 Lajen,11,,17,15,32
039 Lajen,12,,13,10,23
039 Lajen,13,,13,6,19
039 Lajen,14,,19,13,32
039 Lajen,15,,19,11,30
039 Lajen,16,,9,13,22
039 Lajen,17,,8,19,27
039 Lajen,18,,19,15,34
039 Lajen,19,,10,25,35
039 Lajen,20,,20,20,40
039 Lajen,21,,20,12,32
039 Lajen,22,,22,17,39
039 Lajen,23,,19,9,28
039 Lajen,24,,20,14,34
039 Lajen,25,,19,28,47
039 Lajen,26,,29,17,46
039 Lajen,27,,17,19,36
039 Lajen,28,,21,26,47
039 Lajen,29,,18,22,40
039 Lajen,30,,21,23,44
039 Lajen,31,,29,22,51
039 Lajen,32,,20,21,41
039 Lajen,33,,25,21,46
039 Lajen,34,,22,17,39
039 Lajen,35,,29,18,47
039 Lajen,36,,22,16,38
039 Lajen,37,,15,10,25
039 Lajen,38,,27,14,41
039 Lajen,39,,11,23,34
039 Lajen,40,,11,10,21
039 Lajen,41,,16,23,39
039 Lajen,42,,20,12,32
039 Lajen,43,,15,11,26
039 Lajen,44,,11,13,24
039 Lajen,45,,12,11,23
039 Lajen,46,,5,13,18
039 Lajen,47,,9,8,17
039 Lajen,48,,8,11,19
039 Lajen,49,,9,12,21
039 Lajen,50,,12,15,27
039 Lajen,51,,5,13,18
039 Lajen,52,,9,15,24
039 Lajen,53,,14,7,21
039 Lajen,54,,11,10,21
039 Lajen,55,,13,9,22
039 Lajen,56,,11,8,19
039 Lajen,57,,11,13,24
039 Lajen,58,,19,12,31
039 Lajen,59,,17,16,33
039 Lajen,60,,15,11,26
039 Lajen,61,,15,10,25
039 Lajen,62,,6,16,22
039 Lajen,63,,7,8,15
039 Lajen,64,,7,9,16
039 Lajen,65,,8,9,17
039 Lajen,66,,8,8,16
039 Lajen,67,,5,13,18
039 Lajen,68,,10,4,14
039 Lajen,69,,4,8,12
039 Lajen,70,,8,4,12
039 Lajen,71,,5,5,10
039 Lajen,72,,8,10,18
039 Lajen,73,,8,11,19
039 Lajen,74,,10,6,16
039 Lajen,75,,5,9,14
039 Lajen,76,,5,8,13
039 Lajen,77,,6,8,14
039 Lajen,78,,4,6,10
039 Lajen,79,,5,9,14
039 Lajen,80,,2,3,5
039 Lajen,81,,3,3,6
039 Lajen,82,,1,3,4
039 Lajen,83,,1,2,3
039 Lajen,84,,-,2,2
039 Lajen,85,,2,3,5
039 Lajen,86,,-,3,3
039 Lajen,87,,2,2,4
039 Lajen,88,,2,2,4
039 Lajen,89,,2,-,2
039 Lajen,90,,-,1,1
039 Lajen,91,,2,2,4
039 Lajen,92,,1,2,3
039 Lajen,93,,-,2,2
039 Lajen,94,,1,2,3
039 Lajen,97,,-,1,1
040 Leifers,0,,95,87,182
040 Leifers,1,,87,96,183
040 Leifers,2,,86,97,183
040 Leifers,3,,105,84,189
040 Leifers,4,,95,83,178
040 Leifers,5,,93,93,186
040 Leifers,6,,84,89,173
040 Leifers,7,,79,69,148
040 Leifers,8,,81,73,154
040 Leifers,9,,88,79,167
040 Leifers,10,,91,78,169
040 Leifers,11,,68,78,146
040 Leifers,12,,70,82,152
040 Leifers,13,,63,68,131
040 Leifers,14,,79,82,161
040 Leifers,15,,76,62,138
040 Leifers,16,,72,71,143
040 Leifers,17,,76,92,168
040 Leifers,18,,60,61,121
040 Leifers,19,,68,63,131
040 Leifers,20,,67,65,132
040 Leifers,21,,69,81,150
040 Leifers,22,,89,76,165
040 Leifers,23,,101,96,197
040 Leifers,24,,109,86,195
040 Leifers,25,,127,111,238
040 Leifers,26,,150,123,273
040 Leifers,27,,136,113,249
040 Leifers,28,,128,125,253
040 Leifers,29,,128,143,271
040 Leifers,30,,124,139,263
040 Leifers,31,,156,129,285
040 Leifers,32,,139,163,302
040 Leifers,33,,149,136,285
040 Leifers,34,,151,126,277
040 Leifers,35,,166,135,301
040 Leifers,36,,169,153,322
040 Leifers,37,,145,144,289
040 Leifers,38,,139,122,261
040 Leifers,39,,124,141,265
040 Leifers,40,,135,120,255
040 Leifers,41,,118,106,224
040 Leifers,42,,91,108,199
040 Leifers,43,,105,112,217
040 Leifers,44,,136,131,267
040 Leifers,45,,107,124,231
040 Leifers,46,,94,103,197
040 Leifers,47,,111,118,229
040 Leifers,48,,102,96,198
040 Leifers,49,,107,92,199
040 Leifers,50,,95,85,180
040 Leifers,51,,99,99,198
040 Leifers,52,,114,102,216
040 Leifers,53,,104,102,206
040 Leifers,54,,123,153,276
040 Leifers,55,,84,84,168
040 Leifers,56,,98,91,189
040 Leifers,57,,97,91,188
040 Leifers,58,,96,95,191
040 Leifers,59,,88,82,170
040 Leifers,60,,96,94,190
040 Leifers,61,,96,91,187
040 Leifers,62,,94,77,171
040 Leifers,63,,64,83,147
040 Leifers,64,,60,68,128
040 Leifers,65,,57,68,125
040 Leifers,66,,71,66,137
040 Leifers,67,,61,64,125
040 Leifers,68,,69,79,148
040 Leifers,69,,56,64,120
040 Leifers,70,,58,68,126
040 Leifers,71,,47,62,109
040 Leifers,72,,48,40,88
040 Leifers,73,,40,65,105
040 Leifers,74,,36,52,88
040 Leifers,75,,30,51,81
040 Leifers,76,,29,55,84
040 Leifers,77,,31,40,71
040 Leifers,78,,29,41,70
040 Leifers,79,,22,27,49
040 Leifers,80,,18,27,45
040 Leifers,81,,13,37,50
040 Leifers,82,,6,21,27
040 Leifers,83,,3,14,17
040 Leifers,84,,6,16,22
040 Leifers,85,,4,16,20
040 Leifers,86,,5,22,27
040 Leifers,87,,11,16,27
040 Leifers,88,,7,23,30
040 Leifers,89,,5,16,21
040 Leifers,90,,3,14,17
040 Leifers,91,,6,6,12
040 Leifers,92,,3,3,6
040 Leifers,93,,2,4,6
040 Leifers,94,,-,3,3
040 Leifers,95,,1,3,4
040 Leifers,96,,-,3,3
040 Leifers,97,,-,1,1
040 Leifers,100,,-,1,1
041 Lana,0,,66,68,134
041 Lana,1,,71,53,124
041 Lana,2,,56,60,116
041 Lana,3,,55,59,114
041 Lana,4,,63,71,134
041 Lana,5,,55,57,112
041 Lana,6,,58,68,126
041 Lana,7,,56,52,108
041 Lana,8,,59,57,116
041 Lana,9,,51,57,108
041 Lana,10,,51,58,109
041 Lana,11,,45,73,118
041 Lana,12,,59,46,105
041 Lana,13,,70,47,117
041 Lana,14,,53,49,102
041 Lana,15,,62,57,119
041 Lana,16,,60,47,107
041 Lana,17,,65,55,120
041 Lana,18,,66,49,115
041 Lana,19,,45,62,107
041 Lana,20,,47,47,94
041 Lana,21,,53,65,118
041 Lana,22,,66,51,117
041 Lana,23,,67,50,117
041 Lana,24,,59,63,122
041 Lana,25,,60,60,120
041 Lana,26,,74,67,141
041 Lana,27,,66,90,156
041 Lana,28,,90,80,170
041 Lana,29,,79,80,159
041 Lana,30,,77,92,169
041 Lana,31,,119,77,196
041 Lana,32,,80,86,166
041 Lana,33,,93,89,182
041 Lana,34,,92,104,196
041 Lana,35,,91,89,180
041 Lana,36,,96,93,189
041 Lana,37,,96,86,182
041 Lana,38,,86,76,162
041 Lana,39,,81,85,166
041 Lana,40,,80,75,155
041 Lana,41,,79,74,153
041 Lana,42,,72,87,159
041 Lana,43,,74,71,145
041 Lana,44,,60,58,118
041 Lana,45,,66,71,137
041 Lana,46,,61,63,124
041 Lana,47,,55,64,119
041 Lana,48,,50,57,107
041 Lana,49,,54,61,115
041 Lana,50,,53,55,108
041 Lana,51,,53,54,107
041 Lana,52,,55,67,122
041 Lana,53,,55,44,99
041 Lana,54,,66,60,126
041 Lana,55,,43,52,95
041 Lana,56,,49,56,105
041 Lana,57,,65,58,123
041 Lana,58,,58,67,125
041 Lana,59,,52,46,98
041 Lana,60,,42,47,89
041 Lana,61,,55,54,109
041 Lana,62,,45,54,99
041 Lana,63,,35,41,76
041 Lana,64,,44,50,94
041 Lana,65,,37,39,76
041 Lana,66,,40,45,85
041 Lana,67,,34,43,77
041 Lana,68,,31,34,65
041 Lana,69,,29,47,76
041 Lana,70,,28,39,67
041 Lana,71,,23,38,61
041 Lana,72,,37,31,68
041 Lana,73,,30,36,66
041 Lana,74,,26,40,66
041 Lana,75,,32,42,74
041 Lana,76,,12,27,39
041 Lana,77,,20,31,51
041 Lana,78,,25,40,65
041 Lana,79,,15,37,52
041 Lana,80,,17,35,52
041 Lana,81,,11,28,39
041 Lana,82,,4,12,16
041 Lana,83,,3,20,23
041 Lana,84,,4,7,11
041 Lana,85,,14,19,33
041 Lana,86,,10,13,23
041 Lana,87,,6,24,30
041 Lana,88,,6,14,20
041 Lana,89,,4,15,19
041 Lana,90,,2,10,12
041 Lana,91,,3,9,12
041 Lana,92,,1,5,6
041 Lana,93,,2,6,8
041 Lana,94,,1,4,5
041 Lana,95,,1,1,2
041 Lana,96,,-,1,1
041 Lana,97,,1,3,4
041 Lana,100,,1,-,1
041 Lana,101,,1,-,1
042 Laas,0,,24,29,53
042 Laas,1,,20,12,32
042 Laas,2,,27,30,57
042 Laas,3,,27,27,54
042 Laas,4,,32,35,67
042 Laas,5,,31,24,55
042 Laas,6,,25,26,51
042 Laas,7,,24,20,44
042 Laas,8,,15,26,41
042 Laas,9,,23,20,43
042 Laas,10,,21,25,46
042 Laas,11,,21,23,44
042 Laas,12,,24,19,43
042 Laas,13,,28,24,52
042 Laas,14,,33,21,54
042 Laas,15,,28,28,56
042 Laas,16,,28,27,55
042 Laas,17,,22,38,60
042 Laas,18,,34,24,58
042 Laas,19,,24,28,52
042 Laas,20,,18,23,41
042 Laas,21,,30,33,63
042 Laas,22,,31,23,54
042 Laas,23,,24,20,44
042 Laas,24,,24,27,51
042 Laas,25,,29,24,53
042 Laas,26,,36,25,61
042 Laas,27,,30,33,63
042 Laas,28,,27,22,49
042 Laas,29,,28,25,53
042 Laas,30,,37,26,63
042 Laas,31,,35,39,74
042 Laas,32,,39,23,62
042 Laas,33,,31,26,57
042 Laas,34,,33,26,59
042 Laas,35,,39,34,73
042 Laas,36,,28,33,61
042 Laas,37,,28,27,55
042 Laas,38,,33,28,61
042 Laas,39,,28,26,54
042 Laas,40,,34,24,58
042 Laas,41,,35,28,63
042 Laas,42,,28,24,52
042 Laas,43,,20,26,46
042 Laas,44,,24,18,42
042 Laas,45,,16,14,30
042 Laas,46,,16,24,40
042 Laas,47,,25,13,38
042 Laas,48,,30,24,54
042 Laas,49,,15,16,31
042 Laas,50,,21,24,45
042 Laas,51,,20,20,40
042 Laas,52,,17,21,38
042 Laas,53,,28,13,41
042 Laas,54,,13,14,27
042 Laas,55,,15,12,27
042 Laas,56,,12,15,27
042 Laas,57,,13,16,29
042 Laas,58,,17,19,36
042 Laas,59,,16,21,37
042 Laas,60,,21,25,46
042 Laas,61,,14,24,38
042 Laas,62,,20,13,33
042 Laas,63,,16,15,31
042 Laas,64,,22,12,34
042 Laas,65,,18,20,38
042 Laas,66,,13,19,32
042 Laas,67,,20,12,32
042 Laas,68,,16,18,34
042 Laas,69,,20,23,43
042 Laas,70,,17,20,37
042 Laas,71,,16,12,28
042 Laas,72,,12,13,25
042 Laas,73,,15,20,35
042 Laas,74,,17,11,28
042 Laas,75,,10,13,23
042 Laas,76,,8,20,28
042 Laas,77,,15,10,25
042 Laas,78,,9,20,29
042 Laas,79,,4,7,11
042 Laas,80,,7,10,17
042 Laas,81,,4,10,14
042 Laas,82,,5,4,9
042 Laas,83,,3,3,6
042 Laas,84,,2,4,6
042 Laas,85,,-,2,2
042 Laas,86,,2,7,9
042 Laas,87,,2,6,8
042 Laas,88,,3,7,10
042 Laas,89,,-,5,5
042 Laas,90,,3,2,5
042 Laas,91,,-,3,3
042 Laas,92,,-,2,2
042 Laas,93,,-,1,1
042 Laas,95,,-,2,2
042 Laas,100,,-,1,1
043 Laurein,0,,3,7,10
043 Laurein,1,,3,3,6
043 Laurein,2,,2,3,5
043 Laurein,3,,4,5,9
043 Laurein,4,,1,2,3
043 Laurein,5,,3,3,6
043 Laurein,6,,2,4,6
043 Laurein,7,,1,5,6
043 Laurein,8,,1,1,2
043 Laurein,9,,1,1,2
043 Laurein,10,,4,-,4
043 Laurein,11,,3,2,5
043 Laurein,12,,1,-,1
043 Laurein,13,,2,2,4
043 Laurein,14,,4,2,6
043 Laurein,15,,2,2,4
043 Laurein,16,,1,2,3
043 Laurein,18,,2,2,4
043 Laurein,19,,3,1,4
043 Laurein,20,,2,-,2
043 Laurein,21,,2,-,2
043 Laurein,22,,2,5,7
043 Laurein,23,,1,2,3
043 Laurein,24,,5,1,6
043 Laurein,25,,-,6,6
043 Laurein,26,,1,5,6
043 Laurein,27,,5,1,6
043 Laurein,28,,1,3,4
043 Laurein,29,,5,6,11
043 Laurein,30,,4,3,7
043 Laurein,31,,5,5,10
043 Laurein,32,,-,2,2
043 Laurein,33,,5,7,12
043 Laurein,34,,6,3,9
043 Laurein,35,,5,1,6
043 Laurein,36,,4,2,6
043 Laurein,37,,1,2,3
043 Laurein,38,,1,2,3
043 Laurein,39,,5,5,10
043 Laurein,40,,1,1,2
043 Laurein,41,,4,4,8
043 Laurein,42,,3,2,5
043 Laurein,43,,7,-,7
043 Laurein,45,,2,-,2
043 Laurein,46,,4,1,5
043 Laurein,47,,2,1,3
043 Laurein,48,,2,2,4
043 Laurein,50,,2,1,3
043 Laurein,51,,3,2,5
043 Laurein,52,,2,-,2
043 Laurein,53,,2,3,5
043 Laurein,54,,-,1,1
043 Laurein,55,,-,1,1
043 Laurein,56,,-,1,1
043 Laurein,57,,1,-,1
043 Laurein,58,,2,-,2
043 Laurein,60,,4,2,6
043 Laurein,61,,3,3,6
043 Laurein,62,,1,1,2
043 Laurein,63,,2,1,3
043 Laurein,64,,1,2,3
043 Laurein,65,,1,3,4
043 Laurein,66,,1,5,6
043 Laurein,67,,1,3,4
043 Laurein,68,,3,2,5
043 Laurein,69,,1,3,4
043 Laurein,70,,2,5,7
043 Laurein,71,,3,-,3
043 Laurein,72,,5,1,6
043 Laurein,73,,5,1,6
043 Laurein,74,,2,2,4
043 Laurein,75,,2,2,4
043 Laurein,76,,-,1,1
043 Laurein,77,,1,-,1
043 Laurein,78,,-,3,3
043 Laurein,79,,1,-,1
043 Laurein,80,,2,2,4
043 Laurein,81,,-,1,1
043 Laurein,84,,1,-,1
043 Laurein,86,,-,2,2
043 Laurein,87,,1,1,2
043 Laurein,89,,-,1,1
043 Laurein,90,,1,1,2
044 Lüsen,0,,15,10,25
044 Lüsen,1,,6,9,15
044 Lüsen,2,,10,11,21
044 Lüsen,3,,17,7,24
044 Lüsen,4,,9,14,23
044 Lüsen,5,,9,13,22
044 Lüsen,6,,14,13,27
044 Lüsen,7,,9,10,19
044 Lüsen,8,,11,9,20
044 Lüsen,9,,8,10,18
044 Lüsen,10,,6,11,17
044 Lüsen,11,,18,8,26
044 Lüsen,12,,9,9,18
044 Lüsen,13,,7,8,15
044 Lüsen,14,,12,12,24
044 Lüsen,15,,3,2,5
044 Lüsen,16,,9,18,27
044 Lüsen,17,,6,11,17
044 Lüsen,18,,15,10,25
044 Lüsen,19,,11,13,24
044 Lüsen,20,,15,13,28
044 Lüsen,21,,8,9,17
044 Lüsen,22,,16,19,35
044 Lüsen,23,,6,8,14
044 Lüsen,24,,15,10,25
044 Lüsen,25,,13,13,26
044 Lüsen,26,,18,12,30
044 Lüsen,27,,9,9,18
044 Lüsen,28,,10,10,20
044 Lüsen,29,,17,13,30
044 Lüsen,30,,17,16,33
044 Lüsen,31,,8,11,19
044 Lüsen,32,,11,15,26
044 Lüsen,33,,13,22,35
044 Lüsen,34,,14,14,28
044 Lüsen,35,,19,13,32
044 Lüsen,36,,13,9,22
044 Lüsen,37,,13,8,21
044 Lüsen,38,,9,13,22
044 Lüsen,39,,12,10,22
044 Lüsen,40,,8,12,20
044 Lüsen,41,,7,4,11
044 Lüsen,42,,12,12,24
044 Lüsen,43,,9,9,18
044 Lüsen,44,,9,9,18
044 Lüsen,45,,7,7,14
044 Lüsen,46,,14,5,19
044 Lüsen,47,,6,10,16
044 Lüsen,48,,10,4,14
044 Lüsen,49,,5,7,12
044 Lüsen,50,,6,7,13
044 Lüsen,51,,8,12,20
044 Lüsen,52,,8,2,10
044 Lüsen,53,,7,4,11
044 Lüsen,54,,10,5,15
044 Lüsen,55,,4,9,13
044 Lüsen,56,,4,6,10
044 Lüsen,57,,7,7,14
044 Lüsen,58,,2,6,8
044 Lüsen,59,,7,4,11
044 Lüsen,60,,5,9,14
044 Lüsen,61,,9,7,16
044 Lüsen,62,,8,4,12
044 Lüsen,63,,7,5,12
044 Lüsen,64,,6,9,15
044 Lüsen,65,,7,5,12
044 Lüsen,66,,4,5,9
044 Lüsen,67,,7,3,10
044 Lüsen,68,,3,11,14
044 Lüsen,69,,8,5,13
044 Lüsen,70,,4,6,10
044 Lüsen,71,,6,8,14
044 Lüsen,72,,8,8,16
044 Lüsen,73,,6,4,10
044 Lüsen,74,,2,7,9
044 Lüsen,75,,4,5,9
044 Lüsen,76,,4,3,7
044 Lüsen,77,,5,4,9
044 Lüsen,78,,1,3,4
044 Lüsen,79,,2,7,9
044 Lüsen,80,,2,5,7
044 Lüsen,81,,3,2,5
044 Lüsen,82,,-,4,4
044 Lüsen,83,,1,2,3
044 Lüsen,84,,-,2,2
044 Lüsen,85,,-,3,3
044 Lüsen,86,,2,1,3
044 Lüsen,87,,1,4,5
044 Lüsen,88,,1,1,2
044 Lüsen,91,,1,1,2
045 Margreid a.d. Weinstr.,0,,9,8,17
045 Margreid a.d. Weinstr.,1,,9,10,19
045 Margreid a.d. Weinstr.,2,,4,12,16
045 Margreid a.d. Weinstr.,3,,9,14,23
045 Margreid a.d. Weinstr.,4,,4,3,7
045 Margreid a.d. Weinstr.,5,,1,7,8
045 Margreid a.d. Weinstr.,6,,5,7,12
045 Margreid a.d. Weinstr.,7,,3,13,16
045 Margreid a.d. Weinstr.,8,,4,2,6
045 Margreid a.d. Weinstr.,9,,7,6,13
045 Margreid a.d. Weinstr.,10,,6,10,16
045 Margreid a.d. Weinstr.,11,,7,6,13
045 Margreid a.d. Weinstr.,12,,8,6,14
045 Margreid a.d. Weinstr.,13,,8,5,13
045 Margreid a.d. Weinstr.,14,,6,11,17
045 Margreid a.d. Weinstr.,15,,11,-,11
045 Margreid a.d. Weinstr.,16,,4,13,17
045 Margreid a.d. Weinstr.,17,,5,9,14
045 Margreid a.d. Weinstr.,18,,8,9,17
045 Margreid a.d. Weinstr.,19,,14,2,16
045 Margreid a.d. Weinstr.,20,,2,1,3
045 Margreid a.d. Weinstr.,21,,9,4,13
045 Margreid a.d. Weinstr.,22,,8,7,15
045 Margreid a.d. Weinstr.,23,,8,6,14
045 Margreid a.d. Weinstr.,24,,11,13,24
045 Margreid a.d. Weinstr.,25,,8,5,13
045 Margreid a.d. Weinstr.,26,,3,9,12
045 Margreid a.d. Weinstr.,27,,10,11,21
045 Margreid a.d. Weinstr.,28,,11,7,18
045 Margreid a.d. Weinstr.,29,,11,12,23
045 Margreid a.d. Weinstr.,30,,11,10,21
045 Margreid a.d. Weinstr.,31,,9,10,19
045 Margreid a.d. Weinstr.,32,,21,14,35
045 Margreid a.d. Weinstr.,33,,14,15,29
045 Margreid a.d. Weinstr.,34,,20,12,32
045 Margreid a.d. Weinstr.,35,,12,6,18
045 Margreid a.d. Weinstr.,36,,8,7,15
045 Margreid a.d. Weinstr.,37,,12,13,25
045 Margreid a.d. Weinstr.,38,,8,13,21
045 Margreid a.d. Weinstr.,39,,15,12,27
045 Margreid a.d. Weinstr.,40,,16,8,24
045 Margreid a.d. Weinstr.,41,,9,13,22
045 Margreid a.d. Weinstr.,42,,8,6,14
045 Margreid a.d. Weinstr.,43,,10,4,14
045 Margreid a.d. Weinstr.,44,,14,5,19
045 Margreid a.d. Weinstr.,45,,7,6,13
045 Margreid a.d. Weinstr.,46,,6,5,11
045 Margreid a.d. Weinstr.,47,,9,7,16
045 Margreid a.d. Weinstr.,48,,6,8,14
045 Margreid a.d. Weinstr.,49,,3,8,11
045 Margreid a.d. Weinstr.,50,,6,6,12
045 Margreid a.d. Weinstr.,51,,8,5,13
045 Margreid a.d. Weinstr.,52,,7,8,15
045 Margreid a.d. Weinstr.,53,,6,7,13
045 Margreid a.d. Weinstr.,54,,4,4,8
045 Margreid a.d. Weinstr.,55,,6,7,13
045 Margreid a.d. Weinstr.,56,,3,6,9
045 Margreid a.d. Weinstr.,57,,7,4,11
045 Margreid a.d. Weinstr.,58,,11,5,16
045 Margreid a.d. Weinstr.,59,,7,7,14
045 Margreid a.d. Weinstr.,60,,5,3,8
045 Margreid a.d. Weinstr.,61,,3,6,9
045 Margreid a.d. Weinstr.,62,,4,7,11
045 Margreid a.d. Weinstr.,63,,5,4,9
045 Margreid a.d. Weinstr.,64,,7,4,11
045 Margreid a.d. Weinstr.,65,,2,7,9
045 Margreid a.d. Weinstr.,66,,5,3,8
045 Margreid a.d. Weinstr.,67,,5,4,9
045 Margreid a.d. Weinstr.,68,,4,7,11
045 Margreid a.d. Weinstr.,69,,5,6,11
045 Margreid a.d. Weinstr.,70,,7,4,11
045 Margreid a.d. Weinstr.,71,,1,4,5
045 Margreid a.d. Weinstr.,72,,7,3,10
045 Margreid a.d. Weinstr.,73,,3,6,9
045 Margreid a.d. Weinstr.,74,,5,7,12
045 Margreid a.d. Weinstr.,75,,3,3,6
045 Margreid a.d. Weinstr.,76,,1,5,6
045 Margreid a.d. Weinstr.,77,,2,4,6
045 Margreid a.d. Weinstr.,78,,1,3,4
045 Margreid a.d. Weinstr.,79,,-,4,4
045 Margreid a.d. Weinstr.,80,,1,1,2
045 Margreid a.d. Weinstr.,81,,3,5,8
045 Margreid a.d. Weinstr.,82,,-,1,1
045 Margreid a.d. Weinstr.,83,,-,1,1
045 Margreid a.d. Weinstr.,84,,2,2,4
045 Margreid a.d. Weinstr.,85,,-,1,1
045 Margreid a.d. Weinstr.,86,,-,1,1
045 Margreid a.d. Weinstr.,87,,2,2,4
045 Margreid a.d. Weinstr.,88,,-,2,2
045 Margreid a.d. Weinstr.,89,,-,3,3
045 Margreid a.d. Weinstr.,90,,-,1,1
045 Margreid a.d. Weinstr.,91,,1,-,1
045 Margreid a.d. Weinstr.,93,,-,1,1
045 Margreid a.d. Weinstr.,94,,-,1,1
046 Mals,0,,32,33,65
046 Mals,1,,34,28,62
046 Mals,2,,33,30,63
046 Mals,3,,37,32,69
046 Mals,4,,33,24,57
046 Mals,5,,33,41,74
046 Mals,6,,37,30,67
046 Mals,7,,34,32,66
046 Mals,8,,31,30,61
046 Mals,9,,35,32,67
046 Mals,10,,37,27,64
046 Mals,11,,41,34,75
046 Mals,12,,29,25,54
046 Mals,13,,31,28,59
046 Mals,14,,30,32,62
046 Mals,15,,36,35,71
046 Mals,16,,37,36,73
046 Mals,17,,30,31,61
046 Mals,18,,36,31,67
046 Mals,19,,36,38,74
046 Mals,20,,33,31,64
046 Mals,21,,31,29,60
046 Mals,22,,43,33,76
046 Mals,23,,32,25,57
046 Mals,24,,38,25,63
046 Mals,25,,42,38,80
046 Mals,26,,44,29,73
046 Mals,27,,30,39,69
046 Mals,28,,36,46,82
046 Mals,29,,38,51,89
046 Mals,30,,48,45,93
046 Mals,31,,48,41,89
046 Mals,32,,56,42,98
046 Mals,33,,43,27,70
046 Mals,34,,57,45,102
046 Mals,35,,49,39,88
046 Mals,36,,50,44,94
046 Mals,37,,53,52,105
046 Mals,38,,36,30,66
046 Mals,39,,50,38,88
046 Mals,40,,31,39,70
046 Mals,41,,32,36,68
046 Mals,42,,34,23,57
046 Mals,43,,42,33,75
046 Mals,44,,36,26,62
046 Mals,45,,31,26,57
046 Mals,46,,20,19,39
046 Mals,47,,33,30,63
046 Mals,48,,28,22,50
046 Mals,49,,32,22,54
046 Mals,50,,36,20,56
046 Mals,51,,19,27,46
046 Mals,52,,28,17,45
046 Mals,53,,22,21,43
046 Mals,54,,23,28,51
046 Mals,55,,12,20,32
046 Mals,56,,29,15,44
046 Mals,57,,25,18,43
046 Mals,58,,26,23,49
046 Mals,59,,20,18,38
046 Mals,60,,22,27,49
046 Mals,61,,25,25,50
046 Mals,62,,22,21,43
046 Mals,63,,14,30,44
046 Mals,64,,21,18,39
046 Mals,65,,16,18,34
046 Mals,66,,16,20,36
046 Mals,67,,18,22,40
046 Mals,68,,19,13,32
046 Mals,69,,13,18,31
046 Mals,70,,26,19,45
046 Mals,71,,24,18,42
046 Mals,72,,24,15,39
046 Mals,73,,18,16,34
046 Mals,74,,10,22,32
046 Mals,75,,15,22,37
046 Mals,76,,10,18,28
046 Mals,77,,7,16,23
046 Mals,78,,15,16,31
046 Mals,79,,12,15,27
046 Mals,80,,6,19,25
046 Mals,81,,6,22,28
046 Mals,82,,2,8,10
046 Mals,83,,5,2,7
046 Mals,84,,1,7,8
046 Mals,85,,4,9,13
046 Mals,86,,4,8,12
046 Mals,87,,10,17,27
046 Mals,88,,4,5,9
046 Mals,89,,2,5,7
046 Mals,90,,1,5,6
046 Mals,91,,2,1,3
046 Mals,92,,-,3,3
046 Mals,93,,1,-,1
046 Mals,96,,-,1,1
046 Mals,101,,-,1,1
047 Enneberg,0,,15,20,35
047 Enneberg,1,,24,16,40
047 Enneberg,2,,19,11,30
047 Enneberg,3,,23,14,37
047 Enneberg,4,,17,13,30
047 Enneberg,5,,20,8,28
047 Enneberg,6,,20,14,34
047 Enneberg,7,,20,17,37
047 Enneberg,8,,14,15,29
047 Enneberg,9,,16,24,40
047 Enneberg,10,,15,17,32
047 Enneberg,11,,20,17,37
047 Enneberg,12,,22,16,38
047 Enneberg,13,,17,13,30
047 Enneberg,14,,18,10,28
047 Enneberg,15,,23,16,39
047 Enneberg,16,,19,19,38
047 Enneberg,17,,15,17,32
047 Enneberg,18,,24,20,44
047 Enneberg,19,,22,20,42
047 Enneberg,20,,24,19,43
047 Enneberg,21,,11,18,29
047 Enneberg,22,,13,25,38
047 Enneberg,23,,20,22,42
047 Enneberg,24,,13,18,31
047 Enneberg,25,,13,28,41
047 Enneberg,26,,27,31,58
047 Enneberg,27,,21,25,46
047 Enneberg,28,,22,26,48
047 Enneberg,29,,30,31,61
047 Enneberg,30,,28,20,48
047 Enneberg,31,,27,16,43
047 Enneberg,32,,22,18,40
047 Enneberg,33,,24,22,46
047 Enneberg,34,,23,25,48
047 Enneberg,35,,28,21,49
047 Enneberg,36,,23,24,47
047 Enneberg,37,,23,19,42
047 Enneberg,38,,15,16,31
047 Enneberg,39,,20,18,38
047 Enneberg,40,,15,17,32
047 Enneberg,41,,22,15,37
047 Enneberg,42,,21,8,29
047 Enneberg,43,,15,14,29
047 Enneberg,44,,15,17,32
047 Enneberg,45,,15,13,28
047 Enneberg,46,,14,11,25
047 Enneberg,47,,17,20,37
047 Enneberg,48,,14,18,32
047 Enneberg,49,,17,10,27
047 Enneberg,50,,10,16,26
047 Enneberg,51,,17,8,25
047 Enneberg,52,,15,13,28
047 Enneberg,53,,9,11,20
047 Enneberg,54,,15,17,32
047 Enneberg,55,,6,13,19
047 Enneberg,56,,20,16,36
047 Enneberg,57,,17,11,28
047 Enneberg,58,,12,20,32
047 Enneberg,59,,14,11,25
047 Enneberg,60,,13,8,21
047 Enneberg,61,,18,10,28
047 Enneberg,62,,14,19,33
047 Enneberg,63,,16,13,29
047 Enneberg,64,,12,13,25
047 Enneberg,65,,14,16,30
047 Enneberg,66,,8,11,19
047 Enneberg,67,,12,9,21
047 Enneberg,68,,8,17,25
047 Enneberg,69,,13,11,24
047 Enneberg,70,,16,16,32
047 Enneberg,71,,9,6,15
047 Enneberg,72,,10,14,24
047 Enneberg,73,,12,9,21
047 Enneberg,74,,7,9,16
047 Enneberg,75,,12,7,19
047 Enneberg,76,,5,10,15
047 Enneberg,77,,7,13,20
047 Enneberg,78,,8,7,15
047 Enneberg,79,,3,11,14
047 Enneberg,80,,6,5,11
047 Enneberg,81,,2,4,6
047 Enneberg,82,,5,3,8
047 Enneberg,83,,-,6,6
047 Enneberg,84,,1,8,9
047 Enneberg,85,,-,5,5
047 Enneberg,86,,3,5,8
047 Enneberg,87,,2,3,5
047 Enneberg,88,,-,6,6
047 Enneberg,89,,3,3,6
047 Enneberg,90,,3,2,5
047 Enneberg,91,,2,1,3
047 Enneberg,92,,-,3,3
047 Enneberg,93,,1,1,2
047 Enneberg,94,,1,-,1
047 Enneberg,95,,-,2,2
047 Enneberg,96,,-,2,2
048 Marling,0,,15,14,29
048 Marling,1,,15,8,23
048 Marling,2,,12,9,21
048 Marling,3,,11,10,21
048 Marling,4,,14,13,27
048 Marling,5,,18,10,28
048 Marling,6,,9,7,16
048 Marling,7,,16,9,25
048 Marling,8,,17,14,31
048 Marling,9,,12,10,22
048 Marling,10,,8,15,23
048 Marling,11,,10,17,27
048 Marling,12,,10,14,24
048 Marling,13,,5,10,15
048 Marling,14,,12,10,22
048 Marling,15,,9,15,24
048 Marling,16,,11,6,17
048 Marling,17,,10,10,20
048 Marling,18,,11,7,18
048 Marling,19,,14,11,25
048 Marling,20,,12,9,21
048 Marling,21,,16,17,33
048 Marling,22,,15,15,30
048 Marling,23,,11,17,28
048 Marling,24,,15,17,32
048 Marling,25,,13,12,25
048 Marling,26,,11,10,21
048 Marling,27,,15,18,33
048 Marling,28,,14,16,30
048 Marling,29,,24,12,36
048 Marling,30,,15,14,29
048 Marling,31,,21,21,42
048 Marling,32,,26,17,43
048 Marling,33,,19,16,35
048 Marling,34,,23,27,50
048 Marling,35,,23,18,41
048 Marling,36,,25,16,41
048 Marling,37,,28,27,55
048 Marling,38,,21,20,41
048 Marling,39,,21,14,35
048 Marling,40,,19,19,38
048 Marling,41,,16,15,31
048 Marling,42,,16,11,27
048 Marling,43,,12,10,22
048 Marling,44,,11,13,24
048 Marling,45,,9,6,15
048 Marling,46,,17,11,28
048 Marling,47,,11,16,27
048 Marling,48,,13,15,28
048 Marling,49,,7,13,20
048 Marling,50,,18,15,33
048 Marling,51,,19,17,36
048 Marling,52,,8,16,24
048 Marling,53,,17,12,29
048 Marling,54,,14,16,30
048 Marling,55,,20,13,33
048 Marling,56,,14,15,29
048 Marling,57,,11,18,29
048 Marling,58,,13,12,25
048 Marling,59,,22,18,40
048 Marling,60,,12,14,26
048 Marling,61,,15,17,32
048 Marling,62,,13,13,26
048 Marling,63,,12,16,28
048 Marling,64,,14,8,22
048 Marling,65,,8,15,23
048 Marling,66,,13,11,24
048 Marling,67,,8,13,21
048 Marling,68,,11,9,20
048 Marling,69,,13,10,23
048 Marling,70,,6,11,17
048 Marling,71,,7,8,15
048 Marling,72,,9,4,13
048 Marling,73,,10,9,19
048 Marling,74,,5,14,19
048 Marling,75,,5,15,20
048 Marling,76,,3,8,11
048 Marling,77,,6,8,14
048 Marling,78,,3,5,8
048 Marling,79,,5,8,13
048 Marling,80,,-,3,3
048 Marling,81,,4,4,8
048 Marling,82,,1,5,6
048 Marling,83,,2,2,4
048 Marling,84,,1,3,4
048 Marling,85,,3,4,7
048 Marling,86,,2,5,7
048 Marling,87,,2,5,7
048 Marling,88,,2,5,7
048 Marling,90,,-,2,2
048 Marling,91,,2,1,3
048 Marling,92,,3,1,4
048 Marling,93,,1,4,5
048 Marling,95,,-,2,2
048 Marling,96,,1,1,2
049 Martell,0,,6,3,9
049 Martell,1,,2,7,9
049 Martell,2,,5,6,11
049 Martell,3,,5,7,12
049 Martell,4,,4,5,9
049 Martell,5,,7,7,14
049 Martell,6,,7,8,15
049 Martell,7,,7,6,13
049 Martell,8,,5,5,10
049 Martell,9,,8,5,13
049 Martell,10,,6,5,11
049 Martell,11,,9,3,12
049 Martell,12,,4,1,5
049 Martell,13,,8,3,11
049 Martell,14,,-,4,4
049 Martell,15,,6,6,12
049 Martell,16,,6,4,10
049 Martell,17,,9,3,12
049 Martell,18,,6,6,12
049 Martell,19,,8,5,13
049 Martell,20,,9,5,14
049 Martell,21,,8,8,16
049 Martell,22,,3,5,8
049 Martell,23,,5,5,10
049 Martell,24,,5,8,13
049 Martell,25,,3,6,9
049 Martell,26,,6,10,16
049 Martell,27,,8,6,14
049 Martell,28,,4,8,12
049 Martell,29,,12,4,16
049 Martell,30,,6,4,10
049 Martell,31,,6,13,19
049 Martell,32,,9,6,15
049 Martell,33,,4,8,12
049 Martell,34,,14,5,19
049 Martell,35,,17,8,25
049 Martell,36,,9,9,18
049 Martell,37,,14,2,16
049 Martell,38,,9,8,17
049 Martell,39,,7,5,12
049 Martell,40,,10,3,13
049 Martell,41,,7,6,13
049 Martell,42,,7,6,13
049 Martell,43,,8,3,11
049 Martell,44,,4,4,8
049 Martell,45,,7,2,9
049 Martell,46,,7,6,13
049 Martell,47,,5,4,9
049 Martell,48,,5,3,8
049 Martell,49,,6,8,14
049 Martell,50,,3,4,7
049 Martell,51,,4,2,6
049 Martell,52,,6,4,10
049 Martell,53,,5,3,8
049 Martell,54,,3,-,3
049 Martell,55,,5,1,6
049 Martell,56,,1,3,4
049 Martell,57,,2,3,5
049 Martell,58,,5,6,11
049 Martell,59,,4,4,8
049 Martell,60,,6,2,8
049 Martell,61,,2,5,7
049 Martell,62,,1,6,7
049 Martell,63,,3,5,8
049 Martell,64,,3,4,7
049 Martell,65,,4,9,13
049 Martell,66,,8,1,9
049 Martell,67,,5,5,10
049 Martell,68,,2,4,6
049 Martell,69,,6,1,7
049 Martell,70,,7,4,11
049 Martell,71,,5,3,8
049 Martell,72,,3,6,9
049 Martell,73,,3,3,6
049 Martell,74,,2,9,11
049 Martell,75,,2,3,5
049 Martell,76,,4,7,11
049 Martell,77,,1,7,8
049 Martell,78,,2,1,3
049 Martell,79,,1,2,3
049 Martell,80,,-,1,1
049 Martell,81,,1,1,2
049 Martell,82,,2,2,4
049 Martell,83,,1,-,1
049 Martell,84,,-,1,1
049 Martell,85,,4,3,7
049 Martell,86,,-,1,1
049 Martell,87,,1,-,1
049 Martell,88,,1,-,1
049 Martell,89,,3,2,5
049 Martell,90,,-,1,1
049 Martell,91,,-,1,1
049 Martell,93,,-,1,1
050 Mölten,0,,17,13,30
050 Mölten,1,,10,16,26
050 Mölten,2,,8,18,26
050 Mölten,3,,10,9,19
050 Mölten,4,,16,11,27
050 Mölten,5,,11,10,21
050 Mölten,6,,13,4,17
050 Mölten,7,,13,10,23
050 Mölten,8,,7,13,20
050 Mölten,9,,11,6,17
050 Mölten,10,,12,5,17
050 Mölten,11,,13,6,19
050 Mölten,12,,7,8,15
050 Mölten,13,,9,8,17
050 Mölten,14,,10,6,16
050 Mölten,15,,7,13,20
050 Mölten,16,,6,3,9
050 Mölten,17,,7,15,22
050 Mölten,18,,9,6,15
050 Mölten,19,,13,6,19
050 Mölten,20,,12,9,21
050 Mölten,21,,12,9,21
050 Mölten,22,,11,7,18
050 Mölten,23,,7,12,19
050 Mölten,24,,8,16,24
050 Mölten,25,,16,11,27
050 Mölten,26,,12,12,24
050 Mölten,27,,14,15,29
050 Mölten,28,,13,9,22
050 Mölten,29,,15,12,27
050 Mölten,30,,17,11,28
050 Mölten,31,,15,15,30
050 Mölten,32,,16,18,34
050 Mölten,33,,19,13,32
050 Mölten,34,,15,12,27
050 Mölten,35,,11,15,26
050 Mölten,36,,22,12,34
050 Mölten,37,,16,6,22
050 Mölten,38,,10,9,19
050 Mölten,39,,17,9,26
050 Mölten,40,,6,7,13
050 Mölten,41,,14,4,18
050 Mölten,42,,2,11,13
050 Mölten,43,,5,2,7
050 Mölten,44,,4,7,11
050 Mölten,45,,14,7,21
050 Mölten,46,,7,5,12
050 Mölten,47,,6,7,13
050 Mölten,48,,6,5,11
050 Mölten,49,,6,4,10
050 Mölten,50,,8,9,17
050 Mölten,51,,6,5,11
050 Mölten,52,,5,4,9
050 Mölten,53,,4,8,12
050 Mölten,54,,10,2,12
050 Mölten,55,,5,5,10
050 Mölten,56,,2,6,8
050 Mölten,57,,13,8,21
050 Mölten,58,,6,10,16
050 Mölten,59,,10,3,13
050 Mölten,60,,5,7,12
050 Mölten,61,,5,7,12
050 Mölten,62,,2,3,5
050 Mölten,63,,6,6,12
050 Mölten,64,,5,6,11
050 Mölten,65,,10,6,16
050 Mölten,66,,9,6,15
050 Mölten,67,,10,9,19
050 Mölten,68,,3,5,8
050 Mölten,69,,10,2,12
050 Mölten,70,,7,5,12
050 Mölten,71,,3,7,10
050 Mölten,72,,3,6,9
050 Mölten,73,,4,4,8
050 Mölten,74,,3,5,8
050 Mölten,75,,2,4,6
050 Mölten,76,,2,2,4
050 Mölten,77,,7,6,13
050 Mölten,78,,4,2,6
050 Mölten,79,,1,7,8
050 Mölten,80,,2,7,9
050 Mölten,81,,-,5,5
050 Mölten,82,,2,1,3
050 Mölten,83,,1,1,2
050 Mölten,84,,2,2,4
050 Mölten,85,,-,2,2
050 Mölten,86,,-,6,6
050 Mölten,87,,3,-,3
050 Mölten,88,,-,1,1
050 Mölten,89,,-,1,1
050 Mölten,90,,-,1,1
050 Mölten,91,,-,2,2
050 Mölten,94,,-,1,1
051 Meran,0,,163,138,301
051 Meran,1,,159,176,335
051 Meran,2,,142,134,276
051 Meran,3,,182,147,329
051 Meran,4,,178,143,321
051 Meran,5,,154,137,291
051 Meran,6,,158,159,317
051 Meran,7,,124,138,262
051 Meran,8,,165,135,300
051 Meran,9,,149,166,315
051 Meran,10,,151,154,305
051 Meran,11,,166,147,313
051 Meran,12,,160,116,276
051 Meran,13,,157,134,291
051 Meran,14,,152,111,263
051 Meran,15,,124,170,294
051 Meran,16,,152,140,292
051 Meran,17,,136,144,280
051 Meran,18,,147,150,297
051 Meran,19,,160,148,308
051 Meran,20,,150,141,291
051 Meran,21,,140,160,300
051 Meran,22,,174,168,342
051 Meran,23,,168,198,366
051 Meran,24,,186,208,394
051 Meran,25,,218,221,439
051 Meran,26,,259,253,512
051 Meran,27,,238,240,478
051 Meran,28,,253,241,494
051 Meran,29,,280,270,550
051 Meran,30,,270,281,551
051 Meran,31,,313,287,600
051 Meran,32,,317,308,625
051 Meran,33,,320,311,631
051 Meran,34,,324,272,596
051 Meran,35,,337,296,633
051 Meran,36,,328,294,622
051 Meran,37,,353,260,613
051 Meran,38,,250,269,519
051 Meran,39,,304,294,598
051 Meran,40,,292,259,551
051 Meran,41,,271,238,509
051 Meran,42,,265,228,493
051 Meran,43,,234,241,475
051 Meran,44,,223,212,435
051 Meran,45,,199,216,415
051 Meran,46,,187,225,412
051 Meran,47,,191,216,407
051 Meran,48,,221,222,443
051 Meran,49,,212,204,416
051 Meran,50,,203,226,429
051 Meran,51,,226,249,475
051 Meran,52,,224,257,481
051 Meran,53,,231,284,515
051 Meran,54,,248,302,550
051 Meran,55,,218,222,440
051 Meran,56,,216,245,461
051 Meran,57,,268,247,515
051 Meran,58,,273,307,580
051 Meran,59,,240,283,523
051 Meran,60,,209,219,428
051 Meran,61,,210,255,465
051 Meran,62,,196,236,432
051 Meran,63,,202,232,434
051 Meran,64,,180,208,388
051 Meran,65,,176,211,387
051 Meran,66,,169,191,360
051 Meran,67,,160,186,346
051 Meran,68,,141,210,351
051 Meran,69,,134,190,324
051 Meran,70,,145,195,340
051 Meran,71,,130,151,281
051 Meran,72,,137,204,341
051 Meran,73,,118,171,289
051 Meran,74,,122,191,313
051 Meran,75,,92,175,267
051 Meran,76,,103,182,285
051 Meran,77,,85,177,262
051 Meran,78,,93,197,290
051 Meran,79,,64,191,255
051 Meran,80,,85,178,263
051 Meran,81,,55,128,183
051 Meran,82,,48,92,140
051 Meran,83,,41,84,125
051 Meran,84,,30,77,107
051 Meran,85,,44,98,142
051 Meran,86,,45,119,164
051 Meran,87,,45,101,146
051 Meran,88,,39,90,129
051 Meran,89,,24,77,101
051 Meran,90,,25,70,95
051 Meran,91,,20,63,83
051 Meran,92,,17,37,54
051 Meran,93,,5,23,28
051 Meran,94,,5,29,34
051 Meran,95,,2,16,18
051 Meran,96,,2,15,17
051 Meran,97,,1,11,12
051 Meran,98,,2,5,7
051 Meran,99,,2,4,6
051 Meran,100,,1,1,2
051 Meran,102,,-,2,2
052 Welsberg-Taisten,0,,15,19,34
052 Welsberg-Taisten,1,,23,18,41
052 Welsberg-Taisten,2,,18,13,31
052 Welsberg-Taisten,3,,23,20,43
052 Welsberg-Taisten,4,,16,17,33
052 Welsberg-Taisten,5,,18,13,31
052 Welsberg-Taisten,6,,12,16,28
052 Welsberg-Taisten,7,,14,19,33
052 Welsberg-Taisten,8,,10,9,19
052 Welsberg-Taisten,9,,20,17,37
052 Welsberg-Taisten,10,,12,17,29
052 Welsberg-Taisten,11,,6,18,24
052 Welsberg-Taisten,12,,14,16,30
052 Welsberg-Taisten,13,,16,14,30
052 Welsberg-Taisten,14,,10,14,24
052 Welsberg-Taisten,15,,9,13,22
052 Welsberg-Taisten,16,,25,14,39
052 Welsberg-Taisten,17,,19,17,36
052 Welsberg-Taisten,18,,20,13,33
052 Welsberg-Taisten,19,,9,11,20
052 Welsberg-Taisten,20,,16,19,35
052 Welsberg-Taisten,21,,24,15,39
052 Welsberg-Taisten,22,,21,16,37
052 Welsberg-Taisten,23,,13,20,33
052 Welsberg-Taisten,24,,17,15,32
052 Welsberg-Taisten,25,,13,24,37
052 Welsberg-Taisten,26,,27,20,47
052 Welsberg-Taisten,27,,25,10,35
052 Welsberg-Taisten,28,,17,27,44
052 Welsberg-Taisten,29,,31,23,54
052 Welsberg-Taisten,30,,26,24,50
052 Welsberg-Taisten,31,,19,20,39
052 Welsberg-Taisten,32,,23,13,36
052 Welsberg-Taisten,33,,31,21,52
052 Welsberg-Taisten,34,,25,26,51
052 Welsberg-Taisten,35,,25,18,43
052 Welsberg-Taisten,36,,32,21,53
052 Welsberg-Taisten,37,,25,23,48
052 Welsberg-Taisten,38,,21,24,45
052 Welsberg-Taisten,39,,20,17,37
052 Welsberg-Taisten,40,,14,14,28
052 Welsberg-Taisten,41,,21,20,41
052 Welsberg-Taisten,42,,26,18,44
052 Welsberg-Taisten,43,,11,19,30
052 Welsberg-Taisten,44,,21,19,40
052 Welsberg-Taisten,45,,18,12,30
052 Welsberg-Taisten,46,,16,14,30
052 Welsberg-Taisten,47,,20,13,33
052 Welsberg-Taisten,48,,19,11,30
052 Welsberg-Taisten,49,,18,9,27
052 Welsberg-Taisten,50,,17,15,32
052 Welsberg-Taisten,51,,14,13,27
052 Welsberg-Taisten,52,,16,16,32
052 Welsberg-Taisten,53,,10,9,19
052 Welsberg-Taisten,54,,12,13,25
052 Welsberg-Taisten,55,,10,14,24
052 Welsberg-Taisten,56,,13,11,24
052 Welsberg-Taisten,57,,13,13,26
052 Welsberg-Taisten,58,,10,12,22
052 Welsberg-Taisten,59,,19,19,38
052 Welsberg-Taisten,60,,7,13,20
052 Welsberg-Taisten,61,,14,13,27
052 Welsberg-Taisten,62,,14,11,25
052 Welsberg-Taisten,63,,10,8,18
052 Welsberg-Taisten,64,,10,11,21
052 Welsberg-Taisten,65,,4,16,20
052 Welsberg-Taisten,66,,17,16,33
052 Welsberg-Taisten,67,,12,11,23
052 Welsberg-Taisten,68,,11,13,24
052 Welsberg-Taisten,69,,8,12,20
052 Welsberg-Taisten,70,,11,8,19
052 Welsberg-Taisten,71,,9,12,21
052 Welsberg-Taisten,72,,6,21,27
052 Welsberg-Taisten,73,,10,12,22
052 Welsberg-Taisten,74,,8,7,15
052 Welsberg-Taisten,75,,1,8,9
052 Welsberg-Taisten,76,,7,10,17
052 Welsberg-Taisten,77,,5,12,17
052 Welsberg-Taisten,78,,5,8,13
052 Welsberg-Taisten,79,,5,10,15
052 Welsberg-Taisten,80,,4,9,13
052 Welsberg-Taisten,81,,-,8,8
052 Welsberg-Taisten,82,,4,1,5
052 Welsberg-Taisten,83,,3,4,7
052 Welsberg-Taisten,84,,2,1,3
052 Welsberg-Taisten,85,,4,4,8
052 Welsberg-Taisten,86,,2,2,4
052 Welsberg-Taisten,87,,-,3,3
052 Welsberg-Taisten,88,,1,5,6
052 Welsberg-Taisten,89,,-,5,5
052 Welsberg-Taisten,90,,1,5,6
052 Welsberg-Taisten,91,,-,6,6
052 Welsberg-Taisten,92,,-,2,2
052 Welsberg-Taisten,93,,1,2,3
052 Welsberg-Taisten,96,,-,1,1
052 Welsberg-Taisten,100,,1,-,1
052 Welsberg-Taisten,112,,-,1,1
053 Montan,0,,10,5,15
053 Montan,1,,6,11,17
053 Montan,2,,8,10,18
053 Montan,3,,7,7,14
053 Montan,4,,12,10,22
053 Montan,5,,14,15,29
053 Montan,6,,12,5,17
053 Montan,7,,5,8,13
053 Montan,8,,7,10,17
053 Montan,9,,13,10,23
053 Montan,10,,12,8,20
053 Montan,11,,10,11,21
053 Montan,12,,12,14,26
053 Montan,13,,9,17,26
053 Montan,14,,14,5,19
053 Montan,15,,10,8,18
053 Montan,16,,7,3,10
053 Montan,17,,10,5,15
053 Montan,18,,9,7,16
053 Montan,19,,10,7,17
053 Montan,20,,3,4,7
053 Montan,21,,9,9,18
053 Montan,22,,9,6,15
053 Montan,23,,6,4,10
053 Montan,24,,5,4,9
053 Montan,25,,11,9,20
053 Montan,26,,7,8,15
053 Montan,27,,13,4,17
053 Montan,28,,9,5,14
053 Montan,29,,12,10,22
053 Montan,30,,11,12,23
053 Montan,31,,11,16,27
053 Montan,32,,13,17,30
053 Montan,33,,10,11,21
053 Montan,34,,11,16,27
053 Montan,35,,26,13,39
053 Montan,36,,18,12,30
053 Montan,37,,14,17,31
053 Montan,38,,13,15,28
053 Montan,39,,18,11,29
053 Montan,40,,13,12,25
053 Montan,41,,12,11,23
053 Montan,42,,14,9,23
053 Montan,43,,15,11,26
053 Montan,44,,7,14,21
053 Montan,45,,7,11,18
053 Montan,46,,13,11,24
053 Montan,47,,11,8,19
053 Montan,48,,12,3,15
053 Montan,49,,7,6,13
053 Montan,50,,4,4,8
053 Montan,51,,8,3,11
053 Montan,52,,5,6,11
053 Montan,53,,6,9,15
053 Montan,54,,5,2,7
053 Montan,55,,3,3,6
053 Montan,56,,2,5,7
053 Montan,57,,5,7,12
053 Montan,58,,7,6,13
053 Montan,59,,8,4,12
053 Montan,60,,9,7,16
053 Montan,61,,7,9,16
053 Montan,62,,9,9,18
053 Montan,63,,2,7,9
053 Montan,64,,7,11,18
053 Montan,65,,1,9,10
053 Montan,66,,3,6,9
053 Montan,67,,16,5,21
053 Montan,68,,5,8,13
053 Montan,69,,9,11,20
053 Montan,70,,11,12,23
053 Montan,71,,8,9,17
053 Montan,72,,9,2,11
053 Montan,73,,6,5,11
053 Montan,74,,8,9,17
053 Montan,75,,4,8,12
053 Montan,76,,2,8,10
053 Montan,77,,6,11,17
053 Montan,78,,5,8,13
053 Montan,79,,5,4,9
053 Montan,80,,2,8,10
053 Montan,81,,2,4,6
053 Montan,82,,1,4,5
053 Montan,83,,2,5,7
053 Montan,84,,-,2,2
053 Montan,85,,1,7,8
053 Montan,86,,3,3,6
053 Montan,87,,1,5,6
053 Montan,88,,1,2,3
053 Montan,89,,1,3,4
053 Montan,90,,1,-,1
053 Montan,91,,-,2,2
053 Montan,92,,-,3,3
053 Montan,99,,-,1,1
054 Moos in Passeier,0,,14,18,32
054 Moos in Passeier,1,,24,9,33
054 Moos in Passeier,2,,13,17,30
054 Moos in Passeier,3,,12,15,27
054 Moos in Passeier,4,,18,19,37
054 Moos in Passeier,5,,9,12,21
054 Moos in Passeier,6,,18,21,39
054 Moos in Passeier,7,,19,12,31
054 Moos in Passeier,8,,18,18,36
054 Moos in Passeier,9,,18,21,39
054 Moos in Passeier,10,,15,13,28
054 Moos in Passeier,11,,17,19,36
054 Moos in Passeier,12,,15,16,31
054 Moos in Passeier,13,,16,14,30
054 Moos in Passeier,14,,17,15,32
054 Moos in Passeier,15,,19,12,31
054 Moos in Passeier,16,,23,21,44
054 Moos in Passeier,17,,15,14,29
054 Moos in Passeier,18,,17,23,40
054 Moos in Passeier,19,,20,19,39
054 Moos in Passeier,20,,20,19,39
054 Moos in Passeier,21,,21,16,37
054 Moos in Passeier,22,,26,18,44
054 Moos in Passeier,23,,21,20,41
054 Moos in Passeier,24,,14,13,27
054 Moos in Passeier,25,,25,21,46
054 Moos in Passeier,26,,26,12,38
054 Moos in Passeier,27,,12,27,39
054 Moos in Passeier,28,,22,16,38
054 Moos in Passeier,29,,22,18,40
054 Moos in Passeier,30,,23,11,34
054 Moos in Passeier,31,,19,17,36
054 Moos in Passeier,32,,18,23,41
054 Moos in Passeier,33,,21,19,40
054 Moos in Passeier,34,,27,21,48
054 Moos in Passeier,35,,23,10,33
054 Moos in Passeier,36,,26,10,36
054 Moos in Passeier,37,,16,17,33
054 Moos in Passeier,38,,11,20,31
054 Moos in Passeier,39,,10,8,18
054 Moos in Passeier,40,,18,16,34
054 Moos in Passeier,41,,17,14,31
054 Moos in Passeier,42,,14,15,29
054 Moos in Passeier,43,,20,7,27
054 Moos in Passeier,44,,9,8,17
054 Moos in Passeier,45,,10,9,19
054 Moos in Passeier,46,,17,9,26
054 Moos in Passeier,47,,6,9,15
054 Moos in Passeier,48,,8,5,13
054 Moos in Passeier,49,,12,10,22
054 Moos in Passeier,50,,8,9,17
054 Moos in Passeier,51,,17,9,26
054 Moos in Passeier,52,,6,6,12
054 Moos in Passeier,53,,20,10,30
054 Moos in Passeier,54,,9,8,17
054 Moos in Passeier,55,,8,7,15
054 Moos in Passeier,56,,9,9,18
054 Moos in Passeier,57,,15,12,27
054 Moos in Passeier,58,,5,12,17
054 Moos in Passeier,59,,11,15,26
054 Moos in Passeier,60,,9,10,19
054 Moos in Passeier,61,,5,7,12
054 Moos in Passeier,62,,11,9,20
054 Moos in Passeier,63,,6,6,12
054 Moos in Passeier,64,,8,8,16
054 Moos in Passeier,65,,9,7,16
054 Moos in Passeier,66,,10,14,24
054 Moos in Passeier,67,,9,10,19
054 Moos in Passeier,68,,8,4,12
054 Moos in Passeier,69,,10,7,17
054 Moos in Passeier,70,,11,7,18
054 Moos in Passeier,71,,8,13,21
054 Moos in Passeier,72,,4,10,14
054 Moos in Passeier,73,,7,5,12
054 Moos in Passeier,74,,9,3,12
054 Moos in Passeier,75,,9,7,16
054 Moos in Passeier,76,,3,6,9
054 Moos in Passeier,77,,4,3,7
054 Moos in Passeier,78,,2,5,7
054 Moos in Passeier,79,,2,2,4
054 Moos in Passeier,80,,2,3,5
054 Moos in Passeier,81,,1,4,5
054 Moos in Passeier,82,,1,-,1
054 Moos in Passeier,83,,2,2,4
054 Moos in Passeier,84,,1,3,4
054 Moos in Passeier,85,,2,1,3
054 Moos in Passeier,86,,1,5,6
054 Moos in Passeier,87,,1,2,3
054 Moos in Passeier,88,,1,2,3
054 Moos in Passeier,90,,-,2,2
054 Moos in Passeier,91,,-,1,1
054 Moos in Passeier,92,,1,-,1
055 Nals,0,,8,16,24
055 Nals,1,,16,8,24
055 Nals,2,,12,7,19
055 Nals,3,,15,5,20
055 Nals,4,,12,10,22
055 Nals,5,,9,7,16
055 Nals,6,,11,9,20
055 Nals,7,,7,12,19
055 Nals,8,,14,10,24
055 Nals,9,,8,11,19
055 Nals,10,,9,8,17
055 Nals,11,,11,8,19
055 Nals,12,,9,12,21
055 Nals,13,,11,11,22
055 Nals,14,,5,2,7
055 Nals,15,,13,5,18
055 Nals,16,,8,10,18
055 Nals,17,,5,8,13
055 Nals,18,,8,13,21
055 Nals,19,,10,10,20
055 Nals,20,,14,9,23
055 Nals,21,,8,6,14
055 Nals,22,,10,5,15
055 Nals,23,,5,4,9
055 Nals,24,,10,14,24
055 Nals,25,,6,9,15
055 Nals,26,,17,10,27
055 Nals,27,,11,8,19
055 Nals,28,,9,14,23
055 Nals,29,,12,14,26
055 Nals,30,,21,11,32
055 Nals,31,,10,14,24
055 Nals,32,,15,18,33
055 Nals,33,,15,15,30
055 Nals,34,,15,10,25
055 Nals,35,,21,16,37
055 Nals,36,,21,17,38
055 Nals,37,,11,24,35
055 Nals,38,,17,14,31
055 Nals,39,,15,14,29
055 Nals,40,,11,9,20
055 Nals,41,,14,14,28
055 Nals,42,,17,17,34
055 Nals,43,,9,9,18
055 Nals,44,,7,8,15
055 Nals,45,,18,15,33
055 Nals,46,,6,8,14
055 Nals,47,,6,7,13
055 Nals,48,,7,7,14
055 Nals,49,,4,10,14
055 Nals,50,,6,10,16
055 Nals,51,,11,9,20
055 Nals,52,,11,13,24
055 Nals,53,,12,5,17
055 Nals,54,,6,13,19
055 Nals,55,,7,11,18
055 Nals,56,,6,11,17
055 Nals,57,,11,6,17
055 Nals,58,,5,8,13
055 Nals,59,,13,5,18
055 Nals,60,,6,11,17
055 Nals,61,,10,9,19
055 Nals,62,,7,9,16
055 Nals,63,,3,13,16
055 Nals,64,,5,3,8
055 Nals,65,,7,6,13
055 Nals,66,,6,6,12
055 Nals,67,,9,11,20
055 Nals,68,,6,4,10
055 Nals,69,,3,7,10
055 Nals,70,,4,5,9
055 Nals,71,,9,8,17
055 Nals,72,,7,8,15
055 Nals,73,,6,6,12
055 Nals,74,,8,6,14
055 Nals,75,,6,5,11
055 Nals,76,,3,2,5
055 Nals,77,,1,6,7
055 Nals,78,,2,7,9
055 Nals,79,,2,9,11
055 Nals,80,,1,1,2
055 Nals,81,,1,5,6
055 Nals,82,,1,-,1
055 Nals,83,,1,-,1
055 Nals,84,,-,1,1
055 Nals,85,,3,3,6
055 Nals,86,,-,4,4
055 Nals,87,,1,1,2
055 Nals,88,,2,1,3
055 Nals,89,,-,3,3
055 Nals,90,,1,2,3
055 Nals,91,,-,1,1
056 Naturns,0,,31,28,59
056 Naturns,1,,28,29,57
056 Naturns,2,,32,32,64
056 Naturns,3,,21,18,39
056 Naturns,4,,32,34,66
056 Naturns,5,,50,33,83
056 Naturns,6,,36,38,74
056 Naturns,7,,33,39,72
056 Naturns,8,,32,42,74
056 Naturns,9,,43,39,82
056 Naturns,10,,35,32,67
056 Naturns,11,,37,24,61
056 Naturns,12,,43,35,78
056 Naturns,13,,34,19,53
056 Naturns,14,,29,26,55
056 Naturns,15,,37,24,61
056 Naturns,16,,38,19,57
056 Naturns,17,,29,35,64
056 Naturns,18,,37,27,64
056 Naturns,19,,36,47,83
056 Naturns,20,,32,29,61
056 Naturns,21,,41,38,79
056 Naturns,22,,35,41,76
056 Naturns,23,,33,38,71
056 Naturns,24,,32,36,68
056 Naturns,25,,33,39,72
056 Naturns,26,,41,36,77
056 Naturns,27,,44,41,85
056 Naturns,28,,43,43,86
056 Naturns,29,,43,42,85
056 Naturns,30,,48,42,90
056 Naturns,31,,40,46,86
056 Naturns,32,,47,42,89
056 Naturns,33,,47,45,92
056 Naturns,34,,53,44,97
056 Naturns,35,,41,50,91
056 Naturns,36,,46,36,82
056 Naturns,37,,41,47,88
056 Naturns,38,,43,46,89
056 Naturns,39,,38,47,85
056 Naturns,40,,55,39,94
056 Naturns,41,,44,39,83
056 Naturns,42,,30,35,65
056 Naturns,43,,35,33,68
056 Naturns,44,,44,35,79
056 Naturns,45,,31,32,63
056 Naturns,46,,40,32,72
056 Naturns,47,,33,27,60
056 Naturns,48,,36,37,73
056 Naturns,49,,36,37,73
056 Naturns,50,,27,34,61
056 Naturns,51,,27,20,47
056 Naturns,52,,31,25,56
056 Naturns,53,,15,20,35
056 Naturns,54,,26,31,57
056 Naturns,55,,27,18,45
056 Naturns,56,,21,20,41
056 Naturns,57,,27,35,62
056 Naturns,58,,32,33,65
056 Naturns,59,,42,31,73
056 Naturns,60,,21,20,41
056 Naturns,61,,19,21,40
056 Naturns,62,,24,18,42
056 Naturns,63,,23,23,46
056 Naturns,64,,21,20,41
056 Naturns,65,,22,11,33
056 Naturns,66,,18,20,38
056 Naturns,67,,18,14,32
056 Naturns,68,,12,20,32
056 Naturns,69,,14,22,36
056 Naturns,70,,19,25,44
056 Naturns,71,,16,18,34
056 Naturns,72,,17,16,33
056 Naturns,73,,14,19,33
056 Naturns,74,,13,18,31
056 Naturns,75,,15,17,32
056 Naturns,76,,17,16,33
056 Naturns,77,,13,13,26
056 Naturns,78,,6,13,19
056 Naturns,79,,8,19,27
056 Naturns,80,,4,8,12
056 Naturns,81,,4,11,15
056 Naturns,82,,3,4,7
056 Naturns,83,,3,2,5
056 Naturns,84,,3,4,7
056 Naturns,85,,1,10,11
056 Naturns,86,,4,10,14
056 Naturns,87,,5,15,20
056 Naturns,88,,3,6,9
056 Naturns,89,,4,6,10
056 Naturns,90,,4,1,5
056 Naturns,91,,-,8,8
056 Naturns,92,,-,2,2
056 Naturns,93,,1,2,3
056 Naturns,94,,-,1,1
056 Naturns,95,,1,2,3
056 Naturns,96,,-,1,1
056 Naturns,99,,-,1,1
057 Natz-Schabs,0,,18,16,34
057 Natz-Schabs,1,,15,19,34
057 Natz-Schabs,2,,19,17,36
057 Natz-Schabs,3,,17,17,34
057 Natz-Schabs,4,,23,17,40
057 Natz-Schabs,5,,15,13,28
057 Natz-Schabs,6,,20,16,36
057 Natz-Schabs,7,,16,17,33
057 Natz-Schabs,8,,15,13,28
057 Natz-Schabs,9,,22,22,44
057 Natz-Schabs,10,,13,26,39
057 Natz-Schabs,11,,14,24,38
057 Natz-Schabs,12,,24,17,41
057 Natz-Schabs,13,,20,21,41
057 Natz-Schabs,14,,19,20,39
057 Natz-Schabs,15,,19,24,43
057 Natz-Schabs,16,,18,15,33
057 Natz-Schabs,17,,20,19,39
057 Natz-Schabs,18,,11,21,32
057 Natz-Schabs,19,,18,21,39
057 Natz-Schabs,20,,24,13,37
057 Natz-Schabs,21,,13,14,27
057 Natz-Schabs,22,,13,13,26
057 Natz-Schabs,23,,15,11,26
057 Natz-Schabs,24,,11,14,25
057 Natz-Schabs,25,,15,19,34
057 Natz-Schabs,26,,12,19,31
057 Natz-Schabs,27,,19,18,37
057 Natz-Schabs,28,,18,22,40
057 Natz-Schabs,29,,22,20,42
057 Natz-Schabs,30,,26,25,51
057 Natz-Schabs,31,,27,18,45
057 Natz-Schabs,32,,30,14,44
057 Natz-Schabs,33,,25,27,52
057 Natz-Schabs,34,,28,16,44
057 Natz-Schabs,35,,30,30,60
057 Natz-Schabs,36,,30,23,53
057 Natz-Schabs,37,,24,25,49
057 Natz-Schabs,38,,17,24,41
057 Natz-Schabs,39,,19,19,38
057 Natz-Schabs,40,,29,21,50
057 Natz-Schabs,41,,23,20,43
057 Natz-Schabs,42,,23,18,41
057 Natz-Schabs,43,,19,19,38
057 Natz-Schabs,44,,18,20,38
057 Natz-Schabs,45,,19,17,36
057 Natz-Schabs,46,,12,15,27
057 Natz-Schabs,47,,19,15,34
057 Natz-Schabs,48,,14,9,23
057 Natz-Schabs,49,,14,9,23
057 Natz-Schabs,50,,18,15,33
057 Natz-Schabs,51,,20,14,34
057 Natz-Schabs,52,,11,13,24
057 Natz-Schabs,53,,11,13,24
057 Natz-Schabs,54,,14,10,24
057 Natz-Schabs,55,,9,7,16
057 Natz-Schabs,56,,13,12,25
057 Natz-Schabs,57,,9,8,17
057 Natz-Schabs,58,,13,7,20
057 Natz-Schabs,59,,14,9,23
057 Natz-Schabs,60,,4,8,12
057 Natz-Schabs,61,,3,6,9
057 Natz-Schabs,62,,6,6,12
057 Natz-Schabs,63,,12,7,19
057 Natz-Schabs,64,,10,4,14
057 Natz-Schabs,65,,9,7,16
057 Natz-Schabs,66,,5,3,8
057 Natz-Schabs,67,,8,11,19
057 Natz-Schabs,68,,6,7,13
057 Natz-Schabs,69,,8,4,12
057 Natz-Schabs,70,,5,7,12
057 Natz-Schabs,71,,11,2,13
057 Natz-Schabs,72,,4,7,11
057 Natz-Schabs,73,,2,4,6
057 Natz-Schabs,74,,4,7,11
057 Natz-Schabs,75,,3,6,9
057 Natz-Schabs,76,,2,7,9
057 Natz-Schabs,77,,2,10,12
057 Natz-Schabs,78,,5,4,9
057 Natz-Schabs,79,,5,3,8
057 Natz-Schabs,80,,2,9,11
057 Natz-Schabs,81,,-,2,2
057 Natz-Schabs,82,,1,4,5
057 Natz-Schabs,83,,1,2,3
057 Natz-Schabs,84,,1,-,1
057 Natz-Schabs,85,,1,2,3
057 Natz-Schabs,87,,2,-,2
057 Natz-Schabs,88,,-,3,3
057 Natz-Schabs,89,,1,2,3
057 Natz-Schabs,91,,2,-,2
057 Natz-Schabs,92,,1,1,2
057 Natz-Schabs,94,,1,-,1
058 Welschnofen,0,,8,8,16
058 Welschnofen,1,,9,13,22
058 Welschnofen,2,,13,7,20
058 Welschnofen,3,,11,10,21
058 Welschnofen,4,,8,11,19
058 Welschnofen,5,,14,12,26
058 Welschnofen,6,,10,12,22
058 Welschnofen,7,,11,10,21
058 Welschnofen,8,,14,10,24
058 Welschnofen,9,,14,11,25
058 Welschnofen,10,,11,14,25
058 Welschnofen,11,,14,8,22
058 Welschnofen,12,,12,14,26
058 Welschnofen,13,,10,9,19
058 Welschnofen,14,,6,11,17
058 Welschnofen,15,,10,7,17
058 Welschnofen,16,,7,8,15
058 Welschnofen,17,,10,12,22
058 Welschnofen,18,,10,17,27
058 Welschnofen,19,,13,10,23
058 Welschnofen,20,,13,7,20
058 Welschnofen,21,,11,3,14
058 Welschnofen,22,,12,14,26
058 Welschnofen,23,,11,18,29
058 Welschnofen,24,,17,11,28
058 Welschnofen,25,,16,10,26
058 Welschnofen,26,,12,15,27
058 Welschnofen,27,,12,13,25
058 Welschnofen,28,,12,12,24
058 Welschnofen,29,,12,14,26
058 Welschnofen,30,,14,13,27
058 Welschnofen,31,,14,16,30
058 Welschnofen,32,,17,17,34
058 Welschnofen,33,,17,15,32
058 Welschnofen,34,,17,12,29
058 Welschnofen,35,,21,13,34
058 Welschnofen,36,,13,7,20
058 Welschnofen,37,,18,18,36
058 Welschnofen,38,,12,15,27
058 Welschnofen,39,,16,17,33
058 Welschnofen,40,,20,8,28
058 Welschnofen,41,,13,12,25
058 Welschnofen,42,,16,10,26
058 Welschnofen,43,,9,13,22
058 Welschnofen,44,,10,12,22
058 Welschnofen,45,,16,14,30
058 Welschnofen,46,,14,11,25
058 Welschnofen,47,,11,14,25
058 Welschnofen,48,,12,8,20
058 Welschnofen,49,,17,7,24
058 Welschnofen,50,,8,9,17
058 Welschnofen,51,,13,13,26
058 Welschnofen,52,,8,11,19
058 Welschnofen,53,,9,7,16
058 Welschnofen,54,,10,10,20
058 Welschnofen,55,,9,5,14
058 Welschnofen,56,,7,11,18
058 Welschnofen,57,,13,10,23
058 Welschnofen,58,,12,13,25
058 Welschnofen,59,,11,7,18
058 Welschnofen,60,,8,7,15
058 Welschnofen,61,,11,7,18
058 Welschnofen,62,,7,7,14
058 Welschnofen,63,,9,4,13
058 Welschnofen,64,,5,14,19
058 Welschnofen,65,,8,6,14
058 Welschnofen,66,,13,10,23
058 Welschnofen,67,,9,14,23
058 Welschnofen,68,,7,7,14
058 Welschnofen,69,,5,9,14
058 Welschnofen,70,,8,8,16
058 Welschnofen,71,,8,12,20
058 Welschnofen,72,,7,6,13
058 Welschnofen,73,,4,4,8
058 Welschnofen,74,,5,7,12
058 Welschnofen,75,,6,6,12
058 Welschnofen,76,,5,14,19
058 Welschnofen,77,,7,8,15
058 Welschnofen,78,,6,7,13
058 Welschnofen,79,,2,11,13
058 Welschnofen,80,,3,5,8
058 Welschnofen,81,,1,6,7
058 Welschnofen,82,,2,2,4
058 Welschnofen,83,,1,1,2
058 Welschnofen,84,,2,5,7
058 Welschnofen,85,,1,4,5
058 Welschnofen,86,,1,3,4
058 Welschnofen,87,,-,8,8
058 Welschnofen,88,,2,6,8
058 Welschnofen,89,,2,1,3
058 Welschnofen,90,,2,2,4
058 Welschnofen,91,,1,3,4
058 Welschnofen,92,,2,-,2
058 Welschnofen,93,,-,2,2
058 Welschnofen,94,,-,2,2
058 Welschnofen,98,,1,1,2
058 Welschnofen,100,,-,1,1
059 Deutschnofen,0,,17,27,44
059 Deutschnofen,1,,28,23,51
059 Deutschnofen,2,,34,13,47
059 Deutschnofen,3,,22,27,49
059 Deutschnofen,4,,17,26,43
059 Deutschnofen,5,,25,24,49
059 Deutschnofen,6,,29,15,44
059 Deutschnofen,7,,22,27,49
059 Deutschnofen,8,,32,28,60
059 Deutschnofen,9,,20,21,41
059 Deutschnofen,10,,35,28,63
059 Deutschnofen,11,,24,21,45
059 Deutschnofen,12,,24,33,57
059 Deutschnofen,13,,21,25,46
059 Deutschnofen,14,,28,18,46
059 Deutschnofen,15,,26,20,46
059 Deutschnofen,16,,34,26,60
059 Deutschnofen,17,,22,23,45
059 Deutschnofen,18,,21,35,56
059 Deutschnofen,19,,19,18,37
059 Deutschnofen,20,,27,19,46
059 Deutschnofen,21,,22,27,49
059 Deutschnofen,22,,24,19,43
059 Deutschnofen,23,,33,24,57
059 Deutschnofen,24,,15,19,34
059 Deutschnofen,25,,20,28,48
059 Deutschnofen,26,,28,34,62
059 Deutschnofen,27,,16,27,43
059 Deutschnofen,28,,22,31,53
059 Deutschnofen,29,,29,22,51
059 Deutschnofen,30,,29,23,52
059 Deutschnofen,31,,45,26,71
059 Deutschnofen,32,,25,28,53
059 Deutschnofen,33,,31,29,60
059 Deutschnofen,34,,32,34,66
059 Deutschnofen,35,,40,23,63
059 Deutschnofen,36,,30,27,57
059 Deutschnofen,37,,31,26,57
059 Deutschnofen,38,,27,27,54
059 Deutschnofen,39,,34,23,57
059 Deutschnofen,40,,42,26,68
059 Deutschnofen,41,,26,19,45
059 Deutschnofen,42,,23,31,54
059 Deutschnofen,43,,24,26,50
059 Deutschnofen,44,,34,25,59
059 Deutschnofen,45,,29,22,51
059 Deutschnofen,46,,27,20,47
059 Deutschnofen,47,,22,19,41
059 Deutschnofen,48,,24,22,46
059 Deutschnofen,49,,22,14,36
059 Deutschnofen,50,,18,19,37
059 Deutschnofen,51,,22,13,35
059 Deutschnofen,52,,25,17,42
059 Deutschnofen,53,,13,14,27
059 Deutschnofen,54,,18,22,40
059 Deutschnofen,55,,17,16,33
059 Deutschnofen,56,,16,18,34
059 Deutschnofen,57,,25,22,47
059 Deutschnofen,58,,20,17,37
059 Deutschnofen,59,,15,25,40
059 Deutschnofen,60,,13,19,32
059 Deutschnofen,61,,27,14,41
059 Deutschnofen,62,,17,22,39
059 Deutschnofen,63,,13,7,20
059 Deutschnofen,64,,14,10,24
059 Deutschnofen,65,,9,13,22
059 Deutschnofen,66,,16,11,27
059 Deutschnofen,67,,9,14,23
059 Deutschnofen,68,,14,15,29
059 Deutschnofen,69,,12,9,21
059 Deutschnofen,70,,12,11,23
059 Deutschnofen,71,,10,11,21
059 Deutschnofen,72,,10,24,34
059 Deutschnofen,73,,9,15,24
059 Deutschnofen,74,,17,11,28
059 Deutschnofen,75,,11,21,32
059 Deutschnofen,76,,6,12,18
059 Deutschnofen,77,,7,12,19
059 Deutschnofen,78,,9,19,28
059 Deutschnofen,79,,7,17,24
059 Deutschnofen,80,,4,12,16
059 Deutschnofen,81,,2,6,8
059 Deutschnofen,82,,3,6,9
059 Deutschnofen,83,,1,5,6
059 Deutschnofen,84,,4,3,7
059 Deutschnofen,85,,6,6,12
059 Deutschnofen,86,,3,7,10
059 Deutschnofen,87,,4,10,14
059 Deutschnofen,88,,-,7,7
059 Deutschnofen,89,,1,7,8
059 Deutschnofen,90,,3,2,5
059 Deutschnofen,91,,-,2,2
059 Deutschnofen,92,,2,-,2
059 Deutschnofen,93,,1,-,1
059 Deutschnofen,94,,1,1,2
060 Auer,0,,17,20,37
060 Auer,1,,21,23,44
060 Auer,2,,16,17,33
060 Auer,3,,19,19,38
060 Auer,4,,16,22,38
060 Auer,5,,20,14,34
060 Auer,6,,19,19,38
060 Auer,7,,11,22,33
060 Auer,8,,18,20,38
060 Auer,9,,23,12,35
060 Auer,10,,17,16,33
060 Auer,11,,20,18,38
060 Auer,12,,17,23,40
060 Auer,13,,21,15,36
060 Auer,14,,15,15,30
060 Auer,15,,21,18,39
060 Auer,16,,14,10,24
060 Auer,17,,13,16,29
060 Auer,18,,17,24,41
060 Auer,19,,12,16,28
060 Auer,20,,12,12,24
060 Auer,21,,18,17,35
060 Auer,22,,12,9,21
060 Auer,23,,13,17,30
060 Auer,24,,18,23,41
060 Auer,25,,10,15,25
060 Auer,26,,24,26,50
060 Auer,27,,27,18,45
060 Auer,28,,17,22,39
060 Auer,29,,28,20,48
060 Auer,30,,25,16,41
060 Auer,31,,19,28,47
060 Auer,32,,28,33,61
060 Auer,33,,24,22,46
060 Auer,34,,28,38,66
060 Auer,35,,28,25,53
060 Auer,36,,31,19,50
060 Auer,37,,34,34,68
060 Auer,38,,23,24,47
060 Auer,39,,38,33,71
060 Auer,40,,23,33,56
060 Auer,41,,33,28,61
060 Auer,42,,32,19,51
060 Auer,43,,24,25,49
060 Auer,44,,30,27,57
060 Auer,45,,15,24,39
060 Auer,46,,18,14,32
060 Auer,47,,14,20,34
060 Auer,48,,22,19,41
060 Auer,49,,18,22,40
060 Auer,50,,14,22,36
060 Auer,51,,11,13,24
060 Auer,52,,28,14,42
060 Auer,53,,15,22,37
060 Auer,54,,18,23,41
060 Auer,55,,13,13,26
060 Auer,56,,21,16,37
060 Auer,57,,17,19,36
060 Auer,58,,17,19,36
060 Auer,59,,21,16,37
060 Auer,60,,12,9,21
060 Auer,61,,13,18,31
060 Auer,62,,18,20,38
060 Auer,63,,12,13,25
060 Auer,64,,9,9,18
060 Auer,65,,10,16,26
060 Auer,66,,18,15,33
060 Auer,67,,6,9,15
060 Auer,68,,4,17,21
060 Auer,69,,13,10,23
060 Auer,70,,9,10,19
060 Auer,71,,9,15,24
060 Auer,72,,13,12,25
060 Auer,73,,9,13,22
060 Auer,74,,7,16,23
060 Auer,75,,13,10,23
060 Auer,76,,10,9,19
060 Auer,77,,9,15,24
060 Auer,78,,3,17,20
060 Auer,79,,4,12,16
060 Auer,80,,7,10,17
060 Auer,81,,5,3,8
060 Auer,82,,2,8,10
060 Auer,83,,2,5,7
060 Auer,84,,2,3,5
060 Auer,85,,1,2,3
060 Auer,86,,1,3,4
060 Auer,87,,3,7,10
060 Auer,88,,1,5,6
060 Auer,89,,-,1,1
060 Auer,90,,1,1,2
060 Auer,91,,1,3,4
060 Auer,92,,-,1,1
060 Auer,93,,1,1,2
060 Auer,105,,-,1,1
061 St.Ulrich,0,,28,32,60
061 St.Ulrich,1,,43,31,74
061 St.Ulrich,2,,38,33,71
061 St.Ulrich,3,,29,28,57
061 St.Ulrich,4,,28,23,51
061 St.Ulrich,5,,31,32,63
061 St.Ulrich,6,,27,30,57
061 St.Ulrich,7,,21,31,52
061 St.Ulrich,8,,34,31,65
061 St.Ulrich,9,,30,32,62
061 St.Ulrich,10,,29,21,50
061 St.Ulrich,11,,16,25,41
061 St.Ulrich,12,,18,21,39
061 St.Ulrich,13,,27,18,45
061 St.Ulrich,14,,18,18,36
061 St.Ulrich,15,,24,21,45
061 St.Ulrich,16,,23,18,41
061 St.Ulrich,17,,21,19,40
061 St.Ulrich,18,,25,26,51
061 St.Ulrich,19,,21,24,45
061 St.Ulrich,20,,24,28,52
061 St.Ulrich,21,,30,24,54
061 St.Ulrich,22,,22,28,50
061 St.Ulrich,23,,24,21,45
061 St.Ulrich,24,,32,35,67
061 St.Ulrich,25,,37,28,65
061 St.Ulrich,26,,36,31,67
061 St.Ulrich,27,,40,31,71
061 St.Ulrich,28,,42,39,81
061 St.Ulrich,29,,41,37,78
061 St.Ulrich,30,,38,35,73
061 St.Ulrich,31,,49,43,92
061 St.Ulrich,32,,47,41,88
061 St.Ulrich,33,,38,39,77
061 St.Ulrich,34,,40,35,75
061 St.Ulrich,35,,32,31,63
061 St.Ulrich,36,,39,43,82
061 St.Ulrich,37,,38,32,70
061 St.Ulrich,38,,32,36,68
061 St.Ulrich,39,,29,21,50
061 St.Ulrich,40,,34,26,60
061 St.Ulrich,41,,40,26,66
061 St.Ulrich,42,,23,19,42
061 St.Ulrich,43,,27,35,62
061 St.Ulrich,44,,18,30,48
061 St.Ulrich,45,,27,38,65
061 St.Ulrich,46,,26,35,61
061 St.Ulrich,47,,30,17,47
061 St.Ulrich,48,,15,26,41
061 St.Ulrich,49,,25,24,49
061 St.Ulrich,50,,23,24,47
061 St.Ulrich,51,,18,28,46
061 St.Ulrich,52,,31,30,61
061 St.Ulrich,53,,23,22,45
061 St.Ulrich,54,,38,26,64
061 St.Ulrich,55,,20,19,39
061 St.Ulrich,56,,31,32,63
061 St.Ulrich,57,,41,39,80
061 St.Ulrich,58,,33,37,70
061 St.Ulrich,59,,40,46,86
061 St.Ulrich,60,,32,27,59
061 St.Ulrich,61,,20,21,41
061 St.Ulrich,62,,27,26,53
061 St.Ulrich,63,,24,26,50
061 St.Ulrich,64,,24,16,40
061 St.Ulrich,65,,14,25,39
061 St.Ulrich,66,,20,13,33
061 St.Ulrich,67,,20,14,34
061 St.Ulrich,68,,15,22,37
061 St.Ulrich,69,,20,16,36
061 St.Ulrich,70,,21,10,31
061 St.Ulrich,71,,18,5,23
061 St.Ulrich,72,,19,12,31
061 St.Ulrich,73,,18,18,36
061 St.Ulrich,74,,11,16,27
061 St.Ulrich,75,,13,10,23
061 St.Ulrich,76,,10,21,31
061 St.Ulrich,77,,12,24,36
061 St.Ulrich,78,,6,20,26
061 St.Ulrich,79,,9,16,25
061 St.Ulrich,80,,8,19,27
061 St.Ulrich,81,,6,9,15
061 St.Ulrich,82,,5,10,15
061 St.Ulrich,83,,2,6,8
061 St.Ulrich,84,,4,6,10
061 St.Ulrich,85,,2,9,11
061 St.Ulrich,86,,9,9,18
061 St.Ulrich,87,,5,18,23
061 St.Ulrich,88,,6,12,18
061 St.Ulrich,89,,-,9,9
061 St.Ulrich,90,,4,3,7
061 St.Ulrich,91,,3,1,4
061 St.Ulrich,92,,1,1,2
061 St.Ulrich,93,,-,2,2
061 St.Ulrich,94,,-,2,2
061 St.Ulrich,96,,-,1,1
061 St.Ulrich,97,,1,1,2
062 Partschins,0,,17,16,33
062 Partschins,1,,17,12,29
062 Partschins,2,,16,13,29
062 Partschins,3,,21,21,42
062 Partschins,4,,13,19,32
062 Partschins,5,,22,16,38
062 Partschins,6,,21,17,38
062 Partschins,7,,22,17,39
062 Partschins,8,,19,17,36
062 Partschins,9,,23,25,48
062 Partschins,10,,24,24,48
062 Partschins,11,,11,23,34
062 Partschins,12,,19,27,46
062 Partschins,13,,17,14,31
062 Partschins,14,,23,19,42
062 Partschins,15,,11,14,25
062 Partschins,16,,17,20,37
062 Partschins,17,,17,22,39
062 Partschins,18,,18,20,38
062 Partschins,19,,21,27,48
062 Partschins,20,,25,18,43
062 Partschins,21,,15,16,31
062 Partschins,22,,16,16,32
062 Partschins,23,,26,19,45
062 Partschins,24,,19,21,40
062 Partschins,25,,23,20,43
062 Partschins,26,,25,14,39
062 Partschins,27,,31,23,54
062 Partschins,28,,26,28,54
062 Partschins,29,,26,24,50
062 Partschins,30,,29,28,57
062 Partschins,31,,35,26,61
062 Partschins,32,,22,26,48
062 Partschins,33,,31,25,56
062 Partschins,34,,37,35,72
062 Partschins,35,,30,33,63
062 Partschins,36,,28,40,68
062 Partschins,37,,36,25,61
062 Partschins,38,,33,24,57
062 Partschins,39,,20,26,46
062 Partschins,40,,23,37,60
062 Partschins,41,,28,18,46
062 Partschins,42,,22,18,40
062 Partschins,43,,23,25,48
062 Partschins,44,,24,19,43
062 Partschins,45,,26,27,53
062 Partschins,46,,11,27,38
062 Partschins,47,,22,14,36
062 Partschins,48,,16,14,30
062 Partschins,49,,19,16,35
062 Partschins,50,,16,20,36
062 Partschins,51,,8,12,20
062 Partschins,52,,18,17,35
062 Partschins,53,,18,16,34
062 Partschins,54,,28,27,55
062 Partschins,55,,14,17,31
062 Partschins,56,,18,18,36
062 Partschins,57,,23,26,49
062 Partschins,58,,14,16,30
062 Partschins,59,,23,31,54
062 Partschins,60,,14,13,27
062 Partschins,61,,12,17,29
062 Partschins,62,,20,14,34
062 Partschins,63,,16,17,33
062 Partschins,64,,13,17,30
062 Partschins,65,,11,10,21
062 Partschins,66,,13,16,29
062 Partschins,67,,14,16,30
062 Partschins,68,,15,10,25
062 Partschins,69,,14,21,35
062 Partschins,70,,13,11,24
062 Partschins,71,,12,11,23
062 Partschins,72,,12,14,26
062 Partschins,73,,11,13,24
062 Partschins,74,,9,9,18
062 Partschins,75,,8,12,20
062 Partschins,76,,5,14,19
062 Partschins,77,,7,10,17
062 Partschins,78,,6,9,15
062 Partschins,79,,16,8,24
062 Partschins,80,,3,6,9
062 Partschins,81,,4,8,12
062 Partschins,82,,2,3,5
062 Partschins,83,,2,5,7
062 Partschins,84,,2,3,5
062 Partschins,85,,2,1,3
062 Partschins,86,,3,7,10
062 Partschins,87,,2,9,11
062 Partschins,88,,1,7,8
062 Partschins,89,,3,2,5
062 Partschins,90,,1,7,8
062 Partschins,91,,-,4,4
062 Partschins,93,,-,1,1
062 Partschins,94,,2,-,2
062 Partschins,95,,1,1,2
062 Partschins,96,,-,1,1
062 Partschins,97,,-,1,1
062 Partschins,98,,-,1,1
063 Percha,0,,12,13,25
063 Percha,1,,6,7,13
063 Percha,2,,7,10,17
063 Percha,3,,10,16,26
063 Percha,4,,9,4,13
063 Percha,5,,8,8,16
063 Percha,6,,9,11,20
063 Percha,7,,7,9,16
063 Percha,8,,13,6,19
063 Percha,9,,10,9,19
063 Percha,10,,8,7,15
063 Percha,11,,6,8,14
063 Percha,12,,6,5,11
063 Percha,13,,9,17,26
063 Percha,14,,5,7,12
063 Percha,15,,8,14,22
063 Percha,16,,18,9,27
063 Percha,17,,14,10,24
063 Percha,18,,6,12,18
063 Percha,19,,9,6,15
063 Percha,20,,11,5,16
063 Percha,21,,7,13,20
063 Percha,22,,8,11,19
063 Percha,23,,8,9,17
063 Percha,24,,15,10,25
063 Percha,25,,9,7,16
063 Percha,26,,5,12,17
063 Percha,27,,9,8,17
063 Percha,28,,11,11,22
063 Percha,29,,15,10,25
063 Percha,30,,8,11,19
063 Percha,31,,17,12,29
063 Percha,32,,14,13,27
063 Percha,33,,11,14,25
063 Percha,34,,18,6,24
063 Percha,35,,14,22,36
063 Percha,36,,16,10,26
063 Percha,37,,11,16,27
063 Percha,38,,15,11,26
063 Percha,39,,11,11,22
063 Percha,40,,10,6,16
063 Percha,41,,6,8,14
063 Percha,42,,10,9,19
063 Percha,43,,9,4,13
063 Percha,44,,7,12,19
063 Percha,45,,12,11,23
063 Percha,46,,4,4,8
063 Percha,47,,8,6,14
063 Percha,48,,4,8,12
063 Percha,49,,7,7,14
063 Percha,50,,6,7,13
063 Percha,51,,9,6,15
063 Percha,52,,5,4,9
063 Percha,53,,5,6,11
063 Percha,54,,6,8,14
063 Percha,55,,8,5,13
063 Percha,56,,12,4,16
063 Percha,57,,9,7,16
063 Percha,58,,9,7,16
063 Percha,59,,9,6,15
063 Percha,60,,5,5,10
063 Percha,61,,7,5,12
063 Percha,62,,5,9,14
063 Percha,63,,1,5,6
063 Percha,64,,4,5,9
063 Percha,65,,4,5,9
063 Percha,66,,6,6,12
063 Percha,67,,4,5,9
063 Percha,68,,5,3,8
063 Percha,69,,7,2,9
063 Percha,70,,10,3,13
063 Percha,71,,3,5,8
063 Percha,72,,3,3,6
063 Percha,73,,6,4,10
063 Percha,74,,2,8,10
063 Percha,75,,4,6,10
063 Percha,76,,2,2,4
063 Percha,77,,1,4,5
063 Percha,78,,2,2,4
063 Percha,79,,-,2,2
063 Percha,80,,-,1,1
063 Percha,82,,1,1,2
063 Percha,84,,1,1,2
063 Percha,85,,1,1,2
063 Percha,86,,-,4,4
063 Percha,88,,-,3,3
063 Percha,90,,1,-,1
064 Plaus,0,,10,3,13
064 Plaus,1,,9,5,14
064 Plaus,2,,5,6,11
064 Plaus,3,,6,6,12
064 Plaus,4,,5,2,7
064 Plaus,5,,2,2,4
064 Plaus,6,,4,1,5
064 Plaus,7,,8,3,11
064 Plaus,8,,6,5,11
064 Plaus,9,,3,8,11
064 Plaus,10,,4,2,6
064 Plaus,11,,4,6,10
064 Plaus,12,,3,2,5
064 Plaus,13,,4,2,6
064 Plaus,14,,-,4,4
064 Plaus,15,,2,5,7
064 Plaus,16,,4,-,4
064 Plaus,17,,1,1,2
064 Plaus,18,,-,4,4
064 Plaus,19,,2,4,6
064 Plaus,20,,1,5,6
064 Plaus,21,,1,4,5
064 Plaus,22,,3,5,8
064 Plaus,23,,1,4,5
064 Plaus,24,,3,3,6
064 Plaus,25,,9,1,10
064 Plaus,26,,5,5,10
064 Plaus,27,,7,2,9
064 Plaus,28,,6,2,8
064 Plaus,29,,4,5,9
064 Plaus,30,,7,4,11
064 Plaus,31,,8,8,16
064 Plaus,32,,3,7,10
064 Plaus,33,,12,9,21
064 Plaus,34,,4,6,10
064 Plaus,35,,12,3,15
064 Plaus,36,,7,8,15
064 Plaus,37,,3,5,8
064 Plaus,38,,5,4,9
064 Plaus,39,,6,2,8
064 Plaus,40,,1,5,6
064 Plaus,41,,7,2,9
064 Plaus,42,,4,3,7
064 Plaus,43,,2,2,4
064 Plaus,44,,4,1,5
064 Plaus,45,,3,3,6
064 Plaus,46,,1,1,2
064 Plaus,47,,3,4,7
064 Plaus,48,,5,2,7
064 Plaus,49,,4,3,7
064 Plaus,50,,1,2,3
064 Plaus,51,,3,3,6
064 Plaus,52,,1,3,4
064 Plaus,53,,3,5,8
064 Plaus,54,,6,3,9
064 Plaus,55,,4,1,5
064 Plaus,56,,2,3,5
064 Plaus,57,,5,1,6
064 Plaus,58,,-,4,4
064 Plaus,59,,4,4,8
064 Plaus,60,,3,2,5
064 Plaus,61,,3,2,5
064 Plaus,62,,1,1,2
064 Plaus,63,,3,3,6
064 Plaus,65,,2,2,4
064 Plaus,66,,4,3,7
064 Plaus,67,,1,3,4
064 Plaus,68,,1,3,4
064 Plaus,69,,1,1,2
064 Plaus,70,,-,1,1
064 Plaus,71,,1,1,2
064 Plaus,72,,1,-,1
064 Plaus,73,,1,1,2
064 Plaus,74,,1,2,3
064 Plaus,75,,1,-,1
064 Plaus,76,,-,4,4
064 Plaus,77,,-,4,4
064 Plaus,78,,1,2,3
064 Plaus,79,,-,1,1
064 Plaus,80,,1,1,2
064 Plaus,81,,-,2,2
064 Plaus,82,,-,2,2
064 Plaus,88,,1,1,2
064 Plaus,89,,-,1,1
065 Waidbruck,0,,2,2,4
065 Waidbruck,1,,2,1,3
065 Waidbruck,3,,3,3,6
065 Waidbruck,4,,2,-,2
065 Waidbruck,5,,1,3,4
065 Waidbruck,6,,3,1,4
065 Waidbruck,7,,1,1,2
065 Waidbruck,8,,-,2,2
065 Waidbruck,9,,1,-,1
065 Waidbruck,10,,1,1,2
065 Waidbruck,11,,2,-,2
065 Waidbruck,12,,-,1,1
065 Waidbruck,13,,2,1,3
065 Waidbruck,15,,-,1,1
065 Waidbruck,16,,1,1,2
065 Waidbruck,17,,1,-,1
065 Waidbruck,19,,-,2,2
065 Waidbruck,20,,2,-,2
065 Waidbruck,21,,1,-,1
065 Waidbruck,22,,2,-,2
065 Waidbruck,23,,1,1,2
065 Waidbruck,24,,1,1,2
065 Waidbruck,25,,-,1,1
065 Waidbruck,26,,4,-,4
065 Waidbruck,27,,-,1,1
065 Waidbruck,28,,-,1,1
065 Waidbruck,29,,5,-,5
065 Waidbruck,30,,4,1,5
065 Waidbruck,31,,1,3,4
065 Waidbruck,32,,4,1,5
065 Waidbruck,33,,2,5,7
065 Waidbruck,34,,3,2,5
065 Waidbruck,35,,2,1,3
065 Waidbruck,36,,3,-,3
065 Waidbruck,37,,-,1,1
065 Waidbruck,38,,2,1,3
065 Waidbruck,39,,-,1,1
065 Waidbruck,40,,3,1,4
065 Waidbruck,41,,3,1,4
065 Waidbruck,42,,-,1,1
065 Waidbruck,43,,1,1,2
065 Waidbruck,44,,2,-,2
065 Waidbruck,45,,2,1,3
065 Waidbruck,47,,2,1,3
065 Waidbruck,48,,2,1,3
065 Waidbruck,49,,-,2,2
065 Waidbruck,54,,-,3,3
065 Waidbruck,55,,1,1,2
065 Waidbruck,56,,2,2,4
065 Waidbruck,57,,-,1,1
065 Waidbruck,58,,1,-,1
065 Waidbruck,59,,1,2,3
065 Waidbruck,60,,-,3,3
065 Waidbruck,61,,1,-,1
065 Waidbruck,62,,-,3,3
065 Waidbruck,63,,2,1,3
065 Waidbruck,64,,2,2,4
065 Waidbruck,65,,-,3,3
065 Waidbruck,66,,4,1,5
065 Waidbruck,67,,2,-,2
065 Waidbruck,68,,1,4,5
065 Waidbruck,69,,1,-,1
065 Waidbruck,70,,2,-,2
065 Waidbruck,71,,-,3,3
065 Waidbruck,72,,1,-,1
065 Waidbruck,73,,3,1,4
065 Waidbruck,74,,-,1,1
065 Waidbruck,75,,1,1,2
065 Waidbruck,77,,-,2,2
065 Waidbruck,78,,-,1,1
065 Waidbruck,80,,-,3,3
065 Waidbruck,81,,-,2,2
065 Waidbruck,85,,2,-,2
065 Waidbruck,86,,-,1,1
065 Waidbruck,95,,-,1,1
066 Burgstall,0,,10,7,17
066 Burgstall,1,,8,9,17
066 Burgstall,2,,10,9,19
066 Burgstall,3,,8,3,11
066 Burgstall,4,,4,9,13
066 Burgstall,5,,9,8,17
066 Burgstall,6,,5,6,11
066 Burgstall,7,,5,10,15
066 Burgstall,8,,6,4,10
066 Burgstall,9,,8,11,19
066 Burgstall,10,,11,8,19
066 Burgstall,11,,10,4,14
066 Burgstall,12,,6,5,11
066 Burgstall,13,,9,8,17
066 Burgstall,14,,9,4,13
066 Burgstall,15,,5,10,15
066 Burgstall,16,,10,12,22
066 Burgstall,17,,6,8,14
066 Burgstall,18,,13,7,20
066 Burgstall,19,,5,8,13
066 Burgstall,20,,11,5,16
066 Burgstall,21,,4,7,11
066 Burgstall,22,,7,7,14
066 Burgstall,23,,3,11,14
066 Burgstall,24,,10,7,17
066 Burgstall,25,,16,9,25
066 Burgstall,26,,7,9,16
066 Burgstall,27,,11,9,20
066 Burgstall,28,,9,14,23
066 Burgstall,29,,12,7,19
066 Burgstall,30,,11,9,20
066 Burgstall,31,,13,8,21
066 Burgstall,32,,14,15,29
066 Burgstall,33,,7,15,22
066 Burgstall,34,,16,13,29
066 Burgstall,35,,20,17,37
066 Burgstall,36,,16,9,25
066 Burgstall,37,,15,11,26
066 Burgstall,38,,16,11,27
066 Burgstall,39,,9,14,23
066 Burgstall,40,,14,9,23
066 Burgstall,41,,5,8,13
066 Burgstall,42,,15,11,26
066 Burgstall,43,,7,8,15
066 Burgstall,44,,12,11,23
066 Burgstall,45,,7,8,15
066 Burgstall,46,,9,11,20
066 Burgstall,47,,8,10,18
066 Burgstall,48,,10,13,23
066 Burgstall,49,,11,7,18
066 Burgstall,50,,11,10,21
066 Burgstall,51,,8,7,15
066 Burgstall,52,,6,13,19
066 Burgstall,53,,7,8,15
066 Burgstall,54,,9,8,17
066 Burgstall,55,,6,9,15
066 Burgstall,56,,11,9,20
066 Burgstall,57,,9,7,16
066 Burgstall,58,,5,6,11
066 Burgstall,59,,8,5,13
066 Burgstall,60,,5,13,18
066 Burgstall,61,,5,9,14
066 Burgstall,62,,10,14,24
066 Burgstall,63,,5,9,14
066 Burgstall,64,,5,6,11
066 Burgstall,65,,7,3,10
066 Burgstall,66,,10,8,18
066 Burgstall,67,,8,4,12
066 Burgstall,68,,4,8,12
066 Burgstall,69,,6,3,9
066 Burgstall,70,,6,7,13
066 Burgstall,71,,2,4,6
066 Burgstall,72,,4,9,13
066 Burgstall,73,,2,12,14
066 Burgstall,74,,5,10,15
066 Burgstall,75,,7,5,12
066 Burgstall,76,,1,8,9
066 Burgstall,77,,5,3,8
066 Burgstall,78,,6,5,11
066 Burgstall,79,,2,2,4
066 Burgstall,80,,3,3,6
066 Burgstall,81,,1,4,5
066 Burgstall,82,,-,1,1
066 Burgstall,83,,1,1,2
066 Burgstall,84,,2,2,4
066 Burgstall,85,,2,4,6
066 Burgstall,86,,1,4,5
066 Burgstall,87,,3,1,4
066 Burgstall,88,,-,5,5
066 Burgstall,89,,-,4,4
066 Burgstall,90,,-,1,1
066 Burgstall,91,,-,3,3
066 Burgstall,93,,1,-,1
066 Burgstall,94,,1,-,1
066 Burgstall,98,,-,1,1
066 Burgstall,99,,1,-,1
067 Prad am Stilfser Joch,0,,15,14,29
067 Prad am Stilfser Joch,1,,17,16,33
067 Prad am Stilfser Joch,2,,21,20,41
067 Prad am Stilfser Joch,3,,23,17,40
067 Prad am Stilfser Joch,4,,17,18,35
067 Prad am Stilfser Joch,5,,21,12,33
067 Prad am Stilfser Joch,6,,18,25,43
067 Prad am Stilfser Joch,7,,22,27,49
067 Prad am Stilfser Joch,8,,16,21,37
067 Prad am Stilfser Joch,9,,19,11,30
067 Prad am Stilfser Joch,10,,19,21,40
067 Prad am Stilfser Joch,11,,18,23,41
067 Prad am Stilfser Joch,12,,31,16,47
067 Prad am Stilfser Joch,13,,13,19,32
067 Prad am Stilfser Joch,14,,28,27,55
067 Prad am Stilfser Joch,15,,30,23,53
067 Prad am Stilfser Joch,16,,30,29,59
067 Prad am Stilfser Joch,17,,28,25,53
067 Prad am Stilfser Joch,18,,27,22,49
067 Prad am Stilfser Joch,19,,25,24,49
067 Prad am Stilfser Joch,20,,28,24,52
067 Prad am Stilfser Joch,21,,19,11,30
067 Prad am Stilfser Joch,22,,21,18,39
067 Prad am Stilfser Joch,23,,19,35,54
067 Prad am Stilfser Joch,24,,23,23,46
067 Prad am Stilfser Joch,25,,21,17,38
067 Prad am Stilfser Joch,26,,32,20,52
067 Prad am Stilfser Joch,27,,22,32,54
067 Prad am Stilfser Joch,28,,29,21,50
067 Prad am Stilfser Joch,29,,29,23,52
067 Prad am Stilfser Joch,30,,27,23,50
067 Prad am Stilfser Joch,31,,27,29,56
067 Prad am Stilfser Joch,32,,30,30,60
067 Prad am Stilfser Joch,33,,27,24,51
067 Prad am Stilfser Joch,34,,32,29,61
067 Prad am Stilfser Joch,35,,33,22,55
067 Prad am Stilfser Joch,36,,30,25,55
067 Prad am Stilfser Joch,37,,24,10,34
067 Prad am Stilfser Joch,38,,27,31,58
067 Prad am Stilfser Joch,39,,19,27,46
067 Prad am Stilfser Joch,40,,17,24,41
067 Prad am Stilfser Joch,41,,31,13,44
067 Prad am Stilfser Joch,42,,24,29,53
067 Prad am Stilfser Joch,43,,26,24,50
067 Prad am Stilfser Joch,44,,25,25,50
067 Prad am Stilfser Joch,45,,28,17,45
067 Prad am Stilfser Joch,46,,29,18,47
067 Prad am Stilfser Joch,47,,28,17,45
067 Prad am Stilfser Joch,48,,14,21,35
067 Prad am Stilfser Joch,49,,20,22,42
067 Prad am Stilfser Joch,50,,22,17,39
067 Prad am Stilfser Joch,51,,23,21,44
067 Prad am Stilfser Joch,52,,20,11,31
067 Prad am Stilfser Joch,53,,16,14,30
067 Prad am Stilfser Joch,54,,16,15,31
067 Prad am Stilfser Joch,55,,18,11,29
067 Prad am Stilfser Joch,56,,11,15,26
067 Prad am Stilfser Joch,57,,24,16,40
067 Prad am Stilfser Joch,58,,18,16,34
067 Prad am Stilfser Joch,59,,21,10,31
067 Prad am Stilfser Joch,60,,10,16,26
067 Prad am Stilfser Joch,61,,14,13,27
067 Prad am Stilfser Joch,62,,18,14,32
067 Prad am Stilfser Joch,63,,11,13,24
067 Prad am Stilfser Joch,64,,11,11,22
067 Prad am Stilfser Joch,65,,15,15,30
067 Prad am Stilfser Joch,66,,9,24,33
067 Prad am Stilfser Joch,67,,14,10,24
067 Prad am Stilfser Joch,68,,13,19,32
067 Prad am Stilfser Joch,69,,8,14,22
067 Prad am Stilfser Joch,70,,12,14,26
067 Prad am Stilfser Joch,71,,8,12,20
067 Prad am Stilfser Joch,72,,8,9,17
067 Prad am Stilfser Joch,73,,8,12,20
067 Prad am Stilfser Joch,74,,10,13,23
067 Prad am Stilfser Joch,75,,10,9,19
067 Prad am Stilfser Joch,76,,7,12,19
067 Prad am Stilfser Joch,77,,5,12,17
067 Prad am Stilfser Joch,78,,6,13,19
067 Prad am Stilfser Joch,79,,6,7,13
067 Prad am Stilfser Joch,80,,6,7,13
067 Prad am Stilfser Joch,81,,7,4,11
067 Prad am Stilfser Joch,82,,2,5,7
067 Prad am Stilfser Joch,83,,-,4,4
067 Prad am Stilfser Joch,84,,1,5,6
067 Prad am Stilfser Joch,85,,4,2,6
067 Prad am Stilfser Joch,86,,2,7,9
067 Prad am Stilfser Joch,87,,-,3,3
067 Prad am Stilfser Joch,88,,4,6,10
067 Prad am Stilfser Joch,89,,1,3,4
067 Prad am Stilfser Joch,90,,1,4,5
067 Prad am Stilfser Joch,91,,-,2,2
067 Prad am Stilfser Joch,92,,1,2,3
067 Prad am Stilfser Joch,93,,2,2,4
067 Prad am Stilfser Joch,95,,-,2,2
067 Prad am Stilfser Joch,96,,-,1,1
068 Prettau,0,,2,5,7
068 Prettau,1,,6,8,14
068 Prettau,2,,7,5,12
068 Prettau,3,,4,5,9
068 Prettau,4,,1,2,3
068 Prettau,5,,6,5,11
068 Prettau,6,,5,7,12
068 Prettau,7,,4,6,10
068 Prettau,8,,3,3,6
068 Prettau,9,,1,4,5
068 Prettau,10,,1,7,8
068 Prettau,11,,-,4,4
068 Prettau,12,,5,3,8
068 Prettau,13,,5,1,6
068 Prettau,14,,2,2,4
068 Prettau,15,,2,1,3
068 Prettau,16,,3,6,9
068 Prettau,17,,4,2,6
068 Prettau,18,,2,2,4
068 Prettau,19,,2,1,3
068 Prettau,20,,4,2,6
068 Prettau,21,,5,3,8
068 Prettau,22,,1,-,1
068 Prettau,23,,4,3,7
068 Prettau,24,,1,1,2
068 Prettau,25,,4,4,8
068 Prettau,26,,7,2,9
068 Prettau,27,,6,9,15
068 Prettau,28,,10,5,15
068 Prettau,29,,4,4,8
068 Prettau,30,,2,6,8
068 Prettau,31,,8,8,16
068 Prettau,32,,5,4,9
068 Prettau,33,,10,6,16
068 Prettau,34,,6,2,8
068 Prettau,35,,4,12,16
068 Prettau,36,,9,6,15
068 Prettau,37,,5,6,11
068 Prettau,38,,2,5,7
068 Prettau,39,,5,5,10
068 Prettau,40,,7,4,11
068 Prettau,41,,5,2,7
068 Prettau,42,,7,-,7
068 Prettau,43,,4,1,5
068 Prettau,44,,6,5,11
068 Prettau,45,,6,5,11
068 Prettau,46,,6,2,8
068 Prettau,47,,3,3,6
068 Prettau,48,,4,3,7
068 Prettau,49,,2,2,4
068 Prettau,50,,2,2,4
068 Prettau,51,,2,3,5
068 Prettau,52,,2,2,4
068 Prettau,53,,4,5,9
068 Prettau,54,,9,4,13
068 Prettau,55,,1,3,4
068 Prettau,56,,6,5,11
068 Prettau,57,,4,2,6
068 Prettau,58,,3,2,5
068 Prettau,59,,3,3,6
068 Prettau,60,,4,5,9
068 Prettau,61,,4,4,8
068 Prettau,62,,5,7,12
068 Prettau,63,,2,6,8
068 Prettau,64,,4,3,7
068 Prettau,65,,6,3,9
068 Prettau,66,,1,3,4
068 Prettau,67,,4,3,7
068 Prettau,68,,4,-,4
068 Prettau,69,,2,1,3
068 Prettau,70,,5,4,9
068 Prettau,71,,4,5,9
068 Prettau,72,,-,3,3
068 Prettau,73,,3,1,4
068 Prettau,74,,1,7,8
068 Prettau,75,,1,2,3
068 Prettau,76,,2,1,3
068 Prettau,77,,1,4,5
068 Prettau,78,,2,-,2
068 Prettau,79,,1,2,3
068 Prettau,80,,3,4,7
068 Prettau,81,,3,1,4
068 Prettau,82,,1,2,3
068 Prettau,83,,1,-,1
068 Prettau,84,,2,3,5
068 Prettau,85,,-,1,1
068 Prettau,86,,-,3,3
068 Prettau,87,,-,4,4
068 Prettau,88,,-,2,2
068 Prettau,89,,-,2,2
068 Prettau,94,,-,1,1
068 Prettau,95,,-,2,2
068 Prettau,100,,-,1,1
069 Proveis,0,,-,1,1
069 Proveis,1,,4,-,4
069 Proveis,2,,2,2,4
069 Proveis,3,,1,2,3
069 Proveis,4,,1,1,2
069 Proveis,5,,-,4,4
069 Proveis,6,,2,-,2
069 Proveis,7,,2,1,3
069 Proveis,8,,3,1,4
069 Proveis,9,,3,2,5
069 Proveis,10,,-,1,1
069 Proveis,11,,1,1,2
069 Proveis,12,,2,3,5
069 Proveis,13,,2,2,4
069 Proveis,14,,3,1,4
069 Proveis,15,,5,-,5
069 Proveis,16,,3,3,6
069 Proveis,17,,3,3,6
069 Proveis,18,,1,-,1
069 Proveis,19,,2,3,5
069 Proveis,21,,3,1,4
069 Proveis,22,,3,2,5
069 Proveis,23,,2,2,4
069 Proveis,24,,1,3,4
069 Proveis,25,,2,2,4
069 Proveis,26,,5,2,7
069 Proveis,27,,2,-,2
069 Proveis,28,,-,2,2
069 Proveis,29,,1,1,2
069 Proveis,30,,4,3,7
069 Proveis,31,,4,3,7
069 Proveis,32,,6,1,7
069 Proveis,33,,2,1,3
069 Proveis,34,,2,1,3
069 Proveis,35,,1,1,2
069 Proveis,36,,3,-,3
069 Proveis,37,,4,2,6
069 Proveis,38,,5,2,7
069 Proveis,39,,4,1,5
069 Proveis,40,,-,4,4
069 Proveis,41,,4,-,4
069 Proveis,42,,1,3,4
069 Proveis,43,,2,3,5
069 Proveis,44,,4,1,5
069 Proveis,45,,3,4,7
069 Proveis,46,,3,2,5
069 Proveis,47,,2,1,3
069 Proveis,48,,3,3,6
069 Proveis,49,,2,-,2
069 Proveis,50,,1,1,2
069 Proveis,51,,1,-,1
069 Proveis,52,,2,1,3
069 Proveis,53,,1,2,3
069 Proveis,54,,3,-,3
069 Proveis,55,,1,1,2
069 Proveis,56,,2,-,2
069 Proveis,57,,2,1,3
069 Proveis,58,,2,1,3
069 Proveis,59,,1,1,2
069 Proveis,60,,3,-,3
069 Proveis,61,,1,3,4
069 Proveis,62,,-,2,2
069 Proveis,63,,2,1,3
069 Proveis,64,,2,1,3
069 Proveis,65,,1,1,2
069 Proveis,66,,-,1,1
069 Proveis,67,,-,2,2
069 Proveis,68,,1,1,2
069 Proveis,69,,2,1,3
069 Proveis,71,,3,3,6
069 Proveis,72,,4,1,5
069 Proveis,73,,2,2,4
069 Proveis,74,,-,1,1
069 Proveis,75,,-,2,2
069 Proveis,76,,3,-,3
069 Proveis,77,,1,-,1
069 Proveis,78,,2,2,4
069 Proveis,79,,-,6,6
069 Proveis,80,,-,1,1
069 Proveis,83,,-,1,1
069 Proveis,86,,-,2,2
069 Proveis,93,,1,-,1
070 Ratschings,0,,35,25,60
070 Ratschings,1,,26,18,44
070 Ratschings,2,,30,22,52
070 Ratschings,3,,34,38,72
070 Ratschings,4,,29,33,62
070 Ratschings,5,,28,25,53
070 Ratschings,6,,21,28,49
070 Ratschings,7,,25,22,47
070 Ratschings,8,,38,32,70
070 Ratschings,9,,25,19,44
070 Ratschings,10,,31,29,60
070 Ratschings,11,,25,17,42
070 Ratschings,12,,36,28,64
070 Ratschings,13,,28,31,59
070 Ratschings,14,,30,26,56
070 Ratschings,15,,29,34,63
070 Ratschings,16,,27,19,46
070 Ratschings,17,,31,22,53
070 Ratschings,18,,34,25,59
070 Ratschings,19,,29,31,60
070 Ratschings,20,,23,22,45
070 Ratschings,21,,33,21,54
070 Ratschings,22,,33,22,55
070 Ratschings,23,,34,20,54
070 Ratschings,24,,25,27,52
070 Ratschings,25,,32,28,60
070 Ratschings,26,,37,25,62
070 Ratschings,27,,29,32,61
070 Ratschings,28,,33,41,74
070 Ratschings,29,,37,42,79
070 Ratschings,30,,29,38,67
070 Ratschings,31,,34,40,74
070 Ratschings,32,,46,36,82
070 Ratschings,33,,41,36,77
070 Ratschings,34,,47,43,90
070 Ratschings,35,,36,49,85
070 Ratschings,36,,49,40,89
070 Ratschings,37,,48,26,74
070 Ratschings,38,,36,37,73
070 Ratschings,39,,32,26,58
070 Ratschings,40,,39,23,62
070 Ratschings,41,,38,25,63
070 Ratschings,42,,31,19,50
070 Ratschings,43,,32,17,49
070 Ratschings,44,,37,19,56
070 Ratschings,45,,15,32,47
070 Ratschings,46,,29,15,44
070 Ratschings,47,,21,25,46
070 Ratschings,48,,22,18,40
070 Ratschings,49,,15,15,30
070 Ratschings,50,,26,20,46
070 Ratschings,51,,23,24,47
070 Ratschings,52,,32,20,52
070 Ratschings,53,,19,15,34
070 Ratschings,54,,23,7,30
070 Ratschings,55,,19,20,39
070 Ratschings,56,,19,11,30
070 Ratschings,57,,16,13,29
070 Ratschings,58,,20,19,39
070 Ratschings,59,,24,21,45
070 Ratschings,60,,18,18,36
070 Ratschings,61,,20,18,38
070 Ratschings,62,,15,21,36
070 Ratschings,63,,19,10,29
070 Ratschings,64,,14,12,26
070 Ratschings,65,,18,17,35
070 Ratschings,66,,13,9,22
070 Ratschings,67,,16,19,35
070 Ratschings,68,,16,14,30
070 Ratschings,69,,11,13,24
070 Ratschings,70,,12,18,30
070 Ratschings,71,,11,21,32
070 Ratschings,72,,11,12,23
070 Ratschings,73,,16,14,30
070 Ratschings,74,,14,15,29
070 Ratschings,75,,13,9,22
070 Ratschings,76,,14,12,26
070 Ratschings,77,,10,10,20
070 Ratschings,78,,6,12,18
070 Ratschings,79,,6,13,19
070 Ratschings,80,,2,14,16
070 Ratschings,81,,3,3,6
070 Ratschings,82,,-,7,7
070 Ratschings,84,,2,2,4
070 Ratschings,85,,3,6,9
070 Ratschings,86,,1,4,5
070 Ratschings,87,,3,2,5
070 Ratschings,88,,2,3,5
070 Ratschings,89,,1,2,3
070 Ratschings,91,,-,2,2
070 Ratschings,92,,-,2,2
070 Ratschings,94,,-,2,2
071 Rasen-Antholz,0,,26,19,45
071 Rasen-Antholz,1,,15,17,32
071 Rasen-Antholz,2,,18,14,32
071 Rasen-Antholz,3,,23,21,44
071 Rasen-Antholz,4,,22,15,37
071 Rasen-Antholz,5,,10,16,26
071 Rasen-Antholz,6,,20,11,31
071 Rasen-Antholz,7,,18,14,32
071 Rasen-Antholz,8,,27,19,46
071 Rasen-Antholz,9,,15,15,30
071 Rasen-Antholz,10,,12,25,37
071 Rasen-Antholz,11,,19,17,36
071 Rasen-Antholz,12,,20,16,36
071 Rasen-Antholz,13,,27,9,36
071 Rasen-Antholz,14,,16,20,36
071 Rasen-Antholz,15,,23,14,37
071 Rasen-Antholz,16,,18,17,35
071 Rasen-Antholz,17,,14,19,33
071 Rasen-Antholz,18,,21,24,45
071 Rasen-Antholz,19,,15,15,30
071 Rasen-Antholz,20,,18,11,29
071 Rasen-Antholz,21,,16,18,34
071 Rasen-Antholz,22,,16,16,32
071 Rasen-Antholz,23,,16,21,37
071 Rasen-Antholz,24,,19,23,42
071 Rasen-Antholz,25,,22,24,46
071 Rasen-Antholz,26,,29,21,50
071 Rasen-Antholz,27,,34,23,57
071 Rasen-Antholz,28,,30,15,45
071 Rasen-Antholz,29,,29,23,52
071 Rasen-Antholz,30,,26,31,57
071 Rasen-Antholz,31,,30,25,55
071 Rasen-Antholz,32,,31,30,61
071 Rasen-Antholz,33,,27,27,54
071 Rasen-Antholz,34,,28,19,47
071 Rasen-Antholz,35,,34,25,59
071 Rasen-Antholz,36,,28,19,47
071 Rasen-Antholz,37,,24,21,45
071 Rasen-Antholz,38,,28,20,48
071 Rasen-Antholz,39,,19,25,44
071 Rasen-Antholz,40,,20,23,43
071 Rasen-Antholz,41,,27,19,46
071 Rasen-Antholz,42,,23,16,39
071 Rasen-Antholz,43,,23,12,35
071 Rasen-Antholz,44,,17,16,33
071 Rasen-Antholz,45,,19,15,34
071 Rasen-Antholz,46,,14,12,26
071 Rasen-Antholz,47,,17,11,28
071 Rasen-Antholz,48,,12,15,27
071 Rasen-Antholz,49,,12,12,24
071 Rasen-Antholz,50,,15,8,23
071 Rasen-Antholz,51,,14,9,23
071 Rasen-Antholz,52,,14,10,24
071 Rasen-Antholz,53,,9,13,22
071 Rasen-Antholz,54,,10,15,25
071 Rasen-Antholz,55,,11,10,21
071 Rasen-Antholz,56,,10,8,18
071 Rasen-Antholz,57,,13,13,26
071 Rasen-Antholz,58,,11,14,25
071 Rasen-Antholz,59,,15,13,28
071 Rasen-Antholz,60,,11,17,28
071 Rasen-Antholz,61,,17,13,30
071 Rasen-Antholz,62,,14,9,23
071 Rasen-Antholz,63,,10,12,22
071 Rasen-Antholz,64,,9,12,21
071 Rasen-Antholz,65,,10,8,18
071 Rasen-Antholz,66,,12,10,22
071 Rasen-Antholz,67,,12,15,27
071 Rasen-Antholz,68,,15,11,26
071 Rasen-Antholz,69,,14,14,28
071 Rasen-Antholz,70,,4,11,15
071 Rasen-Antholz,71,,13,4,17
071 Rasen-Antholz,72,,5,3,8
071 Rasen-Antholz,73,,13,10,23
071 Rasen-Antholz,74,,8,6,14
071 Rasen-Antholz,75,,7,13,20
071 Rasen-Antholz,76,,7,12,19
071 Rasen-Antholz,77,,4,12,16
071 Rasen-Antholz,78,,5,6,11
071 Rasen-Antholz,79,,8,6,14
071 Rasen-Antholz,80,,2,6,8
071 Rasen-Antholz,81,,5,7,12
071 Rasen-Antholz,82,,2,3,5
071 Rasen-Antholz,83,,3,4,7
071 Rasen-Antholz,84,,-,3,3
071 Rasen-Antholz,85,,3,3,6
071 Rasen-Antholz,86,,1,5,6
071 Rasen-Antholz,87,,1,3,4
071 Rasen-Antholz,88,,1,2,3
071 Rasen-Antholz,89,,-,3,3
071 Rasen-Antholz,90,,-,1,1
071 Rasen-Antholz,91,,1,2,3
071 Rasen-Antholz,92,,1,2,3
071 Rasen-Antholz,93,,-,2,2
071 Rasen-Antholz,94,,-,1,1
071 Rasen-Antholz,95,,-,1,1
072 Ritten,0,,45,40,85
072 Ritten,1,,59,56,115
072 Ritten,2,,42,48,90
072 Ritten,3,,57,54,111
072 Ritten,4,,40,53,93
072 Ritten,5,,57,47,104
072 Ritten,6,,61,49,110
072 Ritten,7,,57,52,109
072 Ritten,8,,50,72,122
072 Ritten,9,,62,50,112
072 Ritten,10,,59,46,105
072 Ritten,11,,50,43,93
072 Ritten,12,,56,54,110
072 Ritten,13,,48,41,89
072 Ritten,14,,48,42,90
072 Ritten,15,,44,47,91
072 Ritten,16,,45,25,70
072 Ritten,17,,51,41,92
072 Ritten,18,,39,47,86
072 Ritten,19,,45,49,94
072 Ritten,20,,44,37,81
072 Ritten,21,,51,41,92
072 Ritten,22,,44,33,77
072 Ritten,23,,62,38,100
072 Ritten,24,,40,43,83
072 Ritten,25,,52,43,95
072 Ritten,26,,64,60,124
072 Ritten,27,,54,51,105
072 Ritten,28,,51,53,104
072 Ritten,29,,56,68,124
072 Ritten,30,,57,67,124
072 Ritten,31,,49,65,114
072 Ritten,32,,69,63,132
072 Ritten,33,,67,53,120
072 Ritten,34,,59,52,111
072 Ritten,35,,78,48,126
072 Ritten,36,,69,58,127
072 Ritten,37,,62,53,115
072 Ritten,38,,59,64,123
072 Ritten,39,,48,60,108
072 Ritten,40,,65,63,128
072 Ritten,41,,65,50,115
072 Ritten,42,,39,44,83
072 Ritten,43,,40,39,79
072 Ritten,44,,45,43,88
072 Ritten,45,,49,40,89
072 Ritten,46,,38,32,70
072 Ritten,47,,49,32,81
072 Ritten,48,,40,44,84
072 Ritten,49,,45,35,80
072 Ritten,50,,36,40,76
072 Ritten,51,,37,42,79
072 Ritten,52,,52,33,85
072 Ritten,53,,33,29,62
072 Ritten,54,,29,39,68
072 Ritten,55,,23,25,48
072 Ritten,56,,34,40,74
072 Ritten,57,,37,39,76
072 Ritten,58,,46,37,83
072 Ritten,59,,38,39,77
072 Ritten,60,,37,24,61
072 Ritten,61,,38,31,69
072 Ritten,62,,34,34,68
072 Ritten,63,,29,26,55
072 Ritten,64,,24,23,47
072 Ritten,65,,23,32,55
072 Ritten,66,,25,26,51
072 Ritten,67,,20,26,46
072 Ritten,68,,23,24,47
072 Ritten,69,,17,33,50
072 Ritten,70,,16,22,38
072 Ritten,71,,24,21,45
072 Ritten,72,,20,12,32
072 Ritten,73,,22,18,40
072 Ritten,74,,15,22,37
072 Ritten,75,,17,37,54
072 Ritten,76,,20,30,50
072 Ritten,77,,20,24,44
072 Ritten,78,,6,29,35
072 Ritten,79,,13,22,35
072 Ritten,80,,11,22,33
072 Ritten,81,,6,15,21
072 Ritten,82,,3,6,9
072 Ritten,83,,4,11,15
072 Ritten,84,,1,4,5
072 Ritten,85,,4,8,12
072 Ritten,86,,5,11,16
072 Ritten,87,,8,12,20
072 Ritten,88,,5,7,12
072 Ritten,89,,3,7,10
072 Ritten,90,,4,6,10
072 Ritten,91,,3,1,4
072 Ritten,92,,1,4,5
072 Ritten,93,,1,4,5
072 Ritten,94,,-,1,1
072 Ritten,97,,-,3,3
072 Ritten,98,,-,1,1
073 Riffian,0,,11,12,23
073 Riffian,1,,7,13,20
073 Riffian,2,,12,11,23
073 Riffian,3,,8,7,15
073 Riffian,4,,6,7,13
073 Riffian,5,,9,10,19
073 Riffian,6,,5,8,13
073 Riffian,7,,7,8,15
073 Riffian,8,,8,9,17
073 Riffian,9,,9,12,21
073 Riffian,10,,6,7,13
073 Riffian,11,,12,5,17
073 Riffian,12,,6,12,18
073 Riffian,13,,7,9,16
073 Riffian,14,,8,6,14
073 Riffian,15,,8,2,10
073 Riffian,16,,8,7,15
073 Riffian,17,,9,7,16
073 Riffian,18,,10,10,20
073 Riffian,19,,11,7,18
073 Riffian,20,,5,4,9
073 Riffian,21,,7,9,16
073 Riffian,22,,10,4,14
073 Riffian,23,,11,8,19
073 Riffian,24,,9,2,11
073 Riffian,25,,6,11,17
073 Riffian,26,,10,3,13
073 Riffian,27,,12,10,22
073 Riffian,28,,10,17,27
073 Riffian,29,,11,16,27
073 Riffian,30,,7,10,17
073 Riffian,31,,9,13,22
073 Riffian,32,,11,14,25
073 Riffian,33,,13,13,26
073 Riffian,34,,9,8,17
073 Riffian,35,,11,7,18
073 Riffian,36,,12,8,20
073 Riffian,37,,13,10,23
073 Riffian,38,,9,9,18
073 Riffian,39,,8,9,17
073 Riffian,40,,16,4,20
073 Riffian,41,,6,14,20
073 Riffian,42,,7,6,13
073 Riffian,43,,6,13,19
073 Riffian,44,,10,4,14
073 Riffian,45,,5,11,16
073 Riffian,46,,9,6,15
073 Riffian,47,,10,4,14
073 Riffian,48,,7,3,10
073 Riffian,49,,7,10,17
073 Riffian,50,,4,3,7
073 Riffian,51,,6,6,12
073 Riffian,52,,9,6,15
073 Riffian,53,,4,4,8
073 Riffian,54,,2,6,8
073 Riffian,55,,6,3,9
073 Riffian,56,,8,8,16
073 Riffian,57,,7,7,14
073 Riffian,58,,12,7,19
073 Riffian,59,,8,3,11
073 Riffian,60,,4,3,7
073 Riffian,61,,4,9,13
073 Riffian,62,,10,4,14
073 Riffian,63,,4,6,10
073 Riffian,64,,2,4,6
073 Riffian,65,,1,2,3
073 Riffian,66,,1,3,4
073 Riffian,67,,7,5,12
073 Riffian,68,,3,3,6
073 Riffian,69,,5,9,14
073 Riffian,70,,4,3,7
073 Riffian,71,,3,7,10
073 Riffian,72,,3,3,6
073 Riffian,73,,5,5,10
073 Riffian,74,,6,2,8
073 Riffian,75,,6,3,9
073 Riffian,76,,5,5,10
073 Riffian,77,,4,6,10
073 Riffian,78,,3,2,5
073 Riffian,79,,1,3,4
073 Riffian,80,,2,3,5
073 Riffian,81,,-,1,1
073 Riffian,82,,1,-,1
073 Riffian,83,,-,3,3
073 Riffian,84,,1,-,1
073 Riffian,85,,1,-,1
073 Riffian,86,,1,5,6
073 Riffian,87,,1,2,3
073 Riffian,88,,-,1,1
073 Riffian,90,,1,-,1
073 Riffian,91,,-,1,1
073 Riffian,92,,1,2,3
073 Riffian,94,,1,-,1
074 Mühlbach,0,,16,17,33
074 Mühlbach,1,,20,13,33
074 Mühlbach,2,,14,16,30
074 Mühlbach,3,,17,16,33
074 Mühlbach,4,,15,18,33
074 Mühlbach,5,,10,15,25
074 Mühlbach,6,,19,13,32
074 Mühlbach,7,,17,17,34
074 Mühlbach,8,,15,23,38
074 Mühlbach,9,,12,19,31
074 Mühlbach,10,,13,13,26
074 Mühlbach,11,,14,21,35
074 Mühlbach,12,,20,15,35
074 Mühlbach,13,,20,12,32
074 Mühlbach,14,,16,9,25
074 Mühlbach,15,,18,17,35
074 Mühlbach,16,,16,21,37
074 Mühlbach,17,,21,17,38
074 Mühlbach,18,,25,24,49
074 Mühlbach,19,,23,18,41
074 Mühlbach,20,,17,16,33
074 Mühlbach,21,,18,13,31
074 Mühlbach,22,,25,22,47
074 Mühlbach,23,,22,14,36
074 Mühlbach,24,,18,29,47
074 Mühlbach,25,,18,22,40
074 Mühlbach,26,,17,16,33
074 Mühlbach,27,,23,16,39
074 Mühlbach,28,,22,17,39
074 Mühlbach,29,,23,23,46
074 Mühlbach,30,,27,13,40
074 Mühlbach,31,,24,31,55
074 Mühlbach,32,,37,22,59
074 Mühlbach,33,,22,18,40
074 Mühlbach,34,,28,16,44
074 Mühlbach,35,,19,23,42
074 Mühlbach,36,,15,20,35
074 Mühlbach,37,,23,18,41
074 Mühlbach,38,,22,18,40
074 Mühlbach,39,,25,22,47
074 Mühlbach,40,,21,14,35
074 Mühlbach,41,,21,17,38
074 Mühlbach,42,,19,13,32
074 Mühlbach,43,,16,19,35
074 Mühlbach,44,,20,22,42
074 Mühlbach,45,,19,17,36
074 Mühlbach,46,,13,20,33
074 Mühlbach,47,,19,17,36
074 Mühlbach,48,,15,22,37
074 Mühlbach,49,,13,22,35
074 Mühlbach,50,,18,19,37
074 Mühlbach,51,,11,14,25
074 Mühlbach,52,,17,12,29
074 Mühlbach,53,,11,17,28
074 Mühlbach,54,,24,13,37
074 Mühlbach,55,,10,8,18
074 Mühlbach,56,,15,13,28
074 Mühlbach,57,,13,11,24
074 Mühlbach,58,,17,13,30
074 Mühlbach,59,,18,15,33
074 Mühlbach,60,,14,10,24
074 Mühlbach,61,,13,16,29
074 Mühlbach,62,,16,8,24
074 Mühlbach,63,,6,12,18
074 Mühlbach,64,,7,7,14
074 Mühlbach,65,,7,11,18
074 Mühlbach,66,,13,12,25
074 Mühlbach,67,,9,10,19
074 Mühlbach,68,,8,10,18
074 Mühlbach,69,,8,12,20
074 Mühlbach,70,,13,7,20
074 Mühlbach,71,,9,3,12
074 Mühlbach,72,,13,20,33
074 Mühlbach,73,,6,10,16
074 Mühlbach,74,,9,10,19
074 Mühlbach,75,,6,7,13
074 Mühlbach,76,,6,7,13
074 Mühlbach,77,,5,12,17
074 Mühlbach,78,,5,12,17
074 Mühlbach,79,,4,7,11
074 Mühlbach,80,,6,10,16
074 Mühlbach,81,,2,10,12
074 Mühlbach,82,,1,2,3
074 Mühlbach,83,,1,4,5
074 Mühlbach,84,,-,1,1
074 Mühlbach,85,,-,2,2
074 Mühlbach,86,,3,8,11
074 Mühlbach,87,,3,4,7
074 Mühlbach,88,,-,1,1
074 Mühlbach,89,,-,1,1
074 Mühlbach,90,,1,4,5
074 Mühlbach,91,,-,1,1
074 Mühlbach,93,,-,1,1
074 Mühlbach,94,,-,4,4
074 Mühlbach,95,,1,1,2
075 Rodeneck,0,,4,15,19
075 Rodeneck,1,,7,8,15
075 Rodeneck,2,,12,7,19
075 Rodeneck,3,,11,7,18
075 Rodeneck,4,,12,11,23
075 Rodeneck,5,,6,10,16
075 Rodeneck,6,,8,10,18
075 Rodeneck,7,,7,7,14
075 Rodeneck,8,,8,10,18
075 Rodeneck,9,,6,9,15
075 Rodeneck,10,,13,8,21
075 Rodeneck,11,,7,6,13
075 Rodeneck,12,,14,10,24
075 Rodeneck,13,,6,5,11
075 Rodeneck,14,,10,12,22
075 Rodeneck,15,,12,9,21
075 Rodeneck,16,,15,10,25
075 Rodeneck,17,,11,7,18
075 Rodeneck,18,,7,6,13
075 Rodeneck,19,,10,6,16
075 Rodeneck,20,,6,10,16
075 Rodeneck,21,,8,6,14
075 Rodeneck,22,,6,8,14
075 Rodeneck,23,,8,9,17
075 Rodeneck,24,,7,7,14
075 Rodeneck,25,,9,7,16
075 Rodeneck,26,,7,7,14
075 Rodeneck,27,,14,9,23
075 Rodeneck,28,,9,11,20
075 Rodeneck,29,,13,6,19
075 Rodeneck,30,,11,11,22
075 Rodeneck,31,,16,10,26
075 Rodeneck,32,,11,13,24
075 Rodeneck,33,,13,12,25
075 Rodeneck,34,,12,8,20
075 Rodeneck,35,,7,6,13
075 Rodeneck,36,,10,10,20
075 Rodeneck,37,,8,10,18
075 Rodeneck,38,,9,12,21
075 Rodeneck,39,,9,11,20
075 Rodeneck,40,,5,10,15
075 Rodeneck,41,,11,6,17
075 Rodeneck,42,,8,5,13
075 Rodeneck,43,,6,6,12
075 Rodeneck,44,,9,4,13
075 Rodeneck,45,,6,6,12
075 Rodeneck,46,,11,3,14
075 Rodeneck,47,,4,1,5
075 Rodeneck,48,,8,5,13
075 Rodeneck,49,,3,3,6
075 Rodeneck,50,,2,7,9
075 Rodeneck,51,,4,7,11
075 Rodeneck,52,,4,7,11
075 Rodeneck,53,,6,4,10
075 Rodeneck,54,,10,6,16
075 Rodeneck,55,,-,5,5
075 Rodeneck,56,,5,5,10
075 Rodeneck,57,,3,2,5
075 Rodeneck,58,,3,6,9
075 Rodeneck,59,,9,3,12
075 Rodeneck,60,,5,4,9
075 Rodeneck,61,,3,9,12
075 Rodeneck,62,,3,3,6
075 Rodeneck,63,,2,5,7
075 Rodeneck,64,,4,5,9
075 Rodeneck,65,,5,2,7
075 Rodeneck,66,,1,12,13
075 Rodeneck,67,,3,2,5
075 Rodeneck,68,,5,5,10
075 Rodeneck,69,,6,5,11
075 Rodeneck,70,,4,3,7
075 Rodeneck,71,,7,2,9
075 Rodeneck,72,,5,5,10
075 Rodeneck,73,,5,5,10
075 Rodeneck,74,,4,6,10
075 Rodeneck,75,,3,9,12
075 Rodeneck,76,,4,5,9
075 Rodeneck,77,,2,2,4
075 Rodeneck,78,,2,3,5
075 Rodeneck,79,,3,1,4
075 Rodeneck,80,,2,2,4
075 Rodeneck,81,,4,2,6
075 Rodeneck,82,,-,3,3
075 Rodeneck,83,,-,1,1
075 Rodeneck,84,,1,1,2
075 Rodeneck,85,,1,1,2
075 Rodeneck,86,,1,1,2
075 Rodeneck,87,,1,1,2
075 Rodeneck,88,,1,-,1
075 Rodeneck,89,,-,1,1
075 Rodeneck,90,,3,-,3
075 Rodeneck,92,,-,1,1
075 Rodeneck,93,,-,1,1
075 Rodeneck,97,,1,-,1
076 Salurn,0,,14,16,30
076 Salurn,1,,20,13,33
076 Salurn,2,,18,25,43
076 Salurn,3,,18,11,29
076 Salurn,4,,19,20,39
076 Salurn,5,,18,10,28
076 Salurn,6,,20,20,40
076 Salurn,7,,16,13,29
076 Salurn,8,,22,18,40
076 Salurn,9,,11,13,24
076 Salurn,10,,8,9,17
076 Salurn,11,,18,17,35
076 Salurn,12,,15,20,35
076 Salurn,13,,19,12,31
076 Salurn,14,,12,16,28
076 Salurn,15,,18,16,34
076 Salurn,16,,13,13,26
076 Salurn,17,,11,16,27
076 Salurn,18,,17,12,29
076 Salurn,19,,15,14,29
076 Salurn,20,,19,15,34
076 Salurn,21,,9,15,24
076 Salurn,22,,13,10,23
076 Salurn,23,,21,20,41
076 Salurn,24,,15,16,31
076 Salurn,25,,14,21,35
076 Salurn,26,,13,18,31
076 Salurn,27,,16,21,37
076 Salurn,28,,22,24,46
076 Salurn,29,,31,18,49
076 Salurn,30,,26,28,54
076 Salurn,31,,24,25,49
076 Salurn,32,,29,22,51
076 Salurn,33,,22,22,44
076 Salurn,34,,26,22,48
076 Salurn,35,,25,23,48
076 Salurn,36,,35,29,64
076 Salurn,37,,36,22,58
076 Salurn,38,,35,21,56
076 Salurn,39,,30,31,61
076 Salurn,40,,24,28,52
076 Salurn,41,,25,28,53
076 Salurn,42,,28,16,44
076 Salurn,43,,17,23,40
076 Salurn,44,,19,15,34
076 Salurn,45,,18,19,37
076 Salurn,46,,26,19,45
076 Salurn,47,,16,15,31
076 Salurn,48,,27,18,45
076 Salurn,49,,28,18,46
076 Salurn,50,,24,16,40
076 Salurn,51,,26,12,38
076 Salurn,52,,16,21,37
076 Salurn,53,,18,17,35
076 Salurn,54,,21,16,37
076 Salurn,55,,15,10,25
076 Salurn,56,,20,20,40
076 Salurn,57,,18,17,35
076 Salurn,58,,18,16,34
076 Salurn,59,,17,16,33
076 Salurn,60,,14,10,24
076 Salurn,61,,10,11,21
076 Salurn,62,,7,13,20
076 Salurn,63,,11,12,23
076 Salurn,64,,12,22,34
076 Salurn,65,,19,17,36
076 Salurn,66,,12,6,18
076 Salurn,67,,11,8,19
076 Salurn,68,,10,20,30
076 Salurn,69,,7,11,18
076 Salurn,70,,10,11,21
076 Salurn,71,,22,13,35
076 Salurn,72,,11,23,34
076 Salurn,73,,6,22,28
076 Salurn,74,,7,15,22
076 Salurn,75,,6,24,30
076 Salurn,76,,9,16,25
076 Salurn,77,,6,9,15
076 Salurn,78,,12,22,34
076 Salurn,79,,5,17,22
076 Salurn,80,,11,11,22
076 Salurn,81,,7,13,20
076 Salurn,82,,5,4,9
076 Salurn,83,,1,5,6
076 Salurn,84,,3,7,10
076 Salurn,85,,5,6,11
076 Salurn,86,,4,11,15
076 Salurn,87,,3,4,7
076 Salurn,88,,3,6,9
076 Salurn,89,,-,5,5
076 Salurn,90,,1,3,4
076 Salurn,91,,-,2,2
076 Salurn,92,,2,4,6
076 Salurn,94,,-,2,2
076 Salurn,95,,-,1,1
076 Salurn,97,,-,1,1
077 Innichen,0,,17,13,30
077 Innichen,1,,14,17,31
077 Innichen,2,,21,13,34
077 Innichen,3,,19,17,36
077 Innichen,4,,15,19,34
077 Innichen,5,,21,12,33
077 Innichen,6,,17,17,34
077 Innichen,7,,22,21,43
077 Innichen,8,,25,17,42
077 Innichen,9,,19,23,42
077 Innichen,10,,17,14,31
077 Innichen,11,,17,22,39
077 Innichen,12,,28,19,47
077 Innichen,13,,21,19,40
077 Innichen,14,,21,17,38
077 Innichen,15,,20,20,40
077 Innichen,16,,20,20,40
077 Innichen,17,,22,16,38
077 Innichen,18,,18,22,40
077 Innichen,19,,14,19,33
077 Innichen,20,,23,15,38
077 Innichen,21,,24,21,45
077 Innichen,22,,9,16,25
077 Innichen,23,,15,25,40
077 Innichen,24,,20,28,48
077 Innichen,25,,21,6,27
077 Innichen,26,,28,24,52
077 Innichen,27,,23,26,49
077 Innichen,28,,27,29,56
077 Innichen,29,,23,15,38
077 Innichen,30,,26,25,51
077 Innichen,31,,26,26,52
077 Innichen,32,,32,33,65
077 Innichen,33,,21,26,47
077 Innichen,34,,29,33,62
077 Innichen,35,,33,31,64
077 Innichen,36,,34,31,65
077 Innichen,37,,30,28,58
077 Innichen,38,,32,23,55
077 Innichen,39,,24,29,53
077 Innichen,40,,36,18,54
077 Innichen,41,,28,23,51
077 Innichen,42,,21,26,47
077 Innichen,43,,22,25,47
077 Innichen,44,,28,16,44
077 Innichen,45,,24,18,42
077 Innichen,46,,23,12,35
077 Innichen,47,,23,17,40
077 Innichen,48,,13,26,39
077 Innichen,49,,12,18,30
077 Innichen,50,,18,21,39
077 Innichen,51,,21,17,38
077 Innichen,52,,17,12,29
077 Innichen,53,,12,15,27
077 Innichen,54,,15,15,30
077 Innichen,55,,12,9,21
077 Innichen,56,,8,13,21
077 Innichen,57,,23,9,32
077 Innichen,58,,18,17,35
077 Innichen,59,,14,16,30
077 Innichen,60,,11,23,34
077 Innichen,61,,14,12,26
077 Innichen,62,,8,11,19
077 Innichen,63,,12,11,23
077 Innichen,64,,9,19,28
077 Innichen,65,,9,19,28
077 Innichen,66,,11,13,24
077 Innichen,67,,12,10,22
077 Innichen,68,,19,16,35
077 Innichen,69,,14,22,36
077 Innichen,70,,16,12,28
077 Innichen,71,,13,17,30
077 Innichen,72,,12,19,31
077 Innichen,73,,6,12,18
077 Innichen,74,,18,13,31
077 Innichen,75,,8,21,29
077 Innichen,76,,9,4,13
077 Innichen,77,,7,12,19
077 Innichen,78,,4,15,19
077 Innichen,79,,9,14,23
077 Innichen,80,,7,12,19
077 Innichen,81,,3,4,7
077 Innichen,82,,1,5,6
077 Innichen,83,,1,2,3
077 Innichen,84,,2,3,5
077 Innichen,85,,4,5,9
077 Innichen,86,,3,2,5
077 Innichen,87,,4,5,9
077 Innichen,88,,1,6,7
077 Innichen,89,,-,1,1
077 Innichen,90,,1,2,3
077 Innichen,91,,1,1,2
077 Innichen,92,,-,4,4
077 Innichen,93,,1,1,2
077 Innichen,94,,1,1,2
077 Innichen,95,,-,1,1
077 Innichen,96,,-,1,1
077 Innichen,98,,-,2,2
079 Jenesien,0,,18,14,32
079 Jenesien,1,,24,24,48
079 Jenesien,2,,16,25,41
079 Jenesien,3,,18,20,38
079 Jenesien,4,,24,11,35
079 Jenesien,5,,28,14,42
079 Jenesien,6,,21,23,44
079 Jenesien,7,,16,20,36
079 Jenesien,8,,26,22,48
079 Jenesien,9,,18,21,39
079 Jenesien,10,,18,15,33
079 Jenesien,11,,18,12,30
079 Jenesien,12,,24,16,40
079 Jenesien,13,,13,21,34
079 Jenesien,14,,16,16,32
079 Jenesien,15,,14,5,19
079 Jenesien,16,,19,14,33
079 Jenesien,17,,17,20,37
079 Jenesien,18,,13,24,37
079 Jenesien,19,,6,20,26
079 Jenesien,20,,14,21,35
079 Jenesien,21,,20,18,38
079 Jenesien,22,,12,14,26
079 Jenesien,23,,17,23,40
079 Jenesien,24,,15,14,29
079 Jenesien,25,,13,14,27
079 Jenesien,26,,19,19,38
079 Jenesien,27,,19,27,46
079 Jenesien,28,,17,22,39
079 Jenesien,29,,33,16,49
079 Jenesien,30,,27,26,53
079 Jenesien,31,,27,19,46
079 Jenesien,32,,19,29,48
079 Jenesien,33,,16,21,37
079 Jenesien,34,,34,28,62
079 Jenesien,35,,33,26,59
079 Jenesien,36,,34,33,67
079 Jenesien,37,,28,21,49
079 Jenesien,38,,26,22,48
079 Jenesien,39,,31,20,51
079 Jenesien,40,,26,12,38
079 Jenesien,41,,24,15,39
079 Jenesien,42,,24,10,34
079 Jenesien,43,,15,16,31
079 Jenesien,44,,16,14,30
079 Jenesien,45,,9,11,20
079 Jenesien,46,,16,15,31
079 Jenesien,47,,14,10,24
079 Jenesien,48,,15,19,34
079 Jenesien,49,,11,9,20
079 Jenesien,50,,12,21,33
079 Jenesien,51,,11,13,24
079 Jenesien,52,,12,7,19
079 Jenesien,53,,14,12,26
079 Jenesien,54,,8,12,20
079 Jenesien,55,,8,13,21
079 Jenesien,56,,12,14,26
079 Jenesien,57,,17,10,27
079 Jenesien,58,,15,10,25
079 Jenesien,59,,15,20,35
079 Jenesien,60,,17,11,28
079 Jenesien,61,,15,18,33
079 Jenesien,62,,22,9,31
079 Jenesien,63,,11,16,27
079 Jenesien,64,,6,18,24
079 Jenesien,65,,6,7,13
079 Jenesien,66,,9,7,16
079 Jenesien,67,,17,12,29
079 Jenesien,68,,8,10,18
079 Jenesien,69,,9,9,18
079 Jenesien,70,,7,15,22
079 Jenesien,71,,9,15,24
079 Jenesien,72,,13,11,24
079 Jenesien,73,,8,11,19
079 Jenesien,74,,10,14,24
079 Jenesien,75,,4,14,18
079 Jenesien,76,,8,10,18
079 Jenesien,77,,7,8,15
079 Jenesien,78,,7,10,17
079 Jenesien,79,,2,5,7
079 Jenesien,80,,3,8,11
079 Jenesien,81,,2,5,7
079 Jenesien,82,,-,1,1
079 Jenesien,83,,1,2,3
079 Jenesien,84,,2,1,3
079 Jenesien,85,,1,4,5
079 Jenesien,86,,2,3,5
079 Jenesien,87,,-,5,5
079 Jenesien,88,,1,6,7
079 Jenesien,89,,2,5,7
079 Jenesien,90,,-,1,1
079 Jenesien,91,,2,1,3
079 Jenesien,92,,2,3,5
079 Jenesien,95,,-,1,1
080 St.Leonhard in Pass.,0,,20,20,40
080 St.Leonhard in Pass.,1,,20,22,42
080 St.Leonhard in Pass.,2,,24,15,39
080 St.Leonhard in Pass.,3,,25,20,45
080 St.Leonhard in Pass.,4,,27,19,46
080 St.Leonhard in Pass.,5,,22,11,33
080 St.Leonhard in Pass.,6,,25,21,46
080 St.Leonhard in Pass.,7,,23,22,45
080 St.Leonhard in Pass.,8,,24,19,43
080 St.Leonhard in Pass.,9,,23,20,43
080 St.Leonhard in Pass.,10,,25,21,46
080 St.Leonhard in Pass.,11,,35,31,66
080 St.Leonhard in Pass.,12,,23,29,52
080 St.Leonhard in Pass.,13,,30,25,55
080 St.Leonhard in Pass.,14,,34,34,68
080 St.Leonhard in Pass.,15,,24,27,51
080 St.Leonhard in Pass.,16,,30,25,55
080 St.Leonhard in Pass.,17,,28,26,54
080 St.Leonhard in Pass.,18,,32,22,54
080 St.Leonhard in Pass.,19,,24,30,54
080 St.Leonhard in Pass.,20,,28,35,63
080 St.Leonhard in Pass.,21,,27,25,52
080 St.Leonhard in Pass.,22,,31,21,52
080 St.Leonhard in Pass.,23,,35,26,61
080 St.Leonhard in Pass.,24,,21,30,51
080 St.Leonhard in Pass.,25,,28,13,41
080 St.Leonhard in Pass.,26,,32,35,67
080 St.Leonhard in Pass.,27,,34,34,68
080 St.Leonhard in Pass.,28,,34,26,60
080 St.Leonhard in Pass.,29,,32,22,54
080 St.Leonhard in Pass.,30,,27,25,52
080 St.Leonhard in Pass.,31,,28,25,53
080 St.Leonhard in Pass.,32,,34,26,60
080 St.Leonhard in Pass.,33,,30,27,57
080 St.Leonhard in Pass.,34,,33,39,72
080 St.Leonhard in Pass.,35,,32,29,61
080 St.Leonhard in Pass.,36,,26,32,58
080 St.Leonhard in Pass.,37,,24,29,53
080 St.Leonhard in Pass.,38,,23,30,53
080 St.Leonhard in Pass.,39,,28,23,51
080 St.Leonhard in Pass.,40,,29,19,48
080 St.Leonhard in Pass.,41,,25,28,53
080 St.Leonhard in Pass.,42,,24,23,47
080 St.Leonhard in Pass.,43,,24,26,50
080 St.Leonhard in Pass.,44,,24,17,41
080 St.Leonhard in Pass.,45,,25,19,44
080 St.Leonhard in Pass.,46,,21,16,37
080 St.Leonhard in Pass.,47,,30,25,55
080 St.Leonhard in Pass.,48,,21,27,48
080 St.Leonhard in Pass.,49,,26,16,42
080 St.Leonhard in Pass.,50,,19,15,34
080 St.Leonhard in Pass.,51,,25,12,37
080 St.Leonhard in Pass.,52,,22,13,35
080 St.Leonhard in Pass.,53,,18,16,34
080 St.Leonhard in Pass.,54,,16,19,35
080 St.Leonhard in Pass.,55,,11,11,22
080 St.Leonhard in Pass.,56,,16,13,29
080 St.Leonhard in Pass.,57,,10,26,36
080 St.Leonhard in Pass.,58,,8,16,24
080 St.Leonhard in Pass.,59,,15,16,31
080 St.Leonhard in Pass.,60,,24,14,38
080 St.Leonhard in Pass.,61,,20,19,39
080 St.Leonhard in Pass.,62,,12,12,24
080 St.Leonhard in Pass.,63,,19,9,28
080 St.Leonhard in Pass.,64,,19,11,30
080 St.Leonhard in Pass.,65,,13,15,28
080 St.Leonhard in Pass.,66,,11,15,26
080 St.Leonhard in Pass.,67,,13,16,29
080 St.Leonhard in Pass.,68,,12,13,25
080 St.Leonhard in Pass.,69,,7,15,22
080 St.Leonhard in Pass.,70,,8,11,19
080 St.Leonhard in Pass.,71,,10,11,21
080 St.Leonhard in Pass.,72,,7,14,21
080 St.Leonhard in Pass.,73,,6,16,22
080 St.Leonhard in Pass.,74,,7,13,20
080 St.Leonhard in Pass.,75,,8,12,20
080 St.Leonhard in Pass.,76,,5,12,17
080 St.Leonhard in Pass.,77,,7,16,23
080 St.Leonhard in Pass.,78,,6,11,17
080 St.Leonhard in Pass.,79,,4,8,12
080 St.Leonhard in Pass.,80,,5,10,15
080 St.Leonhard in Pass.,81,,5,2,7
080 St.Leonhard in Pass.,82,,1,4,5
080 St.Leonhard in Pass.,83,,-,7,7
080 St.Leonhard in Pass.,84,,1,-,1
080 St.Leonhard in Pass.,85,,2,4,6
080 St.Leonhard in Pass.,86,,1,9,10
080 St.Leonhard in Pass.,87,,1,5,6
080 St.Leonhard in Pass.,88,,1,8,9
080 St.Leonhard in Pass.,89,,1,4,5
080 St.Leonhard in Pass.,90,,-,1,1
080 St.Leonhard in Pass.,91,,1,2,3
080 St.Leonhard in Pass.,92,,2,1,3
080 St.Leonhard in Pass.,93,,1,4,5
080 St.Leonhard in Pass.,94,,1,1,2
080 St.Leonhard in Pass.,95,,-,2,2
080 St.Leonhard in Pass.,96,,-,1,1
081 St.Lorenzen,0,,21,21,42
081 St.Lorenzen,1,,29,32,61
081 St.Lorenzen,2,,28,26,54
081 St.Lorenzen,3,,14,28,42
081 St.Lorenzen,4,,28,26,54
081 St.Lorenzen,5,,25,12,37
081 St.Lorenzen,6,,30,19,49
081 St.Lorenzen,7,,22,29,51
081 St.Lorenzen,8,,25,20,45
081 St.Lorenzen,9,,20,15,35
081 St.Lorenzen,10,,24,21,45
081 St.Lorenzen,11,,19,18,37
081 St.Lorenzen,12,,19,25,44
081 St.Lorenzen,13,,19,23,42
081 St.Lorenzen,14,,24,20,44
081 St.Lorenzen,15,,25,22,47
081 St.Lorenzen,16,,26,26,52
081 St.Lorenzen,17,,22,20,42
081 St.Lorenzen,18,,30,19,49
081 St.Lorenzen,19,,21,20,41
081 St.Lorenzen,20,,15,18,33
081 St.Lorenzen,21,,24,27,51
081 St.Lorenzen,22,,22,23,45
081 St.Lorenzen,23,,27,21,48
081 St.Lorenzen,24,,25,22,47
081 St.Lorenzen,25,,22,24,46
081 St.Lorenzen,26,,21,31,52
081 St.Lorenzen,27,,34,24,58
081 St.Lorenzen,28,,33,29,62
081 St.Lorenzen,29,,35,21,56
081 St.Lorenzen,30,,22,27,49
081 St.Lorenzen,31,,31,29,60
081 St.Lorenzen,32,,41,32,73
081 St.Lorenzen,33,,33,34,67
081 St.Lorenzen,34,,35,33,68
081 St.Lorenzen,35,,41,23,64
081 St.Lorenzen,36,,26,25,51
081 St.Lorenzen,37,,34,31,65
081 St.Lorenzen,38,,23,33,56
081 St.Lorenzen,39,,22,39,61
081 St.Lorenzen,40,,30,20,50
081 St.Lorenzen,41,,31,28,59
081 St.Lorenzen,42,,29,32,61
081 St.Lorenzen,43,,26,26,52
081 St.Lorenzen,44,,27,27,54
081 St.Lorenzen,45,,16,18,34
081 St.Lorenzen,46,,19,20,39
081 St.Lorenzen,47,,23,17,40
081 St.Lorenzen,48,,20,13,33
081 St.Lorenzen,49,,17,16,33
081 St.Lorenzen,50,,16,18,34
081 St.Lorenzen,51,,13,21,34
081 St.Lorenzen,52,,15,13,28
081 St.Lorenzen,53,,21,9,30
081 St.Lorenzen,54,,20,9,29
081 St.Lorenzen,55,,13,19,32
081 St.Lorenzen,56,,16,17,33
081 St.Lorenzen,57,,14,15,29
081 St.Lorenzen,58,,18,25,43
081 St.Lorenzen,59,,21,18,39
081 St.Lorenzen,60,,14,13,27
081 St.Lorenzen,61,,15,20,35
081 St.Lorenzen,62,,15,15,30
081 St.Lorenzen,63,,17,16,33
081 St.Lorenzen,64,,13,16,29
081 St.Lorenzen,65,,10,17,27
081 St.Lorenzen,66,,16,14,30
081 St.Lorenzen,67,,12,12,24
081 St.Lorenzen,68,,13,12,25
081 St.Lorenzen,69,,10,15,25
081 St.Lorenzen,70,,9,9,18
081 St.Lorenzen,71,,11,20,31
081 St.Lorenzen,72,,13,17,30
081 St.Lorenzen,73,,10,7,17
081 St.Lorenzen,74,,11,12,23
081 St.Lorenzen,75,,10,19,29
081 St.Lorenzen,76,,3,12,15
081 St.Lorenzen,77,,9,12,21
081 St.Lorenzen,78,,6,8,14
081 St.Lorenzen,79,,6,5,11
081 St.Lorenzen,80,,2,7,9
081 St.Lorenzen,81,,4,7,11
081 St.Lorenzen,82,,2,8,10
081 St.Lorenzen,83,,-,4,4
081 St.Lorenzen,84,,1,3,4
081 St.Lorenzen,85,,1,3,4
081 St.Lorenzen,86,,5,3,8
081 St.Lorenzen,87,,2,2,4
081 St.Lorenzen,88,,1,2,3
081 St.Lorenzen,89,,1,3,4
081 St.Lorenzen,90,,1,1,2
081 St.Lorenzen,91,,2,-,2
081 St.Lorenzen,92,,-,1,1
081 St.Lorenzen,93,,1,2,3
081 St.Lorenzen,95,,-,1,1
081 St.Lorenzen,97,,-,1,1
082 St.Martin in Thurn,0,,11,9,20
082 St.Martin in Thurn,1,,9,20,29
082 St.Martin in Thurn,2,,11,12,23
082 St.Martin in Thurn,3,,17,12,29
082 St.Martin in Thurn,4,,23,15,38
082 St.Martin in Thurn,5,,15,12,27
082 St.Martin in Thurn,6,,15,8,23
082 St.Martin in Thurn,7,,9,9,18
082 St.Martin in Thurn,8,,16,14,30
082 St.Martin in Thurn,9,,11,11,22
082 St.Martin in Thurn,10,,6,15,21
082 St.Martin in Thurn,11,,16,15,31
082 St.Martin in Thurn,12,,8,6,14
082 St.Martin in Thurn,13,,14,12,26
082 St.Martin in Thurn,14,,13,10,23
082 St.Martin in Thurn,15,,12,13,25
082 St.Martin in Thurn,16,,8,6,14
082 St.Martin in Thurn,17,,14,9,23
082 St.Martin in Thurn,18,,14,12,26
082 St.Martin in Thurn,19,,16,8,24
082 St.Martin in Thurn,20,,9,13,22
082 St.Martin in Thurn,21,,9,11,20
082 St.Martin in Thurn,22,,17,8,25
082 St.Martin in Thurn,23,,14,12,26
082 St.Martin in Thurn,24,,12,9,21
082 St.Martin in Thurn,25,,7,14,21
082 St.Martin in Thurn,26,,6,12,18
082 St.Martin in Thurn,27,,13,11,24
082 St.Martin in Thurn,28,,12,9,21
082 St.Martin in Thurn,29,,16,15,31
082 St.Martin in Thurn,30,,14,15,29
082 St.Martin in Thurn,31,,15,15,30
082 St.Martin in Thurn,32,,13,18,31
082 St.Martin in Thurn,33,,12,10,22
082 St.Martin in Thurn,34,,15,24,39
082 St.Martin in Thurn,35,,14,22,36
082 St.Martin in Thurn,36,,13,15,28
082 St.Martin in Thurn,37,,15,13,28
082 St.Martin in Thurn,38,,16,14,30
082 St.Martin in Thurn,39,,14,20,34
082 St.Martin in Thurn,40,,15,7,22
082 St.Martin in Thurn,41,,12,12,24
082 St.Martin in Thurn,42,,13,8,21
082 St.Martin in Thurn,43,,12,9,21
082 St.Martin in Thurn,44,,7,7,14
082 St.Martin in Thurn,45,,13,9,22
082 St.Martin in Thurn,46,,8,8,16
082 St.Martin in Thurn,47,,6,12,18
082 St.Martin in Thurn,48,,3,3,6
082 St.Martin in Thurn,49,,7,8,15
082 St.Martin in Thurn,50,,11,6,17
082 St.Martin in Thurn,51,,4,7,11
082 St.Martin in Thurn,52,,10,7,17
082 St.Martin in Thurn,53,,9,6,15
082 St.Martin in Thurn,54,,9,8,17
082 St.Martin in Thurn,55,,7,4,11
082 St.Martin in Thurn,56,,11,8,19
082 St.Martin in Thurn,57,,4,8,12
082 St.Martin in Thurn,58,,7,5,12
082 St.Martin in Thurn,59,,7,7,14
082 St.Martin in Thurn,60,,5,5,10
082 St.Martin in Thurn,61,,5,8,13
082 St.Martin in Thurn,62,,9,7,16
082 St.Martin in Thurn,63,,7,13,20
082 St.Martin in Thurn,64,,4,5,9
082 St.Martin in Thurn,65,,7,5,12
082 St.Martin in Thurn,66,,8,4,12
082 St.Martin in Thurn,67,,2,11,13
082 St.Martin in Thurn,68,,7,7,14
082 St.Martin in Thurn,69,,10,7,17
082 St.Martin in Thurn,70,,7,7,14
082 St.Martin in Thurn,71,,6,8,14
082 St.Martin in Thurn,72,,3,7,10
082 St.Martin in Thurn,73,,5,5,10
082 St.Martin in Thurn,74,,9,6,15
082 St.Martin in Thurn,75,,8,3,11
082 St.Martin in Thurn,76,,8,8,16
082 St.Martin in Thurn,77,,3,8,11
082 St.Martin in Thurn,78,,7,5,12
082 St.Martin in Thurn,79,,7,4,11
082 St.Martin in Thurn,80,,7,7,14
082 St.Martin in Thurn,81,,2,4,6
082 St.Martin in Thurn,82,,2,-,2
082 St.Martin in Thurn,83,,3,1,4
082 St.Martin in Thurn,84,,1,1,2
082 St.Martin in Thurn,85,,1,1,2
082 St.Martin in Thurn,86,,-,3,3
082 St.Martin in Thurn,87,,1,1,2
082 St.Martin in Thurn,88,,1,1,2
082 St.Martin in Thurn,89,,1,1,2
082 St.Martin in Thurn,90,,3,1,4
082 St.Martin in Thurn,91,,1,2,3
082 St.Martin in Thurn,92,,2,-,2
082 St.Martin in Thurn,96,,2,1,3
083 St.Martin in Passeier,0,,15,18,33
083 St.Martin in Passeier,1,,8,20,28
083 St.Martin in Passeier,2,,16,21,37
083 St.Martin in Passeier,3,,25,25,50
083 St.Martin in Passeier,4,,21,22,43
083 St.Martin in Passeier,5,,19,19,38
083 St.Martin in Passeier,6,,20,23,43
083 St.Martin in Passeier,7,,20,23,43
083 St.Martin in Passeier,8,,22,17,39
083 St.Martin in Passeier,9,,22,23,45
083 St.Martin in Passeier,10,,20,26,46
083 St.Martin in Passeier,11,,19,21,40
083 St.Martin in Passeier,12,,15,15,30
083 St.Martin in Passeier,13,,18,22,40
083 St.Martin in Passeier,14,,21,24,45
083 St.Martin in Passeier,15,,16,20,36
083 St.Martin in Passeier,16,,16,24,40
083 St.Martin in Passeier,17,,19,9,28
083 St.Martin in Passeier,18,,20,19,39
083 St.Martin in Passeier,19,,23,21,44
083 St.Martin in Passeier,20,,19,22,41
083 St.Martin in Passeier,21,,21,11,32
083 St.Martin in Passeier,22,,30,17,47
083 St.Martin in Passeier,23,,21,18,39
083 St.Martin in Passeier,24,,19,20,39
083 St.Martin in Passeier,25,,24,21,45
083 St.Martin in Passeier,26,,20,23,43
083 St.Martin in Passeier,27,,21,29,50
083 St.Martin in Passeier,28,,27,24,51
083 St.Martin in Passeier,29,,28,26,54
083 St.Martin in Passeier,30,,29,29,58
083 St.Martin in Passeier,31,,29,31,60
083 St.Martin in Passeier,32,,24,21,45
083 St.Martin in Passeier,33,,23,24,47
083 St.Martin in Passeier,34,,28,29,57
083 St.Martin in Passeier,35,,32,26,58
083 St.Martin in Passeier,36,,21,21,42
083 St.Martin in Passeier,37,,36,20,56
083 St.Martin in Passeier,38,,22,29,51
083 St.Martin in Passeier,39,,36,19,55
083 St.Martin in Passeier,40,,21,24,45
083 St.Martin in Passeier,41,,25,21,46
083 St.Martin in Passeier,42,,25,21,46
083 St.Martin in Passeier,43,,25,11,36
083 St.Martin in Passeier,44,,21,15,36
083 St.Martin in Passeier,45,,31,16,47
083 St.Martin in Passeier,46,,15,9,24
083 St.Martin in Passeier,47,,23,18,41
083 St.Martin in Passeier,48,,5,19,24
083 St.Martin in Passeier,49,,20,14,34
083 St.Martin in Passeier,50,,12,16,28
083 St.Martin in Passeier,51,,11,8,19
083 St.Martin in Passeier,52,,11,10,21
083 St.Martin in Passeier,53,,15,13,28
083 St.Martin in Passeier,54,,14,11,25
083 St.Martin in Passeier,55,,12,13,25
083 St.Martin in Passeier,56,,18,13,31
083 St.Martin in Passeier,57,,15,11,26
083 St.Martin in Passeier,58,,15,14,29
083 St.Martin in Passeier,59,,10,14,24
083 St.Martin in Passeier,60,,4,13,17
083 St.Martin in Passeier,61,,6,13,19
083 St.Martin in Passeier,62,,14,8,22
083 St.Martin in Passeier,63,,13,19,32
083 St.Martin in Passeier,64,,14,15,29
083 St.Martin in Passeier,65,,7,13,20
083 St.Martin in Passeier,66,,20,9,29
083 St.Martin in Passeier,67,,14,9,23
083 St.Martin in Passeier,68,,11,11,22
083 St.Martin in Passeier,69,,7,12,19
083 St.Martin in Passeier,70,,8,14,22
083 St.Martin in Passeier,71,,12,9,21
083 St.Martin in Passeier,72,,8,8,16
083 St.Martin in Passeier,73,,14,6,20
083 St.Martin in Passeier,74,,4,12,16
083 St.Martin in Passeier,75,,6,8,14
083 St.Martin in Passeier,76,,6,13,19
083 St.Martin in Passeier,77,,2,9,11
083 St.Martin in Passeier,78,,7,7,14
083 St.Martin in Passeier,79,,6,11,17
083 St.Martin in Passeier,80,,2,4,6
083 St.Martin in Passeier,81,,2,4,6
083 St.Martin in Passeier,82,,1,2,3
083 St.Martin in Passeier,83,,2,5,7
083 St.Martin in Passeier,84,,-,1,1
083 St.Martin in Passeier,85,,3,1,4
083 St.Martin in Passeier,86,,1,3,4
083 St.Martin in Passeier,87,,2,1,3
083 St.Martin in Passeier,88,,1,4,5
083 St.Martin in Passeier,89,,1,1,2
083 St.Martin in Passeier,90,,1,2,3
083 St.Martin in Passeier,92,,1,-,1
083 St.Martin in Passeier,94,,-,1,1
084 St.Pankraz,0,,12,14,26
084 St.Pankraz,1,,7,5,12
084 St.Pankraz,2,,12,7,19
084 St.Pankraz,3,,10,11,21
084 St.Pankraz,4,,12,10,22
084 St.Pankraz,5,,10,5,15
084 St.Pankraz,6,,9,8,17
084 St.Pankraz,7,,6,11,17
084 St.Pankraz,8,,7,6,13
084 St.Pankraz,9,,13,12,25
084 St.Pankraz,10,,9,4,13
084 St.Pankraz,11,,11,14,25
084 St.Pankraz,12,,14,7,21
084 St.Pankraz,13,,10,8,18
084 St.Pankraz,14,,9,6,15
084 St.Pankraz,15,,9,8,17
084 St.Pankraz,16,,9,5,14
084 St.Pankraz,17,,10,6,16
084 St.Pankraz,18,,11,9,20
084 St.Pankraz,19,,9,13,22
084 St.Pankraz,20,,12,9,21
084 St.Pankraz,21,,6,7,13
084 St.Pankraz,22,,15,10,25
084 St.Pankraz,23,,8,14,22
084 St.Pankraz,24,,6,8,14
084 St.Pankraz,25,,10,9,19
084 St.Pankraz,26,,15,13,28
084 St.Pankraz,27,,13,9,22
084 St.Pankraz,28,,12,12,24
084 St.Pankraz,29,,18,9,27
084 St.Pankraz,30,,13,10,23
084 St.Pankraz,31,,19,14,33
084 St.Pankraz,32,,22,16,38
084 St.Pankraz,33,,13,15,28
084 St.Pankraz,34,,16,7,23
084 St.Pankraz,35,,23,15,38
084 St.Pankraz,36,,13,14,27
084 St.Pankraz,37,,11,10,21
084 St.Pankraz,38,,17,8,25
084 St.Pankraz,39,,14,12,26
084 St.Pankraz,40,,12,6,18
084 St.Pankraz,41,,18,12,30
084 St.Pankraz,42,,7,9,16
084 St.Pankraz,43,,12,9,21
084 St.Pankraz,44,,10,15,25
084 St.Pankraz,45,,7,5,12
084 St.Pankraz,46,,10,8,18
084 St.Pankraz,47,,10,9,19
084 St.Pankraz,48,,16,10,26
084 St.Pankraz,49,,5,3,8
084 St.Pankraz,50,,12,7,19
084 St.Pankraz,51,,7,6,13
084 St.Pankraz,52,,7,4,11
084 St.Pankraz,53,,7,8,15
084 St.Pankraz,54,,4,8,12
084 St.Pankraz,55,,3,6,9
084 St.Pankraz,56,,5,8,13
084 St.Pankraz,57,,10,15,25
084 St.Pankraz,58,,9,14,23
084 St.Pankraz,59,,8,11,19
084 St.Pankraz,60,,9,7,16
084 St.Pankraz,61,,10,7,17
084 St.Pankraz,62,,5,11,16
084 St.Pankraz,63,,8,10,18
084 St.Pankraz,64,,7,5,12
084 St.Pankraz,65,,5,7,12
084 St.Pankraz,66,,8,7,15
084 St.Pankraz,67,,8,3,11
084 St.Pankraz,68,,7,10,17
084 St.Pankraz,69,,9,5,14
084 St.Pankraz,70,,8,7,15
084 St.Pankraz,71,,11,10,21
084 St.Pankraz,72,,8,10,18
084 St.Pankraz,73,,7,4,11
084 St.Pankraz,74,,8,7,15
084 St.Pankraz,75,,7,8,15
084 St.Pankraz,76,,7,9,16
084 St.Pankraz,77,,11,4,15
084 St.Pankraz,78,,10,8,18
084 St.Pankraz,79,,2,12,14
084 St.Pankraz,80,,2,10,12
084 St.Pankraz,81,,2,3,5
084 St.Pankraz,82,,3,5,8
084 St.Pankraz,83,,-,4,4
084 St.Pankraz,84,,3,-,3
084 St.Pankraz,85,,3,2,5
084 St.Pankraz,86,,1,3,4
084 St.Pankraz,87,,1,1,2
084 St.Pankraz,88,,1,2,3
084 St.Pankraz,89,,1,1,2
084 St.Pankraz,90,,1,2,3
084 St.Pankraz,91,,-,4,4
084 St.Pankraz,92,,-,1,1
084 St.Pankraz,95,,-,1,1
084 St.Pankraz,96,,1,1,2
084 St.Pankraz,102,,-,1,1
085 St.Christina in Gröden,0,,19,14,33
085 St.Christina in Gröden,1,,24,11,35
085 St.Christina in Gröden,2,,14,17,31
085 St.Christina in Gröden,3,,10,11,21
085 St.Christina in Gröden,4,,14,9,23
085 St.Christina in Gröden,5,,14,9,23
085 St.Christina in Gröden,6,,8,14,22
085 St.Christina in Gröden,7,,13,14,27
085 St.Christina in Gröden,8,,12,14,26
085 St.Christina in Gröden,9,,12,16,28
085 St.Christina in Gröden,10,,7,13,20
085 St.Christina in Gröden,11,,5,6,11
085 St.Christina in Gröden,12,,11,10,21
085 St.Christina in Gröden,13,,12,6,18
085 St.Christina in Gröden,14,,11,8,19
085 St.Christina in Gröden,15,,5,11,16
085 St.Christina in Gröden,16,,10,5,15
085 St.Christina in Gröden,17,,18,13,31
085 St.Christina in Gröden,18,,12,5,17
085 St.Christina in Gröden,19,,8,13,21
085 St.Christina in Gröden,20,,10,12,22
085 St.Christina in Gröden,21,,12,10,22
085 St.Christina in Gröden,22,,5,10,15
085 St.Christina in Gröden,23,,3,8,11
085 St.Christina in Gröden,24,,13,8,21
085 St.Christina in Gröden,25,,12,13,25
085 St.Christina in Gröden,26,,6,16,22
085 St.Christina in Gröden,27,,7,12,19
085 St.Christina in Gröden,28,,19,12,31
085 St.Christina in Gröden,29,,9,15,24
085 St.Christina in Gröden,30,,24,18,42
085 St.Christina in Gröden,31,,17,12,29
085 St.Christina in Gröden,32,,23,23,46
085 St.Christina in Gröden,33,,17,18,35
085 St.Christina in Gröden,34,,18,14,32
085 St.Christina in Gröden,35,,13,17,30
085 St.Christina in Gröden,36,,10,20,30
085 St.Christina in Gröden,37,,15,16,31
085 St.Christina in Gröden,38,,21,17,38
085 St.Christina in Gröden,39,,20,15,35
085 St.Christina in Gröden,40,,19,18,37
085 St.Christina in Gröden,41,,9,10,19
085 St.Christina in Gröden,42,,7,12,19
085 St.Christina in Gröden,43,,17,11,28
085 St.Christina in Gröden,44,,10,10,20
085 St.Christina in Gröden,45,,9,9,18
085 St.Christina in Gröden,46,,16,13,29
085 St.Christina in Gröden,47,,9,9,18
085 St.Christina in Gröden,48,,6,6,12
085 St.Christina in Gröden,49,,11,5,16
085 St.Christina in Gröden,50,,6,6,12
085 St.Christina in Gröden,51,,7,12,19
085 St.Christina in Gröden,52,,8,6,14
085 St.Christina in Gröden,53,,6,9,15
085 St.Christina in Gröden,54,,9,11,20
085 St.Christina in Gröden,55,,6,6,12
085 St.Christina in Gröden,56,,6,11,17
085 St.Christina in Gröden,57,,12,15,27
085 St.Christina in Gröden,58,,10,7,17
085 St.Christina in Gröden,59,,13,7,20
085 St.Christina in Gröden,60,,9,11,20
085 St.Christina in Gröden,61,,10,11,21
085 St.Christina in Gröden,62,,7,8,15
085 St.Christina in Gröden,63,,9,7,16
085 St.Christina in Gröden,64,,14,11,25
085 St.Christina in Gröden,65,,13,6,19
085 St.Christina in Gröden,66,,8,12,20
085 St.Christina in Gröden,67,,6,13,19
085 St.Christina in Gröden,68,,10,10,20
085 St.Christina in Gröden,69,,5,7,12
085 St.Christina in Gröden,70,,14,5,19
085 St.Christina in Gröden,71,,4,10,14
085 St.Christina in Gröden,72,,6,5,11
085 St.Christina in Gröden,73,,5,6,11
085 St.Christina in Gröden,74,,9,7,16
085 St.Christina in Gröden,75,,7,9,16
085 St.Christina in Gröden,76,,2,4,6
085 St.Christina in Gröden,77,,6,4,10
085 St.Christina in Gröden,78,,-,10,10
085 St.Christina in Gröden,79,,4,4,8
085 St.Christina in Gröden,80,,4,5,9
085 St.Christina in Gröden,81,,4,1,5
085 St.Christina in Gröden,82,,-,1,1
085 St.Christina in Gröden,83,,1,-,1
085 St.Christina in Gröden,84,,-,3,3
085 St.Christina in Gröden,85,,2,1,3
085 St.Christina in Gröden,86,,1,4,5
085 St.Christina in Gröden,87,,2,-,2
085 St.Christina in Gröden,88,,-,2,2
085 St.Christina in Gröden,89,,-,1,1
085 St.Christina in Gröden,90,,-,1,1
085 St.Christina in Gröden,91,,1,2,3
085 St.Christina in Gröden,93,,1,2,3
085 St.Christina in Gröden,96,,-,1,1
086 Sarntal,0,,36,44,80
086 Sarntal,1,,38,35,73
086 Sarntal,2,,54,46,100
086 Sarntal,3,,44,48,92
086 Sarntal,4,,49,42,91
086 Sarntal,5,,43,41,84
086 Sarntal,6,,34,41,75
086 Sarntal,7,,33,39,72
086 Sarntal,8,,47,36,83
086 Sarntal,9,,43,42,85
086 Sarntal,10,,45,33,78
086 Sarntal,11,,56,36,92
086 Sarntal,12,,45,43,88
086 Sarntal,13,,36,32,68
086 Sarntal,14,,39,43,82
086 Sarntal,15,,43,37,80
086 Sarntal,16,,39,42,81
086 Sarntal,17,,51,42,93
086 Sarntal,18,,62,51,113
086 Sarntal,19,,42,59,101
086 Sarntal,20,,59,47,106
086 Sarntal,21,,55,50,105
086 Sarntal,22,,56,53,109
086 Sarntal,23,,61,45,106
086 Sarntal,24,,52,44,96
086 Sarntal,25,,63,52,115
086 Sarntal,26,,52,65,117
086 Sarntal,27,,62,65,127
086 Sarntal,28,,71,40,111
086 Sarntal,29,,49,50,99
086 Sarntal,30,,62,63,125
086 Sarntal,31,,70,59,129
086 Sarntal,32,,53,46,99
086 Sarntal,33,,58,46,104
086 Sarntal,34,,53,54,107
086 Sarntal,35,,67,52,119
086 Sarntal,36,,65,60,125
086 Sarntal,37,,47,46,93
086 Sarntal,38,,62,33,95
086 Sarntal,39,,39,49,88
086 Sarntal,40,,64,45,109
086 Sarntal,41,,45,39,84
086 Sarntal,42,,54,43,97
086 Sarntal,43,,39,44,83
086 Sarntal,44,,43,31,74
086 Sarntal,45,,41,39,80
086 Sarntal,46,,37,28,65
086 Sarntal,47,,43,31,74
086 Sarntal,48,,39,41,80
086 Sarntal,49,,46,34,80
086 Sarntal,50,,38,36,74
086 Sarntal,51,,51,25,76
086 Sarntal,52,,34,38,72
086 Sarntal,53,,41,28,69
086 Sarntal,54,,37,38,75
086 Sarntal,55,,29,31,60
086 Sarntal,56,,27,31,58
086 Sarntal,57,,41,42,83
086 Sarntal,58,,42,39,81
086 Sarntal,59,,35,34,69
086 Sarntal,60,,31,44,75
086 Sarntal,61,,40,32,72
086 Sarntal,62,,34,28,62
086 Sarntal,63,,26,34,60
086 Sarntal,64,,22,24,46
086 Sarntal,65,,26,25,51
086 Sarntal,66,,27,20,47
086 Sarntal,67,,23,24,47
086 Sarntal,68,,30,27,57
086 Sarntal,69,,20,25,45
086 Sarntal,70,,20,24,44
086 Sarntal,71,,20,29,49
086 Sarntal,72,,24,29,53
086 Sarntal,73,,19,33,52
086 Sarntal,74,,21,15,36
086 Sarntal,75,,22,23,45
086 Sarntal,76,,16,27,43
086 Sarntal,77,,11,24,35
086 Sarntal,78,,16,32,48
086 Sarntal,79,,8,16,24
086 Sarntal,80,,12,17,29
086 Sarntal,81,,4,21,25
086 Sarntal,82,,4,12,16
086 Sarntal,83,,3,10,13
086 Sarntal,84,,1,9,10
086 Sarntal,85,,2,7,9
086 Sarntal,86,,7,8,15
086 Sarntal,87,,9,11,20
086 Sarntal,88,,5,11,16
086 Sarntal,89,,5,7,12
086 Sarntal,90,,2,11,13
086 Sarntal,91,,1,5,6
086 Sarntal,92,,1,4,5
086 Sarntal,93,,2,6,8
086 Sarntal,94,,2,1,3
086 Sarntal,95,,-,1,1
086 Sarntal,96,,-,1,1
086 Sarntal,99,,-,1,1
087 Schenna,0,,23,19,42
087 Schenna,1,,21,17,38
087 Schenna,2,,18,11,29
087 Schenna,3,,13,18,31
087 Schenna,4,,18,16,34
087 Schenna,5,,17,17,34
087 Schenna,6,,21,17,38
087 Schenna,7,,15,9,24
087 Schenna,8,,16,16,32
087 Schenna,9,,12,19,31
087 Schenna,10,,19,15,34
087 Schenna,11,,20,10,30
087 Schenna,12,,21,19,40
087 Schenna,13,,22,17,39
087 Schenna,14,,18,13,31
087 Schenna,15,,15,17,32
087 Schenna,16,,16,13,29
087 Schenna,17,,16,14,30
087 Schenna,18,,11,16,27
087 Schenna,19,,23,8,31
087 Schenna,20,,19,19,38
087 Schenna,21,,24,21,45
087 Schenna,22,,15,20,35
087 Schenna,23,,18,17,35
087 Schenna,24,,23,15,38
087 Schenna,25,,19,25,44
087 Schenna,26,,31,23,54
087 Schenna,27,,28,22,50
087 Schenna,28,,27,17,44
087 Schenna,29,,31,23,54
087 Schenna,30,,22,27,49
087 Schenna,31,,25,20,45
087 Schenna,32,,21,22,43
087 Schenna,33,,35,21,56
087 Schenna,34,,13,21,34
087 Schenna,35,,24,29,53
087 Schenna,36,,22,23,45
087 Schenna,37,,28,21,49
087 Schenna,38,,23,13,36
087 Schenna,39,,29,19,48
087 Schenna,40,,33,24,57
087 Schenna,41,,15,13,28
087 Schenna,42,,20,18,38
087 Schenna,43,,11,19,30
087 Schenna,44,,17,16,33
087 Schenna,45,,12,15,27
087 Schenna,46,,15,18,33
087 Schenna,47,,15,15,30
087 Schenna,48,,14,16,30
087 Schenna,49,,14,13,27
087 Schenna,50,,20,15,35
087 Schenna,51,,20,20,40
087 Schenna,52,,15,15,30
087 Schenna,53,,15,17,32
087 Schenna,54,,18,23,41
087 Schenna,55,,14,13,27
087 Schenna,56,,17,10,27
087 Schenna,57,,20,11,31
087 Schenna,58,,12,19,31
087 Schenna,59,,12,13,25
087 Schenna,60,,10,8,18
087 Schenna,61,,12,14,26
087 Schenna,62,,16,19,35
087 Schenna,63,,7,10,17
087 Schenna,64,,8,11,19
087 Schenna,65,,14,8,22
087 Schenna,66,,13,15,28
087 Schenna,67,,7,9,16
087 Schenna,68,,11,13,24
087 Schenna,69,,13,13,26
087 Schenna,70,,12,9,21
087 Schenna,71,,8,12,20
087 Schenna,72,,7,10,17
087 Schenna,73,,5,15,20
087 Schenna,74,,7,7,14
087 Schenna,75,,5,11,16
087 Schenna,76,,8,8,16
087 Schenna,77,,6,5,11
087 Schenna,78,,10,6,16
087 Schenna,79,,7,15,22
087 Schenna,80,,6,4,10
087 Schenna,81,,2,6,8
087 Schenna,82,,1,5,6
087 Schenna,83,,1,4,5
087 Schenna,84,,2,1,3
087 Schenna,85,,3,3,6
087 Schenna,86,,3,5,8
087 Schenna,87,,1,3,4
087 Schenna,88,,4,2,6
087 Schenna,90,,1,1,2
087 Schenna,91,,2,1,3
087 Schenna,92,,-,2,2
087 Schenna,94,,-,1,1
087 Schenna,96,,-,1,1
087 Schenna,100,,-,1,1
088 Mühlwald,0,,9,11,20
088 Mühlwald,1,,12,10,22
088 Mühlwald,2,,11,13,24
088 Mühlwald,3,,10,8,18
088 Mühlwald,4,,14,13,27
088 Mühlwald,5,,12,4,16
088 Mühlwald,6,,10,6,16
088 Mühlwald,7,,13,12,25
088 Mühlwald,8,,5,7,12
088 Mühlwald,9,,11,7,18
088 Mühlwald,10,,9,6,15
088 Mühlwald,11,,17,8,25
088 Mühlwald,12,,7,3,10
088 Mühlwald,13,,9,14,23
088 Mühlwald,14,,6,7,13
088 Mühlwald,15,,11,18,29
088 Mühlwald,16,,11,19,30
088 Mühlwald,17,,12,10,22
088 Mühlwald,18,,8,17,25
088 Mühlwald,19,,16,14,30
088 Mühlwald,20,,21,5,26
088 Mühlwald,21,,8,21,29
088 Mühlwald,22,,12,13,25
088 Mühlwald,23,,8,8,16
088 Mühlwald,24,,14,12,26
088 Mühlwald,25,,11,10,21
088 Mühlwald,26,,10,9,19
088 Mühlwald,27,,18,10,28
088 Mühlwald,28,,10,11,21
088 Mühlwald,29,,19,15,34
088 Mühlwald,30,,11,9,20
088 Mühlwald,31,,16,17,33
088 Mühlwald,32,,16,9,25
088 Mühlwald,33,,17,14,31
088 Mühlwald,34,,15,8,23
088 Mühlwald,35,,19,12,31
088 Mühlwald,36,,16,8,24
088 Mühlwald,37,,11,10,21
088 Mühlwald,38,,9,12,21
088 Mühlwald,39,,6,10,16
088 Mühlwald,40,,15,9,24
088 Mühlwald,41,,14,5,19
088 Mühlwald,42,,10,7,17
088 Mühlwald,43,,14,12,26
088 Mühlwald,44,,7,8,15
088 Mühlwald,45,,7,7,14
088 Mühlwald,46,,10,4,14
088 Mühlwald,47,,11,9,20
088 Mühlwald,48,,10,8,18
088 Mühlwald,49,,10,4,14
088 Mühlwald,50,,5,9,14
088 Mühlwald,51,,9,3,12
088 Mühlwald,52,,12,4,16
088 Mühlwald,53,,10,7,17
088 Mühlwald,54,,9,3,12
088 Mühlwald,55,,5,4,9
088 Mühlwald,56,,8,4,12
088 Mühlwald,57,,10,2,12
088 Mühlwald,58,,6,7,13
088 Mühlwald,59,,4,8,12
088 Mühlwald,60,,3,8,11
088 Mühlwald,61,,6,11,17
088 Mühlwald,62,,9,4,13
088 Mühlwald,63,,11,3,14
088 Mühlwald,64,,4,3,7
088 Mühlwald,65,,5,4,9
088 Mühlwald,66,,3,10,13
088 Mühlwald,67,,4,10,14
088 Mühlwald,68,,1,2,3
088 Mühlwald,69,,6,6,12
088 Mühlwald,70,,5,6,11
088 Mühlwald,71,,9,9,18
088 Mühlwald,72,,4,4,8
088 Mühlwald,73,,10,2,12
088 Mühlwald,74,,4,5,9
088 Mühlwald,75,,4,3,7
088 Mühlwald,76,,7,5,12
088 Mühlwald,77,,1,6,7
088 Mühlwald,78,,1,5,6
088 Mühlwald,79,,-,6,6
088 Mühlwald,80,,2,2,4
088 Mühlwald,81,,-,2,2
088 Mühlwald,82,,1,3,4
088 Mühlwald,83,,4,2,6
088 Mühlwald,84,,-,1,1
088 Mühlwald,85,,-,3,3
088 Mühlwald,86,,1,1,2
088 Mühlwald,87,,-,2,2
088 Mühlwald,89,,1,2,3
088 Mühlwald,92,,1,-,1
088 Mühlwald,94,,-,1,1
089 Wolkenstein in Gröden,0,,20,19,39
089 Wolkenstein in Gröden,1,,14,19,33
089 Wolkenstein in Gröden,2,,16,23,39
089 Wolkenstein in Gröden,3,,22,27,49
089 Wolkenstein in Gröden,4,,14,12,26
089 Wolkenstein in Gröden,5,,17,11,28
089 Wolkenstein in Gröden,6,,16,16,32
089 Wolkenstein in Gröden,7,,12,13,25
089 Wolkenstein in Gröden,8,,24,12,36
089 Wolkenstein in Gröden,9,,19,15,34
089 Wolkenstein in Gröden,10,,12,12,24
089 Wolkenstein in Gröden,11,,19,14,33
089 Wolkenstein in Gröden,12,,15,16,31
089 Wolkenstein in Gröden,13,,12,19,31
089 Wolkenstein in Gröden,14,,16,14,30
089 Wolkenstein in Gröden,15,,17,11,28
089 Wolkenstein in Gröden,16,,12,11,23
089 Wolkenstein in Gröden,17,,17,10,27
089 Wolkenstein in Gröden,18,,11,16,27
089 Wolkenstein in Gröden,19,,16,12,28
089 Wolkenstein in Gröden,20,,15,16,31
089 Wolkenstein in Gröden,21,,6,14,20
089 Wolkenstein in Gröden,22,,8,10,18
089 Wolkenstein in Gröden,23,,12,13,25
089 Wolkenstein in Gröden,24,,17,18,35
089 Wolkenstein in Gröden,25,,20,19,39
089 Wolkenstein in Gröden,26,,11,17,28
089 Wolkenstein in Gröden,27,,27,21,48
089 Wolkenstein in Gröden,28,,14,16,30
089 Wolkenstein in Gröden,29,,22,27,49
089 Wolkenstein in Gröden,30,,21,23,44
089 Wolkenstein in Gröden,31,,29,19,48
089 Wolkenstein in Gröden,32,,28,24,52
089 Wolkenstein in Gröden,33,,32,25,57
089 Wolkenstein in Gröden,34,,29,21,50
089 Wolkenstein in Gröden,35,,23,31,54
089 Wolkenstein in Gröden,36,,30,22,52
089 Wolkenstein in Gröden,37,,22,19,41
089 Wolkenstein in Gröden,38,,20,25,45
089 Wolkenstein in Gröden,39,,26,29,55
089 Wolkenstein in Gröden,40,,23,23,46
089 Wolkenstein in Gröden,41,,17,17,34
089 Wolkenstein in Gröden,42,,20,17,37
089 Wolkenstein in Gröden,43,,19,16,35
089 Wolkenstein in Gröden,44,,12,13,25
089 Wolkenstein in Gröden,45,,14,11,25
089 Wolkenstein in Gröden,46,,17,10,27
089 Wolkenstein in Gröden,47,,8,14,22
089 Wolkenstein in Gröden,48,,12,6,18
089 Wolkenstein in Gröden,49,,15,11,26
089 Wolkenstein in Gröden,50,,7,17,24
089 Wolkenstein in Gröden,51,,18,12,30
089 Wolkenstein in Gröden,52,,14,14,28
089 Wolkenstein in Gröden,53,,12,17,29
089 Wolkenstein in Gröden,54,,16,19,35
089 Wolkenstein in Gröden,55,,6,14,20
089 Wolkenstein in Gröden,56,,14,10,24
089 Wolkenstein in Gröden,57,,21,15,36
089 Wolkenstein in Gröden,58,,14,13,27
089 Wolkenstein in Gröden,59,,18,19,37
089 Wolkenstein in Gröden,60,,18,18,36
089 Wolkenstein in Gröden,61,,20,17,37
089 Wolkenstein in Gröden,62,,21,8,29
089 Wolkenstein in Gröden,63,,11,19,30
089 Wolkenstein in Gröden,64,,10,15,25
089 Wolkenstein in Gröden,65,,14,10,24
089 Wolkenstein in Gröden,66,,17,10,27
089 Wolkenstein in Gröden,67,,7,11,18
089 Wolkenstein in Gröden,68,,6,9,15
089 Wolkenstein in Gröden,69,,10,10,20
089 Wolkenstein in Gröden,70,,10,11,21
089 Wolkenstein in Gröden,71,,9,7,16
089 Wolkenstein in Gröden,72,,7,11,18
089 Wolkenstein in Gröden,73,,11,7,18
089 Wolkenstein in Gröden,74,,9,6,15
089 Wolkenstein in Gröden,75,,7,7,14
089 Wolkenstein in Gröden,76,,3,13,16
089 Wolkenstein in Gröden,77,,5,6,11
089 Wolkenstein in Gröden,78,,6,10,16
089 Wolkenstein in Gröden,79,,2,6,8
089 Wolkenstein in Gröden,80,,3,4,7
089 Wolkenstein in Gröden,81,,1,3,4
089 Wolkenstein in Gröden,82,,-,2,2
089 Wolkenstein in Gröden,83,,1,4,5
089 Wolkenstein in Gröden,84,,-,3,3
089 Wolkenstein in Gröden,85,,-,4,4
089 Wolkenstein in Gröden,86,,1,3,4
089 Wolkenstein in Gröden,87,,-,2,2
089 Wolkenstein in Gröden,88,,1,6,7
089 Wolkenstein in Gröden,89,,1,3,4
089 Wolkenstein in Gröden,90,,2,1,3
089 Wolkenstein in Gröden,91,,1,2,3
089 Wolkenstein in Gröden,92,,1,3,4
089 Wolkenstein in Gröden,93,,-,1,1
089 Wolkenstein in Gröden,95,,1,1,2
089 Wolkenstein in Gröden,96,,-,1,1
089 Wolkenstein in Gröden,97,,-,1,1
091 Schnals,0,,4,4,8
091 Schnals,1,,7,10,17
091 Schnals,2,,6,15,21
091 Schnals,3,,12,9,21
091 Schnals,4,,7,13,20
091 Schnals,5,,4,10,14
091 Schnals,6,,5,7,12
091 Schnals,7,,11,5,16
091 Schnals,8,,13,10,23
091 Schnals,9,,13,9,22
091 Schnals,10,,5,7,12
091 Schnals,11,,20,9,29
091 Schnals,12,,10,5,15
091 Schnals,13,,12,11,23
091 Schnals,14,,10,10,20
091 Schnals,15,,7,9,16
091 Schnals,16,,12,16,28
091 Schnals,17,,10,10,20
091 Schnals,18,,11,8,19
091 Schnals,19,,16,10,26
091 Schnals,20,,14,12,26
091 Schnals,21,,11,10,21
091 Schnals,22,,12,10,22
091 Schnals,23,,8,8,16
091 Schnals,24,,13,3,16
091 Schnals,25,,7,8,15
091 Schnals,26,,15,7,22
091 Schnals,27,,7,10,17
091 Schnals,28,,9,9,18
091 Schnals,29,,12,10,22
091 Schnals,30,,12,11,23
091 Schnals,31,,15,9,24
091 Schnals,32,,12,9,21
091 Schnals,33,,16,10,26
091 Schnals,34,,15,13,28
091 Schnals,35,,18,7,25
091 Schnals,36,,6,8,14
091 Schnals,37,,10,14,24
091 Schnals,38,,15,12,27
091 Schnals,39,,11,14,25
091 Schnals,40,,9,8,17
091 Schnals,41,,16,13,29
091 Schnals,42,,14,12,26
091 Schnals,43,,11,5,16
091 Schnals,44,,14,6,20
091 Schnals,45,,10,6,16
091 Schnals,46,,10,9,19
091 Schnals,47,,12,9,21
091 Schnals,48,,13,7,20
091 Schnals,49,,12,8,20
091 Schnals,50,,11,6,17
091 Schnals,51,,12,9,21
091 Schnals,52,,3,2,5
091 Schnals,53,,10,8,18
091 Schnals,54,,5,6,11
091 Schnals,55,,9,4,13
091 Schnals,56,,4,7,11
091 Schnals,57,,7,10,17
091 Schnals,58,,4,4,8
091 Schnals,59,,5,5,10
091 Schnals,60,,7,7,14
091 Schnals,61,,7,7,14
091 Schnals,62,,2,11,13
091 Schnals,63,,7,5,12
091 Schnals,64,,6,6,12
091 Schnals,65,,4,5,9
091 Schnals,66,,2,4,6
091 Schnals,67,,7,4,11
091 Schnals,68,,3,10,13
091 Schnals,69,,3,5,8
091 Schnals,70,,-,5,5
091 Schnals,71,,7,6,13
091 Schnals,72,,2,7,9
091 Schnals,73,,3,6,9
091 Schnals,74,,9,3,12
091 Schnals,75,,7,11,18
091 Schnals,76,,3,7,10
091 Schnals,77,,1,2,3
091 Schnals,78,,8,4,12
091 Schnals,79,,1,6,7
091 Schnals,80,,2,6,8
091 Schnals,81,,1,1,2
091 Schnals,82,,3,3,6
091 Schnals,83,,-,3,3
091 Schnals,84,,1,2,3
091 Schnals,85,,3,2,5
091 Schnals,86,,1,2,3
091 Schnals,87,,-,2,2
091 Schnals,88,,2,2,4
091 Schnals,89,,-,2,2
091 Schnals,90,,-,2,2
091 Schnals,91,,-,2,2
092 Sexten,0,,8,15,23
092 Sexten,1,,9,17,26
092 Sexten,2,,11,8,19
092 Sexten,3,,12,11,23
092 Sexten,4,,13,12,25
092 Sexten,5,,15,14,29
092 Sexten,6,,16,11,27
092 Sexten,7,,8,5,13
092 Sexten,8,,15,10,25
092 Sexten,9,,12,12,24
092 Sexten,10,,10,19,29
092 Sexten,11,,10,9,19
092 Sexten,12,,9,6,15
092 Sexten,13,,13,9,22
092 Sexten,14,,7,9,16
092 Sexten,15,,12,11,23
092 Sexten,16,,7,12,19
092 Sexten,17,,11,9,20
092 Sexten,18,,11,19,30
092 Sexten,19,,16,13,29
092 Sexten,20,,17,8,25
092 Sexten,21,,12,19,31
092 Sexten,22,,10,14,24
092 Sexten,23,,10,7,17
092 Sexten,24,,17,12,29
092 Sexten,25,,10,8,18
092 Sexten,26,,9,8,17
092 Sexten,27,,11,8,19
092 Sexten,28,,16,15,31
092 Sexten,29,,13,21,34
092 Sexten,30,,14,22,36
092 Sexten,31,,21,18,39
092 Sexten,32,,20,17,37
092 Sexten,33,,22,17,39
092 Sexten,34,,16,18,34
092 Sexten,35,,21,18,39
092 Sexten,36,,21,19,40
092 Sexten,37,,30,18,48
092 Sexten,38,,15,15,30
092 Sexten,39,,20,14,34
092 Sexten,40,,19,10,29
092 Sexten,41,,16,16,32
092 Sexten,42,,21,17,38
092 Sexten,43,,17,13,30
092 Sexten,44,,14,14,28
092 Sexten,45,,13,13,26
092 Sexten,46,,11,11,22
092 Sexten,47,,6,11,17
092 Sexten,48,,6,11,17
092 Sexten,49,,7,8,15
092 Sexten,50,,13,7,20
092 Sexten,51,,8,6,14
092 Sexten,52,,10,7,17
092 Sexten,53,,11,4,15
092 Sexten,54,,6,9,15
092 Sexten,55,,9,4,13
092 Sexten,56,,7,12,19
092 Sexten,57,,8,6,14
092 Sexten,58,,5,7,12
092 Sexten,59,,10,15,25
092 Sexten,60,,8,14,22
092 Sexten,61,,7,10,17
092 Sexten,62,,14,12,26
092 Sexten,63,,12,9,21
092 Sexten,64,,9,11,20
092 Sexten,65,,12,16,28
092 Sexten,66,,12,7,19
092 Sexten,67,,5,11,16
092 Sexten,68,,7,8,15
092 Sexten,69,,12,14,26
092 Sexten,70,,10,12,22
092 Sexten,71,,8,13,21
092 Sexten,72,,11,13,24
092 Sexten,73,,12,18,30
092 Sexten,74,,7,3,10
092 Sexten,75,,10,12,22
092 Sexten,76,,6,8,14
092 Sexten,77,,7,10,17
092 Sexten,78,,8,11,19
092 Sexten,79,,4,9,13
092 Sexten,80,,2,4,6
092 Sexten,81,,2,4,6
092 Sexten,82,,-,1,1
092 Sexten,83,,1,1,2
092 Sexten,84,,-,2,2
092 Sexten,85,,1,-,1
092 Sexten,86,,2,2,4
092 Sexten,87,,-,6,6
092 Sexten,88,,2,5,7
092 Sexten,89,,-,1,1
092 Sexten,90,,-,1,1
092 Sexten,91,,-,1,1
092 Sexten,92,,-,3,3
092 Sexten,94,,-,1,1
092 Sexten,95,,-,1,1
092 Sexten,97,,-,1,1
093 Schlanders,0,,37,34,71
093 Schlanders,1,,35,39,74
093 Schlanders,2,,43,37,80
093 Schlanders,3,,56,48,104
093 Schlanders,4,,49,38,87
093 Schlanders,5,,35,27,62
093 Schlanders,6,,41,39,80
093 Schlanders,7,,42,45,87
093 Schlanders,8,,35,41,76
093 Schlanders,9,,39,40,79
093 Schlanders,10,,50,41,91
093 Schlanders,11,,37,36,73
093 Schlanders,12,,34,44,78
093 Schlanders,13,,37,30,67
093 Schlanders,14,,35,34,69
093 Schlanders,15,,41,38,79
093 Schlanders,16,,38,38,76
093 Schlanders,17,,31,34,65
093 Schlanders,18,,53,40,93
093 Schlanders,19,,46,35,81
093 Schlanders,20,,33,35,68
093 Schlanders,21,,36,38,74
093 Schlanders,22,,51,32,83
093 Schlanders,23,,36,39,75
093 Schlanders,24,,40,31,71
093 Schlanders,25,,40,36,76
093 Schlanders,26,,50,42,92
093 Schlanders,27,,49,45,94
093 Schlanders,28,,51,40,91
093 Schlanders,29,,49,48,97
093 Schlanders,30,,44,49,93
093 Schlanders,31,,55,43,98
093 Schlanders,32,,54,41,95
093 Schlanders,33,,53,45,98
093 Schlanders,34,,53,54,107
093 Schlanders,35,,57,50,107
093 Schlanders,36,,46,43,89
093 Schlanders,37,,57,60,117
093 Schlanders,38,,58,45,103
093 Schlanders,39,,49,57,106
093 Schlanders,40,,52,45,97
093 Schlanders,41,,45,41,86
093 Schlanders,42,,50,54,104
093 Schlanders,43,,44,37,81
093 Schlanders,44,,27,34,61
093 Schlanders,45,,33,36,69
093 Schlanders,46,,32,33,65
093 Schlanders,47,,33,36,69
093 Schlanders,48,,31,24,55
093 Schlanders,49,,30,32,62
093 Schlanders,50,,25,33,58
093 Schlanders,51,,29,34,63
093 Schlanders,52,,35,27,62
093 Schlanders,53,,24,25,49
093 Schlanders,54,,34,21,55
093 Schlanders,55,,31,17,48
093 Schlanders,56,,29,32,61
093 Schlanders,57,,31,32,63
093 Schlanders,58,,40,38,78
093 Schlanders,59,,37,37,74
093 Schlanders,60,,29,29,58
093 Schlanders,61,,30,38,68
093 Schlanders,62,,19,20,39
093 Schlanders,63,,27,27,54
093 Schlanders,64,,22,28,50
093 Schlanders,65,,19,27,46
093 Schlanders,66,,22,25,47
093 Schlanders,67,,22,33,55
093 Schlanders,68,,23,18,41
093 Schlanders,69,,24,20,44
093 Schlanders,70,,21,30,51
093 Schlanders,71,,14,18,32
093 Schlanders,72,,20,24,44
093 Schlanders,73,,19,26,45
093 Schlanders,74,,16,27,43
093 Schlanders,75,,11,18,29
093 Schlanders,76,,16,20,36
093 Schlanders,77,,10,19,29
093 Schlanders,78,,9,16,25
093 Schlanders,79,,8,11,19
093 Schlanders,80,,4,21,25
093 Schlanders,81,,8,15,23
093 Schlanders,82,,9,17,26
093 Schlanders,83,,7,2,9
093 Schlanders,84,,4,10,14
093 Schlanders,85,,5,4,9
093 Schlanders,86,,7,12,19
093 Schlanders,87,,7,12,19
093 Schlanders,88,,5,10,15
093 Schlanders,89,,3,12,15
093 Schlanders,90,,2,7,9
093 Schlanders,91,,-,6,6
093 Schlanders,92,,1,5,6
093 Schlanders,93,,1,-,1
093 Schlanders,94,,-,3,3
093 Schlanders,95,,-,2,2
093 Schlanders,96,,-,2,2
093 Schlanders,97,,-,3,3
093 Schlanders,99,,-,1,1
094 Schluderns,0,,19,9,28
094 Schluderns,1,,10,13,23
094 Schluderns,2,,7,9,16
094 Schluderns,3,,12,11,23
094 Schluderns,4,,12,17,29
094 Schluderns,5,,9,12,21
094 Schluderns,6,,16,20,36
094 Schluderns,7,,17,7,24
094 Schluderns,8,,8,8,16
094 Schluderns,9,,9,9,18
094 Schluderns,10,,21,7,28
094 Schluderns,11,,15,13,28
094 Schluderns,12,,11,13,24
094 Schluderns,13,,6,10,16
094 Schluderns,14,,13,21,34
094 Schluderns,15,,19,11,30
094 Schluderns,16,,17,12,29
094 Schluderns,17,,13,8,21
094 Schluderns,18,,10,12,22
094 Schluderns,19,,18,14,32
094 Schluderns,20,,9,8,17
094 Schluderns,21,,7,19,26
094 Schluderns,22,,13,12,25
094 Schluderns,23,,14,17,31
094 Schluderns,24,,9,16,25
094 Schluderns,25,,15,10,25
094 Schluderns,26,,17,13,30
094 Schluderns,27,,22,12,34
094 Schluderns,28,,13,14,27
094 Schluderns,29,,14,15,29
094 Schluderns,30,,10,14,24
094 Schluderns,31,,20,9,29
094 Schluderns,32,,19,15,34
094 Schluderns,33,,17,15,32
094 Schluderns,34,,15,19,34
094 Schluderns,35,,26,9,35
094 Schluderns,36,,25,12,37
094 Schluderns,37,,14,20,34
094 Schluderns,38,,12,21,33
094 Schluderns,39,,19,16,35
094 Schluderns,40,,9,7,16
094 Schluderns,41,,12,19,31
094 Schluderns,42,,9,12,21
094 Schluderns,43,,14,7,21
094 Schluderns,44,,12,17,29
094 Schluderns,45,,17,10,27
094 Schluderns,46,,13,7,20
094 Schluderns,47,,10,6,16
094 Schluderns,48,,7,5,12
094 Schluderns,49,,11,3,14
094 Schluderns,50,,7,14,21
094 Schluderns,51,,13,9,22
094 Schluderns,52,,12,8,20
094 Schluderns,53,,7,5,12
094 Schluderns,54,,8,9,17
094 Schluderns,55,,7,3,10
094 Schluderns,56,,4,12,16
094 Schluderns,57,,3,9,12
094 Schluderns,58,,7,8,15
094 Schluderns,59,,11,13,24
094 Schluderns,60,,8,5,13
094 Schluderns,61,,12,8,20
094 Schluderns,62,,8,10,18
094 Schluderns,63,,7,8,15
094 Schluderns,64,,4,7,11
094 Schluderns,65,,6,10,16
094 Schluderns,66,,11,11,22
094 Schluderns,67,,4,9,13
094 Schluderns,68,,11,9,20
094 Schluderns,69,,4,8,12
094 Schluderns,70,,7,10,17
094 Schluderns,71,,9,7,16
094 Schluderns,72,,7,10,17
094 Schluderns,73,,7,1,8
094 Schluderns,74,,4,14,18
094 Schluderns,75,,3,6,9
094 Schluderns,76,,3,5,8
094 Schluderns,77,,1,5,6
094 Schluderns,78,,8,6,14
094 Schluderns,79,,2,8,10
094 Schluderns,80,,1,2,3
094 Schluderns,81,,3,5,8
094 Schluderns,82,,3,2,5
094 Schluderns,83,,1,2,3
094 Schluderns,84,,2,4,6
094 Schluderns,85,,1,3,4
094 Schluderns,86,,2,4,6
094 Schluderns,87,,1,1,2
094 Schluderns,88,,1,3,4
094 Schluderns,89,,-,1,1
094 Schluderns,91,,-,1,1
094 Schluderns,92,,1,1,2
094 Schluderns,93,,-,1,1
094 Schluderns,94,,-,1,1
094 Schluderns,95,,-,1,1
095 Stilfs,0,,10,5,15
095 Stilfs,1,,2,7,9
095 Stilfs,2,,8,3,11
095 Stilfs,3,,9,12,21
095 Stilfs,4,,12,1,13
095 Stilfs,5,,6,7,13
095 Stilfs,6,,8,7,15
095 Stilfs,7,,5,15,20
095 Stilfs,8,,4,9,13
095 Stilfs,9,,12,5,17
095 Stilfs,10,,17,7,24
095 Stilfs,11,,10,6,16
095 Stilfs,12,,6,4,10
095 Stilfs,13,,6,7,13
095 Stilfs,14,,8,8,16
095 Stilfs,15,,12,5,17
095 Stilfs,16,,15,5,20
095 Stilfs,17,,8,7,15
095 Stilfs,18,,12,4,16
095 Stilfs,19,,10,3,13
095 Stilfs,20,,7,4,11
095 Stilfs,21,,5,7,12
095 Stilfs,22,,10,7,17
095 Stilfs,23,,10,13,23
095 Stilfs,24,,13,4,17
095 Stilfs,25,,11,10,21
095 Stilfs,26,,9,6,15
095 Stilfs,27,,3,20,23
095 Stilfs,28,,14,12,26
095 Stilfs,29,,15,11,26
095 Stilfs,30,,11,16,27
095 Stilfs,31,,12,14,26
095 Stilfs,32,,12,11,23
095 Stilfs,33,,11,9,20
095 Stilfs,34,,17,8,25
095 Stilfs,35,,10,10,20
095 Stilfs,36,,11,5,16
095 Stilfs,37,,9,5,14
095 Stilfs,38,,11,14,25
095 Stilfs,39,,10,2,12
095 Stilfs,40,,9,6,15
095 Stilfs,41,,9,8,17
095 Stilfs,42,,6,12,18
095 Stilfs,43,,9,6,15
095 Stilfs,44,,5,12,17
095 Stilfs,45,,4,3,7
095 Stilfs,46,,13,8,21
095 Stilfs,47,,11,5,16
095 Stilfs,48,,12,5,17
095 Stilfs,49,,12,10,22
095 Stilfs,50,,4,10,14
095 Stilfs,51,,8,3,11
095 Stilfs,52,,9,10,19
095 Stilfs,53,,5,5,10
095 Stilfs,54,,9,10,19
095 Stilfs,55,,2,4,6
095 Stilfs,56,,14,8,22
095 Stilfs,57,,8,7,15
095 Stilfs,58,,5,14,19
095 Stilfs,59,,9,4,13
095 Stilfs,60,,7,11,18
095 Stilfs,61,,6,12,18
095 Stilfs,62,,6,6,12
095 Stilfs,63,,7,6,13
095 Stilfs,64,,3,10,13
095 Stilfs,65,,3,9,12
095 Stilfs,66,,6,4,10
095 Stilfs,67,,4,5,9
095 Stilfs,68,,6,7,13
095 Stilfs,69,,5,4,9
095 Stilfs,70,,6,8,14
095 Stilfs,71,,6,1,7
095 Stilfs,72,,3,8,11
095 Stilfs,73,,5,8,13
095 Stilfs,74,,6,5,11
095 Stilfs,75,,7,3,10
095 Stilfs,76,,1,11,12
095 Stilfs,77,,5,5,10
095 Stilfs,78,,3,5,8
095 Stilfs,79,,2,6,8
095 Stilfs,80,,2,10,12
095 Stilfs,81,,3,1,4
095 Stilfs,82,,2,3,5
095 Stilfs,83,,-,3,3
095 Stilfs,84,,-,3,3
095 Stilfs,85,,1,1,2
095 Stilfs,86,,2,4,6
095 Stilfs,87,,-,1,1
095 Stilfs,88,,-,3,3
095 Stilfs,89,,-,2,2
095 Stilfs,90,,-,3,3
095 Stilfs,91,,-,3,3
095 Stilfs,93,,-,1,1
095 Stilfs,94,,-,1,1
096 Terenten,0,,11,10,21
096 Terenten,1,,8,19,27
096 Terenten,2,,18,17,35
096 Terenten,3,,9,8,17
096 Terenten,4,,12,11,23
096 Terenten,5,,12,8,20
096 Terenten,6,,13,14,27
096 Terenten,7,,6,14,20
096 Terenten,8,,10,8,18
096 Terenten,9,,6,15,21
096 Terenten,10,,14,16,30
096 Terenten,11,,14,7,21
096 Terenten,12,,10,8,18
096 Terenten,13,,16,6,22
096 Terenten,14,,10,10,20
096 Terenten,15,,11,16,27
096 Terenten,16,,12,12,24
096 Terenten,17,,14,16,30
096 Terenten,18,,12,9,21
096 Terenten,19,,13,6,19
096 Terenten,20,,11,14,25
096 Terenten,21,,9,10,19
096 Terenten,22,,16,17,33
096 Terenten,23,,11,7,18
096 Terenten,24,,15,10,25
096 Terenten,25,,16,9,25
096 Terenten,26,,15,14,29
096 Terenten,27,,4,15,19
096 Terenten,28,,19,11,30
096 Terenten,29,,14,13,27
096 Terenten,30,,22,12,34
096 Terenten,31,,16,12,28
096 Terenten,32,,11,14,25
096 Terenten,33,,14,14,28
096 Terenten,34,,13,18,31
096 Terenten,35,,15,10,25
096 Terenten,36,,14,16,30
096 Terenten,37,,25,13,38
096 Terenten,38,,20,10,30
096 Terenten,39,,11,15,26
096 Terenten,40,,12,9,21
096 Terenten,41,,13,11,24
096 Terenten,42,,12,8,20
096 Terenten,43,,12,9,21
096 Terenten,44,,11,12,23
096 Terenten,45,,12,10,22
096 Terenten,46,,16,11,27
096 Terenten,47,,9,6,15
096 Terenten,48,,6,7,13
096 Terenten,49,,5,6,11
096 Terenten,50,,10,7,17
096 Terenten,51,,9,6,15
096 Terenten,52,,10,8,18
096 Terenten,53,,7,3,10
096 Terenten,54,,8,3,11
096 Terenten,55,,6,3,9
096 Terenten,56,,3,6,9
096 Terenten,57,,8,4,12
096 Terenten,58,,5,5,10
096 Terenten,59,,6,4,10
096 Terenten,60,,7,5,12
096 Terenten,61,,2,6,8
096 Terenten,62,,6,9,15
096 Terenten,63,,7,5,12
096 Terenten,64,,4,9,13
096 Terenten,65,,7,5,12
096 Terenten,66,,2,4,6
096 Terenten,67,,5,3,8
096 Terenten,68,,4,4,8
096 Terenten,69,,6,11,17
096 Terenten,70,,6,6,12
096 Terenten,71,,5,4,9
096 Terenten,72,,8,6,14
096 Terenten,73,,2,4,6
096 Terenten,74,,3,10,13
096 Terenten,75,,6,3,9
096 Terenten,76,,1,7,8
096 Terenten,77,,4,4,8
096 Terenten,78,,3,1,4
096 Terenten,79,,-,3,3
096 Terenten,80,,4,3,7
096 Terenten,81,,1,4,5
096 Terenten,82,,1,3,4
096 Terenten,83,,1,-,1
096 Terenten,84,,1,2,3
096 Terenten,85,,-,1,1
096 Terenten,86,,2,3,5
096 Terenten,87,,1,-,1
096 Terenten,88,,-,1,1
096 Terenten,90,,-,2,2
096 Terenten,91,,-,1,1
096 Terenten,92,,-,1,1
096 Terenten,93,,-,1,1
096 Terenten,94,,1,-,1
096 Terenten,95,,1,-,1
097 Terlan,0,,30,27,57
097 Terlan,1,,25,18,43
097 Terlan,2,,16,16,32
097 Terlan,3,,24,27,51
097 Terlan,4,,18,20,38
097 Terlan,5,,25,22,47
097 Terlan,6,,18,18,36
097 Terlan,7,,20,20,40
097 Terlan,8,,22,28,50
097 Terlan,9,,24,19,43
097 Terlan,10,,14,20,34
097 Terlan,11,,21,30,51
097 Terlan,12,,21,17,38
097 Terlan,13,,24,16,40
097 Terlan,14,,18,22,40
097 Terlan,15,,26,19,45
097 Terlan,16,,11,11,22
097 Terlan,17,,24,17,41
097 Terlan,18,,20,16,36
097 Terlan,19,,14,15,29
097 Terlan,20,,26,22,48
097 Terlan,21,,18,26,44
097 Terlan,22,,17,18,35
097 Terlan,23,,26,21,47
097 Terlan,24,,29,25,54
097 Terlan,25,,22,15,37
097 Terlan,26,,29,30,59
097 Terlan,27,,20,30,50
097 Terlan,28,,39,20,59
097 Terlan,29,,32,23,55
097 Terlan,30,,36,35,71
097 Terlan,31,,33,35,68
097 Terlan,32,,39,30,69
097 Terlan,33,,23,35,58
097 Terlan,34,,35,19,54
097 Terlan,35,,28,27,55
097 Terlan,36,,29,32,61
097 Terlan,37,,27,35,62
097 Terlan,38,,33,34,67
097 Terlan,39,,41,25,66
097 Terlan,40,,25,31,56
097 Terlan,41,,19,25,44
097 Terlan,42,,31,23,54
097 Terlan,43,,21,27,48
097 Terlan,44,,31,31,62
097 Terlan,45,,20,22,42
097 Terlan,46,,24,19,43
097 Terlan,47,,18,24,42
097 Terlan,48,,22,23,45
097 Terlan,49,,20,19,39
097 Terlan,50,,22,23,45
097 Terlan,51,,20,15,35
097 Terlan,52,,23,23,46
097 Terlan,53,,13,18,31
097 Terlan,54,,14,27,41
097 Terlan,55,,22,20,42
097 Terlan,56,,22,25,47
097 Terlan,57,,18,29,47
097 Terlan,58,,36,19,55
097 Terlan,59,,21,25,46
097 Terlan,60,,21,15,36
097 Terlan,61,,17,19,36
097 Terlan,62,,21,18,39
097 Terlan,63,,15,18,33
097 Terlan,64,,8,12,20
097 Terlan,65,,16,23,39
097 Terlan,66,,7,24,31
097 Terlan,67,,16,16,32
097 Terlan,68,,16,11,27
097 Terlan,69,,20,15,35
097 Terlan,70,,16,17,33
097 Terlan,71,,13,14,27
097 Terlan,72,,14,13,27
097 Terlan,73,,11,12,23
097 Terlan,74,,13,21,34
097 Terlan,75,,12,13,25
097 Terlan,76,,8,15,23
097 Terlan,77,,8,24,32
097 Terlan,78,,9,13,22
097 Terlan,79,,8,14,22
097 Terlan,80,,2,9,11
097 Terlan,81,,-,10,10
097 Terlan,82,,4,3,7
097 Terlan,83,,-,4,4
097 Terlan,84,,-,5,5
097 Terlan,85,,2,6,8
097 Terlan,86,,-,10,10
097 Terlan,87,,5,8,13
097 Terlan,88,,-,5,5
097 Terlan,89,,-,9,9
097 Terlan,90,,1,4,5
097 Terlan,91,,3,1,4
097 Terlan,92,,1,2,3
097 Terlan,93,,-,2,2
097 Terlan,94,,1,-,1
097 Terlan,95,,-,1,1
098 Tramin a.d. Weinstr.,0,,25,15,40
098 Tramin a.d. Weinstr.,1,,24,18,42
098 Tramin a.d. Weinstr.,2,,13,18,31
098 Tramin a.d. Weinstr.,3,,33,18,51
098 Tramin a.d. Weinstr.,4,,20,28,48
098 Tramin a.d. Weinstr.,5,,18,20,38
098 Tramin a.d. Weinstr.,6,,22,22,44
098 Tramin a.d. Weinstr.,7,,17,16,33
098 Tramin a.d. Weinstr.,8,,21,24,45
098 Tramin a.d. Weinstr.,9,,18,11,29
098 Tramin a.d. Weinstr.,10,,25,21,46
098 Tramin a.d. Weinstr.,11,,11,30,41
098 Tramin a.d. Weinstr.,12,,12,25,37
098 Tramin a.d. Weinstr.,13,,18,25,43
098 Tramin a.d. Weinstr.,14,,10,15,25
098 Tramin a.d. Weinstr.,15,,19,21,40
098 Tramin a.d. Weinstr.,16,,20,16,36
098 Tramin a.d. Weinstr.,17,,16,14,30
098 Tramin a.d. Weinstr.,18,,25,18,43
098 Tramin a.d. Weinstr.,19,,29,18,47
098 Tramin a.d. Weinstr.,20,,19,13,32
098 Tramin a.d. Weinstr.,21,,13,14,27
098 Tramin a.d. Weinstr.,22,,10,17,27
098 Tramin a.d. Weinstr.,23,,17,20,37
098 Tramin a.d. Weinstr.,24,,21,17,38
098 Tramin a.d. Weinstr.,25,,18,16,34
098 Tramin a.d. Weinstr.,26,,20,11,31
098 Tramin a.d. Weinstr.,27,,20,18,38
098 Tramin a.d. Weinstr.,28,,22,27,49
098 Tramin a.d. Weinstr.,29,,25,31,56
098 Tramin a.d. Weinstr.,30,,24,20,44
098 Tramin a.d. Weinstr.,31,,32,25,57
098 Tramin a.d. Weinstr.,32,,24,25,49
098 Tramin a.d. Weinstr.,33,,23,27,50
098 Tramin a.d. Weinstr.,34,,31,29,60
098 Tramin a.d. Weinstr.,35,,33,29,62
098 Tramin a.d. Weinstr.,36,,24,28,52
098 Tramin a.d. Weinstr.,37,,25,27,52
098 Tramin a.d. Weinstr.,38,,21,16,37
098 Tramin a.d. Weinstr.,39,,34,27,61
098 Tramin a.d. Weinstr.,40,,29,33,62
098 Tramin a.d. Weinstr.,41,,21,31,52
098 Tramin a.d. Weinstr.,42,,25,22,47
098 Tramin a.d. Weinstr.,43,,18,19,37
098 Tramin a.d. Weinstr.,44,,24,19,43
098 Tramin a.d. Weinstr.,45,,18,19,37
098 Tramin a.d. Weinstr.,46,,18,18,36
098 Tramin a.d. Weinstr.,47,,15,15,30
098 Tramin a.d. Weinstr.,48,,19,17,36
098 Tramin a.d. Weinstr.,49,,10,13,23
098 Tramin a.d. Weinstr.,50,,17,18,35
098 Tramin a.d. Weinstr.,51,,16,15,31
098 Tramin a.d. Weinstr.,52,,18,18,36
098 Tramin a.d. Weinstr.,53,,14,23,37
098 Tramin a.d. Weinstr.,54,,27,17,44
098 Tramin a.d. Weinstr.,55,,8,9,17
098 Tramin a.d. Weinstr.,56,,23,23,46
098 Tramin a.d. Weinstr.,57,,19,22,41
098 Tramin a.d. Weinstr.,58,,20,19,39
098 Tramin a.d. Weinstr.,59,,13,25,38
098 Tramin a.d. Weinstr.,60,,22,17,39
098 Tramin a.d. Weinstr.,61,,14,13,27
098 Tramin a.d. Weinstr.,62,,9,21,30
098 Tramin a.d. Weinstr.,63,,15,13,28
098 Tramin a.d. Weinstr.,64,,13,14,27
098 Tramin a.d. Weinstr.,65,,15,13,28
098 Tramin a.d. Weinstr.,66,,11,12,23
098 Tramin a.d. Weinstr.,67,,11,16,27
098 Tramin a.d. Weinstr.,68,,12,19,31
098 Tramin a.d. Weinstr.,69,,10,19,29
098 Tramin a.d. Weinstr.,70,,23,16,39
098 Tramin a.d. Weinstr.,71,,12,15,27
098 Tramin a.d. Weinstr.,72,,17,16,33
098 Tramin a.d. Weinstr.,73,,16,15,31
098 Tramin a.d. Weinstr.,74,,17,19,36
098 Tramin a.d. Weinstr.,75,,13,21,34
098 Tramin a.d. Weinstr.,76,,6,15,21
098 Tramin a.d. Weinstr.,77,,10,19,29
098 Tramin a.d. Weinstr.,78,,7,16,23
098 Tramin a.d. Weinstr.,79,,14,12,26
098 Tramin a.d. Weinstr.,80,,6,15,21
098 Tramin a.d. Weinstr.,81,,3,13,16
098 Tramin a.d. Weinstr.,82,,3,3,6
098 Tramin a.d. Weinstr.,83,,1,3,4
098 Tramin a.d. Weinstr.,84,,1,2,3
098 Tramin a.d. Weinstr.,85,,2,6,8
098 Tramin a.d. Weinstr.,86,,5,9,14
098 Tramin a.d. Weinstr.,87,,3,2,5
098 Tramin a.d. Weinstr.,88,,2,4,6
098 Tramin a.d. Weinstr.,89,,-,8,8
098 Tramin a.d. Weinstr.,90,,1,7,8
098 Tramin a.d. Weinstr.,91,,-,2,2
098 Tramin a.d. Weinstr.,92,,1,5,6
098 Tramin a.d. Weinstr.,93,,-,5,5
098 Tramin a.d. Weinstr.,94,,-,2,2
098 Tramin a.d. Weinstr.,96,,-,3,3
098 Tramin a.d. Weinstr.,100,,-,1,1
099 Tisens,0,,9,10,19
099 Tisens,1,,11,10,21
099 Tisens,2,,10,14,24
099 Tisens,3,,3,5,8
099 Tisens,4,,9,8,17
099 Tisens,5,,9,7,16
099 Tisens,6,,12,12,24
099 Tisens,7,,6,10,16
099 Tisens,8,,6,16,22
099 Tisens,9,,16,8,24
099 Tisens,10,,10,15,25
099 Tisens,11,,12,9,21
099 Tisens,12,,7,13,20
099 Tisens,13,,14,9,23
099 Tisens,14,,15,8,23
099 Tisens,15,,9,5,14
099 Tisens,16,,13,12,25
099 Tisens,17,,18,6,24
099 Tisens,18,,10,14,24
099 Tisens,19,,4,18,22
099 Tisens,20,,14,12,26
099 Tisens,21,,10,7,17
099 Tisens,22,,12,12,24
099 Tisens,23,,11,7,18
099 Tisens,24,,9,4,13
099 Tisens,25,,13,14,27
099 Tisens,26,,8,9,17
099 Tisens,27,,10,8,18
099 Tisens,28,,6,12,18
099 Tisens,29,,17,17,34
099 Tisens,30,,18,17,35
099 Tisens,31,,18,13,31
099 Tisens,32,,17,15,32
099 Tisens,33,,18,23,41
099 Tisens,34,,19,13,32
099 Tisens,35,,18,25,43
099 Tisens,36,,16,3,19
099 Tisens,37,,18,14,32
099 Tisens,38,,23,7,30
099 Tisens,39,,16,13,29
099 Tisens,40,,16,7,23
099 Tisens,41,,13,10,23
099 Tisens,42,,10,11,21
099 Tisens,43,,17,19,36
099 Tisens,44,,9,13,22
099 Tisens,45,,19,9,28
099 Tisens,46,,8,6,14
099 Tisens,47,,13,10,23
099 Tisens,48,,7,12,19
099 Tisens,49,,10,11,21
099 Tisens,50,,9,7,16
099 Tisens,51,,5,7,12
099 Tisens,52,,14,9,23
099 Tisens,53,,7,8,15
099 Tisens,54,,8,7,15
099 Tisens,55,,3,7,10
099 Tisens,56,,10,10,20
099 Tisens,57,,12,10,22
099 Tisens,58,,8,8,16
099 Tisens,59,,9,14,23
099 Tisens,60,,6,9,15
099 Tisens,61,,14,10,24
099 Tisens,62,,8,12,20
099 Tisens,63,,6,4,10
099 Tisens,64,,7,8,15
099 Tisens,65,,5,11,16
099 Tisens,66,,9,7,16
099 Tisens,67,,2,12,14
099 Tisens,68,,9,11,20
099 Tisens,69,,8,9,17
099 Tisens,70,,5,15,20
099 Tisens,71,,11,11,22
099 Tisens,72,,12,13,25
099 Tisens,73,,15,10,25
099 Tisens,74,,6,9,15
099 Tisens,75,,5,7,12
099 Tisens,76,,3,6,9
099 Tisens,77,,4,12,16
099 Tisens,78,,6,6,12
099 Tisens,79,,6,7,13
099 Tisens,80,,4,6,10
099 Tisens,81,,2,9,11
099 Tisens,82,,4,3,7
099 Tisens,83,,2,5,7
099 Tisens,84,,1,3,4
099 Tisens,85,,2,4,6
099 Tisens,86,,1,6,7
099 Tisens,87,,2,2,4
099 Tisens,88,,1,4,5
099 Tisens,89,,2,3,5
099 Tisens,90,,1,5,6
099 Tisens,92,,-,3,3
099 Tisens,93,,-,2,2
099 Tisens,97,,-,1,1
099 Tisens,99,,-,1,1
100 Tiers,0,,2,8,10
100 Tiers,1,,5,9,14
100 Tiers,2,,4,9,13
100 Tiers,3,,7,6,13
100 Tiers,4,,9,4,13
100 Tiers,5,,6,12,18
100 Tiers,6,,5,7,12
100 Tiers,7,,5,1,6
100 Tiers,8,,6,3,9
100 Tiers,9,,4,3,7
100 Tiers,10,,6,5,11
100 Tiers,11,,5,6,11
100 Tiers,12,,6,8,14
100 Tiers,13,,5,4,9
100 Tiers,14,,9,5,14
100 Tiers,15,,5,6,11
100 Tiers,16,,3,9,12
100 Tiers,17,,7,7,14
100 Tiers,18,,6,6,12
100 Tiers,19,,5,4,9
100 Tiers,20,,2,4,6
100 Tiers,21,,1,9,10
100 Tiers,22,,8,8,16
100 Tiers,23,,6,3,9
100 Tiers,24,,1,3,4
100 Tiers,25,,8,3,11
100 Tiers,26,,5,6,11
100 Tiers,27,,8,10,18
100 Tiers,28,,9,7,16
100 Tiers,29,,6,8,14
100 Tiers,30,,8,8,16
100 Tiers,31,,12,11,23
100 Tiers,32,,5,6,11
100 Tiers,33,,9,12,21
100 Tiers,34,,13,7,20
100 Tiers,35,,7,7,14
100 Tiers,36,,9,2,11
100 Tiers,37,,6,10,16
100 Tiers,38,,6,7,13
100 Tiers,39,,7,4,11
100 Tiers,40,,4,6,10
100 Tiers,41,,11,5,16
100 Tiers,42,,7,4,11
100 Tiers,43,,6,8,14
100 Tiers,44,,11,8,19
100 Tiers,45,,5,3,8
100 Tiers,46,,8,5,13
100 Tiers,47,,6,5,11
100 Tiers,48,,3,3,6
100 Tiers,49,,1,3,4
100 Tiers,50,,7,5,12
100 Tiers,51,,2,5,7
100 Tiers,52,,4,5,9
100 Tiers,53,,1,2,3
100 Tiers,54,,5,4,9
100 Tiers,55,,10,3,13
100 Tiers,56,,-,5,5
100 Tiers,57,,8,10,18
100 Tiers,58,,2,5,7
100 Tiers,59,,4,7,11
100 Tiers,60,,2,3,5
100 Tiers,61,,4,6,10
100 Tiers,62,,6,5,11
100 Tiers,63,,7,5,12
100 Tiers,64,,4,7,11
100 Tiers,65,,7,2,9
100 Tiers,66,,2,5,7
100 Tiers,67,,7,3,10
100 Tiers,68,,3,5,8
100 Tiers,69,,7,3,10
100 Tiers,70,,5,1,6
100 Tiers,71,,3,3,6
100 Tiers,72,,4,3,7
100 Tiers,73,,4,4,8
100 Tiers,74,,4,2,6
100 Tiers,75,,6,5,11
100 Tiers,76,,2,7,9
100 Tiers,77,,3,3,6
100 Tiers,78,,3,2,5
100 Tiers,79,,1,10,11
100 Tiers,80,,2,3,5
100 Tiers,81,,3,1,4
100 Tiers,82,,1,1,2
100 Tiers,83,,3,1,4
100 Tiers,85,,1,2,3
100 Tiers,86,,2,1,3
100 Tiers,87,,1,1,2
100 Tiers,88,,1,2,3
100 Tiers,89,,1,1,2
100 Tiers,90,,-,1,1
100 Tiers,92,,1,-,1
100 Tiers,93,,-,1,1
100 Tiers,97,,1,-,1
101 Tirol,0,,17,10,27
101 Tirol,1,,16,16,32
101 Tirol,2,,15,14,29
101 Tirol,3,,20,19,39
101 Tirol,4,,22,20,42
101 Tirol,5,,10,18,28
101 Tirol,6,,13,16,29
101 Tirol,7,,23,9,32
101 Tirol,8,,12,14,26
101 Tirol,9,,8,9,17
101 Tirol,10,,16,10,26
101 Tirol,11,,10,19,29
101 Tirol,12,,10,14,24
101 Tirol,13,,15,9,24
101 Tirol,14,,10,12,22
101 Tirol,15,,10,16,26
101 Tirol,16,,16,11,27
101 Tirol,17,,18,15,33
101 Tirol,18,,13,13,26
101 Tirol,19,,18,23,41
101 Tirol,20,,18,9,27
101 Tirol,21,,19,6,25
101 Tirol,22,,9,12,21
101 Tirol,23,,15,19,34
101 Tirol,24,,15,8,23
101 Tirol,25,,17,22,39
101 Tirol,26,,14,18,32
101 Tirol,27,,21,17,38
101 Tirol,28,,23,20,43
101 Tirol,29,,24,13,37
101 Tirol,30,,17,13,30
101 Tirol,31,,20,18,38
101 Tirol,32,,22,22,44
101 Tirol,33,,21,21,42
101 Tirol,34,,21,17,38
101 Tirol,35,,24,21,45
101 Tirol,36,,28,23,51
101 Tirol,37,,20,13,33
101 Tirol,38,,18,17,35
101 Tirol,39,,18,23,41
101 Tirol,40,,24,12,36
101 Tirol,41,,16,11,27
101 Tirol,42,,14,18,32
101 Tirol,43,,20,17,37
101 Tirol,44,,9,15,24
101 Tirol,45,,13,14,27
101 Tirol,46,,14,17,31
101 Tirol,47,,19,17,36
101 Tirol,48,,12,10,22
101 Tirol,49,,15,19,34
101 Tirol,50,,15,12,27
101 Tirol,51,,21,15,36
101 Tirol,52,,21,15,36
101 Tirol,53,,9,17,26
101 Tirol,54,,14,8,22
101 Tirol,55,,12,14,26
101 Tirol,56,,18,17,35
101 Tirol,57,,12,12,24
101 Tirol,58,,12,20,32
101 Tirol,59,,13,19,32
101 Tirol,60,,10,13,23
101 Tirol,61,,14,13,27
101 Tirol,62,,9,9,18
101 Tirol,63,,11,15,26
101 Tirol,64,,8,12,20
101 Tirol,65,,11,11,22
101 Tirol,66,,16,7,23
101 Tirol,67,,8,12,20
101 Tirol,68,,7,8,15
101 Tirol,69,,8,7,15
101 Tirol,70,,6,9,15
101 Tirol,71,,10,15,25
101 Tirol,72,,9,9,18
101 Tirol,73,,10,8,18
101 Tirol,74,,5,12,17
101 Tirol,75,,6,9,15
101 Tirol,76,,9,11,20
101 Tirol,77,,5,7,12
101 Tirol,78,,4,7,11
101 Tirol,79,,7,10,17
101 Tirol,80,,2,8,10
101 Tirol,81,,3,4,7
101 Tirol,82,,2,6,8
101 Tirol,83,,1,1,2
101 Tirol,84,,2,3,5
101 Tirol,85,,3,4,7
101 Tirol,86,,4,5,9
101 Tirol,87,,3,6,9
101 Tirol,88,,1,2,3
101 Tirol,89,,2,5,7
101 Tirol,90,,2,2,4
101 Tirol,91,,-,4,4
101 Tirol,92,,-,3,3
101 Tirol,93,,2,-,2
101 Tirol,94,,1,-,1
102 Truden im Naturpark,0,,6,7,13
102 Truden im Naturpark,1,,-,4,4
102 Truden im Naturpark,2,,3,8,11
102 Truden im Naturpark,3,,5,6,11
102 Truden im Naturpark,4,,7,6,13
102 Truden im Naturpark,5,,4,7,11
102 Truden im Naturpark,6,,5,6,11
102 Truden im Naturpark,7,,10,4,14
102 Truden im Naturpark,8,,8,4,12
102 Truden im Naturpark,9,,7,7,14
102 Truden im Naturpark,10,,4,5,9
102 Truden im Naturpark,11,,11,6,17
102 Truden im Naturpark,12,,8,10,18
102 Truden im Naturpark,13,,6,5,11
102 Truden im Naturpark,14,,1,6,7
102 Truden im Naturpark,15,,8,6,14
102 Truden im Naturpark,16,,11,4,15
102 Truden im Naturpark,17,,6,5,11
102 Truden im Naturpark,18,,12,3,15
102 Truden im Naturpark,19,,4,8,12
102 Truden im Naturpark,20,,4,4,8
102 Truden im Naturpark,21,,9,7,16
102 Truden im Naturpark,22,,7,6,13
102 Truden im Naturpark,23,,4,3,7
102 Truden im Naturpark,24,,10,9,19
102 Truden im Naturpark,25,,8,3,11
102 Truden im Naturpark,26,,3,6,9
102 Truden im Naturpark,27,,8,10,18
102 Truden im Naturpark,28,,5,8,13
102 Truden im Naturpark,29,,3,6,9
102 Truden im Naturpark,30,,2,8,10
102 Truden im Naturpark,31,,7,8,15
102 Truden im Naturpark,32,,7,11,18
102 Truden im Naturpark,33,,11,7,18
102 Truden im Naturpark,34,,6,6,12
102 Truden im Naturpark,35,,6,7,13
102 Truden im Naturpark,36,,8,6,14
102 Truden im Naturpark,37,,10,8,18
102 Truden im Naturpark,38,,7,7,14
102 Truden im Naturpark,39,,8,5,13
102 Truden im Naturpark,40,,10,12,22
102 Truden im Naturpark,41,,7,9,16
102 Truden im Naturpark,42,,4,8,12
102 Truden im Naturpark,43,,6,10,16
102 Truden im Naturpark,44,,8,5,13
102 Truden im Naturpark,45,,9,11,20
102 Truden im Naturpark,46,,6,5,11
102 Truden im Naturpark,47,,8,5,13
102 Truden im Naturpark,48,,7,6,13
102 Truden im Naturpark,49,,9,6,15
102 Truden im Naturpark,50,,2,2,4
102 Truden im Naturpark,51,,5,3,8
102 Truden im Naturpark,52,,1,7,8
102 Truden im Naturpark,53,,7,2,9
102 Truden im Naturpark,54,,8,6,14
102 Truden im Naturpark,55,,4,2,6
102 Truden im Naturpark,56,,5,5,10
102 Truden im Naturpark,57,,5,4,9
102 Truden im Naturpark,58,,5,3,8
102 Truden im Naturpark,59,,5,5,10
102 Truden im Naturpark,60,,3,4,7
102 Truden im Naturpark,61,,8,3,11
102 Truden im Naturpark,62,,7,7,14
102 Truden im Naturpark,63,,3,4,7
102 Truden im Naturpark,64,,4,4,8
102 Truden im Naturpark,65,,4,3,7
102 Truden im Naturpark,66,,5,-,5
102 Truden im Naturpark,67,,7,7,14
102 Truden im Naturpark,68,,4,4,8
102 Truden im Naturpark,69,,6,4,10
102 Truden im Naturpark,70,,4,10,14
102 Truden im Naturpark,71,,-,7,7
102 Truden im Naturpark,72,,2,6,8
102 Truden im Naturpark,73,,6,7,13
102 Truden im Naturpark,74,,2,8,10
102 Truden im Naturpark,75,,2,7,9
102 Truden im Naturpark,76,,-,7,7
102 Truden im Naturpark,77,,4,7,11
102 Truden im Naturpark,78,,5,5,10
102 Truden im Naturpark,79,,2,5,7
102 Truden im Naturpark,80,,-,9,9
102 Truden im Naturpark,81,,1,4,5
102 Truden im Naturpark,82,,1,2,3
102 Truden im Naturpark,83,,-,1,1
102 Truden im Naturpark,85,,2,1,3
102 Truden im Naturpark,86,,-,4,4
102 Truden im Naturpark,89,,-,1,1
102 Truden im Naturpark,90,,-,2,2
102 Truden im Naturpark,91,,-,2,2
102 Truden im Naturpark,94,,-,2,2
103 Taufers im Münstertal,0,,4,4,8
103 Taufers im Münstertal,1,,3,4,7
103 Taufers im Münstertal,2,,7,8,15
103 Taufers im Münstertal,3,,3,5,8
103 Taufers im Münstertal,4,,7,4,11
103 Taufers im Münstertal,5,,9,9,18
103 Taufers im Münstertal,6,,5,9,14
103 Taufers im Münstertal,7,,3,5,8
103 Taufers im Münstertal,8,,10,9,19
103 Taufers im Münstertal,9,,6,12,18
103 Taufers im Münstertal,10,,7,7,14
103 Taufers im Münstertal,11,,6,2,8
103 Taufers im Münstertal,12,,6,8,14
103 Taufers im Münstertal,13,,4,6,10
103 Taufers im Münstertal,14,,4,4,8
103 Taufers im Münstertal,15,,4,3,7
103 Taufers im Münstertal,16,,4,7,11
103 Taufers im Münstertal,17,,5,6,11
103 Taufers im Münstertal,18,,5,11,16
103 Taufers im Münstertal,19,,8,2,10
103 Taufers im Münstertal,20,,8,6,14
103 Taufers im Münstertal,21,,7,3,10
103 Taufers im Münstertal,22,,7,5,12
103 Taufers im Münstertal,23,,9,4,13
103 Taufers im Münstertal,24,,5,4,9
103 Taufers im Münstertal,25,,12,1,13
103 Taufers im Münstertal,26,,7,7,14
103 Taufers im Münstertal,27,,2,5,7
103 Taufers im Münstertal,28,,5,8,13
103 Taufers im Münstertal,29,,8,13,21
103 Taufers im Münstertal,30,,6,7,13
103 Taufers im Münstertal,31,,10,7,17
103 Taufers im Münstertal,32,,9,10,19
103 Taufers im Münstertal,33,,4,6,10
103 Taufers im Münstertal,34,,9,10,19
103 Taufers im Münstertal,35,,14,8,22
103 Taufers im Münstertal,36,,8,12,20
103 Taufers im Münstertal,37,,12,10,22
103 Taufers im Münstertal,38,,11,10,21
103 Taufers im Münstertal,39,,9,8,17
103 Taufers im Münstertal,40,,14,7,21
103 Taufers im Münstertal,41,,6,9,15
103 Taufers im Münstertal,42,,5,6,11
103 Taufers im Münstertal,43,,9,6,15
103 Taufers im Münstertal,44,,11,10,21
103 Taufers im Münstertal,45,,3,3,6
103 Taufers im Münstertal,46,,3,6,9
103 Taufers im Münstertal,47,,6,3,9
103 Taufers im Münstertal,48,,6,2,8
103 Taufers im Münstertal,49,,5,4,9
103 Taufers im Münstertal,50,,7,1,8
103 Taufers im Münstertal,51,,6,1,7
103 Taufers im Münstertal,52,,6,1,7
103 Taufers im Münstertal,53,,4,7,11
103 Taufers im Münstertal,54,,3,3,6
103 Taufers im Münstertal,55,,2,3,5
103 Taufers im Münstertal,56,,1,-,1
103 Taufers im Münstertal,57,,7,5,12
103 Taufers im Münstertal,58,,5,5,10
103 Taufers im Münstertal,59,,4,6,10
103 Taufers im Münstertal,60,,4,3,7
103 Taufers im Münstertal,61,,4,4,8
103 Taufers im Münstertal,62,,8,9,17
103 Taufers im Münstertal,63,,3,5,8
103 Taufers im Münstertal,64,,2,8,10
103 Taufers im Münstertal,65,,7,2,9
103 Taufers im Münstertal,66,,4,8,12
103 Taufers im Münstertal,67,,6,5,11
103 Taufers im Münstertal,68,,6,2,8
103 Taufers im Münstertal,69,,9,3,12
103 Taufers im Münstertal,70,,3,4,7
103 Taufers im Münstertal,71,,4,6,10
103 Taufers im Münstertal,72,,4,3,7
103 Taufers im Münstertal,73,,3,3,6
103 Taufers im Münstertal,74,,3,5,8
103 Taufers im Münstertal,75,,1,6,7
103 Taufers im Münstertal,76,,1,7,8
103 Taufers im Münstertal,77,,4,6,10
103 Taufers im Münstertal,78,,2,3,5
103 Taufers im Münstertal,79,,4,-,4
103 Taufers im Münstertal,80,,3,2,5
103 Taufers im Münstertal,81,,2,4,6
103 Taufers im Münstertal,82,,-,1,1
103 Taufers im Münstertal,83,,2,5,7
103 Taufers im Münstertal,84,,1,1,2
103 Taufers im Münstertal,85,,2,2,4
103 Taufers im Münstertal,86,,1,-,1
103 Taufers im Münstertal,87,,-,1,1
103 Taufers im Münstertal,88,,-,2,2
103 Taufers im Münstertal,90,,1,1,2
103 Taufers im Münstertal,91,,-,2,2
103 Taufers im Münstertal,92,,-,3,3
103 Taufers im Münstertal,96,,-,1,1
103 Taufers im Münstertal,99,,-,1,1
104 Ulten,0,,20,20,40
104 Ulten,1,,15,14,29
104 Ulten,2,,18,18,36
104 Ulten,3,,16,20,36
104 Ulten,4,,11,12,23
104 Ulten,5,,12,17,29
104 Ulten,6,,19,16,35
104 Ulten,7,,23,15,38
104 Ulten,8,,16,17,33
104 Ulten,9,,24,31,55
104 Ulten,10,,17,18,35
104 Ulten,11,,18,29,47
104 Ulten,12,,18,19,37
104 Ulten,13,,20,17,37
104 Ulten,14,,22,11,33
104 Ulten,15,,14,16,30
104 Ulten,16,,21,22,43
104 Ulten,17,,22,20,42
104 Ulten,18,,15,27,42
104 Ulten,19,,19,18,37
104 Ulten,20,,20,21,41
104 Ulten,21,,18,18,36
104 Ulten,22,,22,16,38
104 Ulten,23,,24,12,36
104 Ulten,24,,17,23,40
104 Ulten,25,,24,25,49
104 Ulten,26,,22,30,52
104 Ulten,27,,27,20,47
104 Ulten,28,,25,24,49
104 Ulten,29,,27,21,48
104 Ulten,30,,23,31,54
104 Ulten,31,,30,19,49
104 Ulten,32,,27,27,54
104 Ulten,33,,13,24,37
104 Ulten,34,,21,19,40
104 Ulten,35,,25,26,51
104 Ulten,36,,26,21,47
104 Ulten,37,,29,26,55
104 Ulten,38,,32,24,56
104 Ulten,39,,30,18,48
104 Ulten,40,,26,21,47
104 Ulten,41,,24,21,45
104 Ulten,42,,28,16,44
104 Ulten,43,,37,23,60
104 Ulten,44,,18,15,33
104 Ulten,45,,14,13,27
104 Ulten,46,,19,18,37
104 Ulten,47,,24,14,38
104 Ulten,48,,17,13,30
104 Ulten,49,,20,18,38
104 Ulten,50,,21,14,35
104 Ulten,51,,17,10,27
104 Ulten,52,,13,13,26
104 Ulten,53,,17,8,25
104 Ulten,54,,16,16,32
104 Ulten,55,,9,12,21
104 Ulten,56,,14,20,34
104 Ulten,57,,17,16,33
104 Ulten,58,,11,19,30
104 Ulten,59,,14,13,27
104 Ulten,60,,17,10,27
104 Ulten,61,,21,16,37
104 Ulten,62,,8,11,19
104 Ulten,63,,11,11,22
104 Ulten,64,,9,10,19
104 Ulten,65,,11,13,24
104 Ulten,66,,12,14,26
104 Ulten,67,,5,14,19
104 Ulten,68,,15,8,23
104 Ulten,69,,11,9,20
104 Ulten,70,,16,17,33
104 Ulten,71,,7,16,23
104 Ulten,72,,10,17,27
104 Ulten,73,,13,20,33
104 Ulten,74,,10,14,24
104 Ulten,75,,16,14,30
104 Ulten,76,,12,11,23
104 Ulten,77,,12,26,38
104 Ulten,78,,10,12,22
104 Ulten,79,,9,16,25
104 Ulten,80,,9,14,23
104 Ulten,81,,3,14,17
104 Ulten,82,,3,5,8
104 Ulten,83,,1,3,4
104 Ulten,84,,-,4,4
104 Ulten,85,,3,1,4
104 Ulten,86,,3,10,13
104 Ulten,87,,4,6,10
104 Ulten,88,,2,5,7
104 Ulten,89,,3,7,10
104 Ulten,90,,2,6,8
104 Ulten,91,,2,2,4
104 Ulten,92,,1,2,3
104 Ulten,93,,1,1,2
104 Ulten,95,,1,1,2
104 Ulten,102,,-,1,1
105 Pfatten,0,,2,5,7
105 Pfatten,1,,5,5,10
105 Pfatten,2,,10,3,13
105 Pfatten,3,,2,-,2
105 Pfatten,4,,6,6,12
105 Pfatten,5,,4,3,7
105 Pfatten,6,,11,11,22
105 Pfatten,7,,3,4,7
105 Pfatten,8,,6,6,12
105 Pfatten,9,,6,5,11
105 Pfatten,10,,9,7,16
105 Pfatten,11,,5,6,11
105 Pfatten,12,,2,6,8
105 Pfatten,13,,6,5,11
105 Pfatten,14,,4,8,12
105 Pfatten,15,,4,6,10
105 Pfatten,16,,4,5,9
105 Pfatten,17,,3,3,6
105 Pfatten,18,,7,2,9
105 Pfatten,19,,7,2,9
105 Pfatten,20,,1,5,6
105 Pfatten,21,,2,5,7
105 Pfatten,22,,5,3,8
105 Pfatten,23,,4,2,6
105 Pfatten,24,,9,4,13
105 Pfatten,25,,2,6,8
105 Pfatten,26,,5,7,12
105 Pfatten,27,,6,7,13
105 Pfatten,28,,7,8,15
105 Pfatten,29,,9,7,16
105 Pfatten,30,,8,6,14
105 Pfatten,31,,5,5,10
105 Pfatten,32,,3,8,11
105 Pfatten,33,,12,3,15
105 Pfatten,34,,10,7,17
105 Pfatten,35,,13,8,21
105 Pfatten,36,,7,6,13
105 Pfatten,37,,7,9,16
105 Pfatten,38,,10,13,23
105 Pfatten,39,,9,14,23
105 Pfatten,40,,6,12,18
105 Pfatten,41,,5,12,17
105 Pfatten,42,,7,7,14
105 Pfatten,43,,14,6,20
105 Pfatten,44,,9,7,16
105 Pfatten,45,,9,4,13
105 Pfatten,46,,12,2,14
105 Pfatten,47,,7,6,13
105 Pfatten,48,,3,6,9
105 Pfatten,49,,4,2,6
105 Pfatten,50,,4,7,11
105 Pfatten,51,,5,2,7
105 Pfatten,52,,3,2,5
105 Pfatten,53,,4,9,13
105 Pfatten,54,,6,6,12
105 Pfatten,55,,5,4,9
105 Pfatten,56,,4,2,6
105 Pfatten,57,,2,2,4
105 Pfatten,58,,5,2,7
105 Pfatten,59,,5,6,11
105 Pfatten,60,,2,4,6
105 Pfatten,61,,4,1,5
105 Pfatten,62,,3,4,7
105 Pfatten,63,,5,1,6
105 Pfatten,64,,3,5,8
105 Pfatten,65,,5,2,7
105 Pfatten,66,,3,6,9
105 Pfatten,67,,2,3,5
105 Pfatten,68,,-,4,4
105 Pfatten,69,,2,4,6
105 Pfatten,70,,2,3,5
105 Pfatten,71,,-,6,6
105 Pfatten,72,,-,1,1
105 Pfatten,73,,2,-,2
105 Pfatten,74,,3,4,7
105 Pfatten,75,,2,4,6
105 Pfatten,76,,2,5,7
105 Pfatten,77,,3,2,5
105 Pfatten,78,,3,1,4
105 Pfatten,79,,1,1,2
105 Pfatten,80,,1,1,2
105 Pfatten,81,,1,-,1
105 Pfatten,82,,-,1,1
105 Pfatten,83,,1,1,2
105 Pfatten,84,,-,2,2
105 Pfatten,85,,-,2,2
105 Pfatten,86,,1,1,2
105 Pfatten,87,,1,2,3
105 Pfatten,88,,-,2,2
105 Pfatten,91,,1,-,1
105 Pfatten,93,,-,2,2
106 Olang,0,,17,18,35
106 Olang,1,,19,16,35
106 Olang,2,,17,18,35
106 Olang,3,,21,19,40
106 Olang,4,,27,21,48
106 Olang,5,,19,9,28
106 Olang,6,,19,12,31
106 Olang,7,,20,23,43
106 Olang,8,,14,15,29
106 Olang,9,,25,17,42
106 Olang,10,,22,25,47
106 Olang,11,,17,20,37
106 Olang,12,,15,17,32
106 Olang,13,,23,18,41
106 Olang,14,,17,17,34
106 Olang,15,,13,22,35
106 Olang,16,,21,14,35
106 Olang,17,,17,21,38
106 Olang,18,,20,23,43
106 Olang,19,,17,24,41
106 Olang,20,,21,28,49
106 Olang,21,,19,17,36
106 Olang,22,,20,16,36
106 Olang,23,,26,26,52
106 Olang,24,,19,22,41
106 Olang,25,,23,24,47
106 Olang,26,,14,28,42
106 Olang,27,,32,27,59
106 Olang,28,,24,18,42
106 Olang,29,,28,19,47
106 Olang,30,,21,20,41
106 Olang,31,,20,26,46
106 Olang,32,,26,27,53
106 Olang,33,,26,23,49
106 Olang,34,,26,23,49
106 Olang,35,,17,25,42
106 Olang,36,,16,30,46
106 Olang,37,,23,21,44
106 Olang,38,,26,12,38
106 Olang,39,,16,28,44
106 Olang,40,,22,24,46
106 Olang,41,,23,17,40
106 Olang,42,,21,14,35
106 Olang,43,,27,14,41
106 Olang,44,,14,27,41
106 Olang,45,,15,18,33
106 Olang,46,,14,18,32
106 Olang,47,,15,19,34
106 Olang,48,,19,13,32
106 Olang,49,,10,12,22
106 Olang,50,,31,16,47
106 Olang,51,,25,12,37
106 Olang,52,,19,21,40
106 Olang,53,,15,24,39
106 Olang,54,,17,13,30
106 Olang,55,,19,10,29
106 Olang,56,,15,7,22
106 Olang,57,,10,17,27
106 Olang,58,,14,15,29
106 Olang,59,,16,14,30
106 Olang,60,,17,11,28
106 Olang,61,,11,9,20
106 Olang,62,,8,14,22
106 Olang,63,,10,10,20
106 Olang,64,,10,8,18
106 Olang,65,,9,15,24
106 Olang,66,,11,9,20
106 Olang,67,,10,14,24
106 Olang,68,,10,14,24
106 Olang,69,,6,6,12
106 Olang,70,,17,8,25
106 Olang,71,,12,13,25
106 Olang,72,,6,9,15
106 Olang,73,,8,11,19
106 Olang,74,,8,12,20
106 Olang,75,,4,6,10
106 Olang,76,,5,8,13
106 Olang,77,,8,5,13
106 Olang,78,,6,6,12
106 Olang,79,,6,5,11
106 Olang,80,,4,7,11
106 Olang,81,,2,5,7
106 Olang,82,,-,2,2
106 Olang,83,,1,3,4
106 Olang,84,,1,1,2
106 Olang,85,,4,8,12
106 Olang,86,,1,5,6
106 Olang,87,,-,3,3
106 Olang,88,,1,4,5
106 Olang,89,,1,5,6
106 Olang,90,,1,2,3
106 Olang,91,,1,1,2
106 Olang,92,,1,-,1
106 Olang,93,,1,1,2
106 Olang,94,,1,-,1
106 Olang,97,,-,1,1
107 Pfitsch,0,,21,23,44
107 Pfitsch,1,,17,14,31
107 Pfitsch,2,,8,20,28
107 Pfitsch,3,,14,11,25
107 Pfitsch,4,,11,15,26
107 Pfitsch,5,,15,10,25
107 Pfitsch,6,,12,19,31
107 Pfitsch,7,,18,12,30
107 Pfitsch,8,,14,15,29
107 Pfitsch,9,,19,12,31
107 Pfitsch,10,,19,17,36
107 Pfitsch,11,,11,20,31
107 Pfitsch,12,,14,14,28
107 Pfitsch,13,,13,19,32
107 Pfitsch,14,,15,9,24
107 Pfitsch,15,,15,10,25
107 Pfitsch,16,,25,12,37
107 Pfitsch,17,,23,20,43
107 Pfitsch,18,,30,13,43
107 Pfitsch,19,,24,17,41
107 Pfitsch,20,,20,23,43
107 Pfitsch,21,,29,21,50
107 Pfitsch,22,,23,15,38
107 Pfitsch,23,,18,19,37
107 Pfitsch,24,,19,18,37
107 Pfitsch,25,,18,19,37
107 Pfitsch,26,,14,21,35
107 Pfitsch,27,,19,15,34
107 Pfitsch,28,,18,18,36
107 Pfitsch,29,,22,18,40
107 Pfitsch,30,,28,16,44
107 Pfitsch,31,,24,25,49
107 Pfitsch,32,,21,24,45
107 Pfitsch,33,,21,19,40
107 Pfitsch,34,,26,18,44
107 Pfitsch,35,,24,17,41
107 Pfitsch,36,,14,25,39
107 Pfitsch,37,,16,17,33
107 Pfitsch,38,,27,25,52
107 Pfitsch,39,,22,20,42
107 Pfitsch,40,,17,25,42
107 Pfitsch,41,,18,18,36
107 Pfitsch,42,,25,18,43
107 Pfitsch,43,,25,24,49
107 Pfitsch,44,,19,15,34
107 Pfitsch,45,,17,16,33
107 Pfitsch,46,,22,23,45
107 Pfitsch,47,,21,14,35
107 Pfitsch,48,,19,23,42
107 Pfitsch,49,,22,14,36
107 Pfitsch,50,,23,17,40
107 Pfitsch,51,,18,20,38
107 Pfitsch,52,,9,10,19
107 Pfitsch,53,,11,14,25
107 Pfitsch,54,,15,13,28
107 Pfitsch,55,,14,12,26
107 Pfitsch,56,,12,17,29
107 Pfitsch,57,,22,11,33
107 Pfitsch,58,,26,13,39
107 Pfitsch,59,,17,17,34
107 Pfitsch,60,,13,16,29
107 Pfitsch,61,,15,9,24
107 Pfitsch,62,,4,14,18
107 Pfitsch,63,,9,12,21
107 Pfitsch,64,,9,13,22
107 Pfitsch,65,,10,8,18
107 Pfitsch,66,,12,5,17
107 Pfitsch,67,,11,13,24
107 Pfitsch,68,,3,16,19
107 Pfitsch,69,,11,14,25
107 Pfitsch,70,,9,14,23
107 Pfitsch,71,,17,13,30
107 Pfitsch,72,,7,14,21
107 Pfitsch,73,,11,13,24
107 Pfitsch,74,,6,13,19
107 Pfitsch,75,,12,10,22
107 Pfitsch,76,,4,19,23
107 Pfitsch,77,,9,14,23
107 Pfitsch,78,,9,7,16
107 Pfitsch,79,,7,7,14
107 Pfitsch,80,,2,7,9
107 Pfitsch,81,,3,7,10
107 Pfitsch,82,,-,3,3
107 Pfitsch,83,,2,4,6
107 Pfitsch,84,,1,3,4
107 Pfitsch,85,,2,6,8
107 Pfitsch,86,,-,3,3
107 Pfitsch,87,,1,2,3
107 Pfitsch,88,,-,3,3
107 Pfitsch,89,,1,2,3
107 Pfitsch,90,,2,-,2
107 Pfitsch,91,,1,3,4
107 Pfitsch,92,,-,5,5
107 Pfitsch,93,,1,1,2
107 Pfitsch,95,,-,2,2
107 Pfitsch,99,,-,1,1
108 Ahrntal,0,,48,41,89
108 Ahrntal,1,,35,38,73
108 Ahrntal,2,,38,36,74
108 Ahrntal,3,,41,44,85
108 Ahrntal,4,,41,50,91
108 Ahrntal,5,,36,31,67
108 Ahrntal,6,,26,27,53
108 Ahrntal,7,,41,40,81
108 Ahrntal,8,,42,32,74
108 Ahrntal,9,,28,36,64
108 Ahrntal,10,,41,32,73
108 Ahrntal,11,,38,33,71
108 Ahrntal,12,,28,33,61
108 Ahrntal,13,,38,39,77
108 Ahrntal,14,,38,50,88
108 Ahrntal,15,,35,44,79
108 Ahrntal,16,,41,33,74
108 Ahrntal,17,,45,48,93
108 Ahrntal,18,,39,45,84
108 Ahrntal,19,,48,42,90
108 Ahrntal,20,,38,39,77
108 Ahrntal,21,,45,39,84
108 Ahrntal,22,,32,46,78
108 Ahrntal,23,,49,47,96
108 Ahrntal,24,,45,49,94
108 Ahrntal,25,,46,48,94
108 Ahrntal,26,,49,49,98
108 Ahrntal,27,,47,48,95
108 Ahrntal,28,,56,55,111
108 Ahrntal,29,,73,44,117
108 Ahrntal,30,,54,45,99
108 Ahrntal,31,,52,52,104
108 Ahrntal,32,,53,53,106
108 Ahrntal,33,,49,50,99
108 Ahrntal,34,,63,38,101
108 Ahrntal,35,,56,46,102
108 Ahrntal,36,,55,45,100
108 Ahrntal,37,,46,47,93
108 Ahrntal,38,,40,49,89
108 Ahrntal,39,,35,37,72
108 Ahrntal,40,,40,31,71
108 Ahrntal,41,,44,37,81
108 Ahrntal,42,,49,25,74
108 Ahrntal,43,,27,40,67
108 Ahrntal,44,,37,20,57
108 Ahrntal,45,,35,26,61
108 Ahrntal,46,,33,22,55
108 Ahrntal,47,,28,30,58
108 Ahrntal,48,,28,30,58
108 Ahrntal,49,,35,26,61
108 Ahrntal,50,,32,24,56
108 Ahrntal,51,,32,31,63
108 Ahrntal,52,,30,29,59
108 Ahrntal,53,,26,16,42
108 Ahrntal,54,,16,22,38
108 Ahrntal,55,,20,14,34
108 Ahrntal,56,,20,18,38
108 Ahrntal,57,,23,32,55
108 Ahrntal,58,,29,30,59
108 Ahrntal,59,,30,32,62
108 Ahrntal,60,,31,24,55
108 Ahrntal,61,,27,23,50
108 Ahrntal,62,,37,30,67
108 Ahrntal,63,,26,23,49
108 Ahrntal,64,,22,16,38
108 Ahrntal,65,,23,37,60
108 Ahrntal,66,,22,20,42
108 Ahrntal,67,,20,18,38
108 Ahrntal,68,,22,27,49
108 Ahrntal,69,,35,23,58
108 Ahrntal,70,,22,21,43
108 Ahrntal,71,,21,17,38
108 Ahrntal,72,,14,26,40
108 Ahrntal,73,,18,18,36
108 Ahrntal,74,,20,14,34
108 Ahrntal,75,,14,18,32
108 Ahrntal,76,,13,18,31
108 Ahrntal,77,,10,14,24
108 Ahrntal,78,,10,16,26
108 Ahrntal,79,,7,10,17
108 Ahrntal,80,,4,6,10
108 Ahrntal,81,,9,4,13
108 Ahrntal,82,,-,8,8
108 Ahrntal,83,,3,5,8
108 Ahrntal,84,,-,3,3
108 Ahrntal,85,,2,11,13
108 Ahrntal,86,,8,10,18
108 Ahrntal,87,,3,5,8
108 Ahrntal,88,,3,8,11
108 Ahrntal,89,,-,5,5
108 Ahrntal,90,,3,2,5
108 Ahrntal,91,,3,3,6
108 Ahrntal,92,,-,5,5
108 Ahrntal,93,,-,2,2
108 Ahrntal,94,,-,1,1
108 Ahrntal,95,,1,2,3
108 Ahrntal,97,,-,1,1
109 Gsies,0,,10,10,20
109 Gsies,1,,22,14,36
109 Gsies,2,,19,6,25
109 Gsies,3,,12,15,27
109 Gsies,4,,11,18,29
109 Gsies,5,,15,14,29
109 Gsies,6,,10,19,29
109 Gsies,7,,17,19,36
109 Gsies,8,,16,10,26
109 Gsies,9,,16,25,41
109 Gsies,10,,16,13,29
109 Gsies,11,,9,12,21
109 Gsies,12,,7,14,21
109 Gsies,13,,18,17,35
109 Gsies,14,,12,17,29
109 Gsies,15,,17,13,30
109 Gsies,16,,12,8,20
109 Gsies,17,,17,10,27
109 Gsies,18,,18,19,37
109 Gsies,19,,14,18,32
109 Gsies,20,,24,21,45
109 Gsies,21,,10,16,26
109 Gsies,22,,14,15,29
109 Gsies,23,,17,18,35
109 Gsies,24,,15,17,32
109 Gsies,25,,20,29,49
109 Gsies,26,,22,18,40
109 Gsies,27,,17,16,33
109 Gsies,28,,9,18,27
109 Gsies,29,,22,22,44
109 Gsies,30,,29,15,44
109 Gsies,31,,27,12,39
109 Gsies,32,,16,15,31
109 Gsies,33,,16,13,29
109 Gsies,34,,14,19,33
109 Gsies,35,,22,6,28
109 Gsies,36,,15,17,32
109 Gsies,37,,14,16,30
109 Gsies,38,,17,8,25
109 Gsies,39,,9,13,22
109 Gsies,40,,18,16,34
109 Gsies,41,,12,14,26
109 Gsies,42,,16,15,31
109 Gsies,43,,12,14,26
109 Gsies,44,,17,7,24
109 Gsies,45,,17,11,28
109 Gsies,46,,16,6,22
109 Gsies,47,,17,6,23
109 Gsies,48,,17,11,28
109 Gsies,49,,16,13,29
109 Gsies,50,,8,8,16
109 Gsies,51,,15,15,30
109 Gsies,52,,9,10,19
109 Gsies,53,,22,7,29
109 Gsies,54,,15,10,25
109 Gsies,55,,4,11,15
109 Gsies,56,,9,13,22
109 Gsies,57,,10,9,19
109 Gsies,58,,6,13,19
109 Gsies,59,,6,11,17
109 Gsies,60,,9,11,20
109 Gsies,61,,6,9,15
109 Gsies,62,,7,9,16
109 Gsies,63,,11,8,19
109 Gsies,64,,4,10,14
109 Gsies,65,,5,9,14
109 Gsies,66,,6,9,15
109 Gsies,67,,6,5,11
109 Gsies,68,,10,6,16
109 Gsies,69,,7,10,17
109 Gsies,70,,12,6,18
109 Gsies,71,,4,6,10
109 Gsies,72,,8,9,17
109 Gsies,73,,3,11,14
109 Gsies,74,,4,4,8
109 Gsies,75,,8,5,13
109 Gsies,76,,5,7,12
109 Gsies,77,,6,8,14
109 Gsies,78,,10,8,18
109 Gsies,79,,3,11,14
109 Gsies,80,,4,4,8
109 Gsies,81,,4,2,6
109 Gsies,82,,1,2,3
109 Gsies,83,,1,2,3
109 Gsies,84,,1,1,2
109 Gsies,85,,3,1,4
109 Gsies,86,,2,3,5
109 Gsies,87,,1,3,4
109 Gsies,88,,5,6,11
109 Gsies,89,,1,4,5
109 Gsies,90,,-,1,1
109 Gsies,91,,1,1,2
109 Gsies,92,,-,3,3
109 Gsies,93,,-,3,3
109 Gsies,95,,1,1,2
110 Vintl,0,,21,15,36
110 Vintl,1,,21,20,41
110 Vintl,2,,24,30,54
110 Vintl,3,,19,18,37
110 Vintl,4,,22,18,40
110 Vintl,5,,36,26,62
110 Vintl,6,,19,18,37
110 Vintl,7,,23,21,44
110 Vintl,8,,29,21,50
110 Vintl,9,,21,30,51
110 Vintl,10,,28,22,50
110 Vintl,11,,26,16,42
110 Vintl,12,,21,19,40
110 Vintl,13,,20,23,43
110 Vintl,14,,21,19,40
110 Vintl,15,,10,15,25
110 Vintl,16,,27,10,37
110 Vintl,17,,24,17,41
110 Vintl,18,,21,21,42
110 Vintl,19,,20,25,45
110 Vintl,20,,33,20,53
110 Vintl,21,,33,16,49
110 Vintl,22,,20,33,53
110 Vintl,23,,17,25,42
110 Vintl,24,,20,23,43
110 Vintl,25,,26,22,48
110 Vintl,26,,27,28,55
110 Vintl,27,,20,22,42
110 Vintl,28,,34,24,58
110 Vintl,29,,30,26,56
110 Vintl,30,,19,22,41
110 Vintl,31,,29,23,52
110 Vintl,32,,24,22,46
110 Vintl,33,,31,36,67
110 Vintl,34,,33,31,64
110 Vintl,35,,34,34,68
110 Vintl,36,,35,26,61
110 Vintl,37,,30,27,57
110 Vintl,38,,32,24,56
110 Vintl,39,,27,31,58
110 Vintl,40,,18,24,42
110 Vintl,41,,25,23,48
110 Vintl,42,,18,11,29
110 Vintl,43,,24,28,52
110 Vintl,44,,25,19,44
110 Vintl,45,,19,15,34
110 Vintl,46,,16,20,36
110 Vintl,47,,23,9,32
110 Vintl,48,,18,19,37
110 Vintl,49,,22,18,40
110 Vintl,50,,25,18,43
110 Vintl,51,,19,18,37
110 Vintl,52,,13,13,26
110 Vintl,53,,21,14,35
110 Vintl,54,,15,13,28
110 Vintl,55,,18,18,36
110 Vintl,56,,11,5,16
110 Vintl,57,,21,12,33
110 Vintl,58,,11,13,24
110 Vintl,59,,6,16,22
110 Vintl,60,,8,20,28
110 Vintl,61,,18,15,33
110 Vintl,62,,12,5,17
110 Vintl,63,,10,9,19
110 Vintl,64,,14,10,24
110 Vintl,65,,9,12,21
110 Vintl,66,,16,8,24
110 Vintl,67,,6,18,24
110 Vintl,68,,12,15,27
110 Vintl,69,,12,12,24
110 Vintl,70,,9,15,24
110 Vintl,71,,11,16,27
110 Vintl,72,,13,10,23
110 Vintl,73,,9,15,24
110 Vintl,74,,15,9,24
110 Vintl,75,,7,9,16
110 Vintl,76,,9,10,19
110 Vintl,77,,13,12,25
110 Vintl,78,,4,8,12
110 Vintl,79,,8,8,16
110 Vintl,80,,2,8,10
110 Vintl,81,,2,6,8
110 Vintl,82,,1,2,3
110 Vintl,83,,2,4,6
110 Vintl,84,,2,3,5
110 Vintl,85,,1,4,5
110 Vintl,86,,2,6,8
110 Vintl,87,,-,7,7
110 Vintl,88,,1,1,2
110 Vintl,89,,-,6,6
110 Vintl,90,,1,2,3
110 Vintl,91,,-,1,1
110 Vintl,92,,2,2,4
110 Vintl,93,,1,2,3
111 Vahrn,0,,26,20,46
111 Vahrn,1,,24,37,61
111 Vahrn,2,,25,17,42
111 Vahrn,3,,22,21,43
111 Vahrn,4,,33,20,53
111 Vahrn,5,,21,18,39
111 Vahrn,6,,20,24,44
111 Vahrn,7,,20,19,39
111 Vahrn,8,,17,22,39
111 Vahrn,9,,21,20,41
111 Vahrn,10,,16,23,39
111 Vahrn,11,,29,20,49
111 Vahrn,12,,22,20,42
111 Vahrn,13,,19,18,37
111 Vahrn,14,,19,13,32
111 Vahrn,15,,26,28,54
111 Vahrn,16,,20,21,41
111 Vahrn,17,,25,25,50
111 Vahrn,18,,24,26,50
111 Vahrn,19,,28,17,45
111 Vahrn,20,,20,23,43
111 Vahrn,21,,17,27,44
111 Vahrn,22,,21,21,42
111 Vahrn,23,,15,25,40
111 Vahrn,24,,38,23,61
111 Vahrn,25,,32,23,55
111 Vahrn,26,,22,37,59
111 Vahrn,27,,35,36,71
111 Vahrn,28,,31,32,63
111 Vahrn,29,,38,38,76
111 Vahrn,30,,35,33,68
111 Vahrn,31,,32,40,72
111 Vahrn,32,,30,34,64
111 Vahrn,33,,45,23,68
111 Vahrn,34,,36,30,66
111 Vahrn,35,,40,39,79
111 Vahrn,36,,44,36,80
111 Vahrn,37,,33,31,64
111 Vahrn,38,,33,35,68
111 Vahrn,39,,23,21,44
111 Vahrn,40,,32,28,60
111 Vahrn,41,,27,21,48
111 Vahrn,42,,21,19,40
111 Vahrn,43,,29,33,62
111 Vahrn,44,,22,19,41
111 Vahrn,45,,31,28,59
111 Vahrn,46,,24,31,55
111 Vahrn,47,,23,26,49
111 Vahrn,48,,22,18,40
111 Vahrn,49,,21,11,32
111 Vahrn,50,,18,17,35
111 Vahrn,51,,22,28,50
111 Vahrn,52,,19,13,32
111 Vahrn,53,,17,21,38
111 Vahrn,54,,19,24,43
111 Vahrn,55,,10,16,26
111 Vahrn,56,,18,23,41
111 Vahrn,57,,24,20,44
111 Vahrn,58,,20,21,41
111 Vahrn,59,,21,25,46
111 Vahrn,60,,20,15,35
111 Vahrn,61,,20,20,40
111 Vahrn,62,,14,9,23
111 Vahrn,63,,16,18,34
111 Vahrn,64,,13,17,30
111 Vahrn,65,,12,15,27
111 Vahrn,66,,11,15,26
111 Vahrn,67,,9,14,23
111 Vahrn,68,,12,16,28
111 Vahrn,69,,12,15,27
111 Vahrn,70,,15,16,31
111 Vahrn,71,,8,17,25
111 Vahrn,72,,10,12,22
111 Vahrn,73,,9,20,29
111 Vahrn,74,,10,5,15
111 Vahrn,75,,6,16,22
111 Vahrn,76,,8,18,26
111 Vahrn,77,,9,12,21
111 Vahrn,78,,6,13,19
111 Vahrn,79,,8,9,17
111 Vahrn,80,,3,4,7
111 Vahrn,81,,2,3,5
111 Vahrn,82,,4,4,8
111 Vahrn,83,,3,5,8
111 Vahrn,84,,1,-,1
111 Vahrn,85,,-,5,5
111 Vahrn,86,,3,4,7
111 Vahrn,87,,1,4,5
111 Vahrn,88,,1,7,8
111 Vahrn,89,,1,3,4
111 Vahrn,90,,-,3,3
111 Vahrn,91,,-,1,1
111 Vahrn,92,,-,2,2
111 Vahrn,94,,-,1,1
111 Vahrn,95,,-,1,1
111 Vahrn,96,,-,1,1
111 Vahrn,98,,1,-,1
112 Vöran,0,,12,6,18
112 Vöran,1,,6,2,8
112 Vöran,2,,6,5,11
112 Vöran,3,,13,5,18
112 Vöran,4,,9,6,15
112 Vöran,5,,5,9,14
112 Vöran,6,,6,8,14
112 Vöran,7,,7,7,14
112 Vöran,8,,6,3,9
112 Vöran,9,,8,3,11
112 Vöran,10,,6,7,13
112 Vöran,11,,12,5,17
112 Vöran,12,,8,7,15
112 Vöran,13,,13,6,19
112 Vöran,14,,6,7,13
112 Vöran,15,,9,13,22
112 Vöran,16,,9,4,13
112 Vöran,17,,6,6,12
112 Vöran,18,,7,9,16
112 Vöran,19,,10,9,19
112 Vöran,20,,4,5,9
112 Vöran,21,,4,6,10
112 Vöran,22,,10,9,19
112 Vöran,23,,13,6,19
112 Vöran,24,,6,4,10
112 Vöran,25,,6,7,13
112 Vöran,26,,10,8,18
112 Vöran,27,,8,5,13
112 Vöran,28,,10,8,18
112 Vöran,29,,7,12,19
112 Vöran,30,,9,6,15
112 Vöran,31,,6,3,9
112 Vöran,32,,16,2,18
112 Vöran,33,,6,5,11
112 Vöran,34,,8,7,15
112 Vöran,35,,4,4,8
112 Vöran,36,,10,4,14
112 Vöran,37,,8,7,15
112 Vöran,38,,12,15,27
112 Vöran,39,,7,6,13
112 Vöran,40,,8,6,14
112 Vöran,41,,5,7,12
112 Vöran,42,,7,4,11
112 Vöran,43,,3,9,12
112 Vöran,44,,2,2,4
112 Vöran,45,,5,2,7
112 Vöran,46,,6,6,12
112 Vöran,47,,5,4,9
112 Vöran,48,,9,2,11
112 Vöran,49,,2,-,2
112 Vöran,50,,7,4,11
112 Vöran,51,,6,4,10
112 Vöran,52,,2,3,5
112 Vöran,53,,6,4,10
112 Vöran,54,,4,2,6
112 Vöran,55,,-,3,3
112 Vöran,56,,4,3,7
112 Vöran,57,,3,5,8
112 Vöran,58,,6,4,10
112 Vöran,59,,4,6,10
112 Vöran,60,,2,5,7
112 Vöran,61,,3,3,6
112 Vöran,62,,8,4,12
112 Vöran,63,,2,2,4
112 Vöran,64,,4,4,8
112 Vöran,65,,2,1,3
112 Vöran,66,,1,7,8
112 Vöran,67,,6,6,12
112 Vöran,68,,3,5,8
112 Vöran,69,,5,1,6
112 Vöran,70,,5,1,6
112 Vöran,71,,1,3,4
112 Vöran,72,,5,1,6
112 Vöran,73,,-,2,2
112 Vöran,74,,-,3,3
112 Vöran,75,,3,4,7
112 Vöran,76,,-,2,2
112 Vöran,77,,2,1,3
112 Vöran,78,,2,-,2
112 Vöran,79,,3,1,4
112 Vöran,80,,-,2,2
112 Vöran,81,,-,1,1
112 Vöran,84,,1,2,3
112 Vöran,87,,-,1,1
112 Vöran,88,,-,1,1
112 Vöran,90,,-,1,1
112 Vöran,91,,-,1,1
112 Vöran,96,,-,1,1
113 Niederdorf,0,,11,10,21
113 Niederdorf,1,,5,6,11
113 Niederdorf,2,,6,7,13
113 Niederdorf,3,,8,10,18
113 Niederdorf,4,,7,8,15
113 Niederdorf,5,,6,11,17
113 Niederdorf,6,,12,7,19
113 Niederdorf,7,,9,8,17
113 Niederdorf,8,,7,9,16
113 Niederdorf,9,,7,13,20
113 Niederdorf,10,,14,10,24
113 Niederdorf,11,,9,7,16
113 Niederdorf,12,,6,9,15
113 Niederdorf,13,,2,10,12
113 Niederdorf,14,,4,6,10
113 Niederdorf,15,,8,5,13
113 Niederdorf,16,,9,5,14
113 Niederdorf,17,,7,8,15
113 Niederdorf,18,,3,12,15
113 Niederdorf,19,,10,7,17
113 Niederdorf,20,,9,4,13
113 Niederdorf,21,,9,4,13
113 Niederdorf,22,,4,4,8
113 Niederdorf,23,,6,4,10
113 Niederdorf,24,,12,5,17
113 Niederdorf,25,,6,10,16
113 Niederdorf,26,,10,9,19
113 Niederdorf,27,,11,7,18
113 Niederdorf,28,,14,7,21
113 Niederdorf,29,,10,13,23
113 Niederdorf,30,,12,13,25
113 Niederdorf,31,,19,13,32
113 Niederdorf,32,,14,14,28
113 Niederdorf,33,,15,14,29
113 Niederdorf,34,,23,10,33
113 Niederdorf,35,,10,16,26
113 Niederdorf,36,,19,13,32
113 Niederdorf,37,,12,9,21
113 Niederdorf,38,,19,9,28
113 Niederdorf,39,,13,12,25
113 Niederdorf,40,,9,10,19
113 Niederdorf,41,,12,9,21
113 Niederdorf,42,,6,6,12
113 Niederdorf,43,,10,10,20
113 Niederdorf,44,,9,10,19
113 Niederdorf,45,,10,8,18
113 Niederdorf,46,,12,7,19
113 Niederdorf,47,,7,3,10
113 Niederdorf,48,,8,4,12
113 Niederdorf,49,,2,3,5
113 Niederdorf,50,,7,3,10
113 Niederdorf,51,,9,4,13
113 Niederdorf,52,,5,8,13
113 Niederdorf,53,,6,10,16
113 Niederdorf,54,,7,7,14
113 Niederdorf,55,,2,6,8
113 Niederdorf,56,,11,5,16
113 Niederdorf,57,,5,9,14
113 Niederdorf,58,,5,11,16
113 Niederdorf,59,,5,5,10
113 Niederdorf,60,,4,7,11
113 Niederdorf,61,,1,4,5
113 Niederdorf,62,,5,7,12
113 Niederdorf,63,,6,7,13
113 Niederdorf,64,,6,9,15
113 Niederdorf,65,,7,7,14
113 Niederdorf,66,,3,13,16
113 Niederdorf,67,,7,7,14
113 Niederdorf,68,,8,8,16
113 Niederdorf,69,,8,7,15
113 Niederdorf,70,,6,10,16
113 Niederdorf,71,,5,9,14
113 Niederdorf,72,,5,6,11
113 Niederdorf,73,,8,9,17
113 Niederdorf,74,,4,6,10
113 Niederdorf,75,,1,7,8
113 Niederdorf,76,,4,11,15
113 Niederdorf,77,,2,3,5
113 Niederdorf,78,,5,9,14
113 Niederdorf,79,,5,4,9
113 Niederdorf,80,,2,4,6
113 Niederdorf,81,,1,3,4
113 Niederdorf,82,,1,2,3
113 Niederdorf,83,,1,1,2
113 Niederdorf,84,,1,3,4
113 Niederdorf,85,,-,3,3
113 Niederdorf,86,,-,1,1
113 Niederdorf,87,,1,1,2
113 Niederdorf,88,,-,2,2
113 Niederdorf,89,,2,1,3
113 Niederdorf,90,,-,3,3
113 Niederdorf,91,,-,1,1
113 Niederdorf,92,,-,2,2
113 Niederdorf,93,,-,1,1
113 Niederdorf,94,,-,1,1
113 Niederdorf,95,,-,1,1
113 Niederdorf,96,,-,1,1
113 Niederdorf,99,,-,1,1
114 Villanders,0,,11,15,26
114 Villanders,1,,11,10,21
114 Villanders,2,,13,9,22
114 Villanders,3,,13,14,27
114 Villanders,4,,15,8,23
114 Villanders,5,,19,6,25
114 Villanders,6,,11,13,24
114 Villanders,7,,7,18,25
114 Villanders,8,,13,9,22
114 Villanders,9,,19,16,35
114 Villanders,10,,16,14,30
114 Villanders,11,,13,10,23
114 Villanders,12,,9,12,21
114 Villanders,13,,6,15,21
114 Villanders,14,,8,8,16
114 Villanders,15,,10,10,20
114 Villanders,16,,12,13,25
114 Villanders,17,,13,6,19
114 Villanders,18,,15,12,27
114 Villanders,19,,19,14,33
114 Villanders,20,,10,17,27
114 Villanders,21,,15,6,21
114 Villanders,22,,13,14,27
114 Villanders,23,,15,16,31
114 Villanders,24,,13,16,29
114 Villanders,25,,10,15,25
114 Villanders,26,,14,18,32
114 Villanders,27,,12,14,26
114 Villanders,28,,13,14,27
114 Villanders,29,,17,24,41
114 Villanders,30,,15,8,23
114 Villanders,31,,25,20,45
114 Villanders,32,,23,14,37
114 Villanders,33,,20,18,38
114 Villanders,34,,23,16,39
114 Villanders,35,,21,16,37
114 Villanders,36,,19,17,36
114 Villanders,37,,15,15,30
114 Villanders,38,,18,11,29
114 Villanders,39,,14,12,26
114 Villanders,40,,19,7,26
114 Villanders,41,,15,11,26
114 Villanders,42,,16,8,24
114 Villanders,43,,8,7,15
114 Villanders,44,,10,11,21
114 Villanders,45,,11,17,28
114 Villanders,46,,9,5,14
114 Villanders,47,,11,6,17
114 Villanders,48,,11,8,19
114 Villanders,49,,11,6,17
114 Villanders,50,,8,8,16
114 Villanders,51,,10,7,17
114 Villanders,52,,6,12,18
114 Villanders,53,,6,8,14
114 Villanders,54,,11,11,22
114 Villanders,55,,6,4,10
114 Villanders,56,,5,9,14
114 Villanders,57,,8,8,16
114 Villanders,58,,10,8,18
114 Villanders,59,,8,9,17
114 Villanders,60,,8,12,20
114 Villanders,61,,9,5,14
114 Villanders,62,,10,6,16
114 Villanders,63,,5,9,14
114 Villanders,64,,6,6,12
114 Villanders,65,,2,8,10
114 Villanders,66,,1,9,10
114 Villanders,67,,11,9,20
114 Villanders,68,,9,9,18
114 Villanders,69,,6,7,13
114 Villanders,70,,10,6,16
114 Villanders,71,,4,10,14
114 Villanders,72,,5,10,15
114 Villanders,73,,8,6,14
114 Villanders,74,,6,5,11
114 Villanders,75,,2,7,9
114 Villanders,76,,6,5,11
114 Villanders,77,,6,2,8
114 Villanders,78,,4,6,10
114 Villanders,79,,3,11,14
114 Villanders,80,,4,4,8
114 Villanders,81,,-,3,3
114 Villanders,82,,1,-,1
114 Villanders,83,,-,2,2
114 Villanders,84,,-,2,2
114 Villanders,85,,-,3,3
114 Villanders,86,,2,6,8
114 Villanders,87,,1,3,4
114 Villanders,88,,2,4,6
114 Villanders,89,,-,5,5
114 Villanders,90,,1,3,4
114 Villanders,91,,-,3,3
114 Villanders,92,,2,1,3
114 Villanders,93,,1,1,2
114 Villanders,94,,2,-,2
114 Villanders,97,,-,1,1
114 Villanders,98,,-,1,1
114 Villanders,99,,-,1,1
115 Sterzing,0,,26,32,58
115 Sterzing,1,,29,30,59
115 Sterzing,2,,26,31,57
115 Sterzing,3,,34,35,69
115 Sterzing,4,,27,36,63
115 Sterzing,5,,33,30,63
115 Sterzing,6,,34,20,54
115 Sterzing,7,,35,27,62
115 Sterzing,8,,32,32,64
115 Sterzing,9,,34,36,70
115 Sterzing,10,,21,33,54
115 Sterzing,11,,35,24,59
115 Sterzing,12,,27,27,54
115 Sterzing,13,,28,24,52
115 Sterzing,14,,35,32,67
115 Sterzing,15,,16,30,46
115 Sterzing,16,,33,24,57
115 Sterzing,17,,25,30,55
115 Sterzing,18,,26,36,62
115 Sterzing,19,,45,33,78
115 Sterzing,20,,28,40,68
115 Sterzing,21,,31,43,74
115 Sterzing,22,,47,28,75
115 Sterzing,23,,41,35,76
115 Sterzing,24,,35,41,76
115 Sterzing,25,,62,53,115
115 Sterzing,26,,52,39,91
115 Sterzing,27,,52,54,106
115 Sterzing,28,,59,56,115
115 Sterzing,29,,67,48,115
115 Sterzing,30,,56,52,108
115 Sterzing,31,,48,36,84
115 Sterzing,32,,66,53,119
115 Sterzing,33,,68,44,112
115 Sterzing,34,,49,58,107
115 Sterzing,35,,59,49,108
115 Sterzing,36,,53,43,96
115 Sterzing,37,,63,48,111
115 Sterzing,38,,45,46,91
115 Sterzing,39,,41,42,83
115 Sterzing,40,,46,48,94
115 Sterzing,41,,51,41,92
115 Sterzing,42,,42,42,84
115 Sterzing,43,,34,50,84
115 Sterzing,44,,46,30,76
115 Sterzing,45,,36,44,80
115 Sterzing,46,,34,37,71
115 Sterzing,47,,32,39,71
115 Sterzing,48,,43,38,81
115 Sterzing,49,,38,39,77
115 Sterzing,50,,33,40,73
115 Sterzing,51,,32,49,81
115 Sterzing,52,,39,44,83
115 Sterzing,53,,34,29,63
115 Sterzing,54,,48,42,90
115 Sterzing,55,,36,36,72
115 Sterzing,56,,31,28,59
115 Sterzing,57,,44,45,89
115 Sterzing,58,,29,34,63
115 Sterzing,59,,33,28,61
115 Sterzing,60,,43,31,74
115 Sterzing,61,,32,29,61
115 Sterzing,62,,31,27,58
115 Sterzing,63,,23,35,58
115 Sterzing,64,,24,43,67
115 Sterzing,65,,21,23,44
115 Sterzing,66,,20,25,45
115 Sterzing,67,,33,30,63
115 Sterzing,68,,21,18,39
115 Sterzing,69,,23,33,56
115 Sterzing,70,,10,26,36
115 Sterzing,71,,22,19,41
115 Sterzing,72,,19,30,49
115 Sterzing,73,,21,20,41
115 Sterzing,74,,16,23,39
115 Sterzing,75,,7,22,29
115 Sterzing,76,,12,19,31
115 Sterzing,77,,14,20,34
115 Sterzing,78,,15,26,41
115 Sterzing,79,,5,19,24
115 Sterzing,80,,2,13,15
115 Sterzing,81,,6,11,17
115 Sterzing,82,,5,6,11
115 Sterzing,83,,6,5,11
115 Sterzing,84,,4,7,11
115 Sterzing,85,,2,7,9
115 Sterzing,86,,3,14,17
115 Sterzing,87,,2,10,12
115 Sterzing,88,,1,12,13
115 Sterzing,89,,-,4,4
115 Sterzing,90,,1,2,3
115 Sterzing,91,,1,4,5
115 Sterzing,92,,3,1,4
115 Sterzing,93,,1,2,3
115 Sterzing,94,,-,5,5
115 Sterzing,95,,-,1,1
115 Sterzing,96,,-,1,1
115 Sterzing,98,,-,1,1
115 Sterzing,99,,-,1,1
116 Feldthurns,0,,24,14,38
116 Feldthurns,1,,18,20,38
116 Feldthurns,2,,19,20,39
116 Feldthurns,3,,22,16,38
116 Feldthurns,4,,15,18,33
116 Feldthurns,5,,20,19,39
116 Feldthurns,6,,15,16,31
116 Feldthurns,7,,30,20,50
116 Feldthurns,8,,17,19,36
116 Feldthurns,9,,12,14,26
116 Feldthurns,10,,13,18,31
116 Feldthurns,11,,20,16,36
116 Feldthurns,12,,16,19,35
116 Feldthurns,13,,22,13,35
116 Feldthurns,14,,16,20,36
116 Feldthurns,15,,14,19,33
116 Feldthurns,16,,17,20,37
116 Feldthurns,17,,25,25,50
116 Feldthurns,18,,17,21,38
116 Feldthurns,19,,21,19,40
116 Feldthurns,20,,11,25,36
116 Feldthurns,21,,14,17,31
116 Feldthurns,22,,29,23,52
116 Feldthurns,23,,18,16,34
116 Feldthurns,24,,25,22,47
116 Feldthurns,25,,16,17,33
116 Feldthurns,26,,23,31,54
116 Feldthurns,27,,22,20,42
116 Feldthurns,28,,32,24,56
116 Feldthurns,29,,19,25,44
116 Feldthurns,30,,14,22,36
116 Feldthurns,31,,24,26,50
116 Feldthurns,32,,17,29,46
116 Feldthurns,33,,25,22,47
116 Feldthurns,34,,19,22,41
116 Feldthurns,35,,23,28,51
116 Feldthurns,36,,26,20,46
116 Feldthurns,37,,26,18,44
116 Feldthurns,38,,14,16,30
116 Feldthurns,39,,19,19,38
116 Feldthurns,40,,18,12,30
116 Feldthurns,41,,16,15,31
116 Feldthurns,42,,16,20,36
116 Feldthurns,43,,14,13,27
116 Feldthurns,44,,12,18,30
116 Feldthurns,45,,15,13,28
116 Feldthurns,46,,14,15,29
116 Feldthurns,47,,18,12,30
116 Feldthurns,48,,24,16,40
116 Feldthurns,49,,15,11,26
116 Feldthurns,50,,14,15,29
116 Feldthurns,51,,7,15,22
116 Feldthurns,52,,14,11,25
116 Feldthurns,53,,15,9,24
116 Feldthurns,54,,9,9,18
116 Feldthurns,55,,13,13,26
116 Feldthurns,56,,22,11,33
116 Feldthurns,57,,13,13,26
116 Feldthurns,58,,9,9,18
116 Feldthurns,59,,8,4,12
116 Feldthurns,60,,11,7,18
116 Feldthurns,61,,8,12,20
116 Feldthurns,62,,11,8,19
116 Feldthurns,63,,3,11,14
116 Feldthurns,64,,9,11,20
116 Feldthurns,65,,10,11,21
116 Feldthurns,66,,3,5,8
116 Feldthurns,67,,7,5,12
116 Feldthurns,68,,7,11,18
116 Feldthurns,69,,6,7,13
116 Feldthurns,70,,5,14,19
116 Feldthurns,71,,5,11,16
116 Feldthurns,72,,9,4,13
116 Feldthurns,73,,4,6,10
116 Feldthurns,74,,3,10,13
116 Feldthurns,75,,6,10,16
116 Feldthurns,76,,4,9,13
116 Feldthurns,77,,8,11,19
116 Feldthurns,78,,2,10,12
116 Feldthurns,79,,2,9,11
116 Feldthurns,80,,9,10,19
116 Feldthurns,81,,5,5,10
116 Feldthurns,82,,3,1,4
116 Feldthurns,83,,-,1,1
116 Feldthurns,84,,-,3,3
116 Feldthurns,85,,2,7,9
116 Feldthurns,86,,1,4,5
116 Feldthurns,88,,1,3,4
116 Feldthurns,89,,1,1,2
116 Feldthurns,91,,1,-,1
116 Feldthurns,94,,-,1,1
116 Feldthurns,96,,-,1,1
117 Wengen,0,,9,5,14
117 Wengen,1,,9,7,16
117 Wengen,2,,8,6,14
117 Wengen,3,,12,8,20
117 Wengen,4,,9,9,18
117 Wengen,5,,11,9,20
117 Wengen,6,,12,7,19
117 Wengen,7,,11,7,18
117 Wengen,8,,10,7,17
117 Wengen,9,,17,6,23
117 Wengen,10,,12,7,19
117 Wengen,11,,5,7,12
117 Wengen,12,,6,9,15
117 Wengen,13,,11,5,16
117 Wengen,14,,8,8,16
117 Wengen,15,,9,6,15
117 Wengen,16,,14,7,21
117 Wengen,17,,13,5,18
117 Wengen,18,,11,5,16
117 Wengen,19,,6,8,14
117 Wengen,20,,9,10,19
117 Wengen,21,,14,6,20
117 Wengen,22,,6,8,14
117 Wengen,23,,9,8,17
117 Wengen,24,,6,10,16
117 Wengen,25,,16,10,26
117 Wengen,26,,10,8,18
117 Wengen,27,,16,12,28
117 Wengen,28,,12,14,26
117 Wengen,29,,12,14,26
117 Wengen,30,,12,15,27
117 Wengen,31,,12,13,25
117 Wengen,32,,17,11,28
117 Wengen,33,,10,11,21
117 Wengen,34,,12,5,17
117 Wengen,35,,9,10,19
117 Wengen,36,,11,6,17
117 Wengen,37,,11,13,24
117 Wengen,38,,14,8,22
117 Wengen,39,,8,9,17
117 Wengen,40,,10,11,21
117 Wengen,41,,7,7,14
117 Wengen,42,,5,8,13
117 Wengen,43,,7,11,18
117 Wengen,44,,5,6,11
117 Wengen,45,,8,6,14
117 Wengen,46,,9,5,14
117 Wengen,47,,7,2,9
117 Wengen,48,,6,7,13
117 Wengen,49,,9,5,14
117 Wengen,50,,3,6,9
117 Wengen,51,,5,9,14
117 Wengen,52,,2,12,14
117 Wengen,53,,6,3,9
117 Wengen,54,,5,3,8
117 Wengen,55,,5,3,8
117 Wengen,56,,9,8,17
117 Wengen,57,,3,7,10
117 Wengen,58,,8,6,14
117 Wengen,59,,4,4,8
117 Wengen,60,,7,8,15
117 Wengen,61,,6,3,9
117 Wengen,62,,5,4,9
117 Wengen,63,,6,7,13
117 Wengen,64,,2,1,3
117 Wengen,65,,3,7,10
117 Wengen,66,,2,9,11
117 Wengen,67,,5,2,7
117 Wengen,68,,3,8,11
117 Wengen,69,,5,2,7
117 Wengen,70,,5,3,8
117 Wengen,71,,2,9,11
117 Wengen,72,,3,4,7
117 Wengen,73,,4,5,9
117 Wengen,74,,4,6,10
117 Wengen,75,,3,4,7
117 Wengen,76,,2,6,8
117 Wengen,77,,3,6,9
117 Wengen,78,,3,5,8
117 Wengen,79,,5,8,13
117 Wengen,80,,2,3,5
117 Wengen,81,,2,1,3
117 Wengen,83,,2,-,2
117 Wengen,85,,1,2,3
117 Wengen,87,,-,2,2
117 Wengen,88,,1,-,1
117 Wengen,90,,-,1,1
117 Wengen,91,,-,1,1
117 Wengen,92,,-,3,3
117 Wengen,94,,1,-,1
117 Wengen,95,,1,-,1
117 Wengen,96,,-,1,1
118 U.L.Frau i.W.-St.Felix,0,,4,2,6
118 U.L.Frau i.W.-St.Felix,1,,7,3,10
118 U.L.Frau i.W.-St.Felix,2,,6,9,15
118 U.L.Frau i.W.-St.Felix,3,,4,4,8
118 U.L.Frau i.W.-St.Felix,4,,8,5,13
118 U.L.Frau i.W.-St.Felix,5,,3,9,12
118 U.L.Frau i.W.-St.Felix,6,,7,8,15
118 U.L.Frau i.W.-St.Felix,7,,9,5,14
118 U.L.Frau i.W.-St.Felix,8,,7,4,11
118 U.L.Frau i.W.-St.Felix,9,,10,8,18
118 U.L.Frau i.W.-St.Felix,10,,7,5,12
118 U.L.Frau i.W.-St.Felix,11,,9,6,15
118 U.L.Frau i.W.-St.Felix,12,,8,6,14
118 U.L.Frau i.W.-St.Felix,13,,4,7,11
118 U.L.Frau i.W.-St.Felix,14,,8,4,12
118 U.L.Frau i.W.-St.Felix,15,,5,7,12
118 U.L.Frau i.W.-St.Felix,16,,6,7,13
118 U.L.Frau i.W.-St.Felix,17,,2,11,13
118 U.L.Frau i.W.-St.Felix,18,,3,6,9
118 U.L.Frau i.W.-St.Felix,19,,6,4,10
118 U.L.Frau i.W.-St.Felix,20,,3,6,9
118 U.L.Frau i.W.-St.Felix,21,,2,2,4
118 U.L.Frau i.W.-St.Felix,22,,1,4,5
118 U.L.Frau i.W.-St.Felix,23,,5,4,9
118 U.L.Frau i.W.-St.Felix,24,,4,8,12
118 U.L.Frau i.W.-St.Felix,25,,8,3,11
118 U.L.Frau i.W.-St.Felix,26,,5,4,9
118 U.L.Frau i.W.-St.Felix,27,,4,4,8
118 U.L.Frau i.W.-St.Felix,28,,8,4,12
118 U.L.Frau i.W.-St.Felix,29,,2,4,6
118 U.L.Frau i.W.-St.Felix,30,,6,7,13
118 U.L.Frau i.W.-St.Felix,31,,7,3,10
118 U.L.Frau i.W.-St.Felix,32,,6,10,16
118 U.L.Frau i.W.-St.Felix,33,,4,5,9
118 U.L.Frau i.W.-St.Felix,34,,7,7,14
118 U.L.Frau i.W.-St.Felix,35,,10,6,16
118 U.L.Frau i.W.-St.Felix,36,,4,8,12
118 U.L.Frau i.W.-St.Felix,37,,17,8,25
118 U.L.Frau i.W.-St.Felix,38,,8,11,19
118 U.L.Frau i.W.-St.Felix,39,,4,4,8
118 U.L.Frau i.W.-St.Felix,40,,8,9,17
118 U.L.Frau i.W.-St.Felix,41,,5,5,10
118 U.L.Frau i.W.-St.Felix,42,,4,2,6
118 U.L.Frau i.W.-St.Felix,43,,3,5,8
118 U.L.Frau i.W.-St.Felix,44,,5,7,12
118 U.L.Frau i.W.-St.Felix,45,,4,4,8
118 U.L.Frau i.W.-St.Felix,46,,7,4,11
118 U.L.Frau i.W.-St.Felix,47,,3,3,6
118 U.L.Frau i.W.-St.Felix,48,,6,3,9
118 U.L.Frau i.W.-St.Felix,49,,6,3,9
118 U.L.Frau i.W.-St.Felix,50,,3,3,6
118 U.L.Frau i.W.-St.Felix,51,,5,-,5
118 U.L.Frau i.W.-St.Felix,52,,4,2,6
118 U.L.Frau i.W.-St.Felix,53,,2,6,8
118 U.L.Frau i.W.-St.Felix,54,,1,5,6
118 U.L.Frau i.W.-St.Felix,55,,3,1,4
118 U.L.Frau i.W.-St.Felix,56,,5,1,6
118 U.L.Frau i.W.-St.Felix,57,,8,4,12
118 U.L.Frau i.W.-St.Felix,58,,4,4,8
118 U.L.Frau i.W.-St.Felix,59,,5,8,13
118 U.L.Frau i.W.-St.Felix,60,,3,1,4
118 U.L.Frau i.W.-St.Felix,61,,1,4,5
118 U.L.Frau i.W.-St.Felix,62,,3,4,7
118 U.L.Frau i.W.-St.Felix,63,,3,-,3
118 U.L.Frau i.W.-St.Felix,64,,5,2,7
118 U.L.Frau i.W.-St.Felix,65,,3,3,6
118 U.L.Frau i.W.-St.Felix,66,,3,3,6
118 U.L.Frau i.W.-St.Felix,67,,5,5,10
118 U.L.Frau i.W.-St.Felix,68,,6,1,7
118 U.L.Frau i.W.-St.Felix,69,,4,1,5
118 U.L.Frau i.W.-St.Felix,70,,4,5,9
118 U.L.Frau i.W.-St.Felix,71,,2,3,5
118 U.L.Frau i.W.-St.Felix,72,,3,5,8
118 U.L.Frau i.W.-St.Felix,73,,3,4,7
118 U.L.Frau i.W.-St.Felix,74,,2,3,5
118 U.L.Frau i.W.-St.Felix,75,,4,5,9
118 U.L.Frau i.W.-St.Felix,76,,5,3,8
118 U.L.Frau i.W.-St.Felix,77,,2,6,8
118 U.L.Frau i.W.-St.Felix,78,,1,2,3
118 U.L.Frau i.W.-St.Felix,79,,-,3,3
118 U.L.Frau i.W.-St.Felix,80,,-,1,1
118 U.L.Frau i.W.-St.Felix,81,,1,2,3
118 U.L.Frau i.W.-St.Felix,83,,1,-,1
118 U.L.Frau i.W.-St.Felix,85,,-,1,1
118 U.L.Frau i.W.-St.Felix,86,,1,1,2
118 U.L.Frau i.W.-St.Felix,87,,1,2,3
118 U.L.Frau i.W.-St.Felix,88,,2,2,4
118 U.L.Frau i.W.-St.Felix,90,,-,2,2
118 U.L.Frau i.W.-St.Felix,95,,1,-,1
