Gemeinde,Altersklassen,Geschlecht,Männer,Frauen,Insgesamt
001 Aldein,0,,17,10,27
001 Aldein,1,,13,5,18
001 Aldein,2,,16,16,32
001 Aldein,3,,8,15,23
001 Aldein,4,,17,9,26
001 Aldein,5,,8,8,16
001 Aldein,6,,9,12,21
001 Aldein,7,,14,7,21
001 Aldein,8,,13,11,24
001 Aldein,9,,9,13,22
001 Aldein,10,,7,8,15
001 Aldein,11,,7,6,13
001 Aldein,12,,9,17,26
001 Aldein,13,,11,9,20
001 Aldein,14,,11,8,19
001 Aldein,15,,11,10,21
001 Aldein,16,,12,12,24
001 Aldein,17,,10,7,17
001 Aldein,18,,14,12,26
001 Aldein,19,,15,7,22
001 Aldein,20,,10,16,26
001 Aldein,21,,10,15,25
001 Aldein,22,,10,18,28
001 Aldein,23,,10,9,19
001 Aldein,24,,8,23,31
001 Aldein,25,,13,17,30
001 Aldein,26,,18,18,36
001 Aldein,27,,11,16,27
001 Aldein,28,,14,10,24
001 Aldein,29,,16,12,28
001 Aldein,30,,19,17,36
001 Aldein,31,,15,16,31
001 Aldein,32,,22,9,31
001 Aldein,33,,14,17,31
001 Aldein,34,,6,16,22
001 Aldein,35,,7,20,27
001 Aldein,36,,17,11,28
001 Aldein,37,,15,10,25
001 Aldein,38,,14,6,20
001 Aldein,39,,9,15,24
001 Aldein,40,,15,17,32
001 Aldein,41,,17,9,26
001 Aldein,42,,12,13,25
001 Aldein,43,,8,5,13
001 Aldein,44,,9,10,19
001 Aldein,45,,10,9,19
001 Aldein,46,,8,10,18
001 Aldein,47,,10,7,17
001 Aldein,48,,8,10,18
001 Aldein,49,,9,5,14
001 Aldein,50,,15,11,26
001 Aldein,51,,5,12,17
001 Aldein,52,,8,6,14
001 Aldein,53,,10,9,19
001 Aldein,54,,5,11,16
001 Aldein,55,,7,11,18
001 Aldein,56,,7,5,12
001 Aldein,57,,6,6,12
001 Aldein,58,,11,11,22
001 Aldein,59,,8,13,21
001 Aldein,60,,6,12,18
001 Aldein,61,,9,8,17
001 Aldein,62,,5,8,13
001 Aldein,63,,5,7,12
001 Aldein,64,,7,9,16
001 Aldein,65,,9,6,15
001 Aldein,66,,4,4,8
001 Aldein,67,,15,5,20
001 Aldein,68,,8,3,11
001 Aldein,69,,5,8,13
001 Aldein,70,,8,3,11
001 Aldein,71,,6,5,11
001 Aldein,72,,9,9,18
001 Aldein,73,,6,3,9
001 Aldein,74,,5,6,11
001 Aldein,75,,1,5,6
001 Aldein,76,,3,5,8
001 Aldein,77,,2,8,10
001 Aldein,78,,2,5,7
001 Aldein,79,,1,9,10
001 Aldein,80,,4,12,16
001 Aldein,81,,4,2,6
001 Aldein,82,,-,4,4
001 Aldein,83,,1,-,1
001 Aldein,84,,-,1,1
001 Aldein,85,,2,1,3
001 Aldein,87,,-,3,3
001 Aldein,88,,-,3,3
001 Aldein,89,,2,2,4
001 Aldein,90,,-,1,1
001 Aldein,91,,2,-,2
001 Aldein,92,,-,1,1
001 Aldein,93,,-,2,2
001 Aldein,94,,-,1,1
001 Aldein,95,,-,1,1
002 Andrian,0,,2,4,6
002 Andrian,1,,4,4,8
002 Andrian,2,,2,7,9
002 Andrian,3,,6,1,7
002 Andrian,4,,9,5,14
002 Andrian,5,,2,10,12
002 Andrian,6,,9,4,13
002 Andrian,7,,4,4,8
002 Andrian,8,,5,5,10
002 Andrian,9,,6,6,12
002 Andrian,10,,5,7,12
002 Andrian,11,,5,4,9
002 Andrian,12,,4,4,8
002 Andrian,13,,12,6,18
002 Andrian,14,,6,7,13
002 Andrian,15,,8,6,14
002 Andrian,16,,1,4,5
002 Andrian,17,,6,4,10
002 Andrian,18,,5,2,7
002 Andrian,19,,10,6,16
002 Andrian,20,,1,3,4
002 Andrian,21,,5,2,7
002 Andrian,22,,6,4,10
002 Andrian,23,,5,4,9
002 Andrian,24,,4,3,7
002 Andrian,25,,5,4,9
002 Andrian,26,,4,2,6
002 Andrian,27,,5,6,11
002 Andrian,28,,4,7,11
002 Andrian,29,,6,5,11
002 Andrian,30,,6,10,16
002 Andrian,31,,13,5,18
002 Andrian,32,,4,6,10
002 Andrian,33,,8,8,16
002 Andrian,34,,10,9,19
002 Andrian,35,,9,8,17
002 Andrian,36,,11,7,18
002 Andrian,37,,7,7,14
002 Andrian,38,,8,10,18
002 Andrian,39,,6,6,12
002 Andrian,40,,7,2,9
002 Andrian,41,,6,4,10
002 Andrian,42,,5,4,9
002 Andrian,43,,7,8,15
002 Andrian,44,,5,7,12
002 Andrian,45,,4,9,13
002 Andrian,46,,2,4,6
002 Andrian,47,,6,2,8
002 Andrian,48,,7,6,13
002 Andrian,49,,2,3,5
002 Andrian,50,,3,3,6
002 Andrian,51,,6,6,12
002 Andrian,52,,4,2,6
002 Andrian,53,,6,3,9
002 Andrian,54,,5,4,9
002 Andrian,55,,4,7,11
002 Andrian,56,,1,2,3
002 Andrian,57,,1,3,4
002 Andrian,58,,5,7,12
002 Andrian,59,,4,5,9
002 Andrian,60,,6,4,10
002 Andrian,61,,3,8,11
002 Andrian,62,,1,8,9
002 Andrian,63,,4,4,8
002 Andrian,64,,6,4,10
002 Andrian,65,,2,2,4
002 Andrian,66,,3,3,6
002 Andrian,67,,4,3,7
002 Andrian,68,,3,4,7
002 Andrian,69,,7,5,12
002 Andrian,70,,3,5,8
002 Andrian,71,,4,1,5
002 Andrian,72,,2,1,3
002 Andrian,73,,2,4,6
002 Andrian,74,,1,2,3
002 Andrian,75,,4,4,8
002 Andrian,76,,2,1,3
002 Andrian,77,,2,4,6
002 Andrian,78,,1,1,2
002 Andrian,79,,1,4,5
002 Andrian,80,,1,4,5
002 Andrian,81,,1,1,2
002 Andrian,82,,2,2,4
002 Andrian,83,,2,1,3
002 Andrian,85,,1,-,1
002 Andrian,86,,1,2,3
002 Andrian,87,,1,1,2
002 Andrian,88,,1,1,2
002 Andrian,89,,-,2,2
002 Andrian,90,,-,1,1
002 Andrian,91,,-,1,1
002 Andrian,94,,-,1,1
002 Andrian,98,,-,1,1
003 Altrei,0,,3,1,4
003 Altrei,1,,1,1,2
003 Altrei,2,,3,-,3
003 Altrei,3,,4,1,5
003 Altrei,4,,1,1,2
003 Altrei,5,,-,3,3
003 Altrei,6,,1,2,3
003 Altrei,7,,3,2,5
003 Altrei,8,,3,-,3
003 Altrei,9,,6,3,9
003 Altrei,10,,1,1,2
003 Altrei,11,,3,2,5
003 Altrei,12,,2,2,4
003 Altrei,13,,4,4,8
003 Altrei,14,,1,1,2
003 Altrei,15,,3,3,6
003 Altrei,16,,2,2,4
003 Altrei,17,,3,1,4
003 Altrei,18,,4,2,6
003 Altrei,19,,2,2,4
003 Altrei,20,,3,1,4
003 Altrei,21,,3,4,7
003 Altrei,22,,-,1,1
003 Altrei,23,,2,6,8
003 Altrei,24,,-,4,4
003 Altrei,25,,2,3,5
003 Altrei,26,,2,1,3
003 Altrei,27,,1,2,3
003 Altrei,28,,2,3,5
003 Altrei,29,,3,1,4
003 Altrei,30,,5,5,10
003 Altrei,31,,1,3,4
003 Altrei,32,,3,5,8
003 Altrei,33,,-,4,4
003 Altrei,34,,3,-,3
003 Altrei,35,,3,5,8
003 Altrei,36,,2,5,7
003 Altrei,37,,3,5,8
003 Altrei,38,,2,2,4
003 Altrei,39,,10,1,11
003 Altrei,40,,2,3,5
003 Altrei,41,,6,2,8
003 Altrei,42,,5,2,7
003 Altrei,43,,1,3,4
003 Altrei,44,,1,3,4
003 Altrei,45,,5,1,6
003 Altrei,46,,3,3,6
003 Altrei,47,,1,1,2
003 Altrei,48,,3,2,5
003 Altrei,49,,6,3,9
003 Altrei,50,,6,3,9
003 Altrei,51,,1,2,3
003 Altrei,52,,1,-,1
003 Altrei,53,,3,3,6
003 Altrei,54,,3,2,5
003 Altrei,55,,1,3,4
003 Altrei,56,,3,-,3
003 Altrei,57,,2,3,5
003 Altrei,58,,1,3,4
003 Altrei,59,,3,1,4
003 Altrei,60,,1,2,3
003 Altrei,61,,2,4,6
003 Altrei,62,,1,3,4
003 Altrei,63,,1,-,1
003 Altrei,64,,2,1,3
003 Altrei,65,,3,1,4
003 Altrei,66,,3,2,5
003 Altrei,67,,-,2,2
003 Altrei,68,,3,3,6
003 Altrei,69,,-,3,3
003 Altrei,70,,-,2,2
003 Altrei,71,,4,2,6
003 Altrei,72,,2,3,5
003 Altrei,73,,-,2,2
003 Altrei,74,,3,4,7
003 Altrei,75,,1,4,5
003 Altrei,76,,-,2,2
003 Altrei,77,,1,3,4
003 Altrei,78,,1,2,3
003 Altrei,79,,1,1,2
003 Altrei,80,,-,1,1
003 Altrei,81,,1,1,2
003 Altrei,82,,-,1,1
003 Altrei,83,,-,1,1
003 Altrei,84,,-,3,3
003 Altrei,86,,-,1,1
003 Altrei,87,,-,2,2
003 Altrei,88,,1,1,2
003 Altrei,89,,1,-,1
003 Altrei,90,,-,2,2
003 Altrei,93,,-,1,1
003 Altrei,95,,1,-,1
004 Eppan a.d. Weinstr.,0,,74,70,144
004 Eppan a.d. Weinstr.,1,,67,89,156
004 Eppan a.d. Weinstr.,2,,75,60,135
004 Eppan a.d. Weinstr.,3,,84,79,163
004 Eppan a.d. Weinstr.,4,,72,72,144
004 Eppan a.d. Weinstr.,5,,77,73,150
004 Eppan a.d. Weinstr.,6,,70,65,135
004 Eppan a.d. Weinstr.,7,,72,71,143
004 Eppan a.d. Weinstr.,8,,78,87,165
004 Eppan a.d. Weinstr.,9,,63,77,140
004 Eppan a.d. Weinstr.,10,,76,63,139
004 Eppan a.d. Weinstr.,11,,81,62,143
004 Eppan a.d. Weinstr.,12,,75,58,133
004 Eppan a.d. Weinstr.,13,,77,82,159
004 Eppan a.d. Weinstr.,14,,72,64,136
004 Eppan a.d. Weinstr.,15,,84,67,151
004 Eppan a.d. Weinstr.,16,,80,57,137
004 Eppan a.d. Weinstr.,17,,77,73,150
004 Eppan a.d. Weinstr.,18,,63,65,128
004 Eppan a.d. Weinstr.,19,,67,66,133
004 Eppan a.d. Weinstr.,20,,54,70,124
004 Eppan a.d. Weinstr.,21,,83,71,154
004 Eppan a.d. Weinstr.,22,,73,64,137
004 Eppan a.d. Weinstr.,23,,80,74,154
004 Eppan a.d. Weinstr.,24,,79,57,136
004 Eppan a.d. Weinstr.,25,,73,71,144
004 Eppan a.d. Weinstr.,26,,83,87,170
004 Eppan a.d. Weinstr.,27,,76,95,171
004 Eppan a.d. Weinstr.,28,,90,94,184
004 Eppan a.d. Weinstr.,29,,95,121,216
004 Eppan a.d. Weinstr.,30,,110,98,208
004 Eppan a.d. Weinstr.,31,,127,122,249
004 Eppan a.d. Weinstr.,32,,120,111,231
004 Eppan a.d. Weinstr.,33,,115,101,216
004 Eppan a.d. Weinstr.,34,,123,114,237
004 Eppan a.d. Weinstr.,35,,124,136,260
004 Eppan a.d. Weinstr.,36,,104,113,217
004 Eppan a.d. Weinstr.,37,,127,118,245
004 Eppan a.d. Weinstr.,38,,103,126,229
004 Eppan a.d. Weinstr.,39,,121,113,234
004 Eppan a.d. Weinstr.,40,,121,104,225
004 Eppan a.d. Weinstr.,41,,103,115,218
004 Eppan a.d. Weinstr.,42,,126,106,232
004 Eppan a.d. Weinstr.,43,,103,99,202
004 Eppan a.d. Weinstr.,44,,95,93,188
004 Eppan a.d. Weinstr.,45,,87,73,160
004 Eppan a.d. Weinstr.,46,,89,90,179
004 Eppan a.d. Weinstr.,47,,69,92,161
004 Eppan a.d. Weinstr.,48,,86,74,160
004 Eppan a.d. Weinstr.,49,,71,79,150
004 Eppan a.d. Weinstr.,50,,81,64,145
004 Eppan a.d. Weinstr.,51,,64,72,136
004 Eppan a.d. Weinstr.,52,,67,64,131
004 Eppan a.d. Weinstr.,53,,85,67,152
004 Eppan a.d. Weinstr.,54,,69,83,152
004 Eppan a.d. Weinstr.,55,,85,71,156
004 Eppan a.d. Weinstr.,56,,61,50,111
004 Eppan a.d. Weinstr.,57,,73,85,158
004 Eppan a.d. Weinstr.,58,,97,83,180
004 Eppan a.d. Weinstr.,59,,98,82,180
004 Eppan a.d. Weinstr.,60,,66,108,174
004 Eppan a.d. Weinstr.,61,,79,61,140
004 Eppan a.d. Weinstr.,62,,61,84,145
004 Eppan a.d. Weinstr.,63,,62,54,116
004 Eppan a.d. Weinstr.,64,,47,57,104
004 Eppan a.d. Weinstr.,65,,48,51,99
004 Eppan a.d. Weinstr.,66,,44,49,93
004 Eppan a.d. Weinstr.,67,,32,57,89
004 Eppan a.d. Weinstr.,68,,56,57,113
004 Eppan a.d. Weinstr.,69,,50,51,101
004 Eppan a.d. Weinstr.,70,,41,63,104
004 Eppan a.d. Weinstr.,71,,52,68,120
004 Eppan a.d. Weinstr.,72,,45,54,99
004 Eppan a.d. Weinstr.,73,,39,44,83
004 Eppan a.d. Weinstr.,74,,35,47,82
004 Eppan a.d. Weinstr.,75,,42,48,90
004 Eppan a.d. Weinstr.,76,,41,58,99
004 Eppan a.d. Weinstr.,77,,26,68,94
004 Eppan a.d. Weinstr.,78,,25,45,70
004 Eppan a.d. Weinstr.,79,,17,47,64
004 Eppan a.d. Weinstr.,80,,27,47,74
004 Eppan a.d. Weinstr.,81,,17,28,45
004 Eppan a.d. Weinstr.,82,,16,27,43
004 Eppan a.d. Weinstr.,83,,10,18,28
004 Eppan a.d. Weinstr.,84,,11,14,25
004 Eppan a.d. Weinstr.,85,,9,18,27
004 Eppan a.d. Weinstr.,86,,11,12,23
004 Eppan a.d. Weinstr.,87,,12,28,40
004 Eppan a.d. Weinstr.,88,,7,16,23
004 Eppan a.d. Weinstr.,89,,4,18,22
004 Eppan a.d. Weinstr.,90,,5,25,30
004 Eppan a.d. Weinstr.,91,,1,10,11
004 Eppan a.d. Weinstr.,92,,3,12,15
004 Eppan a.d. Weinstr.,93,,1,8,9
004 Eppan a.d. Weinstr.,94,,-,6,6
004 Eppan a.d. Weinstr.,95,,2,3,5
004 Eppan a.d. Weinstr.,96,,1,1,2
004 Eppan a.d. Weinstr.,97,,-,1,1
004 Eppan a.d. Weinstr.,98,,-,1,1
004 Eppan a.d. Weinstr.,99,,-,1,1
004 Eppan a.d. Weinstr.,100,,-,1,1
004 Eppan a.d. Weinstr.,101,,1,-,1
005 Hafling,0,,7,3,10
005 Hafling,1,,4,10,14
005 Hafling,2,,4,3,7
005 Hafling,3,,2,8,10
005 Hafling,4,,1,10,11
005 Hafling,5,,13,5,18
005 Hafling,6,,6,5,11
005 Hafling,7,,3,6,9
005 Hafling,8,,3,7,10
005 Hafling,9,,3,5,8
005 Hafling,10,,8,3,11
005 Hafling,11,,5,6,11
005 Hafling,12,,4,2,6
005 Hafling,13,,2,7,9
005 Hafling,14,,4,4,8
005 Hafling,15,,5,4,9
005 Hafling,16,,5,5,10
005 Hafling,17,,4,8,12
005 Hafling,18,,3,-,3
005 Hafling,19,,7,3,10
005 Hafling,20,,5,5,10
005 Hafling,21,,4,10,14
005 Hafling,22,,4,5,9
005 Hafling,23,,3,5,8
005 Hafling,24,,3,4,7
005 Hafling,25,,4,6,10
005 Hafling,26,,8,5,13
005 Hafling,27,,7,7,14
005 Hafling,28,,10,3,13
005 Hafling,29,,8,1,9
005 Hafling,30,,10,7,17
005 Hafling,31,,7,6,13
005 Hafling,32,,8,12,20
005 Hafling,33,,4,8,12
005 Hafling,34,,6,3,9
005 Hafling,35,,10,6,16
005 Hafling,36,,8,11,19
005 Hafling,37,,3,2,5
005 Hafling,38,,6,3,9
005 Hafling,39,,4,2,6
005 Hafling,40,,7,4,11
005 Hafling,41,,8,7,15
005 Hafling,42,,6,6,12
005 Hafling,43,,3,4,7
005 Hafling,44,,1,5,6
005 Hafling,45,,3,10,13
005 Hafling,46,,8,3,11
005 Hafling,47,,3,1,4
005 Hafling,48,,3,3,6
005 Hafling,49,,4,2,6
005 Hafling,50,,2,3,5
005 Hafling,51,,4,3,7
005 Hafling,52,,5,3,8
005 Hafling,53,,8,2,10
005 Hafling,54,,3,4,7
005 Hafling,55,,1,4,5
005 Hafling,56,,5,3,8
005 Hafling,57,,1,2,3
005 Hafling,58,,4,5,9
005 Hafling,59,,5,3,8
005 Hafling,60,,5,4,9
005 Hafling,61,,2,2,4
005 Hafling,62,,3,5,8
005 Hafling,63,,3,3,6
005 Hafling,64,,3,2,5
005 Hafling,65,,1,1,2
005 Hafling,66,,1,1,2
005 Hafling,67,,1,2,3
005 Hafling,68,,6,3,9
005 Hafling,69,,3,4,7
005 Hafling,70,,3,7,10
005 Hafling,71,,2,4,6
005 Hafling,72,,4,1,5
005 Hafling,73,,4,3,7
005 Hafling,74,,3,5,8
005 Hafling,75,,1,2,3
005 Hafling,76,,2,-,2
005 Hafling,77,,1,2,3
005 Hafling,78,,1,-,1
005 Hafling,79,,-,3,3
005 Hafling,80,,-,3,3
005 Hafling,81,,3,1,4
005 Hafling,82,,1,2,3
005 Hafling,84,,-,1,1
005 Hafling,85,,1,2,3
005 Hafling,86,,1,-,1
005 Hafling,87,,1,-,1
005 Hafling,88,,-,2,2
005 Hafling,89,,-,1,1
005 Hafling,90,,1,-,1
005 Hafling,95,,-,1,1
006 Abtei,0,,27,22,49
006 Abtei,1,,21,30,51
006 Abtei,2,,23,24,47
006 Abtei,3,,13,14,27
006 Abtei,4,,26,22,48
006 Abtei,5,,29,14,43
006 Abtei,6,,24,27,51
006 Abtei,7,,18,13,31
006 Abtei,8,,15,19,34
006 Abtei,9,,24,16,40
006 Abtei,10,,22,12,34
006 Abtei,11,,23,16,39
006 Abtei,12,,16,14,30
006 Abtei,13,,14,9,23
006 Abtei,14,,19,12,31
006 Abtei,15,,17,18,35
006 Abtei,16,,11,13,24
006 Abtei,17,,12,20,32
006 Abtei,18,,14,11,25
006 Abtei,19,,18,19,37
006 Abtei,20,,16,18,34
006 Abtei,21,,23,16,39
006 Abtei,22,,12,23,35
006 Abtei,23,,22,27,49
006 Abtei,24,,19,28,47
006 Abtei,25,,25,23,48
006 Abtei,26,,18,27,45
006 Abtei,27,,20,25,45
006 Abtei,28,,25,24,49
006 Abtei,29,,41,30,71
006 Abtei,30,,17,33,50
006 Abtei,31,,28,29,57
006 Abtei,32,,28,35,63
006 Abtei,33,,24,33,57
006 Abtei,34,,38,37,75
006 Abtei,35,,21,32,53
006 Abtei,36,,33,26,59
006 Abtei,37,,24,31,55
006 Abtei,38,,29,25,54
006 Abtei,39,,24,29,53
006 Abtei,40,,22,27,49
006 Abtei,41,,26,22,48
006 Abtei,42,,26,23,49
006 Abtei,43,,18,23,41
006 Abtei,44,,19,15,34
006 Abtei,45,,21,17,38
006 Abtei,46,,16,15,31
006 Abtei,47,,11,14,25
006 Abtei,48,,14,18,32
006 Abtei,49,,13,13,26
006 Abtei,50,,12,12,24
006 Abtei,51,,15,20,35
006 Abtei,52,,13,18,31
006 Abtei,53,,25,17,42
006 Abtei,54,,14,15,29
006 Abtei,55,,25,18,43
006 Abtei,56,,16,20,36
006 Abtei,57,,14,18,32
006 Abtei,58,,12,11,23
006 Abtei,59,,21,11,32
006 Abtei,60,,17,24,41
006 Abtei,61,,18,20,38
006 Abtei,62,,17,13,30
006 Abtei,63,,16,18,34
006 Abtei,64,,6,19,25
006 Abtei,65,,18,10,28
006 Abtei,66,,13,19,32
006 Abtei,67,,14,17,31
006 Abtei,68,,10,15,25
006 Abtei,69,,8,6,14
006 Abtei,70,,12,13,25
006 Abtei,71,,18,12,30
006 Abtei,72,,8,7,15
006 Abtei,73,,8,15,23
006 Abtei,74,,7,9,16
006 Abtei,75,,8,6,14
006 Abtei,76,,8,7,15
006 Abtei,77,,6,10,16
006 Abtei,78,,5,13,18
006 Abtei,79,,8,6,14
006 Abtei,80,,5,3,8
006 Abtei,81,,3,12,15
006 Abtei,82,,1,5,6
006 Abtei,83,,2,4,6
006 Abtei,84,,-,2,2
006 Abtei,85,,1,4,5
006 Abtei,86,,-,2,2
006 Abtei,87,,1,2,3
006 Abtei,88,,2,1,3
006 Abtei,89,,2,4,6
006 Abtei,90,,1,4,5
006 Abtei,91,,1,3,4
006 Abtei,92,,2,-,2
006 Abtei,93,,-,3,3
006 Abtei,94,,-,1,1
006 Abtei,95,,-,1,1
007 Barbian,0,,11,15,26
007 Barbian,1,,13,7,20
007 Barbian,2,,10,10,20
007 Barbian,3,,16,9,25
007 Barbian,4,,11,7,18
007 Barbian,5,,9,10,19
007 Barbian,6,,10,8,18
007 Barbian,7,,7,4,11
007 Barbian,8,,10,12,22
007 Barbian,9,,12,6,18
007 Barbian,10,,11,10,21
007 Barbian,11,,14,13,27
007 Barbian,12,,9,13,22
007 Barbian,13,,11,5,16
007 Barbian,14,,7,6,13
007 Barbian,15,,13,8,21
007 Barbian,16,,8,9,17
007 Barbian,17,,9,7,16
007 Barbian,18,,11,7,18
007 Barbian,19,,9,5,14
007 Barbian,20,,13,13,26
007 Barbian,21,,8,6,14
007 Barbian,22,,18,14,32
007 Barbian,23,,10,9,19
007 Barbian,24,,6,19,25
007 Barbian,25,,7,15,22
007 Barbian,26,,9,9,18
007 Barbian,27,,16,14,30
007 Barbian,28,,8,17,25
007 Barbian,29,,22,17,39
007 Barbian,30,,16,13,29
007 Barbian,31,,10,11,21
007 Barbian,32,,15,3,18
007 Barbian,33,,13,12,25
007 Barbian,34,,7,9,16
007 Barbian,35,,12,14,26
007 Barbian,36,,9,11,20
007 Barbian,37,,15,13,28
007 Barbian,38,,15,13,28
007 Barbian,39,,15,14,29
007 Barbian,40,,18,10,28
007 Barbian,41,,12,15,27
007 Barbian,42,,12,9,21
007 Barbian,43,,7,9,16
007 Barbian,44,,15,7,22
007 Barbian,45,,4,9,13
007 Barbian,46,,8,7,15
007 Barbian,47,,6,16,22
007 Barbian,48,,10,8,18
007 Barbian,49,,7,5,12
007 Barbian,50,,7,10,17
007 Barbian,51,,12,11,23
007 Barbian,52,,5,5,10
007 Barbian,53,,3,4,7
007 Barbian,54,,6,10,16
007 Barbian,55,,18,6,24
007 Barbian,56,,9,5,14
007 Barbian,57,,11,8,19
007 Barbian,58,,9,6,15
007 Barbian,59,,11,12,23
007 Barbian,60,,8,13,21
007 Barbian,61,,8,3,11
007 Barbian,62,,6,5,11
007 Barbian,63,,5,10,15
007 Barbian,64,,8,8,16
007 Barbian,65,,3,6,9
007 Barbian,66,,3,8,11
007 Barbian,67,,5,5,10
007 Barbian,68,,8,5,13
007 Barbian,69,,4,7,11
007 Barbian,70,,4,8,12
007 Barbian,71,,7,6,13
007 Barbian,72,,8,8,16
007 Barbian,73,,5,9,14
007 Barbian,74,,5,4,9
007 Barbian,75,,4,3,7
007 Barbian,76,,9,3,12
007 Barbian,77,,4,6,10
007 Barbian,78,,3,9,12
007 Barbian,79,,3,5,8
007 Barbian,80,,2,3,5
007 Barbian,81,,2,3,5
007 Barbian,82,,-,3,3
007 Barbian,83,,1,1,2
007 Barbian,84,,-,1,1
007 Barbian,85,,1,1,2
007 Barbian,86,,-,4,4
007 Barbian,87,,4,6,10
007 Barbian,88,,-,3,3
007 Barbian,90,,2,1,3
007 Barbian,91,,1,-,1
007 Barbian,93,,-,1,1
008 Bozen,0,,466,415,881
008 Bozen,1,,423,432,855
008 Bozen,2,,470,437,907
008 Bozen,3,,418,432,850
008 Bozen,4,,455,369,824
008 Bozen,5,,417,426,843
008 Bozen,6,,406,376,782
008 Bozen,7,,446,419,865
008 Bozen,8,,396,387,783
008 Bozen,9,,416,380,796
008 Bozen,10,,458,383,841
008 Bozen,11,,437,394,831
008 Bozen,12,,422,390,812
008 Bozen,13,,410,398,808
008 Bozen,14,,349,380,729
008 Bozen,15,,373,361,734
008 Bozen,16,,398,372,770
008 Bozen,17,,386,376,762
008 Bozen,18,,434,350,784
008 Bozen,19,,406,391,797
008 Bozen,20,,417,391,808
008 Bozen,21,,463,395,858
008 Bozen,22,,426,435,861
008 Bozen,23,,500,438,938
008 Bozen,24,,532,463,995
008 Bozen,25,,535,537,1.072
008 Bozen,26,,643,612,1.255
008 Bozen,27,,697,643,1.340
008 Bozen,28,,711,738,1.449
008 Bozen,29,,796,734,1.530
008 Bozen,30,,878,798,1.676
008 Bozen,31,,857,740,1.597
008 Bozen,32,,904,792,1.696
008 Bozen,33,,799,756,1.555
008 Bozen,34,,811,793,1.604
008 Bozen,35,,894,835,1.729
008 Bozen,36,,918,845,1.763
008 Bozen,37,,908,892,1.800
008 Bozen,38,,784,805,1.589
008 Bozen,39,,769,762,1.531
008 Bozen,40,,791,718,1.509
008 Bozen,41,,705,668,1.373
008 Bozen,42,,695,672,1.367
008 Bozen,43,,703,673,1.376
008 Bozen,44,,629,702,1.331
008 Bozen,45,,640,641,1.281
008 Bozen,46,,629,625,1.254
008 Bozen,47,,631,586,1.217
008 Bozen,48,,546,601,1.147
008 Bozen,49,,555,644,1.199
008 Bozen,50,,545,643,1.188
008 Bozen,51,,615,683,1.298
008 Bozen,52,,631,645,1.276
008 Bozen,53,,667,730,1.397
008 Bozen,54,,660,809,1.469
008 Bozen,55,,742,881,1.623
008 Bozen,56,,562,606,1.168
008 Bozen,57,,610,740,1.350
008 Bozen,58,,651,738,1.389
008 Bozen,59,,666,739,1.405
008 Bozen,60,,731,780,1.511
008 Bozen,61,,701,756,1.457
008 Bozen,62,,617,746,1.363
008 Bozen,63,,667,679,1.346
008 Bozen,64,,564,598,1.162
008 Bozen,65,,522,585,1.107
008 Bozen,66,,502,595,1.097
008 Bozen,67,,521,585,1.106
008 Bozen,68,,444,588,1.032
008 Bozen,69,,458,598,1.056
008 Bozen,70,,461,586,1.047
008 Bozen,71,,479,585,1.064
008 Bozen,72,,364,573,937
008 Bozen,73,,400,530,930
008 Bozen,74,,364,538,902
008 Bozen,75,,419,517,936
008 Bozen,76,,315,557,872
008 Bozen,77,,315,538,853
008 Bozen,78,,310,531,841
008 Bozen,79,,303,557,860
008 Bozen,80,,248,504,752
008 Bozen,81,,229,497,726
008 Bozen,82,,130,299,429
008 Bozen,83,,84,183,267
008 Bozen,84,,87,183,270
008 Bozen,85,,88,195,283
008 Bozen,86,,109,264,373
008 Bozen,87,,113,242,355
008 Bozen,88,,96,220,316
008 Bozen,89,,80,200,280
008 Bozen,90,,48,170,218
008 Bozen,91,,41,124,165
008 Bozen,92,,34,94,128
008 Bozen,93,,22,75,97
008 Bozen,94,,8,52,60
008 Bozen,95,,8,46,54
008 Bozen,96,,3,24,27
008 Bozen,97,,3,22,25
008 Bozen,98,,-,19,19
008 Bozen,99,,3,7,10
008 Bozen,100,,1,6,7
008 Bozen,101,,-,2,2
008 Bozen,102,,-,1,1
008 Bozen,103,,-,2,2
008 Bozen,104,,-,2,2
009 Prags,0,,4,5,9
009 Prags,1,,2,2,4
009 Prags,2,,4,7,11
009 Prags,3,,1,4,5
009 Prags,4,,3,4,7
009 Prags,5,,2,5,7
009 Prags,6,,2,2,4
009 Prags,7,,4,6,10
009 Prags,8,,7,4,11
009 Prags,9,,6,3,9
009 Prags,10,,9,2,11
009 Prags,11,,4,2,6
009 Prags,12,,9,3,12
009 Prags,13,,2,3,5
009 Prags,14,,3,3,6
009 Prags,15,,6,5,11
009 Prags,16,,8,2,10
009 Prags,17,,4,3,7
009 Prags,18,,3,7,10
009 Prags,19,,3,6,9
009 Prags,20,,1,6,7
009 Prags,21,,5,1,6
009 Prags,22,,2,1,3
009 Prags,23,,6,2,8
009 Prags,24,,4,2,6
009 Prags,25,,6,2,8
009 Prags,26,,3,6,9
009 Prags,27,,4,5,9
009 Prags,28,,7,7,14
009 Prags,29,,4,1,5
009 Prags,30,,5,3,8
009 Prags,31,,4,6,10
009 Prags,32,,8,4,12
009 Prags,33,,7,8,15
009 Prags,34,,5,8,13
009 Prags,35,,8,4,12
009 Prags,36,,8,8,16
009 Prags,37,,6,5,11
009 Prags,38,,7,5,12
009 Prags,39,,4,4,8
009 Prags,40,,5,11,16
009 Prags,41,,6,3,9
009 Prags,42,,12,5,17
009 Prags,43,,5,2,7
009 Prags,44,,5,4,9
009 Prags,45,,1,5,6
009 Prags,46,,3,4,7
009 Prags,47,,6,4,10
009 Prags,48,,4,2,6
009 Prags,49,,2,5,7
009 Prags,50,,3,1,4
009 Prags,51,,5,1,6
009 Prags,52,,1,2,3
009 Prags,53,,5,1,6
009 Prags,54,,1,-,1
009 Prags,55,,2,4,6
009 Prags,56,,2,2,4
009 Prags,57,,4,5,9
009 Prags,58,,1,4,5
009 Prags,59,,4,4,8
009 Prags,60,,5,2,7
009 Prags,61,,1,3,4
009 Prags,62,,3,5,8
009 Prags,63,,4,2,6
009 Prags,64,,1,3,4
009 Prags,65,,2,3,5
009 Prags,66,,1,3,4
009 Prags,67,,3,2,5
009 Prags,68,,5,2,7
009 Prags,69,,4,6,10
009 Prags,70,,1,4,5
009 Prags,71,,1,1,2
009 Prags,72,,3,1,4
009 Prags,73,,3,2,5
009 Prags,74,,3,6,9
009 Prags,75,,2,4,6
009 Prags,76,,1,5,6
009 Prags,77,,4,2,6
009 Prags,78,,-,4,4
009 Prags,79,,3,2,5
009 Prags,80,,2,3,5
009 Prags,81,,1,1,2
009 Prags,82,,-,3,3
009 Prags,84,,1,2,3
009 Prags,85,,-,1,1
009 Prags,86,,1,1,2
009 Prags,87,,-,1,1
009 Prags,88,,-,1,1
009 Prags,89,,-,1,1
009 Prags,90,,-,1,1
009 Prags,92,,1,-,1
010 Brenner,0,,6,10,16
010 Brenner,1,,14,15,29
010 Brenner,2,,14,16,30
010 Brenner,3,,17,4,21
010 Brenner,4,,14,6,20
010 Brenner,5,,7,11,18
010 Brenner,6,,7,7,14
010 Brenner,7,,20,12,32
010 Brenner,8,,12,9,21
010 Brenner,9,,10,9,19
010 Brenner,10,,8,20,28
010 Brenner,11,,11,8,19
010 Brenner,12,,14,5,19
010 Brenner,13,,12,4,16
010 Brenner,14,,7,8,15
010 Brenner,15,,12,10,22
010 Brenner,16,,18,8,26
010 Brenner,17,,14,18,32
010 Brenner,18,,18,20,38
010 Brenner,19,,13,6,19
010 Brenner,20,,8,14,22
010 Brenner,21,,10,13,23
010 Brenner,22,,12,10,22
010 Brenner,23,,18,11,29
010 Brenner,24,,16,13,29
010 Brenner,25,,15,10,25
010 Brenner,26,,11,22,33
010 Brenner,27,,17,13,30
010 Brenner,28,,15,14,29
010 Brenner,29,,19,24,43
010 Brenner,30,,25,15,40
010 Brenner,31,,30,19,49
010 Brenner,32,,17,17,34
010 Brenner,33,,13,21,34
010 Brenner,34,,18,20,38
010 Brenner,35,,18,14,32
010 Brenner,36,,22,20,42
010 Brenner,37,,22,17,39
010 Brenner,38,,14,19,33
010 Brenner,39,,20,12,32
010 Brenner,40,,22,12,34
010 Brenner,41,,23,12,35
010 Brenner,42,,17,13,30
010 Brenner,43,,16,9,25
010 Brenner,44,,16,18,34
010 Brenner,45,,16,13,29
010 Brenner,46,,16,9,25
010 Brenner,47,,10,15,25
010 Brenner,48,,9,15,24
010 Brenner,49,,20,9,29
010 Brenner,50,,15,11,26
010 Brenner,51,,13,13,26
010 Brenner,52,,18,16,34
010 Brenner,53,,5,8,13
010 Brenner,54,,22,14,36
010 Brenner,55,,10,16,26
010 Brenner,56,,7,8,15
010 Brenner,57,,19,13,32
010 Brenner,58,,20,14,34
010 Brenner,59,,7,9,16
010 Brenner,60,,10,12,22
010 Brenner,61,,11,11,22
010 Brenner,62,,10,7,17
010 Brenner,63,,10,17,27
010 Brenner,64,,9,14,23
010 Brenner,65,,13,7,20
010 Brenner,66,,6,6,12
010 Brenner,67,,9,8,17
010 Brenner,68,,7,8,15
010 Brenner,69,,2,4,6
010 Brenner,70,,7,10,17
010 Brenner,71,,8,12,20
010 Brenner,72,,12,10,22
010 Brenner,73,,9,9,18
010 Brenner,74,,7,4,11
010 Brenner,75,,9,9,18
010 Brenner,76,,3,9,12
010 Brenner,77,,2,10,12
010 Brenner,78,,5,10,15
010 Brenner,79,,1,7,8
010 Brenner,80,,2,4,6
010 Brenner,81,,3,7,10
010 Brenner,82,,3,3,6
010 Brenner,83,,2,-,2
010 Brenner,84,,1,6,7
010 Brenner,85,,1,-,1
010 Brenner,86,,1,3,4
010 Brenner,87,,1,5,6
010 Brenner,88,,-,3,3
010 Brenner,89,,-,4,4
010 Brenner,90,,2,1,3
010 Brenner,91,,-,2,2
010 Brenner,92,,-,1,1
010 Brenner,95,,-,1,1
010 Brenner,97,,-,1,1
011 Brixen,0,,120,108,228
011 Brixen,1,,114,118,232
011 Brixen,2,,128,118,246
011 Brixen,3,,106,136,242
011 Brixen,4,,110,96,206
011 Brixen,5,,113,108,221
011 Brixen,6,,106,109,215
011 Brixen,7,,117,116,233
011 Brixen,8,,98,101,199
011 Brixen,9,,112,116,228
011 Brixen,10,,108,104,212
011 Brixen,11,,96,106,202
011 Brixen,12,,108,90,198
011 Brixen,13,,109,100,209
011 Brixen,14,,98,93,191
011 Brixen,15,,99,111,210
011 Brixen,16,,113,89,202
011 Brixen,17,,116,86,202
011 Brixen,18,,115,121,236
011 Brixen,19,,118,104,222
011 Brixen,20,,107,98,205
011 Brixen,21,,92,101,193
011 Brixen,22,,120,92,212
011 Brixen,23,,85,94,179
011 Brixen,24,,118,112,230
011 Brixen,25,,129,115,244
011 Brixen,26,,100,109,209
011 Brixen,27,,137,133,270
011 Brixen,28,,141,149,290
011 Brixen,29,,146,142,288
011 Brixen,30,,150,145,295
011 Brixen,31,,176,145,321
011 Brixen,32,,187,174,361
011 Brixen,33,,172,179,351
011 Brixen,34,,163,156,319
011 Brixen,35,,177,185,362
011 Brixen,36,,182,154,336
011 Brixen,37,,184,181,365
011 Brixen,38,,154,169,323
011 Brixen,39,,161,156,317
011 Brixen,40,,137,163,300
011 Brixen,41,,153,148,301
011 Brixen,42,,152,141,293
011 Brixen,43,,154,113,267
011 Brixen,44,,136,136,272
011 Brixen,45,,105,138,243
011 Brixen,46,,122,93,215
011 Brixen,47,,95,108,203
011 Brixen,48,,83,104,187
011 Brixen,49,,105,100,205
011 Brixen,50,,100,104,204
011 Brixen,51,,108,99,207
011 Brixen,52,,80,123,203
011 Brixen,53,,115,120,235
011 Brixen,54,,90,111,201
011 Brixen,55,,108,113,221
011 Brixen,56,,68,98,166
011 Brixen,57,,119,104,223
011 Brixen,58,,134,120,254
011 Brixen,59,,96,98,194
011 Brixen,60,,105,123,228
011 Brixen,61,,90,125,215
011 Brixen,62,,101,108,209
011 Brixen,63,,91,100,191
011 Brixen,64,,87,98,185
011 Brixen,65,,71,94,165
011 Brixen,66,,81,83,164
011 Brixen,67,,81,96,177
011 Brixen,68,,82,69,151
011 Brixen,69,,73,81,154
011 Brixen,70,,73,86,159
011 Brixen,71,,72,99,171
011 Brixen,72,,57,98,155
011 Brixen,73,,69,78,147
011 Brixen,74,,45,96,141
011 Brixen,75,,51,76,127
011 Brixen,76,,56,83,139
011 Brixen,77,,47,80,127
011 Brixen,78,,46,66,112
011 Brixen,79,,44,81,125
011 Brixen,80,,28,81,109
011 Brixen,81,,33,64,97
011 Brixen,82,,21,47,68
011 Brixen,83,,16,32,48
011 Brixen,84,,16,38,54
011 Brixen,85,,8,24,32
011 Brixen,86,,9,32,41
011 Brixen,87,,20,42,62
011 Brixen,88,,10,43,53
011 Brixen,89,,10,38,48
011 Brixen,90,,6,32,38
011 Brixen,91,,8,29,37
011 Brixen,92,,7,15,22
011 Brixen,93,,4,16,20
011 Brixen,94,,2,7,9
011 Brixen,95,,1,6,7
011 Brixen,96,,2,2,4
011 Brixen,97,,-,1,1
011 Brixen,99,,-,2,2
011 Brixen,100,,-,4,4
011 Brixen,101,,-,1,1
012 Branzoll,0,,11,12,23
012 Branzoll,1,,21,10,31
012 Branzoll,2,,10,12,22
012 Branzoll,3,,13,9,22
012 Branzoll,4,,12,22,34
012 Branzoll,5,,16,8,24
012 Branzoll,6,,12,11,23
012 Branzoll,7,,16,10,26
012 Branzoll,8,,16,13,29
012 Branzoll,9,,15,11,26
012 Branzoll,10,,12,16,28
012 Branzoll,11,,9,17,26
012 Branzoll,12,,11,15,26
012 Branzoll,13,,15,14,29
012 Branzoll,14,,11,5,16
012 Branzoll,15,,9,12,21
012 Branzoll,16,,13,14,27
012 Branzoll,17,,14,10,24
012 Branzoll,18,,14,11,25
012 Branzoll,19,,16,11,27
012 Branzoll,20,,14,14,28
012 Branzoll,21,,8,14,22
012 Branzoll,22,,11,6,17
012 Branzoll,23,,10,13,23
012 Branzoll,24,,12,13,25
012 Branzoll,25,,14,13,27
012 Branzoll,26,,11,10,21
012 Branzoll,27,,17,23,40
012 Branzoll,28,,23,18,41
012 Branzoll,29,,17,12,29
012 Branzoll,30,,17,16,33
012 Branzoll,31,,19,24,43
012 Branzoll,32,,22,18,40
012 Branzoll,33,,22,21,43
012 Branzoll,34,,21,22,43
012 Branzoll,35,,19,21,40
012 Branzoll,36,,20,24,44
012 Branzoll,37,,31,25,56
012 Branzoll,38,,18,17,35
012 Branzoll,39,,19,17,36
012 Branzoll,40,,32,33,65
012 Branzoll,41,,22,20,42
012 Branzoll,42,,13,22,35
012 Branzoll,43,,21,15,36
012 Branzoll,44,,24,19,43
012 Branzoll,45,,13,15,28
012 Branzoll,46,,16,18,34
012 Branzoll,47,,22,15,37
012 Branzoll,48,,11,20,31
012 Branzoll,49,,16,18,34
012 Branzoll,50,,15,15,30
012 Branzoll,51,,19,15,34
012 Branzoll,52,,16,15,31
012 Branzoll,53,,15,16,31
012 Branzoll,54,,13,18,31
012 Branzoll,55,,15,21,36
012 Branzoll,56,,12,8,20
012 Branzoll,57,,12,11,23
012 Branzoll,58,,15,12,27
012 Branzoll,59,,19,7,26
012 Branzoll,60,,18,11,29
012 Branzoll,61,,11,13,24
012 Branzoll,62,,16,15,31
012 Branzoll,63,,9,11,20
012 Branzoll,64,,5,10,15
012 Branzoll,65,,10,10,20
012 Branzoll,66,,7,10,17
012 Branzoll,67,,5,12,17
012 Branzoll,68,,19,11,30
012 Branzoll,69,,10,12,22
012 Branzoll,70,,3,10,13
012 Branzoll,71,,8,17,25
012 Branzoll,72,,7,10,17
012 Branzoll,73,,7,10,17
012 Branzoll,74,,4,8,12
012 Branzoll,75,,9,11,20
012 Branzoll,76,,4,6,10
012 Branzoll,77,,4,8,12
012 Branzoll,78,,9,11,20
012 Branzoll,79,,3,5,8
012 Branzoll,80,,5,10,15
012 Branzoll,81,,1,5,6
012 Branzoll,82,,2,6,8
012 Branzoll,83,,2,4,6
012 Branzoll,84,,-,3,3
012 Branzoll,85,,2,1,3
012 Branzoll,86,,2,1,3
012 Branzoll,87,,-,5,5
012 Branzoll,88,,2,3,5
012 Branzoll,89,,1,3,4
012 Branzoll,90,,1,2,3
012 Branzoll,91,,1,1,2
012 Branzoll,92,,-,3,3
012 Branzoll,93,,-,1,1
012 Branzoll,94,,3,-,3
012 Branzoll,95,,1,-,1
013 Bruneck,0,,88,78,166
013 Bruneck,1,,76,83,159
013 Bruneck,2,,97,90,187
013 Bruneck,3,,97,83,180
013 Bruneck,4,,104,66,170
013 Bruneck,5,,71,82,153
013 Bruneck,6,,58,71,129
013 Bruneck,7,,85,75,160
013 Bruneck,8,,74,67,141
013 Bruneck,9,,88,70,158
013 Bruneck,10,,85,56,141
013 Bruneck,11,,83,72,155
013 Bruneck,12,,75,77,152
013 Bruneck,13,,65,72,137
013 Bruneck,14,,56,59,115
013 Bruneck,15,,103,70,173
013 Bruneck,16,,72,65,137
013 Bruneck,17,,77,72,149
013 Bruneck,18,,69,73,142
013 Bruneck,19,,70,70,140
013 Bruneck,20,,86,86,172
013 Bruneck,21,,101,89,190
013 Bruneck,22,,89,95,184
013 Bruneck,23,,113,89,202
013 Bruneck,24,,102,82,184
013 Bruneck,25,,92,93,185
013 Bruneck,26,,104,114,218
013 Bruneck,27,,108,101,209
013 Bruneck,28,,112,115,227
013 Bruneck,29,,121,116,237
013 Bruneck,30,,133,119,252
013 Bruneck,31,,123,135,258
013 Bruneck,32,,124,118,242
013 Bruneck,33,,118,133,251
013 Bruneck,34,,131,110,241
013 Bruneck,35,,126,110,236
013 Bruneck,36,,137,134,271
013 Bruneck,37,,130,131,261
013 Bruneck,38,,115,112,227
013 Bruneck,39,,123,113,236
013 Bruneck,40,,114,94,208
013 Bruneck,41,,102,110,212
013 Bruneck,42,,110,102,212
013 Bruneck,43,,101,105,206
013 Bruneck,44,,84,98,182
013 Bruneck,45,,85,90,175
013 Bruneck,46,,83,79,162
013 Bruneck,47,,89,87,176
013 Bruneck,48,,72,98,170
013 Bruneck,49,,85,96,181
013 Bruneck,50,,70,91,161
013 Bruneck,51,,85,95,180
013 Bruneck,52,,87,88,175
013 Bruneck,53,,78,108,186
013 Bruneck,54,,93,67,160
013 Bruneck,55,,100,79,179
013 Bruneck,56,,58,69,127
013 Bruneck,57,,90,92,182
013 Bruneck,58,,97,85,182
013 Bruneck,59,,94,87,181
013 Bruneck,60,,75,94,169
013 Bruneck,61,,79,84,163
013 Bruneck,62,,87,89,176
013 Bruneck,63,,56,54,110
013 Bruneck,64,,52,58,110
013 Bruneck,65,,58,55,113
013 Bruneck,66,,49,51,100
013 Bruneck,67,,48,51,99
013 Bruneck,68,,54,64,118
013 Bruneck,69,,57,50,107
013 Bruneck,70,,38,54,92
013 Bruneck,71,,41,65,106
013 Bruneck,72,,37,59,96
013 Bruneck,73,,42,63,105
013 Bruneck,74,,31,52,83
013 Bruneck,75,,29,41,70
013 Bruneck,76,,31,47,78
013 Bruneck,77,,18,61,79
013 Bruneck,78,,32,47,79
013 Bruneck,79,,28,47,75
013 Bruneck,80,,20,34,54
013 Bruneck,81,,18,41,59
013 Bruneck,82,,14,27,41
013 Bruneck,83,,5,19,24
013 Bruneck,84,,6,20,26
013 Bruneck,85,,4,28,32
013 Bruneck,86,,5,19,24
013 Bruneck,87,,9,22,31
013 Bruneck,88,,8,32,40
013 Bruneck,89,,10,20,30
013 Bruneck,90,,1,17,18
013 Bruneck,91,,6,13,19
013 Bruneck,92,,7,7,14
013 Bruneck,93,,2,9,11
013 Bruneck,94,,1,6,7
013 Bruneck,95,,2,6,8
013 Bruneck,96,,2,3,5
013 Bruneck,98,,-,2,2
013 Bruneck,99,,-,3,3
013 Bruneck,101,,-,1,1
014 Kuens,0,,5,1,6
014 Kuens,1,,1,6,7
014 Kuens,2,,3,2,5
014 Kuens,3,,2,3,5
014 Kuens,4,,1,1,2
014 Kuens,5,,5,2,7
014 Kuens,6,,2,3,5
014 Kuens,7,,1,4,5
014 Kuens,8,,3,3,6
014 Kuens,9,,3,2,5
014 Kuens,10,,2,2,4
014 Kuens,11,,3,2,5
014 Kuens,12,,3,2,5
014 Kuens,13,,1,3,4
014 Kuens,14,,3,-,3
014 Kuens,15,,1,-,1
014 Kuens,17,,1,-,1
014 Kuens,18,,2,2,4
014 Kuens,19,,2,-,2
014 Kuens,20,,2,-,2
014 Kuens,21,,3,2,5
014 Kuens,22,,1,1,2
014 Kuens,23,,2,-,2
014 Kuens,24,,2,4,6
014 Kuens,25,,3,2,5
014 Kuens,26,,4,2,6
014 Kuens,27,,4,8,12
014 Kuens,28,,-,3,3
014 Kuens,29,,4,2,6
014 Kuens,30,,1,3,4
014 Kuens,31,,6,2,8
014 Kuens,32,,4,1,5
014 Kuens,33,,3,4,7
014 Kuens,34,,4,10,14
014 Kuens,35,,4,5,9
014 Kuens,36,,8,1,9
014 Kuens,37,,5,5,10
014 Kuens,38,,9,2,11
014 Kuens,39,,5,2,7
014 Kuens,40,,-,4,4
014 Kuens,42,,1,-,1
014 Kuens,43,,-,4,4
014 Kuens,44,,3,-,3
014 Kuens,45,,3,-,3
014 Kuens,46,,1,2,3
014 Kuens,48,,1,1,2
014 Kuens,49,,-,1,1
014 Kuens,51,,1,3,4
014 Kuens,52,,-,2,2
014 Kuens,53,,3,1,4
014 Kuens,54,,1,2,3
014 Kuens,55,,1,2,3
014 Kuens,56,,3,1,4
014 Kuens,58,,-,2,2
014 Kuens,59,,-,4,4
014 Kuens,60,,-,2,2
014 Kuens,61,,-,1,1
014 Kuens,62,,4,2,6
014 Kuens,63,,3,2,5
014 Kuens,64,,1,3,4
014 Kuens,65,,2,2,4
014 Kuens,66,,1,3,4
014 Kuens,67,,-,1,1
014 Kuens,68,,2,1,3
014 Kuens,69,,4,2,6
014 Kuens,70,,2,2,4
014 Kuens,71,,2,2,4
014 Kuens,72,,1,-,1
014 Kuens,73,,1,-,1
014 Kuens,74,,1,1,2
014 Kuens,75,,1,-,1
014 Kuens,79,,-,2,2
014 Kuens,82,,-,2,2
014 Kuens,85,,-,1,1
014 Kuens,86,,1,-,1
014 Kuens,89,,1,-,1
014 Kuens,93,,-,1,1
015 Kaltern a.d. Weinstr.,0,,34,41,75
015 Kaltern a.d. Weinstr.,1,,33,38,71
015 Kaltern a.d. Weinstr.,2,,43,33,76
015 Kaltern a.d. Weinstr.,3,,37,43,80
015 Kaltern a.d. Weinstr.,4,,39,44,83
015 Kaltern a.d. Weinstr.,5,,36,44,80
015 Kaltern a.d. Weinstr.,6,,41,36,77
015 Kaltern a.d. Weinstr.,7,,34,39,73
015 Kaltern a.d. Weinstr.,8,,30,38,68
015 Kaltern a.d. Weinstr.,9,,41,35,76
015 Kaltern a.d. Weinstr.,10,,32,40,72
015 Kaltern a.d. Weinstr.,11,,35,36,71
015 Kaltern a.d. Weinstr.,12,,54,25,79
015 Kaltern a.d. Weinstr.,13,,39,35,74
015 Kaltern a.d. Weinstr.,14,,40,32,72
015 Kaltern a.d. Weinstr.,15,,52,41,93
015 Kaltern a.d. Weinstr.,16,,48,36,84
015 Kaltern a.d. Weinstr.,17,,38,35,73
015 Kaltern a.d. Weinstr.,18,,40,43,83
015 Kaltern a.d. Weinstr.,19,,42,43,85
015 Kaltern a.d. Weinstr.,20,,42,37,79
015 Kaltern a.d. Weinstr.,21,,40,43,83
015 Kaltern a.d. Weinstr.,22,,42,38,80
015 Kaltern a.d. Weinstr.,23,,39,28,67
015 Kaltern a.d. Weinstr.,24,,34,42,76
015 Kaltern a.d. Weinstr.,25,,41,42,83
015 Kaltern a.d. Weinstr.,26,,37,48,85
015 Kaltern a.d. Weinstr.,27,,51,48,99
015 Kaltern a.d. Weinstr.,28,,35,46,81
015 Kaltern a.d. Weinstr.,29,,46,56,102
015 Kaltern a.d. Weinstr.,30,,56,50,106
015 Kaltern a.d. Weinstr.,31,,64,57,121
015 Kaltern a.d. Weinstr.,32,,58,69,127
015 Kaltern a.d. Weinstr.,33,,72,62,134
015 Kaltern a.d. Weinstr.,34,,61,58,119
015 Kaltern a.d. Weinstr.,35,,58,66,124
015 Kaltern a.d. Weinstr.,36,,55,61,116
015 Kaltern a.d. Weinstr.,37,,81,55,136
015 Kaltern a.d. Weinstr.,38,,57,55,112
015 Kaltern a.d. Weinstr.,39,,62,63,125
015 Kaltern a.d. Weinstr.,40,,63,60,123
015 Kaltern a.d. Weinstr.,41,,55,60,115
015 Kaltern a.d. Weinstr.,42,,54,51,105
015 Kaltern a.d. Weinstr.,43,,58,61,119
015 Kaltern a.d. Weinstr.,44,,51,57,108
015 Kaltern a.d. Weinstr.,45,,62,43,105
015 Kaltern a.d. Weinstr.,46,,52,40,92
015 Kaltern a.d. Weinstr.,47,,35,47,82
015 Kaltern a.d. Weinstr.,48,,34,37,71
015 Kaltern a.d. Weinstr.,49,,37,55,92
015 Kaltern a.d. Weinstr.,50,,34,33,67
015 Kaltern a.d. Weinstr.,51,,43,33,76
015 Kaltern a.d. Weinstr.,52,,32,38,70
015 Kaltern a.d. Weinstr.,53,,39,37,76
015 Kaltern a.d. Weinstr.,54,,35,57,92
015 Kaltern a.d. Weinstr.,55,,50,40,90
015 Kaltern a.d. Weinstr.,56,,38,38,76
015 Kaltern a.d. Weinstr.,57,,40,45,85
015 Kaltern a.d. Weinstr.,58,,40,36,76
015 Kaltern a.d. Weinstr.,59,,39,43,82
015 Kaltern a.d. Weinstr.,60,,43,43,86
015 Kaltern a.d. Weinstr.,61,,33,41,74
015 Kaltern a.d. Weinstr.,62,,24,35,59
015 Kaltern a.d. Weinstr.,63,,40,42,82
015 Kaltern a.d. Weinstr.,64,,30,34,64
015 Kaltern a.d. Weinstr.,65,,22,25,47
015 Kaltern a.d. Weinstr.,66,,25,27,52
015 Kaltern a.d. Weinstr.,67,,28,26,54
015 Kaltern a.d. Weinstr.,68,,29,38,67
015 Kaltern a.d. Weinstr.,69,,30,31,61
015 Kaltern a.d. Weinstr.,70,,27,37,64
015 Kaltern a.d. Weinstr.,71,,32,41,73
015 Kaltern a.d. Weinstr.,72,,25,32,57
015 Kaltern a.d. Weinstr.,73,,22,35,57
015 Kaltern a.d. Weinstr.,74,,18,40,58
015 Kaltern a.d. Weinstr.,75,,19,32,51
015 Kaltern a.d. Weinstr.,76,,20,38,58
015 Kaltern a.d. Weinstr.,77,,19,31,50
015 Kaltern a.d. Weinstr.,78,,11,34,45
015 Kaltern a.d. Weinstr.,79,,15,32,47
015 Kaltern a.d. Weinstr.,80,,14,35,49
015 Kaltern a.d. Weinstr.,81,,10,26,36
015 Kaltern a.d. Weinstr.,82,,7,16,23
015 Kaltern a.d. Weinstr.,83,,6,8,14
015 Kaltern a.d. Weinstr.,84,,2,10,12
015 Kaltern a.d. Weinstr.,85,,2,4,6
015 Kaltern a.d. Weinstr.,86,,4,13,17
015 Kaltern a.d. Weinstr.,87,,4,13,17
015 Kaltern a.d. Weinstr.,88,,7,14,21
015 Kaltern a.d. Weinstr.,89,,4,17,21
015 Kaltern a.d. Weinstr.,90,,2,6,8
015 Kaltern a.d. Weinstr.,91,,1,3,4
015 Kaltern a.d. Weinstr.,92,,2,4,6
015 Kaltern a.d. Weinstr.,93,,2,1,3
015 Kaltern a.d. Weinstr.,94,,-,4,4
015 Kaltern a.d. Weinstr.,95,,-,1,1
015 Kaltern a.d. Weinstr.,98,,-,1,1
016 Freienfeld,0,,18,16,34
016 Freienfeld,1,,17,14,31
016 Freienfeld,2,,14,20,34
016 Freienfeld,3,,14,16,30
016 Freienfeld,4,,23,18,41
016 Freienfeld,5,,22,12,34
016 Freienfeld,6,,13,14,27
016 Freienfeld,7,,14,9,23
016 Freienfeld,8,,15,10,25
016 Freienfeld,9,,19,21,40
016 Freienfeld,10,,10,13,23
016 Freienfeld,11,,19,18,37
016 Freienfeld,12,,27,19,46
016 Freienfeld,13,,20,14,34
016 Freienfeld,14,,15,18,33
016 Freienfeld,15,,14,12,26
016 Freienfeld,16,,15,13,28
016 Freienfeld,17,,22,15,37
016 Freienfeld,18,,21,18,39
016 Freienfeld,19,,14,16,30
016 Freienfeld,20,,24,21,45
016 Freienfeld,21,,18,16,34
016 Freienfeld,22,,21,20,41
016 Freienfeld,23,,14,15,29
016 Freienfeld,24,,15,18,33
016 Freienfeld,25,,15,9,24
016 Freienfeld,26,,18,19,37
016 Freienfeld,27,,21,18,39
016 Freienfeld,28,,22,18,40
016 Freienfeld,29,,19,23,42
016 Freienfeld,30,,23,23,46
016 Freienfeld,31,,21,14,35
016 Freienfeld,32,,24,26,50
016 Freienfeld,33,,23,21,44
016 Freienfeld,34,,23,30,53
016 Freienfeld,35,,25,18,43
016 Freienfeld,36,,25,15,40
016 Freienfeld,37,,24,19,43
016 Freienfeld,38,,22,18,40
016 Freienfeld,39,,27,29,56
016 Freienfeld,40,,25,20,45
016 Freienfeld,41,,25,21,46
016 Freienfeld,42,,28,14,42
016 Freienfeld,43,,16,19,35
016 Freienfeld,44,,15,17,32
016 Freienfeld,45,,22,15,37
016 Freienfeld,46,,19,9,28
016 Freienfeld,47,,18,17,35
016 Freienfeld,48,,17,10,27
016 Freienfeld,49,,13,18,31
016 Freienfeld,50,,15,11,26
016 Freienfeld,51,,21,10,31
016 Freienfeld,52,,17,13,30
016 Freienfeld,53,,19,13,32
016 Freienfeld,54,,5,12,17
016 Freienfeld,55,,11,16,27
016 Freienfeld,56,,13,2,15
016 Freienfeld,57,,11,5,16
016 Freienfeld,58,,15,10,25
016 Freienfeld,59,,12,9,21
016 Freienfeld,60,,13,11,24
016 Freienfeld,61,,11,4,15
016 Freienfeld,62,,11,9,20
016 Freienfeld,63,,12,11,23
016 Freienfeld,64,,6,11,17
016 Freienfeld,65,,10,12,22
016 Freienfeld,66,,8,12,20
016 Freienfeld,67,,5,6,11
016 Freienfeld,68,,10,8,18
016 Freienfeld,69,,12,10,22
016 Freienfeld,70,,9,9,18
016 Freienfeld,71,,8,8,16
016 Freienfeld,72,,5,7,12
016 Freienfeld,73,,7,6,13
016 Freienfeld,74,,6,9,15
016 Freienfeld,75,,8,14,22
016 Freienfeld,76,,8,10,18
016 Freienfeld,77,,5,6,11
016 Freienfeld,78,,2,14,16
016 Freienfeld,79,,3,9,12
016 Freienfeld,80,,1,3,4
016 Freienfeld,81,,7,4,11
016 Freienfeld,82,,3,4,7
016 Freienfeld,83,,2,4,6
016 Freienfeld,84,,-,2,2
016 Freienfeld,85,,1,3,4
016 Freienfeld,86,,-,3,3
016 Freienfeld,87,,3,5,8
016 Freienfeld,88,,2,3,5
016 Freienfeld,89,,-,1,1
016 Freienfeld,90,,1,4,5
016 Freienfeld,91,,3,2,5
016 Freienfeld,93,,-,2,2
016 Freienfeld,94,,1,1,2
017 Sand in Taufers,0,,33,36,69
017 Sand in Taufers,1,,44,25,69
017 Sand in Taufers,2,,38,35,73
017 Sand in Taufers,3,,29,34,63
017 Sand in Taufers,4,,33,36,69
017 Sand in Taufers,5,,25,32,57
017 Sand in Taufers,6,,27,29,56
017 Sand in Taufers,7,,39,34,73
017 Sand in Taufers,8,,26,33,59
017 Sand in Taufers,9,,32,36,68
017 Sand in Taufers,10,,28,32,60
017 Sand in Taufers,11,,24,31,55
017 Sand in Taufers,12,,29,28,57
017 Sand in Taufers,13,,28,28,56
017 Sand in Taufers,14,,21,22,43
017 Sand in Taufers,15,,22,20,42
017 Sand in Taufers,16,,23,26,49
017 Sand in Taufers,17,,32,26,58
017 Sand in Taufers,18,,34,29,63
017 Sand in Taufers,19,,23,37,60
017 Sand in Taufers,20,,33,36,69
017 Sand in Taufers,21,,31,33,64
017 Sand in Taufers,22,,32,35,67
017 Sand in Taufers,23,,39,33,72
017 Sand in Taufers,24,,34,38,72
017 Sand in Taufers,25,,38,39,77
017 Sand in Taufers,26,,45,39,84
017 Sand in Taufers,27,,61,40,101
017 Sand in Taufers,28,,63,40,103
017 Sand in Taufers,29,,54,54,108
017 Sand in Taufers,30,,44,47,91
017 Sand in Taufers,31,,37,51,88
017 Sand in Taufers,32,,55,40,95
017 Sand in Taufers,33,,49,42,91
017 Sand in Taufers,34,,31,46,77
017 Sand in Taufers,35,,50,33,83
017 Sand in Taufers,36,,49,34,83
017 Sand in Taufers,37,,49,44,93
017 Sand in Taufers,38,,53,46,99
017 Sand in Taufers,39,,36,39,75
017 Sand in Taufers,40,,46,40,86
017 Sand in Taufers,41,,43,33,76
017 Sand in Taufers,42,,36,33,69
017 Sand in Taufers,43,,35,22,57
017 Sand in Taufers,44,,22,37,59
017 Sand in Taufers,45,,28,36,64
017 Sand in Taufers,46,,24,22,46
017 Sand in Taufers,47,,29,28,57
017 Sand in Taufers,48,,32,24,56
017 Sand in Taufers,49,,18,28,46
017 Sand in Taufers,50,,27,22,49
017 Sand in Taufers,51,,34,34,68
017 Sand in Taufers,52,,30,21,51
017 Sand in Taufers,53,,21,25,46
017 Sand in Taufers,54,,26,29,55
017 Sand in Taufers,55,,27,25,52
017 Sand in Taufers,56,,29,9,38
017 Sand in Taufers,57,,18,30,48
017 Sand in Taufers,58,,29,30,59
017 Sand in Taufers,59,,30,33,63
017 Sand in Taufers,60,,27,32,59
017 Sand in Taufers,61,,24,19,43
017 Sand in Taufers,62,,26,30,56
017 Sand in Taufers,63,,18,27,45
017 Sand in Taufers,64,,30,13,43
017 Sand in Taufers,65,,15,25,40
017 Sand in Taufers,66,,30,17,47
017 Sand in Taufers,67,,15,14,29
017 Sand in Taufers,68,,15,18,33
017 Sand in Taufers,69,,12,18,30
017 Sand in Taufers,70,,13,12,25
017 Sand in Taufers,71,,15,18,33
017 Sand in Taufers,72,,15,13,28
017 Sand in Taufers,73,,13,15,28
017 Sand in Taufers,74,,17,13,30
017 Sand in Taufers,75,,10,20,30
017 Sand in Taufers,76,,10,14,24
017 Sand in Taufers,77,,7,17,24
017 Sand in Taufers,78,,10,11,21
017 Sand in Taufers,79,,12,16,28
017 Sand in Taufers,80,,8,16,24
017 Sand in Taufers,81,,6,10,16
017 Sand in Taufers,82,,7,9,16
017 Sand in Taufers,83,,3,6,9
017 Sand in Taufers,84,,4,9,13
017 Sand in Taufers,85,,-,5,5
017 Sand in Taufers,86,,3,7,10
017 Sand in Taufers,87,,2,11,13
017 Sand in Taufers,88,,-,7,7
017 Sand in Taufers,89,,1,3,4
017 Sand in Taufers,90,,1,7,8
017 Sand in Taufers,92,,1,4,5
017 Sand in Taufers,93,,1,-,1
017 Sand in Taufers,94,,1,3,4
017 Sand in Taufers,95,,1,-,1
017 Sand in Taufers,96,,1,-,1
017 Sand in Taufers,99,,-,1,1
018 Kastelbell-Tschars,0,,14,11,25
018 Kastelbell-Tschars,1,,10,9,19
018 Kastelbell-Tschars,2,,25,12,37
018 Kastelbell-Tschars,3,,17,9,26
018 Kastelbell-Tschars,4,,10,8,18
018 Kastelbell-Tschars,5,,13,17,30
018 Kastelbell-Tschars,6,,15,11,26
018 Kastelbell-Tschars,7,,13,15,28
018 Kastelbell-Tschars,8,,14,16,30
018 Kastelbell-Tschars,9,,14,13,27
018 Kastelbell-Tschars,10,,20,14,34
018 Kastelbell-Tschars,11,,15,10,25
018 Kastelbell-Tschars,12,,16,11,27
018 Kastelbell-Tschars,13,,19,7,26
018 Kastelbell-Tschars,14,,19,15,34
018 Kastelbell-Tschars,15,,18,21,39
018 Kastelbell-Tschars,16,,21,15,36
018 Kastelbell-Tschars,17,,8,10,18
018 Kastelbell-Tschars,18,,13,22,35
018 Kastelbell-Tschars,19,,24,14,38
018 Kastelbell-Tschars,20,,15,23,38
018 Kastelbell-Tschars,21,,20,19,39
018 Kastelbell-Tschars,22,,16,17,33
018 Kastelbell-Tschars,23,,14,22,36
018 Kastelbell-Tschars,24,,13,17,30
018 Kastelbell-Tschars,25,,19,18,37
018 Kastelbell-Tschars,26,,18,11,29
018 Kastelbell-Tschars,27,,20,14,34
018 Kastelbell-Tschars,28,,22,18,40
018 Kastelbell-Tschars,29,,12,17,29
018 Kastelbell-Tschars,30,,16,13,29
018 Kastelbell-Tschars,31,,14,15,29
018 Kastelbell-Tschars,32,,24,19,43
018 Kastelbell-Tschars,33,,15,16,31
018 Kastelbell-Tschars,34,,13,23,36
018 Kastelbell-Tschars,35,,22,10,32
018 Kastelbell-Tschars,36,,23,15,38
018 Kastelbell-Tschars,37,,23,17,40
018 Kastelbell-Tschars,38,,24,21,45
018 Kastelbell-Tschars,39,,8,22,30
018 Kastelbell-Tschars,40,,21,18,39
018 Kastelbell-Tschars,41,,24,20,44
018 Kastelbell-Tschars,42,,25,20,45
018 Kastelbell-Tschars,43,,17,13,30
018 Kastelbell-Tschars,44,,15,11,26
018 Kastelbell-Tschars,45,,12,18,30
018 Kastelbell-Tschars,46,,18,20,38
018 Kastelbell-Tschars,47,,9,13,22
018 Kastelbell-Tschars,48,,9,16,25
018 Kastelbell-Tschars,49,,13,17,30
018 Kastelbell-Tschars,50,,16,12,28
018 Kastelbell-Tschars,51,,13,13,26
018 Kastelbell-Tschars,52,,12,8,20
018 Kastelbell-Tschars,53,,12,10,22
018 Kastelbell-Tschars,54,,10,8,18
018 Kastelbell-Tschars,55,,14,13,27
018 Kastelbell-Tschars,56,,10,4,14
018 Kastelbell-Tschars,57,,11,7,18
018 Kastelbell-Tschars,58,,9,8,17
018 Kastelbell-Tschars,59,,11,12,23
018 Kastelbell-Tschars,60,,9,8,17
018 Kastelbell-Tschars,61,,8,10,18
018 Kastelbell-Tschars,62,,12,12,24
018 Kastelbell-Tschars,63,,8,15,23
018 Kastelbell-Tschars,64,,11,10,21
018 Kastelbell-Tschars,65,,10,16,26
018 Kastelbell-Tschars,66,,11,11,22
018 Kastelbell-Tschars,67,,5,16,21
018 Kastelbell-Tschars,68,,17,13,30
018 Kastelbell-Tschars,69,,7,14,21
018 Kastelbell-Tschars,70,,10,14,24
018 Kastelbell-Tschars,71,,23,16,39
018 Kastelbell-Tschars,72,,11,14,25
018 Kastelbell-Tschars,73,,7,11,18
018 Kastelbell-Tschars,74,,10,9,19
018 Kastelbell-Tschars,75,,12,16,28
018 Kastelbell-Tschars,76,,12,12,24
018 Kastelbell-Tschars,77,,4,9,13
018 Kastelbell-Tschars,78,,8,10,18
018 Kastelbell-Tschars,79,,6,9,15
018 Kastelbell-Tschars,80,,4,7,11
018 Kastelbell-Tschars,81,,5,9,14
018 Kastelbell-Tschars,82,,2,4,6
018 Kastelbell-Tschars,83,,-,4,4
018 Kastelbell-Tschars,84,,1,3,4
018 Kastelbell-Tschars,85,,-,1,1
018 Kastelbell-Tschars,86,,5,3,8
018 Kastelbell-Tschars,87,,1,5,6
018 Kastelbell-Tschars,88,,6,1,7
018 Kastelbell-Tschars,89,,1,2,3
018 Kastelbell-Tschars,90,,1,4,5
018 Kastelbell-Tschars,91,,-,2,2
018 Kastelbell-Tschars,92,,1,-,1
018 Kastelbell-Tschars,93,,-,2,2
018 Kastelbell-Tschars,94,,-,1,1
019 Kastelruth,0,,41,28,69
019 Kastelruth,1,,38,30,68
019 Kastelruth,2,,33,40,73
019 Kastelruth,3,,52,48,100
019 Kastelruth,4,,48,49,97
019 Kastelruth,5,,43,38,81
019 Kastelruth,6,,56,40,96
019 Kastelruth,7,,31,31,62
019 Kastelruth,8,,39,35,74
019 Kastelruth,9,,36,50,86
019 Kastelruth,10,,35,39,74
019 Kastelruth,11,,36,37,73
019 Kastelruth,12,,46,38,84
019 Kastelruth,13,,26,24,50
019 Kastelruth,14,,35,41,76
019 Kastelruth,15,,32,23,55
019 Kastelruth,16,,26,33,59
019 Kastelruth,17,,34,29,63
019 Kastelruth,18,,34,44,78
019 Kastelruth,19,,44,33,77
019 Kastelruth,20,,36,41,77
019 Kastelruth,21,,44,37,81
019 Kastelruth,22,,30,43,73
019 Kastelruth,23,,30,38,68
019 Kastelruth,24,,37,40,77
019 Kastelruth,25,,43,52,95
019 Kastelruth,26,,53,32,85
019 Kastelruth,27,,56,50,106
019 Kastelruth,28,,46,54,100
019 Kastelruth,29,,67,37,104
019 Kastelruth,30,,59,45,104
019 Kastelruth,31,,46,56,102
019 Kastelruth,32,,67,53,120
019 Kastelruth,33,,62,56,118
019 Kastelruth,34,,66,61,127
019 Kastelruth,35,,72,51,123
019 Kastelruth,36,,43,79,122
019 Kastelruth,37,,54,40,94
019 Kastelruth,38,,56,33,89
019 Kastelruth,39,,37,48,85
019 Kastelruth,40,,51,44,95
019 Kastelruth,41,,49,39,88
019 Kastelruth,42,,47,43,90
019 Kastelruth,43,,47,41,88
019 Kastelruth,44,,37,36,73
019 Kastelruth,45,,34,29,63
019 Kastelruth,46,,36,36,72
019 Kastelruth,47,,38,28,66
019 Kastelruth,48,,29,28,57
019 Kastelruth,49,,37,25,62
019 Kastelruth,50,,29,25,54
019 Kastelruth,51,,42,20,62
019 Kastelruth,52,,18,32,50
019 Kastelruth,53,,28,39,67
019 Kastelruth,54,,35,31,66
019 Kastelruth,55,,21,39,60
019 Kastelruth,56,,23,19,42
019 Kastelruth,57,,21,45,66
019 Kastelruth,58,,40,39,79
019 Kastelruth,59,,33,29,62
019 Kastelruth,60,,33,47,80
019 Kastelruth,61,,28,37,65
019 Kastelruth,62,,28,28,56
019 Kastelruth,63,,28,26,54
019 Kastelruth,64,,27,24,51
019 Kastelruth,65,,33,19,52
019 Kastelruth,66,,30,29,59
019 Kastelruth,67,,24,24,48
019 Kastelruth,68,,35,28,63
019 Kastelruth,69,,19,38,57
019 Kastelruth,70,,40,27,67
019 Kastelruth,71,,14,26,40
019 Kastelruth,72,,25,26,51
019 Kastelruth,73,,14,19,33
019 Kastelruth,74,,21,31,52
019 Kastelruth,75,,15,24,39
019 Kastelruth,76,,11,22,33
019 Kastelruth,77,,18,22,40
019 Kastelruth,78,,8,19,27
019 Kastelruth,79,,12,15,27
019 Kastelruth,80,,10,19,29
019 Kastelruth,81,,12,16,28
019 Kastelruth,82,,10,8,18
019 Kastelruth,83,,4,9,13
019 Kastelruth,84,,3,5,8
019 Kastelruth,85,,-,5,5
019 Kastelruth,86,,1,13,14
019 Kastelruth,87,,9,8,17
019 Kastelruth,88,,3,5,8
019 Kastelruth,89,,5,8,13
019 Kastelruth,90,,4,7,11
019 Kastelruth,91,,-,5,5
019 Kastelruth,92,,-,5,5
019 Kastelruth,93,,1,2,3
019 Kastelruth,94,,1,1,2
019 Kastelruth,95,,-,5,5
019 Kastelruth,96,,-,2,2
019 Kastelruth,97,,-,1,1
019 Kastelruth,98,,-,1,1
020 Tscherms,0,,7,5,12
020 Tscherms,1,,9,5,14
020 Tscherms,2,,7,5,12
020 Tscherms,3,,5,9,14
020 Tscherms,4,,7,8,15
020 Tscherms,5,,5,5,10
020 Tscherms,6,,10,10,20
020 Tscherms,7,,10,15,25
020 Tscherms,8,,7,7,14
020 Tscherms,9,,11,7,18
020 Tscherms,10,,4,9,13
020 Tscherms,11,,7,6,13
020 Tscherms,12,,3,4,7
020 Tscherms,13,,5,16,21
020 Tscherms,14,,11,5,16
020 Tscherms,15,,9,7,16
020 Tscherms,16,,12,10,22
020 Tscherms,17,,13,5,18
020 Tscherms,18,,9,10,19
020 Tscherms,19,,5,9,14
020 Tscherms,20,,9,7,16
020 Tscherms,21,,8,5,13
020 Tscherms,22,,3,5,8
020 Tscherms,23,,2,8,10
020 Tscherms,24,,6,2,8
020 Tscherms,25,,8,7,15
020 Tscherms,26,,8,4,12
020 Tscherms,27,,8,5,13
020 Tscherms,28,,9,10,19
020 Tscherms,29,,10,8,18
020 Tscherms,30,,9,11,20
020 Tscherms,31,,8,5,13
020 Tscherms,32,,13,17,30
020 Tscherms,33,,18,8,26
020 Tscherms,34,,11,14,25
020 Tscherms,35,,12,9,21
020 Tscherms,36,,15,14,29
020 Tscherms,37,,12,12,24
020 Tscherms,38,,18,13,31
020 Tscherms,39,,15,8,23
020 Tscherms,40,,9,10,19
020 Tscherms,41,,10,12,22
020 Tscherms,42,,8,16,24
020 Tscherms,43,,9,9,18
020 Tscherms,44,,9,10,19
020 Tscherms,45,,8,7,15
020 Tscherms,46,,11,9,20
020 Tscherms,47,,8,7,15
020 Tscherms,48,,11,3,14
020 Tscherms,49,,13,5,18
020 Tscherms,50,,6,13,19
020 Tscherms,51,,8,7,15
020 Tscherms,52,,4,3,7
020 Tscherms,53,,7,5,12
020 Tscherms,54,,8,8,16
020 Tscherms,55,,4,8,12
020 Tscherms,56,,5,7,12
020 Tscherms,57,,6,9,15
020 Tscherms,58,,7,5,12
020 Tscherms,59,,8,3,11
020 Tscherms,60,,10,8,18
020 Tscherms,61,,5,5,10
020 Tscherms,62,,4,4,8
020 Tscherms,63,,7,2,9
020 Tscherms,64,,5,8,13
020 Tscherms,65,,5,7,12
020 Tscherms,66,,5,5,10
020 Tscherms,67,,2,9,11
020 Tscherms,68,,5,2,7
020 Tscherms,69,,6,5,11
020 Tscherms,70,,2,3,5
020 Tscherms,71,,3,5,8
020 Tscherms,72,,3,4,7
020 Tscherms,73,,5,5,10
020 Tscherms,74,,9,5,14
020 Tscherms,75,,3,2,5
020 Tscherms,76,,5,6,11
020 Tscherms,77,,4,5,9
020 Tscherms,78,,1,3,4
020 Tscherms,79,,1,6,7
020 Tscherms,80,,5,3,8
020 Tscherms,81,,5,3,8
020 Tscherms,82,,-,2,2
020 Tscherms,83,,2,2,4
020 Tscherms,84,,1,1,2
020 Tscherms,85,,1,1,2
020 Tscherms,86,,1,-,1
020 Tscherms,87,,-,3,3
020 Tscherms,88,,-,3,3
020 Tscherms,89,,2,-,2
020 Tscherms,90,,-,2,2
020 Tscherms,91,,1,1,2
021 Kiens,0,,21,22,43
021 Kiens,1,,14,19,33
021 Kiens,2,,14,19,33
021 Kiens,3,,23,5,28
021 Kiens,4,,18,13,31
021 Kiens,5,,16,19,35
021 Kiens,6,,14,22,36
021 Kiens,7,,17,18,35
021 Kiens,8,,19,16,35
021 Kiens,9,,26,17,43
021 Kiens,10,,12,25,37
021 Kiens,11,,14,20,34
021 Kiens,12,,14,18,32
021 Kiens,13,,13,14,27
021 Kiens,14,,12,13,25
021 Kiens,15,,18,11,29
021 Kiens,16,,19,13,32
021 Kiens,17,,16,11,27
021 Kiens,18,,13,18,31
021 Kiens,19,,21,17,38
021 Kiens,20,,14,21,35
021 Kiens,21,,17,27,44
021 Kiens,22,,16,20,36
021 Kiens,23,,29,20,49
021 Kiens,24,,19,16,35
021 Kiens,25,,28,22,50
021 Kiens,26,,20,25,45
021 Kiens,27,,22,19,41
021 Kiens,28,,34,26,60
021 Kiens,29,,24,22,46
021 Kiens,30,,32,25,57
021 Kiens,31,,24,26,50
021 Kiens,32,,29,23,52
021 Kiens,33,,44,21,65
021 Kiens,34,,23,25,48
021 Kiens,35,,25,23,48
021 Kiens,36,,22,22,44
021 Kiens,37,,36,24,60
021 Kiens,38,,20,22,42
021 Kiens,39,,29,19,48
021 Kiens,40,,20,24,44
021 Kiens,41,,21,20,41
021 Kiens,42,,26,16,42
021 Kiens,43,,15,13,28
021 Kiens,44,,11,18,29
021 Kiens,45,,18,13,31
021 Kiens,46,,15,11,26
021 Kiens,47,,10,16,26
021 Kiens,48,,14,23,37
021 Kiens,49,,11,8,19
021 Kiens,50,,12,13,25
021 Kiens,51,,16,10,26
021 Kiens,52,,10,15,25
021 Kiens,53,,15,18,33
021 Kiens,54,,15,14,29
021 Kiens,55,,19,13,32
021 Kiens,56,,8,12,20
021 Kiens,57,,11,13,24
021 Kiens,58,,21,12,33
021 Kiens,59,,18,11,29
021 Kiens,60,,20,11,31
021 Kiens,61,,13,15,28
021 Kiens,62,,12,8,20
021 Kiens,63,,13,14,27
021 Kiens,64,,11,13,24
021 Kiens,65,,11,11,22
021 Kiens,66,,4,18,22
021 Kiens,67,,10,14,24
021 Kiens,68,,12,8,20
021 Kiens,69,,15,12,27
021 Kiens,70,,17,9,26
021 Kiens,71,,9,12,21
021 Kiens,72,,7,9,16
021 Kiens,73,,2,6,8
021 Kiens,74,,5,7,12
021 Kiens,75,,3,4,7
021 Kiens,76,,6,4,10
021 Kiens,77,,5,7,12
021 Kiens,78,,8,6,14
021 Kiens,79,,4,4,8
021 Kiens,80,,1,7,8
021 Kiens,81,,5,3,8
021 Kiens,82,,1,3,4
021 Kiens,83,,1,2,3
021 Kiens,84,,1,3,4
021 Kiens,85,,-,4,4
021 Kiens,86,,2,3,5
021 Kiens,87,,2,4,6
021 Kiens,88,,3,3,6
021 Kiens,89,,1,3,4
021 Kiens,90,,1,-,1
021 Kiens,91,,3,1,4
021 Kiens,94,,-,1,1
022 Klausen,0,,36,34,70
022 Klausen,1,,28,30,58
022 Klausen,2,,30,25,55
022 Klausen,3,,20,29,49
022 Klausen,4,,40,32,72
022 Klausen,5,,27,28,55
022 Klausen,6,,34,24,58
022 Klausen,7,,18,31,49
022 Klausen,8,,29,23,52
022 Klausen,9,,40,27,67
022 Klausen,10,,32,30,62
022 Klausen,11,,35,23,58
022 Klausen,12,,28,29,57
022 Klausen,13,,28,32,60
022 Klausen,14,,22,34,56
022 Klausen,15,,35,29,64
022 Klausen,16,,37,36,73
022 Klausen,17,,34,26,60
022 Klausen,18,,25,38,63
022 Klausen,19,,37,34,71
022 Klausen,20,,34,30,64
022 Klausen,21,,26,32,58
022 Klausen,22,,26,38,64
022 Klausen,23,,37,41,78
022 Klausen,24,,38,32,70
022 Klausen,25,,41,22,63
022 Klausen,26,,37,39,76
022 Klausen,27,,35,30,65
022 Klausen,28,,42,26,68
022 Klausen,29,,33,43,76
022 Klausen,30,,44,38,82
022 Klausen,31,,41,47,88
022 Klausen,32,,47,50,97
022 Klausen,33,,54,46,100
022 Klausen,34,,46,42,88
022 Klausen,35,,59,42,101
022 Klausen,36,,41,36,77
022 Klausen,37,,38,42,80
022 Klausen,38,,37,38,75
022 Klausen,39,,31,41,72
022 Klausen,40,,48,40,88
022 Klausen,41,,41,26,67
022 Klausen,42,,28,36,64
022 Klausen,43,,29,29,58
022 Klausen,44,,29,27,56
022 Klausen,45,,28,24,52
022 Klausen,46,,30,31,61
022 Klausen,47,,31,41,72
022 Klausen,48,,21,30,51
022 Klausen,49,,24,16,40
022 Klausen,50,,33,26,59
022 Klausen,51,,29,23,52
022 Klausen,52,,28,26,54
022 Klausen,53,,29,26,55
022 Klausen,54,,28,20,48
022 Klausen,55,,29,21,50
022 Klausen,56,,13,16,29
022 Klausen,57,,22,18,40
022 Klausen,58,,22,29,51
022 Klausen,59,,20,26,46
022 Klausen,60,,27,20,47
022 Klausen,61,,24,22,46
022 Klausen,62,,26,20,46
022 Klausen,63,,18,20,38
022 Klausen,64,,18,18,36
022 Klausen,65,,19,24,43
022 Klausen,66,,12,20,32
022 Klausen,67,,17,15,32
022 Klausen,68,,23,17,40
022 Klausen,69,,12,22,34
022 Klausen,70,,12,14,26
022 Klausen,71,,11,19,30
022 Klausen,72,,19,22,41
022 Klausen,73,,7,17,24
022 Klausen,74,,8,15,23
022 Klausen,75,,13,11,24
022 Klausen,76,,13,9,22
022 Klausen,77,,12,16,28
022 Klausen,78,,3,17,20
022 Klausen,79,,7,17,24
022 Klausen,80,,3,12,15
022 Klausen,81,,4,14,18
022 Klausen,82,,2,10,12
022 Klausen,83,,2,10,12
022 Klausen,84,,3,8,11
022 Klausen,85,,1,4,5
022 Klausen,86,,3,2,5
022 Klausen,87,,4,8,12
022 Klausen,88,,-,12,12
022 Klausen,89,,2,4,6
022 Klausen,90,,2,2,4
022 Klausen,91,,3,3,6
022 Klausen,92,,2,3,5
022 Klausen,93,,1,4,5
022 Klausen,99,,1,-,1
023 Karneid,0,,25,19,44
023 Karneid,1,,18,17,35
023 Karneid,2,,23,28,51
023 Karneid,3,,17,19,36
023 Karneid,4,,33,19,52
023 Karneid,5,,19,17,36
023 Karneid,6,,22,19,41
023 Karneid,7,,21,22,43
023 Karneid,8,,21,22,43
023 Karneid,9,,23,18,41
023 Karneid,10,,17,20,37
023 Karneid,11,,23,17,40
023 Karneid,12,,16,18,34
023 Karneid,13,,18,19,37
023 Karneid,14,,11,21,32
023 Karneid,15,,20,19,39
023 Karneid,16,,21,13,34
023 Karneid,17,,25,15,40
023 Karneid,18,,19,10,29
023 Karneid,19,,23,17,40
023 Karneid,20,,27,29,56
023 Karneid,21,,24,22,46
023 Karneid,22,,25,26,51
023 Karneid,23,,27,10,37
023 Karneid,24,,18,14,32
023 Karneid,25,,22,26,48
023 Karneid,26,,22,22,44
023 Karneid,27,,29,24,53
023 Karneid,28,,26,24,50
023 Karneid,29,,30,30,60
023 Karneid,30,,32,33,65
023 Karneid,31,,34,18,52
023 Karneid,32,,18,25,43
023 Karneid,33,,40,37,77
023 Karneid,34,,36,35,71
023 Karneid,35,,38,36,74
023 Karneid,36,,29,26,55
023 Karneid,37,,35,25,60
023 Karneid,38,,37,22,59
023 Karneid,39,,26,34,60
023 Karneid,40,,28,20,48
023 Karneid,41,,30,28,58
023 Karneid,42,,31,20,51
023 Karneid,43,,21,20,41
023 Karneid,44,,19,18,37
023 Karneid,45,,21,19,40
023 Karneid,46,,16,10,26
023 Karneid,47,,17,16,33
023 Karneid,48,,24,16,40
023 Karneid,49,,11,20,31
023 Karneid,50,,19,12,31
023 Karneid,51,,22,16,38
023 Karneid,52,,12,15,27
023 Karneid,53,,16,25,41
023 Karneid,54,,8,15,23
023 Karneid,55,,12,21,33
023 Karneid,56,,13,15,28
023 Karneid,57,,13,13,26
023 Karneid,58,,21,14,35
023 Karneid,59,,17,24,41
023 Karneid,60,,23,15,38
023 Karneid,61,,14,17,31
023 Karneid,62,,17,17,34
023 Karneid,63,,20,10,30
023 Karneid,64,,9,9,18
023 Karneid,65,,12,12,24
023 Karneid,66,,11,14,25
023 Karneid,67,,16,15,31
023 Karneid,68,,10,15,25
023 Karneid,69,,14,5,19
023 Karneid,70,,18,11,29
023 Karneid,71,,7,8,15
023 Karneid,72,,12,8,20
023 Karneid,73,,9,8,17
023 Karneid,74,,4,9,13
023 Karneid,75,,9,10,19
023 Karneid,76,,6,7,13
023 Karneid,77,,8,12,20
023 Karneid,78,,4,4,8
023 Karneid,79,,3,8,11
023 Karneid,80,,1,6,7
023 Karneid,81,,3,8,11
023 Karneid,82,,6,3,9
023 Karneid,83,,1,6,7
023 Karneid,84,,1,4,5
023 Karneid,85,,-,3,3
023 Karneid,86,,-,2,2
023 Karneid,87,,-,2,2
023 Karneid,88,,-,3,3
023 Karneid,89,,1,5,6
023 Karneid,90,,-,2,2
023 Karneid,91,,1,2,3
023 Karneid,92,,1,2,3
023 Karneid,93,,-,1,1
023 Karneid,95,,-,2,2
023 Karneid,97,,-,1,1
024 Kurtatsch a.d.Weinstr.,0,,17,13,30
024 Kurtatsch a.d.Weinstr.,1,,15,12,27
024 Kurtatsch a.d.Weinstr.,2,,14,10,24
024 Kurtatsch a.d.Weinstr.,3,,17,14,31
024 Kurtatsch a.d.Weinstr.,4,,14,13,27
024 Kurtatsch a.d.Weinstr.,5,,26,17,43
024 Kurtatsch a.d.Weinstr.,6,,21,12,33
024 Kurtatsch a.d.Weinstr.,7,,15,5,20
024 Kurtatsch a.d.Weinstr.,8,,24,20,44
024 Kurtatsch a.d.Weinstr.,9,,21,10,31
024 Kurtatsch a.d.Weinstr.,10,,15,17,32
024 Kurtatsch a.d.Weinstr.,11,,11,7,18
024 Kurtatsch a.d.Weinstr.,12,,10,17,27
024 Kurtatsch a.d.Weinstr.,13,,7,13,20
024 Kurtatsch a.d.Weinstr.,14,,11,12,23
024 Kurtatsch a.d.Weinstr.,15,,9,10,19
024 Kurtatsch a.d.Weinstr.,16,,14,10,24
024 Kurtatsch a.d.Weinstr.,17,,16,8,24
024 Kurtatsch a.d.Weinstr.,18,,16,8,24
024 Kurtatsch a.d.Weinstr.,19,,11,20,31
024 Kurtatsch a.d.Weinstr.,20,,11,11,22
024 Kurtatsch a.d.Weinstr.,21,,7,14,21
024 Kurtatsch a.d.Weinstr.,22,,9,9,18
024 Kurtatsch a.d.Weinstr.,23,,7,13,20
024 Kurtatsch a.d.Weinstr.,24,,10,15,25
024 Kurtatsch a.d.Weinstr.,25,,12,12,24
024 Kurtatsch a.d.Weinstr.,26,,12,9,21
024 Kurtatsch a.d.Weinstr.,27,,7,17,24
024 Kurtatsch a.d.Weinstr.,28,,13,15,28
024 Kurtatsch a.d.Weinstr.,29,,11,20,31
024 Kurtatsch a.d.Weinstr.,30,,13,19,32
024 Kurtatsch a.d.Weinstr.,31,,12,24,36
024 Kurtatsch a.d.Weinstr.,32,,23,16,39
024 Kurtatsch a.d.Weinstr.,33,,27,13,40
024 Kurtatsch a.d.Weinstr.,34,,20,19,39
024 Kurtatsch a.d.Weinstr.,35,,27,16,43
024 Kurtatsch a.d.Weinstr.,36,,24,27,51
024 Kurtatsch a.d.Weinstr.,37,,15,27,42
024 Kurtatsch a.d.Weinstr.,38,,19,23,42
024 Kurtatsch a.d.Weinstr.,39,,25,7,32
024 Kurtatsch a.d.Weinstr.,40,,17,16,33
024 Kurtatsch a.d.Weinstr.,41,,20,21,41
024 Kurtatsch a.d.Weinstr.,42,,18,11,29
024 Kurtatsch a.d.Weinstr.,43,,16,17,33
024 Kurtatsch a.d.Weinstr.,44,,10,10,20
024 Kurtatsch a.d.Weinstr.,45,,10,9,19
024 Kurtatsch a.d.Weinstr.,46,,12,16,28
024 Kurtatsch a.d.Weinstr.,47,,16,8,24
024 Kurtatsch a.d.Weinstr.,48,,17,19,36
024 Kurtatsch a.d.Weinstr.,49,,12,8,20
024 Kurtatsch a.d.Weinstr.,50,,10,14,24
024 Kurtatsch a.d.Weinstr.,51,,14,6,20
024 Kurtatsch a.d.Weinstr.,52,,12,10,22
024 Kurtatsch a.d.Weinstr.,53,,8,8,16
024 Kurtatsch a.d.Weinstr.,54,,12,8,20
024 Kurtatsch a.d.Weinstr.,55,,12,8,20
024 Kurtatsch a.d.Weinstr.,56,,7,8,15
024 Kurtatsch a.d.Weinstr.,57,,5,8,13
024 Kurtatsch a.d.Weinstr.,58,,10,6,16
024 Kurtatsch a.d.Weinstr.,59,,11,12,23
024 Kurtatsch a.d.Weinstr.,60,,7,11,18
024 Kurtatsch a.d.Weinstr.,61,,11,11,22
024 Kurtatsch a.d.Weinstr.,62,,4,15,19
024 Kurtatsch a.d.Weinstr.,63,,11,11,22
024 Kurtatsch a.d.Weinstr.,64,,5,11,16
024 Kurtatsch a.d.Weinstr.,65,,9,8,17
024 Kurtatsch a.d.Weinstr.,66,,5,9,14
024 Kurtatsch a.d.Weinstr.,67,,8,10,18
024 Kurtatsch a.d.Weinstr.,68,,8,7,15
024 Kurtatsch a.d.Weinstr.,69,,11,16,27
024 Kurtatsch a.d.Weinstr.,70,,7,12,19
024 Kurtatsch a.d.Weinstr.,71,,11,15,26
024 Kurtatsch a.d.Weinstr.,72,,9,10,19
024 Kurtatsch a.d.Weinstr.,73,,8,8,16
024 Kurtatsch a.d.Weinstr.,74,,11,6,17
024 Kurtatsch a.d.Weinstr.,75,,7,6,13
024 Kurtatsch a.d.Weinstr.,76,,4,10,14
024 Kurtatsch a.d.Weinstr.,77,,7,10,17
024 Kurtatsch a.d.Weinstr.,78,,8,21,29
024 Kurtatsch a.d.Weinstr.,79,,2,5,7
024 Kurtatsch a.d.Weinstr.,80,,3,7,10
024 Kurtatsch a.d.Weinstr.,81,,6,4,10
024 Kurtatsch a.d.Weinstr.,82,,2,1,3
024 Kurtatsch a.d.Weinstr.,83,,-,1,1
024 Kurtatsch a.d.Weinstr.,84,,-,6,6
024 Kurtatsch a.d.Weinstr.,85,,-,1,1
024 Kurtatsch a.d.Weinstr.,86,,2,2,4
024 Kurtatsch a.d.Weinstr.,87,,3,2,5
024 Kurtatsch a.d.Weinstr.,88,,1,3,4
024 Kurtatsch a.d.Weinstr.,89,,3,4,7
024 Kurtatsch a.d.Weinstr.,90,,-,5,5
024 Kurtatsch a.d.Weinstr.,91,,-,1,1
024 Kurtatsch a.d.Weinstr.,92,,-,3,3
024 Kurtatsch a.d.Weinstr.,93,,1,1,2
024 Kurtatsch a.d.Weinstr.,94,,-,3,3
024 Kurtatsch a.d.Weinstr.,95,,2,-,2
024 Kurtatsch a.d.Weinstr.,97,,1,-,1
025 Kurtinig a.d. Weinstr.,0,,2,5,7
025 Kurtinig a.d. Weinstr.,1,,3,4,7
025 Kurtinig a.d. Weinstr.,2,,3,3,6
025 Kurtinig a.d. Weinstr.,3,,2,5,7
025 Kurtinig a.d. Weinstr.,4,,3,4,7
025 Kurtinig a.d. Weinstr.,5,,1,2,3
025 Kurtinig a.d. Weinstr.,6,,4,2,6
025 Kurtinig a.d. Weinstr.,7,,2,4,6
025 Kurtinig a.d. Weinstr.,8,,4,4,8
025 Kurtinig a.d. Weinstr.,9,,2,3,5
025 Kurtinig a.d. Weinstr.,10,,5,2,7
025 Kurtinig a.d. Weinstr.,11,,3,2,5
025 Kurtinig a.d. Weinstr.,12,,6,4,10
025 Kurtinig a.d. Weinstr.,13,,6,4,10
025 Kurtinig a.d. Weinstr.,14,,5,6,11
025 Kurtinig a.d. Weinstr.,15,,5,5,10
025 Kurtinig a.d. Weinstr.,16,,2,3,5
025 Kurtinig a.d. Weinstr.,17,,3,2,5
025 Kurtinig a.d. Weinstr.,18,,3,4,7
025 Kurtinig a.d. Weinstr.,19,,6,5,11
025 Kurtinig a.d. Weinstr.,20,,6,5,11
025 Kurtinig a.d. Weinstr.,21,,4,3,7
025 Kurtinig a.d. Weinstr.,22,,4,8,12
025 Kurtinig a.d. Weinstr.,23,,3,3,6
025 Kurtinig a.d. Weinstr.,24,,5,-,5
025 Kurtinig a.d. Weinstr.,25,,3,-,3
025 Kurtinig a.d. Weinstr.,26,,2,5,7
025 Kurtinig a.d. Weinstr.,27,,4,3,7
025 Kurtinig a.d. Weinstr.,28,,5,1,6
025 Kurtinig a.d. Weinstr.,29,,3,4,7
025 Kurtinig a.d. Weinstr.,30,,4,3,7
025 Kurtinig a.d. Weinstr.,31,,6,2,8
025 Kurtinig a.d. Weinstr.,32,,7,6,13
025 Kurtinig a.d. Weinstr.,33,,4,4,8
025 Kurtinig a.d. Weinstr.,34,,4,4,8
025 Kurtinig a.d. Weinstr.,35,,2,5,7
025 Kurtinig a.d. Weinstr.,36,,4,4,8
025 Kurtinig a.d. Weinstr.,37,,7,5,12
025 Kurtinig a.d. Weinstr.,38,,6,8,14
025 Kurtinig a.d. Weinstr.,39,,5,5,10
025 Kurtinig a.d. Weinstr.,40,,8,9,17
025 Kurtinig a.d. Weinstr.,41,,5,4,9
025 Kurtinig a.d. Weinstr.,42,,11,5,16
025 Kurtinig a.d. Weinstr.,43,,3,8,11
025 Kurtinig a.d. Weinstr.,44,,8,8,16
025 Kurtinig a.d. Weinstr.,45,,4,3,7
025 Kurtinig a.d. Weinstr.,46,,3,1,4
025 Kurtinig a.d. Weinstr.,47,,7,2,9
025 Kurtinig a.d. Weinstr.,48,,5,4,9
025 Kurtinig a.d. Weinstr.,49,,2,4,6
025 Kurtinig a.d. Weinstr.,50,,3,4,7
025 Kurtinig a.d. Weinstr.,51,,2,3,5
025 Kurtinig a.d. Weinstr.,52,,3,3,6
025 Kurtinig a.d. Weinstr.,53,,4,5,9
025 Kurtinig a.d. Weinstr.,54,,5,1,6
025 Kurtinig a.d. Weinstr.,55,,-,5,5
025 Kurtinig a.d. Weinstr.,56,,3,2,5
025 Kurtinig a.d. Weinstr.,57,,3,2,5
025 Kurtinig a.d. Weinstr.,58,,4,2,6
025 Kurtinig a.d. Weinstr.,59,,2,2,4
025 Kurtinig a.d. Weinstr.,60,,3,2,5
025 Kurtinig a.d. Weinstr.,61,,2,2,4
025 Kurtinig a.d. Weinstr.,62,,5,3,8
025 Kurtinig a.d. Weinstr.,63,,2,2,4
025 Kurtinig a.d. Weinstr.,64,,2,3,5
025 Kurtinig a.d. Weinstr.,65,,6,3,9
025 Kurtinig a.d. Weinstr.,66,,-,6,6
025 Kurtinig a.d. Weinstr.,67,,2,4,6
025 Kurtinig a.d. Weinstr.,68,,1,2,3
025 Kurtinig a.d. Weinstr.,69,,3,4,7
025 Kurtinig a.d. Weinstr.,70,,3,2,5
025 Kurtinig a.d. Weinstr.,71,,4,4,8
025 Kurtinig a.d. Weinstr.,72,,1,3,4
025 Kurtinig a.d. Weinstr.,73,,2,4,6
025 Kurtinig a.d. Weinstr.,74,,2,4,6
025 Kurtinig a.d. Weinstr.,75,,4,1,5
025 Kurtinig a.d. Weinstr.,76,,-,5,5
025 Kurtinig a.d. Weinstr.,77,,2,5,7
025 Kurtinig a.d. Weinstr.,78,,1,1,2
025 Kurtinig a.d. Weinstr.,79,,1,3,4
025 Kurtinig a.d. Weinstr.,80,,2,1,3
025 Kurtinig a.d. Weinstr.,81,,2,1,3
025 Kurtinig a.d. Weinstr.,82,,-,2,2
025 Kurtinig a.d. Weinstr.,83,,-,1,1
025 Kurtinig a.d. Weinstr.,86,,-,2,2
025 Kurtinig a.d. Weinstr.,87,,-,2,2
025 Kurtinig a.d. Weinstr.,89,,1,1,2
025 Kurtinig a.d. Weinstr.,97,,-,2,2
026 Corvara,0,,4,9,13
026 Corvara,1,,6,4,10
026 Corvara,2,,8,7,15
026 Corvara,3,,8,7,15
026 Corvara,4,,4,6,10
026 Corvara,5,,8,4,12
026 Corvara,6,,7,9,16
026 Corvara,7,,6,4,10
026 Corvara,8,,6,3,9
026 Corvara,9,,6,11,17
026 Corvara,10,,2,6,8
026 Corvara,11,,9,6,15
026 Corvara,12,,5,5,10
026 Corvara,13,,6,3,9
026 Corvara,14,,9,7,16
026 Corvara,15,,3,-,3
026 Corvara,16,,6,8,14
026 Corvara,17,,7,3,10
026 Corvara,18,,7,7,14
026 Corvara,19,,8,11,19
026 Corvara,20,,15,2,17
026 Corvara,21,,11,7,18
026 Corvara,22,,10,8,18
026 Corvara,23,,11,3,14
026 Corvara,24,,16,7,23
026 Corvara,25,,11,4,15
026 Corvara,26,,9,18,27
026 Corvara,27,,7,15,22
026 Corvara,28,,14,7,21
026 Corvara,29,,7,7,14
026 Corvara,30,,12,6,18
026 Corvara,31,,10,12,22
026 Corvara,32,,14,11,25
026 Corvara,33,,7,13,20
026 Corvara,34,,15,19,34
026 Corvara,35,,13,17,30
026 Corvara,36,,16,16,32
026 Corvara,37,,8,7,15
026 Corvara,38,,11,11,22
026 Corvara,39,,13,11,24
026 Corvara,40,,7,7,14
026 Corvara,41,,15,12,27
026 Corvara,42,,6,7,13
026 Corvara,43,,11,6,17
026 Corvara,44,,7,5,12
026 Corvara,45,,3,8,11
026 Corvara,46,,11,8,19
026 Corvara,47,,10,8,18
026 Corvara,48,,6,12,18
026 Corvara,49,,5,8,13
026 Corvara,50,,6,8,14
026 Corvara,51,,7,8,15
026 Corvara,52,,3,9,12
026 Corvara,53,,5,4,9
026 Corvara,54,,4,10,14
026 Corvara,55,,14,11,25
026 Corvara,56,,5,5,10
026 Corvara,57,,8,9,17
026 Corvara,58,,6,10,16
026 Corvara,59,,5,9,14
026 Corvara,60,,14,11,25
026 Corvara,61,,9,7,16
026 Corvara,62,,8,4,12
026 Corvara,63,,4,8,12
026 Corvara,64,,5,8,13
026 Corvara,65,,6,8,14
026 Corvara,66,,8,5,13
026 Corvara,67,,8,8,16
026 Corvara,68,,4,4,8
026 Corvara,69,,7,4,11
026 Corvara,70,,7,11,18
026 Corvara,71,,7,3,10
026 Corvara,72,,5,6,11
026 Corvara,73,,2,2,4
026 Corvara,74,,6,4,10
026 Corvara,75,,3,3,6
026 Corvara,76,,1,3,4
026 Corvara,77,,3,1,4
026 Corvara,78,,5,3,8
026 Corvara,79,,3,5,8
026 Corvara,80,,4,1,5
026 Corvara,81,,4,1,5
026 Corvara,82,,2,3,5
026 Corvara,83,,1,1,2
026 Corvara,84,,1,2,3
026 Corvara,85,,-,1,1
026 Corvara,87,,-,3,3
026 Corvara,88,,1,5,6
026 Corvara,89,,2,5,7
026 Corvara,90,,2,-,2
026 Corvara,91,,-,2,2
026 Corvara,92,,-,1,1
026 Corvara,93,,-,1,1
026 Corvara,95,,-,1,1
026 Corvara,98,,1,-,1
027 Graun im Vinschgau,0,,15,13,28
027 Graun im Vinschgau,1,,17,17,34
027 Graun im Vinschgau,2,,13,10,23
027 Graun im Vinschgau,3,,11,17,28
027 Graun im Vinschgau,4,,15,16,31
027 Graun im Vinschgau,5,,22,17,39
027 Graun im Vinschgau,6,,19,16,35
027 Graun im Vinschgau,7,,19,12,31
027 Graun im Vinschgau,8,,21,14,35
027 Graun im Vinschgau,9,,17,16,33
027 Graun im Vinschgau,10,,10,12,22
027 Graun im Vinschgau,11,,18,20,38
027 Graun im Vinschgau,12,,26,18,44
027 Graun im Vinschgau,13,,21,11,32
027 Graun im Vinschgau,14,,16,12,28
027 Graun im Vinschgau,15,,8,8,16
027 Graun im Vinschgau,16,,19,10,29
027 Graun im Vinschgau,17,,20,15,35
027 Graun im Vinschgau,18,,7,16,23
027 Graun im Vinschgau,19,,18,17,35
027 Graun im Vinschgau,20,,22,17,39
027 Graun im Vinschgau,21,,24,15,39
027 Graun im Vinschgau,22,,14,22,36
027 Graun im Vinschgau,23,,16,16,32
027 Graun im Vinschgau,24,,15,19,34
027 Graun im Vinschgau,25,,15,19,34
027 Graun im Vinschgau,26,,21,21,42
027 Graun im Vinschgau,27,,22,14,36
027 Graun im Vinschgau,28,,21,20,41
027 Graun im Vinschgau,29,,21,21,42
027 Graun im Vinschgau,30,,20,11,31
027 Graun im Vinschgau,31,,21,15,36
027 Graun im Vinschgau,32,,29,20,49
027 Graun im Vinschgau,33,,17,21,38
027 Graun im Vinschgau,34,,31,21,52
027 Graun im Vinschgau,35,,19,24,43
027 Graun im Vinschgau,36,,19,19,38
027 Graun im Vinschgau,37,,20,24,44
027 Graun im Vinschgau,38,,22,18,40
027 Graun im Vinschgau,39,,25,24,49
027 Graun im Vinschgau,40,,20,14,34
027 Graun im Vinschgau,41,,20,22,42
027 Graun im Vinschgau,42,,22,11,33
027 Graun im Vinschgau,43,,20,15,35
027 Graun im Vinschgau,44,,12,13,25
027 Graun im Vinschgau,45,,15,11,26
027 Graun im Vinschgau,46,,15,9,24
027 Graun im Vinschgau,47,,18,17,35
027 Graun im Vinschgau,48,,17,7,24
027 Graun im Vinschgau,49,,17,10,27
027 Graun im Vinschgau,50,,13,15,28
027 Graun im Vinschgau,51,,12,12,24
027 Graun im Vinschgau,52,,8,21,29
027 Graun im Vinschgau,53,,13,12,25
027 Graun im Vinschgau,54,,5,10,15
027 Graun im Vinschgau,55,,8,7,15
027 Graun im Vinschgau,56,,7,8,15
027 Graun im Vinschgau,57,,11,8,19
027 Graun im Vinschgau,58,,10,13,23
027 Graun im Vinschgau,59,,9,13,22
027 Graun im Vinschgau,60,,15,10,25
027 Graun im Vinschgau,61,,14,9,23
027 Graun im Vinschgau,62,,11,12,23
027 Graun im Vinschgau,63,,11,12,23
027 Graun im Vinschgau,64,,11,3,14
027 Graun im Vinschgau,65,,14,14,28
027 Graun im Vinschgau,66,,9,8,17
027 Graun im Vinschgau,67,,12,10,22
027 Graun im Vinschgau,68,,8,7,15
027 Graun im Vinschgau,69,,13,7,20
027 Graun im Vinschgau,70,,12,10,22
027 Graun im Vinschgau,71,,5,8,13
027 Graun im Vinschgau,72,,13,14,27
027 Graun im Vinschgau,73,,9,11,20
027 Graun im Vinschgau,74,,6,9,15
027 Graun im Vinschgau,75,,9,14,23
027 Graun im Vinschgau,76,,6,5,11
027 Graun im Vinschgau,77,,7,9,16
027 Graun im Vinschgau,78,,4,13,17
027 Graun im Vinschgau,79,,8,8,16
027 Graun im Vinschgau,80,,6,12,18
027 Graun im Vinschgau,81,,4,3,7
027 Graun im Vinschgau,82,,1,6,7
027 Graun im Vinschgau,83,,3,2,5
027 Graun im Vinschgau,84,,-,2,2
027 Graun im Vinschgau,85,,1,2,3
027 Graun im Vinschgau,86,,1,3,4
027 Graun im Vinschgau,87,,2,5,7
027 Graun im Vinschgau,88,,-,4,4
027 Graun im Vinschgau,89,,1,2,3
027 Graun im Vinschgau,90,,1,3,4
027 Graun im Vinschgau,91,,1,-,1
027 Graun im Vinschgau,92,,-,1,1
027 Graun im Vinschgau,93,,-,4,4
027 Graun im Vinschgau,94,,-,1,1
027 Graun im Vinschgau,98,,-,1,1
028 Toblach,0,,23,17,40
028 Toblach,1,,19,19,38
028 Toblach,2,,17,19,36
028 Toblach,3,,18,11,29
028 Toblach,4,,25,17,42
028 Toblach,5,,27,22,49
028 Toblach,6,,18,9,27
028 Toblach,7,,21,18,39
028 Toblach,8,,20,19,39
028 Toblach,9,,16,18,34
028 Toblach,10,,17,28,45
028 Toblach,11,,17,23,40
028 Toblach,12,,9,16,25
028 Toblach,13,,14,24,38
028 Toblach,14,,31,16,47
028 Toblach,15,,15,21,36
028 Toblach,16,,25,23,48
028 Toblach,17,,20,27,47
028 Toblach,18,,21,20,41
028 Toblach,19,,23,28,51
028 Toblach,20,,24,22,46
028 Toblach,21,,24,19,43
028 Toblach,22,,23,25,48
028 Toblach,23,,24,25,49
028 Toblach,24,,15,24,39
028 Toblach,25,,28,32,60
028 Toblach,26,,23,22,45
028 Toblach,27,,30,19,49
028 Toblach,28,,32,26,58
028 Toblach,29,,35,31,66
028 Toblach,30,,32,23,55
028 Toblach,31,,23,22,45
028 Toblach,32,,35,27,62
028 Toblach,33,,37,25,62
028 Toblach,34,,27,25,52
028 Toblach,35,,28,28,56
028 Toblach,36,,33,28,61
028 Toblach,37,,35,32,67
028 Toblach,38,,33,24,57
028 Toblach,39,,36,29,65
028 Toblach,40,,23,30,53
028 Toblach,41,,21,17,38
028 Toblach,42,,37,26,63
028 Toblach,43,,23,15,38
028 Toblach,44,,28,21,49
028 Toblach,45,,16,25,41
028 Toblach,46,,18,25,43
028 Toblach,47,,19,19,38
028 Toblach,48,,20,25,45
028 Toblach,49,,18,17,35
028 Toblach,50,,28,12,40
028 Toblach,51,,15,17,32
028 Toblach,52,,21,13,34
028 Toblach,53,,16,24,40
028 Toblach,54,,19,13,32
028 Toblach,55,,13,15,28
028 Toblach,56,,13,16,29
028 Toblach,57,,19,11,30
028 Toblach,58,,14,18,32
028 Toblach,59,,14,20,34
028 Toblach,60,,17,12,29
028 Toblach,61,,13,13,26
028 Toblach,62,,15,13,28
028 Toblach,63,,16,8,24
028 Toblach,64,,5,10,15
028 Toblach,65,,10,17,27
028 Toblach,66,,8,19,27
028 Toblach,67,,16,17,33
028 Toblach,68,,10,10,20
028 Toblach,69,,13,17,30
028 Toblach,70,,18,14,32
028 Toblach,71,,10,11,21
028 Toblach,72,,10,16,26
028 Toblach,73,,14,13,27
028 Toblach,74,,10,14,24
028 Toblach,75,,10,14,24
028 Toblach,76,,13,9,22
028 Toblach,77,,9,10,19
028 Toblach,78,,10,8,18
028 Toblach,79,,5,16,21
028 Toblach,80,,6,11,17
028 Toblach,81,,4,9,13
028 Toblach,82,,4,13,17
028 Toblach,83,,4,5,9
028 Toblach,84,,4,4,8
028 Toblach,85,,2,5,7
028 Toblach,86,,1,9,10
028 Toblach,87,,1,6,7
028 Toblach,88,,1,6,7
028 Toblach,89,,1,2,3
028 Toblach,90,,1,3,4
028 Toblach,91,,-,5,5
028 Toblach,92,,1,2,3
028 Toblach,93,,1,2,3
028 Toblach,94,,1,-,1
028 Toblach,95,,-,1,1
028 Toblach,96,,-,1,1
028 Toblach,97,,-,1,1
028 Toblach,100,,-,1,1
028 Toblach,111,,1,-,1
029 Neumarkt,0,,23,32,55
029 Neumarkt,1,,25,17,42
029 Neumarkt,2,,15,25,40
029 Neumarkt,3,,21,32,53
029 Neumarkt,4,,16,15,31
029 Neumarkt,5,,17,21,38
029 Neumarkt,6,,22,24,46
029 Neumarkt,7,,22,24,46
029 Neumarkt,8,,22,35,57
029 Neumarkt,9,,20,26,46
029 Neumarkt,10,,24,19,43
029 Neumarkt,11,,27,24,51
029 Neumarkt,12,,23,31,54
029 Neumarkt,13,,22,24,46
029 Neumarkt,14,,27,29,56
029 Neumarkt,15,,21,17,38
029 Neumarkt,16,,25,17,42
029 Neumarkt,17,,16,24,40
029 Neumarkt,18,,16,23,39
029 Neumarkt,19,,24,23,47
029 Neumarkt,20,,23,22,45
029 Neumarkt,21,,19,19,38
029 Neumarkt,22,,22,20,42
029 Neumarkt,23,,34,23,57
029 Neumarkt,24,,15,13,28
029 Neumarkt,25,,26,33,59
029 Neumarkt,26,,29,31,60
029 Neumarkt,27,,28,35,63
029 Neumarkt,28,,24,22,46
029 Neumarkt,29,,33,38,71
029 Neumarkt,30,,30,44,74
029 Neumarkt,31,,29,26,55
029 Neumarkt,32,,30,34,64
029 Neumarkt,33,,33,46,79
029 Neumarkt,34,,44,40,84
029 Neumarkt,35,,53,40,93
029 Neumarkt,36,,46,38,84
029 Neumarkt,37,,50,38,88
029 Neumarkt,38,,42,43,85
029 Neumarkt,39,,50,30,80
029 Neumarkt,40,,32,35,67
029 Neumarkt,41,,48,48,96
029 Neumarkt,42,,46,34,80
029 Neumarkt,43,,29,36,65
029 Neumarkt,44,,35,30,65
029 Neumarkt,45,,32,24,56
029 Neumarkt,46,,39,40,79
029 Neumarkt,47,,38,26,64
029 Neumarkt,48,,21,20,41
029 Neumarkt,49,,26,22,48
029 Neumarkt,50,,21,22,43
029 Neumarkt,51,,24,23,47
029 Neumarkt,52,,20,24,44
029 Neumarkt,53,,20,22,42
029 Neumarkt,54,,28,31,59
029 Neumarkt,55,,34,31,65
029 Neumarkt,56,,26,24,50
029 Neumarkt,57,,22,15,37
029 Neumarkt,58,,25,22,47
029 Neumarkt,59,,23,26,49
029 Neumarkt,60,,37,26,63
029 Neumarkt,61,,33,34,67
029 Neumarkt,62,,18,29,47
029 Neumarkt,63,,19,18,37
029 Neumarkt,64,,25,19,44
029 Neumarkt,65,,20,19,39
029 Neumarkt,66,,21,23,44
029 Neumarkt,67,,15,23,38
029 Neumarkt,68,,19,19,38
029 Neumarkt,69,,20,22,42
029 Neumarkt,70,,24,30,54
029 Neumarkt,71,,16,24,40
029 Neumarkt,72,,14,17,31
029 Neumarkt,73,,7,21,28
029 Neumarkt,74,,20,20,40
029 Neumarkt,75,,18,19,37
029 Neumarkt,76,,15,21,36
029 Neumarkt,77,,10,15,25
029 Neumarkt,78,,15,27,42
029 Neumarkt,79,,10,16,26
029 Neumarkt,80,,7,25,32
029 Neumarkt,81,,7,19,26
029 Neumarkt,82,,5,8,13
029 Neumarkt,83,,5,3,8
029 Neumarkt,84,,2,8,10
029 Neumarkt,85,,2,6,8
029 Neumarkt,86,,1,6,7
029 Neumarkt,87,,6,8,14
029 Neumarkt,88,,5,7,12
029 Neumarkt,89,,2,6,8
029 Neumarkt,90,,1,6,7
029 Neumarkt,91,,1,3,4
029 Neumarkt,92,,3,2,5
029 Neumarkt,93,,1,1,2
029 Neumarkt,94,,-,1,1
029 Neumarkt,95,,1,2,3
029 Neumarkt,97,,-,1,1
030 Pfalzen,0,,13,10,23
030 Pfalzen,1,,11,17,28
030 Pfalzen,2,,17,17,34
030 Pfalzen,3,,16,14,30
030 Pfalzen,4,,12,13,25
030 Pfalzen,5,,15,14,29
030 Pfalzen,6,,23,16,39
030 Pfalzen,7,,12,15,27
030 Pfalzen,8,,11,16,27
030 Pfalzen,9,,13,22,35
030 Pfalzen,10,,15,19,34
030 Pfalzen,11,,19,12,31
030 Pfalzen,12,,16,19,35
030 Pfalzen,13,,13,8,21
030 Pfalzen,14,,13,23,36
030 Pfalzen,15,,19,18,37
030 Pfalzen,16,,22,13,35
030 Pfalzen,17,,15,11,26
030 Pfalzen,18,,12,10,22
030 Pfalzen,19,,19,19,38
030 Pfalzen,20,,19,19,38
030 Pfalzen,21,,20,16,36
030 Pfalzen,22,,15,21,36
030 Pfalzen,23,,17,19,36
030 Pfalzen,24,,21,18,39
030 Pfalzen,25,,17,10,27
030 Pfalzen,26,,10,18,28
030 Pfalzen,27,,22,20,42
030 Pfalzen,28,,15,22,37
030 Pfalzen,29,,17,19,36
030 Pfalzen,30,,22,20,42
030 Pfalzen,31,,18,20,38
030 Pfalzen,32,,30,14,44
030 Pfalzen,33,,22,30,52
030 Pfalzen,34,,18,23,41
030 Pfalzen,35,,23,23,46
030 Pfalzen,36,,23,23,46
030 Pfalzen,37,,20,15,35
030 Pfalzen,38,,28,18,46
030 Pfalzen,39,,18,27,45
030 Pfalzen,40,,24,17,41
030 Pfalzen,41,,20,13,33
030 Pfalzen,42,,13,15,28
030 Pfalzen,43,,16,20,36
030 Pfalzen,44,,23,18,41
030 Pfalzen,45,,15,14,29
030 Pfalzen,46,,15,11,26
030 Pfalzen,47,,13,12,25
030 Pfalzen,48,,13,11,24
030 Pfalzen,49,,10,10,20
030 Pfalzen,50,,16,16,32
030 Pfalzen,51,,11,11,22
030 Pfalzen,52,,15,6,21
030 Pfalzen,53,,9,10,19
030 Pfalzen,54,,11,4,15
030 Pfalzen,55,,8,9,17
030 Pfalzen,56,,7,8,15
030 Pfalzen,57,,10,6,16
030 Pfalzen,58,,8,12,20
030 Pfalzen,59,,6,13,19
030 Pfalzen,60,,11,8,19
030 Pfalzen,61,,13,9,22
030 Pfalzen,62,,10,6,16
030 Pfalzen,63,,11,10,21
030 Pfalzen,64,,6,5,11
030 Pfalzen,65,,2,8,10
030 Pfalzen,66,,8,5,13
030 Pfalzen,67,,8,13,21
030 Pfalzen,68,,7,8,15
030 Pfalzen,69,,9,5,14
030 Pfalzen,70,,12,7,19
030 Pfalzen,71,,9,11,20
030 Pfalzen,72,,10,6,16
030 Pfalzen,73,,3,5,8
030 Pfalzen,74,,6,5,11
030 Pfalzen,75,,4,4,8
030 Pfalzen,76,,7,4,11
030 Pfalzen,77,,3,11,14
030 Pfalzen,78,,6,8,14
030 Pfalzen,79,,4,4,8
030 Pfalzen,80,,-,7,7
030 Pfalzen,81,,3,7,10
030 Pfalzen,82,,4,4,8
030 Pfalzen,83,,1,1,2
030 Pfalzen,84,,1,1,2
030 Pfalzen,85,,-,2,2
030 Pfalzen,86,,1,-,1
030 Pfalzen,87,,2,3,5
030 Pfalzen,88,,1,3,4
030 Pfalzen,89,,1,1,2
030 Pfalzen,90,,-,1,1
030 Pfalzen,91,,-,3,3
030 Pfalzen,92,,2,1,3
030 Pfalzen,93,,2,-,2
031 Völs am Schlern,0,,21,27,48
031 Völs am Schlern,1,,22,28,50
031 Völs am Schlern,2,,21,16,37
031 Völs am Schlern,3,,27,26,53
031 Völs am Schlern,4,,18,23,41
031 Völs am Schlern,5,,15,21,36
031 Völs am Schlern,6,,21,22,43
031 Völs am Schlern,7,,20,8,28
031 Völs am Schlern,8,,18,17,35
031 Völs am Schlern,9,,20,17,37
031 Völs am Schlern,10,,15,20,35
031 Völs am Schlern,11,,19,18,37
031 Völs am Schlern,12,,19,14,33
031 Völs am Schlern,13,,15,14,29
031 Völs am Schlern,14,,17,14,31
031 Völs am Schlern,15,,20,12,32
031 Völs am Schlern,16,,18,14,32
031 Völs am Schlern,17,,16,7,23
031 Völs am Schlern,18,,13,22,35
031 Völs am Schlern,19,,20,20,40
031 Völs am Schlern,20,,25,18,43
031 Völs am Schlern,21,,29,13,42
031 Völs am Schlern,22,,19,23,42
031 Völs am Schlern,23,,25,18,43
031 Völs am Schlern,24,,20,24,44
031 Völs am Schlern,25,,23,21,44
031 Völs am Schlern,26,,21,19,40
031 Völs am Schlern,27,,26,25,51
031 Völs am Schlern,28,,27,39,66
031 Völs am Schlern,29,,35,29,64
031 Völs am Schlern,30,,36,37,73
031 Völs am Schlern,31,,29,32,61
031 Völs am Schlern,32,,33,31,64
031 Völs am Schlern,33,,28,34,62
031 Völs am Schlern,34,,30,22,52
031 Völs am Schlern,35,,39,25,64
031 Völs am Schlern,36,,26,26,52
031 Völs am Schlern,37,,28,23,51
031 Völs am Schlern,38,,32,29,61
031 Völs am Schlern,39,,29,19,48
031 Völs am Schlern,40,,23,21,44
031 Völs am Schlern,41,,25,24,49
031 Völs am Schlern,42,,18,12,30
031 Völs am Schlern,43,,21,15,36
031 Völs am Schlern,44,,21,17,38
031 Völs am Schlern,45,,20,18,38
031 Völs am Schlern,46,,17,15,32
031 Völs am Schlern,47,,17,25,42
031 Völs am Schlern,48,,16,25,41
031 Völs am Schlern,49,,18,18,36
031 Völs am Schlern,50,,18,20,38
031 Völs am Schlern,51,,22,15,37
031 Völs am Schlern,52,,17,9,26
031 Völs am Schlern,53,,16,13,29
031 Völs am Schlern,54,,16,19,35
031 Völs am Schlern,55,,15,11,26
031 Völs am Schlern,56,,11,12,23
031 Völs am Schlern,57,,16,11,27
031 Völs am Schlern,58,,14,22,36
031 Völs am Schlern,59,,16,16,32
031 Völs am Schlern,60,,20,18,38
031 Völs am Schlern,61,,10,19,29
031 Völs am Schlern,62,,14,11,25
031 Völs am Schlern,63,,14,14,28
031 Völs am Schlern,64,,11,9,20
031 Völs am Schlern,65,,10,21,31
031 Völs am Schlern,66,,17,13,30
031 Völs am Schlern,67,,15,8,23
031 Völs am Schlern,68,,7,14,21
031 Völs am Schlern,69,,13,8,21
031 Völs am Schlern,70,,13,14,27
031 Völs am Schlern,71,,7,12,19
031 Völs am Schlern,72,,7,12,19
031 Völs am Schlern,73,,7,13,20
031 Völs am Schlern,74,,10,11,21
031 Völs am Schlern,75,,12,6,18
031 Völs am Schlern,76,,9,11,20
031 Völs am Schlern,77,,12,13,25
031 Völs am Schlern,78,,5,6,11
031 Völs am Schlern,79,,5,8,13
031 Völs am Schlern,80,,4,13,17
031 Völs am Schlern,81,,4,6,10
031 Völs am Schlern,82,,1,5,6
031 Völs am Schlern,83,,1,5,6
031 Völs am Schlern,84,,1,5,6
031 Völs am Schlern,85,,2,2,4
031 Völs am Schlern,86,,1,5,6
031 Völs am Schlern,87,,4,4,8
031 Völs am Schlern,88,,6,2,8
031 Völs am Schlern,89,,1,2,3
031 Völs am Schlern,90,,1,3,4
031 Völs am Schlern,91,,1,3,4
031 Völs am Schlern,92,,2,-,2
031 Völs am Schlern,93,,-,3,3
031 Völs am Schlern,94,,-,3,3
032 Franzensfeste,0,,5,5,10
032 Franzensfeste,1,,2,5,7
032 Franzensfeste,2,,6,6,12
032 Franzensfeste,3,,4,5,9
032 Franzensfeste,4,,5,3,8
032 Franzensfeste,5,,6,4,10
032 Franzensfeste,6,,5,2,7
032 Franzensfeste,7,,6,6,12
032 Franzensfeste,8,,5,5,10
032 Franzensfeste,9,,5,8,13
032 Franzensfeste,10,,4,4,8
032 Franzensfeste,11,,2,4,6
032 Franzensfeste,12,,5,4,9
032 Franzensfeste,13,,4,2,6
032 Franzensfeste,14,,4,2,6
032 Franzensfeste,15,,5,4,9
032 Franzensfeste,16,,4,9,13
032 Franzensfeste,17,,5,6,11
032 Franzensfeste,18,,9,4,13
032 Franzensfeste,19,,3,7,10
032 Franzensfeste,20,,7,4,11
032 Franzensfeste,21,,5,9,14
032 Franzensfeste,22,,11,5,16
032 Franzensfeste,23,,5,4,9
032 Franzensfeste,24,,2,2,4
032 Franzensfeste,25,,3,3,6
032 Franzensfeste,26,,7,9,16
032 Franzensfeste,27,,5,8,13
032 Franzensfeste,28,,2,6,8
032 Franzensfeste,29,,7,11,18
032 Franzensfeste,30,,9,3,12
032 Franzensfeste,31,,15,7,22
032 Franzensfeste,32,,6,6,12
032 Franzensfeste,33,,10,14,24
032 Franzensfeste,34,,9,6,15
032 Franzensfeste,35,,9,6,15
032 Franzensfeste,36,,9,5,14
032 Franzensfeste,37,,15,10,25
032 Franzensfeste,38,,6,9,15
032 Franzensfeste,39,,10,2,12
032 Franzensfeste,40,,6,10,16
032 Franzensfeste,41,,6,7,13
032 Franzensfeste,42,,8,9,17
032 Franzensfeste,43,,11,3,14
032 Franzensfeste,44,,3,6,9
032 Franzensfeste,45,,6,7,13
032 Franzensfeste,46,,9,7,16
032 Franzensfeste,47,,4,10,14
032 Franzensfeste,48,,6,6,12
032 Franzensfeste,49,,5,4,9
032 Franzensfeste,50,,7,1,8
032 Franzensfeste,51,,11,3,14
032 Franzensfeste,52,,3,4,7
032 Franzensfeste,53,,5,4,9
032 Franzensfeste,54,,4,4,8
032 Franzensfeste,55,,9,5,14
032 Franzensfeste,56,,4,7,11
032 Franzensfeste,57,,4,9,13
032 Franzensfeste,58,,3,2,5
032 Franzensfeste,59,,5,1,6
032 Franzensfeste,60,,5,2,7
032 Franzensfeste,61,,4,4,8
032 Franzensfeste,62,,7,4,11
032 Franzensfeste,63,,1,3,4
032 Franzensfeste,64,,8,6,14
032 Franzensfeste,65,,4,2,6
032 Franzensfeste,66,,3,3,6
032 Franzensfeste,67,,3,3,6
032 Franzensfeste,68,,2,6,8
032 Franzensfeste,69,,3,7,10
032 Franzensfeste,70,,2,8,10
032 Franzensfeste,71,,6,4,10
032 Franzensfeste,72,,4,8,12
032 Franzensfeste,73,,2,2,4
032 Franzensfeste,74,,3,7,10
032 Franzensfeste,75,,4,9,13
032 Franzensfeste,76,,4,1,5
032 Franzensfeste,77,,7,5,12
032 Franzensfeste,78,,4,6,10
032 Franzensfeste,79,,4,5,9
032 Franzensfeste,80,,2,4,6
032 Franzensfeste,81,,1,5,6
032 Franzensfeste,82,,2,1,3
032 Franzensfeste,83,,-,2,2
032 Franzensfeste,84,,1,-,1
032 Franzensfeste,86,,1,2,3
032 Franzensfeste,87,,-,1,1
032 Franzensfeste,88,,1,1,2
032 Franzensfeste,89,,-,1,1
032 Franzensfeste,90,,-,1,1
032 Franzensfeste,91,,1,-,1
032 Franzensfeste,92,,-,1,1
032 Franzensfeste,93,,-,1,1
032 Franzensfeste,97,,-,1,1
033 Villnöss,0,,13,18,31
033 Villnöss,1,,18,16,34
033 Villnöss,2,,15,31,46
033 Villnöss,3,,24,19,43
033 Villnöss,4,,16,23,39
033 Villnöss,5,,23,17,40
033 Villnöss,6,,16,13,29
033 Villnöss,7,,14,12,26
033 Villnöss,8,,17,11,28
033 Villnöss,9,,12,14,26
033 Villnöss,10,,21,16,37
033 Villnöss,11,,13,11,24
033 Villnöss,12,,11,7,18
033 Villnöss,13,,16,23,39
033 Villnöss,14,,16,20,36
033 Villnöss,15,,11,17,28
033 Villnöss,16,,16,17,33
033 Villnöss,17,,15,14,29
033 Villnöss,18,,17,14,31
033 Villnöss,19,,11,16,27
033 Villnöss,20,,12,18,30
033 Villnöss,21,,20,9,29
033 Villnöss,22,,11,11,22
033 Villnöss,23,,16,13,29
033 Villnöss,24,,17,15,32
033 Villnöss,25,,16,14,30
033 Villnöss,26,,24,15,39
033 Villnöss,27,,21,20,41
033 Villnöss,28,,12,17,29
033 Villnöss,29,,19,26,45
033 Villnöss,30,,27,24,51
033 Villnöss,31,,19,25,44
033 Villnöss,32,,30,20,50
033 Villnöss,33,,29,17,46
033 Villnöss,34,,22,17,39
033 Villnöss,35,,24,20,44
033 Villnöss,36,,30,24,54
033 Villnöss,37,,32,26,58
033 Villnöss,38,,30,19,49
033 Villnöss,39,,26,19,45
033 Villnöss,40,,23,15,38
033 Villnöss,41,,20,13,33
033 Villnöss,42,,11,12,23
033 Villnöss,43,,8,15,23
033 Villnöss,44,,13,12,25
033 Villnöss,45,,15,15,30
033 Villnöss,46,,13,2,15
033 Villnöss,47,,16,13,29
033 Villnöss,48,,13,13,26
033 Villnöss,49,,13,11,24
033 Villnöss,50,,9,9,18
033 Villnöss,51,,7,10,17
033 Villnöss,52,,9,13,22
033 Villnöss,53,,9,9,18
033 Villnöss,54,,11,11,22
033 Villnöss,55,,9,5,14
033 Villnöss,56,,8,4,12
033 Villnöss,57,,9,14,23
033 Villnöss,58,,13,10,23
033 Villnöss,59,,11,17,28
033 Villnöss,60,,13,10,23
033 Villnöss,61,,8,18,26
033 Villnöss,62,,12,13,25
033 Villnöss,63,,12,9,21
033 Villnöss,64,,10,13,23
033 Villnöss,65,,5,16,21
033 Villnöss,66,,5,10,15
033 Villnöss,67,,11,9,20
033 Villnöss,68,,10,11,21
033 Villnöss,69,,15,13,28
033 Villnöss,70,,10,11,21
033 Villnöss,71,,10,10,20
033 Villnöss,72,,10,12,22
033 Villnöss,73,,16,6,22
033 Villnöss,74,,7,11,18
033 Villnöss,75,,4,8,12
033 Villnöss,76,,9,6,15
033 Villnöss,77,,5,12,17
033 Villnöss,78,,7,11,18
033 Villnöss,79,,4,12,16
033 Villnöss,80,,1,7,8
033 Villnöss,81,,1,5,6
033 Villnöss,82,,3,5,8
033 Villnöss,83,,-,2,2
033 Villnöss,84,,2,5,7
033 Villnöss,85,,-,1,1
033 Villnöss,86,,1,3,4
033 Villnöss,87,,5,3,8
033 Villnöss,88,,1,2,3
033 Villnöss,89,,-,1,1
033 Villnöss,90,,1,1,2
033 Villnöss,91,,1,2,3
033 Villnöss,92,,1,2,3
033 Villnöss,93,,-,4,4
033 Villnöss,95,,1,1,2
033 Villnöss,96,,-,1,1
034 Gais,0,,21,16,37
034 Gais,1,,21,20,41
034 Gais,2,,21,29,50
034 Gais,3,,23,22,45
034 Gais,4,,27,11,38
034 Gais,5,,10,21,31
034 Gais,6,,26,17,43
034 Gais,7,,22,24,46
034 Gais,8,,13,18,31
034 Gais,9,,20,28,48
034 Gais,10,,26,29,55
034 Gais,11,,14,20,34
034 Gais,12,,17,13,30
034 Gais,13,,19,16,35
034 Gais,14,,16,22,38
034 Gais,15,,17,18,35
034 Gais,16,,22,16,38
034 Gais,17,,22,16,38
034 Gais,18,,21,19,40
034 Gais,19,,18,18,36
034 Gais,20,,22,18,40
034 Gais,21,,24,23,47
034 Gais,22,,23,14,37
034 Gais,23,,19,18,37
034 Gais,24,,17,23,40
034 Gais,25,,22,18,40
034 Gais,26,,20,19,39
034 Gais,27,,27,26,53
034 Gais,28,,25,26,51
034 Gais,29,,25,36,61
034 Gais,30,,33,27,60
034 Gais,31,,27,24,51
034 Gais,32,,34,33,67
034 Gais,33,,22,24,46
034 Gais,34,,27,29,56
034 Gais,35,,33,20,53
034 Gais,36,,33,27,60
034 Gais,37,,29,29,58
034 Gais,38,,17,16,33
034 Gais,39,,30,18,48
034 Gais,40,,22,28,50
034 Gais,41,,17,11,28
034 Gais,42,,18,22,40
034 Gais,43,,24,19,43
034 Gais,44,,11,15,26
034 Gais,45,,27,21,48
034 Gais,46,,16,13,29
034 Gais,47,,15,13,28
034 Gais,48,,15,14,29
034 Gais,49,,15,17,32
034 Gais,50,,17,19,36
034 Gais,51,,22,20,42
034 Gais,52,,15,11,26
034 Gais,53,,25,14,39
034 Gais,54,,21,12,33
034 Gais,55,,18,18,36
034 Gais,56,,11,9,20
034 Gais,57,,13,13,26
034 Gais,58,,14,16,30
034 Gais,59,,14,15,29
034 Gais,60,,20,13,33
034 Gais,61,,18,13,31
034 Gais,62,,13,16,29
034 Gais,63,,15,14,29
034 Gais,64,,18,16,34
034 Gais,65,,10,13,23
034 Gais,66,,13,12,25
034 Gais,67,,7,6,13
034 Gais,68,,4,10,14
034 Gais,69,,8,9,17
034 Gais,70,,11,8,19
034 Gais,71,,4,13,17
034 Gais,72,,5,5,10
034 Gais,73,,10,8,18
034 Gais,74,,7,9,16
034 Gais,75,,12,8,20
034 Gais,76,,5,6,11
034 Gais,77,,5,8,13
034 Gais,78,,5,11,16
034 Gais,79,,3,4,7
034 Gais,80,,3,5,8
034 Gais,81,,2,2,4
034 Gais,82,,1,3,4
034 Gais,83,,2,4,6
034 Gais,84,,1,2,3
034 Gais,85,,-,3,3
034 Gais,86,,-,3,3
034 Gais,87,,1,4,5
034 Gais,88,,2,2,4
034 Gais,89,,-,2,2
034 Gais,90,,1,1,2
034 Gais,91,,1,1,2
034 Gais,92,,-,1,1
034 Gais,94,,-,1,1
035 Gargazon,0,,4,7,11
035 Gargazon,1,,10,5,15
035 Gargazon,2,,12,7,19
035 Gargazon,3,,13,7,20
035 Gargazon,4,,6,13,19
035 Gargazon,5,,11,5,16
035 Gargazon,6,,12,5,17
035 Gargazon,7,,3,7,10
035 Gargazon,8,,11,8,19
035 Gargazon,9,,11,8,19
035 Gargazon,10,,17,10,27
035 Gargazon,11,,6,11,17
035 Gargazon,12,,8,6,14
035 Gargazon,13,,9,4,13
035 Gargazon,14,,7,10,17
035 Gargazon,15,,5,10,15
035 Gargazon,16,,10,3,13
035 Gargazon,17,,11,3,14
035 Gargazon,18,,4,7,11
035 Gargazon,19,,5,7,12
035 Gargazon,20,,11,5,16
035 Gargazon,21,,6,12,18
035 Gargazon,22,,5,8,13
035 Gargazon,23,,2,9,11
035 Gargazon,24,,4,7,11
035 Gargazon,25,,4,7,11
035 Gargazon,26,,9,6,15
035 Gargazon,27,,5,9,14
035 Gargazon,28,,9,7,16
035 Gargazon,29,,7,18,25
035 Gargazon,30,,12,13,25
035 Gargazon,31,,9,9,18
035 Gargazon,32,,14,11,25
035 Gargazon,33,,15,17,32
035 Gargazon,34,,16,17,33
035 Gargazon,35,,12,15,27
035 Gargazon,36,,13,9,22
035 Gargazon,37,,15,15,30
035 Gargazon,38,,14,15,29
035 Gargazon,39,,13,12,25
035 Gargazon,40,,10,11,21
035 Gargazon,41,,9,12,21
035 Gargazon,42,,16,12,28
035 Gargazon,43,,7,7,14
035 Gargazon,44,,18,10,28
035 Gargazon,45,,13,6,19
035 Gargazon,46,,8,3,11
035 Gargazon,47,,10,11,21
035 Gargazon,48,,15,9,24
035 Gargazon,49,,3,7,10
035 Gargazon,50,,10,9,19
035 Gargazon,51,,7,6,13
035 Gargazon,52,,7,10,17
035 Gargazon,53,,8,8,16
035 Gargazon,54,,4,10,14
035 Gargazon,55,,6,13,19
035 Gargazon,56,,8,4,12
035 Gargazon,57,,2,5,7
035 Gargazon,58,,4,7,11
035 Gargazon,59,,8,12,20
035 Gargazon,60,,10,9,19
035 Gargazon,61,,5,15,20
035 Gargazon,62,,9,6,15
035 Gargazon,63,,10,7,17
035 Gargazon,64,,8,13,21
035 Gargazon,65,,5,4,9
035 Gargazon,66,,12,2,14
035 Gargazon,67,,8,5,13
035 Gargazon,68,,3,10,13
035 Gargazon,69,,7,2,9
035 Gargazon,70,,4,7,11
035 Gargazon,71,,3,5,8
035 Gargazon,72,,2,10,12
035 Gargazon,73,,4,5,9
035 Gargazon,74,,4,5,9
035 Gargazon,75,,5,3,8
035 Gargazon,76,,3,6,9
035 Gargazon,77,,1,3,4
035 Gargazon,78,,5,6,11
035 Gargazon,79,,3,7,10
035 Gargazon,80,,5,5,10
035 Gargazon,81,,4,1,5
035 Gargazon,82,,2,2,4
035 Gargazon,83,,-,2,2
035 Gargazon,84,,-,1,1
035 Gargazon,85,,-,2,2
035 Gargazon,86,,2,3,5
035 Gargazon,87,,2,2,4
035 Gargazon,88,,2,4,6
035 Gargazon,89,,2,4,6
035 Gargazon,92,,-,1,1
035 Gargazon,95,,-,1,1
036 Glurns,0,,5,-,5
036 Glurns,1,,4,4,8
036 Glurns,2,,5,5,10
036 Glurns,3,,9,4,13
036 Glurns,4,,4,7,11
036 Glurns,5,,8,5,13
036 Glurns,6,,7,4,11
036 Glurns,7,,2,3,5
036 Glurns,8,,8,7,15
036 Glurns,9,,4,8,12
036 Glurns,10,,6,4,10
036 Glurns,11,,8,6,14
036 Glurns,12,,4,3,7
036 Glurns,13,,6,9,15
036 Glurns,14,,6,6,12
036 Glurns,15,,5,8,13
036 Glurns,16,,3,3,6
036 Glurns,17,,7,7,14
036 Glurns,18,,9,6,15
036 Glurns,19,,11,9,20
036 Glurns,20,,6,7,13
036 Glurns,21,,13,7,20
036 Glurns,22,,6,9,15
036 Glurns,23,,5,10,15
036 Glurns,24,,5,2,7
036 Glurns,25,,10,4,14
036 Glurns,26,,7,7,14
036 Glurns,27,,8,8,16
036 Glurns,28,,3,4,7
036 Glurns,29,,5,6,11
036 Glurns,30,,6,6,12
036 Glurns,31,,4,-,4
036 Glurns,32,,4,6,10
036 Glurns,33,,6,5,11
036 Glurns,34,,7,10,17
036 Glurns,35,,5,8,13
036 Glurns,36,,1,5,6
036 Glurns,37,,9,4,13
036 Glurns,38,,6,9,15
036 Glurns,39,,4,5,9
036 Glurns,40,,4,6,10
036 Glurns,41,,8,8,16
036 Glurns,42,,12,9,21
036 Glurns,43,,5,10,15
036 Glurns,44,,6,12,18
036 Glurns,45,,8,5,13
036 Glurns,46,,10,7,17
036 Glurns,47,,12,4,16
036 Glurns,48,,8,9,17
036 Glurns,49,,5,10,15
036 Glurns,50,,8,10,18
036 Glurns,51,,6,5,11
036 Glurns,52,,6,3,9
036 Glurns,53,,8,5,13
036 Glurns,54,,11,7,18
036 Glurns,55,,9,2,11
036 Glurns,56,,7,1,8
036 Glurns,57,,4,4,8
036 Glurns,58,,1,4,5
036 Glurns,59,,5,5,10
036 Glurns,60,,4,2,6
036 Glurns,61,,5,1,6
036 Glurns,62,,1,3,4
036 Glurns,63,,4,4,8
036 Glurns,64,,5,5,10
036 Glurns,65,,-,1,1
036 Glurns,66,,2,4,6
036 Glurns,67,,1,6,7
036 Glurns,68,,1,1,2
036 Glurns,69,,8,3,11
036 Glurns,70,,4,2,6
036 Glurns,71,,4,1,5
036 Glurns,72,,4,7,11
036 Glurns,73,,1,3,4
036 Glurns,74,,1,3,4
036 Glurns,75,,-,2,2
036 Glurns,76,,1,6,7
036 Glurns,77,,2,2,4
036 Glurns,78,,-,1,1
036 Glurns,79,,1,-,1
036 Glurns,80,,2,3,5
036 Glurns,81,,1,1,2
036 Glurns,82,,1,3,4
036 Glurns,83,,-,2,2
036 Glurns,84,,1,2,3
036 Glurns,86,,-,2,2
036 Glurns,87,,-,3,3
036 Glurns,88,,1,4,5
036 Glurns,89,,-,3,3
036 Glurns,90,,1,3,4
036 Glurns,91,,-,1,1
036 Glurns,92,,-,1,1
036 Glurns,94,,-,1,1
037 Latsch,0,,32,26,58
037 Latsch,1,,36,36,72
037 Latsch,2,,27,20,47
037 Latsch,3,,27,24,51
037 Latsch,4,,34,40,74
037 Latsch,5,,37,36,73
037 Latsch,6,,46,34,80
037 Latsch,7,,40,24,64
037 Latsch,8,,33,32,65
037 Latsch,9,,34,35,69
037 Latsch,10,,28,34,62
037 Latsch,11,,34,50,84
037 Latsch,12,,34,29,63
037 Latsch,13,,39,33,72
037 Latsch,14,,30,38,68
037 Latsch,15,,34,24,58
037 Latsch,16,,33,34,67
037 Latsch,17,,32,36,68
037 Latsch,18,,26,31,57
037 Latsch,19,,32,46,78
037 Latsch,20,,27,40,67
037 Latsch,21,,32,38,70
037 Latsch,22,,39,26,65
037 Latsch,23,,29,25,54
037 Latsch,24,,24,37,61
037 Latsch,25,,22,20,42
037 Latsch,26,,30,30,60
037 Latsch,27,,28,31,59
037 Latsch,28,,28,35,63
037 Latsch,29,,31,39,70
037 Latsch,30,,40,43,83
037 Latsch,31,,38,37,75
037 Latsch,32,,42,46,88
037 Latsch,33,,44,55,99
037 Latsch,34,,50,50,100
037 Latsch,35,,36,51,87
037 Latsch,36,,53,48,101
037 Latsch,37,,57,41,98
037 Latsch,38,,49,47,96
037 Latsch,39,,44,45,89
037 Latsch,40,,48,40,88
037 Latsch,41,,43,56,99
037 Latsch,42,,46,44,90
037 Latsch,43,,38,30,68
037 Latsch,44,,28,32,60
037 Latsch,45,,30,33,63
037 Latsch,46,,39,28,67
037 Latsch,47,,32,23,55
037 Latsch,48,,28,21,49
037 Latsch,49,,42,20,62
037 Latsch,50,,21,33,54
037 Latsch,51,,32,17,49
037 Latsch,52,,15,22,37
037 Latsch,53,,16,21,37
037 Latsch,54,,18,16,34
037 Latsch,55,,18,22,40
037 Latsch,56,,20,18,38
037 Latsch,57,,24,13,37
037 Latsch,58,,26,23,49
037 Latsch,59,,29,23,52
037 Latsch,60,,16,27,43
037 Latsch,61,,22,24,46
037 Latsch,62,,18,19,37
037 Latsch,63,,18,30,48
037 Latsch,64,,13,27,40
037 Latsch,65,,20,14,34
037 Latsch,66,,28,15,43
037 Latsch,67,,19,26,45
037 Latsch,68,,20,22,42
037 Latsch,69,,24,21,45
037 Latsch,70,,17,19,36
037 Latsch,71,,21,20,41
037 Latsch,72,,17,16,33
037 Latsch,73,,17,19,36
037 Latsch,74,,15,30,45
037 Latsch,75,,21,15,36
037 Latsch,76,,16,23,39
037 Latsch,77,,8,18,26
037 Latsch,78,,11,20,31
037 Latsch,79,,10,22,32
037 Latsch,80,,15,18,33
037 Latsch,81,,9,8,17
037 Latsch,82,,7,11,18
037 Latsch,83,,2,4,6
037 Latsch,84,,3,5,8
037 Latsch,85,,1,4,5
037 Latsch,86,,2,4,6
037 Latsch,87,,3,6,9
037 Latsch,88,,4,8,12
037 Latsch,89,,3,3,6
037 Latsch,90,,2,3,5
037 Latsch,91,,1,2,3
037 Latsch,92,,1,1,2
037 Latsch,93,,2,3,5
037 Latsch,95,,-,2,2
038 Algund,0,,28,24,52
038 Algund,1,,21,28,49
038 Algund,2,,37,25,62
038 Algund,3,,21,20,41
038 Algund,4,,18,20,38
038 Algund,5,,15,19,34
038 Algund,6,,33,24,57
038 Algund,7,,25,13,38
038 Algund,8,,26,17,43
038 Algund,9,,31,18,49
038 Algund,10,,25,22,47
038 Algund,11,,28,19,47
038 Algund,12,,20,27,47
038 Algund,13,,20,24,44
038 Algund,14,,28,21,49
038 Algund,15,,22,31,53
038 Algund,16,,24,20,44
038 Algund,17,,21,21,42
038 Algund,18,,24,30,54
038 Algund,19,,26,21,47
038 Algund,20,,25,20,45
038 Algund,21,,27,26,53
038 Algund,22,,19,25,44
038 Algund,23,,19,29,48
038 Algund,24,,18,34,52
038 Algund,25,,24,27,51
038 Algund,26,,28,20,48
038 Algund,27,,24,28,52
038 Algund,28,,35,16,51
038 Algund,29,,32,32,64
038 Algund,30,,25,31,56
038 Algund,31,,43,26,69
038 Algund,32,,38,35,73
038 Algund,33,,37,32,69
038 Algund,34,,34,36,70
038 Algund,35,,32,36,68
038 Algund,36,,34,40,74
038 Algund,37,,46,28,74
038 Algund,38,,32,41,73
038 Algund,39,,32,39,71
038 Algund,40,,25,46,71
038 Algund,41,,29,41,70
038 Algund,42,,34,30,64
038 Algund,43,,40,31,71
038 Algund,44,,29,31,60
038 Algund,45,,32,28,60
038 Algund,46,,24,25,49
038 Algund,47,,30,21,51
038 Algund,48,,18,31,49
038 Algund,49,,24,26,50
038 Algund,50,,28,28,56
038 Algund,51,,21,24,45
038 Algund,52,,27,27,54
038 Algund,53,,27,23,50
038 Algund,54,,22,21,43
038 Algund,55,,35,27,62
038 Algund,56,,24,25,49
038 Algund,57,,25,24,49
038 Algund,58,,22,21,43
038 Algund,59,,18,36,54
038 Algund,60,,21,22,43
038 Algund,61,,14,27,41
038 Algund,62,,25,30,55
038 Algund,63,,22,24,46
038 Algund,64,,15,13,28
038 Algund,65,,16,29,45
038 Algund,66,,15,20,35
038 Algund,67,,22,23,45
038 Algund,68,,23,23,46
038 Algund,69,,18,22,40
038 Algund,70,,14,24,38
038 Algund,71,,14,22,36
038 Algund,72,,14,22,36
038 Algund,73,,12,21,33
038 Algund,74,,12,18,30
038 Algund,75,,15,20,35
038 Algund,76,,11,15,26
038 Algund,77,,7,18,25
038 Algund,78,,5,12,17
038 Algund,79,,11,18,29
038 Algund,80,,12,11,23
038 Algund,81,,12,13,25
038 Algund,82,,7,12,19
038 Algund,83,,5,7,12
038 Algund,84,,1,6,7
038 Algund,85,,2,4,6
038 Algund,86,,3,5,8
038 Algund,87,,3,7,10
038 Algund,88,,2,5,7
038 Algund,89,,2,8,10
038 Algund,90,,1,9,10
038 Algund,91,,5,6,11
038 Algund,92,,3,1,4
038 Algund,93,,4,4,8
038 Algund,94,,-,2,2
038 Algund,95,,-,2,2
038 Algund,96,,-,1,1
039 Lajen,0,,17,22,39
039 Lajen,1,,24,14,38
039 Lajen,2,,17,15,32
039 Lajen,3,,19,15,34
039 Lajen,4,,14,22,36
039 Lajen,5,,17,10,27
039 Lajen,6,,8,11,19
039 Lajen,7,,11,14,25
039 Lajen,8,,13,14,27
039 Lajen,9,,15,10,25
039 Lajen,10,,19,19,38
039 Lajen,11,,8,9,17
039 Lajen,12,,17,15,32
039 Lajen,13,,12,10,22
039 Lajen,14,,13,6,19
039 Lajen,15,,19,13,32
039 Lajen,16,,19,11,30
039 Lajen,17,,9,13,22
039 Lajen,18,,9,18,27
039 Lajen,19,,19,15,34
039 Lajen,20,,10,25,35
039 Lajen,21,,20,20,40
039 Lajen,22,,20,12,32
039 Lajen,23,,22,16,38
039 Lajen,24,,23,8,31
039 Lajen,25,,20,17,37
039 Lajen,26,,18,29,47
039 Lajen,27,,32,18,50
039 Lajen,28,,19,18,37
039 Lajen,29,,21,26,47
039 Lajen,30,,19,23,42
039 Lajen,31,,23,23,46
039 Lajen,32,,32,21,53
039 Lajen,33,,20,20,40
039 Lajen,34,,24,21,45
039 Lajen,35,,22,18,40
039 Lajen,36,,29,17,46
039 Lajen,37,,22,16,38
039 Lajen,38,,15,11,26
039 Lajen,39,,26,14,40
039 Lajen,40,,12,22,34
039 Lajen,41,,12,9,21
039 Lajen,42,,16,23,39
039 Lajen,43,,21,10,31
039 Lajen,44,,14,11,25
039 Lajen,45,,11,14,25
039 Lajen,46,,13,11,24
039 Lajen,47,,5,13,18
039 Lajen,48,,9,8,17
039 Lajen,49,,8,10,18
039 Lajen,50,,10,12,22
039 Lajen,51,,13,14,27
039 Lajen,52,,5,14,19
039 Lajen,53,,9,17,26
039 Lajen,54,,15,7,22
039 Lajen,55,,11,13,24
039 Lajen,56,,13,9,22
039 Lajen,57,,11,8,19
039 Lajen,58,,11,12,23
039 Lajen,59,,19,13,32
039 Lajen,60,,18,17,35
039 Lajen,61,,15,10,25
039 Lajen,62,,15,10,25
039 Lajen,63,,5,16,21
039 Lajen,64,,7,8,15
039 Lajen,65,,7,9,16
039 Lajen,66,,7,9,16
039 Lajen,67,,8,8,16
039 Lajen,68,,5,13,18
039 Lajen,69,,10,4,14
039 Lajen,70,,3,8,11
039 Lajen,71,,8,4,12
039 Lajen,72,,5,5,10
039 Lajen,73,,7,9,16
039 Lajen,74,,8,11,19
039 Lajen,75,,10,6,16
039 Lajen,76,,4,9,13
039 Lajen,77,,4,8,12
039 Lajen,78,,6,7,13
039 Lajen,79,,3,6,9
039 Lajen,80,,5,8,13
039 Lajen,81,,2,2,4
039 Lajen,82,,2,3,5
039 Lajen,83,,1,3,4
039 Lajen,84,,-,2,2
039 Lajen,85,,-,2,2
039 Lajen,86,,1,3,4
039 Lajen,87,,-,2,2
039 Lajen,88,,2,2,4
039 Lajen,89,,2,2,4
039 Lajen,92,,1,2,3
039 Lajen,93,,1,1,2
039 Lajen,94,,-,2,2
039 Lajen,95,,1,1,2
040 Leifers,0,,78,71,149
040 Leifers,1,,91,89,180
040 Leifers,2,,88,94,182
040 Leifers,3,,84,100,184
040 Leifers,4,,105,85,190
040 Leifers,5,,95,82,177
040 Leifers,6,,92,88,180
040 Leifers,7,,86,90,176
040 Leifers,8,,80,68,148
040 Leifers,9,,80,73,153
040 Leifers,10,,87,80,167
040 Leifers,11,,91,77,168
040 Leifers,12,,65,77,142
040 Leifers,13,,69,82,151
040 Leifers,14,,63,69,132
040 Leifers,15,,78,82,160
040 Leifers,16,,75,64,139
040 Leifers,17,,73,69,142
040 Leifers,18,,76,89,165
040 Leifers,19,,60,64,124
040 Leifers,20,,72,65,137
040 Leifers,21,,68,68,136
040 Leifers,22,,75,82,157
040 Leifers,23,,87,80,167
040 Leifers,24,,104,93,197
040 Leifers,25,,118,94,212
040 Leifers,26,,123,112,235
040 Leifers,27,,154,127,281
040 Leifers,28,,142,122,264
040 Leifers,29,,127,123,250
040 Leifers,30,,132,141,273
040 Leifers,31,,127,140,267
040 Leifers,32,,155,128,283
040 Leifers,33,,140,155,295
040 Leifers,34,,145,134,279
040 Leifers,35,,145,125,270
040 Leifers,36,,163,128,291
040 Leifers,37,,168,156,324
040 Leifers,38,,147,141,288
040 Leifers,39,,138,123,261
040 Leifers,40,,124,139,263
040 Leifers,41,,125,116,241
040 Leifers,42,,116,107,223
040 Leifers,43,,88,107,195
040 Leifers,44,,105,111,216
040 Leifers,45,,135,133,268
040 Leifers,46,,110,125,235
040 Leifers,47,,93,108,201
040 Leifers,48,,114,118,232
040 Leifers,49,,101,94,195
040 Leifers,50,,108,91,199
040 Leifers,51,,96,88,184
040 Leifers,52,,96,97,193
040 Leifers,53,,115,103,218
040 Leifers,54,,105,102,207
040 Leifers,55,,123,150,273
040 Leifers,56,,87,83,170
040 Leifers,57,,99,91,190
040 Leifers,58,,94,90,184
040 Leifers,59,,97,92,189
040 Leifers,60,,88,83,171
040 Leifers,61,,96,92,188
040 Leifers,62,,95,90,185
040 Leifers,63,,95,77,172
040 Leifers,64,,60,84,144
040 Leifers,65,,61,67,128
040 Leifers,66,,55,67,122
040 Leifers,67,,66,64,130
040 Leifers,68,,59,63,122
040 Leifers,69,,66,79,145
040 Leifers,70,,56,62,118
040 Leifers,71,,55,69,124
040 Leifers,72,,44,59,103
040 Leifers,73,,46,41,87
040 Leifers,74,,40,63,103
040 Leifers,75,,36,51,87
040 Leifers,76,,29,48,77
040 Leifers,77,,27,50,77
040 Leifers,78,,30,39,69
040 Leifers,79,,28,41,69
040 Leifers,80,,21,27,48
040 Leifers,81,,16,26,42
040 Leifers,82,,13,36,49
040 Leifers,83,,4,19,23
040 Leifers,84,,3,13,16
040 Leifers,85,,6,16,22
040 Leifers,86,,3,17,20
040 Leifers,87,,4,22,26
040 Leifers,88,,11,15,26
040 Leifers,89,,7,22,29
040 Leifers,90,,5,11,16
040 Leifers,91,,1,12,13
040 Leifers,92,,6,5,11
040 Leifers,93,,2,2,4
040 Leifers,94,,2,4,6
040 Leifers,95,,-,3,3
040 Leifers,96,,-,3,3
040 Leifers,97,,-,1,1
040 Leifers,98,,-,1,1
041 Lana,0,,65,56,121
041 Lana,1,,66,71,137
041 Lana,2,,69,51,120
041 Lana,3,,57,60,117
041 Lana,4,,55,60,115
041 Lana,5,,65,74,139
041 Lana,6,,56,56,112
041 Lana,7,,62,68,130
041 Lana,8,,56,57,113
041 Lana,9,,60,57,117
041 Lana,10,,52,58,110
041 Lana,11,,52,57,109
041 Lana,12,,45,73,118
041 Lana,13,,59,45,104
041 Lana,14,,70,47,117
041 Lana,15,,53,49,102
041 Lana,16,,62,59,121
041 Lana,17,,60,48,108
041 Lana,18,,65,54,119
041 Lana,19,,65,49,114
041 Lana,20,,45,63,108
041 Lana,21,,46,50,96
041 Lana,22,,54,68,122
041 Lana,23,,68,51,119
041 Lana,24,,70,53,123
041 Lana,25,,56,63,119
041 Lana,26,,61,62,123
041 Lana,27,,71,68,139
041 Lana,28,,69,93,162
041 Lana,29,,93,84,177
041 Lana,30,,80,83,163
041 Lana,31,,78,94,172
041 Lana,32,,120,80,200
041 Lana,33,,85,83,168
041 Lana,34,,91,91,182
041 Lana,35,,92,102,194
041 Lana,36,,87,90,177
041 Lana,37,,96,92,188
041 Lana,38,,95,81,176
041 Lana,39,,86,76,162
041 Lana,40,,82,86,168
041 Lana,41,,79,76,155
041 Lana,42,,77,75,152
041 Lana,43,,73,84,157
041 Lana,44,,74,71,145
041 Lana,45,,57,58,115
041 Lana,46,,66,71,137
041 Lana,47,,61,63,124
041 Lana,48,,56,64,120
041 Lana,49,,50,57,107
041 Lana,50,,56,62,118
041 Lana,51,,54,55,109
041 Lana,52,,53,54,107
041 Lana,53,,53,66,119
041 Lana,54,,55,45,100
041 Lana,55,,64,59,123
041 Lana,56,,44,52,96
041 Lana,57,,48,57,105
041 Lana,58,,63,57,120
041 Lana,59,,57,67,124
041 Lana,60,,52,46,98
041 Lana,61,,39,47,86
041 Lana,62,,55,52,107
041 Lana,63,,45,54,99
041 Lana,64,,36,40,76
041 Lana,65,,43,51,94
041 Lana,66,,37,40,77
041 Lana,67,,41,46,87
041 Lana,68,,33,43,76
041 Lana,69,,31,34,65
041 Lana,70,,29,47,76
041 Lana,71,,28,39,67
041 Lana,72,,23,37,60
041 Lana,73,,37,30,67
041 Lana,74,,29,36,65
041 Lana,75,,25,42,67
041 Lana,76,,30,41,71
041 Lana,77,,12,25,37
041 Lana,78,,20,29,49
041 Lana,79,,24,40,64
041 Lana,80,,14,37,51
041 Lana,81,,15,33,48
041 Lana,82,,10,26,36
041 Lana,83,,3,13,16
041 Lana,84,,3,20,23
041 Lana,85,,3,7,10
041 Lana,86,,14,19,33
041 Lana,87,,8,16,24
041 Lana,88,,5,19,24
041 Lana,89,,4,13,17
041 Lana,90,,2,10,12
041 Lana,91,,2,14,16
041 Lana,92,,1,8,9
041 Lana,93,,-,8,8
041 Lana,94,,2,5,7
041 Lana,95,,1,4,5
041 Lana,96,,-,2,2
041 Lana,97,,-,3,3
041 Lana,98,,1,1,2
042 Laas,0,,14,16,30
042 Laas,1,,24,26,50
042 Laas,2,,19,12,31
042 Laas,3,,26,30,56
042 Laas,4,,27,27,54
042 Laas,5,,32,34,66
042 Laas,6,,30,24,54
042 Laas,7,,25,25,50
042 Laas,8,,23,20,43
042 Laas,9,,15,26,41
042 Laas,10,,23,21,44
042 Laas,11,,20,25,45
042 Laas,12,,21,24,45
042 Laas,13,,24,19,43
042 Laas,14,,29,22,51
042 Laas,15,,33,20,53
042 Laas,16,,30,28,58
042 Laas,17,,28,27,55
042 Laas,18,,22,38,60
042 Laas,19,,33,25,58
042 Laas,20,,26,27,53
042 Laas,21,,18,25,43
042 Laas,22,,29,33,62
042 Laas,23,,32,25,57
042 Laas,24,,25,20,45
042 Laas,25,,24,30,54
042 Laas,26,,29,24,53
042 Laas,27,,37,22,59
042 Laas,28,,31,34,65
042 Laas,29,,28,23,51
042 Laas,30,,27,25,52
042 Laas,31,,35,24,59
042 Laas,32,,34,35,69
042 Laas,33,,37,21,58
042 Laas,34,,33,25,58
042 Laas,35,,32,25,57
042 Laas,36,,40,33,73
042 Laas,37,,25,30,55
042 Laas,38,,25,29,54
042 Laas,39,,33,28,61
042 Laas,40,,29,27,56
042 Laas,41,,36,24,60
042 Laas,42,,34,28,62
042 Laas,43,,28,24,52
042 Laas,44,,21,27,48
042 Laas,45,,23,18,41
042 Laas,46,,16,14,30
042 Laas,47,,16,24,40
042 Laas,48,,25,12,37
042 Laas,49,,31,24,55
042 Laas,50,,14,17,31
042 Laas,51,,21,25,46
042 Laas,52,,19,19,38
042 Laas,53,,18,20,38
042 Laas,54,,28,12,40
042 Laas,55,,14,14,28
042 Laas,56,,15,12,27
042 Laas,57,,12,15,27
042 Laas,58,,13,16,29
042 Laas,59,,17,19,36
042 Laas,60,,16,21,37
042 Laas,61,,20,26,46
042 Laas,62,,14,25,39
042 Laas,63,,19,14,33
042 Laas,64,,16,14,30
042 Laas,65,,22,11,33
042 Laas,66,,18,22,40
042 Laas,67,,13,19,32
042 Laas,68,,19,12,31
042 Laas,69,,16,18,34
042 Laas,70,,21,22,43
042 Laas,71,,17,20,37
042 Laas,72,,16,12,28
042 Laas,73,,13,13,26
042 Laas,74,,14,20,34
042 Laas,75,,16,12,28
042 Laas,76,,9,12,21
042 Laas,77,,7,20,27
042 Laas,78,,15,10,25
042 Laas,79,,7,20,27
042 Laas,80,,4,7,11
042 Laas,81,,7,10,17
042 Laas,82,,4,8,12
042 Laas,83,,5,4,9
042 Laas,84,,3,2,5
042 Laas,85,,2,4,6
042 Laas,86,,-,2,2
042 Laas,87,,1,7,8
042 Laas,88,,1,6,7
042 Laas,89,,3,5,8
042 Laas,90,,-,5,5
042 Laas,91,,2,2,4
042 Laas,92,,-,2,2
042 Laas,93,,-,2,2
042 Laas,94,,-,1,1
042 Laas,96,,-,1,1
043 Laurein,0,,7,-,7
043 Laurein,1,,3,7,10
043 Laurein,2,,3,2,5
043 Laurein,3,,2,3,5
043 Laurein,4,,3,5,8
043 Laurein,5,,1,2,3
043 Laurein,6,,2,2,4
043 Laurein,7,,2,4,6
043 Laurein,8,,1,5,6
043 Laurein,9,,1,1,2
043 Laurein,10,,1,1,2
043 Laurein,11,,4,-,4
043 Laurein,12,,3,2,5
043 Laurein,13,,1,-,1
043 Laurein,14,,2,2,4
043 Laurein,15,,4,2,6
043 Laurein,16,,2,2,4
043 Laurein,17,,1,2,3
043 Laurein,19,,2,2,4
043 Laurein,20,,3,1,4
043 Laurein,21,,2,-,2
043 Laurein,22,,2,-,2
043 Laurein,23,,2,5,7
043 Laurein,24,,1,2,3
043 Laurein,25,,5,1,6
043 Laurein,26,,-,6,6
043 Laurein,27,,1,4,5
043 Laurein,28,,5,1,6
043 Laurein,29,,1,2,3
043 Laurein,30,,5,6,11
043 Laurein,31,,4,2,6
043 Laurein,32,,5,4,9
043 Laurein,33,,-,2,2
043 Laurein,34,,5,7,12
043 Laurein,35,,6,3,9
043 Laurein,36,,4,1,5
043 Laurein,37,,4,2,6
043 Laurein,38,,-,2,2
043 Laurein,39,,1,2,3
043 Laurein,40,,5,5,10
043 Laurein,41,,1,1,2
043 Laurein,42,,3,4,7
043 Laurein,43,,3,2,5
043 Laurein,44,,7,-,7
043 Laurein,46,,2,-,2
043 Laurein,47,,4,1,5
043 Laurein,48,,2,1,3
043 Laurein,49,,2,2,4
043 Laurein,51,,2,1,3
043 Laurein,52,,3,2,5
043 Laurein,53,,2,-,2
043 Laurein,54,,2,4,6
043 Laurein,55,,-,1,1
043 Laurein,56,,-,1,1
043 Laurein,57,,-,1,1
043 Laurein,58,,1,-,1
043 Laurein,59,,2,-,2
043 Laurein,61,,4,2,6
043 Laurein,62,,1,3,4
043 Laurein,63,,1,1,2
043 Laurein,64,,2,1,3
043 Laurein,65,,1,2,3
043 Laurein,66,,1,3,4
043 Laurein,67,,1,5,6
043 Laurein,68,,1,3,4
043 Laurein,69,,3,2,5
043 Laurein,70,,1,3,4
043 Laurein,71,,2,5,7
043 Laurein,72,,3,-,3
043 Laurein,73,,5,1,6
043 Laurein,74,,5,1,6
043 Laurein,75,,2,2,4
043 Laurein,76,,2,2,4
043 Laurein,77,,-,1,1
043 Laurein,78,,1,-,1
043 Laurein,79,,-,3,3
043 Laurein,80,,1,-,1
043 Laurein,81,,2,2,4
043 Laurein,82,,-,1,1
043 Laurein,85,,1,-,1
043 Laurein,87,,-,2,2
043 Laurein,88,,1,1,2
043 Laurein,90,,-,1,1
043 Laurein,91,,1,1,2
044 Lüsen,0,,11,11,22
044 Lüsen,1,,14,9,23
044 Lüsen,2,,5,10,15
044 Lüsen,3,,9,11,20
044 Lüsen,4,,16,6,22
044 Lüsen,5,,9,13,22
044 Lüsen,6,,9,12,21
044 Lüsen,7,,14,13,27
044 Lüsen,8,,9,9,18
044 Lüsen,9,,11,9,20
044 Lüsen,10,,8,10,18
044 Lüsen,11,,6,11,17
044 Lüsen,12,,18,9,27
044 Lüsen,13,,9,9,18
044 Lüsen,14,,7,8,15
044 Lüsen,15,,12,12,24
044 Lüsen,16,,3,2,5
044 Lüsen,17,,9,18,27
044 Lüsen,18,,6,11,17
044 Lüsen,19,,15,10,25
044 Lüsen,20,,11,13,24
044 Lüsen,21,,15,13,28
044 Lüsen,22,,8,9,17
044 Lüsen,23,,16,19,35
044 Lüsen,24,,6,7,13
044 Lüsen,25,,15,10,25
044 Lüsen,26,,14,13,27
044 Lüsen,27,,16,12,28
044 Lüsen,28,,10,7,17
044 Lüsen,29,,10,9,19
044 Lüsen,30,,15,12,27
044 Lüsen,31,,17,16,33
044 Lüsen,32,,9,9,18
044 Lüsen,33,,11,15,26
044 Lüsen,34,,13,22,35
044 Lüsen,35,,14,14,28
044 Lüsen,36,,18,13,31
044 Lüsen,37,,13,9,22
044 Lüsen,38,,13,9,22
044 Lüsen,39,,9,13,22
044 Lüsen,40,,12,10,22
044 Lüsen,41,,8,13,21
044 Lüsen,42,,7,4,11
044 Lüsen,43,,11,12,23
044 Lüsen,44,,9,10,19
044 Lüsen,45,,9,9,18
044 Lüsen,46,,7,6,13
044 Lüsen,47,,14,4,18
044 Lüsen,48,,6,10,16
044 Lüsen,49,,10,4,14
044 Lüsen,50,,4,7,11
044 Lüsen,51,,5,7,12
044 Lüsen,52,,8,12,20
044 Lüsen,53,,8,2,10
044 Lüsen,54,,7,4,11
044 Lüsen,55,,10,5,15
044 Lüsen,56,,4,9,13
044 Lüsen,57,,4,6,10
044 Lüsen,58,,7,7,14
044 Lüsen,59,,2,6,8
044 Lüsen,60,,7,4,11
044 Lüsen,61,,5,9,14
044 Lüsen,62,,9,7,16
044 Lüsen,63,,7,4,11
044 Lüsen,64,,7,5,12
044 Lüsen,65,,6,9,15
044 Lüsen,66,,7,5,12
044 Lüsen,67,,4,5,9
044 Lüsen,68,,7,3,10
044 Lüsen,69,,2,10,12
044 Lüsen,70,,8,5,13
044 Lüsen,71,,4,5,9
044 Lüsen,72,,5,8,13
044 Lüsen,73,,8,8,16
044 Lüsen,74,,6,4,10
044 Lüsen,75,,2,7,9
044 Lüsen,76,,4,5,9
044 Lüsen,77,,4,3,7
044 Lüsen,78,,2,4,6
044 Lüsen,79,,1,3,4
044 Lüsen,80,,2,7,9
044 Lüsen,81,,2,5,7
044 Lüsen,82,,3,2,5
044 Lüsen,83,,-,4,4
044 Lüsen,84,,1,2,3
044 Lüsen,85,,-,2,2
044 Lüsen,86,,-,3,3
044 Lüsen,87,,2,1,3
044 Lüsen,88,,1,4,5
044 Lüsen,89,,1,1,2
044 Lüsen,92,,1,1,2
045 Margreid a.d. Weinstr.,0,,13,7,20
045 Margreid a.d. Weinstr.,1,,9,7,16
045 Margreid a.d. Weinstr.,2,,9,10,19
045 Margreid a.d. Weinstr.,3,,5,12,17
045 Margreid a.d. Weinstr.,4,,9,14,23
045 Margreid a.d. Weinstr.,5,,3,4,7
045 Margreid a.d. Weinstr.,6,,1,7,8
045 Margreid a.d. Weinstr.,7,,5,8,13
045 Margreid a.d. Weinstr.,8,,3,13,16
045 Margreid a.d. Weinstr.,9,,5,2,7
045 Margreid a.d. Weinstr.,10,,7,6,13
045 Margreid a.d. Weinstr.,11,,6,10,16
045 Margreid a.d. Weinstr.,12,,7,6,13
045 Margreid a.d. Weinstr.,13,,8,6,14
045 Margreid a.d. Weinstr.,14,,9,5,14
045 Margreid a.d. Weinstr.,15,,6,11,17
045 Margreid a.d. Weinstr.,16,,11,-,11
045 Margreid a.d. Weinstr.,17,,4,13,17
045 Margreid a.d. Weinstr.,18,,6,8,14
045 Margreid a.d. Weinstr.,19,,8,9,17
045 Margreid a.d. Weinstr.,20,,14,2,16
045 Margreid a.d. Weinstr.,21,,2,1,3
045 Margreid a.d. Weinstr.,22,,10,5,15
045 Margreid a.d. Weinstr.,23,,8,6,14
045 Margreid a.d. Weinstr.,24,,8,10,18
045 Margreid a.d. Weinstr.,25,,11,13,24
045 Margreid a.d. Weinstr.,26,,6,6,12
045 Margreid a.d. Weinstr.,27,,3,8,11
045 Margreid a.d. Weinstr.,28,,10,11,21
045 Margreid a.d. Weinstr.,29,,10,6,16
045 Margreid a.d. Weinstr.,30,,11,12,23
045 Margreid a.d. Weinstr.,31,,12,9,21
045 Margreid a.d. Weinstr.,32,,9,12,21
045 Margreid a.d. Weinstr.,33,,20,14,34
045 Margreid a.d. Weinstr.,34,,14,16,30
045 Margreid a.d. Weinstr.,35,,22,13,35
045 Margreid a.d. Weinstr.,36,,10,6,16
045 Margreid a.d. Weinstr.,37,,8,6,14
045 Margreid a.d. Weinstr.,38,,14,15,29
045 Margreid a.d. Weinstr.,39,,8,12,20
045 Margreid a.d. Weinstr.,40,,15,12,27
045 Margreid a.d. Weinstr.,41,,16,10,26
045 Margreid a.d. Weinstr.,42,,8,12,20
045 Margreid a.d. Weinstr.,43,,7,6,13
045 Margreid a.d. Weinstr.,44,,8,4,12
045 Margreid a.d. Weinstr.,45,,15,5,20
045 Margreid a.d. Weinstr.,46,,7,6,13
045 Margreid a.d. Weinstr.,47,,4,5,9
045 Margreid a.d. Weinstr.,48,,9,7,16
045 Margreid a.d. Weinstr.,49,,6,8,14
045 Margreid a.d. Weinstr.,50,,4,8,12
045 Margreid a.d. Weinstr.,51,,7,6,13
045 Margreid a.d. Weinstr.,52,,8,4,12
045 Margreid a.d. Weinstr.,53,,7,8,15
045 Margreid a.d. Weinstr.,54,,6,7,13
045 Margreid a.d. Weinstr.,55,,4,4,8
045 Margreid a.d. Weinstr.,56,,6,7,13
045 Margreid a.d. Weinstr.,57,,3,6,9
045 Margreid a.d. Weinstr.,58,,6,4,10
045 Margreid a.d. Weinstr.,59,,11,5,16
045 Margreid a.d. Weinstr.,60,,7,7,14
045 Margreid a.d. Weinstr.,61,,5,3,8
045 Margreid a.d. Weinstr.,62,,3,6,9
045 Margreid a.d. Weinstr.,63,,4,8,12
045 Margreid a.d. Weinstr.,64,,6,4,10
045 Margreid a.d. Weinstr.,65,,7,4,11
045 Margreid a.d. Weinstr.,66,,2,7,9
045 Margreid a.d. Weinstr.,67,,5,3,8
045 Margreid a.d. Weinstr.,68,,5,4,9
045 Margreid a.d. Weinstr.,69,,4,7,11
045 Margreid a.d. Weinstr.,70,,5,6,11
045 Margreid a.d. Weinstr.,71,,7,3,10
045 Margreid a.d. Weinstr.,72,,1,4,5
045 Margreid a.d. Weinstr.,73,,6,3,9
045 Margreid a.d. Weinstr.,74,,2,5,7
045 Margreid a.d. Weinstr.,75,,3,6,9
045 Margreid a.d. Weinstr.,76,,3,2,5
045 Margreid a.d. Weinstr.,77,,1,5,6
045 Margreid a.d. Weinstr.,78,,2,4,6
045 Margreid a.d. Weinstr.,79,,1,3,4
045 Margreid a.d. Weinstr.,80,,-,4,4
045 Margreid a.d. Weinstr.,81,,1,1,2
045 Margreid a.d. Weinstr.,82,,2,5,7
045 Margreid a.d. Weinstr.,83,,1,1,2
045 Margreid a.d. Weinstr.,84,,-,1,1
045 Margreid a.d. Weinstr.,85,,2,2,4
045 Margreid a.d. Weinstr.,86,,-,1,1
045 Margreid a.d. Weinstr.,87,,-,1,1
045 Margreid a.d. Weinstr.,88,,2,1,3
045 Margreid a.d. Weinstr.,89,,-,2,2
045 Margreid a.d. Weinstr.,90,,-,3,3
045 Margreid a.d. Weinstr.,91,,-,1,1
045 Margreid a.d. Weinstr.,94,,-,1,1
045 Margreid a.d. Weinstr.,95,,-,1,1
046 Mals,0,,24,29,53
046 Mals,1,,33,33,66
046 Mals,2,,36,28,64
046 Mals,3,,33,28,61
046 Mals,4,,37,31,68
046 Mals,5,,31,24,55
046 Mals,6,,31,41,72
046 Mals,7,,37,30,67
046 Mals,8,,34,32,66
046 Mals,9,,31,30,61
046 Mals,10,,35,32,67
046 Mals,11,,37,27,64
046 Mals,12,,41,34,75
046 Mals,13,,29,25,54
046 Mals,14,,31,29,60
046 Mals,15,,29,34,63
046 Mals,16,,36,35,71
046 Mals,17,,37,36,73
046 Mals,18,,30,31,61
046 Mals,19,,36,32,68
046 Mals,20,,36,38,74
046 Mals,21,,32,31,63
046 Mals,22,,30,29,59
046 Mals,23,,45,34,79
046 Mals,24,,35,24,59
046 Mals,25,,36,24,60
046 Mals,26,,41,36,77
046 Mals,27,,42,27,69
046 Mals,28,,31,35,66
046 Mals,29,,33,42,75
046 Mals,30,,37,51,88
046 Mals,31,,48,45,93
046 Mals,32,,50,42,92
046 Mals,33,,57,41,98
046 Mals,34,,45,25,70
046 Mals,35,,55,47,102
046 Mals,36,,48,37,85
046 Mals,37,,49,45,94
046 Mals,38,,51,51,102
046 Mals,39,,36,29,65
046 Mals,40,,49,38,87
046 Mals,41,,31,40,71
046 Mals,42,,31,35,66
046 Mals,43,,34,23,57
046 Mals,44,,39,33,72
046 Mals,45,,35,26,61
046 Mals,46,,31,25,56
046 Mals,47,,20,19,39
046 Mals,48,,33,31,64
046 Mals,49,,28,21,49
046 Mals,50,,32,22,54
046 Mals,51,,36,20,56
046 Mals,52,,19,28,47
046 Mals,53,,28,17,45
046 Mals,54,,22,20,42
046 Mals,55,,23,28,51
046 Mals,56,,11,20,31
046 Mals,57,,30,15,45
046 Mals,58,,24,18,42
046 Mals,59,,26,23,49
046 Mals,60,,20,18,38
046 Mals,61,,22,27,49
046 Mals,62,,25,25,50
046 Mals,63,,22,20,42
046 Mals,64,,13,29,42
046 Mals,65,,20,18,38
046 Mals,66,,16,18,34
046 Mals,67,,17,19,36
046 Mals,68,,18,22,40
046 Mals,69,,19,13,32
046 Mals,70,,12,18,30
046 Mals,71,,26,19,45
046 Mals,72,,24,18,42
046 Mals,73,,24,15,39
046 Mals,74,,16,16,32
046 Mals,75,,10,19,29
046 Mals,76,,15,21,36
046 Mals,77,,10,18,28
046 Mals,78,,6,16,22
046 Mals,79,,14,16,30
046 Mals,80,,10,15,25
046 Mals,81,,6,19,25
046 Mals,82,,5,21,26
046 Mals,83,,1,7,8
046 Mals,84,,4,2,6
046 Mals,85,,1,6,7
046 Mals,86,,3,6,9
046 Mals,87,,3,7,10
046 Mals,88,,9,16,25
046 Mals,89,,3,5,8
046 Mals,90,,2,4,6
046 Mals,91,,1,4,5
046 Mals,92,,2,1,3
046 Mals,93,,-,2,2
046 Mals,97,,-,1,1
047 Enneberg,0,,24,16,40
047 Enneberg,1,,16,20,36
047 Enneberg,2,,24,15,39
047 Enneberg,3,,19,11,30
047 Enneberg,4,,23,14,37
047 Enneberg,5,,18,13,31
047 Enneberg,6,,20,8,28
047 Enneberg,7,,20,15,35
047 Enneberg,8,,20,17,37
047 Enneberg,9,,14,15,29
047 Enneberg,10,,16,24,40
047 Enneberg,11,,14,17,31
047 Enneberg,12,,20,17,37
047 Enneberg,13,,22,16,38
047 Enneberg,14,,17,13,30
047 Enneberg,15,,18,10,28
047 Enneberg,16,,23,15,38
047 Enneberg,17,,19,19,38
047 Enneberg,18,,15,17,32
047 Enneberg,19,,24,19,43
047 Enneberg,20,,22,20,42
047 Enneberg,21,,24,19,43
047 Enneberg,22,,11,18,29
047 Enneberg,23,,13,24,37
047 Enneberg,24,,21,22,43
047 Enneberg,25,,13,18,31
047 Enneberg,26,,16,28,44
047 Enneberg,27,,26,31,57
047 Enneberg,28,,21,23,44
047 Enneberg,29,,22,28,50
047 Enneberg,30,,30,31,61
047 Enneberg,31,,26,22,48
047 Enneberg,32,,25,17,42
047 Enneberg,33,,22,18,40
047 Enneberg,34,,24,21,45
047 Enneberg,35,,22,20,42
047 Enneberg,36,,28,21,49
047 Enneberg,37,,23,22,45
047 Enneberg,38,,23,18,41
047 Enneberg,39,,14,17,31
047 Enneberg,40,,20,17,37
047 Enneberg,41,,15,17,32
047 Enneberg,42,,22,14,36
047 Enneberg,43,,21,8,29
047 Enneberg,44,,15,14,29
047 Enneberg,45,,15,17,32
047 Enneberg,46,,15,13,28
047 Enneberg,47,,14,11,25
047 Enneberg,48,,17,20,37
047 Enneberg,49,,14,18,32
047 Enneberg,50,,17,10,27
047 Enneberg,51,,10,16,26
047 Enneberg,52,,18,8,26
047 Enneberg,53,,15,13,28
047 Enneberg,54,,8,11,19
047 Enneberg,55,,14,17,31
047 Enneberg,56,,5,14,19
047 Enneberg,57,,20,16,36
047 Enneberg,58,,17,11,28
047 Enneberg,59,,12,20,32
047 Enneberg,60,,14,11,25
047 Enneberg,61,,13,8,21
047 Enneberg,62,,18,10,28
047 Enneberg,63,,14,19,33
047 Enneberg,64,,16,13,29
047 Enneberg,65,,12,12,24
047 Enneberg,66,,14,16,30
047 Enneberg,67,,8,10,18
047 Enneberg,68,,12,9,21
047 Enneberg,69,,8,17,25
047 Enneberg,70,,13,11,24
047 Enneberg,71,,14,16,30
047 Enneberg,72,,9,6,15
047 Enneberg,73,,10,13,23
047 Enneberg,74,,12,8,20
047 Enneberg,75,,7,9,16
047 Enneberg,76,,12,7,19
047 Enneberg,77,,4,10,14
047 Enneberg,78,,6,13,19
047 Enneberg,79,,7,7,14
047 Enneberg,80,,3,11,14
047 Enneberg,81,,6,5,11
047 Enneberg,82,,2,4,6
047 Enneberg,83,,5,3,8
047 Enneberg,84,,-,6,6
047 Enneberg,85,,1,7,8
047 Enneberg,86,,-,5,5
047 Enneberg,87,,2,5,7
047 Enneberg,88,,1,2,3
047 Enneberg,89,,-,5,5
047 Enneberg,90,,3,2,5
047 Enneberg,91,,2,1,3
047 Enneberg,92,,1,1,2
047 Enneberg,93,,-,2,2
047 Enneberg,94,,1,1,2
047 Enneberg,96,,-,1,1
047 Enneberg,97,,-,2,2
048 Marling,0,,9,14,23
048 Marling,1,,13,13,26
048 Marling,2,,15,7,22
048 Marling,3,,11,9,20
048 Marling,4,,11,10,21
048 Marling,5,,14,13,27
048 Marling,6,,19,10,29
048 Marling,7,,9,7,16
048 Marling,8,,16,9,25
048 Marling,9,,17,14,31
048 Marling,10,,12,10,22
048 Marling,11,,9,15,24
048 Marling,12,,9,16,25
048 Marling,13,,10,14,24
048 Marling,14,,5,9,14
048 Marling,15,,12,10,22
048 Marling,16,,9,14,23
048 Marling,17,,11,6,17
048 Marling,18,,10,10,20
048 Marling,19,,11,7,18
048 Marling,20,,14,10,24
048 Marling,21,,13,9,22
048 Marling,22,,14,16,30
048 Marling,23,,15,15,30
048 Marling,24,,12,19,31
048 Marling,25,,15,18,33
048 Marling,26,,13,10,23
048 Marling,27,,9,13,22
048 Marling,28,,15,18,33
048 Marling,29,,13,14,27
048 Marling,30,,24,14,38
048 Marling,31,,14,16,30
048 Marling,32,,20,21,41
048 Marling,33,,26,19,45
048 Marling,34,,19,15,34
048 Marling,35,,21,27,48
048 Marling,36,,22,20,42
048 Marling,37,,25,16,41
048 Marling,38,,29,29,58
048 Marling,39,,21,18,39
048 Marling,40,,22,13,35
048 Marling,41,,17,18,35
048 Marling,42,,17,15,32
048 Marling,43,,16,11,27
048 Marling,44,,12,10,22
048 Marling,45,,10,11,21
048 Marling,46,,9,6,15
048 Marling,47,,17,11,28
048 Marling,48,,12,16,28
048 Marling,49,,13,15,28
048 Marling,50,,6,12,18
048 Marling,51,,17,15,32
048 Marling,52,,19,18,37
048 Marling,53,,7,16,23
048 Marling,54,,17,12,29
048 Marling,55,,13,16,29
048 Marling,56,,20,15,35
048 Marling,57,,15,15,30
048 Marling,58,,11,18,29
048 Marling,59,,12,13,25
048 Marling,60,,22,18,40
048 Marling,61,,12,14,26
048 Marling,62,,15,17,32
048 Marling,63,,13,14,27
048 Marling,64,,11,16,27
048 Marling,65,,14,8,22
048 Marling,66,,8,15,23
048 Marling,67,,12,11,23
048 Marling,68,,8,13,21
048 Marling,69,,11,9,20
048 Marling,70,,13,9,22
048 Marling,71,,6,10,16
048 Marling,72,,7,8,15
048 Marling,73,,9,4,13
048 Marling,74,,10,9,19
048 Marling,75,,5,14,19
048 Marling,76,,4,14,18
048 Marling,77,,3,7,10
048 Marling,78,,6,8,14
048 Marling,79,,3,5,8
048 Marling,80,,5,8,13
048 Marling,81,,-,3,3
048 Marling,82,,4,4,8
048 Marling,83,,1,3,4
048 Marling,84,,2,2,4
048 Marling,85,,1,3,4
048 Marling,86,,3,4,7
048 Marling,87,,2,4,6
048 Marling,88,,2,3,5
048 Marling,89,,2,3,5
048 Marling,91,,-,1,1
048 Marling,92,,2,1,3
048 Marling,93,,3,1,4
048 Marling,94,,1,2,3
048 Marling,96,,-,1,1
048 Marling,97,,1,-,1
049 Martell,0,,5,7,12
049 Martell,1,,6,4,10
049 Martell,2,,2,7,9
049 Martell,3,,5,6,11
049 Martell,4,,5,8,13
049 Martell,5,,4,6,10
049 Martell,6,,7,7,14
049 Martell,7,,7,8,15
049 Martell,8,,8,6,14
049 Martell,9,,5,6,11
049 Martell,10,,8,5,13
049 Martell,11,,6,6,12
049 Martell,12,,9,4,13
049 Martell,13,,5,1,6
049 Martell,14,,8,3,11
049 Martell,15,,-,5,5
049 Martell,16,,6,7,13
049 Martell,17,,6,4,10
049 Martell,18,,9,3,12
049 Martell,19,,6,6,12
049 Martell,20,,8,5,13
049 Martell,21,,8,5,13
049 Martell,22,,8,8,16
049 Martell,23,,4,5,9
049 Martell,24,,5,3,8
049 Martell,25,,5,8,13
049 Martell,26,,3,6,9
049 Martell,27,,6,11,17
049 Martell,28,,8,6,14
049 Martell,29,,4,8,12
049 Martell,30,,11,4,15
049 Martell,31,,8,4,12
049 Martell,32,,6,13,19
049 Martell,33,,8,6,14
049 Martell,34,,4,8,12
049 Martell,35,,16,5,21
049 Martell,36,,17,9,26
049 Martell,37,,9,9,18
049 Martell,38,,13,2,15
049 Martell,39,,9,9,18
049 Martell,40,,7,5,12
049 Martell,41,,9,3,12
049 Martell,42,,7,6,13
049 Martell,43,,7,6,13
049 Martell,44,,7,3,10
049 Martell,45,,5,4,9
049 Martell,46,,7,2,9
049 Martell,47,,7,6,13
049 Martell,48,,5,4,9
049 Martell,49,,4,3,7
049 Martell,50,,7,8,15
049 Martell,51,,3,4,7
049 Martell,52,,4,2,6
049 Martell,53,,6,4,10
049 Martell,54,,5,3,8
049 Martell,55,,3,-,3
049 Martell,56,,5,1,6
049 Martell,57,,1,3,4
049 Martell,58,,2,3,5
049 Martell,59,,5,6,11
049 Martell,60,,4,4,8
049 Martell,61,,6,2,8
049 Martell,62,,2,4,6
049 Martell,63,,2,6,8
049 Martell,64,,3,4,7
049 Martell,65,,3,4,7
049 Martell,66,,4,9,13
049 Martell,67,,8,1,9
049 Martell,68,,5,6,11
049 Martell,69,,2,4,6
049 Martell,70,,5,1,6
049 Martell,71,,7,4,11
049 Martell,72,,4,3,7
049 Martell,73,,3,6,9
049 Martell,74,,3,3,6
049 Martell,75,,2,8,10
049 Martell,76,,2,3,5
049 Martell,77,,4,7,11
049 Martell,78,,1,7,8
049 Martell,79,,2,1,3
049 Martell,80,,1,1,2
049 Martell,81,,-,1,1
049 Martell,82,,1,1,2
049 Martell,83,,2,2,4
049 Martell,84,,1,-,1
049 Martell,85,,-,1,1
049 Martell,86,,2,2,4
049 Martell,87,,-,1,1
049 Martell,88,,1,-,1
049 Martell,89,,1,-,1
049 Martell,90,,3,2,5
049 Martell,91,,-,1,1
049 Martell,92,,-,1,1
049 Martell,94,,-,1,1
050 Mölten,0,,15,13,28
050 Mölten,1,,16,14,30
050 Mölten,2,,10,18,28
050 Mölten,3,,8,17,25
050 Mölten,4,,10,11,21
050 Mölten,5,,15,11,26
050 Mölten,6,,12,10,22
050 Mölten,7,,13,4,17
050 Mölten,8,,12,10,22
050 Mölten,9,,8,13,21
050 Mölten,10,,10,6,16
050 Mölten,11,,12,5,17
050 Mölten,12,,13,5,18
050 Mölten,13,,7,8,15
050 Mölten,14,,9,8,17
050 Mölten,15,,10,6,16
050 Mölten,16,,7,13,20
050 Mölten,17,,7,3,10
050 Mölten,18,,7,15,22
050 Mölten,19,,10,6,16
050 Mölten,20,,13,6,19
050 Mölten,21,,12,9,21
050 Mölten,22,,13,10,23
050 Mölten,23,,11,6,17
050 Mölten,24,,7,12,19
050 Mölten,25,,8,15,23
050 Mölten,26,,17,11,28
050 Mölten,27,,13,12,25
050 Mölten,28,,14,15,29
050 Mölten,29,,13,9,22
050 Mölten,30,,15,12,27
050 Mölten,31,,17,12,29
050 Mölten,32,,14,16,30
050 Mölten,33,,16,18,34
050 Mölten,34,,19,13,32
050 Mölten,35,,15,14,29
050 Mölten,36,,11,15,26
050 Mölten,37,,21,12,33
050 Mölten,38,,17,6,23
050 Mölten,39,,11,9,20
050 Mölten,40,,17,9,26
050 Mölten,41,,6,7,13
050 Mölten,42,,13,4,17
050 Mölten,43,,2,10,12
050 Mölten,44,,6,2,8
050 Mölten,45,,4,8,12
050 Mölten,46,,14,7,21
050 Mölten,47,,7,5,12
050 Mölten,48,,6,7,13
050 Mölten,49,,6,5,11
050 Mölten,50,,5,4,9
050 Mölten,51,,9,9,18
050 Mölten,52,,6,5,11
050 Mölten,53,,5,4,9
050 Mölten,54,,4,8,12
050 Mölten,55,,10,3,13
050 Mölten,56,,5,5,10
050 Mölten,57,,2,6,8
050 Mölten,58,,13,8,21
050 Mölten,59,,6,10,16
050 Mölten,60,,10,3,13
050 Mölten,61,,6,7,13
050 Mölten,62,,6,7,13
050 Mölten,63,,2,3,5
050 Mölten,64,,6,6,12
050 Mölten,65,,5,6,11
050 Mölten,66,,9,6,15
050 Mölten,67,,9,6,15
050 Mölten,68,,10,9,19
050 Mölten,69,,3,5,8
050 Mölten,70,,10,2,12
050 Mölten,71,,7,5,12
050 Mölten,72,,3,7,10
050 Mölten,73,,2,6,8
050 Mölten,74,,3,4,7
050 Mölten,75,,3,6,9
050 Mölten,76,,2,5,7
050 Mölten,77,,2,2,4
050 Mölten,78,,7,6,13
050 Mölten,79,,4,2,6
050 Mölten,80,,1,5,6
050 Mölten,81,,2,7,9
050 Mölten,82,,-,7,7
050 Mölten,83,,2,1,3
050 Mölten,84,,-,1,1
050 Mölten,85,,2,2,4
050 Mölten,86,,-,2,2
050 Mölten,87,,-,6,6
050 Mölten,88,,3,-,3
050 Mölten,89,,-,1,1
050 Mölten,90,,-,2,2
050 Mölten,91,,-,1,1
050 Mölten,92,,1,2,3
050 Mölten,93,,-,2,2
050 Mölten,95,,-,1,1
051 Meran,0,,149,153,302
051 Meran,1,,169,140,309
051 Meran,2,,158,169,327
051 Meran,3,,139,136,275
051 Meran,4,,175,153,328
051 Meran,5,,176,141,317
051 Meran,6,,153,141,294
051 Meran,7,,157,163,320
051 Meran,8,,121,135,256
051 Meran,9,,167,131,298
051 Meran,10,,150,167,317
051 Meran,11,,148,151,299
051 Meran,12,,164,149,313
051 Meran,13,,157,120,277
051 Meran,14,,157,138,295
051 Meran,15,,150,108,258
051 Meran,16,,128,172,300
051 Meran,17,,152,139,291
051 Meran,18,,134,146,280
051 Meran,19,,147,149,296
051 Meran,20,,159,153,312
051 Meran,21,,154,144,298
051 Meran,22,,146,162,308
051 Meran,23,,175,166,341
051 Meran,24,,162,199,361
051 Meran,25,,190,204,394
051 Meran,26,,220,229,449
051 Meran,27,,258,257,515
051 Meran,28,,238,253,491
051 Meran,29,,255,246,501
051 Meran,30,,275,266,541
051 Meran,31,,278,284,562
051 Meran,32,,304,279,583
051 Meran,33,,316,312,628
051 Meran,34,,318,314,632
051 Meran,35,,314,269,583
051 Meran,36,,325,294,619
051 Meran,37,,330,293,623
051 Meran,38,,344,261,605
051 Meran,39,,253,271,524
051 Meran,40,,297,292,589
051 Meran,41,,290,257,547
051 Meran,42,,265,240,505
051 Meran,43,,260,225,485
051 Meran,44,,240,238,478
051 Meran,45,,225,215,440
051 Meran,46,,193,217,410
051 Meran,47,,182,223,405
051 Meran,48,,186,214,400
051 Meran,49,,209,220,429
051 Meran,50,,208,203,411
051 Meran,51,,202,220,422
051 Meran,52,,224,249,473
051 Meran,53,,225,256,481
051 Meran,54,,227,279,506
051 Meran,55,,244,301,545
051 Meran,56,,216,216,432
051 Meran,57,,213,243,456
051 Meran,58,,261,243,504
051 Meran,59,,268,302,570
051 Meran,60,,238,287,525
051 Meran,61,,206,222,428
051 Meran,62,,207,254,461
051 Meran,63,,193,234,427
051 Meran,64,,199,232,431
051 Meran,65,,176,208,384
051 Meran,66,,174,207,381
051 Meran,67,,172,190,362
051 Meran,68,,157,178,335
051 Meran,69,,141,205,346
051 Meran,70,,130,185,315
051 Meran,71,,145,192,337
051 Meran,72,,121,151,272
051 Meran,73,,132,199,331
051 Meran,74,,114,168,282
051 Meran,75,,115,184,299
051 Meran,76,,85,172,257
051 Meran,77,,98,174,272
051 Meran,78,,83,171,254
051 Meran,79,,86,192,278
051 Meran,80,,58,186,244
051 Meran,81,,78,169,247
051 Meran,82,,52,122,174
051 Meran,83,,45,85,130
051 Meran,84,,34,81,115
051 Meran,85,,28,68,96
051 Meran,86,,39,92,131
051 Meran,87,,41,100,141
051 Meran,88,,38,89,127
051 Meran,89,,33,81,114
051 Meran,90,,22,67,89
051 Meran,91,,18,56,74
051 Meran,92,,15,53,68
051 Meran,93,,14,27,41
051 Meran,94,,4,20,24
051 Meran,95,,4,25,29
051 Meran,96,,2,12,14
051 Meran,97,,2,11,13
051 Meran,98,,-,5,5
051 Meran,99,,1,3,4
051 Meran,100,,1,2,3
051 Meran,103,,-,1,1
052 Welsberg-Taisten,0,,28,16,44
052 Welsberg-Taisten,1,,16,18,34
052 Welsberg-Taisten,2,,21,17,38
052 Welsberg-Taisten,3,,18,13,31
052 Welsberg-Taisten,4,,23,19,42
052 Welsberg-Taisten,5,,17,16,33
052 Welsberg-Taisten,6,,18,13,31
052 Welsberg-Taisten,7,,12,15,27
052 Welsberg-Taisten,8,,14,19,33
052 Welsberg-Taisten,9,,11,9,20
052 Welsberg-Taisten,10,,20,17,37
052 Welsberg-Taisten,11,,12,17,29
052 Welsberg-Taisten,12,,6,18,24
052 Welsberg-Taisten,13,,14,16,30
052 Welsberg-Taisten,14,,15,14,29
052 Welsberg-Taisten,15,,10,14,24
052 Welsberg-Taisten,16,,9,13,22
052 Welsberg-Taisten,17,,25,15,40
052 Welsberg-Taisten,18,,19,16,35
052 Welsberg-Taisten,19,,20,13,33
052 Welsberg-Taisten,20,,9,9,18
052 Welsberg-Taisten,21,,14,19,33
052 Welsberg-Taisten,22,,24,16,40
052 Welsberg-Taisten,23,,21,17,38
052 Welsberg-Taisten,24,,14,19,33
052 Welsberg-Taisten,25,,17,15,32
052 Welsberg-Taisten,26,,12,22,34
052 Welsberg-Taisten,27,,25,21,46
052 Welsberg-Taisten,28,,27,9,36
052 Welsberg-Taisten,29,,17,24,41
052 Welsberg-Taisten,30,,31,23,54
052 Welsberg-Taisten,31,,26,21,47
052 Welsberg-Taisten,32,,20,20,40
052 Welsberg-Taisten,33,,23,15,38
052 Welsberg-Taisten,34,,31,21,52
052 Welsberg-Taisten,35,,26,24,50
052 Welsberg-Taisten,36,,25,19,44
052 Welsberg-Taisten,37,,32,21,53
052 Welsberg-Taisten,38,,25,23,48
052 Welsberg-Taisten,39,,21,24,45
052 Welsberg-Taisten,40,,20,16,36
052 Welsberg-Taisten,41,,13,14,27
052 Welsberg-Taisten,42,,22,20,42
052 Welsberg-Taisten,43,,26,18,44
052 Welsberg-Taisten,44,,11,19,30
052 Welsberg-Taisten,45,,20,19,39
052 Welsberg-Taisten,46,,17,12,29
052 Welsberg-Taisten,47,,15,14,29
052 Welsberg-Taisten,48,,20,12,32
052 Welsberg-Taisten,49,,19,10,29
052 Welsberg-Taisten,50,,18,9,27
052 Welsberg-Taisten,51,,16,15,31
052 Welsberg-Taisten,52,,15,13,28
052 Welsberg-Taisten,53,,16,16,32
052 Welsberg-Taisten,54,,10,10,20
052 Welsberg-Taisten,55,,12,13,25
052 Welsberg-Taisten,56,,10,14,24
052 Welsberg-Taisten,57,,13,11,24
052 Welsberg-Taisten,58,,12,14,26
052 Welsberg-Taisten,59,,10,12,22
052 Welsberg-Taisten,60,,19,19,38
052 Welsberg-Taisten,61,,7,13,20
052 Welsberg-Taisten,62,,14,13,27
052 Welsberg-Taisten,63,,14,11,25
052 Welsberg-Taisten,64,,10,8,18
052 Welsberg-Taisten,65,,10,11,21
052 Welsberg-Taisten,66,,4,16,20
052 Welsberg-Taisten,67,,17,16,33
052 Welsberg-Taisten,68,,11,11,22
052 Welsberg-Taisten,69,,11,13,24
052 Welsberg-Taisten,70,,8,12,20
052 Welsberg-Taisten,71,,10,8,18
052 Welsberg-Taisten,72,,9,12,21
052 Welsberg-Taisten,73,,6,21,27
052 Welsberg-Taisten,74,,10,12,22
052 Welsberg-Taisten,75,,8,7,15
052 Welsberg-Taisten,76,,1,8,9
052 Welsberg-Taisten,77,,7,10,17
052 Welsberg-Taisten,78,,5,11,16
052 Welsberg-Taisten,79,,5,8,13
052 Welsberg-Taisten,80,,5,10,15
052 Welsberg-Taisten,81,,3,8,11
052 Welsberg-Taisten,82,,-,8,8
052 Welsberg-Taisten,83,,2,1,3
052 Welsberg-Taisten,84,,3,4,7
052 Welsberg-Taisten,85,,2,1,3
052 Welsberg-Taisten,86,,4,4,8
052 Welsberg-Taisten,87,,2,2,4
052 Welsberg-Taisten,88,,-,4,4
052 Welsberg-Taisten,89,,1,5,6
052 Welsberg-Taisten,90,,-,4,4
052 Welsberg-Taisten,91,,1,4,5
052 Welsberg-Taisten,92,,-,4,4
052 Welsberg-Taisten,93,,-,2,2
052 Welsberg-Taisten,94,,1,2,3
052 Welsberg-Taisten,97,,-,1,1
052 Welsberg-Taisten,101,,1,-,1
052 Welsberg-Taisten,113,,-,1,1
053 Montan,0,,9,5,14
053 Montan,1,,10,6,16
053 Montan,2,,6,11,17
053 Montan,3,,8,8,16
053 Montan,4,,7,7,14
053 Montan,5,,11,10,21
053 Montan,6,,14,15,29
053 Montan,7,,12,5,17
053 Montan,8,,5,8,13
053 Montan,9,,7,10,17
053 Montan,10,,13,10,23
053 Montan,11,,12,8,20
053 Montan,12,,10,11,21
053 Montan,13,,12,14,26
053 Montan,14,,9,17,26
053 Montan,15,,14,5,19
053 Montan,16,,10,8,18
053 Montan,17,,7,3,10
053 Montan,18,,10,5,15
053 Montan,19,,9,7,16
053 Montan,20,,10,8,18
053 Montan,21,,3,4,7
053 Montan,22,,9,9,18
053 Montan,23,,9,6,15
053 Montan,24,,7,4,11
053 Montan,25,,5,3,8
053 Montan,26,,11,10,21
053 Montan,27,,7,9,16
053 Montan,28,,12,5,17
053 Montan,29,,10,4,14
053 Montan,30,,13,10,23
053 Montan,31,,15,12,27
053 Montan,32,,10,15,25
053 Montan,33,,13,17,30
053 Montan,34,,11,11,22
053 Montan,35,,12,16,28
053 Montan,36,,26,13,39
053 Montan,37,,19,11,30
053 Montan,38,,13,17,30
053 Montan,39,,13,15,28
053 Montan,40,,18,11,29
053 Montan,41,,14,12,26
053 Montan,42,,12,11,23
053 Montan,43,,14,9,23
053 Montan,44,,15,11,26
053 Montan,45,,7,14,21
053 Montan,46,,7,10,17
053 Montan,47,,13,11,24
053 Montan,48,,11,7,18
053 Montan,49,,12,3,15
053 Montan,50,,7,6,13
053 Montan,51,,4,4,8
053 Montan,52,,9,3,12
053 Montan,53,,5,6,11
053 Montan,54,,6,9,15
053 Montan,55,,5,2,7
053 Montan,56,,3,3,6
053 Montan,57,,2,5,7
053 Montan,58,,5,7,12
053 Montan,59,,7,6,13
053 Montan,60,,7,5,12
053 Montan,61,,9,7,16
053 Montan,62,,6,9,15
053 Montan,63,,9,9,18
053 Montan,64,,2,7,9
053 Montan,65,,7,11,18
053 Montan,66,,1,9,10
053 Montan,67,,3,6,9
053 Montan,68,,16,5,21
053 Montan,69,,5,8,13
053 Montan,70,,9,11,20
053 Montan,71,,12,13,25
053 Montan,72,,7,9,16
053 Montan,73,,7,3,10
053 Montan,74,,6,5,11
053 Montan,75,,7,9,16
053 Montan,76,,4,8,12
053 Montan,77,,2,8,10
053 Montan,78,,5,11,16
053 Montan,79,,5,8,13
053 Montan,80,,4,4,8
053 Montan,81,,2,8,10
053 Montan,82,,2,4,6
053 Montan,83,,1,4,5
053 Montan,84,,2,5,7
053 Montan,85,,-,2,2
053 Montan,86,,-,7,7
053 Montan,87,,2,2,4
053 Montan,88,,1,5,6
053 Montan,89,,1,1,2
053 Montan,90,,1,2,3
053 Montan,91,,1,-,1
053 Montan,92,,-,1,1
053 Montan,93,,-,2,2
053 Montan,94,,1,-,1
053 Montan,100,,-,1,1
054 Moos in Passeier,0,,14,13,27
054 Moos in Passeier,1,,13,18,31
054 Moos in Passeier,2,,24,10,34
054 Moos in Passeier,3,,13,17,30
054 Moos in Passeier,4,,12,15,27
054 Moos in Passeier,5,,18,20,38
054 Moos in Passeier,6,,9,12,21
054 Moos in Passeier,7,,17,21,38
054 Moos in Passeier,8,,19,12,31
054 Moos in Passeier,9,,18,18,36
054 Moos in Passeier,10,,18,21,39
054 Moos in Passeier,11,,15,13,28
054 Moos in Passeier,12,,17,19,36
054 Moos in Passeier,13,,16,16,32
054 Moos in Passeier,14,,16,14,30
054 Moos in Passeier,15,,17,15,32
054 Moos in Passeier,16,,19,12,31
054 Moos in Passeier,17,,23,21,44
054 Moos in Passeier,18,,15,14,29
054 Moos in Passeier,19,,17,24,41
054 Moos in Passeier,20,,19,20,39
054 Moos in Passeier,21,,20,18,38
054 Moos in Passeier,22,,20,15,35
054 Moos in Passeier,23,,26,16,42
054 Moos in Passeier,24,,21,18,39
054 Moos in Passeier,25,,15,12,27
054 Moos in Passeier,26,,24,20,44
054 Moos in Passeier,27,,23,12,35
054 Moos in Passeier,28,,11,25,36
054 Moos in Passeier,29,,21,16,37
054 Moos in Passeier,30,,22,17,39
054 Moos in Passeier,31,,23,11,34
054 Moos in Passeier,32,,17,18,35
054 Moos in Passeier,33,,18,21,39
054 Moos in Passeier,34,,21,19,40
054 Moos in Passeier,35,,26,21,47
054 Moos in Passeier,36,,22,10,32
054 Moos in Passeier,37,,26,10,36
054 Moos in Passeier,38,,17,17,34
054 Moos in Passeier,39,,11,20,31
054 Moos in Passeier,40,,10,8,18
054 Moos in Passeier,41,,18,16,34
054 Moos in Passeier,42,,17,14,31
054 Moos in Passeier,43,,14,15,29
054 Moos in Passeier,44,,21,7,28
054 Moos in Passeier,45,,9,8,17
054 Moos in Passeier,46,,8,9,17
054 Moos in Passeier,47,,17,9,26
054 Moos in Passeier,48,,6,9,15
054 Moos in Passeier,49,,8,5,13
054 Moos in Passeier,50,,11,10,21
054 Moos in Passeier,51,,8,10,18
054 Moos in Passeier,52,,17,9,26
054 Moos in Passeier,53,,6,6,12
054 Moos in Passeier,54,,19,10,29
054 Moos in Passeier,55,,9,8,17
054 Moos in Passeier,56,,9,7,16
054 Moos in Passeier,57,,9,9,18
054 Moos in Passeier,58,,15,12,27
054 Moos in Passeier,59,,5,12,17
054 Moos in Passeier,60,,10,15,25
054 Moos in Passeier,61,,9,10,19
054 Moos in Passeier,62,,5,7,12
054 Moos in Passeier,63,,11,8,19
054 Moos in Passeier,64,,5,6,11
054 Moos in Passeier,65,,8,7,15
054 Moos in Passeier,66,,9,7,16
054 Moos in Passeier,67,,10,14,24
054 Moos in Passeier,68,,8,10,18
054 Moos in Passeier,69,,8,4,12
054 Moos in Passeier,70,,10,7,17
054 Moos in Passeier,71,,11,7,18
054 Moos in Passeier,72,,8,13,21
054 Moos in Passeier,73,,4,10,14
054 Moos in Passeier,74,,7,5,12
054 Moos in Passeier,75,,8,3,11
054 Moos in Passeier,76,,9,7,16
054 Moos in Passeier,77,,3,6,9
054 Moos in Passeier,78,,4,3,7
054 Moos in Passeier,79,,2,6,8
054 Moos in Passeier,80,,2,2,4
054 Moos in Passeier,81,,2,3,5
054 Moos in Passeier,82,,1,4,5
054 Moos in Passeier,83,,1,-,1
054 Moos in Passeier,84,,2,2,4
054 Moos in Passeier,85,,1,3,4
054 Moos in Passeier,86,,2,1,3
054 Moos in Passeier,87,,1,5,6
054 Moos in Passeier,88,,1,2,3
054 Moos in Passeier,89,,1,2,3
054 Moos in Passeier,91,,-,1,1
054 Moos in Passeier,92,,-,1,1
054 Moos in Passeier,93,,1,-,1
055 Nals,0,,9,12,21
055 Nals,1,,7,15,22
055 Nals,2,,17,8,25
055 Nals,3,,12,7,19
055 Nals,4,,14,6,20
055 Nals,5,,11,9,20
055 Nals,6,,9,6,15
055 Nals,7,,9,8,17
055 Nals,8,,7,12,19
055 Nals,9,,13,10,23
055 Nals,10,,8,11,19
055 Nals,11,,9,7,16
055 Nals,12,,11,8,19
055 Nals,13,,9,12,21
055 Nals,14,,11,11,22
055 Nals,15,,5,2,7
055 Nals,16,,13,5,18
055 Nals,17,,7,11,18
055 Nals,18,,5,8,13
055 Nals,19,,8,14,22
055 Nals,20,,11,12,23
055 Nals,21,,14,9,23
055 Nals,22,,8,5,13
055 Nals,23,,10,7,17
055 Nals,24,,5,7,12
055 Nals,25,,10,14,24
055 Nals,26,,6,11,17
055 Nals,27,,17,9,26
055 Nals,28,,12,8,20
055 Nals,29,,10,15,25
055 Nals,30,,13,14,27
055 Nals,31,,19,11,30
055 Nals,32,,11,14,25
055 Nals,33,,18,17,35
055 Nals,34,,17,14,31
055 Nals,35,,13,8,21
055 Nals,36,,18,14,32
055 Nals,37,,19,16,35
055 Nals,38,,11,22,33
055 Nals,39,,15,14,29
055 Nals,40,,17,14,31
055 Nals,41,,11,9,20
055 Nals,42,,14,14,28
055 Nals,43,,16,17,33
055 Nals,44,,9,9,18
055 Nals,45,,7,8,15
055 Nals,46,,18,16,34
055 Nals,47,,6,8,14
055 Nals,48,,6,8,14
055 Nals,49,,7,6,13
055 Nals,50,,4,10,14
055 Nals,51,,7,11,18
055 Nals,52,,11,9,20
055 Nals,53,,11,13,24
055 Nals,54,,12,6,18
055 Nals,55,,7,13,20
055 Nals,56,,7,11,18
055 Nals,57,,6,12,18
055 Nals,58,,11,6,17
055 Nals,59,,5,8,13
055 Nals,60,,12,6,18
055 Nals,61,,7,11,18
055 Nals,62,,10,9,19
055 Nals,63,,7,9,16
055 Nals,64,,3,13,16
055 Nals,65,,5,3,8
055 Nals,66,,7,6,13
055 Nals,67,,6,6,12
055 Nals,68,,9,10,19
055 Nals,69,,6,4,10
055 Nals,70,,3,7,10
055 Nals,71,,4,5,9
055 Nals,72,,9,8,17
055 Nals,73,,7,8,15
055 Nals,74,,6,6,12
055 Nals,75,,8,6,14
055 Nals,76,,6,5,11
055 Nals,77,,3,2,5
055 Nals,78,,1,6,7
055 Nals,79,,2,7,9
055 Nals,80,,2,8,10
055 Nals,81,,1,1,2
055 Nals,82,,1,5,6
055 Nals,84,,1,-,1
055 Nals,85,,-,1,1
055 Nals,86,,3,3,6
055 Nals,87,,-,4,4
055 Nals,88,,1,1,2
055 Nals,89,,2,1,3
055 Nals,90,,-,2,2
055 Nals,91,,1,1,2
055 Nals,92,,-,1,1
056 Naturns,0,,31,30,61
056 Naturns,1,,28,26,54
056 Naturns,2,,29,28,57
056 Naturns,3,,31,33,64
056 Naturns,4,,21,18,39
056 Naturns,5,,32,34,66
056 Naturns,6,,48,33,81
056 Naturns,7,,36,38,74
056 Naturns,8,,33,39,72
056 Naturns,9,,32,41,73
056 Naturns,10,,43,39,82
056 Naturns,11,,35,32,67
056 Naturns,12,,37,24,61
056 Naturns,13,,44,35,79
056 Naturns,14,,34,19,53
056 Naturns,15,,29,26,55
056 Naturns,16,,37,24,61
056 Naturns,17,,38,19,57
056 Naturns,18,,31,35,66
056 Naturns,19,,37,28,65
056 Naturns,20,,36,46,82
056 Naturns,21,,31,29,60
056 Naturns,22,,40,36,76
056 Naturns,23,,35,40,75
056 Naturns,24,,33,39,72
056 Naturns,25,,33,36,69
056 Naturns,26,,35,37,72
056 Naturns,27,,40,38,78
056 Naturns,28,,45,43,88
056 Naturns,29,,41,41,82
056 Naturns,30,,41,41,82
056 Naturns,31,,48,42,90
056 Naturns,32,,37,48,85
056 Naturns,33,,47,42,89
056 Naturns,34,,48,42,90
056 Naturns,35,,52,43,95
056 Naturns,36,,38,50,88
056 Naturns,37,,46,36,82
056 Naturns,38,,42,48,90
056 Naturns,39,,43,46,89
056 Naturns,40,,37,49,86
056 Naturns,41,,54,38,92
056 Naturns,42,,44,41,85
056 Naturns,43,,29,35,64
056 Naturns,44,,35,33,68
056 Naturns,45,,42,35,77
056 Naturns,46,,31,33,64
056 Naturns,47,,40,32,72
056 Naturns,48,,33,27,60
056 Naturns,49,,36,36,72
056 Naturns,50,,36,37,73
056 Naturns,51,,28,33,61
056 Naturns,52,,27,20,47
056 Naturns,53,,31,25,56
056 Naturns,54,,14,20,34
056 Naturns,55,,26,31,57
056 Naturns,56,,25,18,43
056 Naturns,57,,22,20,42
056 Naturns,58,,27,35,62
056 Naturns,59,,32,34,66
056 Naturns,60,,41,30,71
056 Naturns,61,,21,20,41
056 Naturns,62,,20,21,41
056 Naturns,63,,23,18,41
056 Naturns,64,,23,23,46
056 Naturns,65,,21,20,41
056 Naturns,66,,22,11,33
056 Naturns,67,,18,20,38
056 Naturns,68,,17,14,31
056 Naturns,69,,12,20,32
056 Naturns,70,,13,22,35
056 Naturns,71,,19,25,44
056 Naturns,72,,16,18,34
056 Naturns,73,,17,16,33
056 Naturns,74,,13,19,32
056 Naturns,75,,13,17,30
056 Naturns,76,,15,17,32
056 Naturns,77,,17,16,33
056 Naturns,78,,12,13,25
056 Naturns,79,,5,12,17
056 Naturns,80,,8,18,26
056 Naturns,81,,4,8,12
056 Naturns,82,,4,11,15
056 Naturns,83,,2,3,5
056 Naturns,84,,3,2,5
056 Naturns,85,,3,4,7
056 Naturns,86,,1,6,7
056 Naturns,87,,3,9,12
056 Naturns,88,,5,13,18
056 Naturns,89,,2,6,8
056 Naturns,90,,4,3,7
056 Naturns,91,,4,1,5
056 Naturns,92,,-,6,6
056 Naturns,93,,-,2,2
056 Naturns,94,,1,2,3
056 Naturns,96,,1,2,3
056 Naturns,97,,-,1,1
056 Naturns,100,,-,1,1
057 Natz-Schabs,0,,12,18,30
057 Natz-Schabs,1,,18,15,33
057 Natz-Schabs,2,,15,19,34
057 Natz-Schabs,3,,18,15,33
057 Natz-Schabs,4,,18,17,35
057 Natz-Schabs,5,,23,18,41
057 Natz-Schabs,6,,16,14,30
057 Natz-Schabs,7,,22,16,38
057 Natz-Schabs,8,,16,17,33
057 Natz-Schabs,9,,16,13,29
057 Natz-Schabs,10,,22,21,43
057 Natz-Schabs,11,,13,26,39
057 Natz-Schabs,12,,16,24,40
057 Natz-Schabs,13,,24,16,40
057 Natz-Schabs,14,,20,21,41
057 Natz-Schabs,15,,18,19,37
057 Natz-Schabs,16,,20,24,44
057 Natz-Schabs,17,,18,15,33
057 Natz-Schabs,18,,21,19,40
057 Natz-Schabs,19,,10,21,31
057 Natz-Schabs,20,,18,21,39
057 Natz-Schabs,21,,23,13,36
057 Natz-Schabs,22,,13,15,28
057 Natz-Schabs,23,,13,14,27
057 Natz-Schabs,24,,15,10,25
057 Natz-Schabs,25,,10,17,27
057 Natz-Schabs,26,,15,19,34
057 Natz-Schabs,27,,12,19,31
057 Natz-Schabs,28,,21,19,40
057 Natz-Schabs,29,,20,22,42
057 Natz-Schabs,30,,23,21,44
057 Natz-Schabs,31,,27,24,51
057 Natz-Schabs,32,,30,20,50
057 Natz-Schabs,33,,29,16,45
057 Natz-Schabs,34,,27,27,54
057 Natz-Schabs,35,,26,16,42
057 Natz-Schabs,36,,32,27,59
057 Natz-Schabs,37,,28,24,52
057 Natz-Schabs,38,,25,24,49
057 Natz-Schabs,39,,15,24,39
057 Natz-Schabs,40,,17,19,36
057 Natz-Schabs,41,,28,22,50
057 Natz-Schabs,42,,21,19,40
057 Natz-Schabs,43,,22,18,40
057 Natz-Schabs,44,,20,19,39
057 Natz-Schabs,45,,18,20,38
057 Natz-Schabs,46,,20,18,38
057 Natz-Schabs,47,,12,14,26
057 Natz-Schabs,48,,20,15,35
057 Natz-Schabs,49,,14,10,24
057 Natz-Schabs,50,,14,9,23
057 Natz-Schabs,51,,17,15,32
057 Natz-Schabs,52,,20,14,34
057 Natz-Schabs,53,,12,13,25
057 Natz-Schabs,54,,11,12,23
057 Natz-Schabs,55,,14,10,24
057 Natz-Schabs,56,,10,6,16
057 Natz-Schabs,57,,13,12,25
057 Natz-Schabs,58,,10,8,18
057 Natz-Schabs,59,,13,7,20
057 Natz-Schabs,60,,14,9,23
057 Natz-Schabs,61,,3,8,11
057 Natz-Schabs,62,,2,6,8
057 Natz-Schabs,63,,6,6,12
057 Natz-Schabs,64,,12,7,19
057 Natz-Schabs,65,,9,4,13
057 Natz-Schabs,66,,9,7,16
057 Natz-Schabs,67,,5,3,8
057 Natz-Schabs,68,,7,11,18
057 Natz-Schabs,69,,6,7,13
057 Natz-Schabs,70,,7,4,11
057 Natz-Schabs,71,,5,7,12
057 Natz-Schabs,72,,10,2,12
057 Natz-Schabs,73,,4,7,11
057 Natz-Schabs,74,,2,4,6
057 Natz-Schabs,75,,4,7,11
057 Natz-Schabs,76,,3,6,9
057 Natz-Schabs,77,,2,7,9
057 Natz-Schabs,78,,2,10,12
057 Natz-Schabs,79,,5,4,9
057 Natz-Schabs,80,,5,3,8
057 Natz-Schabs,81,,2,7,9
057 Natz-Schabs,82,,-,2,2
057 Natz-Schabs,83,,1,4,5
057 Natz-Schabs,84,,1,2,3
057 Natz-Schabs,85,,1,-,1
057 Natz-Schabs,86,,1,2,3
057 Natz-Schabs,88,,2,-,2
057 Natz-Schabs,89,,-,3,3
057 Natz-Schabs,90,,-,2,2
057 Natz-Schabs,92,,1,-,1
057 Natz-Schabs,93,,-,1,1
058 Welschnofen,0,,5,12,17
058 Welschnofen,1,,8,8,16
058 Welschnofen,2,,9,13,22
058 Welschnofen,3,,14,7,21
058 Welschnofen,4,,12,11,23
058 Welschnofen,5,,9,11,20
058 Welschnofen,6,,14,13,27
058 Welschnofen,7,,10,12,22
058 Welschnofen,8,,12,10,22
058 Welschnofen,9,,14,10,24
058 Welschnofen,10,,14,11,25
058 Welschnofen,11,,11,14,25
058 Welschnofen,12,,14,8,22
058 Welschnofen,13,,12,14,26
058 Welschnofen,14,,10,9,19
058 Welschnofen,15,,7,11,18
058 Welschnofen,16,,10,7,17
058 Welschnofen,17,,7,8,15
058 Welschnofen,18,,10,13,23
058 Welschnofen,19,,10,17,27
058 Welschnofen,20,,13,10,23
058 Welschnofen,21,,13,7,20
058 Welschnofen,22,,11,3,14
058 Welschnofen,23,,12,14,26
058 Welschnofen,24,,12,20,32
058 Welschnofen,25,,20,12,32
058 Welschnofen,26,,19,11,30
058 Welschnofen,27,,12,15,27
058 Welschnofen,28,,14,15,29
058 Welschnofen,29,,12,12,24
058 Welschnofen,30,,13,15,28
058 Welschnofen,31,,19,13,32
058 Welschnofen,32,,13,16,29
058 Welschnofen,33,,19,17,36
058 Welschnofen,34,,18,14,32
058 Welschnofen,35,,16,13,29
058 Welschnofen,36,,21,14,35
058 Welschnofen,37,,13,7,20
058 Welschnofen,38,,18,18,36
058 Welschnofen,39,,12,15,27
058 Welschnofen,40,,16,18,34
058 Welschnofen,41,,21,8,29
058 Welschnofen,42,,13,12,25
058 Welschnofen,43,,16,10,26
058 Welschnofen,44,,10,13,23
058 Welschnofen,45,,11,13,24
058 Welschnofen,46,,16,14,30
058 Welschnofen,47,,14,11,25
058 Welschnofen,48,,10,14,24
058 Welschnofen,49,,11,8,19
058 Welschnofen,50,,17,7,24
058 Welschnofen,51,,9,9,18
058 Welschnofen,52,,13,13,26
058 Welschnofen,53,,9,11,20
058 Welschnofen,54,,9,8,17
058 Welschnofen,55,,10,10,20
058 Welschnofen,56,,10,6,16
058 Welschnofen,57,,7,11,18
058 Welschnofen,58,,14,9,23
058 Welschnofen,59,,12,13,25
058 Welschnofen,60,,11,7,18
058 Welschnofen,61,,8,7,15
058 Welschnofen,62,,11,7,18
058 Welschnofen,63,,7,8,15
058 Welschnofen,64,,9,4,13
058 Welschnofen,65,,5,14,19
058 Welschnofen,66,,8,6,14
058 Welschnofen,67,,13,10,23
058 Welschnofen,68,,10,14,24
058 Welschnofen,69,,7,7,14
058 Welschnofen,70,,5,9,14
058 Welschnofen,71,,7,8,15
058 Welschnofen,72,,8,12,20
058 Welschnofen,73,,7,6,13
058 Welschnofen,74,,4,3,7
058 Welschnofen,75,,5,8,13
058 Welschnofen,76,,6,6,12
058 Welschnofen,77,,5,14,19
058 Welschnofen,78,,7,8,15
058 Welschnofen,79,,6,7,13
058 Welschnofen,80,,2,11,13
058 Welschnofen,81,,3,5,8
058 Welschnofen,82,,1,6,7
058 Welschnofen,83,,2,1,3
058 Welschnofen,84,,1,1,2
058 Welschnofen,85,,3,4,7
058 Welschnofen,86,,-,4,4
058 Welschnofen,87,,-,2,2
058 Welschnofen,88,,-,4,4
058 Welschnofen,89,,2,5,7
058 Welschnofen,90,,1,1,2
058 Welschnofen,91,,2,2,4
058 Welschnofen,92,,1,3,4
058 Welschnofen,93,,2,-,2
058 Welschnofen,94,,-,2,2
058 Welschnofen,95,,-,2,2
058 Welschnofen,99,,1,-,1
058 Welschnofen,101,,-,1,1
059 Deutschnofen,0,,22,29,51
059 Deutschnofen,1,,16,28,44
059 Deutschnofen,2,,27,23,50
059 Deutschnofen,3,,33,14,47
059 Deutschnofen,4,,20,28,48
059 Deutschnofen,5,,17,26,43
059 Deutschnofen,6,,25,24,49
059 Deutschnofen,7,,28,14,42
059 Deutschnofen,8,,22,27,49
059 Deutschnofen,9,,33,28,61
059 Deutschnofen,10,,20,21,41
059 Deutschnofen,11,,35,28,63
059 Deutschnofen,12,,24,21,45
059 Deutschnofen,13,,24,33,57
059 Deutschnofen,14,,21,24,45
059 Deutschnofen,15,,29,18,47
059 Deutschnofen,16,,25,19,44
059 Deutschnofen,17,,33,27,60
059 Deutschnofen,18,,22,23,45
059 Deutschnofen,19,,21,35,56
059 Deutschnofen,20,,19,19,38
059 Deutschnofen,21,,28,20,48
059 Deutschnofen,22,,22,24,46
059 Deutschnofen,23,,24,19,43
059 Deutschnofen,24,,29,25,54
059 Deutschnofen,25,,18,19,37
059 Deutschnofen,26,,21,27,48
059 Deutschnofen,27,,28,34,62
059 Deutschnofen,28,,18,29,47
059 Deutschnofen,29,,23,32,55
059 Deutschnofen,30,,28,22,50
059 Deutschnofen,31,,27,24,51
059 Deutschnofen,32,,48,28,76
059 Deutschnofen,33,,26,26,52
059 Deutschnofen,34,,29,29,58
059 Deutschnofen,35,,33,33,66
059 Deutschnofen,36,,39,23,62
059 Deutschnofen,37,,31,27,58
059 Deutschnofen,38,,33,26,59
059 Deutschnofen,39,,27,27,54
059 Deutschnofen,40,,36,22,58
059 Deutschnofen,41,,42,26,68
059 Deutschnofen,42,,26,18,44
059 Deutschnofen,43,,24,31,55
059 Deutschnofen,44,,23,26,49
059 Deutschnofen,45,,34,26,60
059 Deutschnofen,46,,28,22,50
059 Deutschnofen,47,,27,19,46
059 Deutschnofen,48,,22,19,41
059 Deutschnofen,49,,24,22,46
059 Deutschnofen,50,,21,14,35
059 Deutschnofen,51,,18,22,40
059 Deutschnofen,52,,21,13,34
059 Deutschnofen,53,,24,16,40
059 Deutschnofen,54,,13,15,28
059 Deutschnofen,55,,19,22,41
059 Deutschnofen,56,,17,16,33
059 Deutschnofen,57,,16,17,33
059 Deutschnofen,58,,24,22,46
059 Deutschnofen,59,,20,17,37
059 Deutschnofen,60,,15,24,39
059 Deutschnofen,61,,13,19,32
059 Deutschnofen,62,,26,14,40
059 Deutschnofen,63,,17,21,38
059 Deutschnofen,64,,13,7,20
059 Deutschnofen,65,,14,10,24
059 Deutschnofen,66,,8,13,21
059 Deutschnofen,67,,16,10,26
059 Deutschnofen,68,,9,14,23
059 Deutschnofen,69,,14,15,29
059 Deutschnofen,70,,12,9,21
059 Deutschnofen,71,,11,10,21
059 Deutschnofen,72,,9,10,19
059 Deutschnofen,73,,10,23,33
059 Deutschnofen,74,,9,15,24
059 Deutschnofen,75,,17,11,28
059 Deutschnofen,76,,10,21,31
059 Deutschnofen,77,,6,12,18
059 Deutschnofen,78,,6,11,17
059 Deutschnofen,79,,9,17,26
059 Deutschnofen,80,,7,16,23
059 Deutschnofen,81,,3,12,15
059 Deutschnofen,82,,1,6,7
059 Deutschnofen,83,,3,6,9
059 Deutschnofen,84,,1,4,5
059 Deutschnofen,85,,4,3,7
059 Deutschnofen,86,,5,5,10
059 Deutschnofen,87,,3,6,9
059 Deutschnofen,88,,3,9,12
059 Deutschnofen,89,,-,6,6
059 Deutschnofen,90,,1,7,8
059 Deutschnofen,91,,3,2,5
059 Deutschnofen,92,,-,2,2
059 Deutschnofen,93,,2,-,2
059 Deutschnofen,94,,1,-,1
059 Deutschnofen,95,,1,1,2
060 Auer,0,,15,18,33
060 Auer,1,,16,20,36
060 Auer,2,,20,22,42
060 Auer,3,,17,20,37
060 Auer,4,,19,19,38
060 Auer,5,,17,22,39
060 Auer,6,,18,14,32
060 Auer,7,,21,20,41
060 Auer,8,,11,23,34
060 Auer,9,,19,20,39
060 Auer,10,,23,13,36
060 Auer,11,,17,18,35
060 Auer,12,,20,19,39
060 Auer,13,,17,24,41
060 Auer,14,,21,15,36
060 Auer,15,,15,15,30
060 Auer,16,,21,19,40
060 Auer,17,,14,11,25
060 Auer,18,,13,16,29
060 Auer,19,,17,25,42
060 Auer,20,,13,16,29
060 Auer,21,,13,12,25
060 Auer,22,,18,18,36
060 Auer,23,,13,9,22
060 Auer,24,,12,20,32
060 Auer,25,,17,26,43
060 Auer,26,,11,15,26
060 Auer,27,,28,24,52
060 Auer,28,,28,18,46
060 Auer,29,,15,21,36
060 Auer,30,,31,21,52
060 Auer,31,,24,21,45
060 Auer,32,,22,28,50
060 Auer,33,,28,34,62
060 Auer,34,,26,24,50
060 Auer,35,,29,39,68
060 Auer,36,,33,22,55
060 Auer,37,,31,21,52
060 Auer,38,,33,35,68
060 Auer,39,,20,24,44
060 Auer,40,,38,33,71
060 Auer,41,,23,34,57
060 Auer,42,,36,28,64
060 Auer,43,,32,19,51
060 Auer,44,,25,25,50
060 Auer,45,,31,28,59
060 Auer,46,,14,24,38
060 Auer,47,,19,14,33
060 Auer,48,,14,20,34
060 Auer,49,,23,20,43
060 Auer,50,,17,22,39
060 Auer,51,,14,21,35
060 Auer,52,,10,13,23
060 Auer,53,,28,14,42
060 Auer,54,,16,24,40
060 Auer,55,,18,24,42
060 Auer,56,,13,13,26
060 Auer,57,,22,16,38
060 Auer,58,,17,18,35
060 Auer,59,,17,18,35
060 Auer,60,,20,15,35
060 Auer,61,,12,10,22
060 Auer,62,,12,19,31
060 Auer,63,,17,20,37
060 Auer,64,,11,13,24
060 Auer,65,,10,9,19
060 Auer,66,,10,16,26
060 Auer,67,,18,13,31
060 Auer,68,,5,9,14
060 Auer,69,,4,17,21
060 Auer,70,,13,10,23
060 Auer,71,,9,9,18
060 Auer,72,,9,15,24
060 Auer,73,,13,9,22
060 Auer,74,,9,13,22
060 Auer,75,,7,15,22
060 Auer,76,,12,10,22
060 Auer,77,,10,10,20
060 Auer,78,,9,15,24
060 Auer,79,,1,15,16
060 Auer,80,,3,12,15
060 Auer,81,,8,10,18
060 Auer,82,,4,3,7
060 Auer,83,,2,8,10
060 Auer,84,,2,3,5
060 Auer,85,,2,3,5
060 Auer,86,,-,2,2
060 Auer,87,,1,3,4
060 Auer,88,,2,7,9
060 Auer,89,,1,5,6
060 Auer,90,,-,1,1
060 Auer,91,,1,1,2
060 Auer,92,,1,2,3
060 Auer,93,,-,1,1
060 Auer,94,,1,1,2
061 St.Ulrich,0,,22,22,44
061 St.Ulrich,1,,29,31,60
061 St.Ulrich,2,,44,31,75
061 St.Ulrich,3,,38,35,73
061 St.Ulrich,4,,29,30,59
061 St.Ulrich,5,,28,24,52
061 St.Ulrich,6,,31,33,64
061 St.Ulrich,7,,28,29,57
061 St.Ulrich,8,,21,29,50
061 St.Ulrich,9,,33,31,64
061 St.Ulrich,10,,30,33,63
061 St.Ulrich,11,,28,22,50
061 St.Ulrich,12,,17,25,42
061 St.Ulrich,13,,18,21,39
061 St.Ulrich,14,,26,18,44
061 St.Ulrich,15,,18,18,36
061 St.Ulrich,16,,24,21,45
061 St.Ulrich,17,,23,18,41
061 St.Ulrich,18,,21,19,40
061 St.Ulrich,19,,24,26,50
061 St.Ulrich,20,,21,24,45
061 St.Ulrich,21,,24,28,52
061 St.Ulrich,22,,29,25,54
061 St.Ulrich,23,,23,28,51
061 St.Ulrich,24,,23,22,45
061 St.Ulrich,25,,32,35,67
061 St.Ulrich,26,,36,28,64
061 St.Ulrich,27,,33,29,62
061 St.Ulrich,28,,38,31,69
061 St.Ulrich,29,,42,39,81
061 St.Ulrich,30,,41,36,77
061 St.Ulrich,31,,42,35,77
061 St.Ulrich,32,,45,43,88
061 St.Ulrich,33,,49,39,88
061 St.Ulrich,34,,40,40,80
061 St.Ulrich,35,,39,37,76
061 St.Ulrich,36,,31,33,64
061 St.Ulrich,37,,40,41,81
061 St.Ulrich,38,,38,33,71
061 St.Ulrich,39,,31,35,66
061 St.Ulrich,40,,29,21,50
061 St.Ulrich,41,,34,26,60
061 St.Ulrich,42,,40,27,67
061 St.Ulrich,43,,22,18,40
061 St.Ulrich,44,,27,34,61
061 St.Ulrich,45,,17,30,47
061 St.Ulrich,46,,27,38,65
061 St.Ulrich,47,,26,35,61
061 St.Ulrich,48,,29,18,47
061 St.Ulrich,49,,15,26,41
061 St.Ulrich,50,,25,23,48
061 St.Ulrich,51,,22,22,44
061 St.Ulrich,52,,19,27,46
061 St.Ulrich,53,,30,30,60
061 St.Ulrich,54,,22,23,45
061 St.Ulrich,55,,35,26,61
061 St.Ulrich,56,,20,19,39
061 St.Ulrich,57,,30,32,62
061 St.Ulrich,58,,41,39,80
061 St.Ulrich,59,,32,37,69
061 St.Ulrich,60,,38,45,83
061 St.Ulrich,61,,32,28,60
061 St.Ulrich,62,,20,20,40
061 St.Ulrich,63,,26,26,52
061 St.Ulrich,64,,24,26,50
061 St.Ulrich,65,,25,17,42
061 St.Ulrich,66,,13,24,37
061 St.Ulrich,67,,20,13,33
061 St.Ulrich,68,,20,13,33
061 St.Ulrich,69,,15,23,38
061 St.Ulrich,70,,20,16,36
061 St.Ulrich,71,,19,9,28
061 St.Ulrich,72,,18,4,22
061 St.Ulrich,73,,19,13,32
061 St.Ulrich,74,,18,17,35
061 St.Ulrich,75,,11,16,27
061 St.Ulrich,76,,11,10,21
061 St.Ulrich,77,,10,21,31
061 St.Ulrich,78,,12,23,35
061 St.Ulrich,79,,6,20,26
061 St.Ulrich,80,,9,14,23
061 St.Ulrich,81,,7,19,26
061 St.Ulrich,82,,6,9,15
061 St.Ulrich,83,,6,9,15
061 St.Ulrich,84,,2,7,9
061 St.Ulrich,85,,4,6,10
061 St.Ulrich,86,,2,9,11
061 St.Ulrich,87,,9,8,17
061 St.Ulrich,88,,3,14,17
061 St.Ulrich,89,,5,9,14
061 St.Ulrich,90,,-,8,8
061 St.Ulrich,91,,4,1,5
061 St.Ulrich,92,,3,1,4
061 St.Ulrich,93,,1,1,2
061 St.Ulrich,94,,-,2,2
061 St.Ulrich,95,,-,1,1
061 St.Ulrich,97,,-,1,1
061 St.Ulrich,98,,1,-,1
062 Partschins,0,,18,17,35
062 Partschins,1,,19,15,34
062 Partschins,2,,15,13,28
062 Partschins,3,,16,13,29
062 Partschins,4,,21,21,42
062 Partschins,5,,13,19,32
062 Partschins,6,,22,16,38
062 Partschins,7,,21,17,38
062 Partschins,8,,22,17,39
062 Partschins,9,,19,18,37
062 Partschins,10,,22,26,48
062 Partschins,11,,27,24,51
062 Partschins,12,,11,24,35
062 Partschins,13,,19,27,46
062 Partschins,14,,17,14,31
062 Partschins,15,,22,21,43
062 Partschins,16,,11,14,25
062 Partschins,17,,17,20,37
062 Partschins,18,,17,21,38
062 Partschins,19,,18,20,38
062 Partschins,20,,23,28,51
062 Partschins,21,,25,18,43
062 Partschins,22,,16,16,32
062 Partschins,23,,16,15,31
062 Partschins,24,,25,17,42
062 Partschins,25,,19,22,41
062 Partschins,26,,23,19,42
062 Partschins,27,,21,17,38
062 Partschins,28,,29,23,52
062 Partschins,29,,26,28,54
062 Partschins,30,,24,27,51
062 Partschins,31,,25,31,56
062 Partschins,32,,34,25,59
062 Partschins,33,,20,27,47
062 Partschins,34,,32,26,58
062 Partschins,35,,37,36,73
062 Partschins,36,,30,33,63
062 Partschins,37,,27,38,65
062 Partschins,38,,35,26,61
062 Partschins,39,,30,25,55
062 Partschins,40,,20,24,44
062 Partschins,41,,26,37,63
062 Partschins,42,,27,18,45
062 Partschins,43,,19,18,37
062 Partschins,44,,23,25,48
062 Partschins,45,,23,20,43
062 Partschins,46,,26,27,53
062 Partschins,47,,11,27,38
062 Partschins,48,,22,15,37
062 Partschins,49,,16,15,31
062 Partschins,50,,20,15,35
062 Partschins,51,,16,20,36
062 Partschins,52,,9,11,20
062 Partschins,53,,17,18,35
062 Partschins,54,,17,16,33
062 Partschins,55,,28,27,55
062 Partschins,56,,13,17,30
062 Partschins,57,,17,18,35
062 Partschins,58,,23,26,49
062 Partschins,59,,14,16,30
062 Partschins,60,,23,30,53
062 Partschins,61,,14,13,27
062 Partschins,62,,11,17,28
062 Partschins,63,,20,14,34
062 Partschins,64,,16,17,33
062 Partschins,65,,13,17,30
062 Partschins,66,,11,10,21
062 Partschins,67,,13,17,30
062 Partschins,68,,14,16,30
062 Partschins,69,,16,10,26
062 Partschins,70,,14,21,35
062 Partschins,71,,13,11,24
062 Partschins,72,,12,11,23
062 Partschins,73,,12,13,25
062 Partschins,74,,11,13,24
062 Partschins,75,,9,9,18
062 Partschins,76,,8,12,20
062 Partschins,77,,5,14,19
062 Partschins,78,,7,10,17
062 Partschins,79,,6,8,14
062 Partschins,80,,15,8,23
062 Partschins,81,,3,6,9
062 Partschins,82,,4,6,10
062 Partschins,83,,2,3,5
062 Partschins,84,,1,5,6
062 Partschins,85,,1,3,4
062 Partschins,86,,2,1,3
062 Partschins,87,,3,6,9
062 Partschins,88,,2,9,11
062 Partschins,89,,1,7,8
062 Partschins,90,,2,2,4
062 Partschins,91,,-,7,7
062 Partschins,92,,-,3,3
062 Partschins,94,,-,1,1
062 Partschins,95,,2,-,2
062 Partschins,96,,1,1,2
062 Partschins,98,,-,1,1
062 Partschins,99,,-,1,1
063 Percha,0,,5,4,9
063 Percha,1,,12,13,25
063 Percha,2,,4,8,12
063 Percha,3,,7,9,16
063 Percha,4,,10,17,27
063 Percha,5,,9,4,13
063 Percha,6,,8,9,17
063 Percha,7,,9,11,20
063 Percha,8,,7,9,16
063 Percha,9,,12,6,18
063 Percha,10,,10,9,19
063 Percha,11,,9,6,15
063 Percha,12,,6,8,14
063 Percha,13,,6,5,11
063 Percha,14,,9,18,27
063 Percha,15,,5,7,12
063 Percha,16,,8,14,22
063 Percha,17,,18,9,27
063 Percha,18,,14,10,24
063 Percha,19,,6,12,18
063 Percha,20,,9,6,15
063 Percha,21,,11,5,16
063 Percha,22,,7,13,20
063 Percha,23,,8,10,18
063 Percha,24,,8,10,18
063 Percha,25,,15,11,26
063 Percha,26,,10,8,18
063 Percha,27,,5,12,17
063 Percha,28,,10,8,18
063 Percha,29,,11,11,22
063 Percha,30,,15,11,26
063 Percha,31,,8,11,19
063 Percha,32,,18,15,33
063 Percha,33,,14,13,27
063 Percha,34,,11,12,23
063 Percha,35,,18,6,24
063 Percha,36,,13,23,36
063 Percha,37,,16,10,26
063 Percha,38,,11,17,28
063 Percha,39,,14,11,25
063 Percha,40,,12,12,24
063 Percha,41,,10,5,15
063 Percha,42,,7,8,15
063 Percha,43,,10,8,18
063 Percha,44,,10,5,15
063 Percha,45,,7,12,19
063 Percha,46,,11,11,22
063 Percha,47,,4,4,8
063 Percha,48,,8,6,14
063 Percha,49,,4,8,12
063 Percha,50,,7,7,14
063 Percha,51,,6,7,13
063 Percha,52,,10,7,17
063 Percha,53,,4,4,8
063 Percha,54,,5,5,10
063 Percha,55,,6,8,14
063 Percha,56,,8,5,13
063 Percha,57,,12,4,16
063 Percha,58,,9,6,15
063 Percha,59,,9,7,16
063 Percha,60,,9,6,15
063 Percha,61,,5,5,10
063 Percha,62,,6,5,11
063 Percha,63,,5,9,14
063 Percha,64,,1,5,6
063 Percha,65,,4,4,8
063 Percha,66,,4,5,9
063 Percha,67,,6,6,12
063 Percha,68,,4,5,9
063 Percha,69,,5,3,8
063 Percha,70,,7,2,9
063 Percha,71,,10,3,13
063 Percha,72,,3,5,8
063 Percha,73,,3,3,6
063 Percha,74,,6,5,11
063 Percha,75,,2,7,9
063 Percha,76,,4,6,10
063 Percha,77,,2,2,4
063 Percha,78,,1,4,5
063 Percha,79,,2,2,4
063 Percha,80,,-,2,2
063 Percha,81,,-,1,1
063 Percha,83,,1,1,2
063 Percha,85,,1,1,2
063 Percha,86,,1,1,2
063 Percha,87,,-,4,4
063 Percha,89,,-,2,2
063 Percha,91,,1,-,1
064 Plaus,0,,8,3,11
064 Plaus,1,,10,4,14
064 Plaus,2,,10,5,15
064 Plaus,3,,5,6,11
064 Plaus,4,,6,6,12
064 Plaus,5,,6,2,8
064 Plaus,6,,2,2,4
064 Plaus,7,,4,1,5
064 Plaus,8,,8,3,11
064 Plaus,9,,6,5,11
064 Plaus,10,,3,8,11
064 Plaus,11,,4,2,6
064 Plaus,12,,5,6,11
064 Plaus,13,,3,2,5
064 Plaus,14,,4,2,6
064 Plaus,15,,-,4,4
064 Plaus,16,,2,5,7
064 Plaus,17,,5,-,5
064 Plaus,18,,1,1,2
064 Plaus,19,,-,4,4
064 Plaus,20,,2,5,7
064 Plaus,21,,1,5,6
064 Plaus,22,,1,5,6
064 Plaus,23,,3,5,8
064 Plaus,24,,1,5,6
064 Plaus,25,,3,3,6
064 Plaus,26,,9,1,10
064 Plaus,27,,5,6,11
064 Plaus,28,,7,2,9
064 Plaus,29,,5,2,7
064 Plaus,30,,4,6,10
064 Plaus,31,,7,4,11
064 Plaus,32,,8,8,16
064 Plaus,33,,3,7,10
064 Plaus,34,,11,8,19
064 Plaus,35,,6,6,12
064 Plaus,36,,12,2,14
064 Plaus,37,,6,8,14
064 Plaus,38,,2,4,6
064 Plaus,39,,5,5,10
064 Plaus,40,,6,2,8
064 Plaus,41,,2,5,7
064 Plaus,42,,7,2,9
064 Plaus,43,,4,3,7
064 Plaus,44,,2,2,4
064 Plaus,45,,3,1,4
064 Plaus,46,,3,4,7
064 Plaus,47,,1,1,2
064 Plaus,48,,3,4,7
064 Plaus,49,,5,2,7
064 Plaus,50,,3,3,6
064 Plaus,51,,1,2,3
064 Plaus,52,,3,3,6
064 Plaus,53,,1,3,4
064 Plaus,54,,3,5,8
064 Plaus,55,,6,2,8
064 Plaus,56,,3,1,4
064 Plaus,57,,2,3,5
064 Plaus,58,,4,1,5
064 Plaus,59,,-,4,4
064 Plaus,60,,4,5,9
064 Plaus,61,,3,2,5
064 Plaus,62,,3,2,5
064 Plaus,63,,1,1,2
064 Plaus,64,,3,3,6
064 Plaus,66,,2,2,4
064 Plaus,67,,4,3,7
064 Plaus,68,,1,3,4
064 Plaus,69,,1,3,4
064 Plaus,70,,1,1,2
064 Plaus,71,,-,1,1
064 Plaus,72,,1,1,2
064 Plaus,73,,1,-,1
064 Plaus,74,,1,1,2
064 Plaus,75,,1,2,3
064 Plaus,76,,1,-,1
064 Plaus,77,,-,4,4
064 Plaus,78,,-,3,3
064 Plaus,79,,1,1,2
064 Plaus,80,,-,1,1
064 Plaus,81,,1,1,2
064 Plaus,82,,-,2,2
064 Plaus,83,,-,1,1
064 Plaus,89,,1,-,1
064 Plaus,90,,-,1,1
065 Waidbruck,0,,1,-,1
065 Waidbruck,1,,2,2,4
065 Waidbruck,2,,2,1,3
065 Waidbruck,4,,3,3,6
065 Waidbruck,5,,2,-,2
065 Waidbruck,6,,1,3,4
065 Waidbruck,7,,3,1,4
065 Waidbruck,8,,1,1,2
065 Waidbruck,9,,-,2,2
065 Waidbruck,10,,1,-,1
065 Waidbruck,11,,1,1,2
065 Waidbruck,12,,1,-,1
065 Waidbruck,13,,-,1,1
065 Waidbruck,14,,1,1,2
065 Waidbruck,16,,-,1,1
065 Waidbruck,17,,1,1,2
065 Waidbruck,18,,1,-,1
065 Waidbruck,20,,-,2,2
065 Waidbruck,21,,2,-,2
065 Waidbruck,22,,1,1,2
065 Waidbruck,23,,2,-,2
065 Waidbruck,24,,1,1,2
065 Waidbruck,25,,-,1,1
065 Waidbruck,26,,2,1,3
065 Waidbruck,27,,4,-,4
065 Waidbruck,28,,-,1,1
065 Waidbruck,29,,-,1,1
065 Waidbruck,30,,3,-,3
065 Waidbruck,31,,4,2,6
065 Waidbruck,32,,1,3,4
065 Waidbruck,33,,3,1,4
065 Waidbruck,34,,2,4,6
065 Waidbruck,35,,2,2,4
065 Waidbruck,36,,2,1,3
065 Waidbruck,37,,3,-,3
065 Waidbruck,38,,-,1,1
065 Waidbruck,39,,2,-,2
065 Waidbruck,40,,-,1,1
065 Waidbruck,41,,3,1,4
065 Waidbruck,42,,3,1,4
065 Waidbruck,43,,-,1,1
065 Waidbruck,44,,1,1,2
065 Waidbruck,45,,2,-,2
065 Waidbruck,46,,2,1,3
065 Waidbruck,48,,1,1,2
065 Waidbruck,49,,1,1,2
065 Waidbruck,50,,-,2,2
065 Waidbruck,55,,-,3,3
065 Waidbruck,56,,1,1,2
065 Waidbruck,57,,2,2,4
065 Waidbruck,58,,-,1,1
065 Waidbruck,59,,1,-,1
065 Waidbruck,60,,1,2,3
065 Waidbruck,61,,-,3,3
065 Waidbruck,62,,1,-,1
065 Waidbruck,63,,-,3,3
065 Waidbruck,64,,2,1,3
065 Waidbruck,65,,2,2,4
065 Waidbruck,66,,-,3,3
065 Waidbruck,67,,4,1,5
065 Waidbruck,68,,2,-,2
065 Waidbruck,69,,1,4,5
065 Waidbruck,70,,1,-,1
065 Waidbruck,71,,1,-,1
065 Waidbruck,72,,-,3,3
065 Waidbruck,73,,1,-,1
065 Waidbruck,74,,2,1,3
065 Waidbruck,75,,-,1,1
065 Waidbruck,76,,1,1,2
065 Waidbruck,78,,-,2,2
065 Waidbruck,79,,-,1,1
065 Waidbruck,81,,-,3,3
065 Waidbruck,82,,-,2,2
065 Waidbruck,86,,2,-,2
065 Waidbruck,87,,-,1,1
066 Burgstall,0,,9,8,17
066 Burgstall,1,,10,8,18
066 Burgstall,2,,8,9,17
066 Burgstall,3,,10,10,20
066 Burgstall,4,,8,4,12
066 Burgstall,5,,4,8,12
066 Burgstall,6,,10,10,20
066 Burgstall,7,,5,6,11
066 Burgstall,8,,6,9,15
066 Burgstall,9,,4,4,8
066 Burgstall,10,,8,11,19
066 Burgstall,11,,12,8,20
066 Burgstall,12,,9,3,12
066 Burgstall,13,,6,5,11
066 Burgstall,14,,9,9,18
066 Burgstall,15,,10,4,14
066 Burgstall,16,,6,11,17
066 Burgstall,17,,9,12,21
066 Burgstall,18,,7,10,17
066 Burgstall,19,,13,8,21
066 Burgstall,20,,4,7,11
066 Burgstall,21,,12,6,18
066 Burgstall,22,,4,6,10
066 Burgstall,23,,8,6,14
066 Burgstall,24,,3,12,15
066 Burgstall,25,,10,5,15
066 Burgstall,26,,17,9,26
066 Burgstall,27,,10,9,19
066 Burgstall,28,,10,11,21
066 Burgstall,29,,8,15,23
066 Burgstall,30,,15,8,23
066 Burgstall,31,,12,10,22
066 Burgstall,32,,13,9,22
066 Burgstall,33,,15,18,33
066 Burgstall,34,,10,16,26
066 Burgstall,35,,17,15,32
066 Burgstall,36,,20,17,37
066 Burgstall,37,,16,11,27
066 Burgstall,38,,17,12,29
066 Burgstall,39,,18,11,29
066 Burgstall,40,,8,14,22
066 Burgstall,41,,14,10,24
066 Burgstall,42,,5,9,14
066 Burgstall,43,,16,9,25
066 Burgstall,44,,7,9,16
066 Burgstall,45,,12,10,22
066 Burgstall,46,,8,9,17
066 Burgstall,47,,9,11,20
066 Burgstall,48,,7,10,17
066 Burgstall,49,,9,13,22
066 Burgstall,50,,13,7,20
066 Burgstall,51,,10,12,22
066 Burgstall,52,,8,7,15
066 Burgstall,53,,6,13,19
066 Burgstall,54,,7,8,15
066 Burgstall,55,,10,8,18
066 Burgstall,56,,6,9,15
066 Burgstall,57,,13,9,22
066 Burgstall,58,,9,8,17
066 Burgstall,59,,5,6,11
066 Burgstall,60,,8,4,12
066 Burgstall,61,,5,13,18
066 Burgstall,62,,6,9,15
066 Burgstall,63,,10,14,24
066 Burgstall,64,,4,9,13
066 Burgstall,65,,5,6,11
066 Burgstall,66,,7,3,10
066 Burgstall,67,,9,8,17
066 Burgstall,68,,8,4,12
066 Burgstall,69,,3,8,11
066 Burgstall,70,,6,3,9
066 Burgstall,71,,6,7,13
066 Burgstall,72,,2,4,6
066 Burgstall,73,,4,8,12
066 Burgstall,74,,2,12,14
066 Burgstall,75,,4,9,13
066 Burgstall,76,,7,5,12
066 Burgstall,77,,1,8,9
066 Burgstall,78,,5,3,8
066 Burgstall,79,,6,6,12
066 Burgstall,80,,2,2,4
066 Burgstall,81,,3,3,6
066 Burgstall,82,,1,4,5
066 Burgstall,83,,-,1,1
066 Burgstall,84,,1,1,2
066 Burgstall,85,,2,2,4
066 Burgstall,86,,1,3,4
066 Burgstall,87,,1,3,4
066 Burgstall,88,,2,1,3
066 Burgstall,89,,-,5,5
066 Burgstall,90,,-,4,4
066 Burgstall,91,,-,1,1
066 Burgstall,92,,-,3,3
066 Burgstall,94,,1,-,1
066 Burgstall,95,,1,-,1
066 Burgstall,99,,-,1,1
066 Burgstall,100,,1,-,1
067 Prad am Stilfser Joch,0,,22,15,37
067 Prad am Stilfser Joch,1,,15,13,28
067 Prad am Stilfser Joch,2,,16,16,32
067 Prad am Stilfser Joch,3,,20,21,41
067 Prad am Stilfser Joch,4,,23,16,39
067 Prad am Stilfser Joch,5,,18,18,36
067 Prad am Stilfser Joch,6,,21,12,33
067 Prad am Stilfser Joch,7,,19,25,44
067 Prad am Stilfser Joch,8,,22,27,49
067 Prad am Stilfser Joch,9,,16,21,37
067 Prad am Stilfser Joch,10,,21,11,32
067 Prad am Stilfser Joch,11,,19,21,40
067 Prad am Stilfser Joch,12,,18,23,41
067 Prad am Stilfser Joch,13,,31,16,47
067 Prad am Stilfser Joch,14,,14,19,33
067 Prad am Stilfser Joch,15,,28,28,56
067 Prad am Stilfser Joch,16,,29,22,51
067 Prad am Stilfser Joch,17,,29,29,58
067 Prad am Stilfser Joch,18,,28,25,53
067 Prad am Stilfser Joch,19,,27,22,49
067 Prad am Stilfser Joch,20,,24,25,49
067 Prad am Stilfser Joch,21,,27,22,49
067 Prad am Stilfser Joch,22,,19,13,32
067 Prad am Stilfser Joch,23,,21,19,40
067 Prad am Stilfser Joch,24,,18,34,52
067 Prad am Stilfser Joch,25,,23,22,45
067 Prad am Stilfser Joch,26,,21,15,36
067 Prad am Stilfser Joch,27,,30,17,47
067 Prad am Stilfser Joch,28,,21,33,54
067 Prad am Stilfser Joch,29,,29,20,49
067 Prad am Stilfser Joch,30,,30,20,50
067 Prad am Stilfser Joch,31,,28,25,53
067 Prad am Stilfser Joch,32,,28,26,54
067 Prad am Stilfser Joch,33,,30,30,60
067 Prad am Stilfser Joch,34,,22,24,46
067 Prad am Stilfser Joch,35,,32,31,63
067 Prad am Stilfser Joch,36,,33,22,55
067 Prad am Stilfser Joch,37,,28,26,54
067 Prad am Stilfser Joch,38,,25,10,35
067 Prad am Stilfser Joch,39,,26,30,56
067 Prad am Stilfser Joch,40,,19,25,44
067 Prad am Stilfser Joch,41,,18,23,41
067 Prad am Stilfser Joch,42,,31,13,44
067 Prad am Stilfser Joch,43,,21,28,49
067 Prad am Stilfser Joch,44,,26,24,50
067 Prad am Stilfser Joch,45,,24,24,48
067 Prad am Stilfser Joch,46,,28,16,44
067 Prad am Stilfser Joch,47,,28,17,45
067 Prad am Stilfser Joch,48,,26,17,43
067 Prad am Stilfser Joch,49,,13,20,33
067 Prad am Stilfser Joch,50,,20,21,41
067 Prad am Stilfser Joch,51,,23,17,40
067 Prad am Stilfser Joch,52,,21,21,42
067 Prad am Stilfser Joch,53,,19,11,30
067 Prad am Stilfser Joch,54,,16,13,29
067 Prad am Stilfser Joch,55,,16,15,31
067 Prad am Stilfser Joch,56,,16,10,26
067 Prad am Stilfser Joch,57,,11,15,26
067 Prad am Stilfser Joch,58,,24,16,40
067 Prad am Stilfser Joch,59,,18,16,34
067 Prad am Stilfser Joch,60,,21,10,31
067 Prad am Stilfser Joch,61,,10,16,26
067 Prad am Stilfser Joch,62,,14,13,27
067 Prad am Stilfser Joch,63,,18,14,32
067 Prad am Stilfser Joch,64,,11,12,23
067 Prad am Stilfser Joch,65,,12,11,23
067 Prad am Stilfser Joch,66,,15,15,30
067 Prad am Stilfser Joch,67,,8,24,32
067 Prad am Stilfser Joch,68,,14,10,24
067 Prad am Stilfser Joch,69,,13,18,31
067 Prad am Stilfser Joch,70,,7,14,21
067 Prad am Stilfser Joch,71,,12,14,26
067 Prad am Stilfser Joch,72,,9,12,21
067 Prad am Stilfser Joch,73,,8,9,17
067 Prad am Stilfser Joch,74,,7,12,19
067 Prad am Stilfser Joch,75,,9,13,22
067 Prad am Stilfser Joch,76,,10,7,17
067 Prad am Stilfser Joch,77,,6,10,16
067 Prad am Stilfser Joch,78,,4,10,14
067 Prad am Stilfser Joch,79,,6,13,19
067 Prad am Stilfser Joch,80,,5,7,12
067 Prad am Stilfser Joch,81,,5,6,11
067 Prad am Stilfser Joch,82,,6,4,10
067 Prad am Stilfser Joch,83,,1,5,6
067 Prad am Stilfser Joch,84,,-,4,4
067 Prad am Stilfser Joch,85,,-,5,5
067 Prad am Stilfser Joch,86,,4,1,5
067 Prad am Stilfser Joch,87,,2,7,9
067 Prad am Stilfser Joch,88,,-,3,3
067 Prad am Stilfser Joch,89,,4,4,8
067 Prad am Stilfser Joch,90,,1,3,4
067 Prad am Stilfser Joch,91,,1,4,5
067 Prad am Stilfser Joch,92,,-,2,2
067 Prad am Stilfser Joch,93,,-,1,1
067 Prad am Stilfser Joch,94,,1,2,3
067 Prad am Stilfser Joch,96,,-,2,2
068 Prettau,0,,3,5,8
068 Prettau,1,,2,5,7
068 Prettau,2,,6,7,13
068 Prettau,3,,6,4,10
068 Prettau,4,,4,5,9
068 Prettau,5,,1,2,3
068 Prettau,6,,6,5,11
068 Prettau,7,,5,7,12
068 Prettau,8,,4,6,10
068 Prettau,9,,3,3,6
068 Prettau,10,,1,4,5
068 Prettau,11,,1,7,8
068 Prettau,12,,-,4,4
068 Prettau,13,,5,3,8
068 Prettau,14,,5,1,6
068 Prettau,15,,1,2,3
068 Prettau,16,,2,1,3
068 Prettau,17,,3,6,9
068 Prettau,18,,4,2,6
068 Prettau,19,,2,2,4
068 Prettau,20,,2,1,3
068 Prettau,21,,4,2,6
068 Prettau,22,,5,3,8
068 Prettau,23,,1,-,1
068 Prettau,24,,4,2,6
068 Prettau,25,,1,1,2
068 Prettau,26,,4,4,8
068 Prettau,27,,7,2,9
068 Prettau,28,,6,8,14
068 Prettau,29,,9,5,14
068 Prettau,30,,4,4,8
068 Prettau,31,,3,6,9
068 Prettau,32,,8,6,14
068 Prettau,33,,5,4,9
068 Prettau,34,,9,5,14
068 Prettau,35,,6,1,7
068 Prettau,36,,5,11,16
068 Prettau,37,,8,6,14
068 Prettau,38,,5,6,11
068 Prettau,39,,2,5,7
068 Prettau,40,,5,5,10
068 Prettau,41,,8,4,12
068 Prettau,42,,5,2,7
068 Prettau,43,,7,-,7
068 Prettau,44,,4,1,5
068 Prettau,45,,6,5,11
068 Prettau,46,,6,5,11
068 Prettau,47,,6,2,8
068 Prettau,48,,3,3,6
068 Prettau,49,,4,3,7
068 Prettau,50,,2,2,4
068 Prettau,51,,2,2,4
068 Prettau,52,,2,3,5
068 Prettau,53,,2,2,4
068 Prettau,54,,4,5,9
068 Prettau,55,,9,4,13
068 Prettau,56,,1,3,4
068 Prettau,57,,6,5,11
068 Prettau,58,,4,2,6
068 Prettau,59,,3,2,5
068 Prettau,60,,3,3,6
068 Prettau,61,,4,5,9
068 Prettau,62,,4,3,7
068 Prettau,63,,5,7,12
068 Prettau,64,,2,6,8
068 Prettau,65,,4,3,7
068 Prettau,66,,6,3,9
068 Prettau,67,,1,3,4
068 Prettau,68,,4,3,7
068 Prettau,69,,4,-,4
068 Prettau,70,,2,1,3
068 Prettau,71,,5,4,9
068 Prettau,72,,4,5,9
068 Prettau,73,,-,3,3
068 Prettau,74,,3,1,4
068 Prettau,75,,1,7,8
068 Prettau,76,,1,2,3
068 Prettau,77,,2,1,3
068 Prettau,78,,1,4,5
068 Prettau,79,,2,-,2
068 Prettau,80,,1,2,3
068 Prettau,81,,2,3,5
068 Prettau,82,,3,1,4
068 Prettau,83,,1,2,3
068 Prettau,84,,1,-,1
068 Prettau,85,,2,2,4
068 Prettau,86,,-,1,1
068 Prettau,87,,-,3,3
068 Prettau,88,,-,3,3
068 Prettau,89,,-,2,2
068 Prettau,90,,-,2,2
068 Prettau,95,,-,1,1
068 Prettau,96,,-,2,2
069 Proveis,0,,3,1,4
069 Proveis,1,,-,1,1
069 Proveis,2,,4,-,4
069 Proveis,3,,2,2,4
069 Proveis,4,,1,2,3
069 Proveis,5,,1,1,2
069 Proveis,6,,-,5,5
069 Proveis,7,,2,-,2
069 Proveis,8,,2,1,3
069 Proveis,9,,3,1,4
069 Proveis,10,,3,2,5
069 Proveis,11,,-,1,1
069 Proveis,12,,1,1,2
069 Proveis,13,,2,3,5
069 Proveis,14,,2,2,4
069 Proveis,15,,3,1,4
069 Proveis,16,,5,-,5
069 Proveis,17,,3,3,6
069 Proveis,18,,3,3,6
069 Proveis,19,,1,-,1
069 Proveis,20,,3,3,6
069 Proveis,22,,3,1,4
069 Proveis,23,,3,2,5
069 Proveis,24,,2,2,4
069 Proveis,25,,1,3,4
069 Proveis,26,,2,2,4
069 Proveis,27,,5,2,7
069 Proveis,28,,2,-,2
069 Proveis,29,,-,2,2
069 Proveis,30,,1,1,2
069 Proveis,31,,4,3,7
069 Proveis,32,,3,3,6
069 Proveis,33,,6,1,7
069 Proveis,34,,2,1,3
069 Proveis,35,,2,2,4
069 Proveis,36,,1,1,2
069 Proveis,37,,3,-,3
069 Proveis,38,,4,2,6
069 Proveis,39,,5,2,7
069 Proveis,40,,4,1,5
069 Proveis,41,,-,4,4
069 Proveis,42,,4,-,4
069 Proveis,43,,1,3,4
069 Proveis,44,,2,3,5
069 Proveis,45,,4,1,5
069 Proveis,46,,3,4,7
069 Proveis,47,,3,2,5
069 Proveis,48,,2,1,3
069 Proveis,49,,3,3,6
069 Proveis,50,,2,-,2
069 Proveis,51,,1,1,2
069 Proveis,52,,1,-,1
069 Proveis,53,,2,1,3
069 Proveis,54,,1,2,3
069 Proveis,55,,3,-,3
069 Proveis,56,,1,1,2
069 Proveis,57,,2,-,2
069 Proveis,58,,2,1,3
069 Proveis,59,,2,1,3
069 Proveis,60,,1,1,2
069 Proveis,61,,3,-,3
069 Proveis,62,,1,3,4
069 Proveis,63,,-,2,2
069 Proveis,64,,2,1,3
069 Proveis,65,,2,1,3
069 Proveis,66,,1,1,2
069 Proveis,67,,-,1,1
069 Proveis,68,,-,2,2
069 Proveis,69,,1,1,2
069 Proveis,70,,2,1,3
069 Proveis,72,,3,3,6
069 Proveis,73,,4,1,5
069 Proveis,74,,-,2,2
069 Proveis,75,,-,1,1
069 Proveis,76,,-,2,2
069 Proveis,77,,3,-,3
069 Proveis,78,,1,-,1
069 Proveis,79,,1,1,2
069 Proveis,80,,-,5,5
069 Proveis,81,,-,1,1
069 Proveis,84,,-,1,1
069 Proveis,94,,1,-,1
070 Ratschings,0,,22,30,52
070 Ratschings,1,,35,25,60
070 Ratschings,2,,26,18,44
070 Ratschings,3,,32,22,54
070 Ratschings,4,,34,38,72
070 Ratschings,5,,30,34,64
070 Ratschings,6,,28,25,53
070 Ratschings,7,,22,29,51
070 Ratschings,8,,25,23,48
070 Ratschings,9,,39,31,70
070 Ratschings,10,,25,19,44
070 Ratschings,11,,31,28,59
070 Ratschings,12,,25,17,42
070 Ratschings,13,,35,29,64
070 Ratschings,14,,27,31,58
070 Ratschings,15,,28,26,54
070 Ratschings,16,,29,34,63
070 Ratschings,17,,26,19,45
070 Ratschings,18,,31,21,52
070 Ratschings,19,,34,25,59
070 Ratschings,20,,30,30,60
070 Ratschings,21,,23,22,45
070 Ratschings,22,,32,22,54
070 Ratschings,23,,31,24,55
070 Ratschings,24,,35,17,52
070 Ratschings,25,,25,26,51
070 Ratschings,26,,31,30,61
070 Ratschings,27,,37,24,61
070 Ratschings,28,,31,31,62
070 Ratschings,29,,33,42,75
070 Ratschings,30,,37,41,78
070 Ratschings,31,,30,36,66
070 Ratschings,32,,33,43,76
070 Ratschings,33,,46,38,84
070 Ratschings,34,,42,37,79
070 Ratschings,35,,47,42,89
070 Ratschings,36,,37,49,86
070 Ratschings,37,,48,39,87
070 Ratschings,38,,48,26,74
070 Ratschings,39,,37,38,75
070 Ratschings,40,,34,27,61
070 Ratschings,41,,39,23,62
070 Ratschings,42,,39,25,64
070 Ratschings,43,,31,19,50
070 Ratschings,44,,33,18,51
070 Ratschings,45,,36,19,55
070 Ratschings,46,,15,32,47
070 Ratschings,47,,29,15,44
070 Ratschings,48,,21,25,46
070 Ratschings,49,,22,18,40
070 Ratschings,50,,15,15,30
070 Ratschings,51,,25,20,45
070 Ratschings,52,,22,23,45
070 Ratschings,53,,32,19,51
070 Ratschings,54,,18,15,33
070 Ratschings,55,,23,6,29
070 Ratschings,56,,19,20,39
070 Ratschings,57,,19,11,30
070 Ratschings,58,,16,14,30
070 Ratschings,59,,20,19,39
070 Ratschings,60,,23,20,43
070 Ratschings,61,,17,18,35
070 Ratschings,62,,19,17,36
070 Ratschings,63,,15,21,36
070 Ratschings,64,,19,9,28
070 Ratschings,65,,14,12,26
070 Ratschings,66,,17,17,34
070 Ratschings,67,,13,9,22
070 Ratschings,68,,16,19,35
070 Ratschings,69,,16,13,29
070 Ratschings,70,,11,12,23
070 Ratschings,71,,12,18,30
070 Ratschings,72,,10,21,31
070 Ratschings,73,,10,12,22
070 Ratschings,74,,15,14,29
070 Ratschings,75,,14,14,28
070 Ratschings,76,,13,9,22
070 Ratschings,77,,13,12,25
070 Ratschings,78,,10,10,20
070 Ratschings,79,,4,12,16
070 Ratschings,80,,6,13,19
070 Ratschings,81,,2,14,16
070 Ratschings,82,,2,3,5
070 Ratschings,83,,-,6,6
070 Ratschings,85,,2,2,4
070 Ratschings,86,,2,5,7
070 Ratschings,87,,-,4,4
070 Ratschings,88,,3,1,4
070 Ratschings,89,,2,1,3
070 Ratschings,90,,1,-,1
070 Ratschings,92,,-,1,1
070 Ratschings,93,,-,2,2
070 Ratschings,95,,-,1,1
071 Rasen-Antholz,0,,17,21,38
071 Rasen-Antholz,1,,24,21,45
071 Rasen-Antholz,2,,15,17,32
071 Rasen-Antholz,3,,17,15,32
071 Rasen-Antholz,4,,24,20,44
071 Rasen-Antholz,5,,23,14,37
071 Rasen-Antholz,6,,10,15,25
071 Rasen-Antholz,7,,20,11,31
071 Rasen-Antholz,8,,17,14,31
071 Rasen-Antholz,9,,27,19,46
071 Rasen-Antholz,10,,15,14,29
071 Rasen-Antholz,11,,12,25,37
071 Rasen-Antholz,12,,19,17,36
071 Rasen-Antholz,13,,20,16,36
071 Rasen-Antholz,14,,25,9,34
071 Rasen-Antholz,15,,16,20,36
071 Rasen-Antholz,16,,23,14,37
071 Rasen-Antholz,17,,18,17,35
071 Rasen-Antholz,18,,15,19,34
071 Rasen-Antholz,19,,20,24,44
071 Rasen-Antholz,20,,15,16,31
071 Rasen-Antholz,21,,18,12,30
071 Rasen-Antholz,22,,16,19,35
071 Rasen-Antholz,23,,16,18,34
071 Rasen-Antholz,24,,16,18,34
071 Rasen-Antholz,25,,19,25,44
071 Rasen-Antholz,26,,23,26,49
071 Rasen-Antholz,27,,31,19,50
071 Rasen-Antholz,28,,33,21,54
071 Rasen-Antholz,29,,29,14,43
071 Rasen-Antholz,30,,30,23,53
071 Rasen-Antholz,31,,25,29,54
071 Rasen-Antholz,32,,29,26,55
071 Rasen-Antholz,33,,28,30,58
071 Rasen-Antholz,34,,26,26,52
071 Rasen-Antholz,35,,30,17,47
071 Rasen-Antholz,36,,34,25,59
071 Rasen-Antholz,37,,27,19,46
071 Rasen-Antholz,38,,24,21,45
071 Rasen-Antholz,39,,28,20,48
071 Rasen-Antholz,40,,18,24,42
071 Rasen-Antholz,41,,21,24,45
071 Rasen-Antholz,42,,27,19,46
071 Rasen-Antholz,43,,22,16,38
071 Rasen-Antholz,44,,22,11,33
071 Rasen-Antholz,45,,17,16,33
071 Rasen-Antholz,46,,18,14,32
071 Rasen-Antholz,47,,14,12,26
071 Rasen-Antholz,48,,17,11,28
071 Rasen-Antholz,49,,12,15,27
071 Rasen-Antholz,50,,12,12,24
071 Rasen-Antholz,51,,16,8,24
071 Rasen-Antholz,52,,14,8,22
071 Rasen-Antholz,53,,14,10,24
071 Rasen-Antholz,54,,9,14,23
071 Rasen-Antholz,55,,10,14,24
071 Rasen-Antholz,56,,11,10,21
071 Rasen-Antholz,57,,10,8,18
071 Rasen-Antholz,58,,13,13,26
071 Rasen-Antholz,59,,11,14,25
071 Rasen-Antholz,60,,14,13,27
071 Rasen-Antholz,61,,11,17,28
071 Rasen-Antholz,62,,17,13,30
071 Rasen-Antholz,63,,14,8,22
071 Rasen-Antholz,64,,10,12,22
071 Rasen-Antholz,65,,9,12,21
071 Rasen-Antholz,66,,10,8,18
071 Rasen-Antholz,67,,12,10,22
071 Rasen-Antholz,68,,12,15,27
071 Rasen-Antholz,69,,15,10,25
071 Rasen-Antholz,70,,14,14,28
071 Rasen-Antholz,71,,4,11,15
071 Rasen-Antholz,72,,13,4,17
071 Rasen-Antholz,73,,5,3,8
071 Rasen-Antholz,74,,12,10,22
071 Rasen-Antholz,75,,8,6,14
071 Rasen-Antholz,76,,7,13,20
071 Rasen-Antholz,77,,7,12,19
071 Rasen-Antholz,78,,3,11,14
071 Rasen-Antholz,79,,5,6,11
071 Rasen-Antholz,80,,6,6,12
071 Rasen-Antholz,81,,2,6,8
071 Rasen-Antholz,82,,4,6,10
071 Rasen-Antholz,83,,2,3,5
071 Rasen-Antholz,84,,3,4,7
071 Rasen-Antholz,85,,-,3,3
071 Rasen-Antholz,86,,3,3,6
071 Rasen-Antholz,87,,1,4,5
071 Rasen-Antholz,88,,1,3,4
071 Rasen-Antholz,89,,1,2,3
071 Rasen-Antholz,90,,-,3,3
071 Rasen-Antholz,91,,-,1,1
071 Rasen-Antholz,92,,1,2,3
071 Rasen-Antholz,93,,1,1,2
071 Rasen-Antholz,94,,-,1,1
071 Rasen-Antholz,95,,-,1,1
071 Rasen-Antholz,96,,-,1,1
072 Ritten,0,,54,50,104
072 Ritten,1,,45,40,85
072 Ritten,2,,55,55,110
072 Ritten,3,,44,49,93
072 Ritten,4,,57,55,112
072 Ritten,5,,40,53,93
072 Ritten,6,,58,46,104
072 Ritten,7,,61,50,111
072 Ritten,8,,58,52,110
072 Ritten,9,,50,72,122
072 Ritten,10,,62,50,112
072 Ritten,11,,60,47,107
072 Ritten,12,,50,43,93
072 Ritten,13,,58,55,113
072 Ritten,14,,48,41,89
072 Ritten,15,,48,42,90
072 Ritten,16,,44,46,90
072 Ritten,17,,45,25,70
072 Ritten,18,,51,43,94
072 Ritten,19,,41,49,90
072 Ritten,20,,44,48,92
072 Ritten,21,,44,39,83
072 Ritten,22,,51,41,92
072 Ritten,23,,44,37,81
072 Ritten,24,,64,38,102
072 Ritten,25,,43,43,86
072 Ritten,26,,51,43,94
072 Ritten,27,,65,60,125
072 Ritten,28,,58,47,105
072 Ritten,29,,52,53,105
072 Ritten,30,,53,66,119
072 Ritten,31,,57,70,127
072 Ritten,32,,51,66,117
072 Ritten,33,,73,65,138
072 Ritten,34,,70,51,121
072 Ritten,35,,60,52,112
072 Ritten,36,,80,47,127
072 Ritten,37,,68,60,128
072 Ritten,38,,63,54,117
072 Ritten,39,,60,63,123
072 Ritten,40,,49,60,109
072 Ritten,41,,62,63,125
072 Ritten,42,,66,48,114
072 Ritten,43,,39,45,84
072 Ritten,44,,40,39,79
072 Ritten,45,,45,43,88
072 Ritten,46,,48,39,87
072 Ritten,47,,38,32,70
072 Ritten,48,,48,33,81
072 Ritten,49,,40,43,83
072 Ritten,50,,45,35,80
072 Ritten,51,,36,42,78
072 Ritten,52,,36,40,76
072 Ritten,53,,51,33,84
072 Ritten,54,,33,29,62
072 Ritten,55,,28,39,67
072 Ritten,56,,22,26,48
072 Ritten,57,,34,40,74
072 Ritten,58,,36,38,74
072 Ritten,59,,45,36,81
072 Ritten,60,,38,39,77
072 Ritten,61,,35,24,59
072 Ritten,62,,37,32,69
072 Ritten,63,,34,34,68
072 Ritten,64,,30,27,57
072 Ritten,65,,24,23,47
072 Ritten,66,,23,30,53
072 Ritten,67,,26,27,53
072 Ritten,68,,18,26,44
072 Ritten,69,,23,24,47
072 Ritten,70,,17,33,50
072 Ritten,71,,15,21,36
072 Ritten,72,,24,21,45
072 Ritten,73,,19,13,32
072 Ritten,74,,20,18,38
072 Ritten,75,,15,22,37
072 Ritten,76,,17,36,53
072 Ritten,77,,20,29,49
072 Ritten,78,,18,23,41
072 Ritten,79,,6,27,33
072 Ritten,80,,13,22,35
072 Ritten,81,,9,21,30
072 Ritten,82,,6,15,21
072 Ritten,83,,3,7,10
072 Ritten,84,,3,11,14
072 Ritten,85,,1,4,5
072 Ritten,86,,4,7,11
072 Ritten,87,,4,9,13
072 Ritten,88,,5,8,13
072 Ritten,89,,2,6,8
072 Ritten,90,,3,6,9
072 Ritten,91,,4,5,9
072 Ritten,92,,2,1,3
072 Ritten,93,,-,2,2
072 Ritten,94,,1,4,5
072 Ritten,95,,-,1,1
072 Ritten,98,,-,1,1
072 Ritten,99,,-,1,1
073 Riffian,0,,10,6,16
073 Riffian,1,,11,12,23
073 Riffian,2,,8,13,21
073 Riffian,3,,12,10,22
073 Riffian,4,,8,8,16
073 Riffian,5,,5,7,12
073 Riffian,6,,9,10,19
073 Riffian,7,,6,8,14
073 Riffian,8,,7,8,15
073 Riffian,9,,9,9,18
073 Riffian,10,,9,12,21
073 Riffian,11,,6,7,13
073 Riffian,12,,12,5,17
073 Riffian,13,,6,11,17
073 Riffian,14,,7,9,16
073 Riffian,15,,8,6,14
073 Riffian,16,,8,2,10
073 Riffian,17,,8,6,14
073 Riffian,18,,9,7,16
073 Riffian,19,,9,10,19
073 Riffian,20,,10,7,17
073 Riffian,21,,6,5,11
073 Riffian,22,,6,8,14
073 Riffian,23,,9,6,15
073 Riffian,24,,11,7,18
073 Riffian,25,,9,3,12
073 Riffian,26,,6,12,18
073 Riffian,27,,10,2,12
073 Riffian,28,,11,10,21
073 Riffian,29,,10,18,28
073 Riffian,30,,9,17,26
073 Riffian,31,,9,10,19
073 Riffian,32,,9,13,22
073 Riffian,33,,10,14,24
073 Riffian,34,,13,13,26
073 Riffian,35,,9,8,17
073 Riffian,36,,12,7,19
073 Riffian,37,,12,8,20
073 Riffian,38,,13,10,23
073 Riffian,39,,9,9,18
073 Riffian,40,,8,9,17
073 Riffian,41,,16,5,21
073 Riffian,42,,6,13,19
073 Riffian,43,,7,6,13
073 Riffian,44,,6,13,19
073 Riffian,45,,10,4,14
073 Riffian,46,,5,9,14
073 Riffian,47,,10,6,16
073 Riffian,48,,10,4,14
073 Riffian,49,,7,3,10
073 Riffian,50,,7,10,17
073 Riffian,51,,4,3,7
073 Riffian,52,,6,6,12
073 Riffian,53,,8,4,12
073 Riffian,54,,3,4,7
073 Riffian,55,,2,6,8
073 Riffian,56,,6,3,9
073 Riffian,57,,8,8,16
073 Riffian,58,,7,7,14
073 Riffian,59,,12,7,19
073 Riffian,60,,8,3,11
073 Riffian,61,,4,3,7
073 Riffian,62,,4,9,13
073 Riffian,63,,10,4,14
073 Riffian,64,,4,6,10
073 Riffian,65,,2,4,6
073 Riffian,66,,1,3,4
073 Riffian,67,,1,3,4
073 Riffian,68,,7,4,11
073 Riffian,69,,2,3,5
073 Riffian,70,,5,9,14
073 Riffian,71,,4,3,7
073 Riffian,72,,3,7,10
073 Riffian,73,,3,3,6
073 Riffian,74,,5,4,9
073 Riffian,75,,6,2,8
073 Riffian,76,,5,3,8
073 Riffian,77,,5,4,9
073 Riffian,78,,4,6,10
073 Riffian,79,,2,2,4
073 Riffian,80,,1,3,4
073 Riffian,81,,2,3,5
073 Riffian,82,,-,1,1
073 Riffian,83,,1,-,1
073 Riffian,84,,-,3,3
073 Riffian,85,,1,-,1
073 Riffian,86,,1,-,1
073 Riffian,87,,1,5,6
073 Riffian,88,,-,2,2
073 Riffian,89,,-,1,1
073 Riffian,91,,1,-,1
073 Riffian,92,,-,1,1
073 Riffian,93,,-,1,1
073 Riffian,95,,1,-,1
074 Mühlbach,0,,11,20,31
074 Mühlbach,1,,18,18,36
074 Mühlbach,2,,21,12,33
074 Mühlbach,3,,16,15,31
074 Mühlbach,4,,17,16,33
074 Mühlbach,5,,17,18,35
074 Mühlbach,6,,12,15,27
074 Mühlbach,7,,19,14,33
074 Mühlbach,8,,17,17,34
074 Mühlbach,9,,15,23,38
074 Mühlbach,10,,13,19,32
074 Mühlbach,11,,13,13,26
074 Mühlbach,12,,14,21,35
074 Mühlbach,13,,21,15,36
074 Mühlbach,14,,20,12,32
074 Mühlbach,15,,15,9,24
074 Mühlbach,16,,17,17,34
074 Mühlbach,17,,16,21,37
074 Mühlbach,18,,20,17,37
074 Mühlbach,19,,25,25,50
074 Mühlbach,20,,23,18,41
074 Mühlbach,21,,17,15,32
074 Mühlbach,22,,18,15,33
074 Mühlbach,23,,25,22,47
074 Mühlbach,24,,22,13,35
074 Mühlbach,25,,19,26,45
074 Mühlbach,26,,18,21,39
074 Mühlbach,27,,18,17,35
074 Mühlbach,28,,21,19,40
074 Mühlbach,29,,22,18,40
074 Mühlbach,30,,23,23,46
074 Mühlbach,31,,24,11,35
074 Mühlbach,32,,26,32,58
074 Mühlbach,33,,37,20,57
074 Mühlbach,34,,21,18,39
074 Mühlbach,35,,27,17,44
074 Mühlbach,36,,18,23,41
074 Mühlbach,37,,14,21,35
074 Mühlbach,38,,22,18,40
074 Mühlbach,39,,22,16,38
074 Mühlbach,40,,25,23,48
074 Mühlbach,41,,23,14,37
074 Mühlbach,42,,21,18,39
074 Mühlbach,43,,18,13,31
074 Mühlbach,44,,16,20,36
074 Mühlbach,45,,19,22,41
074 Mühlbach,46,,20,17,37
074 Mühlbach,47,,13,20,33
074 Mühlbach,48,,19,17,36
074 Mühlbach,49,,16,21,37
074 Mühlbach,50,,13,22,35
074 Mühlbach,51,,20,18,38
074 Mühlbach,52,,12,14,26
074 Mühlbach,53,,17,12,29
074 Mühlbach,54,,11,19,30
074 Mühlbach,55,,23,12,35
074 Mühlbach,56,,9,8,17
074 Mühlbach,57,,14,13,27
074 Mühlbach,58,,13,10,23
074 Mühlbach,59,,17,13,30
074 Mühlbach,60,,19,15,34
074 Mühlbach,61,,14,10,24
074 Mühlbach,62,,13,16,29
074 Mühlbach,63,,16,8,24
074 Mühlbach,64,,6,12,18
074 Mühlbach,65,,7,7,14
074 Mühlbach,66,,7,11,18
074 Mühlbach,67,,13,12,25
074 Mühlbach,68,,9,10,19
074 Mühlbach,69,,7,10,17
074 Mühlbach,70,,8,12,20
074 Mühlbach,71,,13,6,19
074 Mühlbach,72,,8,3,11
074 Mühlbach,73,,12,19,31
074 Mühlbach,74,,5,10,15
074 Mühlbach,75,,9,8,17
074 Mühlbach,76,,6,7,13
074 Mühlbach,77,,6,7,13
074 Mühlbach,78,,5,12,17
074 Mühlbach,79,,5,12,17
074 Mühlbach,80,,4,6,10
074 Mühlbach,81,,4,9,13
074 Mühlbach,82,,2,10,12
074 Mühlbach,83,,-,2,2
074 Mühlbach,84,,1,4,5
074 Mühlbach,85,,-,1,1
074 Mühlbach,86,,-,2,2
074 Mühlbach,87,,3,5,8
074 Mühlbach,88,,1,4,5
074 Mühlbach,89,,-,1,1
074 Mühlbach,90,,-,1,1
074 Mühlbach,91,,1,2,3
074 Mühlbach,94,,-,1,1
074 Mühlbach,95,,-,3,3
074 Mühlbach,96,,1,1,2
075 Rodeneck,0,,9,5,14
075 Rodeneck,1,,4,15,19
075 Rodeneck,2,,7,8,15
075 Rodeneck,3,,11,6,17
075 Rodeneck,4,,11,7,18
075 Rodeneck,5,,13,10,23
075 Rodeneck,6,,5,10,15
075 Rodeneck,7,,8,10,18
075 Rodeneck,8,,7,7,14
075 Rodeneck,9,,9,10,19
075 Rodeneck,10,,6,9,15
075 Rodeneck,11,,12,8,20
075 Rodeneck,12,,7,6,13
075 Rodeneck,13,,14,9,23
075 Rodeneck,14,,6,5,11
075 Rodeneck,15,,10,11,21
075 Rodeneck,16,,12,9,21
075 Rodeneck,17,,15,10,25
075 Rodeneck,18,,11,7,18
075 Rodeneck,19,,7,6,13
075 Rodeneck,20,,10,6,16
075 Rodeneck,21,,6,10,16
075 Rodeneck,22,,8,7,15
075 Rodeneck,23,,6,8,14
075 Rodeneck,24,,7,9,16
075 Rodeneck,25,,7,7,14
075 Rodeneck,26,,9,5,14
075 Rodeneck,27,,8,7,15
075 Rodeneck,28,,15,9,24
075 Rodeneck,29,,9,11,20
075 Rodeneck,30,,14,6,20
075 Rodeneck,31,,12,12,24
075 Rodeneck,32,,16,10,26
075 Rodeneck,33,,11,12,23
075 Rodeneck,34,,12,11,23
075 Rodeneck,35,,13,8,21
075 Rodeneck,36,,8,6,14
075 Rodeneck,37,,9,10,19
075 Rodeneck,38,,8,10,18
075 Rodeneck,39,,9,12,21
075 Rodeneck,40,,9,11,20
075 Rodeneck,41,,5,10,15
075 Rodeneck,42,,11,6,17
075 Rodeneck,43,,9,5,14
075 Rodeneck,44,,6,6,12
075 Rodeneck,45,,9,4,13
075 Rodeneck,46,,6,6,12
075 Rodeneck,47,,11,3,14
075 Rodeneck,48,,4,1,5
075 Rodeneck,49,,8,5,13
075 Rodeneck,50,,3,3,6
075 Rodeneck,51,,2,7,9
075 Rodeneck,52,,3,7,10
075 Rodeneck,53,,4,7,11
075 Rodeneck,54,,6,3,9
075 Rodeneck,55,,10,7,17
075 Rodeneck,56,,-,5,5
075 Rodeneck,57,,5,5,10
075 Rodeneck,58,,3,2,5
075 Rodeneck,59,,3,6,9
075 Rodeneck,60,,9,3,12
075 Rodeneck,61,,5,4,9
075 Rodeneck,62,,3,9,12
075 Rodeneck,63,,3,3,6
075 Rodeneck,64,,2,5,7
075 Rodeneck,65,,4,5,9
075 Rodeneck,66,,5,2,7
075 Rodeneck,67,,1,12,13
075 Rodeneck,68,,3,2,5
075 Rodeneck,69,,5,5,10
075 Rodeneck,70,,6,5,11
075 Rodeneck,71,,4,4,8
075 Rodeneck,72,,8,2,10
075 Rodeneck,73,,5,5,10
075 Rodeneck,74,,5,5,10
075 Rodeneck,75,,4,5,9
075 Rodeneck,76,,2,9,11
075 Rodeneck,77,,4,5,9
075 Rodeneck,78,,2,2,4
075 Rodeneck,79,,2,3,5
075 Rodeneck,80,,2,1,3
075 Rodeneck,81,,2,2,4
075 Rodeneck,82,,4,2,6
075 Rodeneck,83,,-,3,3
075 Rodeneck,84,,-,1,1
075 Rodeneck,85,,1,1,2
075 Rodeneck,86,,1,-,1
075 Rodeneck,87,,1,1,2
075 Rodeneck,88,,1,1,2
075 Rodeneck,89,,1,-,1
075 Rodeneck,90,,-,1,1
075 Rodeneck,91,,3,-,3
075 Rodeneck,93,,-,1,1
075 Rodeneck,98,,1,-,1
076 Salurn,0,,10,11,21
076 Salurn,1,,14,17,31
076 Salurn,2,,20,12,32
076 Salurn,3,,17,23,40
076 Salurn,4,,16,11,27
076 Salurn,5,,20,20,40
076 Salurn,6,,18,10,28
076 Salurn,7,,21,19,40
076 Salurn,8,,16,13,29
076 Salurn,9,,22,18,40
076 Salurn,10,,11,13,24
076 Salurn,11,,11,14,25
076 Salurn,12,,18,18,36
076 Salurn,13,,18,20,38
076 Salurn,14,,20,14,34
076 Salurn,15,,12,16,28
076 Salurn,16,,18,16,34
076 Salurn,17,,13,14,27
076 Salurn,18,,11,17,28
076 Salurn,19,,17,13,30
076 Salurn,20,,15,14,29
076 Salurn,21,,19,17,36
076 Salurn,22,,9,16,25
076 Salurn,23,,15,11,26
076 Salurn,24,,21,19,40
076 Salurn,25,,16,17,33
076 Salurn,26,,17,20,37
076 Salurn,27,,13,20,33
076 Salurn,28,,19,20,39
076 Salurn,29,,25,25,50
076 Salurn,30,,31,20,51
076 Salurn,31,,25,26,51
076 Salurn,32,,26,26,52
076 Salurn,33,,30,19,49
076 Salurn,34,,22,25,47
076 Salurn,35,,26,23,49
076 Salurn,36,,27,23,50
076 Salurn,37,,35,29,64
076 Salurn,38,,39,23,62
076 Salurn,39,,32,21,53
076 Salurn,40,,30,33,63
076 Salurn,41,,21,30,51
076 Salurn,42,,27,29,56
076 Salurn,43,,28,18,46
076 Salurn,44,,18,23,41
076 Salurn,45,,20,14,34
076 Salurn,46,,19,20,39
076 Salurn,47,,26,18,44
076 Salurn,48,,16,15,31
076 Salurn,49,,27,19,46
076 Salurn,50,,27,19,46
076 Salurn,51,,24,14,38
076 Salurn,52,,26,12,38
076 Salurn,53,,16,20,36
076 Salurn,54,,18,17,35
076 Salurn,55,,20,16,36
076 Salurn,56,,13,10,23
076 Salurn,57,,20,19,39
076 Salurn,58,,18,17,35
076 Salurn,59,,19,16,35
076 Salurn,60,,19,15,34
076 Salurn,61,,14,10,24
076 Salurn,62,,10,11,21
076 Salurn,63,,6,13,19
076 Salurn,64,,11,12,23
076 Salurn,65,,12,22,34
076 Salurn,66,,18,17,35
076 Salurn,67,,11,6,17
076 Salurn,68,,11,7,18
076 Salurn,69,,10,20,30
076 Salurn,70,,7,11,18
076 Salurn,71,,10,10,20
076 Salurn,72,,21,13,34
076 Salurn,73,,11,23,34
076 Salurn,74,,5,21,26
076 Salurn,75,,7,15,22
076 Salurn,76,,6,23,29
076 Salurn,77,,8,16,24
076 Salurn,78,,6,10,16
076 Salurn,79,,10,22,32
076 Salurn,80,,4,17,21
076 Salurn,81,,10,12,22
076 Salurn,82,,7,14,21
076 Salurn,83,,5,4,9
076 Salurn,84,,1,4,5
076 Salurn,85,,2,7,9
076 Salurn,86,,5,6,11
076 Salurn,87,,4,8,12
076 Salurn,88,,2,3,5
076 Salurn,89,,3,5,8
076 Salurn,90,,-,4,4
076 Salurn,91,,1,3,4
076 Salurn,92,,-,2,2
076 Salurn,93,,1,4,5
076 Salurn,95,,-,1,1
076 Salurn,96,,-,1,1
077 Innichen,0,,25,20,45
077 Innichen,1,,19,12,31
077 Innichen,2,,15,16,31
077 Innichen,3,,21,12,33
077 Innichen,4,,20,16,36
077 Innichen,5,,16,17,33
077 Innichen,6,,21,11,32
077 Innichen,7,,18,16,34
077 Innichen,8,,22,21,43
077 Innichen,9,,24,16,40
077 Innichen,10,,19,24,43
077 Innichen,11,,18,14,32
077 Innichen,12,,19,22,41
077 Innichen,13,,28,19,47
077 Innichen,14,,22,20,42
077 Innichen,15,,20,17,37
077 Innichen,16,,20,20,40
077 Innichen,17,,21,20,41
077 Innichen,18,,22,16,38
077 Innichen,19,,18,23,41
077 Innichen,20,,13,20,33
077 Innichen,21,,23,16,39
077 Innichen,22,,24,22,46
077 Innichen,23,,10,15,25
077 Innichen,24,,16,26,42
077 Innichen,25,,18,27,45
077 Innichen,26,,21,7,28
077 Innichen,27,,26,21,47
077 Innichen,28,,22,25,47
077 Innichen,29,,27,27,54
077 Innichen,30,,21,16,37
077 Innichen,31,,24,26,50
077 Innichen,32,,27,26,53
077 Innichen,33,,30,32,62
077 Innichen,34,,21,26,47
077 Innichen,35,,27,33,60
077 Innichen,36,,33,31,64
077 Innichen,37,,33,34,67
077 Innichen,38,,29,27,56
077 Innichen,39,,31,24,55
077 Innichen,40,,23,28,51
077 Innichen,41,,32,17,49
077 Innichen,42,,26,24,50
077 Innichen,43,,20,24,44
077 Innichen,44,,21,25,46
077 Innichen,45,,29,16,45
077 Innichen,46,,25,18,43
077 Innichen,47,,24,12,36
077 Innichen,48,,23,17,40
077 Innichen,49,,13,26,39
077 Innichen,50,,12,19,31
077 Innichen,51,,19,21,40
077 Innichen,52,,21,17,38
077 Innichen,53,,17,11,28
077 Innichen,54,,12,15,27
077 Innichen,55,,15,15,30
077 Innichen,56,,11,8,19
077 Innichen,57,,8,13,21
077 Innichen,58,,23,9,32
077 Innichen,59,,17,18,35
077 Innichen,60,,14,16,30
077 Innichen,61,,11,23,34
077 Innichen,62,,14,12,26
077 Innichen,63,,8,11,19
077 Innichen,64,,12,11,23
077 Innichen,65,,9,18,27
077 Innichen,66,,9,19,28
077 Innichen,67,,11,13,24
077 Innichen,68,,11,10,21
077 Innichen,69,,17,16,33
077 Innichen,70,,14,22,36
077 Innichen,71,,16,12,28
077 Innichen,72,,13,17,30
077 Innichen,73,,11,19,30
077 Innichen,74,,6,12,18
077 Innichen,75,,17,11,28
077 Innichen,76,,8,21,29
077 Innichen,77,,9,4,13
077 Innichen,78,,7,12,19
077 Innichen,79,,4,13,17
077 Innichen,80,,9,14,23
077 Innichen,81,,7,12,19
077 Innichen,82,,3,2,5
077 Innichen,83,,1,5,6
077 Innichen,84,,1,2,3
077 Innichen,85,,2,3,5
077 Innichen,86,,4,5,9
077 Innichen,87,,3,2,5
077 Innichen,88,,3,4,7
077 Innichen,89,,1,6,7
077 Innichen,90,,-,2,2
077 Innichen,91,,1,-,1
077 Innichen,92,,1,2,3
077 Innichen,93,,-,4,4
077 Innichen,94,,1,1,2
077 Innichen,95,,-,1,1
077 Innichen,96,,-,1,1
077 Innichen,97,,-,1,1
077 Innichen,99,,-,2,2
079 Jenesien,0,,19,22,41
079 Jenesien,1,,19,15,34
079 Jenesien,2,,25,24,49
079 Jenesien,3,,15,26,41
079 Jenesien,4,,19,19,38
079 Jenesien,5,,24,11,35
079 Jenesien,6,,28,15,43
079 Jenesien,7,,21,23,44
079 Jenesien,8,,16,19,35
079 Jenesien,9,,27,23,50
079 Jenesien,10,,18,21,39
079 Jenesien,11,,18,15,33
079 Jenesien,12,,18,13,31
079 Jenesien,13,,24,16,40
079 Jenesien,14,,14,21,35
079 Jenesien,15,,16,16,32
079 Jenesien,16,,15,6,21
079 Jenesien,17,,19,14,33
079 Jenesien,18,,17,20,37
079 Jenesien,19,,13,23,36
079 Jenesien,20,,6,20,26
079 Jenesien,21,,14,22,36
079 Jenesien,22,,20,17,37
079 Jenesien,23,,12,14,26
079 Jenesien,24,,18,21,39
079 Jenesien,25,,16,14,30
079 Jenesien,26,,13,14,27
079 Jenesien,27,,19,18,37
079 Jenesien,28,,19,28,47
079 Jenesien,29,,21,21,42
079 Jenesien,30,,32,20,52
079 Jenesien,31,,27,27,54
079 Jenesien,32,,28,18,46
079 Jenesien,33,,19,31,50
079 Jenesien,34,,16,21,37
079 Jenesien,35,,36,28,64
079 Jenesien,36,,33,27,60
079 Jenesien,37,,34,33,67
079 Jenesien,38,,26,23,49
079 Jenesien,39,,28,22,50
079 Jenesien,40,,32,20,52
079 Jenesien,41,,26,12,38
079 Jenesien,42,,24,17,41
079 Jenesien,43,,21,10,31
079 Jenesien,44,,14,17,31
079 Jenesien,45,,17,14,31
079 Jenesien,46,,10,12,22
079 Jenesien,47,,16,15,31
079 Jenesien,48,,15,10,25
079 Jenesien,49,,14,20,34
079 Jenesien,50,,11,9,20
079 Jenesien,51,,12,21,33
079 Jenesien,52,,11,13,24
079 Jenesien,53,,12,7,19
079 Jenesien,54,,14,11,25
079 Jenesien,55,,10,12,22
079 Jenesien,56,,9,13,22
079 Jenesien,57,,13,14,27
079 Jenesien,58,,17,10,27
079 Jenesien,59,,16,10,26
079 Jenesien,60,,15,20,35
079 Jenesien,61,,17,11,28
079 Jenesien,62,,15,18,33
079 Jenesien,63,,22,9,31
079 Jenesien,64,,10,16,26
079 Jenesien,65,,6,18,24
079 Jenesien,66,,6,7,13
079 Jenesien,67,,8,7,15
079 Jenesien,68,,17,12,29
079 Jenesien,69,,8,10,18
079 Jenesien,70,,9,9,18
079 Jenesien,71,,7,15,22
079 Jenesien,72,,9,15,24
079 Jenesien,73,,11,10,21
079 Jenesien,74,,7,11,18
079 Jenesien,75,,10,14,24
079 Jenesien,76,,4,14,18
079 Jenesien,77,,8,10,18
079 Jenesien,78,,7,8,15
079 Jenesien,79,,7,9,16
079 Jenesien,80,,1,5,6
079 Jenesien,81,,3,8,11
079 Jenesien,82,,1,4,5
079 Jenesien,83,,-,1,1
079 Jenesien,84,,-,1,1
079 Jenesien,85,,2,1,3
079 Jenesien,86,,1,4,5
079 Jenesien,87,,2,3,5
079 Jenesien,88,,-,5,5
079 Jenesien,89,,1,4,5
079 Jenesien,90,,2,4,6
079 Jenesien,91,,-,1,1
079 Jenesien,92,,1,-,1
079 Jenesien,93,,2,2,4
079 Jenesien,96,,-,1,1
080 St.Leonhard in Pass.,0,,26,14,40
080 St.Leonhard in Pass.,1,,19,19,38
080 St.Leonhard in Pass.,2,,19,21,40
080 St.Leonhard in Pass.,3,,23,16,39
080 St.Leonhard in Pass.,4,,23,20,43
080 St.Leonhard in Pass.,5,,25,19,44
080 St.Leonhard in Pass.,6,,22,11,33
080 St.Leonhard in Pass.,7,,24,20,44
080 St.Leonhard in Pass.,8,,23,22,45
080 St.Leonhard in Pass.,9,,24,20,44
080 St.Leonhard in Pass.,10,,22,19,41
080 St.Leonhard in Pass.,11,,25,21,46
080 St.Leonhard in Pass.,12,,35,30,65
080 St.Leonhard in Pass.,13,,22,29,51
080 St.Leonhard in Pass.,14,,30,25,55
080 St.Leonhard in Pass.,15,,34,33,67
080 St.Leonhard in Pass.,16,,23,27,50
080 St.Leonhard in Pass.,17,,30,25,55
080 St.Leonhard in Pass.,18,,28,27,55
080 St.Leonhard in Pass.,19,,31,21,52
080 St.Leonhard in Pass.,20,,23,27,50
080 St.Leonhard in Pass.,21,,26,35,61
080 St.Leonhard in Pass.,22,,26,25,51
080 St.Leonhard in Pass.,23,,31,20,51
080 St.Leonhard in Pass.,24,,35,26,61
080 St.Leonhard in Pass.,25,,19,28,47
080 St.Leonhard in Pass.,26,,25,14,39
080 St.Leonhard in Pass.,27,,33,32,65
080 St.Leonhard in Pass.,28,,34,33,67
080 St.Leonhard in Pass.,29,,33,27,60
080 St.Leonhard in Pass.,30,,32,22,54
080 St.Leonhard in Pass.,31,,27,24,51
080 St.Leonhard in Pass.,32,,26,22,48
080 St.Leonhard in Pass.,33,,33,24,57
080 St.Leonhard in Pass.,34,,28,26,54
080 St.Leonhard in Pass.,35,,30,36,66
080 St.Leonhard in Pass.,36,,32,29,61
080 St.Leonhard in Pass.,37,,25,31,56
080 St.Leonhard in Pass.,38,,24,28,52
080 St.Leonhard in Pass.,39,,23,30,53
080 St.Leonhard in Pass.,40,,29,22,51
080 St.Leonhard in Pass.,41,,29,18,47
080 St.Leonhard in Pass.,42,,27,28,55
080 St.Leonhard in Pass.,43,,24,21,45
080 St.Leonhard in Pass.,44,,21,27,48
080 St.Leonhard in Pass.,45,,24,17,41
080 St.Leonhard in Pass.,46,,25,19,44
080 St.Leonhard in Pass.,47,,21,16,37
080 St.Leonhard in Pass.,48,,30,25,55
080 St.Leonhard in Pass.,49,,22,27,49
080 St.Leonhard in Pass.,50,,26,16,42
080 St.Leonhard in Pass.,51,,19,15,34
080 St.Leonhard in Pass.,52,,25,12,37
080 St.Leonhard in Pass.,53,,22,13,35
080 St.Leonhard in Pass.,54,,18,16,34
080 St.Leonhard in Pass.,55,,16,19,35
080 St.Leonhard in Pass.,56,,11,11,22
080 St.Leonhard in Pass.,57,,16,13,29
080 St.Leonhard in Pass.,58,,10,25,35
080 St.Leonhard in Pass.,59,,8,16,24
080 St.Leonhard in Pass.,60,,15,15,30
080 St.Leonhard in Pass.,61,,23,14,37
080 St.Leonhard in Pass.,62,,20,19,39
080 St.Leonhard in Pass.,63,,12,13,25
080 St.Leonhard in Pass.,64,,20,9,29
080 St.Leonhard in Pass.,65,,19,11,30
080 St.Leonhard in Pass.,66,,12,15,27
080 St.Leonhard in Pass.,67,,11,15,26
080 St.Leonhard in Pass.,68,,13,16,29
080 St.Leonhard in Pass.,69,,10,12,22
080 St.Leonhard in Pass.,70,,7,14,21
080 St.Leonhard in Pass.,71,,8,11,19
080 St.Leonhard in Pass.,72,,9,11,20
080 St.Leonhard in Pass.,73,,6,14,20
080 St.Leonhard in Pass.,74,,5,16,21
080 St.Leonhard in Pass.,75,,6,13,19
080 St.Leonhard in Pass.,76,,7,11,18
080 St.Leonhard in Pass.,77,,5,10,15
080 St.Leonhard in Pass.,78,,7,15,22
080 St.Leonhard in Pass.,79,,6,10,16
080 St.Leonhard in Pass.,80,,4,8,12
080 St.Leonhard in Pass.,81,,5,9,14
080 St.Leonhard in Pass.,82,,4,3,7
080 St.Leonhard in Pass.,83,,1,3,4
080 St.Leonhard in Pass.,84,,-,6,6
080 St.Leonhard in Pass.,85,,1,-,1
080 St.Leonhard in Pass.,86,,2,4,6
080 St.Leonhard in Pass.,87,,1,9,10
080 St.Leonhard in Pass.,88,,1,4,5
080 St.Leonhard in Pass.,89,,1,7,8
080 St.Leonhard in Pass.,90,,1,4,5
080 St.Leonhard in Pass.,91,,-,1,1
080 St.Leonhard in Pass.,92,,-,2,2
080 St.Leonhard in Pass.,93,,2,1,3
080 St.Leonhard in Pass.,94,,1,2,3
080 St.Leonhard in Pass.,96,,-,1,1
080 St.Leonhard in Pass.,97,,-,1,1
081 St.Lorenzen,0,,30,18,48
081 St.Lorenzen,1,,22,21,43
081 St.Lorenzen,2,,30,32,62
081 St.Lorenzen,3,,28,25,53
081 St.Lorenzen,4,,14,28,42
081 St.Lorenzen,5,,31,27,58
081 St.Lorenzen,6,,24,13,37
081 St.Lorenzen,7,,32,20,52
081 St.Lorenzen,8,,21,30,51
081 St.Lorenzen,9,,25,20,45
081 St.Lorenzen,10,,20,15,35
081 St.Lorenzen,11,,24,21,45
081 St.Lorenzen,12,,18,18,36
081 St.Lorenzen,13,,19,26,45
081 St.Lorenzen,14,,22,23,45
081 St.Lorenzen,15,,24,20,44
081 St.Lorenzen,16,,25,21,46
081 St.Lorenzen,17,,27,26,53
081 St.Lorenzen,18,,22,20,42
081 St.Lorenzen,19,,30,20,50
081 St.Lorenzen,20,,21,20,41
081 St.Lorenzen,21,,16,18,34
081 St.Lorenzen,22,,25,28,53
081 St.Lorenzen,23,,24,23,47
081 St.Lorenzen,24,,27,21,48
081 St.Lorenzen,25,,24,22,46
081 St.Lorenzen,26,,19,27,46
081 St.Lorenzen,27,,21,28,49
081 St.Lorenzen,28,,33,23,56
081 St.Lorenzen,29,,33,33,66
081 St.Lorenzen,30,,32,21,53
081 St.Lorenzen,31,,24,29,53
081 St.Lorenzen,32,,30,29,59
081 St.Lorenzen,33,,40,34,74
081 St.Lorenzen,34,,32,38,70
081 St.Lorenzen,35,,35,35,70
081 St.Lorenzen,36,,41,23,64
081 St.Lorenzen,37,,28,23,51
081 St.Lorenzen,38,,34,32,66
081 St.Lorenzen,39,,25,34,59
081 St.Lorenzen,40,,22,40,62
081 St.Lorenzen,41,,31,21,52
081 St.Lorenzen,42,,32,28,60
081 St.Lorenzen,43,,30,32,62
081 St.Lorenzen,44,,27,28,55
081 St.Lorenzen,45,,27,27,54
081 St.Lorenzen,46,,17,19,36
081 St.Lorenzen,47,,19,20,39
081 St.Lorenzen,48,,23,17,40
081 St.Lorenzen,49,,20,13,33
081 St.Lorenzen,50,,18,16,34
081 St.Lorenzen,51,,16,18,34
081 St.Lorenzen,52,,13,21,34
081 St.Lorenzen,53,,14,13,27
081 St.Lorenzen,54,,22,9,31
081 St.Lorenzen,55,,20,11,31
081 St.Lorenzen,56,,13,19,32
081 St.Lorenzen,57,,17,17,34
081 St.Lorenzen,58,,14,16,30
081 St.Lorenzen,59,,18,25,43
081 St.Lorenzen,60,,20,18,38
081 St.Lorenzen,61,,14,13,27
081 St.Lorenzen,62,,15,19,34
081 St.Lorenzen,63,,15,15,30
081 St.Lorenzen,64,,18,16,34
081 St.Lorenzen,65,,13,16,29
081 St.Lorenzen,66,,10,16,26
081 St.Lorenzen,67,,15,14,29
081 St.Lorenzen,68,,12,12,24
081 St.Lorenzen,69,,13,12,25
081 St.Lorenzen,70,,11,15,26
081 St.Lorenzen,71,,9,9,18
081 St.Lorenzen,72,,11,20,31
081 St.Lorenzen,73,,12,17,29
081 St.Lorenzen,74,,10,6,16
081 St.Lorenzen,75,,10,11,21
081 St.Lorenzen,76,,8,18,26
081 St.Lorenzen,77,,3,11,14
081 St.Lorenzen,78,,9,12,21
081 St.Lorenzen,79,,5,7,12
081 St.Lorenzen,80,,6,5,11
081 St.Lorenzen,81,,1,7,8
081 St.Lorenzen,82,,4,7,11
081 St.Lorenzen,83,,2,6,8
081 St.Lorenzen,84,,-,3,3
081 St.Lorenzen,85,,1,1,2
081 St.Lorenzen,86,,1,2,3
081 St.Lorenzen,87,,5,3,8
081 St.Lorenzen,88,,1,2,3
081 St.Lorenzen,89,,1,2,3
081 St.Lorenzen,90,,1,3,4
081 St.Lorenzen,91,,1,1,2
081 St.Lorenzen,92,,1,-,1
081 St.Lorenzen,94,,-,2,2
081 St.Lorenzen,96,,-,1,1
081 St.Lorenzen,98,,-,1,1
082 St.Martin in Thurn,0,,10,13,23
082 St.Martin in Thurn,1,,10,9,19
082 St.Martin in Thurn,2,,9,22,31
082 St.Martin in Thurn,3,,11,11,22
082 St.Martin in Thurn,4,,17,13,30
082 St.Martin in Thurn,5,,24,15,39
082 St.Martin in Thurn,6,,15,11,26
082 St.Martin in Thurn,7,,15,8,23
082 St.Martin in Thurn,8,,9,9,18
082 St.Martin in Thurn,9,,16,14,30
082 St.Martin in Thurn,10,,11,11,22
082 St.Martin in Thurn,11,,6,16,22
082 St.Martin in Thurn,12,,16,15,31
082 St.Martin in Thurn,13,,9,6,15
082 St.Martin in Thurn,14,,14,12,26
082 St.Martin in Thurn,15,,13,10,23
082 St.Martin in Thurn,16,,12,14,26
082 St.Martin in Thurn,17,,9,6,15
082 St.Martin in Thurn,18,,14,9,23
082 St.Martin in Thurn,19,,14,13,27
082 St.Martin in Thurn,20,,17,8,25
082 St.Martin in Thurn,21,,8,12,20
082 St.Martin in Thurn,22,,9,12,21
082 St.Martin in Thurn,23,,17,8,25
082 St.Martin in Thurn,24,,13,12,25
082 St.Martin in Thurn,25,,12,9,21
082 St.Martin in Thurn,26,,6,14,20
082 St.Martin in Thurn,27,,6,11,17
082 St.Martin in Thurn,28,,13,11,24
082 St.Martin in Thurn,29,,13,9,22
082 St.Martin in Thurn,30,,16,14,30
082 St.Martin in Thurn,31,,14,15,29
082 St.Martin in Thurn,32,,15,16,31
082 St.Martin in Thurn,33,,13,18,31
082 St.Martin in Thurn,34,,11,10,21
082 St.Martin in Thurn,35,,15,23,38
082 St.Martin in Thurn,36,,14,22,36
082 St.Martin in Thurn,37,,13,15,28
082 St.Martin in Thurn,38,,15,14,29
082 St.Martin in Thurn,39,,16,15,31
082 St.Martin in Thurn,40,,14,21,35
082 St.Martin in Thurn,41,,15,6,21
082 St.Martin in Thurn,42,,12,12,24
082 St.Martin in Thurn,43,,13,8,21
082 St.Martin in Thurn,44,,12,10,22
082 St.Martin in Thurn,45,,7,7,14
082 St.Martin in Thurn,46,,13,9,22
082 St.Martin in Thurn,47,,9,8,17
082 St.Martin in Thurn,48,,5,12,17
082 St.Martin in Thurn,49,,3,3,6
082 St.Martin in Thurn,50,,8,8,16
082 St.Martin in Thurn,51,,11,6,17
082 St.Martin in Thurn,52,,4,7,11
082 St.Martin in Thurn,53,,10,6,16
082 St.Martin in Thurn,54,,9,6,15
082 St.Martin in Thurn,55,,9,8,17
082 St.Martin in Thurn,56,,7,4,11
082 St.Martin in Thurn,57,,11,8,19
082 St.Martin in Thurn,58,,4,8,12
082 St.Martin in Thurn,59,,7,5,12
082 St.Martin in Thurn,60,,7,7,14
082 St.Martin in Thurn,61,,5,5,10
082 St.Martin in Thurn,62,,5,8,13
082 St.Martin in Thurn,63,,9,7,16
082 St.Martin in Thurn,64,,7,12,19
082 St.Martin in Thurn,65,,4,5,9
082 St.Martin in Thurn,66,,7,5,12
082 St.Martin in Thurn,67,,7,4,11
082 St.Martin in Thurn,68,,2,11,13
082 St.Martin in Thurn,69,,8,7,15
082 St.Martin in Thurn,70,,10,7,17
082 St.Martin in Thurn,71,,8,6,14
082 St.Martin in Thurn,72,,6,8,14
082 St.Martin in Thurn,73,,4,6,10
082 St.Martin in Thurn,74,,5,5,10
082 St.Martin in Thurn,75,,8,5,13
082 St.Martin in Thurn,76,,8,3,11
082 St.Martin in Thurn,77,,8,9,17
082 St.Martin in Thurn,78,,4,8,12
082 St.Martin in Thurn,79,,7,4,11
082 St.Martin in Thurn,80,,7,4,11
082 St.Martin in Thurn,81,,7,7,14
082 St.Martin in Thurn,82,,2,4,6
082 St.Martin in Thurn,83,,2,-,2
082 St.Martin in Thurn,84,,2,2,4
082 St.Martin in Thurn,85,,1,2,3
082 St.Martin in Thurn,86,,2,2,4
082 St.Martin in Thurn,87,,-,3,3
082 St.Martin in Thurn,88,,1,1,2
082 St.Martin in Thurn,89,,1,1,2
082 St.Martin in Thurn,90,,1,2,3
082 St.Martin in Thurn,91,,3,3,6
082 St.Martin in Thurn,92,,-,2,2
082 St.Martin in Thurn,93,,2,2,4
082 St.Martin in Thurn,97,,2,1,3
083 St.Martin in Passeier,0,,14,15,29
083 St.Martin in Passeier,1,,14,18,32
083 St.Martin in Passeier,2,,9,20,29
083 St.Martin in Passeier,3,,16,21,37
083 St.Martin in Passeier,4,,28,24,52
083 St.Martin in Passeier,5,,22,22,44
083 St.Martin in Passeier,6,,19,18,37
083 St.Martin in Passeier,7,,20,23,43
083 St.Martin in Passeier,8,,20,23,43
083 St.Martin in Passeier,9,,22,18,40
083 St.Martin in Passeier,10,,21,24,45
083 St.Martin in Passeier,11,,19,26,45
083 St.Martin in Passeier,12,,19,21,40
083 St.Martin in Passeier,13,,15,15,30
083 St.Martin in Passeier,14,,18,22,40
083 St.Martin in Passeier,15,,22,25,47
083 St.Martin in Passeier,16,,16,20,36
083 St.Martin in Passeier,17,,16,24,40
083 St.Martin in Passeier,18,,19,9,28
083 St.Martin in Passeier,19,,21,19,40
083 St.Martin in Passeier,20,,23,22,45
083 St.Martin in Passeier,21,,19,22,41
083 St.Martin in Passeier,22,,22,13,35
083 St.Martin in Passeier,23,,29,17,46
083 St.Martin in Passeier,24,,21,20,41
083 St.Martin in Passeier,25,,19,23,42
083 St.Martin in Passeier,26,,23,21,44
083 St.Martin in Passeier,27,,19,21,40
083 St.Martin in Passeier,28,,21,26,47
083 St.Martin in Passeier,29,,26,23,49
083 St.Martin in Passeier,30,,29,26,55
083 St.Martin in Passeier,31,,26,26,52
083 St.Martin in Passeier,32,,30,28,58
083 St.Martin in Passeier,33,,24,22,46
083 St.Martin in Passeier,34,,23,24,47
083 St.Martin in Passeier,35,,28,29,57
083 St.Martin in Passeier,36,,30,25,55
083 St.Martin in Passeier,37,,20,20,40
083 St.Martin in Passeier,38,,36,20,56
083 St.Martin in Passeier,39,,23,29,52
083 St.Martin in Passeier,40,,35,18,53
083 St.Martin in Passeier,41,,19,24,43
083 St.Martin in Passeier,42,,26,21,47
083 St.Martin in Passeier,43,,24,22,46
083 St.Martin in Passeier,44,,26,11,37
083 St.Martin in Passeier,45,,21,15,36
083 St.Martin in Passeier,46,,31,16,47
083 St.Martin in Passeier,47,,14,9,23
083 St.Martin in Passeier,48,,22,18,40
083 St.Martin in Passeier,49,,5,18,23
083 St.Martin in Passeier,50,,19,14,33
083 St.Martin in Passeier,51,,12,16,28
083 St.Martin in Passeier,52,,11,8,19
083 St.Martin in Passeier,53,,11,10,21
083 St.Martin in Passeier,54,,14,13,27
083 St.Martin in Passeier,55,,14,11,25
083 St.Martin in Passeier,56,,12,12,24
083 St.Martin in Passeier,57,,16,12,28
083 St.Martin in Passeier,58,,14,11,25
083 St.Martin in Passeier,59,,15,14,29
083 St.Martin in Passeier,60,,10,15,25
083 St.Martin in Passeier,61,,4,12,16
083 St.Martin in Passeier,62,,6,13,19
083 St.Martin in Passeier,63,,14,8,22
083 St.Martin in Passeier,64,,13,19,32
083 St.Martin in Passeier,65,,15,15,30
083 St.Martin in Passeier,66,,7,13,20
083 St.Martin in Passeier,67,,20,9,29
083 St.Martin in Passeier,68,,13,9,22
083 St.Martin in Passeier,69,,10,10,20
083 St.Martin in Passeier,70,,7,13,20
083 St.Martin in Passeier,71,,7,13,20
083 St.Martin in Passeier,72,,12,9,21
083 St.Martin in Passeier,73,,8,8,16
083 St.Martin in Passeier,74,,13,6,19
083 St.Martin in Passeier,75,,4,10,14
083 St.Martin in Passeier,76,,5,8,13
083 St.Martin in Passeier,77,,6,13,19
083 St.Martin in Passeier,78,,1,8,9
083 St.Martin in Passeier,79,,7,6,13
083 St.Martin in Passeier,80,,6,12,18
083 St.Martin in Passeier,81,,1,5,6
083 St.Martin in Passeier,82,,2,4,6
083 St.Martin in Passeier,83,,1,2,3
083 St.Martin in Passeier,84,,2,4,6
083 St.Martin in Passeier,85,,-,1,1
083 St.Martin in Passeier,86,,3,1,4
083 St.Martin in Passeier,87,,1,3,4
083 St.Martin in Passeier,88,,2,2,4
083 St.Martin in Passeier,89,,-,3,3
083 St.Martin in Passeier,90,,1,1,2
083 St.Martin in Passeier,91,,-,2,2
084 St.Pankraz,0,,12,15,27
084 St.Pankraz,1,,12,14,26
084 St.Pankraz,2,,8,5,13
084 St.Pankraz,3,,12,6,18
084 St.Pankraz,4,,9,12,21
084 St.Pankraz,5,,12,10,22
084 St.Pankraz,6,,10,5,15
084 St.Pankraz,7,,9,8,17
084 St.Pankraz,8,,6,11,17
084 St.Pankraz,9,,7,6,13
084 St.Pankraz,10,,13,12,25
084 St.Pankraz,11,,9,4,13
084 St.Pankraz,12,,11,14,25
084 St.Pankraz,13,,14,7,21
084 St.Pankraz,14,,10,8,18
084 St.Pankraz,15,,9,6,15
084 St.Pankraz,16,,9,7,16
084 St.Pankraz,17,,9,5,14
084 St.Pankraz,18,,10,6,16
084 St.Pankraz,19,,11,9,20
084 St.Pankraz,20,,9,14,23
084 St.Pankraz,21,,12,9,21
084 St.Pankraz,22,,6,6,12
084 St.Pankraz,23,,15,10,25
084 St.Pankraz,24,,8,15,23
084 St.Pankraz,25,,6,11,17
084 St.Pankraz,26,,10,9,19
084 St.Pankraz,27,,15,12,27
084 St.Pankraz,28,,13,10,23
084 St.Pankraz,29,,12,13,25
084 St.Pankraz,30,,18,9,27
084 St.Pankraz,31,,13,10,23
084 St.Pankraz,32,,21,14,35
084 St.Pankraz,33,,21,17,38
084 St.Pankraz,34,,13,14,27
084 St.Pankraz,35,,15,6,21
084 St.Pankraz,36,,24,14,38
084 St.Pankraz,37,,13,14,27
084 St.Pankraz,38,,10,10,20
084 St.Pankraz,39,,17,8,25
084 St.Pankraz,40,,14,12,26
084 St.Pankraz,41,,12,6,18
084 St.Pankraz,42,,17,12,29
084 St.Pankraz,43,,7,10,17
084 St.Pankraz,44,,11,9,20
084 St.Pankraz,45,,10,15,25
084 St.Pankraz,46,,7,5,12
084 St.Pankraz,47,,10,8,18
084 St.Pankraz,48,,10,9,19
084 St.Pankraz,49,,14,10,24
084 St.Pankraz,50,,5,3,8
084 St.Pankraz,51,,11,6,17
084 St.Pankraz,52,,7,6,13
084 St.Pankraz,53,,8,4,12
084 St.Pankraz,54,,7,8,15
084 St.Pankraz,55,,4,8,12
084 St.Pankraz,56,,3,6,9
084 St.Pankraz,57,,5,8,13
084 St.Pankraz,58,,10,15,25
084 St.Pankraz,59,,9,14,23
084 St.Pankraz,60,,8,12,20
084 St.Pankraz,61,,9,7,16
084 St.Pankraz,62,,10,7,17
084 St.Pankraz,63,,5,11,16
084 St.Pankraz,64,,9,10,19
084 St.Pankraz,65,,6,5,11
084 St.Pankraz,66,,5,7,12
084 St.Pankraz,67,,8,7,15
084 St.Pankraz,68,,8,3,11
084 St.Pankraz,69,,7,10,17
084 St.Pankraz,70,,9,5,14
084 St.Pankraz,71,,8,7,15
084 St.Pankraz,72,,8,10,18
084 St.Pankraz,73,,8,10,18
084 St.Pankraz,74,,7,5,12
084 St.Pankraz,75,,7,6,13
084 St.Pankraz,76,,7,8,15
084 St.Pankraz,77,,7,8,15
084 St.Pankraz,78,,10,4,14
084 St.Pankraz,79,,10,8,18
084 St.Pankraz,80,,2,11,13
084 St.Pankraz,81,,2,10,12
084 St.Pankraz,82,,2,2,4
084 St.Pankraz,83,,2,4,6
084 St.Pankraz,84,,-,4,4
084 St.Pankraz,85,,3,-,3
084 St.Pankraz,86,,2,2,4
084 St.Pankraz,87,,1,2,3
084 St.Pankraz,88,,1,1,2
084 St.Pankraz,89,,1,2,3
084 St.Pankraz,90,,1,1,2
084 St.Pankraz,91,,1,2,3
084 St.Pankraz,92,,-,4,4
084 St.Pankraz,96,,-,1,1
084 St.Pankraz,97,,1,-,1
085 St.Christina in Gröden,0,,10,11,21
085 St.Christina in Gröden,1,,19,14,33
085 St.Christina in Gröden,2,,21,11,32
085 St.Christina in Gröden,3,,13,14,27
085 St.Christina in Gröden,4,,11,11,22
085 St.Christina in Gröden,5,,13,6,19
085 St.Christina in Gröden,6,,14,9,23
085 St.Christina in Gröden,7,,7,14,21
085 St.Christina in Gröden,8,,13,14,27
085 St.Christina in Gröden,9,,13,13,26
085 St.Christina in Gröden,10,,11,16,27
085 St.Christina in Gröden,11,,7,13,20
085 St.Christina in Gröden,12,,5,6,11
085 St.Christina in Gröden,13,,10,10,20
085 St.Christina in Gröden,14,,12,6,18
085 St.Christina in Gröden,15,,11,8,19
085 St.Christina in Gröden,16,,5,11,16
085 St.Christina in Gröden,17,,10,5,15
085 St.Christina in Gröden,18,,18,13,31
085 St.Christina in Gröden,19,,12,6,18
085 St.Christina in Gröden,20,,8,13,21
085 St.Christina in Gröden,21,,10,13,23
085 St.Christina in Gröden,22,,12,10,22
085 St.Christina in Gröden,23,,5,9,14
085 St.Christina in Gröden,24,,3,8,11
085 St.Christina in Gröden,25,,13,9,22
085 St.Christina in Gröden,26,,12,15,27
085 St.Christina in Gröden,27,,6,15,21
085 St.Christina in Gröden,28,,7,13,20
085 St.Christina in Gröden,29,,18,9,27
085 St.Christina in Gröden,30,,9,11,20
085 St.Christina in Gröden,31,,21,18,39
085 St.Christina in Gröden,32,,18,11,29
085 St.Christina in Gröden,33,,25,23,48
085 St.Christina in Gröden,34,,16,17,33
085 St.Christina in Gröden,35,,18,13,31
085 St.Christina in Gröden,36,,14,17,31
085 St.Christina in Gröden,37,,11,21,32
085 St.Christina in Gröden,38,,15,17,32
085 St.Christina in Gröden,39,,20,15,35
085 St.Christina in Gröden,40,,21,14,35
085 St.Christina in Gröden,41,,18,17,35
085 St.Christina in Gröden,42,,9,9,18
085 St.Christina in Gröden,43,,7,11,18
085 St.Christina in Gröden,44,,16,11,27
085 St.Christina in Gröden,45,,10,10,20
085 St.Christina in Gröden,46,,9,9,18
085 St.Christina in Gröden,47,,16,14,30
085 St.Christina in Gröden,48,,9,9,18
085 St.Christina in Gröden,49,,5,6,11
085 St.Christina in Gröden,50,,11,5,16
085 St.Christina in Gröden,51,,6,6,12
085 St.Christina in Gröden,52,,7,12,19
085 St.Christina in Gröden,53,,8,5,13
085 St.Christina in Gröden,54,,6,9,15
085 St.Christina in Gröden,55,,9,11,20
085 St.Christina in Gröden,56,,6,6,12
085 St.Christina in Gröden,57,,6,11,17
085 St.Christina in Gröden,58,,12,15,27
085 St.Christina in Gröden,59,,11,7,18
085 St.Christina in Gröden,60,,13,8,21
085 St.Christina in Gröden,61,,9,11,20
085 St.Christina in Gröden,62,,10,11,21
085 St.Christina in Gröden,63,,7,8,15
085 St.Christina in Gröden,64,,9,6,15
085 St.Christina in Gröden,65,,13,10,23
085 St.Christina in Gröden,66,,13,5,18
085 St.Christina in Gröden,67,,8,12,20
085 St.Christina in Gröden,68,,6,13,19
085 St.Christina in Gröden,69,,9,9,18
085 St.Christina in Gröden,70,,5,7,12
085 St.Christina in Gröden,71,,14,5,19
085 St.Christina in Gröden,72,,4,10,14
085 St.Christina in Gröden,73,,6,5,11
085 St.Christina in Gröden,74,,5,6,11
085 St.Christina in Gröden,75,,9,7,16
085 St.Christina in Gröden,76,,7,9,16
085 St.Christina in Gröden,77,,2,4,6
085 St.Christina in Gröden,78,,6,4,10
085 St.Christina in Gröden,79,,-,10,10
085 St.Christina in Gröden,80,,2,4,6
085 St.Christina in Gröden,81,,2,5,7
085 St.Christina in Gröden,82,,4,1,5
085 St.Christina in Gröden,83,,-,1,1
085 St.Christina in Gröden,84,,1,-,1
085 St.Christina in Gröden,85,,-,3,3
085 St.Christina in Gröden,86,,2,1,3
085 St.Christina in Gröden,87,,1,4,5
085 St.Christina in Gröden,88,,2,-,2
085 St.Christina in Gröden,89,,-,1,1
085 St.Christina in Gröden,90,,-,1,1
085 St.Christina in Gröden,91,,-,1,1
085 St.Christina in Gröden,92,,-,2,2
085 St.Christina in Gröden,94,,-,1,1
085 St.Christina in Gröden,97,,-,1,1
086 Sarntal,0,,47,29,76
086 Sarntal,1,,36,45,81
086 Sarntal,2,,37,35,72
086 Sarntal,3,,51,44,95
086 Sarntal,4,,44,48,92
086 Sarntal,5,,48,42,90
086 Sarntal,6,,43,42,85
086 Sarntal,7,,34,41,75
086 Sarntal,8,,32,39,71
086 Sarntal,9,,46,35,81
086 Sarntal,10,,43,41,84
086 Sarntal,11,,44,33,77
086 Sarntal,12,,55,36,91
086 Sarntal,13,,45,43,88
086 Sarntal,14,,36,31,67
086 Sarntal,15,,39,43,82
086 Sarntal,16,,43,38,81
086 Sarntal,17,,38,42,80
086 Sarntal,18,,51,42,93
086 Sarntal,19,,62,50,112
086 Sarntal,20,,42,58,100
086 Sarntal,21,,58,46,104
086 Sarntal,22,,57,52,109
086 Sarntal,23,,56,55,111
086 Sarntal,24,,63,47,110
086 Sarntal,25,,54,43,97
086 Sarntal,26,,61,51,112
086 Sarntal,27,,51,62,113
086 Sarntal,28,,62,63,125
086 Sarntal,29,,71,39,110
086 Sarntal,30,,48,48,96
086 Sarntal,31,,66,61,127
086 Sarntal,32,,69,59,128
086 Sarntal,33,,51,45,96
086 Sarntal,34,,55,47,102
086 Sarntal,35,,54,52,106
086 Sarntal,36,,68,51,119
086 Sarntal,37,,62,60,122
086 Sarntal,38,,44,44,88
086 Sarntal,39,,63,34,97
086 Sarntal,40,,39,47,86
086 Sarntal,41,,64,46,110
086 Sarntal,42,,45,40,85
086 Sarntal,43,,53,43,96
086 Sarntal,44,,39,44,83
086 Sarntal,45,,43,31,74
086 Sarntal,46,,40,39,79
086 Sarntal,47,,36,28,64
086 Sarntal,48,,42,30,72
086 Sarntal,49,,40,42,82
086 Sarntal,50,,45,34,79
086 Sarntal,51,,37,35,72
086 Sarntal,52,,51,25,76
086 Sarntal,53,,35,38,73
086 Sarntal,54,,41,28,69
086 Sarntal,55,,37,37,74
086 Sarntal,56,,29,31,60
086 Sarntal,57,,28,31,59
086 Sarntal,58,,41,42,83
086 Sarntal,59,,40,39,79
086 Sarntal,60,,35,34,69
086 Sarntal,61,,30,44,74
086 Sarntal,62,,40,32,72
086 Sarntal,63,,34,28,62
086 Sarntal,64,,26,34,60
086 Sarntal,65,,22,24,46
086 Sarntal,66,,25,25,50
086 Sarntal,67,,27,19,46
086 Sarntal,68,,23,24,47
086 Sarntal,69,,30,27,57
086 Sarntal,70,,19,25,44
086 Sarntal,71,,19,25,44
086 Sarntal,72,,20,30,50
086 Sarntal,73,,23,28,51
086 Sarntal,74,,19,32,51
086 Sarntal,75,,21,15,36
086 Sarntal,76,,19,23,42
086 Sarntal,77,,16,25,41
086 Sarntal,78,,11,24,35
086 Sarntal,79,,14,32,46
086 Sarntal,80,,8,13,21
086 Sarntal,81,,12,18,30
086 Sarntal,82,,3,19,22
086 Sarntal,83,,4,11,15
086 Sarntal,84,,3,9,12
086 Sarntal,85,,-,8,8
086 Sarntal,86,,2,7,9
086 Sarntal,87,,6,7,13
086 Sarntal,88,,8,11,19
086 Sarntal,89,,3,10,13
086 Sarntal,90,,2,4,6
086 Sarntal,91,,1,8,9
086 Sarntal,92,,1,4,5
086 Sarntal,93,,-,1,1
086 Sarntal,94,,1,5,6
086 Sarntal,95,,2,-,2
086 Sarntal,96,,-,1,1
086 Sarntal,97,,-,1,1
086 Sarntal,100,,-,1,1
087 Schenna,0,,20,12,32
087 Schenna,1,,22,18,40
087 Schenna,2,,21,17,38
087 Schenna,3,,18,11,29
087 Schenna,4,,12,18,30
087 Schenna,5,,16,16,32
087 Schenna,6,,17,16,33
087 Schenna,7,,21,17,38
087 Schenna,8,,15,9,24
087 Schenna,9,,16,16,32
087 Schenna,10,,12,19,31
087 Schenna,11,,19,15,34
087 Schenna,12,,20,10,30
087 Schenna,13,,21,19,40
087 Schenna,14,,22,17,39
087 Schenna,15,,18,13,31
087 Schenna,16,,16,16,32
087 Schenna,17,,16,13,29
087 Schenna,18,,16,14,30
087 Schenna,19,,11,16,27
087 Schenna,20,,23,9,32
087 Schenna,21,,19,19,38
087 Schenna,22,,24,21,45
087 Schenna,23,,15,17,32
087 Schenna,24,,17,16,33
087 Schenna,25,,22,15,37
087 Schenna,26,,19,26,45
087 Schenna,27,,32,20,52
087 Schenna,28,,29,24,53
087 Schenna,29,,27,17,44
087 Schenna,30,,30,23,53
087 Schenna,31,,22,26,48
087 Schenna,32,,24,21,45
087 Schenna,33,,21,22,43
087 Schenna,34,,34,20,54
087 Schenna,35,,14,21,35
087 Schenna,36,,23,27,50
087 Schenna,37,,22,23,45
087 Schenna,38,,27,20,47
087 Schenna,39,,23,13,36
087 Schenna,40,,30,20,50
087 Schenna,41,,32,24,56
087 Schenna,42,,15,13,28
087 Schenna,43,,20,19,39
087 Schenna,44,,12,19,31
087 Schenna,45,,17,16,33
087 Schenna,46,,12,15,27
087 Schenna,47,,15,18,33
087 Schenna,48,,15,15,30
087 Schenna,49,,14,16,30
087 Schenna,50,,14,12,26
087 Schenna,51,,20,15,35
087 Schenna,52,,20,19,39
087 Schenna,53,,15,15,30
087 Schenna,54,,15,17,32
087 Schenna,55,,18,23,41
087 Schenna,56,,14,13,27
087 Schenna,57,,17,10,27
087 Schenna,58,,20,11,31
087 Schenna,59,,12,19,31
087 Schenna,60,,12,13,25
087 Schenna,61,,10,8,18
087 Schenna,62,,12,14,26
087 Schenna,63,,16,19,35
087 Schenna,64,,7,10,17
087 Schenna,65,,8,11,19
087 Schenna,66,,14,8,22
087 Schenna,67,,13,15,28
087 Schenna,68,,7,9,16
087 Schenna,69,,11,13,24
087 Schenna,70,,13,13,26
087 Schenna,71,,12,8,20
087 Schenna,72,,8,11,19
087 Schenna,73,,7,10,17
087 Schenna,74,,5,15,20
087 Schenna,75,,7,7,14
087 Schenna,76,,5,11,16
087 Schenna,77,,9,8,17
087 Schenna,78,,5,5,10
087 Schenna,79,,10,6,16
087 Schenna,80,,7,15,22
087 Schenna,81,,6,5,11
087 Schenna,82,,2,6,8
087 Schenna,83,,1,4,5
087 Schenna,84,,1,2,3
087 Schenna,85,,2,1,3
087 Schenna,86,,2,3,5
087 Schenna,87,,3,5,8
087 Schenna,88,,-,2,2
087 Schenna,89,,4,2,6
087 Schenna,91,,1,1,2
087 Schenna,92,,1,1,2
087 Schenna,93,,-,1,1
087 Schenna,95,,-,1,1
087 Schenna,97,,-,1,1
087 Schenna,101,,-,1,1
088 Mühlwald,0,,11,12,23
088 Mühlwald,1,,9,11,20
088 Mühlwald,2,,12,10,22
088 Mühlwald,3,,11,13,24
088 Mühlwald,4,,11,8,19
088 Mühlwald,5,,14,13,27
088 Mühlwald,6,,13,4,17
088 Mühlwald,7,,9,6,15
088 Mühlwald,8,,13,12,25
088 Mühlwald,9,,5,7,12
088 Mühlwald,10,,11,6,17
088 Mühlwald,11,,9,6,15
088 Mühlwald,12,,17,8,25
088 Mühlwald,13,,7,3,10
088 Mühlwald,14,,9,14,23
088 Mühlwald,15,,6,7,13
088 Mühlwald,16,,11,17,28
088 Mühlwald,17,,11,18,29
088 Mühlwald,18,,12,10,22
088 Mühlwald,19,,8,17,25
088 Mühlwald,20,,16,14,30
088 Mühlwald,21,,21,5,26
088 Mühlwald,22,,8,21,29
088 Mühlwald,23,,12,10,22
088 Mühlwald,24,,8,8,16
088 Mühlwald,25,,14,13,27
088 Mühlwald,26,,11,9,20
088 Mühlwald,27,,10,8,18
088 Mühlwald,28,,18,9,27
088 Mühlwald,29,,10,11,21
088 Mühlwald,30,,17,15,32
088 Mühlwald,31,,10,9,19
088 Mühlwald,32,,15,17,32
088 Mühlwald,33,,17,9,26
088 Mühlwald,34,,17,14,31
088 Mühlwald,35,,15,8,23
088 Mühlwald,36,,19,12,31
088 Mühlwald,37,,16,8,24
088 Mühlwald,38,,11,11,22
088 Mühlwald,39,,9,11,20
088 Mühlwald,40,,6,10,16
088 Mühlwald,41,,15,9,24
088 Mühlwald,42,,14,5,19
088 Mühlwald,43,,10,7,17
088 Mühlwald,44,,14,12,26
088 Mühlwald,45,,8,8,16
088 Mühlwald,46,,7,7,14
088 Mühlwald,47,,10,4,14
088 Mühlwald,48,,11,9,20
088 Mühlwald,49,,10,8,18
088 Mühlwald,50,,10,4,14
088 Mühlwald,51,,5,9,14
088 Mühlwald,52,,9,3,12
088 Mühlwald,53,,12,4,16
088 Mühlwald,54,,10,7,17
088 Mühlwald,55,,8,3,11
088 Mühlwald,56,,5,4,9
088 Mühlwald,57,,8,4,12
088 Mühlwald,58,,10,2,12
088 Mühlwald,59,,6,7,13
088 Mühlwald,60,,4,7,11
088 Mühlwald,61,,3,8,11
088 Mühlwald,62,,6,11,17
088 Mühlwald,63,,9,4,13
088 Mühlwald,64,,11,3,14
088 Mühlwald,65,,4,3,7
088 Mühlwald,66,,5,4,9
088 Mühlwald,67,,3,8,11
088 Mühlwald,68,,4,10,14
088 Mühlwald,69,,1,2,3
088 Mühlwald,70,,6,6,12
088 Mühlwald,71,,4,5,9
088 Mühlwald,72,,8,9,17
088 Mühlwald,73,,4,4,8
088 Mühlwald,74,,9,2,11
088 Mühlwald,75,,4,5,9
088 Mühlwald,76,,4,3,7
088 Mühlwald,77,,6,5,11
088 Mühlwald,78,,1,6,7
088 Mühlwald,79,,1,4,5
088 Mühlwald,80,,-,5,5
088 Mühlwald,81,,2,1,3
088 Mühlwald,82,,-,2,2
088 Mühlwald,83,,1,3,4
088 Mühlwald,84,,4,2,6
088 Mühlwald,85,,-,1,1
088 Mühlwald,86,,-,3,3
088 Mühlwald,87,,1,1,2
088 Mühlwald,88,,-,2,2
088 Mühlwald,90,,-,2,2
088 Mühlwald,93,,1,-,1
089 Wolkenstein in Gröden,0,,22,19,41
089 Wolkenstein in Gröden,1,,21,21,42
089 Wolkenstein in Gröden,2,,14,19,33
089 Wolkenstein in Gröden,3,,16,23,39
089 Wolkenstein in Gröden,4,,22,27,49
089 Wolkenstein in Gröden,5,,15,12,27
089 Wolkenstein in Gröden,6,,18,12,30
089 Wolkenstein in Gröden,7,,16,17,33
089 Wolkenstein in Gröden,8,,12,13,25
089 Wolkenstein in Gröden,9,,24,12,36
089 Wolkenstein in Gröden,10,,20,15,35
089 Wolkenstein in Gröden,11,,12,12,24
089 Wolkenstein in Gröden,12,,18,14,32
089 Wolkenstein in Gröden,13,,16,16,32
089 Wolkenstein in Gröden,14,,12,19,31
089 Wolkenstein in Gröden,15,,16,14,30
089 Wolkenstein in Gröden,16,,17,11,28
089 Wolkenstein in Gröden,17,,12,11,23
089 Wolkenstein in Gröden,18,,16,10,26
089 Wolkenstein in Gröden,19,,11,17,28
089 Wolkenstein in Gröden,20,,16,12,28
089 Wolkenstein in Gröden,21,,15,16,31
089 Wolkenstein in Gröden,22,,6,15,21
089 Wolkenstein in Gröden,23,,8,9,17
089 Wolkenstein in Gröden,24,,12,11,23
089 Wolkenstein in Gröden,25,,17,16,33
089 Wolkenstein in Gröden,26,,20,19,39
089 Wolkenstein in Gröden,27,,11,18,29
089 Wolkenstein in Gröden,28,,27,21,48
089 Wolkenstein in Gröden,29,,16,18,34
089 Wolkenstein in Gröden,30,,22,27,49
089 Wolkenstein in Gröden,31,,21,24,45
089 Wolkenstein in Gröden,32,,28,20,48
089 Wolkenstein in Gröden,33,,27,27,54
089 Wolkenstein in Gröden,34,,31,25,56
089 Wolkenstein in Gröden,35,,28,21,49
089 Wolkenstein in Gröden,36,,24,32,56
089 Wolkenstein in Gröden,37,,29,23,52
089 Wolkenstein in Gröden,38,,22,18,40
089 Wolkenstein in Gröden,39,,21,25,46
089 Wolkenstein in Gröden,40,,26,29,55
089 Wolkenstein in Gröden,41,,24,22,46
089 Wolkenstein in Gröden,42,,17,17,34
089 Wolkenstein in Gröden,43,,20,16,36
089 Wolkenstein in Gröden,44,,19,16,35
089 Wolkenstein in Gröden,45,,11,13,24
089 Wolkenstein in Gröden,46,,14,10,24
089 Wolkenstein in Gröden,47,,17,9,26
089 Wolkenstein in Gröden,48,,8,14,22
089 Wolkenstein in Gröden,49,,12,6,18
089 Wolkenstein in Gröden,50,,15,11,26
089 Wolkenstein in Gröden,51,,7,17,24
089 Wolkenstein in Gröden,52,,18,12,30
089 Wolkenstein in Gröden,53,,14,13,27
089 Wolkenstein in Gröden,54,,10,17,27
089 Wolkenstein in Gröden,55,,16,19,35
089 Wolkenstein in Gröden,56,,6,14,20
089 Wolkenstein in Gröden,57,,14,10,24
089 Wolkenstein in Gröden,58,,21,16,37
089 Wolkenstein in Gröden,59,,13,13,26
089 Wolkenstein in Gröden,60,,17,19,36
089 Wolkenstein in Gröden,61,,17,18,35
089 Wolkenstein in Gröden,62,,19,16,35
089 Wolkenstein in Gröden,63,,21,7,28
089 Wolkenstein in Gröden,64,,11,19,30
089 Wolkenstein in Gröden,65,,11,15,26
089 Wolkenstein in Gröden,66,,14,10,24
089 Wolkenstein in Gröden,67,,17,10,27
089 Wolkenstein in Gröden,68,,7,11,18
089 Wolkenstein in Gröden,69,,5,9,14
089 Wolkenstein in Gröden,70,,10,10,20
089 Wolkenstein in Gröden,71,,10,11,21
089 Wolkenstein in Gröden,72,,8,7,15
089 Wolkenstein in Gröden,73,,6,10,16
089 Wolkenstein in Gröden,74,,11,7,18
089 Wolkenstein in Gröden,75,,9,6,15
089 Wolkenstein in Gröden,76,,7,7,14
089 Wolkenstein in Gröden,77,,3,12,15
089 Wolkenstein in Gröden,78,,5,6,11
089 Wolkenstein in Gröden,79,,6,10,16
089 Wolkenstein in Gröden,80,,2,5,7
089 Wolkenstein in Gröden,81,,3,4,7
089 Wolkenstein in Gröden,82,,1,3,4
089 Wolkenstein in Gröden,83,,-,2,2
089 Wolkenstein in Gröden,84,,1,4,5
089 Wolkenstein in Gröden,85,,-,1,1
089 Wolkenstein in Gröden,86,,-,4,4
089 Wolkenstein in Gröden,87,,1,2,3
089 Wolkenstein in Gröden,88,,-,2,2
089 Wolkenstein in Gröden,89,,-,4,4
089 Wolkenstein in Gröden,90,,1,3,4
089 Wolkenstein in Gröden,91,,2,-,2
089 Wolkenstein in Gröden,92,,-,2,2
089 Wolkenstein in Gröden,93,,-,3,3
089 Wolkenstein in Gröden,94,,-,1,1
089 Wolkenstein in Gröden,97,,-,1,1
091 Schnals,0,,6,5,11
091 Schnals,1,,4,4,8
091 Schnals,2,,7,10,17
091 Schnals,3,,6,15,21
091 Schnals,4,,12,9,21
091 Schnals,5,,7,13,20
091 Schnals,6,,4,10,14
091 Schnals,7,,5,7,12
091 Schnals,8,,11,5,16
091 Schnals,9,,13,10,23
091 Schnals,10,,12,9,21
091 Schnals,11,,5,7,12
091 Schnals,12,,20,9,29
091 Schnals,13,,10,5,15
091 Schnals,14,,12,11,23
091 Schnals,15,,9,10,19
091 Schnals,16,,7,9,16
091 Schnals,17,,12,16,28
091 Schnals,18,,10,10,20
091 Schnals,19,,10,7,17
091 Schnals,20,,16,10,26
091 Schnals,21,,14,11,25
091 Schnals,22,,12,10,22
091 Schnals,23,,12,11,23
091 Schnals,24,,8,8,16
091 Schnals,25,,13,2,15
091 Schnals,26,,6,8,14
091 Schnals,27,,15,8,23
091 Schnals,28,,7,9,16
091 Schnals,29,,10,8,18
091 Schnals,30,,13,10,23
091 Schnals,31,,13,10,23
091 Schnals,32,,13,9,22
091 Schnals,33,,11,9,20
091 Schnals,34,,16,11,27
091 Schnals,35,,13,14,27
091 Schnals,36,,16,8,24
091 Schnals,37,,7,9,16
091 Schnals,38,,10,15,25
091 Schnals,39,,15,12,27
091 Schnals,40,,12,14,26
091 Schnals,41,,10,8,18
091 Schnals,42,,16,12,28
091 Schnals,43,,14,12,26
091 Schnals,44,,11,5,16
091 Schnals,45,,14,5,19
091 Schnals,46,,10,6,16
091 Schnals,47,,10,9,19
091 Schnals,48,,13,9,22
091 Schnals,49,,13,7,20
091 Schnals,50,,12,8,20
091 Schnals,51,,11,6,17
091 Schnals,52,,10,9,19
091 Schnals,53,,3,2,5
091 Schnals,54,,10,8,18
091 Schnals,55,,5,6,11
091 Schnals,56,,8,4,12
091 Schnals,57,,4,7,11
091 Schnals,58,,7,10,17
091 Schnals,59,,4,4,8
091 Schnals,60,,5,5,10
091 Schnals,61,,7,7,14
091 Schnals,62,,7,7,14
091 Schnals,63,,2,11,13
091 Schnals,64,,7,5,12
091 Schnals,65,,6,6,12
091 Schnals,66,,3,5,8
091 Schnals,67,,2,4,6
091 Schnals,68,,6,4,10
091 Schnals,69,,3,10,13
091 Schnals,70,,3,5,8
091 Schnals,71,,-,5,5
091 Schnals,72,,6,6,12
091 Schnals,73,,2,7,9
091 Schnals,74,,3,6,9
091 Schnals,75,,9,3,12
091 Schnals,76,,7,11,18
091 Schnals,77,,2,7,9
091 Schnals,78,,1,2,3
091 Schnals,79,,8,4,12
091 Schnals,80,,1,6,7
091 Schnals,81,,2,5,7
091 Schnals,82,,1,1,2
091 Schnals,83,,3,3,6
091 Schnals,84,,-,3,3
091 Schnals,85,,1,2,3
091 Schnals,86,,3,2,5
091 Schnals,87,,1,2,3
091 Schnals,88,,-,2,2
091 Schnals,89,,2,2,4
091 Schnals,90,,-,2,2
091 Schnals,91,,-,1,1
091 Schnals,92,,-,1,1
092 Sexten,0,,20,11,31
092 Sexten,1,,8,14,22
092 Sexten,2,,8,16,24
092 Sexten,3,,11,9,20
092 Sexten,4,,11,10,21
092 Sexten,5,,13,12,25
092 Sexten,6,,15,15,30
092 Sexten,7,,16,11,27
092 Sexten,8,,8,5,13
092 Sexten,9,,13,10,23
092 Sexten,10,,11,12,23
092 Sexten,11,,10,19,29
092 Sexten,12,,9,9,18
092 Sexten,13,,10,6,16
092 Sexten,14,,12,9,21
092 Sexten,15,,6,9,15
092 Sexten,16,,12,11,23
092 Sexten,17,,7,11,18
092 Sexten,18,,11,9,20
092 Sexten,19,,11,19,30
092 Sexten,20,,15,13,28
092 Sexten,21,,17,8,25
092 Sexten,22,,12,19,31
092 Sexten,23,,11,14,25
092 Sexten,24,,10,6,16
092 Sexten,25,,17,11,28
092 Sexten,26,,10,7,17
092 Sexten,27,,9,7,16
092 Sexten,28,,11,8,19
092 Sexten,29,,15,15,30
092 Sexten,30,,12,17,29
092 Sexten,31,,14,21,35
092 Sexten,32,,21,17,38
092 Sexten,33,,19,17,36
092 Sexten,34,,21,17,38
092 Sexten,35,,16,18,34
092 Sexten,36,,21,18,39
092 Sexten,37,,21,19,40
092 Sexten,38,,29,18,47
092 Sexten,39,,15,14,29
092 Sexten,40,,20,14,34
092 Sexten,41,,20,10,30
092 Sexten,42,,16,16,32
092 Sexten,43,,22,15,37
092 Sexten,44,,17,13,30
092 Sexten,45,,14,14,28
092 Sexten,46,,11,13,24
092 Sexten,47,,11,11,22
092 Sexten,48,,6,11,17
092 Sexten,49,,6,11,17
092 Sexten,50,,7,8,15
092 Sexten,51,,13,7,20
092 Sexten,52,,8,6,14
092 Sexten,53,,10,7,17
092 Sexten,54,,11,4,15
092 Sexten,55,,6,9,15
092 Sexten,56,,9,4,13
092 Sexten,57,,7,12,19
092 Sexten,58,,8,6,14
092 Sexten,59,,5,7,12
092 Sexten,60,,10,15,25
092 Sexten,61,,9,14,23
092 Sexten,62,,7,10,17
092 Sexten,63,,14,12,26
092 Sexten,64,,12,9,21
092 Sexten,65,,9,11,20
092 Sexten,66,,11,16,27
092 Sexten,67,,12,7,19
092 Sexten,68,,5,11,16
092 Sexten,69,,7,8,15
092 Sexten,70,,12,14,26
092 Sexten,71,,9,12,21
092 Sexten,72,,8,13,21
092 Sexten,73,,11,13,24
092 Sexten,74,,12,17,29
092 Sexten,75,,7,3,10
092 Sexten,76,,8,12,20
092 Sexten,77,,6,7,13
092 Sexten,78,,6,10,16
092 Sexten,79,,8,11,19
092 Sexten,80,,4,9,13
092 Sexten,81,,2,3,5
092 Sexten,82,,2,4,6
092 Sexten,83,,-,1,1
092 Sexten,84,,1,1,2
092 Sexten,85,,-,2,2
092 Sexten,86,,1,-,1
092 Sexten,87,,2,1,3
092 Sexten,88,,-,6,6
092 Sexten,89,,1,5,6
092 Sexten,91,,-,1,1
092 Sexten,92,,-,1,1
092 Sexten,93,,-,2,2
092 Sexten,95,,-,1,1
092 Sexten,96,,-,1,1
092 Sexten,98,,-,1,1
093 Schlanders,0,,30,34,64
093 Schlanders,1,,39,35,74
093 Schlanders,2,,33,38,71
093 Schlanders,3,,44,37,81
093 Schlanders,4,,56,47,103
093 Schlanders,5,,46,39,85
093 Schlanders,6,,36,27,63
093 Schlanders,7,,41,39,80
093 Schlanders,8,,44,43,87
093 Schlanders,9,,35,40,75
093 Schlanders,10,,39,39,78
093 Schlanders,11,,50,41,91
093 Schlanders,12,,37,35,72
093 Schlanders,13,,34,43,77
093 Schlanders,14,,35,31,66
093 Schlanders,15,,35,35,70
093 Schlanders,16,,41,37,78
093 Schlanders,17,,38,38,76
093 Schlanders,18,,31,35,66
093 Schlanders,19,,52,40,92
093 Schlanders,20,,45,31,76
093 Schlanders,21,,34,34,68
093 Schlanders,22,,34,39,73
093 Schlanders,23,,51,31,82
093 Schlanders,24,,34,35,69
093 Schlanders,25,,39,30,69
093 Schlanders,26,,42,35,77
093 Schlanders,27,,50,40,90
093 Schlanders,28,,48,47,95
093 Schlanders,29,,54,42,96
093 Schlanders,30,,50,49,99
093 Schlanders,31,,44,50,94
093 Schlanders,32,,57,46,103
093 Schlanders,33,,54,42,96
093 Schlanders,34,,54,48,102
093 Schlanders,35,,49,52,101
093 Schlanders,36,,58,49,107
093 Schlanders,37,,43,44,87
093 Schlanders,38,,55,58,113
093 Schlanders,39,,57,44,101
093 Schlanders,40,,50,56,106
093 Schlanders,41,,49,46,95
093 Schlanders,42,,45,39,84
093 Schlanders,43,,49,54,103
093 Schlanders,44,,43,37,80
093 Schlanders,45,,28,34,62
093 Schlanders,46,,34,35,69
093 Schlanders,47,,33,33,66
093 Schlanders,48,,34,36,70
093 Schlanders,49,,31,24,55
093 Schlanders,50,,30,32,62
093 Schlanders,51,,25,32,57
093 Schlanders,52,,29,34,63
093 Schlanders,53,,35,27,62
093 Schlanders,54,,23,24,47
093 Schlanders,55,,34,21,55
093 Schlanders,56,,31,16,47
093 Schlanders,57,,27,32,59
093 Schlanders,58,,31,32,63
093 Schlanders,59,,38,38,76
093 Schlanders,60,,37,37,74
093 Schlanders,61,,29,29,58
093 Schlanders,62,,29,37,66
093 Schlanders,63,,18,20,38
093 Schlanders,64,,27,26,53
093 Schlanders,65,,21,28,49
093 Schlanders,66,,19,27,46
093 Schlanders,67,,21,23,44
093 Schlanders,68,,20,31,51
093 Schlanders,69,,23,18,41
093 Schlanders,70,,23,20,43
093 Schlanders,71,,20,29,49
093 Schlanders,72,,14,18,32
093 Schlanders,73,,20,23,43
093 Schlanders,74,,19,26,45
093 Schlanders,75,,15,27,42
093 Schlanders,76,,10,18,28
093 Schlanders,77,,14,18,32
093 Schlanders,78,,10,19,29
093 Schlanders,79,,8,15,23
093 Schlanders,80,,8,11,19
093 Schlanders,81,,3,20,23
093 Schlanders,82,,8,14,22
093 Schlanders,83,,9,16,25
093 Schlanders,84,,7,2,9
093 Schlanders,85,,4,9,13
093 Schlanders,86,,5,2,7
093 Schlanders,87,,5,10,15
093 Schlanders,88,,4,10,14
093 Schlanders,89,,2,8,10
093 Schlanders,90,,3,9,12
093 Schlanders,91,,2,6,8
093 Schlanders,92,,-,6,6
093 Schlanders,93,,1,4,5
093 Schlanders,94,,1,-,1
093 Schlanders,95,,-,3,3
093 Schlanders,97,,-,1,1
093 Schlanders,98,,-,3,3
093 Schlanders,100,,-,1,1
094 Schluderns,0,,13,9,22
094 Schluderns,1,,19,11,30
094 Schluderns,2,,10,14,24
094 Schluderns,3,,8,10,18
094 Schluderns,4,,12,11,23
094 Schluderns,5,,12,17,29
094 Schluderns,6,,9,12,21
094 Schluderns,7,,15,20,35
094 Schluderns,8,,17,7,24
094 Schluderns,9,,8,8,16
094 Schluderns,10,,8,9,17
094 Schluderns,11,,21,7,28
094 Schluderns,12,,15,13,28
094 Schluderns,13,,12,14,26
094 Schluderns,14,,6,10,16
094 Schluderns,15,,13,21,34
094 Schluderns,16,,18,11,29
094 Schluderns,17,,16,12,28
094 Schluderns,18,,13,8,21
094 Schluderns,19,,8,12,20
094 Schluderns,20,,18,14,32
094 Schluderns,21,,8,7,15
094 Schluderns,22,,7,19,26
094 Schluderns,23,,13,12,25
094 Schluderns,24,,15,16,31
094 Schluderns,25,,9,15,24
094 Schluderns,26,,17,11,28
094 Schluderns,27,,16,15,31
094 Schluderns,28,,22,13,35
094 Schluderns,29,,13,14,27
094 Schluderns,30,,12,16,28
094 Schluderns,31,,10,15,25
094 Schluderns,32,,19,8,27
094 Schluderns,33,,19,15,34
094 Schluderns,34,,17,17,34
094 Schluderns,35,,16,19,35
094 Schluderns,36,,26,10,36
094 Schluderns,37,,27,11,38
094 Schluderns,38,,15,19,34
094 Schluderns,39,,13,23,36
094 Schluderns,40,,18,16,34
094 Schluderns,41,,8,6,14
094 Schluderns,42,,13,19,32
094 Schluderns,43,,10,12,22
094 Schluderns,44,,16,7,23
094 Schluderns,45,,11,17,28
094 Schluderns,46,,17,10,27
094 Schluderns,47,,13,7,20
094 Schluderns,48,,10,6,16
094 Schluderns,49,,7,5,12
094 Schluderns,50,,11,3,14
094 Schluderns,51,,7,15,22
094 Schluderns,52,,13,9,22
094 Schluderns,53,,10,8,18
094 Schluderns,54,,7,5,12
094 Schluderns,55,,8,9,17
094 Schluderns,56,,7,3,10
094 Schluderns,57,,4,11,15
094 Schluderns,58,,3,9,12
094 Schluderns,59,,7,8,15
094 Schluderns,60,,11,13,24
094 Schluderns,61,,8,5,13
094 Schluderns,62,,12,8,20
094 Schluderns,63,,8,10,18
094 Schluderns,64,,7,8,15
094 Schluderns,65,,5,7,12
094 Schluderns,66,,6,10,16
094 Schluderns,67,,11,11,22
094 Schluderns,68,,4,9,13
094 Schluderns,69,,12,9,21
094 Schluderns,70,,4,8,12
094 Schluderns,71,,7,10,17
094 Schluderns,72,,10,7,17
094 Schluderns,73,,6,10,16
094 Schluderns,74,,6,1,7
094 Schluderns,75,,4,14,18
094 Schluderns,76,,3,7,10
094 Schluderns,77,,3,5,8
094 Schluderns,78,,1,5,6
094 Schluderns,79,,8,6,14
094 Schluderns,80,,2,8,10
094 Schluderns,81,,1,3,4
094 Schluderns,82,,3,5,8
094 Schluderns,83,,3,2,5
094 Schluderns,84,,1,3,4
094 Schluderns,85,,2,4,6
094 Schluderns,86,,1,3,4
094 Schluderns,87,,2,1,3
094 Schluderns,88,,1,1,2
094 Schluderns,89,,-,2,2
094 Schluderns,90,,-,1,1
094 Schluderns,92,,-,2,2
094 Schluderns,94,,-,1,1
094 Schluderns,96,,-,1,1
095 Stilfs,0,,7,10,17
095 Stilfs,1,,10,4,14
095 Stilfs,2,,2,7,9
095 Stilfs,3,,8,3,11
095 Stilfs,4,,10,12,22
095 Stilfs,5,,12,2,14
095 Stilfs,6,,6,7,13
095 Stilfs,7,,8,7,15
095 Stilfs,8,,5,15,20
095 Stilfs,9,,4,9,13
095 Stilfs,10,,12,5,17
095 Stilfs,11,,17,7,24
095 Stilfs,12,,10,6,16
095 Stilfs,13,,6,4,10
095 Stilfs,14,,6,7,13
095 Stilfs,15,,8,8,16
095 Stilfs,16,,12,5,17
095 Stilfs,17,,15,5,20
095 Stilfs,18,,8,7,15
095 Stilfs,19,,12,4,16
095 Stilfs,20,,9,3,12
095 Stilfs,21,,9,4,13
095 Stilfs,22,,5,7,12
095 Stilfs,23,,10,6,16
095 Stilfs,24,,7,11,18
095 Stilfs,25,,13,4,17
095 Stilfs,26,,10,11,21
095 Stilfs,27,,9,7,16
095 Stilfs,28,,4,23,27
095 Stilfs,29,,14,12,26
095 Stilfs,30,,14,13,27
095 Stilfs,31,,12,16,28
095 Stilfs,32,,13,15,28
095 Stilfs,33,,11,11,22
095 Stilfs,34,,10,10,20
095 Stilfs,35,,18,8,26
095 Stilfs,36,,9,10,19
095 Stilfs,37,,11,5,16
095 Stilfs,38,,10,5,15
095 Stilfs,39,,13,14,27
095 Stilfs,40,,10,2,12
095 Stilfs,41,,9,6,15
095 Stilfs,42,,10,8,18
095 Stilfs,43,,6,12,18
095 Stilfs,44,,9,6,15
095 Stilfs,45,,6,12,18
095 Stilfs,46,,4,3,7
095 Stilfs,47,,13,8,21
095 Stilfs,48,,11,5,16
095 Stilfs,49,,12,5,17
095 Stilfs,50,,12,9,21
095 Stilfs,51,,3,9,12
095 Stilfs,52,,8,3,11
095 Stilfs,53,,9,10,19
095 Stilfs,54,,6,5,11
095 Stilfs,55,,9,10,19
095 Stilfs,56,,1,4,5
095 Stilfs,57,,14,8,22
095 Stilfs,58,,8,7,15
095 Stilfs,59,,5,14,19
095 Stilfs,60,,9,4,13
095 Stilfs,61,,7,11,18
095 Stilfs,62,,6,12,18
095 Stilfs,63,,6,6,12
095 Stilfs,64,,7,6,13
095 Stilfs,65,,3,10,13
095 Stilfs,66,,3,8,11
095 Stilfs,67,,6,4,10
095 Stilfs,68,,4,6,10
095 Stilfs,69,,6,7,13
095 Stilfs,70,,3,4,7
095 Stilfs,71,,6,8,14
095 Stilfs,72,,6,1,7
095 Stilfs,73,,3,8,11
095 Stilfs,74,,5,7,12
095 Stilfs,75,,5,5,10
095 Stilfs,76,,7,3,10
095 Stilfs,77,,1,11,12
095 Stilfs,78,,4,5,9
095 Stilfs,79,,2,5,7
095 Stilfs,80,,2,6,8
095 Stilfs,81,,2,10,12
095 Stilfs,82,,2,1,3
095 Stilfs,83,,2,3,5
095 Stilfs,84,,-,3,3
095 Stilfs,85,,-,3,3
095 Stilfs,86,,1,1,2
095 Stilfs,87,,2,3,5
095 Stilfs,88,,-,1,1
095 Stilfs,89,,-,3,3
095 Stilfs,90,,-,2,2
095 Stilfs,91,,-,3,3
095 Stilfs,92,,-,3,3
095 Stilfs,94,,-,1,1
095 Stilfs,95,,-,1,1
096 Terenten,0,,10,11,21
096 Terenten,1,,13,9,22
096 Terenten,2,,8,19,27
096 Terenten,3,,19,19,38
096 Terenten,4,,9,8,17
096 Terenten,5,,14,11,25
096 Terenten,6,,12,8,20
096 Terenten,7,,13,14,27
096 Terenten,8,,6,13,19
096 Terenten,9,,10,8,18
096 Terenten,10,,6,15,21
096 Terenten,11,,14,16,30
096 Terenten,12,,14,7,21
096 Terenten,13,,10,8,18
096 Terenten,14,,16,6,22
096 Terenten,15,,10,10,20
096 Terenten,16,,11,16,27
096 Terenten,17,,12,12,24
096 Terenten,18,,14,16,30
096 Terenten,19,,12,9,21
096 Terenten,20,,13,6,19
096 Terenten,21,,11,14,25
096 Terenten,22,,9,10,19
096 Terenten,23,,16,17,33
096 Terenten,24,,11,7,18
096 Terenten,25,,15,10,25
096 Terenten,26,,17,8,25
096 Terenten,27,,15,15,30
096 Terenten,28,,6,16,22
096 Terenten,29,,18,10,28
096 Terenten,30,,14,14,28
096 Terenten,31,,22,13,35
096 Terenten,32,,15,12,27
096 Terenten,33,,11,14,25
096 Terenten,34,,14,15,29
096 Terenten,35,,13,19,32
096 Terenten,36,,15,10,25
096 Terenten,37,,14,16,30
096 Terenten,38,,26,12,38
096 Terenten,39,,20,10,30
096 Terenten,40,,10,15,25
096 Terenten,41,,12,9,21
096 Terenten,42,,15,11,26
096 Terenten,43,,12,8,20
096 Terenten,44,,12,9,21
096 Terenten,45,,11,12,23
096 Terenten,46,,12,10,22
096 Terenten,47,,16,11,27
096 Terenten,48,,9,6,15
096 Terenten,49,,6,7,13
096 Terenten,50,,5,6,11
096 Terenten,51,,9,7,16
096 Terenten,52,,9,6,15
096 Terenten,53,,10,8,18
096 Terenten,54,,7,3,10
096 Terenten,55,,8,3,11
096 Terenten,56,,6,3,9
096 Terenten,57,,3,6,9
096 Terenten,58,,8,4,12
096 Terenten,59,,5,5,10
096 Terenten,60,,6,4,10
096 Terenten,61,,7,5,12
096 Terenten,62,,2,6,8
096 Terenten,63,,6,9,15
096 Terenten,64,,7,5,12
096 Terenten,65,,4,9,13
096 Terenten,66,,7,5,12
096 Terenten,67,,2,4,6
096 Terenten,68,,5,3,8
096 Terenten,69,,4,4,8
096 Terenten,70,,6,11,17
096 Terenten,71,,5,6,11
096 Terenten,72,,5,4,9
096 Terenten,73,,7,6,13
096 Terenten,74,,2,4,6
096 Terenten,75,,3,9,12
096 Terenten,76,,6,3,9
096 Terenten,77,,1,7,8
096 Terenten,78,,4,4,8
096 Terenten,79,,3,1,4
096 Terenten,80,,-,3,3
096 Terenten,81,,4,3,7
096 Terenten,82,,1,2,3
096 Terenten,83,,-,3,3
096 Terenten,84,,1,-,1
096 Terenten,85,,1,2,3
096 Terenten,86,,-,1,1
096 Terenten,87,,2,2,4
096 Terenten,88,,1,-,1
096 Terenten,89,,-,1,1
096 Terenten,91,,-,2,2
096 Terenten,92,,-,1,1
096 Terenten,95,,1,-,1
097 Terlan,0,,20,23,43
097 Terlan,1,,32,28,60
097 Terlan,2,,29,21,50
097 Terlan,3,,17,18,35
097 Terlan,4,,28,27,55
097 Terlan,5,,18,23,41
097 Terlan,6,,26,21,47
097 Terlan,7,,19,18,37
097 Terlan,8,,21,21,42
097 Terlan,9,,23,28,51
097 Terlan,10,,25,18,43
097 Terlan,11,,14,21,35
097 Terlan,12,,21,30,51
097 Terlan,13,,21,17,38
097 Terlan,14,,25,16,41
097 Terlan,15,,16,22,38
097 Terlan,16,,27,19,46
097 Terlan,17,,11,12,23
097 Terlan,18,,23,18,41
097 Terlan,19,,20,16,36
097 Terlan,20,,14,15,29
097 Terlan,21,,25,22,47
097 Terlan,22,,20,25,45
097 Terlan,23,,17,17,34
097 Terlan,24,,27,18,45
097 Terlan,25,,29,23,52
097 Terlan,26,,26,15,41
097 Terlan,27,,31,39,70
097 Terlan,28,,21,30,51
097 Terlan,29,,39,23,62
097 Terlan,30,,36,24,60
097 Terlan,31,,36,37,73
097 Terlan,32,,34,35,69
097 Terlan,33,,40,28,68
097 Terlan,34,,24,35,59
097 Terlan,35,,36,22,58
097 Terlan,36,,29,30,59
097 Terlan,37,,29,33,62
097 Terlan,38,,30,36,66
097 Terlan,39,,32,34,66
097 Terlan,40,,44,26,70
097 Terlan,41,,24,31,55
097 Terlan,42,,20,24,44
097 Terlan,43,,31,23,54
097 Terlan,44,,20,26,46
097 Terlan,45,,30,32,62
097 Terlan,46,,20,21,41
097 Terlan,47,,25,19,44
097 Terlan,48,,19,23,42
097 Terlan,49,,20,23,43
097 Terlan,50,,21,20,41
097 Terlan,51,,21,24,45
097 Terlan,52,,21,15,36
097 Terlan,53,,24,23,47
097 Terlan,54,,13,18,31
097 Terlan,55,,13,25,38
097 Terlan,56,,22,20,42
097 Terlan,57,,22,25,47
097 Terlan,58,,18,28,46
097 Terlan,59,,34,19,53
097 Terlan,60,,21,25,46
097 Terlan,61,,21,15,36
097 Terlan,62,,16,19,35
097 Terlan,63,,21,18,39
097 Terlan,64,,15,17,32
097 Terlan,65,,7,12,19
097 Terlan,66,,17,23,40
097 Terlan,67,,7,23,30
097 Terlan,68,,16,16,32
097 Terlan,69,,15,11,26
097 Terlan,70,,20,15,35
097 Terlan,71,,15,16,31
097 Terlan,72,,13,14,27
097 Terlan,73,,13,13,26
097 Terlan,74,,11,12,23
097 Terlan,75,,12,21,33
097 Terlan,76,,12,13,25
097 Terlan,77,,8,14,22
097 Terlan,78,,7,23,30
097 Terlan,79,,8,12,20
097 Terlan,80,,8,13,21
097 Terlan,81,,2,9,11
097 Terlan,82,,-,9,9
097 Terlan,83,,4,3,7
097 Terlan,84,,-,4,4
097 Terlan,85,,-,5,5
097 Terlan,86,,2,4,6
097 Terlan,87,,-,9,9
097 Terlan,88,,5,8,13
097 Terlan,89,,-,5,5
097 Terlan,90,,-,8,8
097 Terlan,91,,1,3,4
097 Terlan,92,,3,-,3
097 Terlan,93,,-,2,2
097 Terlan,94,,-,1,1
097 Terlan,95,,1,-,1
097 Terlan,96,,-,1,1
098 Tramin a.d. Weinstr.,0,,17,22,39
098 Tramin a.d. Weinstr.,1,,25,14,39
098 Tramin a.d. Weinstr.,2,,23,18,41
098 Tramin a.d. Weinstr.,3,,12,19,31
098 Tramin a.d. Weinstr.,4,,31,16,47
098 Tramin a.d. Weinstr.,5,,21,27,48
098 Tramin a.d. Weinstr.,6,,17,20,37
098 Tramin a.d. Weinstr.,7,,21,21,42
098 Tramin a.d. Weinstr.,8,,17,17,34
098 Tramin a.d. Weinstr.,9,,21,24,45
098 Tramin a.d. Weinstr.,10,,18,10,28
098 Tramin a.d. Weinstr.,11,,23,21,44
098 Tramin a.d. Weinstr.,12,,11,30,41
098 Tramin a.d. Weinstr.,13,,12,25,37
098 Tramin a.d. Weinstr.,14,,18,25,43
098 Tramin a.d. Weinstr.,15,,10,16,26
098 Tramin a.d. Weinstr.,16,,20,21,41
098 Tramin a.d. Weinstr.,17,,20,16,36
098 Tramin a.d. Weinstr.,18,,17,14,31
098 Tramin a.d. Weinstr.,19,,25,18,43
098 Tramin a.d. Weinstr.,20,,29,18,47
098 Tramin a.d. Weinstr.,21,,19,14,33
098 Tramin a.d. Weinstr.,22,,13,14,27
098 Tramin a.d. Weinstr.,23,,10,19,29
098 Tramin a.d. Weinstr.,24,,16,19,35
098 Tramin a.d. Weinstr.,25,,21,16,37
098 Tramin a.d. Weinstr.,26,,20,19,39
098 Tramin a.d. Weinstr.,27,,21,16,37
098 Tramin a.d. Weinstr.,28,,20,18,38
098 Tramin a.d. Weinstr.,29,,23,29,52
098 Tramin a.d. Weinstr.,30,,26,31,57
098 Tramin a.d. Weinstr.,31,,28,19,47
098 Tramin a.d. Weinstr.,32,,32,25,57
098 Tramin a.d. Weinstr.,33,,22,26,48
098 Tramin a.d. Weinstr.,34,,24,25,49
098 Tramin a.d. Weinstr.,35,,32,29,61
098 Tramin a.d. Weinstr.,36,,31,29,60
098 Tramin a.d. Weinstr.,37,,27,30,57
098 Tramin a.d. Weinstr.,38,,26,26,52
098 Tramin a.d. Weinstr.,39,,23,14,37
098 Tramin a.d. Weinstr.,40,,33,25,58
098 Tramin a.d. Weinstr.,41,,29,33,62
098 Tramin a.d. Weinstr.,42,,19,31,50
098 Tramin a.d. Weinstr.,43,,25,21,46
098 Tramin a.d. Weinstr.,44,,18,19,37
098 Tramin a.d. Weinstr.,45,,23,19,42
098 Tramin a.d. Weinstr.,46,,20,19,39
098 Tramin a.d. Weinstr.,47,,18,18,36
098 Tramin a.d. Weinstr.,48,,15,14,29
098 Tramin a.d. Weinstr.,49,,19,17,36
098 Tramin a.d. Weinstr.,50,,10,12,22
098 Tramin a.d. Weinstr.,51,,17,19,36
098 Tramin a.d. Weinstr.,52,,16,14,30
098 Tramin a.d. Weinstr.,53,,18,18,36
098 Tramin a.d. Weinstr.,54,,14,22,36
098 Tramin a.d. Weinstr.,55,,25,18,43
098 Tramin a.d. Weinstr.,56,,7,9,16
098 Tramin a.d. Weinstr.,57,,23,24,47
098 Tramin a.d. Weinstr.,58,,19,22,41
098 Tramin a.d. Weinstr.,59,,20,20,40
098 Tramin a.d. Weinstr.,60,,13,25,38
098 Tramin a.d. Weinstr.,61,,22,17,39
098 Tramin a.d. Weinstr.,62,,14,13,27
098 Tramin a.d. Weinstr.,63,,8,20,28
098 Tramin a.d. Weinstr.,64,,15,13,28
098 Tramin a.d. Weinstr.,65,,13,14,27
098 Tramin a.d. Weinstr.,66,,15,13,28
098 Tramin a.d. Weinstr.,67,,11,12,23
098 Tramin a.d. Weinstr.,68,,11,15,26
098 Tramin a.d. Weinstr.,69,,11,19,30
098 Tramin a.d. Weinstr.,70,,9,19,28
098 Tramin a.d. Weinstr.,71,,23,15,38
098 Tramin a.d. Weinstr.,72,,10,15,25
098 Tramin a.d. Weinstr.,73,,17,16,33
098 Tramin a.d. Weinstr.,74,,17,14,31
098 Tramin a.d. Weinstr.,75,,16,19,35
098 Tramin a.d. Weinstr.,76,,13,21,34
098 Tramin a.d. Weinstr.,77,,6,15,21
098 Tramin a.d. Weinstr.,78,,10,18,28
098 Tramin a.d. Weinstr.,79,,6,12,18
098 Tramin a.d. Weinstr.,80,,13,11,24
098 Tramin a.d. Weinstr.,81,,6,15,21
098 Tramin a.d. Weinstr.,82,,3,13,16
098 Tramin a.d. Weinstr.,83,,3,3,6
098 Tramin a.d. Weinstr.,84,,1,3,4
098 Tramin a.d. Weinstr.,85,,1,2,3
098 Tramin a.d. Weinstr.,86,,2,6,8
098 Tramin a.d. Weinstr.,87,,5,9,14
098 Tramin a.d. Weinstr.,88,,2,3,5
098 Tramin a.d. Weinstr.,89,,1,4,5
098 Tramin a.d. Weinstr.,90,,-,6,6
098 Tramin a.d. Weinstr.,91,,1,6,7
098 Tramin a.d. Weinstr.,92,,-,2,2
098 Tramin a.d. Weinstr.,93,,1,3,4
098 Tramin a.d. Weinstr.,94,,-,3,3
098 Tramin a.d. Weinstr.,95,,-,2,2
098 Tramin a.d. Weinstr.,96,,-,1,1
098 Tramin a.d. Weinstr.,97,,-,3,3
098 Tramin a.d. Weinstr.,101,,-,1,1
099 Tisens,0,,10,11,21
099 Tisens,1,,10,10,20
099 Tisens,2,,11,10,21
099 Tisens,3,,11,14,25
099 Tisens,4,,4,7,11
099 Tisens,5,,9,8,17
099 Tisens,6,,10,8,18
099 Tisens,7,,12,12,24
099 Tisens,8,,6,10,16
099 Tisens,9,,6,16,22
099 Tisens,10,,16,8,24
099 Tisens,11,,10,15,25
099 Tisens,12,,12,9,21
099 Tisens,13,,7,14,21
099 Tisens,14,,15,9,24
099 Tisens,15,,15,8,23
099 Tisens,16,,10,4,14
099 Tisens,17,,12,12,24
099 Tisens,18,,18,6,24
099 Tisens,19,,10,15,25
099 Tisens,20,,4,18,22
099 Tisens,21,,15,12,27
099 Tisens,22,,10,7,17
099 Tisens,23,,12,12,24
099 Tisens,24,,11,6,17
099 Tisens,25,,8,5,13
099 Tisens,26,,13,15,28
099 Tisens,27,,10,10,20
099 Tisens,28,,10,8,18
099 Tisens,29,,8,12,20
099 Tisens,30,,19,16,35
099 Tisens,31,,18,18,36
099 Tisens,32,,16,14,30
099 Tisens,33,,18,17,35
099 Tisens,34,,18,25,43
099 Tisens,35,,20,13,33
099 Tisens,36,,18,26,44
099 Tisens,37,,16,4,20
099 Tisens,38,,18,14,32
099 Tisens,39,,22,7,29
099 Tisens,40,,14,15,29
099 Tisens,41,,16,7,23
099 Tisens,42,,14,10,24
099 Tisens,43,,10,11,21
099 Tisens,44,,17,19,36
099 Tisens,45,,9,12,21
099 Tisens,46,,19,9,28
099 Tisens,47,,8,7,15
099 Tisens,48,,12,10,22
099 Tisens,49,,7,12,19
099 Tisens,50,,10,11,21
099 Tisens,51,,9,7,16
099 Tisens,52,,5,8,13
099 Tisens,53,,15,9,24
099 Tisens,54,,7,8,15
099 Tisens,55,,8,7,15
099 Tisens,56,,3,7,10
099 Tisens,57,,10,10,20
099 Tisens,58,,12,10,22
099 Tisens,59,,8,8,16
099 Tisens,60,,8,14,22
099 Tisens,61,,6,9,15
099 Tisens,62,,14,10,24
099 Tisens,63,,8,12,20
099 Tisens,64,,6,4,10
099 Tisens,65,,7,8,15
099 Tisens,66,,4,12,16
099 Tisens,67,,8,7,15
099 Tisens,68,,2,12,14
099 Tisens,69,,9,11,20
099 Tisens,70,,7,9,16
099 Tisens,71,,5,15,20
099 Tisens,72,,11,11,22
099 Tisens,73,,11,13,24
099 Tisens,74,,15,10,25
099 Tisens,75,,6,9,15
099 Tisens,76,,4,7,11
099 Tisens,77,,3,5,8
099 Tisens,78,,4,11,15
099 Tisens,79,,6,6,12
099 Tisens,80,,5,7,12
099 Tisens,81,,3,6,9
099 Tisens,82,,2,7,9
099 Tisens,83,,3,3,6
099 Tisens,84,,2,6,8
099 Tisens,85,,1,3,4
099 Tisens,86,,2,4,6
099 Tisens,87,,1,5,6
099 Tisens,88,,1,2,3
099 Tisens,89,,1,4,5
099 Tisens,90,,2,2,4
099 Tisens,91,,1,5,6
099 Tisens,93,,-,3,3
099 Tisens,94,,-,2,2
099 Tisens,98,,-,1,1
099 Tisens,100,,-,1,1
100 Tiers,0,,2,9,11
100 Tiers,1,,2,8,10
100 Tiers,2,,5,8,13
100 Tiers,3,,4,8,12
100 Tiers,4,,7,5,12
100 Tiers,5,,9,3,12
100 Tiers,6,,6,10,16
100 Tiers,7,,5,7,12
100 Tiers,8,,4,1,5
100 Tiers,9,,6,3,9
100 Tiers,10,,4,3,7
100 Tiers,11,,6,5,11
100 Tiers,12,,5,6,11
100 Tiers,13,,6,8,14
100 Tiers,14,,5,4,9
100 Tiers,15,,8,5,13
100 Tiers,16,,5,6,11
100 Tiers,17,,3,9,12
100 Tiers,18,,6,6,12
100 Tiers,19,,6,6,12
100 Tiers,20,,5,4,9
100 Tiers,21,,2,4,6
100 Tiers,22,,1,9,10
100 Tiers,23,,8,7,15
100 Tiers,24,,5,3,8
100 Tiers,25,,1,3,4
100 Tiers,26,,7,2,9
100 Tiers,27,,4,7,11
100 Tiers,28,,9,9,18
100 Tiers,29,,9,7,16
100 Tiers,30,,5,8,13
100 Tiers,31,,8,8,16
100 Tiers,32,,13,11,24
100 Tiers,33,,5,6,11
100 Tiers,34,,10,11,21
100 Tiers,35,,11,6,17
100 Tiers,36,,7,6,13
100 Tiers,37,,9,2,11
100 Tiers,38,,6,10,16
100 Tiers,39,,5,7,12
100 Tiers,40,,6,4,10
100 Tiers,41,,4,6,10
100 Tiers,42,,11,5,16
100 Tiers,43,,7,4,11
100 Tiers,44,,6,8,14
100 Tiers,45,,10,8,18
100 Tiers,46,,5,3,8
100 Tiers,47,,8,5,13
100 Tiers,48,,6,5,11
100 Tiers,49,,3,3,6
100 Tiers,50,,1,3,4
100 Tiers,51,,7,4,11
100 Tiers,52,,2,5,7
100 Tiers,53,,3,5,8
100 Tiers,54,,1,3,4
100 Tiers,55,,5,4,9
100 Tiers,56,,10,3,13
100 Tiers,57,,1,5,6
100 Tiers,58,,8,10,18
100 Tiers,59,,2,5,7
100 Tiers,60,,4,6,10
100 Tiers,61,,2,3,5
100 Tiers,62,,4,6,10
100 Tiers,63,,6,5,11
100 Tiers,64,,7,5,12
100 Tiers,65,,4,6,10
100 Tiers,66,,7,2,9
100 Tiers,67,,2,5,7
100 Tiers,68,,7,3,10
100 Tiers,69,,3,5,8
100 Tiers,70,,7,2,9
100 Tiers,71,,4,1,5
100 Tiers,72,,3,3,6
100 Tiers,73,,4,3,7
100 Tiers,74,,4,4,8
100 Tiers,75,,4,2,6
100 Tiers,76,,6,4,10
100 Tiers,77,,2,7,9
100 Tiers,78,,2,3,5
100 Tiers,79,,3,2,5
100 Tiers,80,,1,10,11
100 Tiers,81,,2,3,5
100 Tiers,82,,3,1,4
100 Tiers,83,,1,1,2
100 Tiers,84,,3,1,4
100 Tiers,86,,1,2,3
100 Tiers,87,,2,1,3
100 Tiers,88,,1,1,2
100 Tiers,89,,-,2,2
100 Tiers,90,,1,1,2
100 Tiers,91,,-,1,1
101 Tirol,0,,18,9,27
101 Tirol,1,,18,10,28
101 Tirol,2,,14,17,31
101 Tirol,3,,17,14,31
101 Tirol,4,,21,18,39
101 Tirol,5,,21,19,40
101 Tirol,6,,11,17,28
101 Tirol,7,,14,15,29
101 Tirol,8,,23,9,32
101 Tirol,9,,12,14,26
101 Tirol,10,,8,9,17
101 Tirol,11,,16,11,27
101 Tirol,12,,11,18,29
101 Tirol,13,,10,14,24
101 Tirol,14,,15,9,24
101 Tirol,15,,10,12,22
101 Tirol,16,,10,16,26
101 Tirol,17,,16,11,27
101 Tirol,18,,18,14,32
101 Tirol,19,,13,13,26
101 Tirol,20,,17,23,40
101 Tirol,21,,18,9,27
101 Tirol,22,,19,5,24
101 Tirol,23,,9,13,22
101 Tirol,24,,15,19,34
101 Tirol,25,,16,9,25
101 Tirol,26,,18,20,38
101 Tirol,27,,15,20,35
101 Tirol,28,,22,14,36
101 Tirol,29,,24,18,42
101 Tirol,30,,24,13,37
101 Tirol,31,,14,13,27
101 Tirol,32,,22,22,44
101 Tirol,33,,22,22,44
101 Tirol,34,,21,20,41
101 Tirol,35,,20,17,37
101 Tirol,36,,23,21,44
101 Tirol,37,,27,24,51
101 Tirol,38,,20,12,32
101 Tirol,39,,18,16,34
101 Tirol,40,,18,22,40
101 Tirol,41,,24,12,36
101 Tirol,42,,16,12,28
101 Tirol,43,,13,18,31
101 Tirol,44,,19,17,36
101 Tirol,45,,9,15,24
101 Tirol,46,,13,14,27
101 Tirol,47,,14,17,31
101 Tirol,48,,19,17,36
101 Tirol,49,,12,10,22
101 Tirol,50,,16,19,35
101 Tirol,51,,15,12,27
101 Tirol,52,,21,15,36
101 Tirol,53,,21,15,36
101 Tirol,54,,9,17,26
101 Tirol,55,,13,6,19
101 Tirol,56,,12,14,26
101 Tirol,57,,16,17,33
101 Tirol,58,,13,12,25
101 Tirol,59,,13,20,33
101 Tirol,60,,12,18,30
101 Tirol,61,,10,13,23
101 Tirol,62,,14,12,26
101 Tirol,63,,8,9,17
101 Tirol,64,,11,15,26
101 Tirol,65,,7,12,19
101 Tirol,66,,10,11,21
101 Tirol,67,,16,7,23
101 Tirol,68,,7,12,19
101 Tirol,69,,7,8,15
101 Tirol,70,,8,7,15
101 Tirol,71,,6,9,15
101 Tirol,72,,10,15,25
101 Tirol,73,,8,9,17
101 Tirol,74,,10,8,18
101 Tirol,75,,5,10,15
101 Tirol,76,,6,9,15
101 Tirol,77,,9,11,20
101 Tirol,78,,5,6,11
101 Tirol,79,,4,6,10
101 Tirol,80,,7,8,15
101 Tirol,81,,2,7,9
101 Tirol,82,,3,4,7
101 Tirol,83,,2,6,8
101 Tirol,84,,-,1,1
101 Tirol,85,,1,3,4
101 Tirol,86,,2,4,6
101 Tirol,87,,4,4,8
101 Tirol,88,,2,5,7
101 Tirol,89,,1,2,3
101 Tirol,90,,2,4,6
101 Tirol,91,,1,2,3
101 Tirol,92,,-,4,4
101 Tirol,93,,-,2,2
101 Tirol,94,,2,-,2
101 Tirol,95,,1,-,1
102 Truden im Naturpark,0,,4,4,8
102 Truden im Naturpark,1,,6,7,13
102 Truden im Naturpark,2,,-,3,3
102 Truden im Naturpark,3,,3,8,11
102 Truden im Naturpark,4,,5,6,11
102 Truden im Naturpark,5,,6,6,12
102 Truden im Naturpark,6,,4,7,11
102 Truden im Naturpark,7,,5,6,11
102 Truden im Naturpark,8,,10,3,13
102 Truden im Naturpark,9,,8,4,12
102 Truden im Naturpark,10,,6,6,12
102 Truden im Naturpark,11,,4,5,9
102 Truden im Naturpark,12,,11,7,18
102 Truden im Naturpark,13,,8,12,20
102 Truden im Naturpark,14,,6,5,11
102 Truden im Naturpark,15,,2,6,8
102 Truden im Naturpark,16,,8,6,14
102 Truden im Naturpark,17,,12,4,16
102 Truden im Naturpark,18,,6,5,11
102 Truden im Naturpark,19,,12,3,15
102 Truden im Naturpark,20,,4,8,12
102 Truden im Naturpark,21,,4,4,8
102 Truden im Naturpark,22,,9,7,16
102 Truden im Naturpark,23,,7,5,12
102 Truden im Naturpark,24,,4,4,8
102 Truden im Naturpark,25,,10,8,18
102 Truden im Naturpark,26,,8,3,11
102 Truden im Naturpark,27,,3,5,8
102 Truden im Naturpark,28,,7,9,16
102 Truden im Naturpark,29,,6,9,15
102 Truden im Naturpark,30,,4,8,12
102 Truden im Naturpark,31,,1,8,9
102 Truden im Naturpark,32,,8,8,16
102 Truden im Naturpark,33,,7,12,19
102 Truden im Naturpark,34,,10,8,18
102 Truden im Naturpark,35,,7,7,14
102 Truden im Naturpark,36,,7,7,14
102 Truden im Naturpark,37,,10,7,17
102 Truden im Naturpark,38,,10,7,17
102 Truden im Naturpark,39,,8,7,15
102 Truden im Naturpark,40,,8,5,13
102 Truden im Naturpark,41,,10,12,22
102 Truden im Naturpark,42,,7,9,16
102 Truden im Naturpark,43,,4,8,12
102 Truden im Naturpark,44,,6,9,15
102 Truden im Naturpark,45,,8,6,14
102 Truden im Naturpark,46,,8,10,18
102 Truden im Naturpark,47,,6,5,11
102 Truden im Naturpark,48,,8,5,13
102 Truden im Naturpark,49,,6,6,12
102 Truden im Naturpark,50,,9,6,15
102 Truden im Naturpark,51,,2,2,4
102 Truden im Naturpark,52,,5,3,8
102 Truden im Naturpark,53,,1,6,7
102 Truden im Naturpark,54,,7,2,9
102 Truden im Naturpark,55,,8,6,14
102 Truden im Naturpark,56,,4,2,6
102 Truden im Naturpark,57,,5,5,10
102 Truden im Naturpark,58,,5,5,10
102 Truden im Naturpark,59,,5,3,8
102 Truden im Naturpark,60,,5,5,10
102 Truden im Naturpark,61,,2,4,6
102 Truden im Naturpark,62,,8,2,10
102 Truden im Naturpark,63,,7,7,14
102 Truden im Naturpark,64,,3,4,7
102 Truden im Naturpark,65,,4,4,8
102 Truden im Naturpark,66,,4,3,7
102 Truden im Naturpark,67,,5,-,5
102 Truden im Naturpark,68,,6,7,13
102 Truden im Naturpark,69,,4,4,8
102 Truden im Naturpark,70,,5,4,9
102 Truden im Naturpark,71,,4,9,13
102 Truden im Naturpark,72,,-,7,7
102 Truden im Naturpark,73,,2,6,8
102 Truden im Naturpark,74,,6,6,12
102 Truden im Naturpark,75,,2,8,10
102 Truden im Naturpark,76,,-,7,7
102 Truden im Naturpark,77,,-,7,7
102 Truden im Naturpark,78,,4,7,11
102 Truden im Naturpark,79,,4,5,9
102 Truden im Naturpark,80,,1,5,6
102 Truden im Naturpark,81,,-,9,9
102 Truden im Naturpark,82,,1,4,5
102 Truden im Naturpark,83,,1,2,3
102 Truden im Naturpark,84,,-,1,1
102 Truden im Naturpark,86,,2,1,3
102 Truden im Naturpark,87,,-,3,3
102 Truden im Naturpark,90,,-,1,1
102 Truden im Naturpark,91,,-,2,2
102 Truden im Naturpark,92,,-,1,1
102 Truden im Naturpark,95,,-,1,1
103 Taufers im Münstertal,0,,6,6,12
103 Taufers im Münstertal,1,,4,4,8
103 Taufers im Münstertal,2,,3,4,7
103 Taufers im Münstertal,3,,8,8,16
103 Taufers im Münstertal,4,,2,5,7
103 Taufers im Münstertal,5,,6,4,10
103 Taufers im Münstertal,6,,9,9,18
103 Taufers im Münstertal,7,,5,9,14
103 Taufers im Münstertal,8,,3,5,8
103 Taufers im Münstertal,9,,10,9,19
103 Taufers im Münstertal,10,,6,12,18
103 Taufers im Münstertal,11,,7,7,14
103 Taufers im Münstertal,12,,6,2,8
103 Taufers im Münstertal,13,,6,8,14
103 Taufers im Münstertal,14,,5,6,11
103 Taufers im Münstertal,15,,6,4,10
103 Taufers im Münstertal,16,,5,3,8
103 Taufers im Münstertal,17,,4,7,11
103 Taufers im Münstertal,18,,5,6,11
103 Taufers im Münstertal,19,,5,11,16
103 Taufers im Münstertal,20,,9,2,11
103 Taufers im Münstertal,21,,8,4,12
103 Taufers im Münstertal,22,,8,3,11
103 Taufers im Münstertal,23,,6,4,10
103 Taufers im Münstertal,24,,9,5,14
103 Taufers im Münstertal,25,,5,4,9
103 Taufers im Münstertal,26,,13,2,15
103 Taufers im Münstertal,27,,5,5,10
103 Taufers im Münstertal,28,,3,4,7
103 Taufers im Münstertal,29,,5,8,13
103 Taufers im Münstertal,30,,8,14,22
103 Taufers im Münstertal,31,,6,8,14
103 Taufers im Münstertal,32,,10,6,16
103 Taufers im Münstertal,33,,8,10,18
103 Taufers im Münstertal,34,,4,4,8
103 Taufers im Münstertal,35,,8,8,16
103 Taufers im Münstertal,36,,13,7,20
103 Taufers im Münstertal,37,,7,12,19
103 Taufers im Münstertal,38,,11,11,22
103 Taufers im Münstertal,39,,11,10,21
103 Taufers im Münstertal,40,,9,8,17
103 Taufers im Münstertal,41,,13,7,20
103 Taufers im Münstertal,42,,6,9,15
103 Taufers im Münstertal,43,,5,6,11
103 Taufers im Münstertal,44,,8,7,15
103 Taufers im Münstertal,45,,10,10,20
103 Taufers im Münstertal,46,,3,3,6
103 Taufers im Münstertal,47,,3,6,9
103 Taufers im Münstertal,48,,7,3,10
103 Taufers im Münstertal,49,,6,2,8
103 Taufers im Münstertal,50,,5,4,9
103 Taufers im Münstertal,51,,7,1,8
103 Taufers im Münstertal,52,,5,1,6
103 Taufers im Münstertal,53,,6,1,7
103 Taufers im Münstertal,54,,3,7,10
103 Taufers im Münstertal,55,,3,3,6
103 Taufers im Münstertal,56,,2,3,5
103 Taufers im Münstertal,57,,1,-,1
103 Taufers im Münstertal,58,,6,5,11
103 Taufers im Münstertal,59,,5,5,10
103 Taufers im Münstertal,60,,4,6,10
103 Taufers im Münstertal,61,,4,3,7
103 Taufers im Münstertal,62,,4,4,8
103 Taufers im Münstertal,63,,8,9,17
103 Taufers im Münstertal,64,,3,5,8
103 Taufers im Münstertal,65,,2,9,11
103 Taufers im Münstertal,66,,6,2,8
103 Taufers im Münstertal,67,,4,8,12
103 Taufers im Münstertal,68,,6,5,11
103 Taufers im Münstertal,69,,5,2,7
103 Taufers im Münstertal,70,,9,3,12
103 Taufers im Münstertal,71,,3,3,6
103 Taufers im Münstertal,72,,4,6,10
103 Taufers im Münstertal,73,,4,3,7
103 Taufers im Münstertal,74,,3,3,6
103 Taufers im Münstertal,75,,3,5,8
103 Taufers im Münstertal,76,,1,5,6
103 Taufers im Münstertal,77,,1,7,8
103 Taufers im Münstertal,78,,4,4,8
103 Taufers im Münstertal,79,,2,2,4
103 Taufers im Münstertal,80,,3,-,3
103 Taufers im Münstertal,81,,3,2,5
103 Taufers im Münstertal,82,,2,3,5
103 Taufers im Münstertal,83,,-,1,1
103 Taufers im Münstertal,84,,2,4,6
103 Taufers im Münstertal,85,,1,-,1
103 Taufers im Münstertal,86,,2,2,4
103 Taufers im Münstertal,87,,1,-,1
103 Taufers im Münstertal,88,,-,1,1
103 Taufers im Münstertal,89,,-,2,2
103 Taufers im Münstertal,91,,1,1,2
103 Taufers im Münstertal,92,,-,1,1
103 Taufers im Münstertal,93,,-,3,3
103 Taufers im Münstertal,97,,-,1,1
104 Ulten,0,,24,15,39
104 Ulten,1,,20,19,39
104 Ulten,2,,15,14,29
104 Ulten,3,,18,19,37
104 Ulten,4,,16,19,35
104 Ulten,5,,11,13,24
104 Ulten,6,,12,16,28
104 Ulten,7,,19,16,35
104 Ulten,8,,23,15,38
104 Ulten,9,,16,18,34
104 Ulten,10,,24,31,55
104 Ulten,11,,16,18,34
104 Ulten,12,,18,29,47
104 Ulten,13,,16,20,36
104 Ulten,14,,20,17,37
104 Ulten,15,,22,11,33
104 Ulten,16,,14,16,30
104 Ulten,17,,20,22,42
104 Ulten,18,,22,20,42
104 Ulten,19,,16,26,42
104 Ulten,20,,19,18,37
104 Ulten,21,,20,23,43
104 Ulten,22,,18,18,36
104 Ulten,23,,22,16,38
104 Ulten,24,,23,12,35
104 Ulten,25,,15,21,36
104 Ulten,26,,24,24,48
104 Ulten,27,,23,31,54
104 Ulten,28,,26,19,45
104 Ulten,29,,25,25,50
104 Ulten,30,,28,20,48
104 Ulten,31,,24,27,51
104 Ulten,32,,29,20,49
104 Ulten,33,,27,26,53
104 Ulten,34,,13,24,37
104 Ulten,35,,22,20,42
104 Ulten,36,,25,26,51
104 Ulten,37,,26,22,48
104 Ulten,38,,30,25,55
104 Ulten,39,,32,24,56
104 Ulten,40,,30,18,48
104 Ulten,41,,25,21,46
104 Ulten,42,,23,21,44
104 Ulten,43,,27,16,43
104 Ulten,44,,36,22,58
104 Ulten,45,,18,15,33
104 Ulten,46,,14,12,26
104 Ulten,47,,19,17,36
104 Ulten,48,,24,14,38
104 Ulten,49,,19,13,32
104 Ulten,50,,20,18,38
104 Ulten,51,,22,14,36
104 Ulten,52,,17,10,27
104 Ulten,53,,14,13,27
104 Ulten,54,,17,8,25
104 Ulten,55,,16,16,32
104 Ulten,56,,9,12,21
104 Ulten,57,,14,20,34
104 Ulten,58,,17,16,33
104 Ulten,59,,11,19,30
104 Ulten,60,,14,12,26
104 Ulten,61,,17,9,26
104 Ulten,62,,21,16,37
104 Ulten,63,,8,11,19
104 Ulten,64,,11,11,22
104 Ulten,65,,9,10,19
104 Ulten,66,,11,13,24
104 Ulten,67,,12,14,26
104 Ulten,68,,5,14,19
104 Ulten,69,,15,8,23
104 Ulten,70,,11,9,20
104 Ulten,71,,16,17,33
104 Ulten,72,,7,16,23
104 Ulten,73,,10,17,27
104 Ulten,74,,12,20,32
104 Ulten,75,,10,14,24
104 Ulten,76,,16,13,29
104 Ulten,77,,11,11,22
104 Ulten,78,,11,26,37
104 Ulten,79,,10,12,22
104 Ulten,80,,9,15,24
104 Ulten,81,,9,13,22
104 Ulten,82,,3,14,17
104 Ulten,83,,3,5,8
104 Ulten,84,,1,3,4
104 Ulten,85,,-,4,4
104 Ulten,86,,3,2,5
104 Ulten,87,,2,10,12
104 Ulten,88,,4,6,10
104 Ulten,89,,2,4,6
104 Ulten,90,,3,5,8
104 Ulten,91,,2,5,7
104 Ulten,92,,2,1,3
104 Ulten,93,,-,2,2
104 Ulten,94,,1,-,1
104 Ulten,96,,-,1,1
104 Ulten,103,,-,1,1
105 Pfatten,0,,6,1,7
105 Pfatten,1,,2,5,7
105 Pfatten,2,,4,4,8
105 Pfatten,3,,11,3,14
105 Pfatten,4,,3,-,3
105 Pfatten,5,,5,8,13
105 Pfatten,6,,4,4,8
105 Pfatten,7,,9,11,20
105 Pfatten,8,,3,5,8
105 Pfatten,9,,6,6,12
105 Pfatten,10,,7,5,12
105 Pfatten,11,,9,8,17
105 Pfatten,12,,5,6,11
105 Pfatten,13,,2,7,9
105 Pfatten,14,,6,5,11
105 Pfatten,15,,4,8,12
105 Pfatten,16,,4,6,10
105 Pfatten,17,,4,6,10
105 Pfatten,18,,3,3,6
105 Pfatten,19,,7,2,9
105 Pfatten,20,,8,2,10
105 Pfatten,21,,2,4,6
105 Pfatten,22,,2,6,8
105 Pfatten,23,,5,3,8
105 Pfatten,24,,5,3,8
105 Pfatten,25,,9,3,12
105 Pfatten,26,,2,6,8
105 Pfatten,27,,7,7,14
105 Pfatten,28,,4,8,12
105 Pfatten,29,,8,11,19
105 Pfatten,30,,11,7,18
105 Pfatten,31,,9,6,15
105 Pfatten,32,,6,3,9
105 Pfatten,33,,3,8,11
105 Pfatten,34,,14,4,18
105 Pfatten,35,,11,7,18
105 Pfatten,36,,12,11,23
105 Pfatten,37,,8,6,14
105 Pfatten,38,,7,9,16
105 Pfatten,39,,8,12,20
105 Pfatten,40,,9,14,23
105 Pfatten,41,,6,12,18
105 Pfatten,42,,4,12,16
105 Pfatten,43,,8,7,15
105 Pfatten,44,,14,6,20
105 Pfatten,45,,10,7,17
105 Pfatten,46,,9,4,13
105 Pfatten,47,,12,3,15
105 Pfatten,48,,7,7,14
105 Pfatten,49,,2,6,8
105 Pfatten,50,,4,2,6
105 Pfatten,51,,4,7,11
105 Pfatten,52,,5,2,7
105 Pfatten,53,,3,2,5
105 Pfatten,54,,5,8,13
105 Pfatten,55,,5,6,11
105 Pfatten,56,,5,4,9
105 Pfatten,57,,4,2,6
105 Pfatten,58,,2,2,4
105 Pfatten,59,,5,2,7
105 Pfatten,60,,4,6,10
105 Pfatten,61,,2,3,5
105 Pfatten,62,,4,2,6
105 Pfatten,63,,2,4,6
105 Pfatten,64,,5,1,6
105 Pfatten,65,,3,4,7
105 Pfatten,66,,6,2,8
105 Pfatten,67,,3,6,9
105 Pfatten,68,,2,3,5
105 Pfatten,69,,-,4,4
105 Pfatten,70,,2,4,6
105 Pfatten,71,,2,3,5
105 Pfatten,72,,-,6,6
105 Pfatten,73,,-,1,1
105 Pfatten,74,,2,-,2
105 Pfatten,75,,3,4,7
105 Pfatten,76,,2,4,6
105 Pfatten,77,,2,5,7
105 Pfatten,78,,3,2,5
105 Pfatten,79,,3,1,4
105 Pfatten,80,,-,1,1
105 Pfatten,81,,1,1,2
105 Pfatten,82,,1,-,1
105 Pfatten,83,,-,1,1
105 Pfatten,84,,1,1,2
105 Pfatten,85,,-,2,2
105 Pfatten,86,,-,2,2
105 Pfatten,87,,1,-,1
105 Pfatten,88,,1,2,3
105 Pfatten,89,,-,2,2
105 Pfatten,92,,1,-,1
105 Pfatten,94,,-,2,2
106 Olang,0,,20,23,43
106 Olang,1,,19,17,36
106 Olang,2,,18,14,32
106 Olang,3,,15,20,35
106 Olang,4,,21,17,38
106 Olang,5,,26,21,47
106 Olang,6,,20,9,29
106 Olang,7,,19,11,30
106 Olang,8,,19,23,42
106 Olang,9,,14,15,29
106 Olang,10,,25,17,42
106 Olang,11,,23,25,48
106 Olang,12,,19,19,38
106 Olang,13,,15,17,32
106 Olang,14,,25,18,43
106 Olang,15,,18,17,35
106 Olang,16,,13,22,35
106 Olang,17,,21,14,35
106 Olang,18,,17,21,38
106 Olang,19,,19,23,42
106 Olang,20,,16,24,40
106 Olang,21,,21,27,48
106 Olang,22,,19,18,37
106 Olang,23,,20,14,34
106 Olang,24,,26,26,52
106 Olang,25,,19,22,41
106 Olang,26,,24,24,48
106 Olang,27,,15,27,42
106 Olang,28,,31,24,55
106 Olang,29,,23,18,41
106 Olang,30,,27,18,45
106 Olang,31,,22,20,42
106 Olang,32,,20,25,45
106 Olang,33,,28,28,56
106 Olang,34,,28,24,52
106 Olang,35,,25,21,46
106 Olang,36,,16,22,38
106 Olang,37,,17,30,47
106 Olang,38,,22,22,44
106 Olang,39,,26,11,37
106 Olang,40,,15,28,43
106 Olang,41,,23,24,47
106 Olang,42,,25,17,42
106 Olang,43,,21,13,34
106 Olang,44,,28,14,42
106 Olang,45,,14,27,41
106 Olang,46,,15,18,33
106 Olang,47,,15,18,33
106 Olang,48,,15,19,34
106 Olang,49,,19,13,32
106 Olang,50,,9,12,21
106 Olang,51,,32,16,48
106 Olang,52,,24,12,36
106 Olang,53,,19,21,40
106 Olang,54,,15,25,40
106 Olang,55,,17,13,30
106 Olang,56,,18,10,28
106 Olang,57,,15,7,22
106 Olang,58,,10,17,27
106 Olang,59,,14,14,28
106 Olang,60,,16,14,30
106 Olang,61,,17,11,28
106 Olang,62,,11,9,20
106 Olang,63,,8,14,22
106 Olang,64,,10,9,19
106 Olang,65,,10,8,18
106 Olang,66,,9,15,24
106 Olang,67,,11,9,20
106 Olang,68,,10,14,24
106 Olang,69,,10,13,23
106 Olang,70,,5,6,11
106 Olang,71,,17,8,25
106 Olang,72,,12,12,24
106 Olang,73,,6,9,15
106 Olang,74,,8,11,19
106 Olang,75,,7,13,20
106 Olang,76,,4,6,10
106 Olang,77,,5,7,12
106 Olang,78,,7,5,12
106 Olang,79,,4,6,10
106 Olang,80,,6,4,10
106 Olang,81,,3,7,10
106 Olang,82,,1,5,6
106 Olang,83,,-,2,2
106 Olang,84,,1,3,4
106 Olang,85,,1,1,2
106 Olang,86,,3,8,11
106 Olang,87,,1,4,5
106 Olang,88,,-,3,3
106 Olang,89,,1,3,4
106 Olang,90,,1,4,5
106 Olang,91,,1,2,3
106 Olang,92,,-,1,1
106 Olang,93,,1,-,1
106 Olang,94,,-,1,1
106 Olang,95,,1,-,1
106 Olang,98,,-,1,1
107 Pfitsch,0,,10,8,18
107 Pfitsch,1,,24,22,46
107 Pfitsch,2,,16,14,30
107 Pfitsch,3,,10,20,30
107 Pfitsch,4,,14,10,24
107 Pfitsch,5,,12,15,27
107 Pfitsch,6,,17,11,28
107 Pfitsch,7,,12,20,32
107 Pfitsch,8,,18,12,30
107 Pfitsch,9,,13,16,29
107 Pfitsch,10,,20,13,33
107 Pfitsch,11,,20,17,37
107 Pfitsch,12,,11,20,31
107 Pfitsch,13,,14,14,28
107 Pfitsch,14,,12,18,30
107 Pfitsch,15,,16,9,25
107 Pfitsch,16,,15,10,25
107 Pfitsch,17,,25,12,37
107 Pfitsch,18,,22,20,42
107 Pfitsch,19,,29,14,43
107 Pfitsch,20,,24,16,40
107 Pfitsch,21,,20,21,41
107 Pfitsch,22,,28,20,48
107 Pfitsch,23,,23,15,38
107 Pfitsch,24,,18,23,41
107 Pfitsch,25,,20,19,39
107 Pfitsch,26,,16,18,34
107 Pfitsch,27,,15,21,36
107 Pfitsch,28,,18,15,33
107 Pfitsch,29,,16,18,34
107 Pfitsch,30,,21,18,39
107 Pfitsch,31,,26,18,44
107 Pfitsch,32,,24,26,50
107 Pfitsch,33,,22,24,46
107 Pfitsch,34,,21,17,38
107 Pfitsch,35,,26,18,44
107 Pfitsch,36,,23,17,40
107 Pfitsch,37,,14,25,39
107 Pfitsch,38,,18,16,34
107 Pfitsch,39,,26,25,51
107 Pfitsch,40,,22,21,43
107 Pfitsch,41,,15,25,40
107 Pfitsch,42,,17,18,35
107 Pfitsch,43,,22,17,39
107 Pfitsch,44,,24,24,48
107 Pfitsch,45,,19,14,33
107 Pfitsch,46,,17,15,32
107 Pfitsch,47,,22,23,45
107 Pfitsch,48,,21,14,35
107 Pfitsch,49,,19,23,42
107 Pfitsch,50,,23,14,37
107 Pfitsch,51,,23,17,40
107 Pfitsch,52,,18,20,38
107 Pfitsch,53,,9,11,20
107 Pfitsch,54,,10,14,24
107 Pfitsch,55,,15,13,28
107 Pfitsch,56,,14,12,26
107 Pfitsch,57,,12,17,29
107 Pfitsch,58,,22,12,34
107 Pfitsch,59,,26,13,39
107 Pfitsch,60,,17,17,34
107 Pfitsch,61,,14,16,30
107 Pfitsch,62,,15,9,24
107 Pfitsch,63,,4,14,18
107 Pfitsch,64,,9,12,21
107 Pfitsch,65,,9,13,22
107 Pfitsch,66,,10,8,18
107 Pfitsch,67,,11,5,16
107 Pfitsch,68,,13,13,26
107 Pfitsch,69,,3,15,18
107 Pfitsch,70,,10,14,24
107 Pfitsch,71,,9,14,23
107 Pfitsch,72,,17,12,29
107 Pfitsch,73,,7,14,21
107 Pfitsch,74,,11,11,22
107 Pfitsch,75,,6,12,18
107 Pfitsch,76,,12,10,22
107 Pfitsch,77,,4,19,23
107 Pfitsch,78,,7,14,21
107 Pfitsch,79,,8,5,13
107 Pfitsch,80,,7,7,14
107 Pfitsch,81,,1,7,8
107 Pfitsch,82,,2,7,9
107 Pfitsch,83,,-,3,3
107 Pfitsch,84,,2,5,7
107 Pfitsch,85,,1,3,4
107 Pfitsch,86,,2,5,7
107 Pfitsch,87,,-,3,3
107 Pfitsch,88,,-,2,2
107 Pfitsch,89,,-,5,5
107 Pfitsch,90,,1,1,2
107 Pfitsch,91,,1,-,1
107 Pfitsch,92,,1,3,4
107 Pfitsch,93,,-,5,5
107 Pfitsch,94,,1,-,1
107 Pfitsch,96,,-,1,1
107 Pfitsch,100,,-,1,1
108 Ahrntal,0,,29,31,60
108 Ahrntal,1,,46,40,86
108 Ahrntal,2,,35,36,71
108 Ahrntal,3,,37,38,75
108 Ahrntal,4,,41,44,85
108 Ahrntal,5,,39,49,88
108 Ahrntal,6,,36,31,67
108 Ahrntal,7,,26,27,53
108 Ahrntal,8,,40,41,81
108 Ahrntal,9,,41,32,73
108 Ahrntal,10,,26,37,63
108 Ahrntal,11,,41,31,72
108 Ahrntal,12,,38,33,71
108 Ahrntal,13,,28,33,61
108 Ahrntal,14,,37,37,74
108 Ahrntal,15,,38,50,88
108 Ahrntal,16,,35,45,80
108 Ahrntal,17,,41,33,74
108 Ahrntal,18,,45,48,93
108 Ahrntal,19,,38,45,83
108 Ahrntal,20,,50,40,90
108 Ahrntal,21,,37,37,74
108 Ahrntal,22,,45,37,82
108 Ahrntal,23,,33,50,83
108 Ahrntal,24,,50,45,95
108 Ahrntal,25,,46,50,96
108 Ahrntal,26,,45,47,92
108 Ahrntal,27,,48,46,94
108 Ahrntal,28,,44,46,90
108 Ahrntal,29,,56,55,111
108 Ahrntal,30,,71,42,113
108 Ahrntal,31,,53,44,97
108 Ahrntal,32,,52,49,101
108 Ahrntal,33,,52,52,104
108 Ahrntal,34,,47,50,97
108 Ahrntal,35,,62,38,100
108 Ahrntal,36,,55,42,97
108 Ahrntal,37,,55,44,99
108 Ahrntal,38,,46,45,91
108 Ahrntal,39,,39,49,88
108 Ahrntal,40,,35,35,70
108 Ahrntal,41,,40,30,70
108 Ahrntal,42,,41,37,78
108 Ahrntal,43,,49,26,75
108 Ahrntal,44,,27,40,67
108 Ahrntal,45,,37,20,57
108 Ahrntal,46,,36,26,62
108 Ahrntal,47,,33,22,55
108 Ahrntal,48,,26,30,56
108 Ahrntal,49,,27,31,58
108 Ahrntal,50,,34,26,60
108 Ahrntal,51,,32,24,56
108 Ahrntal,52,,32,31,63
108 Ahrntal,53,,29,28,57
108 Ahrntal,54,,26,16,42
108 Ahrntal,55,,17,23,40
108 Ahrntal,56,,20,14,34
108 Ahrntal,57,,19,18,37
108 Ahrntal,58,,23,31,54
108 Ahrntal,59,,29,30,59
108 Ahrntal,60,,30,32,62
108 Ahrntal,61,,31,24,55
108 Ahrntal,62,,27,23,50
108 Ahrntal,63,,37,30,67
108 Ahrntal,64,,26,22,48
108 Ahrntal,65,,22,16,38
108 Ahrntal,66,,23,37,60
108 Ahrntal,67,,21,20,41
108 Ahrntal,68,,20,17,37
108 Ahrntal,69,,21,27,48
108 Ahrntal,70,,35,22,57
108 Ahrntal,71,,22,20,42
108 Ahrntal,72,,21,17,38
108 Ahrntal,73,,14,26,40
108 Ahrntal,74,,18,18,36
108 Ahrntal,75,,20,14,34
108 Ahrntal,76,,13,18,31
108 Ahrntal,77,,12,17,29
108 Ahrntal,78,,10,13,23
108 Ahrntal,79,,9,15,24
108 Ahrntal,80,,7,9,16
108 Ahrntal,81,,5,6,11
108 Ahrntal,82,,8,4,12
108 Ahrntal,83,,-,6,6
108 Ahrntal,84,,3,6,9
108 Ahrntal,85,,-,4,4
108 Ahrntal,86,,2,11,13
108 Ahrntal,87,,7,10,17
108 Ahrntal,88,,3,4,7
108 Ahrntal,89,,3,8,11
108 Ahrntal,90,,1,4,5
108 Ahrntal,91,,3,1,4
108 Ahrntal,92,,2,3,5
108 Ahrntal,93,,-,3,3
108 Ahrntal,94,,-,2,2
108 Ahrntal,95,,-,1,1
108 Ahrntal,96,,1,-,1
109 Gsies,0,,15,17,32
109 Gsies,1,,9,9,18
109 Gsies,2,,22,14,36
109 Gsies,3,,19,6,25
109 Gsies,4,,12,15,27
109 Gsies,5,,11,18,29
109 Gsies,6,,15,14,29
109 Gsies,7,,10,19,29
109 Gsies,8,,17,19,36
109 Gsies,9,,16,10,26
109 Gsies,10,,16,25,41
109 Gsies,11,,16,13,29
109 Gsies,12,,9,12,21
109 Gsies,13,,7,14,21
109 Gsies,14,,18,17,35
109 Gsies,15,,12,17,29
109 Gsies,16,,17,13,30
109 Gsies,17,,13,8,21
109 Gsies,18,,17,10,27
109 Gsies,19,,18,19,37
109 Gsies,20,,15,18,33
109 Gsies,21,,23,21,44
109 Gsies,22,,10,17,27
109 Gsies,23,,14,15,29
109 Gsies,24,,17,18,35
109 Gsies,25,,14,17,31
109 Gsies,26,,20,29,49
109 Gsies,27,,22,18,40
109 Gsies,28,,16,14,30
109 Gsies,29,,10,18,28
109 Gsies,30,,22,20,42
109 Gsies,31,,28,15,43
109 Gsies,32,,26,11,37
109 Gsies,33,,15,15,30
109 Gsies,34,,16,13,29
109 Gsies,35,,14,19,33
109 Gsies,36,,21,6,27
109 Gsies,37,,16,17,33
109 Gsies,38,,14,16,30
109 Gsies,39,,17,8,25
109 Gsies,40,,9,13,22
109 Gsies,41,,18,17,35
109 Gsies,42,,12,14,26
109 Gsies,43,,16,16,32
109 Gsies,44,,12,14,26
109 Gsies,45,,17,7,24
109 Gsies,46,,17,11,28
109 Gsies,47,,16,6,22
109 Gsies,48,,18,6,24
109 Gsies,49,,17,11,28
109 Gsies,50,,16,13,29
109 Gsies,51,,8,8,16
109 Gsies,52,,15,15,30
109 Gsies,53,,9,10,19
109 Gsies,54,,22,7,29
109 Gsies,55,,15,10,25
109 Gsies,56,,4,11,15
109 Gsies,57,,8,13,21
109 Gsies,58,,10,9,19
109 Gsies,59,,5,13,18
109 Gsies,60,,6,11,17
109 Gsies,61,,9,11,20
109 Gsies,62,,6,9,15
109 Gsies,63,,7,9,16
109 Gsies,64,,11,8,19
109 Gsies,65,,4,10,14
109 Gsies,66,,4,9,13
109 Gsies,67,,5,9,14
109 Gsies,68,,6,5,11
109 Gsies,69,,10,6,16
109 Gsies,70,,7,10,17
109 Gsies,71,,12,6,18
109 Gsies,72,,3,6,9
109 Gsies,73,,8,9,17
109 Gsies,74,,3,11,14
109 Gsies,75,,4,4,8
109 Gsies,76,,7,5,12
109 Gsies,77,,5,7,12
109 Gsies,78,,6,8,14
109 Gsies,79,,10,7,17
109 Gsies,80,,3,11,14
109 Gsies,81,,4,4,8
109 Gsies,82,,4,2,6
109 Gsies,83,,1,2,3
109 Gsies,84,,1,2,3
109 Gsies,85,,1,-,1
109 Gsies,86,,2,1,3
109 Gsies,87,,2,2,4
109 Gsies,88,,1,3,4
109 Gsies,89,,5,6,11
109 Gsies,90,,1,4,5
109 Gsies,93,,-,3,3
109 Gsies,94,,-,2,2
109 Gsies,96,,1,1,2
110 Vintl,0,,18,19,37
110 Vintl,1,,22,14,36
110 Vintl,2,,20,22,42
110 Vintl,3,,22,30,52
110 Vintl,4,,19,17,36
110 Vintl,5,,21,17,38
110 Vintl,6,,36,25,61
110 Vintl,7,,19,19,38
110 Vintl,8,,24,21,45
110 Vintl,9,,28,21,49
110 Vintl,10,,21,30,51
110 Vintl,11,,28,22,50
110 Vintl,12,,26,17,43
110 Vintl,13,,21,19,40
110 Vintl,14,,20,23,43
110 Vintl,15,,21,20,41
110 Vintl,16,,10,15,25
110 Vintl,17,,27,10,37
110 Vintl,18,,24,17,41
110 Vintl,19,,21,21,42
110 Vintl,20,,19,25,44
110 Vintl,21,,33,20,53
110 Vintl,22,,33,16,49
110 Vintl,23,,20,33,53
110 Vintl,24,,16,23,39
110 Vintl,25,,20,26,46
110 Vintl,26,,24,20,44
110 Vintl,27,,27,27,54
110 Vintl,28,,21,21,42
110 Vintl,29,,34,22,56
110 Vintl,30,,30,27,57
110 Vintl,31,,19,19,38
110 Vintl,32,,31,25,56
110 Vintl,33,,25,21,46
110 Vintl,34,,31,36,67
110 Vintl,35,,34,29,63
110 Vintl,36,,34,33,67
110 Vintl,37,,36,24,60
110 Vintl,38,,31,27,58
110 Vintl,39,,31,24,55
110 Vintl,40,,27,31,58
110 Vintl,41,,18,24,42
110 Vintl,42,,24,23,47
110 Vintl,43,,18,11,29
110 Vintl,44,,24,28,52
110 Vintl,45,,25,19,44
110 Vintl,46,,19,14,33
110 Vintl,47,,16,18,34
110 Vintl,48,,23,9,32
110 Vintl,49,,18,19,37
110 Vintl,50,,22,18,40
110 Vintl,51,,24,18,42
110 Vintl,52,,19,18,37
110 Vintl,53,,12,13,25
110 Vintl,54,,20,14,34
110 Vintl,55,,15,13,28
110 Vintl,56,,17,18,35
110 Vintl,57,,11,5,16
110 Vintl,58,,21,12,33
110 Vintl,59,,11,13,24
110 Vintl,60,,6,16,22
110 Vintl,61,,8,20,28
110 Vintl,62,,17,15,32
110 Vintl,63,,12,5,17
110 Vintl,64,,10,10,20
110 Vintl,65,,14,10,24
110 Vintl,66,,9,12,21
110 Vintl,67,,17,8,25
110 Vintl,68,,6,18,24
110 Vintl,69,,10,15,25
110 Vintl,70,,11,12,23
110 Vintl,71,,8,15,23
110 Vintl,72,,11,16,27
110 Vintl,73,,13,9,22
110 Vintl,74,,9,15,24
110 Vintl,75,,15,7,22
110 Vintl,76,,7,9,16
110 Vintl,77,,7,9,16
110 Vintl,78,,10,10,20
110 Vintl,79,,4,9,13
110 Vintl,80,,6,6,12
110 Vintl,81,,2,8,10
110 Vintl,82,,2,5,7
110 Vintl,83,,1,2,3
110 Vintl,84,,2,4,6
110 Vintl,85,,2,2,4
110 Vintl,86,,1,3,4
110 Vintl,87,,2,5,7
110 Vintl,88,,-,4,4
110 Vintl,89,,1,1,2
110 Vintl,90,,-,5,5
110 Vintl,91,,1,2,3
110 Vintl,92,,-,1,1
110 Vintl,93,,-,1,1
110 Vintl,94,,1,1,2
111 Vahrn,0,,29,17,46
111 Vahrn,1,,26,20,46
111 Vahrn,2,,23,35,58
111 Vahrn,3,,26,19,45
111 Vahrn,4,,20,22,42
111 Vahrn,5,,32,19,51
111 Vahrn,6,,17,16,33
111 Vahrn,7,,19,23,42
111 Vahrn,8,,21,16,37
111 Vahrn,9,,18,21,39
111 Vahrn,10,,20,21,41
111 Vahrn,11,,14,27,41
111 Vahrn,12,,30,20,50
111 Vahrn,13,,21,20,41
111 Vahrn,14,,18,17,35
111 Vahrn,15,,19,13,32
111 Vahrn,16,,27,28,55
111 Vahrn,17,,19,21,40
111 Vahrn,18,,24,24,48
111 Vahrn,19,,25,26,51
111 Vahrn,20,,29,17,46
111 Vahrn,21,,22,23,45
111 Vahrn,22,,17,24,41
111 Vahrn,23,,21,24,45
111 Vahrn,24,,15,24,39
111 Vahrn,25,,35,22,57
111 Vahrn,26,,35,24,59
111 Vahrn,27,,23,34,57
111 Vahrn,28,,30,38,68
111 Vahrn,29,,36,30,66
111 Vahrn,30,,38,36,74
111 Vahrn,31,,36,35,71
111 Vahrn,32,,32,39,71
111 Vahrn,33,,29,31,60
111 Vahrn,34,,44,26,70
111 Vahrn,35,,36,31,67
111 Vahrn,36,,41,42,83
111 Vahrn,37,,40,34,74
111 Vahrn,38,,30,30,60
111 Vahrn,39,,33,34,67
111 Vahrn,40,,24,20,44
111 Vahrn,41,,31,29,60
111 Vahrn,42,,27,20,47
111 Vahrn,43,,20,19,39
111 Vahrn,44,,29,32,61
111 Vahrn,45,,23,18,41
111 Vahrn,46,,28,28,56
111 Vahrn,47,,21,30,51
111 Vahrn,48,,23,26,49
111 Vahrn,49,,23,18,41
111 Vahrn,50,,21,12,33
111 Vahrn,51,,17,17,34
111 Vahrn,52,,22,27,49
111 Vahrn,53,,19,13,32
111 Vahrn,54,,17,21,38
111 Vahrn,55,,19,24,43
111 Vahrn,56,,10,16,26
111 Vahrn,57,,18,23,41
111 Vahrn,58,,26,23,49
111 Vahrn,59,,20,22,42
111 Vahrn,60,,21,23,44
111 Vahrn,61,,20,15,35
111 Vahrn,62,,20,20,40
111 Vahrn,63,,14,10,24
111 Vahrn,64,,16,19,35
111 Vahrn,65,,13,17,30
111 Vahrn,66,,11,15,26
111 Vahrn,67,,11,15,26
111 Vahrn,68,,9,14,23
111 Vahrn,69,,11,15,26
111 Vahrn,70,,13,15,28
111 Vahrn,71,,15,16,31
111 Vahrn,72,,8,17,25
111 Vahrn,73,,10,12,22
111 Vahrn,74,,9,19,28
111 Vahrn,75,,9,4,13
111 Vahrn,76,,5,14,19
111 Vahrn,77,,7,18,25
111 Vahrn,78,,9,12,21
111 Vahrn,79,,5,13,18
111 Vahrn,80,,7,9,16
111 Vahrn,81,,3,4,7
111 Vahrn,82,,2,3,5
111 Vahrn,83,,3,4,7
111 Vahrn,84,,3,5,8
111 Vahrn,85,,1,-,1
111 Vahrn,86,,-,5,5
111 Vahrn,87,,2,3,5
111 Vahrn,88,,1,3,4
111 Vahrn,89,,1,6,7
111 Vahrn,90,,1,2,3
111 Vahrn,91,,-,2,2
111 Vahrn,92,,-,1,1
111 Vahrn,93,,-,1,1
111 Vahrn,95,,-,1,1
111 Vahrn,96,,-,1,1
111 Vahrn,97,,-,1,1
111 Vahrn,99,,1,-,1
112 Vöran,0,,7,4,11
112 Vöran,1,,12,5,17
112 Vöran,2,,6,2,8
112 Vöran,3,,6,4,10
112 Vöran,4,,13,5,18
112 Vöran,5,,9,6,15
112 Vöran,6,,5,9,14
112 Vöran,7,,7,8,15
112 Vöran,8,,7,7,14
112 Vöran,9,,6,3,9
112 Vöran,10,,8,3,11
112 Vöran,11,,6,7,13
112 Vöran,12,,11,5,16
112 Vöran,13,,8,7,15
112 Vöran,14,,13,6,19
112 Vöran,15,,6,7,13
112 Vöran,16,,9,12,21
112 Vöran,17,,9,4,13
112 Vöran,18,,6,6,12
112 Vöran,19,,7,9,16
112 Vöran,20,,10,9,19
112 Vöran,21,,4,5,9
112 Vöran,22,,4,6,10
112 Vöran,23,,10,9,19
112 Vöran,24,,13,7,20
112 Vöran,25,,6,3,9
112 Vöran,26,,6,6,12
112 Vöran,27,,9,8,17
112 Vöran,28,,7,5,12
112 Vöran,29,,10,6,16
112 Vöran,30,,7,11,18
112 Vöran,31,,9,6,15
112 Vöran,32,,6,3,9
112 Vöran,33,,15,2,17
112 Vöran,34,,6,5,11
112 Vöran,35,,8,7,15
112 Vöran,36,,4,4,8
112 Vöran,37,,10,4,14
112 Vöran,38,,8,7,15
112 Vöran,39,,13,16,29
112 Vöran,40,,6,7,13
112 Vöran,41,,7,6,13
112 Vöran,42,,5,7,12
112 Vöran,43,,7,4,11
112 Vöran,44,,3,9,12
112 Vöran,45,,2,2,4
112 Vöran,46,,5,2,7
112 Vöran,47,,6,6,12
112 Vöran,48,,5,4,9
112 Vöran,49,,9,1,10
112 Vöran,50,,2,-,2
112 Vöran,51,,7,4,11
112 Vöran,52,,6,4,10
112 Vöran,53,,2,3,5
112 Vöran,54,,6,4,10
112 Vöran,55,,4,2,6
112 Vöran,56,,-,3,3
112 Vöran,57,,4,3,7
112 Vöran,58,,3,5,8
112 Vöran,59,,6,4,10
112 Vöran,60,,5,6,11
112 Vöran,61,,2,5,7
112 Vöran,62,,3,3,6
112 Vöran,63,,8,4,12
112 Vöran,64,,2,2,4
112 Vöran,65,,4,5,9
112 Vöran,66,,2,1,3
112 Vöran,67,,1,7,8
112 Vöran,68,,6,6,12
112 Vöran,69,,3,5,8
112 Vöran,70,,5,2,7
112 Vöran,71,,5,1,6
112 Vöran,72,,1,3,4
112 Vöran,73,,5,1,6
112 Vöran,74,,-,2,2
112 Vöran,75,,-,3,3
112 Vöran,76,,3,4,7
112 Vöran,77,,-,2,2
112 Vöran,78,,2,1,3
112 Vöran,79,,2,-,2
112 Vöran,80,,3,1,4
112 Vöran,81,,-,2,2
112 Vöran,85,,1,2,3
112 Vöran,88,,-,1,1
112 Vöran,92,,-,1,1
112 Vöran,97,,-,1,1
113 Niederdorf,0,,6,11,17
113 Niederdorf,1,,10,11,21
113 Niederdorf,2,,5,6,11
113 Niederdorf,3,,6,8,14
113 Niederdorf,4,,8,9,17
113 Niederdorf,5,,7,8,15
113 Niederdorf,6,,6,11,17
113 Niederdorf,7,,12,7,19
113 Niederdorf,8,,9,7,16
113 Niederdorf,9,,7,9,16
113 Niederdorf,10,,7,13,20
113 Niederdorf,11,,12,10,22
113 Niederdorf,12,,8,7,15
113 Niederdorf,13,,6,9,15
113 Niederdorf,14,,2,8,10
113 Niederdorf,15,,4,6,10
113 Niederdorf,16,,8,5,13
113 Niederdorf,17,,8,5,13
113 Niederdorf,18,,7,9,16
113 Niederdorf,19,,3,10,13
113 Niederdorf,20,,10,7,17
113 Niederdorf,21,,9,4,13
113 Niederdorf,22,,10,4,14
113 Niederdorf,23,,4,4,8
113 Niederdorf,24,,7,5,12
113 Niederdorf,25,,12,5,17
113 Niederdorf,26,,6,9,15
113 Niederdorf,27,,8,9,17
113 Niederdorf,28,,13,6,19
113 Niederdorf,29,,14,9,23
113 Niederdorf,30,,12,13,25
113 Niederdorf,31,,11,13,24
113 Niederdorf,32,,20,13,33
113 Niederdorf,33,,15,10,25
113 Niederdorf,34,,13,14,27
113 Niederdorf,35,,23,10,33
113 Niederdorf,36,,10,16,26
113 Niederdorf,37,,17,13,30
113 Niederdorf,38,,12,9,21
113 Niederdorf,39,,17,9,26
113 Niederdorf,40,,13,13,26
113 Niederdorf,41,,9,10,19
113 Niederdorf,42,,11,9,20
113 Niederdorf,43,,6,6,12
113 Niederdorf,44,,10,10,20
113 Niederdorf,45,,10,10,20
113 Niederdorf,46,,11,8,19
113 Niederdorf,47,,12,7,19
113 Niederdorf,48,,7,3,10
113 Niederdorf,49,,8,4,12
113 Niederdorf,50,,1,2,3
113 Niederdorf,51,,6,3,9
113 Niederdorf,52,,9,4,13
113 Niederdorf,53,,5,8,13
113 Niederdorf,54,,6,9,15
113 Niederdorf,55,,6,7,13
113 Niederdorf,56,,2,6,8
113 Niederdorf,57,,11,5,16
113 Niederdorf,58,,5,9,14
113 Niederdorf,59,,5,11,16
113 Niederdorf,60,,5,5,10
113 Niederdorf,61,,5,6,11
113 Niederdorf,62,,1,4,5
113 Niederdorf,63,,5,7,12
113 Niederdorf,64,,6,7,13
113 Niederdorf,65,,6,8,14
113 Niederdorf,66,,7,6,13
113 Niederdorf,67,,2,13,15
113 Niederdorf,68,,7,7,14
113 Niederdorf,69,,8,7,15
113 Niederdorf,70,,8,7,15
113 Niederdorf,71,,6,10,16
113 Niederdorf,72,,5,9,14
113 Niederdorf,73,,5,6,11
113 Niederdorf,74,,8,9,17
113 Niederdorf,75,,4,6,10
113 Niederdorf,76,,1,7,8
113 Niederdorf,77,,3,10,13
113 Niederdorf,78,,2,3,5
113 Niederdorf,79,,4,9,13
113 Niederdorf,80,,5,4,9
113 Niederdorf,81,,2,4,6
113 Niederdorf,82,,1,3,4
113 Niederdorf,83,,1,2,3
113 Niederdorf,84,,1,-,1
113 Niederdorf,85,,1,2,3
113 Niederdorf,86,,-,3,3
113 Niederdorf,87,,-,1,1
113 Niederdorf,88,,1,1,2
113 Niederdorf,89,,-,2,2
113 Niederdorf,90,,-,1,1
113 Niederdorf,91,,-,3,3
113 Niederdorf,92,,-,1,1
113 Niederdorf,93,,-,2,2
113 Niederdorf,94,,-,1,1
113 Niederdorf,95,,-,1,1
113 Niederdorf,96,,-,1,1
113 Niederdorf,97,,-,1,1
113 Niederdorf,100,,-,1,1
114 Villanders,0,,15,12,27
114 Villanders,1,,11,16,27
114 Villanders,2,,13,11,24
114 Villanders,3,,13,8,21
114 Villanders,4,,11,13,24
114 Villanders,5,,15,8,23
114 Villanders,6,,18,6,24
114 Villanders,7,,11,13,24
114 Villanders,8,,7,18,25
114 Villanders,9,,14,8,22
114 Villanders,10,,19,16,35
114 Villanders,11,,16,14,30
114 Villanders,12,,13,10,23
114 Villanders,13,,10,12,22
114 Villanders,14,,7,15,22
114 Villanders,15,,8,8,16
114 Villanders,16,,10,10,20
114 Villanders,17,,13,13,26
114 Villanders,18,,14,6,20
114 Villanders,19,,15,12,27
114 Villanders,20,,20,15,35
114 Villanders,21,,10,18,28
114 Villanders,22,,16,5,21
114 Villanders,23,,13,15,28
114 Villanders,24,,15,14,29
114 Villanders,25,,13,14,27
114 Villanders,26,,10,12,22
114 Villanders,27,,14,16,30
114 Villanders,28,,12,17,29
114 Villanders,29,,13,14,27
114 Villanders,30,,17,25,42
114 Villanders,31,,16,8,24
114 Villanders,32,,25,20,45
114 Villanders,33,,23,11,34
114 Villanders,34,,19,16,35
114 Villanders,35,,23,17,40
114 Villanders,36,,22,16,38
114 Villanders,37,,20,17,37
114 Villanders,38,,15,15,30
114 Villanders,39,,19,12,31
114 Villanders,40,,14,13,27
114 Villanders,41,,19,7,26
114 Villanders,42,,16,11,27
114 Villanders,43,,16,8,24
114 Villanders,44,,9,7,16
114 Villanders,45,,10,11,21
114 Villanders,46,,10,17,27
114 Villanders,47,,9,5,14
114 Villanders,48,,10,8,18
114 Villanders,49,,11,7,18
114 Villanders,50,,10,7,17
114 Villanders,51,,10,9,19
114 Villanders,52,,10,6,16
114 Villanders,53,,7,12,19
114 Villanders,54,,7,8,15
114 Villanders,55,,11,10,21
114 Villanders,56,,6,4,10
114 Villanders,57,,5,9,14
114 Villanders,58,,7,8,15
114 Villanders,59,,10,8,18
114 Villanders,60,,8,9,17
114 Villanders,61,,8,12,20
114 Villanders,62,,9,5,14
114 Villanders,63,,9,6,15
114 Villanders,64,,5,9,14
114 Villanders,65,,6,6,12
114 Villanders,66,,2,8,10
114 Villanders,67,,1,9,10
114 Villanders,68,,11,9,20
114 Villanders,69,,8,9,17
114 Villanders,70,,6,7,13
114 Villanders,71,,10,6,16
114 Villanders,72,,4,9,13
114 Villanders,73,,4,9,13
114 Villanders,74,,8,6,14
114 Villanders,75,,6,6,12
114 Villanders,76,,2,7,9
114 Villanders,77,,5,5,10
114 Villanders,78,,6,3,9
114 Villanders,79,,4,6,10
114 Villanders,80,,3,11,14
114 Villanders,81,,4,4,8
114 Villanders,82,,-,3,3
114 Villanders,84,,-,3,3
114 Villanders,85,,-,2,2
114 Villanders,86,,-,4,4
114 Villanders,87,,2,5,7
114 Villanders,88,,1,3,4
114 Villanders,89,,1,4,5
114 Villanders,90,,-,7,7
114 Villanders,91,,1,2,3
114 Villanders,92,,-,3,3
114 Villanders,93,,2,-,2
114 Villanders,94,,-,1,1
114 Villanders,95,,1,-,1
114 Villanders,98,,-,1,1
114 Villanders,100,,-,1,1
115 Sterzing,0,,34,35,69
115 Sterzing,1,,24,34,58
115 Sterzing,2,,29,29,58
115 Sterzing,3,,23,30,53
115 Sterzing,4,,34,33,67
115 Sterzing,5,,27,36,63
115 Sterzing,6,,33,31,64
115 Sterzing,7,,32,21,53
115 Sterzing,8,,36,29,65
115 Sterzing,9,,32,32,64
115 Sterzing,10,,35,37,72
115 Sterzing,11,,22,33,55
115 Sterzing,12,,35,24,59
115 Sterzing,13,,29,25,54
115 Sterzing,14,,29,24,53
115 Sterzing,15,,36,30,66
115 Sterzing,16,,16,30,46
115 Sterzing,17,,33,24,57
115 Sterzing,18,,27,31,58
115 Sterzing,19,,27,36,63
115 Sterzing,20,,43,33,76
115 Sterzing,21,,30,41,71
115 Sterzing,22,,32,45,77
115 Sterzing,23,,47,31,78
115 Sterzing,24,,41,32,73
115 Sterzing,25,,34,42,76
115 Sterzing,26,,66,49,115
115 Sterzing,27,,52,38,90
115 Sterzing,28,,52,54,106
115 Sterzing,29,,60,56,116
115 Sterzing,30,,66,49,115
115 Sterzing,31,,53,56,109
115 Sterzing,32,,45,36,81
115 Sterzing,33,,62,50,112
115 Sterzing,34,,62,42,104
115 Sterzing,35,,51,57,108
115 Sterzing,36,,59,52,111
115 Sterzing,37,,55,42,97
115 Sterzing,38,,60,50,110
115 Sterzing,39,,43,46,89
115 Sterzing,40,,43,41,84
115 Sterzing,41,,45,47,92
115 Sterzing,42,,51,42,93
115 Sterzing,43,,44,42,86
115 Sterzing,44,,35,50,85
115 Sterzing,45,,48,28,76
115 Sterzing,46,,35,45,80
115 Sterzing,47,,33,38,71
115 Sterzing,48,,33,40,73
115 Sterzing,49,,44,39,83
115 Sterzing,50,,38,39,77
115 Sterzing,51,,33,41,74
115 Sterzing,52,,33,49,82
115 Sterzing,53,,38,44,82
115 Sterzing,54,,34,28,62
115 Sterzing,55,,46,43,89
115 Sterzing,56,,35,36,71
115 Sterzing,57,,31,28,59
115 Sterzing,58,,46,45,91
115 Sterzing,59,,30,34,64
115 Sterzing,60,,32,28,60
115 Sterzing,61,,46,32,78
115 Sterzing,62,,30,30,60
115 Sterzing,63,,29,28,57
115 Sterzing,64,,23,35,58
115 Sterzing,65,,23,44,67
115 Sterzing,66,,21,23,44
115 Sterzing,67,,20,25,45
115 Sterzing,68,,32,29,61
115 Sterzing,69,,21,18,39
115 Sterzing,70,,23,33,56
115 Sterzing,71,,10,25,35
115 Sterzing,72,,21,19,40
115 Sterzing,73,,19,29,48
115 Sterzing,74,,21,20,41
115 Sterzing,75,,16,21,37
115 Sterzing,76,,7,22,29
115 Sterzing,77,,13,20,33
115 Sterzing,78,,14,19,33
115 Sterzing,79,,15,25,40
115 Sterzing,80,,5,19,24
115 Sterzing,81,,2,12,14
115 Sterzing,82,,6,9,15
115 Sterzing,83,,4,4,8
115 Sterzing,84,,5,5,10
115 Sterzing,85,,4,7,11
115 Sterzing,86,,2,5,7
115 Sterzing,87,,2,13,15
115 Sterzing,88,,2,7,9
115 Sterzing,89,,1,9,10
115 Sterzing,90,,-,4,4
115 Sterzing,91,,1,2,3
115 Sterzing,92,,1,3,4
115 Sterzing,93,,3,1,4
115 Sterzing,94,,1,1,2
115 Sterzing,95,,-,2,2
115 Sterzing,96,,-,1,1
115 Sterzing,99,,-,1,1
115 Sterzing,100,,-,1,1
116 Feldthurns,0,,15,23,38
116 Feldthurns,1,,23,14,37
116 Feldthurns,2,,18,20,38
116 Feldthurns,3,,19,18,37
116 Feldthurns,4,,22,16,38
116 Feldthurns,5,,16,18,34
116 Feldthurns,6,,20,18,38
116 Feldthurns,7,,15,16,31
116 Feldthurns,8,,31,20,51
116 Feldthurns,9,,17,19,36
116 Feldthurns,10,,12,14,26
116 Feldthurns,11,,14,18,32
116 Feldthurns,12,,20,15,35
116 Feldthurns,13,,16,19,35
116 Feldthurns,14,,22,13,35
116 Feldthurns,15,,17,20,37
116 Feldthurns,16,,14,20,34
116 Feldthurns,17,,16,20,36
116 Feldthurns,18,,27,25,52
116 Feldthurns,19,,15,22,37
116 Feldthurns,20,,20,18,38
116 Feldthurns,21,,11,25,36
116 Feldthurns,22,,14,15,29
116 Feldthurns,23,,30,23,53
116 Feldthurns,24,,18,17,35
116 Feldthurns,25,,25,21,46
116 Feldthurns,26,,17,15,32
116 Feldthurns,27,,25,30,55
116 Feldthurns,28,,21,21,42
116 Feldthurns,29,,33,24,57
116 Feldthurns,30,,19,25,44
116 Feldthurns,31,,15,24,39
116 Feldthurns,32,,24,25,49
116 Feldthurns,33,,17,26,43
116 Feldthurns,34,,24,21,45
116 Feldthurns,35,,21,21,42
116 Feldthurns,36,,23,29,52
116 Feldthurns,37,,25,19,44
116 Feldthurns,38,,26,17,43
116 Feldthurns,39,,15,16,31
116 Feldthurns,40,,18,19,37
116 Feldthurns,41,,18,12,30
116 Feldthurns,42,,16,15,31
116 Feldthurns,43,,15,20,35
116 Feldthurns,44,,14,13,27
116 Feldthurns,45,,12,18,30
116 Feldthurns,46,,15,13,28
116 Feldthurns,47,,14,15,29
116 Feldthurns,48,,18,13,31
116 Feldthurns,49,,24,15,39
116 Feldthurns,50,,15,11,26
116 Feldthurns,51,,14,15,29
116 Feldthurns,52,,7,15,22
116 Feldthurns,53,,14,11,25
116 Feldthurns,54,,15,8,23
116 Feldthurns,55,,10,9,19
116 Feldthurns,56,,13,13,26
116 Feldthurns,57,,22,11,33
116 Feldthurns,58,,13,13,26
116 Feldthurns,59,,9,9,18
116 Feldthurns,60,,8,4,12
116 Feldthurns,61,,11,7,18
116 Feldthurns,62,,8,12,20
116 Feldthurns,63,,11,8,19
116 Feldthurns,64,,3,10,13
116 Feldthurns,65,,9,11,20
116 Feldthurns,66,,10,11,21
116 Feldthurns,67,,3,5,8
116 Feldthurns,68,,7,5,12
116 Feldthurns,69,,7,11,18
116 Feldthurns,70,,5,7,12
116 Feldthurns,71,,6,14,20
116 Feldthurns,72,,5,11,16
116 Feldthurns,73,,9,4,13
116 Feldthurns,74,,4,5,9
116 Feldthurns,75,,3,10,13
116 Feldthurns,76,,6,10,16
116 Feldthurns,77,,4,9,13
116 Feldthurns,78,,7,11,18
116 Feldthurns,79,,2,10,12
116 Feldthurns,80,,2,9,11
116 Feldthurns,81,,9,10,19
116 Feldthurns,82,,5,7,12
116 Feldthurns,83,,3,1,4
116 Feldthurns,84,,-,2,2
116 Feldthurns,85,,-,3,3
116 Feldthurns,86,,2,7,9
116 Feldthurns,87,,1,4,5
116 Feldthurns,88,,-,1,1
116 Feldthurns,89,,1,2,3
116 Feldthurns,90,,-,1,1
116 Feldthurns,92,,1,-,1
116 Feldthurns,95,,-,1,1
116 Feldthurns,97,,-,1,1
117 Wengen,0,,5,11,16
117 Wengen,1,,10,5,15
117 Wengen,2,,9,6,15
117 Wengen,3,,7,7,14
117 Wengen,4,,12,7,19
117 Wengen,5,,9,9,18
117 Wengen,6,,11,9,20
117 Wengen,7,,12,7,19
117 Wengen,8,,11,7,18
117 Wengen,9,,10,7,17
117 Wengen,10,,17,6,23
117 Wengen,11,,12,7,19
117 Wengen,12,,5,7,12
117 Wengen,13,,6,9,15
117 Wengen,14,,11,5,16
117 Wengen,15,,8,8,16
117 Wengen,16,,9,6,15
117 Wengen,17,,14,7,21
117 Wengen,18,,13,5,18
117 Wengen,19,,11,5,16
117 Wengen,20,,6,8,14
117 Wengen,21,,9,10,19
117 Wengen,22,,14,5,19
117 Wengen,23,,6,8,14
117 Wengen,24,,9,8,17
117 Wengen,25,,6,10,16
117 Wengen,26,,16,10,26
117 Wengen,27,,10,7,17
117 Wengen,28,,16,12,28
117 Wengen,29,,12,14,26
117 Wengen,30,,12,15,27
117 Wengen,31,,12,14,26
117 Wengen,32,,11,13,24
117 Wengen,33,,17,11,28
117 Wengen,34,,10,12,22
117 Wengen,35,,13,5,18
117 Wengen,36,,8,10,18
117 Wengen,37,,11,6,17
117 Wengen,38,,11,13,24
117 Wengen,39,,14,7,21
117 Wengen,40,,8,9,17
117 Wengen,41,,10,11,21
117 Wengen,42,,7,7,14
117 Wengen,43,,5,8,13
117 Wengen,44,,7,11,18
117 Wengen,45,,5,6,11
117 Wengen,46,,8,6,14
117 Wengen,47,,9,5,14
117 Wengen,48,,6,2,8
117 Wengen,49,,6,7,13
117 Wengen,50,,9,5,14
117 Wengen,51,,3,6,9
117 Wengen,52,,5,9,14
117 Wengen,53,,2,12,14
117 Wengen,54,,6,3,9
117 Wengen,55,,5,3,8
117 Wengen,56,,5,3,8
117 Wengen,57,,9,8,17
117 Wengen,58,,3,7,10
117 Wengen,59,,8,6,14
117 Wengen,60,,4,4,8
117 Wengen,61,,7,8,15
117 Wengen,62,,6,3,9
117 Wengen,63,,5,4,9
117 Wengen,64,,6,6,12
117 Wengen,65,,2,1,3
117 Wengen,66,,2,7,9
117 Wengen,67,,2,9,11
117 Wengen,68,,4,2,6
117 Wengen,69,,3,8,11
117 Wengen,70,,5,2,7
117 Wengen,71,,5,3,8
117 Wengen,72,,2,9,11
117 Wengen,73,,2,4,6
117 Wengen,74,,4,5,9
117 Wengen,75,,4,5,9
117 Wengen,76,,3,4,7
117 Wengen,77,,2,6,8
117 Wengen,78,,3,6,9
117 Wengen,79,,3,5,8
117 Wengen,80,,5,8,13
117 Wengen,81,,2,2,4
117 Wengen,82,,1,1,2
117 Wengen,84,,2,-,2
117 Wengen,86,,1,1,2
117 Wengen,88,,-,2,2
117 Wengen,89,,1,-,1
117 Wengen,91,,-,1,1
117 Wengen,93,,-,2,2
117 Wengen,95,,1,-,1
117 Wengen,96,,1,-,1
117 Wengen,97,,-,1,1
118 U.L.Frau i.W.-St.Felix,0,,7,7,14
118 U.L.Frau i.W.-St.Felix,1,,3,2,5
118 U.L.Frau i.W.-St.Felix,2,,7,5,12
118 U.L.Frau i.W.-St.Felix,3,,6,9,15
118 U.L.Frau i.W.-St.Felix,4,,5,4,9
118 U.L.Frau i.W.-St.Felix,5,,8,5,13
118 U.L.Frau i.W.-St.Felix,6,,4,10,14
118 U.L.Frau i.W.-St.Felix,7,,7,8,15
118 U.L.Frau i.W.-St.Felix,8,,9,5,14
118 U.L.Frau i.W.-St.Felix,9,,7,4,11
118 U.L.Frau i.W.-St.Felix,10,,10,8,18
118 U.L.Frau i.W.-St.Felix,11,,7,4,11
118 U.L.Frau i.W.-St.Felix,12,,8,6,14
118 U.L.Frau i.W.-St.Felix,13,,8,6,14
118 U.L.Frau i.W.-St.Felix,14,,4,7,11
118 U.L.Frau i.W.-St.Felix,15,,7,4,11
118 U.L.Frau i.W.-St.Felix,16,,5,7,12
118 U.L.Frau i.W.-St.Felix,17,,5,7,12
118 U.L.Frau i.W.-St.Felix,18,,2,12,14
118 U.L.Frau i.W.-St.Felix,19,,3,6,9
118 U.L.Frau i.W.-St.Felix,20,,6,4,10
118 U.L.Frau i.W.-St.Felix,21,,3,6,9
118 U.L.Frau i.W.-St.Felix,22,,2,3,5
118 U.L.Frau i.W.-St.Felix,23,,1,4,5
118 U.L.Frau i.W.-St.Felix,24,,4,3,7
118 U.L.Frau i.W.-St.Felix,25,,4,8,12
118 U.L.Frau i.W.-St.Felix,26,,8,3,11
118 U.L.Frau i.W.-St.Felix,27,,5,4,9
118 U.L.Frau i.W.-St.Felix,28,,4,4,8
118 U.L.Frau i.W.-St.Felix,29,,8,4,12
118 U.L.Frau i.W.-St.Felix,30,,2,4,6
118 U.L.Frau i.W.-St.Felix,31,,5,8,13
118 U.L.Frau i.W.-St.Felix,32,,7,4,11
118 U.L.Frau i.W.-St.Felix,33,,6,9,15
118 U.L.Frau i.W.-St.Felix,34,,3,5,8
118 U.L.Frau i.W.-St.Felix,35,,8,7,15
118 U.L.Frau i.W.-St.Felix,36,,10,6,16
118 U.L.Frau i.W.-St.Felix,37,,4,8,12
118 U.L.Frau i.W.-St.Felix,38,,16,8,24
118 U.L.Frau i.W.-St.Felix,39,,8,11,19
118 U.L.Frau i.W.-St.Felix,40,,4,4,8
118 U.L.Frau i.W.-St.Felix,41,,8,9,17
118 U.L.Frau i.W.-St.Felix,42,,5,5,10
118 U.L.Frau i.W.-St.Felix,43,,4,2,6
118 U.L.Frau i.W.-St.Felix,44,,3,5,8
118 U.L.Frau i.W.-St.Felix,45,,5,7,12
118 U.L.Frau i.W.-St.Felix,46,,3,4,7
118 U.L.Frau i.W.-St.Felix,47,,7,3,10
118 U.L.Frau i.W.-St.Felix,48,,3,3,6
118 U.L.Frau i.W.-St.Felix,49,,6,3,9
118 U.L.Frau i.W.-St.Felix,50,,6,3,9
118 U.L.Frau i.W.-St.Felix,51,,3,3,6
118 U.L.Frau i.W.-St.Felix,52,,5,-,5
118 U.L.Frau i.W.-St.Felix,53,,4,2,6
118 U.L.Frau i.W.-St.Felix,54,,2,6,8
118 U.L.Frau i.W.-St.Felix,55,,1,5,6
118 U.L.Frau i.W.-St.Felix,56,,3,1,4
118 U.L.Frau i.W.-St.Felix,57,,5,1,6
118 U.L.Frau i.W.-St.Felix,58,,8,4,12
118 U.L.Frau i.W.-St.Felix,59,,4,4,8
118 U.L.Frau i.W.-St.Felix,60,,5,8,13
118 U.L.Frau i.W.-St.Felix,61,,3,1,4
118 U.L.Frau i.W.-St.Felix,62,,1,4,5
118 U.L.Frau i.W.-St.Felix,63,,3,4,7
118 U.L.Frau i.W.-St.Felix,64,,3,-,3
118 U.L.Frau i.W.-St.Felix,65,,5,2,7
118 U.L.Frau i.W.-St.Felix,66,,3,3,6
118 U.L.Frau i.W.-St.Felix,67,,3,3,6
118 U.L.Frau i.W.-St.Felix,68,,5,4,9
118 U.L.Frau i.W.-St.Felix,69,,6,1,7
118 U.L.Frau i.W.-St.Felix,70,,4,1,5
118 U.L.Frau i.W.-St.Felix,71,,4,5,9
118 U.L.Frau i.W.-St.Felix,72,,1,3,4
118 U.L.Frau i.W.-St.Felix,73,,3,5,8
118 U.L.Frau i.W.-St.Felix,74,,3,4,7
118 U.L.Frau i.W.-St.Felix,75,,2,3,5
118 U.L.Frau i.W.-St.Felix,76,,4,5,9
118 U.L.Frau i.W.-St.Felix,77,,5,4,9
118 U.L.Frau i.W.-St.Felix,78,,2,5,7
118 U.L.Frau i.W.-St.Felix,79,,1,2,3
118 U.L.Frau i.W.-St.Felix,80,,-,3,3
118 U.L.Frau i.W.-St.Felix,81,,-,1,1
118 U.L.Frau i.W.-St.Felix,82,,1,2,3
118 U.L.Frau i.W.-St.Felix,84,,1,-,1
118 U.L.Frau i.W.-St.Felix,86,,-,1,1
118 U.L.Frau i.W.-St.Felix,87,,1,1,2
118 U.L.Frau i.W.-St.Felix,88,,1,2,3
118 U.L.Frau i.W.-St.Felix,89,,2,2,4
118 U.L.Frau i.W.-St.Felix,91,,-,2,2

