Gemeinde,Altersklassen,Geschlecht,Männer,Frauen,Insgesamt
001 Aldein,0,,10,11,21
001 Aldein,1,,16,10,26
001 Aldein,2,,12,5,17
001 Aldein,3,,16,14,30
001 Aldein,4,,8,15,23
001 Aldein,5,,14,9,23
001 Aldein,6,,7,8,15
001 Aldein,7,,9,12,21
001 Aldein,8,,14,8,22
001 Aldein,9,,13,12,25
001 Aldein,10,,9,13,22
001 Aldein,11,,7,8,15
001 Aldein,12,,8,6,14
001 Aldein,13,,9,16,25
001 Aldein,14,,11,9,20
001 Aldein,15,,11,8,19
001 Aldein,16,,11,10,21
001 Aldein,17,,12,12,24
001 Aldein,18,,10,7,17
001 Aldein,19,,14,12,26
001 Aldein,20,,15,6,21
001 Aldein,21,,10,14,24
001 Aldein,22,,10,14,24
001 Aldein,23,,10,18,28
001 Aldein,24,,10,9,19
001 Aldein,25,,8,21,29
001 Aldein,26,,13,17,30
001 Aldein,27,,17,18,35
001 Aldein,28,,11,15,26
001 Aldein,29,,15,8,23
001 Aldein,30,,17,13,30
001 Aldein,31,,17,17,34
001 Aldein,32,,14,15,29
001 Aldein,33,,22,8,30
001 Aldein,34,,12,16,28
001 Aldein,35,,6,16,22
001 Aldein,36,,7,20,27
001 Aldein,37,,17,10,27
001 Aldein,38,,14,10,24
001 Aldein,39,,14,6,20
001 Aldein,40,,8,16,24
001 Aldein,41,,15,17,32
001 Aldein,42,,16,9,25
001 Aldein,43,,12,13,25
001 Aldein,44,,8,5,13
001 Aldein,45,,9,10,19
001 Aldein,46,,10,8,18
001 Aldein,47,,8,10,18
001 Aldein,48,,9,7,16
001 Aldein,49,,8,10,18
001 Aldein,50,,9,5,14
001 Aldein,51,,15,11,26
001 Aldein,52,,5,12,17
001 Aldein,53,,8,6,14
001 Aldein,54,,9,9,18
001 Aldein,55,,5,11,16
001 Aldein,56,,7,11,18
001 Aldein,57,,7,5,12
001 Aldein,58,,6,6,12
001 Aldein,59,,11,11,22
001 Aldein,60,,8,13,21
001 Aldein,61,,6,12,18
001 Aldein,62,,9,8,17
001 Aldein,63,,5,8,13
001 Aldein,64,,6,7,13
001 Aldein,65,,7,10,17
001 Aldein,66,,8,6,14
001 Aldein,67,,4,4,8
001 Aldein,68,,15,5,20
001 Aldein,69,,8,3,11
001 Aldein,70,,5,8,13
001 Aldein,71,,8,4,12
001 Aldein,72,,5,5,10
001 Aldein,73,,9,9,18
001 Aldein,74,,5,3,8
001 Aldein,75,,6,6,12
001 Aldein,76,,-,5,5
001 Aldein,77,,2,5,7
001 Aldein,78,,2,8,10
001 Aldein,79,,2,5,7
001 Aldein,80,,1,9,10
001 Aldein,81,,4,10,14
001 Aldein,82,,4,2,6
001 Aldein,83,,-,4,4
001 Aldein,85,,-,1,1
001 Aldein,86,,2,1,3
001 Aldein,88,,-,2,2
001 Aldein,89,,-,3,3
001 Aldein,90,,2,2,4
001 Aldein,91,,-,1,1
001 Aldein,92,,2,-,2
001 Aldein,93,,-,1,1
001 Aldein,94,,-,2,2
001 Aldein,95,,-,1,1
002 Andrian,0,,2,-,2
002 Andrian,1,,2,4,6
002 Andrian,2,,5,4,9
002 Andrian,3,,2,6,8
002 Andrian,4,,8,1,9
002 Andrian,5,,9,6,15
002 Andrian,6,,2,10,12
002 Andrian,7,,8,4,12
002 Andrian,8,,5,5,10
002 Andrian,9,,5,5,10
002 Andrian,10,,6,6,12
002 Andrian,11,,5,7,12
002 Andrian,12,,5,4,9
002 Andrian,13,,4,3,7
002 Andrian,14,,12,7,19
002 Andrian,15,,6,7,13
002 Andrian,16,,8,6,14
002 Andrian,17,,1,3,4
002 Andrian,18,,6,5,11
002 Andrian,19,,5,2,7
002 Andrian,20,,10,6,16
002 Andrian,21,,1,3,4
002 Andrian,22,,6,2,8
002 Andrian,23,,6,4,10
002 Andrian,24,,5,6,11
002 Andrian,25,,4,4,8
002 Andrian,26,,6,4,10
002 Andrian,27,,5,1,6
002 Andrian,28,,5,6,11
002 Andrian,29,,5,7,12
002 Andrian,30,,7,6,13
002 Andrian,31,,7,11,18
002 Andrian,32,,12,5,17
002 Andrian,33,,5,7,12
002 Andrian,34,,9,8,17
002 Andrian,35,,9,7,16
002 Andrian,36,,8,8,16
002 Andrian,37,,11,7,18
002 Andrian,38,,8,7,15
002 Andrian,39,,7,12,19
002 Andrian,40,,8,7,15
002 Andrian,41,,7,2,9
002 Andrian,42,,7,4,11
002 Andrian,43,,6,5,11
002 Andrian,44,,7,8,15
002 Andrian,45,,5,7,12
002 Andrian,46,,5,9,14
002 Andrian,47,,2,4,6
002 Andrian,48,,5,2,7
002 Andrian,49,,7,7,14
002 Andrian,50,,2,3,5
002 Andrian,51,,3,3,6
002 Andrian,52,,7,6,13
002 Andrian,53,,4,2,6
002 Andrian,54,,6,3,9
002 Andrian,55,,5,4,9
002 Andrian,56,,4,8,12
002 Andrian,57,,1,2,3
002 Andrian,58,,1,3,4
002 Andrian,59,,5,7,12
002 Andrian,60,,4,5,9
002 Andrian,61,,6,4,10
002 Andrian,62,,4,8,12
002 Andrian,63,,1,8,9
002 Andrian,64,,4,4,8
002 Andrian,65,,6,4,10
002 Andrian,66,,2,2,4
002 Andrian,67,,3,3,6
002 Andrian,68,,5,3,8
002 Andrian,69,,3,4,7
002 Andrian,70,,7,5,12
002 Andrian,71,,3,4,7
002 Andrian,72,,4,1,5
002 Andrian,73,,2,1,3
002 Andrian,74,,2,4,6
002 Andrian,75,,1,2,3
002 Andrian,76,,4,4,8
002 Andrian,77,,2,1,3
002 Andrian,78,,2,4,6
002 Andrian,79,,1,1,2
002 Andrian,80,,1,4,5
002 Andrian,81,,1,4,5
002 Andrian,82,,1,1,2
002 Andrian,83,,2,2,4
002 Andrian,84,,2,1,3
002 Andrian,86,,1,-,1
002 Andrian,87,,1,2,3
002 Andrian,88,,1,1,2
002 Andrian,89,,1,1,2
002 Andrian,90,,-,1,1
002 Andrian,91,,-,1,1
002 Andrian,95,,-,1,1
003 Altrei,0,,3,2,5
003 Altrei,1,,3,1,4
003 Altrei,2,,1,1,2
003 Altrei,3,,3,-,3
003 Altrei,4,,3,1,4
003 Altrei,5,,1,1,2
003 Altrei,6,,-,3,3
003 Altrei,7,,1,2,3
003 Altrei,8,,3,2,5
003 Altrei,9,,3,-,3
003 Altrei,10,,6,3,9
003 Altrei,11,,1,1,2
003 Altrei,12,,3,2,5
003 Altrei,13,,2,2,4
003 Altrei,14,,4,4,8
003 Altrei,15,,1,1,2
003 Altrei,16,,3,3,6
003 Altrei,17,,2,2,4
003 Altrei,18,,3,1,4
003 Altrei,19,,4,2,6
003 Altrei,20,,2,2,4
003 Altrei,21,,3,1,4
003 Altrei,22,,3,4,7
003 Altrei,23,,-,1,1
003 Altrei,24,,2,5,7
003 Altrei,25,,-,4,4
003 Altrei,26,,2,3,5
003 Altrei,27,,2,1,3
003 Altrei,28,,1,1,2
003 Altrei,29,,2,3,5
003 Altrei,30,,2,1,3
003 Altrei,31,,5,4,9
003 Altrei,32,,1,3,4
003 Altrei,33,,3,5,8
003 Altrei,34,,-,4,4
003 Altrei,35,,3,-,3
003 Altrei,36,,3,4,7
003 Altrei,37,,2,4,6
003 Altrei,38,,3,6,9
003 Altrei,39,,2,2,4
003 Altrei,40,,11,1,12
003 Altrei,41,,2,2,4
003 Altrei,42,,6,2,8
003 Altrei,43,,5,2,7
003 Altrei,44,,1,3,4
003 Altrei,45,,1,3,4
003 Altrei,46,,5,1,6
003 Altrei,47,,3,3,6
003 Altrei,48,,1,1,2
003 Altrei,49,,3,2,5
003 Altrei,50,,6,3,9
003 Altrei,51,,6,3,9
003 Altrei,52,,1,2,3
003 Altrei,53,,1,-,1
003 Altrei,54,,3,3,6
003 Altrei,55,,3,2,5
003 Altrei,56,,1,3,4
003 Altrei,57,,3,-,3
003 Altrei,58,,2,3,5
003 Altrei,59,,1,3,4
003 Altrei,60,,3,1,4
003 Altrei,61,,1,2,3
003 Altrei,62,,2,4,6
003 Altrei,63,,1,3,4
003 Altrei,64,,1,-,1
003 Altrei,65,,2,1,3
003 Altrei,66,,3,1,4
003 Altrei,67,,3,1,4
003 Altrei,68,,-,2,2
003 Altrei,69,,3,3,6
003 Altrei,70,,-,3,3
003 Altrei,71,,-,2,2
003 Altrei,72,,2,2,4
003 Altrei,73,,2,3,5
003 Altrei,74,,-,2,2
003 Altrei,75,,2,4,6
003 Altrei,76,,1,4,5
003 Altrei,77,,-,1,1
003 Altrei,78,,1,3,4
003 Altrei,79,,1,2,3
003 Altrei,80,,1,1,2
003 Altrei,81,,-,1,1
003 Altrei,82,,1,1,2
003 Altrei,83,,-,1,1
003 Altrei,85,,-,3,3
003 Altrei,87,,-,1,1
003 Altrei,88,,-,2,2
003 Altrei,89,,1,1,2
003 Altrei,90,,1,-,1
003 Altrei,91,,-,2,2
003 Altrei,94,,-,1,1
003 Altrei,96,,1,-,1
004 Eppan a.d. Weinstr.,0,,74,74,148
004 Eppan a.d. Weinstr.,1,,79,73,152
004 Eppan a.d. Weinstr.,2,,67,86,153
004 Eppan a.d. Weinstr.,3,,79,57,136
004 Eppan a.d. Weinstr.,4,,85,77,162
004 Eppan a.d. Weinstr.,5,,72,73,145
004 Eppan a.d. Weinstr.,6,,76,71,147
004 Eppan a.d. Weinstr.,7,,69,64,133
004 Eppan a.d. Weinstr.,8,,71,72,143
004 Eppan a.d. Weinstr.,9,,79,85,164
004 Eppan a.d. Weinstr.,10,,62,76,138
004 Eppan a.d. Weinstr.,11,,75,63,138
004 Eppan a.d. Weinstr.,12,,82,61,143
004 Eppan a.d. Weinstr.,13,,75,59,134
004 Eppan a.d. Weinstr.,14,,79,83,162
004 Eppan a.d. Weinstr.,15,,73,68,141
004 Eppan a.d. Weinstr.,16,,87,68,155
004 Eppan a.d. Weinstr.,17,,81,56,137
004 Eppan a.d. Weinstr.,18,,76,73,149
004 Eppan a.d. Weinstr.,19,,62,67,129
004 Eppan a.d. Weinstr.,20,,66,68,134
004 Eppan a.d. Weinstr.,21,,56,70,126
004 Eppan a.d. Weinstr.,22,,80,71,151
004 Eppan a.d. Weinstr.,23,,73,65,138
004 Eppan a.d. Weinstr.,24,,75,71,146
004 Eppan a.d. Weinstr.,25,,79,57,136
004 Eppan a.d. Weinstr.,26,,75,69,144
004 Eppan a.d. Weinstr.,27,,86,92,178
004 Eppan a.d. Weinstr.,28,,77,94,171
004 Eppan a.d. Weinstr.,29,,93,96,189
004 Eppan a.d. Weinstr.,30,,104,117,221
004 Eppan a.d. Weinstr.,31,,114,104,218
004 Eppan a.d. Weinstr.,32,,126,120,246
004 Eppan a.d. Weinstr.,33,,121,116,237
004 Eppan a.d. Weinstr.,34,,117,107,224
004 Eppan a.d. Weinstr.,35,,130,115,245
004 Eppan a.d. Weinstr.,36,,117,133,250
004 Eppan a.d. Weinstr.,37,,100,113,213
004 Eppan a.d. Weinstr.,38,,126,118,244
004 Eppan a.d. Weinstr.,39,,102,125,227
004 Eppan a.d. Weinstr.,40,,124,111,235
004 Eppan a.d. Weinstr.,41,,125,104,229
004 Eppan a.d. Weinstr.,42,,104,114,218
004 Eppan a.d. Weinstr.,43,,122,104,226
004 Eppan a.d. Weinstr.,44,,105,99,204
004 Eppan a.d. Weinstr.,45,,94,92,186
004 Eppan a.d. Weinstr.,46,,86,75,161
004 Eppan a.d. Weinstr.,47,,91,89,180
004 Eppan a.d. Weinstr.,48,,67,91,158
004 Eppan a.d. Weinstr.,49,,84,75,159
004 Eppan a.d. Weinstr.,50,,71,79,150
004 Eppan a.d. Weinstr.,51,,80,65,145
004 Eppan a.d. Weinstr.,52,,63,71,134
004 Eppan a.d. Weinstr.,53,,66,64,130
004 Eppan a.d. Weinstr.,54,,83,68,151
004 Eppan a.d. Weinstr.,55,,70,84,154
004 Eppan a.d. Weinstr.,56,,84,71,155
004 Eppan a.d. Weinstr.,57,,63,53,116
004 Eppan a.d. Weinstr.,58,,74,82,156
004 Eppan a.d. Weinstr.,59,,95,83,178
004 Eppan a.d. Weinstr.,60,,97,81,178
004 Eppan a.d. Weinstr.,61,,66,106,172
004 Eppan a.d. Weinstr.,62,,80,61,141
004 Eppan a.d. Weinstr.,63,,62,85,147
004 Eppan a.d. Weinstr.,64,,62,54,116
004 Eppan a.d. Weinstr.,65,,47,57,104
004 Eppan a.d. Weinstr.,66,,47,51,98
004 Eppan a.d. Weinstr.,67,,43,49,92
004 Eppan a.d. Weinstr.,68,,33,56,89
004 Eppan a.d. Weinstr.,69,,54,56,110
004 Eppan a.d. Weinstr.,70,,49,50,99
004 Eppan a.d. Weinstr.,71,,41,61,102
004 Eppan a.d. Weinstr.,72,,52,63,115
004 Eppan a.d. Weinstr.,73,,42,53,95
004 Eppan a.d. Weinstr.,74,,40,44,84
004 Eppan a.d. Weinstr.,75,,35,46,81
004 Eppan a.d. Weinstr.,76,,42,48,90
004 Eppan a.d. Weinstr.,77,,37,56,93
004 Eppan a.d. Weinstr.,78,,24,67,91
004 Eppan a.d. Weinstr.,79,,24,43,67
004 Eppan a.d. Weinstr.,80,,15,46,61
004 Eppan a.d. Weinstr.,81,,24,41,65
004 Eppan a.d. Weinstr.,82,,16,27,43
004 Eppan a.d. Weinstr.,83,,14,24,38
004 Eppan a.d. Weinstr.,84,,10,17,27
004 Eppan a.d. Weinstr.,85,,11,11,22
004 Eppan a.d. Weinstr.,86,,9,16,25
004 Eppan a.d. Weinstr.,87,,9,12,21
004 Eppan a.d. Weinstr.,88,,11,22,33
004 Eppan a.d. Weinstr.,89,,5,14,19
004 Eppan a.d. Weinstr.,90,,3,18,21
004 Eppan a.d. Weinstr.,91,,3,19,22
004 Eppan a.d. Weinstr.,92,,1,8,9
004 Eppan a.d. Weinstr.,93,,3,10,13
004 Eppan a.d. Weinstr.,94,,-,5,5
004 Eppan a.d. Weinstr.,95,,-,5,5
004 Eppan a.d. Weinstr.,96,,1,2,3
004 Eppan a.d. Weinstr.,97,,1,-,1
004 Eppan a.d. Weinstr.,98,,-,1,1
004 Eppan a.d. Weinstr.,99,,-,1,1
004 Eppan a.d. Weinstr.,100,,-,1,1
004 Eppan a.d. Weinstr.,101,,-,1,1
005 Hafling,0,,5,4,9
005 Hafling,1,,9,2,11
005 Hafling,2,,4,9,13
005 Hafling,3,,4,4,8
005 Hafling,4,,2,7,9
005 Hafling,5,,1,10,11
005 Hafling,6,,12,5,17
005 Hafling,7,,6,5,11
005 Hafling,8,,3,5,8
005 Hafling,9,,3,7,10
005 Hafling,10,,3,5,8
005 Hafling,11,,8,3,11
005 Hafling,12,,5,6,11
005 Hafling,13,,4,2,6
005 Hafling,14,,2,7,9
005 Hafling,15,,4,4,8
005 Hafling,16,,5,3,8
005 Hafling,17,,5,5,10
005 Hafling,18,,4,9,13
005 Hafling,19,,3,-,3
005 Hafling,20,,6,4,10
005 Hafling,21,,5,4,9
005 Hafling,22,,4,10,14
005 Hafling,23,,4,3,7
005 Hafling,24,,3,5,8
005 Hafling,25,,3,4,7
005 Hafling,26,,4,6,10
005 Hafling,27,,9,5,14
005 Hafling,28,,7,8,15
005 Hafling,29,,12,3,15
005 Hafling,30,,9,1,10
005 Hafling,31,,9,6,15
005 Hafling,32,,7,5,12
005 Hafling,33,,10,10,20
005 Hafling,34,,3,8,11
005 Hafling,35,,5,3,8
005 Hafling,36,,10,6,16
005 Hafling,37,,9,11,20
005 Hafling,38,,3,2,5
005 Hafling,39,,7,3,10
005 Hafling,40,,5,2,7
005 Hafling,41,,8,4,12
005 Hafling,42,,8,7,15
005 Hafling,43,,6,6,12
005 Hafling,44,,3,4,7
005 Hafling,45,,2,5,7
005 Hafling,46,,3,11,14
005 Hafling,47,,8,3,11
005 Hafling,48,,3,1,4
005 Hafling,49,,3,3,6
005 Hafling,50,,5,2,7
005 Hafling,51,,2,3,5
005 Hafling,52,,4,3,7
005 Hafling,53,,5,3,8
005 Hafling,54,,6,2,8
005 Hafling,55,,2,4,6
005 Hafling,56,,-,4,4
005 Hafling,57,,5,3,8
005 Hafling,58,,1,3,4
005 Hafling,59,,4,5,9
005 Hafling,60,,5,3,8
005 Hafling,61,,5,4,9
005 Hafling,62,,2,2,4
005 Hafling,63,,4,5,9
005 Hafling,64,,3,3,6
005 Hafling,65,,3,2,5
005 Hafling,66,,1,1,2
005 Hafling,67,,1,1,2
005 Hafling,68,,1,2,3
005 Hafling,69,,6,3,9
005 Hafling,70,,3,4,7
005 Hafling,71,,3,7,10
005 Hafling,72,,2,4,6
005 Hafling,73,,4,1,5
005 Hafling,74,,3,3,6
005 Hafling,75,,3,5,8
005 Hafling,76,,1,2,3
005 Hafling,77,,1,-,1
005 Hafling,78,,1,2,3
005 Hafling,79,,1,-,1
005 Hafling,80,,-,3,3
005 Hafling,81,,-,3,3
005 Hafling,82,,3,1,4
005 Hafling,83,,1,2,3
005 Hafling,85,,-,1,1
005 Hafling,86,,1,1,2
005 Hafling,87,,1,-,1
005 Hafling,88,,1,-,1
005 Hafling,89,,-,1,1
005 Hafling,90,,-,1,1
005 Hafling,91,,1,-,1
006 Abtei,0,,12,27,39
006 Abtei,1,,27,23,50
006 Abtei,2,,20,30,50
006 Abtei,3,,23,25,48
006 Abtei,4,,13,13,26
006 Abtei,5,,27,22,49
006 Abtei,6,,29,14,43
006 Abtei,7,,24,27,51
006 Abtei,8,,19,13,32
006 Abtei,9,,15,19,34
006 Abtei,10,,24,16,40
006 Abtei,11,,21,12,33
006 Abtei,12,,23,16,39
006 Abtei,13,,15,14,29
006 Abtei,14,,14,10,24
006 Abtei,15,,19,12,31
006 Abtei,16,,17,18,35
006 Abtei,17,,11,13,24
006 Abtei,18,,12,20,32
006 Abtei,19,,14,11,25
006 Abtei,20,,18,19,37
006 Abtei,21,,16,19,35
006 Abtei,22,,23,16,39
006 Abtei,23,,12,23,35
006 Abtei,24,,22,26,48
006 Abtei,25,,21,29,50
006 Abtei,26,,26,24,50
006 Abtei,27,,18,28,46
006 Abtei,28,,21,26,47
006 Abtei,29,,26,24,50
006 Abtei,30,,42,29,71
006 Abtei,31,,17,32,49
006 Abtei,32,,29,28,57
006 Abtei,33,,29,34,63
006 Abtei,34,,27,33,60
006 Abtei,35,,37,37,74
006 Abtei,36,,22,31,53
006 Abtei,37,,34,27,61
006 Abtei,38,,24,30,54
006 Abtei,39,,31,26,57
006 Abtei,40,,24,29,53
006 Abtei,41,,22,27,49
006 Abtei,42,,27,22,49
006 Abtei,43,,26,23,49
006 Abtei,44,,18,23,41
006 Abtei,45,,19,15,34
006 Abtei,46,,19,17,36
006 Abtei,47,,16,15,31
006 Abtei,48,,11,14,25
006 Abtei,49,,14,18,32
006 Abtei,50,,13,13,26
006 Abtei,51,,11,12,23
006 Abtei,52,,15,20,35
006 Abtei,53,,12,18,30
006 Abtei,54,,25,17,42
006 Abtei,55,,14,14,28
006 Abtei,56,,23,18,41
006 Abtei,57,,17,20,37
006 Abtei,58,,14,18,32
006 Abtei,59,,12,11,23
006 Abtei,60,,21,11,32
006 Abtei,61,,17,24,41
006 Abtei,62,,18,19,37
006 Abtei,63,,17,13,30
006 Abtei,64,,16,18,34
006 Abtei,65,,6,19,25
006 Abtei,66,,18,10,28
006 Abtei,67,,13,18,31
006 Abtei,68,,15,17,32
006 Abtei,69,,10,15,25
006 Abtei,70,,8,6,14
006 Abtei,71,,12,13,25
006 Abtei,72,,17,12,29
006 Abtei,73,,8,7,15
006 Abtei,74,,8,15,23
006 Abtei,75,,7,9,16
006 Abtei,76,,8,6,14
006 Abtei,77,,8,7,15
006 Abtei,78,,6,10,16
006 Abtei,79,,6,12,18
006 Abtei,80,,7,6,13
006 Abtei,81,,5,2,7
006 Abtei,82,,3,10,13
006 Abtei,83,,1,5,6
006 Abtei,84,,2,4,6
006 Abtei,85,,-,1,1
006 Abtei,86,,1,4,5
006 Abtei,87,,-,2,2
006 Abtei,88,,1,2,3
006 Abtei,89,,2,-,2
006 Abtei,90,,1,4,5
006 Abtei,91,,1,3,4
006 Abtei,92,,1,2,3
006 Abtei,93,,2,-,2
006 Abtei,94,,-,2,2
006 Abtei,95,,-,1,1
006 Abtei,97,,-,1,1
007 Barbian,0,,6,5,11
007 Barbian,1,,10,16,26
007 Barbian,2,,13,7,20
007 Barbian,3,,10,10,20
007 Barbian,4,,16,9,25
007 Barbian,5,,11,7,18
007 Barbian,6,,10,10,20
007 Barbian,7,,11,8,19
007 Barbian,8,,7,4,11
007 Barbian,9,,10,12,22
007 Barbian,10,,13,6,19
007 Barbian,11,,11,11,22
007 Barbian,12,,14,13,27
007 Barbian,13,,10,13,23
007 Barbian,14,,13,5,18
007 Barbian,15,,8,6,14
007 Barbian,16,,13,8,21
007 Barbian,17,,8,10,18
007 Barbian,18,,9,7,16
007 Barbian,19,,11,7,18
007 Barbian,20,,9,6,15
007 Barbian,21,,13,13,26
007 Barbian,22,,9,6,15
007 Barbian,23,,18,12,30
007 Barbian,24,,10,10,20
007 Barbian,25,,6,20,26
007 Barbian,26,,8,17,25
007 Barbian,27,,8,10,18
007 Barbian,28,,16,14,30
007 Barbian,29,,8,17,25
007 Barbian,30,,23,17,40
007 Barbian,31,,17,12,29
007 Barbian,32,,12,11,23
007 Barbian,33,,16,4,20
007 Barbian,34,,14,13,27
007 Barbian,35,,7,9,16
007 Barbian,36,,12,15,27
007 Barbian,37,,10,12,22
007 Barbian,38,,15,14,29
007 Barbian,39,,14,13,27
007 Barbian,40,,15,14,29
007 Barbian,41,,17,11,28
007 Barbian,42,,12,15,27
007 Barbian,43,,12,9,21
007 Barbian,44,,7,9,16
007 Barbian,45,,15,7,22
007 Barbian,46,,4,9,13
007 Barbian,47,,8,7,15
007 Barbian,48,,6,15,21
007 Barbian,49,,11,8,19
007 Barbian,50,,7,5,12
007 Barbian,51,,7,10,17
007 Barbian,52,,12,11,23
007 Barbian,53,,5,6,11
007 Barbian,54,,3,4,7
007 Barbian,55,,6,10,16
007 Barbian,56,,18,6,24
007 Barbian,57,,8,5,13
007 Barbian,58,,11,8,19
007 Barbian,59,,9,6,15
007 Barbian,60,,11,12,23
007 Barbian,61,,8,12,20
007 Barbian,62,,8,3,11
007 Barbian,63,,6,5,11
007 Barbian,64,,5,10,15
007 Barbian,65,,8,8,16
007 Barbian,66,,3,6,9
007 Barbian,67,,3,8,11
007 Barbian,68,,5,5,10
007 Barbian,69,,8,5,13
007 Barbian,70,,4,7,11
007 Barbian,71,,4,8,12
007 Barbian,72,,7,6,13
007 Barbian,73,,8,8,16
007 Barbian,74,,5,9,14
007 Barbian,75,,5,3,8
007 Barbian,76,,4,3,7
007 Barbian,77,,6,3,9
007 Barbian,78,,4,6,10
007 Barbian,79,,3,8,11
007 Barbian,80,,3,5,8
007 Barbian,81,,1,3,4
007 Barbian,82,,2,2,4
007 Barbian,83,,-,3,3
007 Barbian,84,,1,1,2
007 Barbian,85,,-,1,1
007 Barbian,86,,1,1,2
007 Barbian,87,,-,4,4
007 Barbian,88,,3,4,7
007 Barbian,89,,-,3,3
007 Barbian,91,,2,1,3
007 Barbian,92,,1,-,1
007 Barbian,94,,-,1,1
008 Bozen,0,,448,410,858
008 Bozen,1,,473,420,893
008 Bozen,2,,422,431,853
008 Bozen,3,,477,446,923
008 Bozen,4,,425,437,862
008 Bozen,5,,460,370,830
008 Bozen,6,,420,433,853
008 Bozen,7,,408,378,786
008 Bozen,8,,451,421,872
008 Bozen,9,,395,394,789
008 Bozen,10,,416,381,797
008 Bozen,11,,462,387,849
008 Bozen,12,,434,398,832
008 Bozen,13,,424,391,815
008 Bozen,14,,413,397,810
008 Bozen,15,,351,382,733
008 Bozen,16,,373,362,735
008 Bozen,17,,402,372,774
008 Bozen,18,,396,380,776
008 Bozen,19,,431,361,792
008 Bozen,20,,414,396,810
008 Bozen,21,,420,398,818
008 Bozen,22,,486,408,894
008 Bozen,23,,437,442,879
008 Bozen,24,,518,440,958
008 Bozen,25,,555,470,1.025
008 Bozen,26,,545,560,1.105
008 Bozen,27,,667,630,1.297
008 Bozen,28,,706,662,1.368
008 Bozen,29,,705,747,1.452
008 Bozen,30,,785,745,1.530
008 Bozen,31,,867,819,1.686
008 Bozen,32,,842,740,1.582
008 Bozen,33,,909,795,1.704
008 Bozen,34,,789,754,1.543
008 Bozen,35,,801,794,1.595
008 Bozen,36,,902,832,1.734
008 Bozen,37,,906,844,1.750
008 Bozen,38,,897,891,1.788
008 Bozen,39,,777,804,1.581
008 Bozen,40,,767,767,1.534
008 Bozen,41,,778,713,1.491
008 Bozen,42,,706,674,1.380
008 Bozen,43,,697,682,1.379
008 Bozen,44,,690,674,1.364
008 Bozen,45,,632,701,1.333
008 Bozen,46,,642,635,1.277
008 Bozen,47,,622,624,1.246
008 Bozen,48,,626,589,1.215
008 Bozen,49,,549,595,1.144
008 Bozen,50,,548,644,1.192
008 Bozen,51,,549,634,1.183
008 Bozen,52,,606,682,1.288
008 Bozen,53,,626,636,1.262
008 Bozen,54,,663,728,1.391
008 Bozen,55,,650,808,1.458
008 Bozen,56,,732,878,1.610
008 Bozen,57,,554,597,1.151
008 Bozen,58,,597,731,1.328
008 Bozen,59,,646,732,1.378
008 Bozen,60,,660,725,1.385
008 Bozen,61,,721,774,1.495
008 Bozen,62,,691,751,1.442
008 Bozen,63,,610,737,1.347
008 Bozen,64,,657,675,1.332
008 Bozen,65,,553,593,1.146
008 Bozen,66,,514,579,1.093
008 Bozen,67,,489,589,1.078
008 Bozen,68,,515,582,1.097
008 Bozen,69,,439,580,1.019
008 Bozen,70,,450,589,1.039
008 Bozen,71,,450,573,1.023
008 Bozen,72,,458,581,1.039
008 Bozen,73,,353,561,914
008 Bozen,74,,389,520,909
008 Bozen,75,,343,523,866
008 Bozen,76,,407,502,909
008 Bozen,77,,302,545,847
008 Bozen,78,,298,517,815
008 Bozen,79,,286,518,804
008 Bozen,80,,285,536,821
008 Bozen,81,,231,484,715
008 Bozen,82,,203,466,669
008 Bozen,83,,110,285,395
008 Bozen,84,,77,172,249
008 Bozen,85,,79,172,251
008 Bozen,86,,75,179,254
008 Bozen,87,,91,246,337
008 Bozen,88,,100,220,320
008 Bozen,89,,80,194,274
008 Bozen,90,,62,171,233
008 Bozen,91,,39,144,183
008 Bozen,92,,29,105,134
008 Bozen,93,,27,77,104
008 Bozen,94,,16,63,79
008 Bozen,95,,7,40,47
008 Bozen,96,,8,35,43
008 Bozen,97,,3,20,23
008 Bozen,98,,2,14,16
008 Bozen,99,,-,15,15
008 Bozen,100,,2,4,6
008 Bozen,101,,-,5,5
008 Bozen,102,,-,2,2
008 Bozen,103,,-,1,1
008 Bozen,105,,-,2,2
009 Prags,0,,3,4,7
009 Prags,1,,4,5,9
009 Prags,2,,2,2,4
009 Prags,3,,4,7,11
009 Prags,4,,2,4,6
009 Prags,5,,3,4,7
009 Prags,6,,2,6,8
009 Prags,7,,2,2,4
009 Prags,8,,4,6,10
009 Prags,9,,7,4,11
009 Prags,10,,6,3,9
009 Prags,11,,9,2,11
009 Prags,12,,4,2,6
009 Prags,13,,8,3,11
009 Prags,14,,2,3,5
009 Prags,15,,3,3,6
009 Prags,16,,6,5,11
009 Prags,17,,8,2,10
009 Prags,18,,4,3,7
009 Prags,19,,3,7,10
009 Prags,20,,3,6,9
009 Prags,21,,1,6,7
009 Prags,22,,5,1,6
009 Prags,23,,2,1,3
009 Prags,24,,6,2,8
009 Prags,25,,5,2,7
009 Prags,26,,6,1,7
009 Prags,27,,3,6,9
009 Prags,28,,4,5,9
009 Prags,29,,7,7,14
009 Prags,30,,4,1,5
009 Prags,31,,5,3,8
009 Prags,32,,4,6,10
009 Prags,33,,8,4,12
009 Prags,34,,7,8,15
009 Prags,35,,5,7,12
009 Prags,36,,8,4,12
009 Prags,37,,8,6,14
009 Prags,38,,6,5,11
009 Prags,39,,6,5,11
009 Prags,40,,4,4,8
009 Prags,41,,5,11,16
009 Prags,42,,6,4,10
009 Prags,43,,11,5,16
009 Prags,44,,5,2,7
009 Prags,45,,5,4,9
009 Prags,46,,1,5,6
009 Prags,47,,3,4,7
009 Prags,48,,6,4,10
009 Prags,49,,4,2,6
009 Prags,50,,2,5,7
009 Prags,51,,3,1,4
009 Prags,52,,5,1,6
009 Prags,53,,1,1,2
009 Prags,54,,5,1,6
009 Prags,55,,1,-,1
009 Prags,56,,2,4,6
009 Prags,57,,2,2,4
009 Prags,58,,4,4,8
009 Prags,59,,1,4,5
009 Prags,60,,4,4,8
009 Prags,61,,5,2,7
009 Prags,62,,1,3,4
009 Prags,63,,3,5,8
009 Prags,64,,4,2,6
009 Prags,65,,1,3,4
009 Prags,66,,2,3,5
009 Prags,67,,1,3,4
009 Prags,68,,3,2,5
009 Prags,69,,5,2,7
009 Prags,70,,4,6,10
009 Prags,71,,1,4,5
009 Prags,72,,1,1,2
009 Prags,73,,3,1,4
009 Prags,74,,3,2,5
009 Prags,75,,3,5,8
009 Prags,76,,2,4,6
009 Prags,77,,1,5,6
009 Prags,78,,4,2,6
009 Prags,79,,-,4,4
009 Prags,80,,3,1,4
009 Prags,81,,2,3,5
009 Prags,82,,1,1,2
009 Prags,83,,-,2,2
009 Prags,85,,1,2,3
009 Prags,86,,-,1,1
009 Prags,87,,1,1,2
009 Prags,88,,-,1,1
009 Prags,90,,-,1,1
009 Prags,91,,-,1,1
010 Brenner,0,,12,14,26
010 Brenner,1,,7,8,15
010 Brenner,2,,15,13,28
010 Brenner,3,,12,17,29
010 Brenner,4,,17,2,19
010 Brenner,5,,16,6,22
010 Brenner,6,,5,11,16
010 Brenner,7,,7,9,16
010 Brenner,8,,20,12,32
010 Brenner,9,,13,8,21
010 Brenner,10,,11,9,20
010 Brenner,11,,8,19,27
010 Brenner,12,,11,8,19
010 Brenner,13,,15,5,20
010 Brenner,14,,12,4,16
010 Brenner,15,,8,8,16
010 Brenner,16,,11,10,21
010 Brenner,17,,18,8,26
010 Brenner,18,,14,15,29
010 Brenner,19,,18,20,38
010 Brenner,20,,14,6,20
010 Brenner,21,,8,13,21
010 Brenner,22,,8,11,19
010 Brenner,23,,14,11,25
010 Brenner,24,,21,11,32
010 Brenner,25,,16,14,30
010 Brenner,26,,14,11,25
010 Brenner,27,,14,25,39
010 Brenner,28,,18,12,30
010 Brenner,29,,14,12,26
010 Brenner,30,,17,24,41
010 Brenner,31,,26,13,39
010 Brenner,32,,28,19,47
010 Brenner,33,,16,17,33
010 Brenner,34,,15,19,34
010 Brenner,35,,21,16,37
010 Brenner,36,,18,17,35
010 Brenner,37,,24,20,44
010 Brenner,38,,22,16,38
010 Brenner,39,,13,20,33
010 Brenner,40,,20,13,33
010 Brenner,41,,22,12,34
010 Brenner,42,,21,11,32
010 Brenner,43,,17,12,29
010 Brenner,44,,16,9,25
010 Brenner,45,,14,18,32
010 Brenner,46,,15,13,28
010 Brenner,47,,16,9,25
010 Brenner,48,,9,15,24
010 Brenner,49,,9,15,24
010 Brenner,50,,20,9,29
010 Brenner,51,,15,11,26
010 Brenner,52,,12,13,25
010 Brenner,53,,18,16,34
010 Brenner,54,,5,8,13
010 Brenner,55,,22,14,36
010 Brenner,56,,9,16,25
010 Brenner,57,,7,8,15
010 Brenner,58,,18,14,32
010 Brenner,59,,22,14,36
010 Brenner,60,,6,9,15
010 Brenner,61,,12,12,24
010 Brenner,62,,11,11,22
010 Brenner,63,,9,7,16
010 Brenner,64,,10,17,27
010 Brenner,65,,9,14,23
010 Brenner,66,,13,7,20
010 Brenner,67,,6,6,12
010 Brenner,68,,9,8,17
010 Brenner,69,,6,8,14
010 Brenner,70,,2,4,6
010 Brenner,71,,6,10,16
010 Brenner,72,,8,12,20
010 Brenner,73,,12,10,22
010 Brenner,74,,9,9,18
010 Brenner,75,,7,3,10
010 Brenner,76,,9,9,18
010 Brenner,77,,3,8,11
010 Brenner,78,,2,10,12
010 Brenner,79,,5,10,15
010 Brenner,80,,1,7,8
010 Brenner,81,,2,4,6
010 Brenner,82,,2,7,9
010 Brenner,83,,3,3,6
010 Brenner,84,,2,-,2
010 Brenner,85,,1,4,5
010 Brenner,86,,1,-,1
010 Brenner,87,,1,3,4
010 Brenner,88,,1,4,5
010 Brenner,89,,-,2,2
010 Brenner,90,,-,4,4
010 Brenner,91,,2,1,3
010 Brenner,92,,-,2,2
010 Brenner,93,,-,1,1
010 Brenner,96,,-,1,1
010 Brenner,98,,-,1,1
011 Brixen,0,,97,99,196
011 Brixen,1,,114,108,222
011 Brixen,2,,115,114,229
011 Brixen,3,,136,114,250
011 Brixen,4,,106,134,240
011 Brixen,5,,111,94,205
011 Brixen,6,,112,105,217
011 Brixen,7,,103,111,214
011 Brixen,8,,117,117,234
011 Brixen,9,,99,101,200
011 Brixen,10,,112,115,227
011 Brixen,11,,112,100,212
011 Brixen,12,,94,108,202
011 Brixen,13,,110,89,199
011 Brixen,14,,113,99,212
011 Brixen,15,,99,92,191
011 Brixen,16,,100,109,209
011 Brixen,17,,111,89,200
011 Brixen,18,,117,88,205
011 Brixen,19,,115,117,232
011 Brixen,20,,116,104,220
011 Brixen,21,,108,96,204
011 Brixen,22,,91,99,190
011 Brixen,23,,120,90,210
011 Brixen,24,,84,97,181
011 Brixen,25,,119,114,233
011 Brixen,26,,123,123,246
011 Brixen,27,,105,106,211
011 Brixen,28,,139,135,274
011 Brixen,29,,136,151,287
011 Brixen,30,,145,144,289
011 Brixen,31,,149,142,291
011 Brixen,32,,166,142,308
011 Brixen,33,,188,175,363
011 Brixen,34,,167,180,347
011 Brixen,35,,162,154,316
011 Brixen,36,,166,182,348
011 Brixen,37,,181,157,338
011 Brixen,38,,178,180,358
011 Brixen,39,,151,171,322
011 Brixen,40,,165,155,320
011 Brixen,41,,134,164,298
011 Brixen,42,,147,146,293
011 Brixen,43,,152,137,289
011 Brixen,44,,153,113,266
011 Brixen,45,,133,136,269
011 Brixen,46,,106,138,244
011 Brixen,47,,121,89,210
011 Brixen,48,,97,108,205
011 Brixen,49,,82,103,185
011 Brixen,50,,99,102,201
011 Brixen,51,,97,104,201
011 Brixen,52,,108,99,207
011 Brixen,53,,79,125,204
011 Brixen,54,,111,116,227
011 Brixen,55,,92,111,203
011 Brixen,56,,105,109,214
011 Brixen,57,,67,98,165
011 Brixen,58,,119,105,224
011 Brixen,59,,133,118,251
011 Brixen,60,,94,98,192
011 Brixen,61,,105,125,230
011 Brixen,62,,88,124,212
011 Brixen,63,,100,109,209
011 Brixen,64,,90,98,188
011 Brixen,65,,88,95,183
011 Brixen,66,,70,93,163
011 Brixen,67,,78,82,160
011 Brixen,68,,79,97,176
011 Brixen,69,,80,69,149
011 Brixen,70,,73,81,154
011 Brixen,71,,71,86,157
011 Brixen,72,,67,99,166
011 Brixen,73,,55,95,150
011 Brixen,74,,69,76,145
011 Brixen,75,,42,94,136
011 Brixen,76,,46,73,119
011 Brixen,77,,52,80,132
011 Brixen,78,,44,81,125
011 Brixen,79,,43,64,107
011 Brixen,80,,38,79,117
011 Brixen,81,,25,80,105
011 Brixen,82,,29,58,87
011 Brixen,83,,19,42,61
011 Brixen,84,,11,29,40
011 Brixen,85,,15,35,50
011 Brixen,86,,7,21,28
011 Brixen,87,,7,30,37
011 Brixen,88,,18,35,53
011 Brixen,89,,9,37,46
011 Brixen,90,,8,32,40
011 Brixen,91,,4,26,30
011 Brixen,92,,7,23,30
011 Brixen,93,,5,12,17
011 Brixen,94,,3,12,15
011 Brixen,95,,2,6,8
011 Brixen,96,,-,4,4
011 Brixen,97,,2,1,3
011 Brixen,100,,-,1,1
011 Brixen,101,,-,2,2
012 Branzoll,0,,13,9,22
012 Branzoll,1,,10,12,22
012 Branzoll,2,,19,8,27
012 Branzoll,3,,10,12,22
012 Branzoll,4,,12,7,19
012 Branzoll,5,,12,20,32
012 Branzoll,6,,16,8,24
012 Branzoll,7,,12,12,24
012 Branzoll,8,,15,9,24
012 Branzoll,9,,17,13,30
012 Branzoll,10,,15,11,26
012 Branzoll,11,,12,17,29
012 Branzoll,12,,9,17,26
012 Branzoll,13,,11,15,26
012 Branzoll,14,,15,13,28
012 Branzoll,15,,11,5,16
012 Branzoll,16,,8,12,20
012 Branzoll,17,,12,14,26
012 Branzoll,18,,13,10,23
012 Branzoll,19,,14,11,25
012 Branzoll,20,,16,14,30
012 Branzoll,21,,14,13,27
012 Branzoll,22,,8,15,23
012 Branzoll,23,,11,5,16
012 Branzoll,24,,12,15,27
012 Branzoll,25,,13,15,28
012 Branzoll,26,,16,13,29
012 Branzoll,27,,11,10,21
012 Branzoll,28,,17,22,39
012 Branzoll,29,,23,15,38
012 Branzoll,30,,16,14,30
012 Branzoll,31,,17,20,37
012 Branzoll,32,,17,22,39
012 Branzoll,33,,24,17,41
012 Branzoll,34,,22,20,42
012 Branzoll,35,,20,22,42
012 Branzoll,36,,19,20,39
012 Branzoll,37,,21,23,44
012 Branzoll,38,,29,24,53
012 Branzoll,39,,17,16,33
012 Branzoll,40,,18,17,35
012 Branzoll,41,,29,33,62
012 Branzoll,42,,22,19,41
012 Branzoll,43,,13,22,35
012 Branzoll,44,,22,15,37
012 Branzoll,45,,22,18,40
012 Branzoll,46,,13,15,28
012 Branzoll,47,,15,18,33
012 Branzoll,48,,21,15,36
012 Branzoll,49,,11,18,29
012 Branzoll,50,,16,18,34
012 Branzoll,51,,15,14,29
012 Branzoll,52,,18,14,32
012 Branzoll,53,,14,15,29
012 Branzoll,54,,15,16,31
012 Branzoll,55,,12,17,29
012 Branzoll,56,,15,21,36
012 Branzoll,57,,12,8,20
012 Branzoll,58,,13,11,24
012 Branzoll,59,,14,12,26
012 Branzoll,60,,19,7,26
012 Branzoll,61,,18,12,30
012 Branzoll,62,,11,13,24
012 Branzoll,63,,16,14,30
012 Branzoll,64,,9,11,20
012 Branzoll,65,,5,9,14
012 Branzoll,66,,9,10,19
012 Branzoll,67,,7,9,16
012 Branzoll,68,,5,10,15
012 Branzoll,69,,19,11,30
012 Branzoll,70,,10,10,20
012 Branzoll,71,,3,10,13
012 Branzoll,72,,8,16,24
012 Branzoll,73,,7,10,17
012 Branzoll,74,,7,10,17
012 Branzoll,75,,4,8,12
012 Branzoll,76,,8,11,19
012 Branzoll,77,,4,5,9
012 Branzoll,78,,3,8,11
012 Branzoll,79,,8,11,19
012 Branzoll,80,,2,5,7
012 Branzoll,81,,5,8,13
012 Branzoll,82,,1,5,6
012 Branzoll,83,,2,5,7
012 Branzoll,84,,2,4,6
012 Branzoll,85,,-,2,2
012 Branzoll,86,,2,1,3
012 Branzoll,87,,1,1,2
012 Branzoll,88,,-,4,4
012 Branzoll,89,,2,3,5
012 Branzoll,90,,1,3,4
012 Branzoll,91,,1,2,3
012 Branzoll,92,,1,1,2
012 Branzoll,93,,-,2,2
012 Branzoll,94,,-,1,1
012 Branzoll,95,,1,-,1
012 Branzoll,96,,1,-,1
013 Bruneck,0,,52,83,135
013 Bruneck,1,,88,74,162
013 Bruneck,2,,75,82,157
013 Bruneck,3,,95,90,185
013 Bruneck,4,,91,82,173
013 Bruneck,5,,102,64,166
013 Bruneck,6,,69,81,150
013 Bruneck,7,,60,73,133
013 Bruneck,8,,81,75,156
013 Bruneck,9,,73,65,138
013 Bruneck,10,,90,72,162
013 Bruneck,11,,84,56,140
013 Bruneck,12,,84,70,154
013 Bruneck,13,,79,77,156
013 Bruneck,14,,65,72,137
013 Bruneck,15,,57,56,113
013 Bruneck,16,,105,70,175
013 Bruneck,17,,73,66,139
013 Bruneck,18,,81,72,153
013 Bruneck,19,,69,75,144
013 Bruneck,20,,69,70,139
013 Bruneck,21,,86,92,178
013 Bruneck,22,,101,90,191
013 Bruneck,23,,87,91,178
013 Bruneck,24,,112,89,201
013 Bruneck,25,,104,88,192
013 Bruneck,26,,93,97,190
013 Bruneck,27,,102,108,210
013 Bruneck,28,,106,101,207
013 Bruneck,29,,118,108,226
013 Bruneck,30,,109,116,225
013 Bruneck,31,,128,110,238
013 Bruneck,32,,121,134,255
013 Bruneck,33,,123,118,241
013 Bruneck,34,,121,135,256
013 Bruneck,35,,124,113,237
013 Bruneck,36,,125,107,232
013 Bruneck,37,,128,132,260
013 Bruneck,38,,126,132,258
013 Bruneck,39,,118,108,226
013 Bruneck,40,,122,109,231
013 Bruneck,41,,111,92,203
013 Bruneck,42,,103,111,214
013 Bruneck,43,,109,98,207
013 Bruneck,44,,101,102,203
013 Bruneck,45,,79,100,179
013 Bruneck,46,,86,91,177
013 Bruneck,47,,78,79,157
013 Bruneck,48,,88,84,172
013 Bruneck,49,,70,99,169
013 Bruneck,50,,83,98,181
013 Bruneck,51,,70,92,162
013 Bruneck,52,,83,94,177
013 Bruneck,53,,85,90,175
013 Bruneck,54,,77,106,183
013 Bruneck,55,,94,67,161
013 Bruneck,56,,101,80,181
013 Bruneck,57,,59,67,126
013 Bruneck,58,,91,92,183
013 Bruneck,59,,97,85,182
013 Bruneck,60,,93,86,179
013 Bruneck,61,,75,93,168
013 Bruneck,62,,79,85,164
013 Bruneck,63,,87,90,177
013 Bruneck,64,,55,53,108
013 Bruneck,65,,50,56,106
013 Bruneck,66,,56,54,110
013 Bruneck,67,,48,49,97
013 Bruneck,68,,45,52,97
013 Bruneck,69,,53,63,116
013 Bruneck,70,,56,50,106
013 Bruneck,71,,35,51,86
013 Bruneck,72,,39,65,104
013 Bruneck,73,,36,58,94
013 Bruneck,74,,41,62,103
013 Bruneck,75,,31,52,83
013 Bruneck,76,,29,39,68
013 Bruneck,77,,29,46,75
013 Bruneck,78,,15,58,73
013 Bruneck,79,,31,48,79
013 Bruneck,80,,26,42,68
013 Bruneck,81,,18,34,52
013 Bruneck,82,,16,36,52
013 Bruneck,83,,11,27,38
013 Bruneck,84,,5,18,23
013 Bruneck,85,,5,19,24
013 Bruneck,86,,3,25,28
013 Bruneck,87,,5,16,21
013 Bruneck,88,,8,19,27
013 Bruneck,89,,7,27,34
013 Bruneck,90,,8,19,27
013 Bruneck,91,,1,15,16
013 Bruneck,92,,6,7,13
013 Bruneck,93,,5,7,12
013 Bruneck,94,,-,7,7
013 Bruneck,95,,1,5,6
013 Bruneck,96,,1,3,4
013 Bruneck,97,,2,1,3
013 Bruneck,99,,-,1,1
013 Bruneck,100,,-,3,3
014 Kuens,0,,3,2,5
014 Kuens,1,,4,1,5
014 Kuens,2,,1,6,7
014 Kuens,3,,2,2,4
014 Kuens,4,,2,3,5
014 Kuens,5,,1,1,2
014 Kuens,6,,5,2,7
014 Kuens,7,,2,3,5
014 Kuens,8,,1,4,5
014 Kuens,9,,3,3,6
014 Kuens,10,,3,2,5
014 Kuens,11,,2,2,4
014 Kuens,12,,3,2,5
014 Kuens,13,,3,2,5
014 Kuens,14,,1,3,4
014 Kuens,15,,3,-,3
014 Kuens,16,,1,1,2
014 Kuens,18,,1,-,1
014 Kuens,19,,2,2,4
014 Kuens,20,,2,-,2
014 Kuens,21,,2,-,2
014 Kuens,22,,3,2,5
014 Kuens,23,,1,1,2
014 Kuens,24,,2,-,2
014 Kuens,25,,2,4,6
014 Kuens,26,,3,2,5
014 Kuens,27,,4,2,6
014 Kuens,28,,3,7,10
014 Kuens,29,,-,3,3
014 Kuens,30,,4,1,5
014 Kuens,31,,1,4,5
014 Kuens,32,,6,2,8
014 Kuens,33,,4,1,5
014 Kuens,34,,3,4,7
014 Kuens,35,,4,10,14
014 Kuens,36,,3,5,8
014 Kuens,37,,8,1,9
014 Kuens,38,,5,5,10
014 Kuens,39,,8,2,10
014 Kuens,40,,5,2,7
014 Kuens,41,,-,4,4
014 Kuens,43,,1,-,1
014 Kuens,44,,-,3,3
014 Kuens,45,,3,-,3
014 Kuens,46,,3,-,3
014 Kuens,47,,1,2,3
014 Kuens,49,,1,1,2
014 Kuens,50,,-,2,2
014 Kuens,52,,1,3,4
014 Kuens,53,,-,2,2
014 Kuens,54,,2,1,3
014 Kuens,55,,1,2,3
014 Kuens,56,,1,2,3
014 Kuens,57,,3,1,4
014 Kuens,59,,-,2,2
014 Kuens,60,,-,4,4
014 Kuens,61,,-,2,2
014 Kuens,62,,-,1,1
014 Kuens,63,,5,1,6
014 Kuens,64,,3,2,5
014 Kuens,65,,1,3,4
014 Kuens,66,,2,2,4
014 Kuens,67,,1,3,4
014 Kuens,68,,-,1,1
014 Kuens,69,,1,1,2
014 Kuens,70,,4,2,6
014 Kuens,71,,2,2,4
014 Kuens,72,,2,2,4
014 Kuens,73,,1,-,1
014 Kuens,74,,1,-,1
014 Kuens,75,,1,1,2
014 Kuens,76,,1,-,1
014 Kuens,80,,-,2,2
014 Kuens,83,,-,2,2
014 Kuens,86,,-,1,1
014 Kuens,87,,1,-,1
014 Kuens,90,,1,-,1
015 Kaltern a.d. Weinstr.,0,,39,31,70
015 Kaltern a.d. Weinstr.,1,,35,46,81
015 Kaltern a.d. Weinstr.,2,,34,37,71
015 Kaltern a.d. Weinstr.,3,,44,35,79
015 Kaltern a.d. Weinstr.,4,,35,44,79
015 Kaltern a.d. Weinstr.,5,,41,44,85
015 Kaltern a.d. Weinstr.,6,,40,45,85
015 Kaltern a.d. Weinstr.,7,,42,36,78
015 Kaltern a.d. Weinstr.,8,,34,42,76
015 Kaltern a.d. Weinstr.,9,,29,38,67
015 Kaltern a.d. Weinstr.,10,,43,36,79
015 Kaltern a.d. Weinstr.,11,,33,41,74
015 Kaltern a.d. Weinstr.,12,,39,38,77
015 Kaltern a.d. Weinstr.,13,,53,28,81
015 Kaltern a.d. Weinstr.,14,,39,33,72
015 Kaltern a.d. Weinstr.,15,,40,31,71
015 Kaltern a.d. Weinstr.,16,,51,41,92
015 Kaltern a.d. Weinstr.,17,,49,36,85
015 Kaltern a.d. Weinstr.,18,,39,35,74
015 Kaltern a.d. Weinstr.,19,,42,43,85
015 Kaltern a.d. Weinstr.,20,,41,43,84
015 Kaltern a.d. Weinstr.,21,,43,38,81
015 Kaltern a.d. Weinstr.,22,,43,42,85
015 Kaltern a.d. Weinstr.,23,,41,38,79
015 Kaltern a.d. Weinstr.,24,,40,32,72
015 Kaltern a.d. Weinstr.,25,,34,42,76
015 Kaltern a.d. Weinstr.,26,,37,41,78
015 Kaltern a.d. Weinstr.,27,,40,52,92
015 Kaltern a.d. Weinstr.,28,,50,46,96
015 Kaltern a.d. Weinstr.,29,,34,43,77
015 Kaltern a.d. Weinstr.,30,,44,60,104
015 Kaltern a.d. Weinstr.,31,,59,50,109
015 Kaltern a.d. Weinstr.,32,,63,57,120
015 Kaltern a.d. Weinstr.,33,,58,62,120
015 Kaltern a.d. Weinstr.,34,,75,62,137
015 Kaltern a.d. Weinstr.,35,,56,60,116
015 Kaltern a.d. Weinstr.,36,,62,70,132
015 Kaltern a.d. Weinstr.,37,,55,61,116
015 Kaltern a.d. Weinstr.,38,,82,56,138
015 Kaltern a.d. Weinstr.,39,,56,55,111
015 Kaltern a.d. Weinstr.,40,,63,62,125
015 Kaltern a.d. Weinstr.,41,,63,59,122
015 Kaltern a.d. Weinstr.,42,,54,62,116
015 Kaltern a.d. Weinstr.,43,,55,52,107
015 Kaltern a.d. Weinstr.,44,,57,62,119
015 Kaltern a.d. Weinstr.,45,,52,56,108
015 Kaltern a.d. Weinstr.,46,,61,43,104
015 Kaltern a.d. Weinstr.,47,,52,41,93
015 Kaltern a.d. Weinstr.,48,,34,47,81
015 Kaltern a.d. Weinstr.,49,,33,37,70
015 Kaltern a.d. Weinstr.,50,,38,55,93
015 Kaltern a.d. Weinstr.,51,,33,33,66
015 Kaltern a.d. Weinstr.,52,,42,34,76
015 Kaltern a.d. Weinstr.,53,,30,38,68
015 Kaltern a.d. Weinstr.,54,,41,36,77
015 Kaltern a.d. Weinstr.,55,,34,56,90
015 Kaltern a.d. Weinstr.,56,,50,42,92
015 Kaltern a.d. Weinstr.,57,,38,38,76
015 Kaltern a.d. Weinstr.,58,,40,44,84
015 Kaltern a.d. Weinstr.,59,,40,35,75
015 Kaltern a.d. Weinstr.,60,,40,44,84
015 Kaltern a.d. Weinstr.,61,,45,42,87
015 Kaltern a.d. Weinstr.,62,,32,42,74
015 Kaltern a.d. Weinstr.,63,,23,35,58
015 Kaltern a.d. Weinstr.,64,,41,40,81
015 Kaltern a.d. Weinstr.,65,,28,34,62
015 Kaltern a.d. Weinstr.,66,,23,24,47
015 Kaltern a.d. Weinstr.,67,,26,26,52
015 Kaltern a.d. Weinstr.,68,,26,27,53
015 Kaltern a.d. Weinstr.,69,,28,38,66
015 Kaltern a.d. Weinstr.,70,,30,31,61
015 Kaltern a.d. Weinstr.,71,,29,36,65
015 Kaltern a.d. Weinstr.,72,,30,42,72
015 Kaltern a.d. Weinstr.,73,,25,32,57
015 Kaltern a.d. Weinstr.,74,,23,32,55
015 Kaltern a.d. Weinstr.,75,,18,38,56
015 Kaltern a.d. Weinstr.,76,,18,33,51
015 Kaltern a.d. Weinstr.,77,,21,38,59
015 Kaltern a.d. Weinstr.,78,,17,29,46
015 Kaltern a.d. Weinstr.,79,,10,32,42
015 Kaltern a.d. Weinstr.,80,,15,30,45
015 Kaltern a.d. Weinstr.,81,,13,34,47
015 Kaltern a.d. Weinstr.,82,,7,26,33
015 Kaltern a.d. Weinstr.,83,,5,17,22
015 Kaltern a.d. Weinstr.,84,,5,8,13
015 Kaltern a.d. Weinstr.,85,,2,9,11
015 Kaltern a.d. Weinstr.,86,,2,5,7
015 Kaltern a.d. Weinstr.,87,,4,12,16
015 Kaltern a.d. Weinstr.,88,,3,14,17
015 Kaltern a.d. Weinstr.,89,,7,15,22
015 Kaltern a.d. Weinstr.,90,,2,17,19
015 Kaltern a.d. Weinstr.,91,,2,5,7
015 Kaltern a.d. Weinstr.,92,,1,4,5
015 Kaltern a.d. Weinstr.,93,,2,2,4
015 Kaltern a.d. Weinstr.,94,,1,-,1
015 Kaltern a.d. Weinstr.,95,,-,3,3
016 Freienfeld,0,,18,22,40
016 Freienfeld,1,,17,19,36
016 Freienfeld,2,,14,15,29
016 Freienfeld,3,,15,21,36
016 Freienfeld,4,,13,17,30
016 Freienfeld,5,,22,17,39
016 Freienfeld,6,,22,12,34
016 Freienfeld,7,,14,15,29
016 Freienfeld,8,,15,9,24
016 Freienfeld,9,,15,11,26
016 Freienfeld,10,,19,21,40
016 Freienfeld,11,,10,12,22
016 Freienfeld,12,,19,19,38
016 Freienfeld,13,,26,20,46
016 Freienfeld,14,,20,15,35
016 Freienfeld,15,,15,18,33
016 Freienfeld,16,,15,12,27
016 Freienfeld,17,,17,14,31
016 Freienfeld,18,,22,15,37
016 Freienfeld,19,,21,19,40
016 Freienfeld,20,,14,16,30
016 Freienfeld,21,,23,20,43
016 Freienfeld,22,,19,16,35
016 Freienfeld,23,,19,22,41
016 Freienfeld,24,,13,15,28
016 Freienfeld,25,,16,19,35
016 Freienfeld,26,,17,8,25
016 Freienfeld,27,,18,18,36
016 Freienfeld,28,,22,19,41
016 Freienfeld,29,,23,19,42
016 Freienfeld,30,,22,22,44
016 Freienfeld,31,,23,25,48
016 Freienfeld,32,,23,14,37
016 Freienfeld,33,,26,26,52
016 Freienfeld,34,,24,20,44
016 Freienfeld,35,,20,30,50
016 Freienfeld,36,,25,19,44
016 Freienfeld,37,,25,16,41
016 Freienfeld,38,,25,20,45
016 Freienfeld,39,,22,18,40
016 Freienfeld,40,,25,28,53
016 Freienfeld,41,,24,20,44
016 Freienfeld,42,,28,22,50
016 Freienfeld,43,,27,14,41
016 Freienfeld,44,,16,20,36
016 Freienfeld,45,,14,20,34
016 Freienfeld,46,,23,15,38
016 Freienfeld,47,,20,9,29
016 Freienfeld,48,,19,17,36
016 Freienfeld,49,,17,10,27
016 Freienfeld,50,,13,18,31
016 Freienfeld,51,,15,10,25
016 Freienfeld,52,,19,10,29
016 Freienfeld,53,,17,13,30
016 Freienfeld,54,,20,13,33
016 Freienfeld,55,,4,12,16
016 Freienfeld,56,,11,16,27
016 Freienfeld,57,,12,2,14
016 Freienfeld,58,,11,5,16
016 Freienfeld,59,,13,10,23
016 Freienfeld,60,,12,9,21
016 Freienfeld,61,,13,11,24
016 Freienfeld,62,,11,4,15
016 Freienfeld,63,,11,9,20
016 Freienfeld,64,,13,11,24
016 Freienfeld,65,,6,11,17
016 Freienfeld,66,,8,12,20
016 Freienfeld,67,,7,12,19
016 Freienfeld,68,,5,6,11
016 Freienfeld,69,,10,8,18
016 Freienfeld,70,,11,10,21
016 Freienfeld,71,,9,9,18
016 Freienfeld,72,,8,7,15
016 Freienfeld,73,,5,7,12
016 Freienfeld,74,,6,5,11
016 Freienfeld,75,,6,9,15
016 Freienfeld,76,,8,14,22
016 Freienfeld,77,,7,9,16
016 Freienfeld,78,,4,5,9
016 Freienfeld,79,,2,14,16
016 Freienfeld,80,,2,9,11
016 Freienfeld,81,,1,3,4
016 Freienfeld,82,,7,4,11
016 Freienfeld,83,,3,4,7
016 Freienfeld,84,,1,3,4
016 Freienfeld,85,,-,2,2
016 Freienfeld,86,,1,1,2
016 Freienfeld,87,,-,3,3
016 Freienfeld,88,,3,5,8
016 Freienfeld,89,,2,3,5
016 Freienfeld,91,,1,4,5
016 Freienfeld,92,,2,2,4
016 Freienfeld,94,,-,2,2
016 Freienfeld,95,,1,1,2
017 Sand in Taufers,0,,29,32,61
017 Sand in Taufers,1,,33,38,71
017 Sand in Taufers,2,,44,22,66
017 Sand in Taufers,3,,38,35,73
017 Sand in Taufers,4,,27,34,61
017 Sand in Taufers,5,,33,37,70
017 Sand in Taufers,6,,25,32,57
017 Sand in Taufers,7,,27,30,57
017 Sand in Taufers,8,,39,35,74
017 Sand in Taufers,9,,26,33,59
017 Sand in Taufers,10,,33,36,69
017 Sand in Taufers,11,,28,32,60
017 Sand in Taufers,12,,25,31,56
017 Sand in Taufers,13,,29,28,57
017 Sand in Taufers,14,,28,28,56
017 Sand in Taufers,15,,21,22,43
017 Sand in Taufers,16,,22,21,43
017 Sand in Taufers,17,,23,26,49
017 Sand in Taufers,18,,32,26,58
017 Sand in Taufers,19,,33,30,63
017 Sand in Taufers,20,,23,37,60
017 Sand in Taufers,21,,33,35,68
017 Sand in Taufers,22,,33,33,66
017 Sand in Taufers,23,,31,35,66
017 Sand in Taufers,24,,39,35,74
017 Sand in Taufers,25,,32,39,71
017 Sand in Taufers,26,,38,40,78
017 Sand in Taufers,27,,47,40,87
017 Sand in Taufers,28,,60,41,101
017 Sand in Taufers,29,,58,41,99
017 Sand in Taufers,30,,51,50,101
017 Sand in Taufers,31,,45,47,92
017 Sand in Taufers,32,,38,50,88
017 Sand in Taufers,33,,54,40,94
017 Sand in Taufers,34,,49,40,89
017 Sand in Taufers,35,,31,45,76
017 Sand in Taufers,36,,48,33,81
017 Sand in Taufers,37,,49,37,86
017 Sand in Taufers,38,,48,44,92
017 Sand in Taufers,39,,50,47,97
017 Sand in Taufers,40,,34,39,73
017 Sand in Taufers,41,,44,41,85
017 Sand in Taufers,42,,42,33,75
017 Sand in Taufers,43,,36,33,69
017 Sand in Taufers,44,,33,21,54
017 Sand in Taufers,45,,22,37,59
017 Sand in Taufers,46,,28,37,65
017 Sand in Taufers,47,,24,22,46
017 Sand in Taufers,48,,29,29,58
017 Sand in Taufers,49,,32,24,56
017 Sand in Taufers,50,,18,28,46
017 Sand in Taufers,51,,27,22,49
017 Sand in Taufers,52,,35,34,69
017 Sand in Taufers,53,,30,20,50
017 Sand in Taufers,54,,21,25,46
017 Sand in Taufers,55,,25,29,54
017 Sand in Taufers,56,,26,25,51
017 Sand in Taufers,57,,28,9,37
017 Sand in Taufers,58,,17,30,47
017 Sand in Taufers,59,,29,30,59
017 Sand in Taufers,60,,28,33,61
017 Sand in Taufers,61,,27,32,59
017 Sand in Taufers,62,,24,19,43
017 Sand in Taufers,63,,26,30,56
017 Sand in Taufers,64,,18,26,44
017 Sand in Taufers,65,,29,13,42
017 Sand in Taufers,66,,15,25,40
017 Sand in Taufers,67,,30,17,47
017 Sand in Taufers,68,,15,14,29
017 Sand in Taufers,69,,15,18,33
017 Sand in Taufers,70,,10,17,27
017 Sand in Taufers,71,,12,13,25
017 Sand in Taufers,72,,15,18,33
017 Sand in Taufers,73,,14,12,26
017 Sand in Taufers,74,,12,15,27
017 Sand in Taufers,75,,14,12,26
017 Sand in Taufers,76,,10,19,29
017 Sand in Taufers,77,,9,15,24
017 Sand in Taufers,78,,6,16,22
017 Sand in Taufers,79,,11,12,23
017 Sand in Taufers,80,,10,16,26
017 Sand in Taufers,81,,8,16,24
017 Sand in Taufers,82,,5,9,14
017 Sand in Taufers,83,,7,9,16
017 Sand in Taufers,84,,3,4,7
017 Sand in Taufers,85,,2,8,10
017 Sand in Taufers,86,,-,4,4
017 Sand in Taufers,87,,3,5,8
017 Sand in Taufers,88,,2,9,11
017 Sand in Taufers,89,,-,7,7
017 Sand in Taufers,90,,-,3,3
017 Sand in Taufers,91,,-,6,6
017 Sand in Taufers,93,,1,3,4
017 Sand in Taufers,95,,-,2,2
017 Sand in Taufers,96,,1,-,1
018 Kastelbell-Tschars,0,,8,9,17
018 Kastelbell-Tschars,1,,15,11,26
018 Kastelbell-Tschars,2,,10,9,19
018 Kastelbell-Tschars,3,,23,11,34
018 Kastelbell-Tschars,4,,17,8,25
018 Kastelbell-Tschars,5,,9,9,18
018 Kastelbell-Tschars,6,,14,16,30
018 Kastelbell-Tschars,7,,15,10,25
018 Kastelbell-Tschars,8,,14,15,29
018 Kastelbell-Tschars,9,,13,15,28
018 Kastelbell-Tschars,10,,14,13,27
018 Kastelbell-Tschars,11,,18,13,31
018 Kastelbell-Tschars,12,,15,10,25
018 Kastelbell-Tschars,13,,16,11,27
018 Kastelbell-Tschars,14,,19,7,26
018 Kastelbell-Tschars,15,,19,16,35
018 Kastelbell-Tschars,16,,17,21,38
018 Kastelbell-Tschars,17,,21,15,36
018 Kastelbell-Tschars,18,,8,10,18
018 Kastelbell-Tschars,19,,14,23,37
018 Kastelbell-Tschars,20,,24,13,37
018 Kastelbell-Tschars,21,,15,20,35
018 Kastelbell-Tschars,22,,18,19,37
018 Kastelbell-Tschars,23,,15,14,29
018 Kastelbell-Tschars,24,,14,19,33
018 Kastelbell-Tschars,25,,11,16,27
018 Kastelbell-Tschars,26,,20,19,39
018 Kastelbell-Tschars,27,,18,12,30
018 Kastelbell-Tschars,28,,18,13,31
018 Kastelbell-Tschars,29,,21,19,40
018 Kastelbell-Tschars,30,,16,18,34
018 Kastelbell-Tschars,31,,16,14,30
018 Kastelbell-Tschars,32,,13,14,27
018 Kastelbell-Tschars,33,,27,19,46
018 Kastelbell-Tschars,34,,16,14,30
018 Kastelbell-Tschars,35,,12,22,34
018 Kastelbell-Tschars,36,,23,10,33
018 Kastelbell-Tschars,37,,23,16,39
018 Kastelbell-Tschars,38,,21,15,36
018 Kastelbell-Tschars,39,,24,21,45
018 Kastelbell-Tschars,40,,7,22,29
018 Kastelbell-Tschars,41,,21,18,39
018 Kastelbell-Tschars,42,,25,20,45
018 Kastelbell-Tschars,43,,25,20,45
018 Kastelbell-Tschars,44,,17,14,31
018 Kastelbell-Tschars,45,,15,11,26
018 Kastelbell-Tschars,46,,12,16,28
018 Kastelbell-Tschars,47,,18,18,36
018 Kastelbell-Tschars,48,,8,13,21
018 Kastelbell-Tschars,49,,9,16,25
018 Kastelbell-Tschars,50,,14,16,30
018 Kastelbell-Tschars,51,,16,12,28
018 Kastelbell-Tschars,52,,13,13,26
018 Kastelbell-Tschars,53,,12,8,20
018 Kastelbell-Tschars,54,,12,10,22
018 Kastelbell-Tschars,55,,10,8,18
018 Kastelbell-Tschars,56,,14,13,27
018 Kastelbell-Tschars,57,,9,4,13
018 Kastelbell-Tschars,58,,11,7,18
018 Kastelbell-Tschars,59,,7,8,15
018 Kastelbell-Tschars,60,,12,12,24
018 Kastelbell-Tschars,61,,9,8,17
018 Kastelbell-Tschars,62,,8,10,18
018 Kastelbell-Tschars,63,,12,12,24
018 Kastelbell-Tschars,64,,7,15,22
018 Kastelbell-Tschars,65,,11,10,21
018 Kastelbell-Tschars,66,,10,16,26
018 Kastelbell-Tschars,67,,11,11,22
018 Kastelbell-Tschars,68,,5,16,21
018 Kastelbell-Tschars,69,,17,13,30
018 Kastelbell-Tschars,70,,7,13,20
018 Kastelbell-Tschars,71,,10,14,24
018 Kastelbell-Tschars,72,,22,16,38
018 Kastelbell-Tschars,73,,10,14,24
018 Kastelbell-Tschars,74,,6,11,17
018 Kastelbell-Tschars,75,,10,9,19
018 Kastelbell-Tschars,76,,11,16,27
018 Kastelbell-Tschars,77,,12,12,24
018 Kastelbell-Tschars,78,,3,9,12
018 Kastelbell-Tschars,79,,8,10,18
018 Kastelbell-Tschars,80,,5,8,13
018 Kastelbell-Tschars,81,,4,6,10
018 Kastelbell-Tschars,82,,5,7,12
018 Kastelbell-Tschars,83,,1,4,5
018 Kastelbell-Tschars,84,,-,4,4
018 Kastelbell-Tschars,85,,1,3,4
018 Kastelbell-Tschars,86,,-,1,1
018 Kastelbell-Tschars,87,,4,3,7
018 Kastelbell-Tschars,88,,1,4,5
018 Kastelbell-Tschars,89,,3,1,4
018 Kastelbell-Tschars,90,,1,2,3
018 Kastelbell-Tschars,91,,-,4,4
018 Kastelbell-Tschars,92,,-,2,2
018 Kastelbell-Tschars,93,,1,-,1
018 Kastelbell-Tschars,94,,-,2,2
019 Kastelruth,0,,32,34,66
019 Kastelruth,1,,43,30,73
019 Kastelruth,2,,35,28,63
019 Kastelruth,3,,34,39,73
019 Kastelruth,4,,50,46,96
019 Kastelruth,5,,47,49,96
019 Kastelruth,6,,44,36,80
019 Kastelruth,7,,54,40,94
019 Kastelruth,8,,31,31,62
019 Kastelruth,9,,39,36,75
019 Kastelruth,10,,36,51,87
019 Kastelruth,11,,35,38,73
019 Kastelruth,12,,37,37,74
019 Kastelruth,13,,46,38,84
019 Kastelruth,14,,26,25,51
019 Kastelruth,15,,35,41,76
019 Kastelruth,16,,32,23,55
019 Kastelruth,17,,26,33,59
019 Kastelruth,18,,34,28,62
019 Kastelruth,19,,34,44,78
019 Kastelruth,20,,44,33,77
019 Kastelruth,21,,36,41,77
019 Kastelruth,22,,42,38,80
019 Kastelruth,23,,31,41,72
019 Kastelruth,24,,31,38,69
019 Kastelruth,25,,38,41,79
019 Kastelruth,26,,39,56,95
019 Kastelruth,27,,53,34,87
019 Kastelruth,28,,54,46,100
019 Kastelruth,29,,43,56,99
019 Kastelruth,30,,66,37,103
019 Kastelruth,31,,59,44,103
019 Kastelruth,32,,49,51,100
019 Kastelruth,33,,63,54,117
019 Kastelruth,34,,61,57,118
019 Kastelruth,35,,68,59,127
019 Kastelruth,36,,72,48,120
019 Kastelruth,37,,44,80,124
019 Kastelruth,38,,56,40,96
019 Kastelruth,39,,57,32,89
019 Kastelruth,40,,38,48,86
019 Kastelruth,41,,53,45,98
019 Kastelruth,42,,49,39,88
019 Kastelruth,43,,48,42,90
019 Kastelruth,44,,46,41,87
019 Kastelruth,45,,38,37,75
019 Kastelruth,46,,34,31,65
019 Kastelruth,47,,36,36,72
019 Kastelruth,48,,38,28,66
019 Kastelruth,49,,27,28,55
019 Kastelruth,50,,37,25,62
019 Kastelruth,51,,29,25,54
019 Kastelruth,52,,43,20,63
019 Kastelruth,53,,17,34,51
019 Kastelruth,54,,28,39,67
019 Kastelruth,55,,35,31,66
019 Kastelruth,56,,21,38,59
019 Kastelruth,57,,23,19,42
019 Kastelruth,58,,21,44,65
019 Kastelruth,59,,40,39,79
019 Kastelruth,60,,33,28,61
019 Kastelruth,61,,33,46,79
019 Kastelruth,62,,28,36,64
019 Kastelruth,63,,27,28,55
019 Kastelruth,64,,28,26,54
019 Kastelruth,65,,27,24,51
019 Kastelruth,66,,31,20,51
019 Kastelruth,67,,30,29,59
019 Kastelruth,68,,23,25,48
019 Kastelruth,69,,35,28,63
019 Kastelruth,70,,19,37,56
019 Kastelruth,71,,39,25,64
019 Kastelruth,72,,13,26,39
019 Kastelruth,73,,25,27,52
019 Kastelruth,74,,13,19,32
019 Kastelruth,75,,20,31,51
019 Kastelruth,76,,14,23,37
019 Kastelruth,77,,11,21,32
019 Kastelruth,78,,15,22,37
019 Kastelruth,79,,9,18,27
019 Kastelruth,80,,11,15,26
019 Kastelruth,81,,10,18,28
019 Kastelruth,82,,9,15,24
019 Kastelruth,83,,9,7,16
019 Kastelruth,84,,3,8,11
019 Kastelruth,85,,1,4,5
019 Kastelruth,86,,-,4,4
019 Kastelruth,87,,1,13,14
019 Kastelruth,88,,7,8,15
019 Kastelruth,89,,2,4,6
019 Kastelruth,90,,4,8,12
019 Kastelruth,91,,2,5,7
019 Kastelruth,92,,-,4,4
019 Kastelruth,93,,-,4,4
019 Kastelruth,94,,1,1,2
019 Kastelruth,95,,-,1,1
019 Kastelruth,96,,-,3,3
019 Kastelruth,97,,-,1,1
020 Tscherms,0,,9,7,16
020 Tscherms,1,,7,7,14
020 Tscherms,2,,10,5,15
020 Tscherms,3,,7,6,13
020 Tscherms,4,,5,9,14
020 Tscherms,5,,7,7,14
020 Tscherms,6,,5,4,9
020 Tscherms,7,,9,10,19
020 Tscherms,8,,10,15,25
020 Tscherms,9,,8,7,15
020 Tscherms,10,,11,6,17
020 Tscherms,11,,4,10,14
020 Tscherms,12,,7,6,13
020 Tscherms,13,,3,4,7
020 Tscherms,14,,5,15,20
020 Tscherms,15,,11,5,16
020 Tscherms,16,,10,7,17
020 Tscherms,17,,12,10,22
020 Tscherms,18,,13,5,18
020 Tscherms,19,,9,10,19
020 Tscherms,20,,5,9,14
020 Tscherms,21,,9,7,16
020 Tscherms,22,,8,4,12
020 Tscherms,23,,3,5,8
020 Tscherms,24,,2,8,10
020 Tscherms,25,,6,3,9
020 Tscherms,26,,8,6,14
020 Tscherms,27,,8,4,12
020 Tscherms,28,,9,5,14
020 Tscherms,29,,9,10,19
020 Tscherms,30,,9,9,18
020 Tscherms,31,,9,13,22
020 Tscherms,32,,10,6,16
020 Tscherms,33,,13,18,31
020 Tscherms,34,,16,7,23
020 Tscherms,35,,10,15,25
020 Tscherms,36,,13,4,17
020 Tscherms,37,,17,13,30
020 Tscherms,38,,12,12,24
020 Tscherms,39,,18,14,32
020 Tscherms,40,,15,9,24
020 Tscherms,41,,9,10,19
020 Tscherms,42,,10,13,23
020 Tscherms,43,,8,16,24
020 Tscherms,44,,9,8,17
020 Tscherms,45,,9,10,19
020 Tscherms,46,,8,7,15
020 Tscherms,47,,11,9,20
020 Tscherms,48,,8,8,16
020 Tscherms,49,,10,4,14
020 Tscherms,50,,14,6,20
020 Tscherms,51,,5,13,18
020 Tscherms,52,,8,7,15
020 Tscherms,53,,3,3,6
020 Tscherms,54,,7,5,12
020 Tscherms,55,,7,7,14
020 Tscherms,56,,5,8,13
020 Tscherms,57,,5,7,12
020 Tscherms,58,,5,9,14
020 Tscherms,59,,7,5,12
020 Tscherms,60,,8,3,11
020 Tscherms,61,,10,8,18
020 Tscherms,62,,5,5,10
020 Tscherms,63,,4,4,8
020 Tscherms,64,,7,2,9
020 Tscherms,65,,5,8,13
020 Tscherms,66,,5,7,12
020 Tscherms,67,,4,5,9
020 Tscherms,68,,2,9,11
020 Tscherms,69,,5,2,7
020 Tscherms,70,,6,5,11
020 Tscherms,71,,2,3,5
020 Tscherms,72,,3,5,8
020 Tscherms,73,,3,4,7
020 Tscherms,74,,5,5,10
020 Tscherms,75,,9,4,13
020 Tscherms,76,,3,2,5
020 Tscherms,77,,5,6,11
020 Tscherms,78,,4,5,9
020 Tscherms,79,,1,3,4
020 Tscherms,80,,1,6,7
020 Tscherms,81,,4,3,7
020 Tscherms,82,,4,3,7
020 Tscherms,83,,-,2,2
020 Tscherms,84,,2,2,4
020 Tscherms,85,,1,1,2
020 Tscherms,86,,1,1,2
020 Tscherms,87,,1,-,1
020 Tscherms,88,,-,3,3
020 Tscherms,89,,-,3,3
020 Tscherms,90,,2,-,2
020 Tscherms,91,,-,2,2
020 Tscherms,92,,1,1,2
021 Kiens,0,,10,13,23
021 Kiens,1,,21,22,43
021 Kiens,2,,13,21,34
021 Kiens,3,,14,18,32
021 Kiens,4,,23,6,29
021 Kiens,5,,17,13,30
021 Kiens,6,,17,19,36
021 Kiens,7,,14,21,35
021 Kiens,8,,17,18,35
021 Kiens,9,,19,16,35
021 Kiens,10,,26,17,43
021 Kiens,11,,12,25,37
021 Kiens,12,,14,19,33
021 Kiens,13,,13,18,31
021 Kiens,14,,13,14,27
021 Kiens,15,,11,13,24
021 Kiens,16,,18,11,29
021 Kiens,17,,19,13,32
021 Kiens,18,,16,11,27
021 Kiens,19,,13,18,31
021 Kiens,20,,22,17,39
021 Kiens,21,,14,21,35
021 Kiens,22,,16,25,41
021 Kiens,23,,15,20,35
021 Kiens,24,,29,21,50
021 Kiens,25,,19,15,34
021 Kiens,26,,29,23,52
021 Kiens,27,,19,25,44
021 Kiens,28,,22,20,42
021 Kiens,29,,34,24,58
021 Kiens,30,,23,22,45
021 Kiens,31,,29,24,53
021 Kiens,32,,25,27,52
021 Kiens,33,,29,25,54
021 Kiens,34,,42,18,60
021 Kiens,35,,23,23,46
021 Kiens,36,,24,23,47
021 Kiens,37,,25,22,47
021 Kiens,38,,34,24,58
021 Kiens,39,,20,22,42
021 Kiens,40,,29,18,47
021 Kiens,41,,20,24,44
021 Kiens,42,,21,20,41
021 Kiens,43,,24,16,40
021 Kiens,44,,14,13,27
021 Kiens,45,,11,18,29
021 Kiens,46,,18,13,31
021 Kiens,47,,15,11,26
021 Kiens,48,,10,16,26
021 Kiens,49,,14,23,37
021 Kiens,50,,11,8,19
021 Kiens,51,,12,13,25
021 Kiens,52,,16,10,26
021 Kiens,53,,10,15,25
021 Kiens,54,,15,18,33
021 Kiens,55,,16,14,30
021 Kiens,56,,19,12,31
021 Kiens,57,,8,12,20
021 Kiens,58,,11,13,24
021 Kiens,59,,21,12,33
021 Kiens,60,,17,11,28
021 Kiens,61,,19,11,30
021 Kiens,62,,13,16,29
021 Kiens,63,,12,8,20
021 Kiens,64,,14,14,28
021 Kiens,65,,11,12,23
021 Kiens,66,,11,11,22
021 Kiens,67,,4,17,21
021 Kiens,68,,9,14,23
021 Kiens,69,,12,8,20
021 Kiens,70,,14,13,27
021 Kiens,71,,17,9,26
021 Kiens,72,,9,11,20
021 Kiens,73,,7,9,16
021 Kiens,74,,2,5,7
021 Kiens,75,,5,6,11
021 Kiens,76,,3,5,8
021 Kiens,77,,6,3,9
021 Kiens,78,,5,7,12
021 Kiens,79,,7,6,13
021 Kiens,80,,4,4,8
021 Kiens,81,,1,7,8
021 Kiens,82,,5,3,8
021 Kiens,83,,1,3,4
021 Kiens,84,,1,2,3
021 Kiens,85,,1,2,3
021 Kiens,86,,-,3,3
021 Kiens,87,,2,2,4
021 Kiens,88,,2,2,4
021 Kiens,89,,3,2,5
021 Kiens,90,,1,3,4
021 Kiens,92,,2,1,3
021 Kiens,95,,-,1,1
022 Klausen,0,,39,23,62
022 Klausen,1,,32,34,66
022 Klausen,2,,28,33,61
022 Klausen,3,,29,25,54
022 Klausen,4,,21,29,50
022 Klausen,5,,40,34,74
022 Klausen,6,,25,28,53
022 Klausen,7,,34,24,58
022 Klausen,8,,18,31,49
022 Klausen,9,,29,23,52
022 Klausen,10,,39,26,65
022 Klausen,11,,33,31,64
022 Klausen,12,,38,23,61
022 Klausen,13,,28,29,57
022 Klausen,14,,30,32,62
022 Klausen,15,,23,33,56
022 Klausen,16,,35,29,64
022 Klausen,17,,37,37,74
022 Klausen,18,,32,26,58
022 Klausen,19,,24,39,63
022 Klausen,20,,39,36,75
022 Klausen,21,,34,32,66
022 Klausen,22,,26,32,58
022 Klausen,23,,27,38,65
022 Klausen,24,,37,43,80
022 Klausen,25,,37,35,72
022 Klausen,26,,42,22,64
022 Klausen,27,,35,41,76
022 Klausen,28,,37,30,67
022 Klausen,29,,45,26,71
022 Klausen,30,,35,41,76
022 Klausen,31,,44,37,81
022 Klausen,32,,42,48,90
022 Klausen,33,,47,51,98
022 Klausen,34,,49,42,91
022 Klausen,35,,45,42,87
022 Klausen,36,,58,42,100
022 Klausen,37,,41,38,79
022 Klausen,38,,39,43,82
022 Klausen,39,,37,38,75
022 Klausen,40,,32,41,73
022 Klausen,41,,49,40,89
022 Klausen,42,,38,26,64
022 Klausen,43,,29,37,66
022 Klausen,44,,29,30,59
022 Klausen,45,,29,26,55
022 Klausen,46,,28,24,52
022 Klausen,47,,30,31,61
022 Klausen,48,,31,41,72
022 Klausen,49,,19,30,49
022 Klausen,50,,24,15,39
022 Klausen,51,,33,26,59
022 Klausen,52,,29,23,52
022 Klausen,53,,28,26,54
022 Klausen,54,,29,26,55
022 Klausen,55,,28,20,48
022 Klausen,56,,30,21,51
022 Klausen,57,,13,17,30
022 Klausen,58,,22,18,40
022 Klausen,59,,22,28,50
022 Klausen,60,,21,26,47
022 Klausen,61,,27,20,47
022 Klausen,62,,24,22,46
022 Klausen,63,,26,20,46
022 Klausen,64,,18,20,38
022 Klausen,65,,18,17,35
022 Klausen,66,,19,24,43
022 Klausen,67,,12,19,31
022 Klausen,68,,17,15,32
022 Klausen,69,,22,17,39
022 Klausen,70,,12,22,34
022 Klausen,71,,12,15,27
022 Klausen,72,,12,19,31
022 Klausen,73,,19,22,41
022 Klausen,74,,7,17,24
022 Klausen,75,,8,15,23
022 Klausen,76,,13,11,24
022 Klausen,77,,12,9,21
022 Klausen,78,,12,15,27
022 Klausen,79,,3,15,18
022 Klausen,80,,6,16,22
022 Klausen,81,,2,12,14
022 Klausen,82,,4,10,14
022 Klausen,83,,2,10,12
022 Klausen,84,,2,9,11
022 Klausen,85,,3,6,9
022 Klausen,86,,1,2,3
022 Klausen,87,,3,-,3
022 Klausen,88,,4,8,12
022 Klausen,89,,-,11,11
022 Klausen,90,,2,2,4
022 Klausen,91,,1,-,1
022 Klausen,92,,2,3,5
022 Klausen,93,,-,2,2
023 Karneid,0,,13,15,28
023 Karneid,1,,21,22,43
023 Karneid,2,,17,20,37
023 Karneid,3,,24,28,52
023 Karneid,4,,18,20,38
023 Karneid,5,,31,18,49
023 Karneid,6,,19,18,37
023 Karneid,7,,23,20,43
023 Karneid,8,,21,23,44
023 Karneid,9,,21,19,40
023 Karneid,10,,23,18,41
023 Karneid,11,,17,20,37
023 Karneid,12,,23,15,38
023 Karneid,13,,16,18,34
023 Karneid,14,,18,19,37
023 Karneid,15,,12,19,31
023 Karneid,16,,20,19,39
023 Karneid,17,,21,13,34
023 Karneid,18,,26,15,41
023 Karneid,19,,18,10,28
023 Karneid,20,,23,17,40
023 Karneid,21,,27,27,54
023 Karneid,22,,24,20,44
023 Karneid,23,,25,25,50
023 Karneid,24,,24,11,35
023 Karneid,25,,17,15,32
023 Karneid,26,,23,28,51
023 Karneid,27,,19,19,38
023 Karneid,28,,28,26,54
023 Karneid,29,,31,27,58
023 Karneid,30,,29,27,56
023 Karneid,31,,32,32,64
023 Karneid,32,,33,17,50
023 Karneid,33,,18,25,43
023 Karneid,34,,40,37,77
023 Karneid,35,,35,35,70
023 Karneid,36,,36,33,69
023 Karneid,37,,30,26,56
023 Karneid,38,,35,23,58
023 Karneid,39,,36,23,59
023 Karneid,40,,27,34,61
023 Karneid,41,,27,20,47
023 Karneid,42,,29,27,56
023 Karneid,43,,30,20,50
023 Karneid,44,,20,19,39
023 Karneid,45,,19,18,37
023 Karneid,46,,21,19,40
023 Karneid,47,,16,10,26
023 Karneid,48,,15,17,32
023 Karneid,49,,23,16,39
023 Karneid,50,,11,20,31
023 Karneid,51,,19,12,31
023 Karneid,52,,22,16,38
023 Karneid,53,,12,15,27
023 Karneid,54,,16,25,41
023 Karneid,55,,8,15,23
023 Karneid,56,,12,21,33
023 Karneid,57,,13,15,28
023 Karneid,58,,13,14,27
023 Karneid,59,,21,14,35
023 Karneid,60,,18,24,42
023 Karneid,61,,23,15,38
023 Karneid,62,,15,16,31
023 Karneid,63,,17,17,34
023 Karneid,64,,21,10,31
023 Karneid,65,,9,9,18
023 Karneid,66,,12,12,24
023 Karneid,67,,10,14,24
023 Karneid,68,,14,15,29
023 Karneid,69,,10,15,25
023 Karneid,70,,13,5,18
023 Karneid,71,,18,11,29
023 Karneid,72,,7,8,15
023 Karneid,73,,12,10,22
023 Karneid,74,,9,8,17
023 Karneid,75,,4,9,13
023 Karneid,76,,9,10,19
023 Karneid,77,,6,7,13
023 Karneid,78,,8,10,18
023 Karneid,79,,4,4,8
023 Karneid,80,,2,8,10
023 Karneid,81,,1,6,7
023 Karneid,82,,3,8,11
023 Karneid,83,,6,3,9
023 Karneid,84,,-,6,6
023 Karneid,85,,1,3,4
023 Karneid,86,,-,2,2
023 Karneid,87,,-,1,1
023 Karneid,88,,-,1,1
023 Karneid,89,,-,3,3
023 Karneid,90,,-,4,4
023 Karneid,91,,-,1,1
023 Karneid,92,,1,1,2
023 Karneid,93,,1,1,2
023 Karneid,94,,-,1,1
023 Karneid,98,,-,1,1
024 Kurtatsch a.d.Weinstr.,0,,12,16,28
024 Kurtatsch a.d.Weinstr.,1,,17,12,29
024 Kurtatsch a.d.Weinstr.,2,,15,11,26
024 Kurtatsch a.d.Weinstr.,3,,15,10,25
024 Kurtatsch a.d.Weinstr.,4,,16,14,30
024 Kurtatsch a.d.Weinstr.,5,,13,12,25
024 Kurtatsch a.d.Weinstr.,6,,25,17,42
024 Kurtatsch a.d.Weinstr.,7,,19,12,31
024 Kurtatsch a.d.Weinstr.,8,,15,5,20
024 Kurtatsch a.d.Weinstr.,9,,24,20,44
024 Kurtatsch a.d.Weinstr.,10,,21,10,31
024 Kurtatsch a.d.Weinstr.,11,,15,17,32
024 Kurtatsch a.d.Weinstr.,12,,11,7,18
024 Kurtatsch a.d.Weinstr.,13,,10,17,27
024 Kurtatsch a.d.Weinstr.,14,,7,14,21
024 Kurtatsch a.d.Weinstr.,15,,11,12,23
024 Kurtatsch a.d.Weinstr.,16,,10,10,20
024 Kurtatsch a.d.Weinstr.,17,,13,11,24
024 Kurtatsch a.d.Weinstr.,18,,16,8,24
024 Kurtatsch a.d.Weinstr.,19,,15,8,23
024 Kurtatsch a.d.Weinstr.,20,,11,19,30
024 Kurtatsch a.d.Weinstr.,21,,11,12,23
024 Kurtatsch a.d.Weinstr.,22,,7,14,21
024 Kurtatsch a.d.Weinstr.,23,,9,10,19
024 Kurtatsch a.d.Weinstr.,24,,7,9,16
024 Kurtatsch a.d.Weinstr.,25,,8,14,22
024 Kurtatsch a.d.Weinstr.,26,,12,13,25
024 Kurtatsch a.d.Weinstr.,27,,12,10,22
024 Kurtatsch a.d.Weinstr.,28,,9,17,26
024 Kurtatsch a.d.Weinstr.,29,,15,15,30
024 Kurtatsch a.d.Weinstr.,30,,13,20,33
024 Kurtatsch a.d.Weinstr.,31,,13,19,32
024 Kurtatsch a.d.Weinstr.,32,,13,26,39
024 Kurtatsch a.d.Weinstr.,33,,24,18,42
024 Kurtatsch a.d.Weinstr.,34,,26,13,39
024 Kurtatsch a.d.Weinstr.,35,,19,19,38
024 Kurtatsch a.d.Weinstr.,36,,29,16,45
024 Kurtatsch a.d.Weinstr.,37,,23,26,49
024 Kurtatsch a.d.Weinstr.,38,,14,26,40
024 Kurtatsch a.d.Weinstr.,39,,19,21,40
024 Kurtatsch a.d.Weinstr.,40,,24,7,31
024 Kurtatsch a.d.Weinstr.,41,,17,15,32
024 Kurtatsch a.d.Weinstr.,42,,20,21,41
024 Kurtatsch a.d.Weinstr.,43,,19,10,29
024 Kurtatsch a.d.Weinstr.,44,,15,18,33
024 Kurtatsch a.d.Weinstr.,45,,10,10,20
024 Kurtatsch a.d.Weinstr.,46,,10,9,19
024 Kurtatsch a.d.Weinstr.,47,,14,16,30
024 Kurtatsch a.d.Weinstr.,48,,15,7,22
024 Kurtatsch a.d.Weinstr.,49,,16,18,34
024 Kurtatsch a.d.Weinstr.,50,,11,8,19
024 Kurtatsch a.d.Weinstr.,51,,10,13,23
024 Kurtatsch a.d.Weinstr.,52,,14,6,20
024 Kurtatsch a.d.Weinstr.,53,,13,10,23
024 Kurtatsch a.d.Weinstr.,54,,7,8,15
024 Kurtatsch a.d.Weinstr.,55,,11,8,19
024 Kurtatsch a.d.Weinstr.,56,,11,8,19
024 Kurtatsch a.d.Weinstr.,57,,7,8,15
024 Kurtatsch a.d.Weinstr.,58,,5,8,13
024 Kurtatsch a.d.Weinstr.,59,,10,6,16
024 Kurtatsch a.d.Weinstr.,60,,11,12,23
024 Kurtatsch a.d.Weinstr.,61,,7,11,18
024 Kurtatsch a.d.Weinstr.,62,,11,11,22
024 Kurtatsch a.d.Weinstr.,63,,4,14,18
024 Kurtatsch a.d.Weinstr.,64,,11,11,22
024 Kurtatsch a.d.Weinstr.,65,,5,11,16
024 Kurtatsch a.d.Weinstr.,66,,9,7,16
024 Kurtatsch a.d.Weinstr.,67,,5,8,13
024 Kurtatsch a.d.Weinstr.,68,,8,10,18
024 Kurtatsch a.d.Weinstr.,69,,8,7,15
024 Kurtatsch a.d.Weinstr.,70,,11,16,27
024 Kurtatsch a.d.Weinstr.,71,,7,12,19
024 Kurtatsch a.d.Weinstr.,72,,11,15,26
024 Kurtatsch a.d.Weinstr.,73,,9,10,19
024 Kurtatsch a.d.Weinstr.,74,,7,8,15
024 Kurtatsch a.d.Weinstr.,75,,10,6,16
024 Kurtatsch a.d.Weinstr.,76,,6,6,12
024 Kurtatsch a.d.Weinstr.,77,,4,9,13
024 Kurtatsch a.d.Weinstr.,78,,6,10,16
024 Kurtatsch a.d.Weinstr.,79,,7,19,26
024 Kurtatsch a.d.Weinstr.,80,,2,3,5
024 Kurtatsch a.d.Weinstr.,81,,3,8,11
024 Kurtatsch a.d.Weinstr.,82,,5,4,9
024 Kurtatsch a.d.Weinstr.,83,,2,1,3
024 Kurtatsch a.d.Weinstr.,84,,-,1,1
024 Kurtatsch a.d.Weinstr.,85,,-,6,6
024 Kurtatsch a.d.Weinstr.,86,,-,1,1
024 Kurtatsch a.d.Weinstr.,87,,2,2,4
024 Kurtatsch a.d.Weinstr.,88,,3,2,5
024 Kurtatsch a.d.Weinstr.,89,,-,2,2
024 Kurtatsch a.d.Weinstr.,90,,2,4,6
024 Kurtatsch a.d.Weinstr.,91,,-,5,5
024 Kurtatsch a.d.Weinstr.,92,,-,1,1
024 Kurtatsch a.d.Weinstr.,93,,-,2,2
024 Kurtatsch a.d.Weinstr.,94,,1,1,2
024 Kurtatsch a.d.Weinstr.,95,,-,2,2
024 Kurtatsch a.d.Weinstr.,96,,2,-,2
024 Kurtatsch a.d.Weinstr.,98,,1,-,1
025 Kurtinig a.d. Weinstr.,0,,3,4,7
025 Kurtinig a.d. Weinstr.,1,,2,5,7
025 Kurtinig a.d. Weinstr.,2,,3,4,7
025 Kurtinig a.d. Weinstr.,3,,3,3,6
025 Kurtinig a.d. Weinstr.,4,,2,5,7
025 Kurtinig a.d. Weinstr.,5,,3,4,7
025 Kurtinig a.d. Weinstr.,6,,1,2,3
025 Kurtinig a.d. Weinstr.,7,,4,3,7
025 Kurtinig a.d. Weinstr.,8,,2,4,6
025 Kurtinig a.d. Weinstr.,9,,4,4,8
025 Kurtinig a.d. Weinstr.,10,,2,3,5
025 Kurtinig a.d. Weinstr.,11,,5,2,7
025 Kurtinig a.d. Weinstr.,12,,3,2,5
025 Kurtinig a.d. Weinstr.,13,,6,4,10
025 Kurtinig a.d. Weinstr.,14,,6,4,10
025 Kurtinig a.d. Weinstr.,15,,5,6,11
025 Kurtinig a.d. Weinstr.,16,,4,5,9
025 Kurtinig a.d. Weinstr.,17,,2,3,5
025 Kurtinig a.d. Weinstr.,18,,3,2,5
025 Kurtinig a.d. Weinstr.,19,,3,4,7
025 Kurtinig a.d. Weinstr.,20,,6,5,11
025 Kurtinig a.d. Weinstr.,21,,6,5,11
025 Kurtinig a.d. Weinstr.,22,,4,3,7
025 Kurtinig a.d. Weinstr.,23,,4,8,12
025 Kurtinig a.d. Weinstr.,24,,3,2,5
025 Kurtinig a.d. Weinstr.,25,,4,1,5
025 Kurtinig a.d. Weinstr.,26,,3,-,3
025 Kurtinig a.d. Weinstr.,27,,2,5,7
025 Kurtinig a.d. Weinstr.,28,,4,2,6
025 Kurtinig a.d. Weinstr.,29,,6,1,7
025 Kurtinig a.d. Weinstr.,30,,2,5,7
025 Kurtinig a.d. Weinstr.,31,,3,3,6
025 Kurtinig a.d. Weinstr.,32,,6,3,9
025 Kurtinig a.d. Weinstr.,33,,7,6,13
025 Kurtinig a.d. Weinstr.,34,,5,4,9
025 Kurtinig a.d. Weinstr.,35,,4,4,8
025 Kurtinig a.d. Weinstr.,36,,2,5,7
025 Kurtinig a.d. Weinstr.,37,,4,4,8
025 Kurtinig a.d. Weinstr.,38,,7,5,12
025 Kurtinig a.d. Weinstr.,39,,5,7,12
025 Kurtinig a.d. Weinstr.,40,,5,5,10
025 Kurtinig a.d. Weinstr.,41,,8,9,17
025 Kurtinig a.d. Weinstr.,42,,5,4,9
025 Kurtinig a.d. Weinstr.,43,,11,5,16
025 Kurtinig a.d. Weinstr.,44,,3,8,11
025 Kurtinig a.d. Weinstr.,45,,8,7,15
025 Kurtinig a.d. Weinstr.,46,,4,3,7
025 Kurtinig a.d. Weinstr.,47,,3,1,4
025 Kurtinig a.d. Weinstr.,48,,7,2,9
025 Kurtinig a.d. Weinstr.,49,,5,5,10
025 Kurtinig a.d. Weinstr.,50,,2,4,6
025 Kurtinig a.d. Weinstr.,51,,3,4,7
025 Kurtinig a.d. Weinstr.,52,,3,3,6
025 Kurtinig a.d. Weinstr.,53,,3,3,6
025 Kurtinig a.d. Weinstr.,54,,4,5,9
025 Kurtinig a.d. Weinstr.,55,,5,1,6
025 Kurtinig a.d. Weinstr.,56,,-,5,5
025 Kurtinig a.d. Weinstr.,57,,3,2,5
025 Kurtinig a.d. Weinstr.,58,,3,2,5
025 Kurtinig a.d. Weinstr.,59,,4,2,6
025 Kurtinig a.d. Weinstr.,60,,2,2,4
025 Kurtinig a.d. Weinstr.,61,,3,2,5
025 Kurtinig a.d. Weinstr.,62,,2,2,4
025 Kurtinig a.d. Weinstr.,63,,5,3,8
025 Kurtinig a.d. Weinstr.,64,,2,2,4
025 Kurtinig a.d. Weinstr.,65,,2,3,5
025 Kurtinig a.d. Weinstr.,66,,6,3,9
025 Kurtinig a.d. Weinstr.,67,,-,6,6
025 Kurtinig a.d. Weinstr.,68,,2,4,6
025 Kurtinig a.d. Weinstr.,69,,1,2,3
025 Kurtinig a.d. Weinstr.,70,,3,4,7
025 Kurtinig a.d. Weinstr.,71,,3,2,5
025 Kurtinig a.d. Weinstr.,72,,4,4,8
025 Kurtinig a.d. Weinstr.,73,,1,3,4
025 Kurtinig a.d. Weinstr.,74,,2,4,6
025 Kurtinig a.d. Weinstr.,75,,2,4,6
025 Kurtinig a.d. Weinstr.,76,,4,-,4
025 Kurtinig a.d. Weinstr.,77,,-,5,5
025 Kurtinig a.d. Weinstr.,78,,2,4,6
025 Kurtinig a.d. Weinstr.,79,,1,1,2
025 Kurtinig a.d. Weinstr.,80,,-,3,3
025 Kurtinig a.d. Weinstr.,81,,2,1,3
025 Kurtinig a.d. Weinstr.,82,,1,-,1
025 Kurtinig a.d. Weinstr.,83,,-,2,2
025 Kurtinig a.d. Weinstr.,84,,-,1,1
025 Kurtinig a.d. Weinstr.,87,,-,2,2
025 Kurtinig a.d. Weinstr.,88,,-,2,2
025 Kurtinig a.d. Weinstr.,90,,1,1,2
025 Kurtinig a.d. Weinstr.,98,,-,1,1
026 Corvara,0,,6,6,12
026 Corvara,1,,4,9,13
026 Corvara,2,,7,4,11
026 Corvara,3,,8,7,15
026 Corvara,4,,10,7,17
026 Corvara,5,,4,6,10
026 Corvara,6,,8,4,12
026 Corvara,7,,7,9,16
026 Corvara,8,,6,4,10
026 Corvara,9,,6,3,9
026 Corvara,10,,6,11,17
026 Corvara,11,,2,6,8
026 Corvara,12,,9,7,16
026 Corvara,13,,5,5,10
026 Corvara,14,,6,3,9
026 Corvara,15,,9,7,16
026 Corvara,16,,3,-,3
026 Corvara,17,,5,8,13
026 Corvara,18,,7,3,10
026 Corvara,19,,7,7,14
026 Corvara,20,,8,11,19
026 Corvara,21,,15,2,17
026 Corvara,22,,11,7,18
026 Corvara,23,,10,8,18
026 Corvara,24,,10,3,13
026 Corvara,25,,15,8,23
026 Corvara,26,,11,4,15
026 Corvara,27,,8,18,26
026 Corvara,28,,7,15,22
026 Corvara,29,,14,8,22
026 Corvara,30,,7,7,14
026 Corvara,31,,12,6,18
026 Corvara,32,,10,12,22
026 Corvara,33,,14,12,26
026 Corvara,34,,7,14,21
026 Corvara,35,,16,19,35
026 Corvara,36,,13,17,30
026 Corvara,37,,16,17,33
026 Corvara,38,,8,7,15
026 Corvara,39,,11,11,22
026 Corvara,40,,13,12,25
026 Corvara,41,,8,7,15
026 Corvara,42,,15,12,27
026 Corvara,43,,6,7,13
026 Corvara,44,,10,6,16
026 Corvara,45,,7,5,12
026 Corvara,46,,4,8,12
026 Corvara,47,,11,7,18
026 Corvara,48,,10,8,18
026 Corvara,49,,6,13,19
026 Corvara,50,,5,8,13
026 Corvara,51,,6,8,14
026 Corvara,52,,7,8,15
026 Corvara,53,,3,9,12
026 Corvara,54,,5,5,10
026 Corvara,55,,4,10,14
026 Corvara,56,,14,11,25
026 Corvara,57,,5,5,10
026 Corvara,58,,8,9,17
026 Corvara,59,,5,10,15
026 Corvara,60,,5,9,14
026 Corvara,61,,14,12,26
026 Corvara,62,,9,6,15
026 Corvara,63,,8,4,12
026 Corvara,64,,4,8,12
026 Corvara,65,,5,8,13
026 Corvara,66,,6,8,14
026 Corvara,67,,8,5,13
026 Corvara,68,,8,8,16
026 Corvara,69,,4,4,8
026 Corvara,70,,7,4,11
026 Corvara,71,,7,11,18
026 Corvara,72,,7,3,10
026 Corvara,73,,5,5,10
026 Corvara,74,,2,2,4
026 Corvara,75,,6,3,9
026 Corvara,76,,3,3,6
026 Corvara,77,,1,3,4
026 Corvara,78,,3,1,4
026 Corvara,79,,4,3,7
026 Corvara,80,,3,4,7
026 Corvara,81,,4,1,5
026 Corvara,82,,4,1,5
026 Corvara,83,,2,2,4
026 Corvara,84,,1,1,2
026 Corvara,85,,1,2,3
026 Corvara,88,,-,3,3
026 Corvara,89,,-,5,5
026 Corvara,90,,2,5,7
026 Corvara,91,,2,-,2
026 Corvara,92,,-,2,2
026 Corvara,93,,-,1,1
026 Corvara,94,,-,1,1
026 Corvara,96,,-,1,1
026 Corvara,99,,1,-,1
027 Graun im Vinschgau,0,,10,13,23
027 Graun im Vinschgau,1,,14,13,27
027 Graun im Vinschgau,2,,17,15,32
027 Graun im Vinschgau,3,,13,10,23
027 Graun im Vinschgau,4,,11,16,27
027 Graun im Vinschgau,5,,16,16,32
027 Graun im Vinschgau,6,,21,19,40
027 Graun im Vinschgau,7,,19,16,35
027 Graun im Vinschgau,8,,19,12,31
027 Graun im Vinschgau,9,,21,14,35
027 Graun im Vinschgau,10,,17,16,33
027 Graun im Vinschgau,11,,10,12,22
027 Graun im Vinschgau,12,,18,19,37
027 Graun im Vinschgau,13,,26,18,44
027 Graun im Vinschgau,14,,21,11,32
027 Graun im Vinschgau,15,,16,12,28
027 Graun im Vinschgau,16,,8,8,16
027 Graun im Vinschgau,17,,19,10,29
027 Graun im Vinschgau,18,,20,15,35
027 Graun im Vinschgau,19,,8,15,23
027 Graun im Vinschgau,20,,18,16,34
027 Graun im Vinschgau,21,,21,17,38
027 Graun im Vinschgau,22,,24,16,40
027 Graun im Vinschgau,23,,15,22,37
027 Graun im Vinschgau,24,,16,15,31
027 Graun im Vinschgau,25,,15,19,34
027 Graun im Vinschgau,26,,15,20,35
027 Graun im Vinschgau,27,,19,19,38
027 Graun im Vinschgau,28,,20,13,33
027 Graun im Vinschgau,29,,21,20,41
027 Graun im Vinschgau,30,,20,20,40
027 Graun im Vinschgau,31,,20,10,30
027 Graun im Vinschgau,32,,21,14,35
027 Graun im Vinschgau,33,,28,20,48
027 Graun im Vinschgau,34,,17,22,39
027 Graun im Vinschgau,35,,28,21,49
027 Graun im Vinschgau,36,,19,23,42
027 Graun im Vinschgau,37,,18,19,37
027 Graun im Vinschgau,38,,20,23,43
027 Graun im Vinschgau,39,,22,17,39
027 Graun im Vinschgau,40,,23,23,46
027 Graun im Vinschgau,41,,19,15,34
027 Graun im Vinschgau,42,,20,21,41
027 Graun im Vinschgau,43,,22,11,33
027 Graun im Vinschgau,44,,20,15,35
027 Graun im Vinschgau,45,,12,12,24
027 Graun im Vinschgau,46,,15,11,26
027 Graun im Vinschgau,47,,14,9,23
027 Graun im Vinschgau,48,,17,17,34
027 Graun im Vinschgau,49,,14,6,20
027 Graun im Vinschgau,50,,18,10,28
027 Graun im Vinschgau,51,,13,16,29
027 Graun im Vinschgau,52,,12,12,24
027 Graun im Vinschgau,53,,7,21,28
027 Graun im Vinschgau,54,,13,12,25
027 Graun im Vinschgau,55,,5,10,15
027 Graun im Vinschgau,56,,8,7,15
027 Graun im Vinschgau,57,,8,8,16
027 Graun im Vinschgau,58,,11,10,21
027 Graun im Vinschgau,59,,9,13,22
027 Graun im Vinschgau,60,,10,13,23
027 Graun im Vinschgau,61,,15,10,25
027 Graun im Vinschgau,62,,14,9,23
027 Graun im Vinschgau,63,,11,11,22
027 Graun im Vinschgau,64,,11,11,22
027 Graun im Vinschgau,65,,11,3,14
027 Graun im Vinschgau,66,,14,14,28
027 Graun im Vinschgau,67,,9,8,17
027 Graun im Vinschgau,68,,11,9,20
027 Graun im Vinschgau,69,,8,7,15
027 Graun im Vinschgau,70,,12,7,19
027 Graun im Vinschgau,71,,10,10,20
027 Graun im Vinschgau,72,,5,7,12
027 Graun im Vinschgau,73,,13,14,27
027 Graun im Vinschgau,74,,9,11,20
027 Graun im Vinschgau,75,,6,10,16
027 Graun im Vinschgau,76,,8,13,21
027 Graun im Vinschgau,77,,6,5,11
027 Graun im Vinschgau,78,,7,9,16
027 Graun im Vinschgau,79,,4,13,17
027 Graun im Vinschgau,80,,7,8,15
027 Graun im Vinschgau,81,,6,12,18
027 Graun im Vinschgau,82,,4,1,5
027 Graun im Vinschgau,83,,1,5,6
027 Graun im Vinschgau,84,,2,2,4
027 Graun im Vinschgau,85,,-,1,1
027 Graun im Vinschgau,86,,1,2,3
027 Graun im Vinschgau,87,,-,3,3
027 Graun im Vinschgau,88,,2,4,6
027 Graun im Vinschgau,89,,-,2,2
027 Graun im Vinschgau,90,,1,1,2
027 Graun im Vinschgau,91,,1,2,3
027 Graun im Vinschgau,93,,-,1,1
027 Graun im Vinschgau,94,,-,3,3
027 Graun im Vinschgau,95,,-,1,1
027 Graun im Vinschgau,99,,-,1,1
028 Toblach,0,,9,24,33
028 Toblach,1,,26,17,43
028 Toblach,2,,21,18,39
028 Toblach,3,,15,19,34
028 Toblach,4,,19,11,30
028 Toblach,5,,25,17,42
028 Toblach,6,,27,22,49
028 Toblach,7,,18,8,26
028 Toblach,8,,21,19,40
028 Toblach,9,,19,19,38
028 Toblach,10,,16,18,34
028 Toblach,11,,17,28,45
028 Toblach,12,,17,23,40
028 Toblach,13,,10,15,25
028 Toblach,14,,14,24,38
028 Toblach,15,,31,16,47
028 Toblach,16,,15,21,36
028 Toblach,17,,25,23,48
028 Toblach,18,,20,27,47
028 Toblach,19,,21,20,41
028 Toblach,20,,22,28,50
028 Toblach,21,,25,22,47
028 Toblach,22,,26,18,44
028 Toblach,23,,25,24,49
028 Toblach,24,,23,25,48
028 Toblach,25,,15,26,41
028 Toblach,26,,28,33,61
028 Toblach,27,,23,21,44
028 Toblach,28,,31,17,48
028 Toblach,29,,32,26,58
028 Toblach,30,,32,33,65
028 Toblach,31,,30,21,51
028 Toblach,32,,23,21,44
028 Toblach,33,,36,27,63
028 Toblach,34,,37,25,62
028 Toblach,35,,29,24,53
028 Toblach,36,,28,29,57
028 Toblach,37,,35,29,64
028 Toblach,38,,33,31,64
028 Toblach,39,,32,25,57
028 Toblach,40,,36,30,66
028 Toblach,41,,22,30,52
028 Toblach,42,,21,17,38
028 Toblach,43,,37,27,64
028 Toblach,44,,25,15,40
028 Toblach,45,,27,22,49
028 Toblach,46,,16,24,40
028 Toblach,47,,18,26,44
028 Toblach,48,,19,19,38
028 Toblach,49,,20,25,45
028 Toblach,50,,18,17,35
028 Toblach,51,,27,11,38
028 Toblach,52,,15,17,32
028 Toblach,53,,20,13,33
028 Toblach,54,,16,24,40
028 Toblach,55,,19,15,34
028 Toblach,56,,13,15,28
028 Toblach,57,,13,17,30
028 Toblach,58,,19,12,31
028 Toblach,59,,14,18,32
028 Toblach,60,,15,19,34
028 Toblach,61,,18,12,30
028 Toblach,62,,13,13,26
028 Toblach,63,,15,13,28
028 Toblach,64,,16,8,24
028 Toblach,65,,5,9,14
028 Toblach,66,,9,17,26
028 Toblach,67,,8,18,26
028 Toblach,68,,15,16,31
028 Toblach,69,,10,10,20
028 Toblach,70,,13,17,30
028 Toblach,71,,17,14,31
028 Toblach,72,,10,11,21
028 Toblach,73,,10,14,24
028 Toblach,74,,14,11,25
028 Toblach,75,,10,14,24
028 Toblach,76,,9,14,23
028 Toblach,77,,13,9,22
028 Toblach,78,,8,10,18
028 Toblach,79,,10,8,18
028 Toblach,80,,6,16,22
028 Toblach,81,,4,12,16
028 Toblach,82,,4,8,12
028 Toblach,83,,4,11,15
028 Toblach,84,,4,4,8
028 Toblach,85,,4,4,8
028 Toblach,86,,2,5,7
028 Toblach,87,,1,7,8
028 Toblach,88,,1,4,5
028 Toblach,89,,1,5,6
028 Toblach,90,,1,2,3
028 Toblach,91,,1,3,4
028 Toblach,92,,-,3,3
028 Toblach,93,,1,1,2
028 Toblach,94,,-,1,1
028 Toblach,95,,1,-,1
028 Toblach,96,,-,1,1
028 Toblach,97,,-,1,1
029 Neumarkt,0,,25,25,50
029 Neumarkt,1,,23,33,56
029 Neumarkt,2,,27,17,44
029 Neumarkt,3,,17,24,41
029 Neumarkt,4,,21,36,57
029 Neumarkt,5,,18,17,35
029 Neumarkt,6,,18,23,41
029 Neumarkt,7,,23,24,47
029 Neumarkt,8,,22,24,46
029 Neumarkt,9,,22,35,57
029 Neumarkt,10,,20,26,46
029 Neumarkt,11,,24,18,42
029 Neumarkt,12,,26,24,50
029 Neumarkt,13,,22,31,53
029 Neumarkt,14,,22,24,46
029 Neumarkt,15,,25,29,54
029 Neumarkt,16,,21,16,37
029 Neumarkt,17,,25,18,43
029 Neumarkt,18,,17,23,40
029 Neumarkt,19,,15,24,39
029 Neumarkt,20,,24,25,49
029 Neumarkt,21,,22,21,43
029 Neumarkt,22,,19,20,39
029 Neumarkt,23,,22,17,39
029 Neumarkt,24,,34,26,60
029 Neumarkt,25,,18,14,32
029 Neumarkt,26,,26,34,60
029 Neumarkt,27,,32,32,64
029 Neumarkt,28,,30,35,65
029 Neumarkt,29,,26,24,50
029 Neumarkt,30,,34,41,75
029 Neumarkt,31,,30,48,78
029 Neumarkt,32,,30,28,58
029 Neumarkt,33,,33,36,69
029 Neumarkt,34,,29,46,75
029 Neumarkt,35,,45,41,86
029 Neumarkt,36,,55,42,97
029 Neumarkt,37,,46,36,82
029 Neumarkt,38,,49,39,88
029 Neumarkt,39,,45,44,89
029 Neumarkt,40,,51,33,84
029 Neumarkt,41,,31,36,67
029 Neumarkt,42,,48,45,93
029 Neumarkt,43,,42,33,75
029 Neumarkt,44,,29,36,65
029 Neumarkt,45,,37,29,66
029 Neumarkt,46,,33,25,58
029 Neumarkt,47,,36,41,77
029 Neumarkt,48,,37,29,66
029 Neumarkt,49,,19,19,38
029 Neumarkt,50,,27,22,49
029 Neumarkt,51,,21,23,44
029 Neumarkt,52,,24,23,47
029 Neumarkt,53,,18,25,43
029 Neumarkt,54,,21,22,43
029 Neumarkt,55,,27,31,58
029 Neumarkt,56,,33,32,65
029 Neumarkt,57,,26,23,49
029 Neumarkt,58,,22,15,37
029 Neumarkt,59,,26,23,49
029 Neumarkt,60,,22,26,48
029 Neumarkt,61,,37,25,62
029 Neumarkt,62,,31,33,64
029 Neumarkt,63,,16,29,45
029 Neumarkt,64,,20,18,38
029 Neumarkt,65,,24,18,42
029 Neumarkt,66,,20,18,38
029 Neumarkt,67,,21,23,44
029 Neumarkt,68,,14,23,37
029 Neumarkt,69,,19,19,38
029 Neumarkt,70,,20,22,42
029 Neumarkt,71,,24,30,54
029 Neumarkt,72,,17,23,40
029 Neumarkt,73,,14,17,31
029 Neumarkt,74,,7,21,28
029 Neumarkt,75,,19,20,39
029 Neumarkt,76,,16,17,33
029 Neumarkt,77,,16,20,36
029 Neumarkt,78,,10,14,24
029 Neumarkt,79,,15,25,40
029 Neumarkt,80,,10,17,27
029 Neumarkt,81,,5,22,27
029 Neumarkt,82,,6,19,25
029 Neumarkt,83,,5,8,13
029 Neumarkt,84,,6,3,9
029 Neumarkt,85,,1,8,9
029 Neumarkt,86,,1,4,5
029 Neumarkt,87,,1,6,7
029 Neumarkt,88,,5,7,12
029 Neumarkt,89,,4,7,11
029 Neumarkt,90,,3,6,9
029 Neumarkt,91,,1,5,6
029 Neumarkt,92,,1,3,4
029 Neumarkt,93,,2,2,4
029 Neumarkt,94,,-,1,1
029 Neumarkt,95,,-,1,1
029 Neumarkt,96,,1,2,3
030 Pfalzen,0,,13,13,26
030 Pfalzen,1,,15,10,25
030 Pfalzen,2,,11,16,27
030 Pfalzen,3,,18,17,35
030 Pfalzen,4,,16,15,31
030 Pfalzen,5,,13,15,28
030 Pfalzen,6,,15,16,31
030 Pfalzen,7,,23,16,39
030 Pfalzen,8,,11,15,26
030 Pfalzen,9,,11,16,27
030 Pfalzen,10,,13,21,34
030 Pfalzen,11,,15,19,34
030 Pfalzen,12,,19,13,32
030 Pfalzen,13,,16,19,35
030 Pfalzen,14,,13,8,21
030 Pfalzen,15,,14,23,37
030 Pfalzen,16,,20,18,38
030 Pfalzen,17,,22,13,35
030 Pfalzen,18,,15,10,25
030 Pfalzen,19,,12,10,22
030 Pfalzen,20,,19,19,38
030 Pfalzen,21,,18,19,37
030 Pfalzen,22,,20,16,36
030 Pfalzen,23,,15,20,35
030 Pfalzen,24,,17,18,35
030 Pfalzen,25,,21,17,38
030 Pfalzen,26,,17,11,28
030 Pfalzen,27,,10,19,29
030 Pfalzen,28,,24,16,40
030 Pfalzen,29,,14,20,34
030 Pfalzen,30,,17,20,37
030 Pfalzen,31,,22,21,43
030 Pfalzen,32,,19,20,39
030 Pfalzen,33,,31,12,43
030 Pfalzen,34,,23,33,56
030 Pfalzen,35,,17,22,39
030 Pfalzen,36,,22,22,44
030 Pfalzen,37,,24,22,46
030 Pfalzen,38,,19,15,34
030 Pfalzen,39,,28,18,46
030 Pfalzen,40,,18,28,46
030 Pfalzen,41,,25,18,43
030 Pfalzen,42,,20,12,32
030 Pfalzen,43,,14,15,29
030 Pfalzen,44,,16,21,37
030 Pfalzen,45,,24,18,42
030 Pfalzen,46,,15,14,29
030 Pfalzen,47,,15,11,26
030 Pfalzen,48,,13,12,25
030 Pfalzen,49,,13,11,24
030 Pfalzen,50,,10,10,20
030 Pfalzen,51,,16,16,32
030 Pfalzen,52,,11,11,22
030 Pfalzen,53,,15,6,21
030 Pfalzen,54,,10,10,20
030 Pfalzen,55,,11,3,14
030 Pfalzen,56,,8,9,17
030 Pfalzen,57,,7,9,16
030 Pfalzen,58,,10,6,16
030 Pfalzen,59,,8,12,20
030 Pfalzen,60,,6,13,19
030 Pfalzen,61,,12,8,20
030 Pfalzen,62,,13,9,22
030 Pfalzen,63,,10,5,15
030 Pfalzen,64,,11,10,21
030 Pfalzen,65,,6,5,11
030 Pfalzen,66,,2,9,11
030 Pfalzen,67,,8,5,13
030 Pfalzen,68,,8,13,21
030 Pfalzen,69,,6,8,14
030 Pfalzen,70,,9,4,13
030 Pfalzen,71,,12,6,18
030 Pfalzen,72,,8,11,19
030 Pfalzen,73,,10,6,16
030 Pfalzen,74,,3,5,8
030 Pfalzen,75,,6,5,11
030 Pfalzen,76,,4,4,8
030 Pfalzen,77,,7,4,11
030 Pfalzen,78,,3,11,14
030 Pfalzen,79,,6,6,12
030 Pfalzen,80,,3,3,6
030 Pfalzen,81,,-,5,5
030 Pfalzen,82,,2,7,9
030 Pfalzen,83,,4,4,8
030 Pfalzen,84,,1,1,2
030 Pfalzen,85,,1,1,2
030 Pfalzen,86,,-,2,2
030 Pfalzen,88,,1,3,4
030 Pfalzen,89,,1,3,4
030 Pfalzen,92,,-,3,3
030 Pfalzen,93,,1,1,2
030 Pfalzen,94,,1,-,1
031 Völs am Schlern,0,,19,29,48
031 Völs am Schlern,1,,19,25,44
031 Völs am Schlern,2,,21,29,50
031 Völs am Schlern,3,,21,16,37
031 Völs am Schlern,4,,26,27,53
031 Völs am Schlern,5,,19,23,42
031 Völs am Schlern,6,,14,20,34
031 Völs am Schlern,7,,20,23,43
031 Völs am Schlern,8,,20,8,28
031 Völs am Schlern,9,,17,17,34
031 Völs am Schlern,10,,20,17,37
031 Völs am Schlern,11,,14,20,34
031 Völs am Schlern,12,,19,18,37
031 Völs am Schlern,13,,19,15,34
031 Völs am Schlern,14,,16,14,30
031 Völs am Schlern,15,,18,14,32
031 Völs am Schlern,16,,22,12,34
031 Völs am Schlern,17,,17,14,31
031 Völs am Schlern,18,,16,6,22
031 Völs am Schlern,19,,12,22,34
031 Völs am Schlern,20,,19,20,39
031 Völs am Schlern,21,,26,18,44
031 Völs am Schlern,22,,31,15,46
031 Völs am Schlern,23,,21,23,44
031 Völs am Schlern,24,,25,19,44
031 Völs am Schlern,25,,21,26,47
031 Völs am Schlern,26,,26,21,47
031 Völs am Schlern,27,,23,18,41
031 Völs am Schlern,28,,25,22,47
031 Völs am Schlern,29,,26,34,60
031 Völs am Schlern,30,,35,28,63
031 Völs am Schlern,31,,36,34,70
031 Völs am Schlern,32,,32,34,66
031 Völs am Schlern,33,,34,30,64
031 Völs am Schlern,34,,28,34,62
031 Völs am Schlern,35,,29,22,51
031 Völs am Schlern,36,,41,24,65
031 Völs am Schlern,37,,26,26,52
031 Völs am Schlern,38,,26,24,50
031 Völs am Schlern,39,,32,28,60
031 Völs am Schlern,40,,27,20,47
031 Völs am Schlern,41,,22,20,42
031 Völs am Schlern,42,,24,22,46
031 Völs am Schlern,43,,19,11,30
031 Völs am Schlern,44,,21,16,37
031 Völs am Schlern,45,,21,17,38
031 Völs am Schlern,46,,20,17,37
031 Völs am Schlern,47,,17,15,32
031 Völs am Schlern,48,,16,26,42
031 Völs am Schlern,49,,17,24,41
031 Völs am Schlern,50,,18,18,36
031 Völs am Schlern,51,,17,21,38
031 Völs am Schlern,52,,22,15,37
031 Völs am Schlern,53,,17,9,26
031 Völs am Schlern,54,,16,13,29
031 Völs am Schlern,55,,16,19,35
031 Völs am Schlern,56,,15,11,26
031 Völs am Schlern,57,,11,12,23
031 Völs am Schlern,58,,14,11,25
031 Völs am Schlern,59,,14,22,36
031 Völs am Schlern,60,,15,17,32
031 Völs am Schlern,61,,21,19,40
031 Völs am Schlern,62,,11,19,30
031 Völs am Schlern,63,,13,11,24
031 Völs am Schlern,64,,13,15,28
031 Völs am Schlern,65,,11,9,20
031 Völs am Schlern,66,,9,19,28
031 Völs am Schlern,67,,16,13,29
031 Völs am Schlern,68,,15,8,23
031 Völs am Schlern,69,,7,14,21
031 Völs am Schlern,70,,13,8,21
031 Völs am Schlern,71,,13,14,27
031 Völs am Schlern,72,,6,12,18
031 Völs am Schlern,73,,7,11,18
031 Völs am Schlern,74,,5,13,18
031 Völs am Schlern,75,,10,11,21
031 Völs am Schlern,76,,10,6,16
031 Völs am Schlern,77,,7,11,18
031 Völs am Schlern,78,,12,14,26
031 Völs am Schlern,79,,5,6,11
031 Völs am Schlern,80,,3,7,10
031 Völs am Schlern,81,,4,13,17
031 Völs am Schlern,82,,4,6,10
031 Völs am Schlern,83,,1,5,6
031 Völs am Schlern,84,,1,4,5
031 Völs am Schlern,85,,1,5,6
031 Völs am Schlern,86,,2,2,4
031 Völs am Schlern,87,,1,3,4
031 Völs am Schlern,88,,3,5,8
031 Völs am Schlern,89,,5,1,6
031 Völs am Schlern,90,,1,1,2
031 Völs am Schlern,91,,1,3,4
031 Völs am Schlern,92,,1,3,4
031 Völs am Schlern,93,,2,-,2
031 Völs am Schlern,94,,-,3,3
031 Völs am Schlern,95,,-,2,2
032 Franzensfeste,0,,7,6,13
032 Franzensfeste,1,,5,5,10
032 Franzensfeste,2,,2,3,5
032 Franzensfeste,3,,6,7,13
032 Franzensfeste,4,,4,6,10
032 Franzensfeste,5,,5,3,8
032 Franzensfeste,6,,6,3,9
032 Franzensfeste,7,,4,2,6
032 Franzensfeste,8,,6,5,11
032 Franzensfeste,9,,5,5,10
032 Franzensfeste,10,,5,9,14
032 Franzensfeste,11,,4,4,8
032 Franzensfeste,12,,2,4,6
032 Franzensfeste,13,,4,4,8
032 Franzensfeste,14,,3,2,5
032 Franzensfeste,15,,4,2,6
032 Franzensfeste,16,,5,5,10
032 Franzensfeste,17,,4,6,10
032 Franzensfeste,18,,5,6,11
032 Franzensfeste,19,,7,5,12
032 Franzensfeste,20,,3,7,10
032 Franzensfeste,21,,7,4,11
032 Franzensfeste,22,,5,7,12
032 Franzensfeste,23,,12,5,17
032 Franzensfeste,24,,6,4,10
032 Franzensfeste,25,,1,2,3
032 Franzensfeste,26,,2,4,6
032 Franzensfeste,27,,8,10,18
032 Franzensfeste,28,,9,7,16
032 Franzensfeste,29,,2,6,8
032 Franzensfeste,30,,6,11,17
032 Franzensfeste,31,,8,3,11
032 Franzensfeste,32,,14,7,21
032 Franzensfeste,33,,8,7,15
032 Franzensfeste,34,,8,13,21
032 Franzensfeste,35,,10,6,16
032 Franzensfeste,36,,9,7,16
032 Franzensfeste,37,,11,6,17
032 Franzensfeste,38,,15,8,23
032 Franzensfeste,39,,7,8,15
032 Franzensfeste,40,,9,2,11
032 Franzensfeste,41,,6,10,16
032 Franzensfeste,42,,5,7,12
032 Franzensfeste,43,,8,9,17
032 Franzensfeste,44,,11,3,14
032 Franzensfeste,45,,4,6,10
032 Franzensfeste,46,,4,7,11
032 Franzensfeste,47,,9,7,16
032 Franzensfeste,48,,5,10,15
032 Franzensfeste,49,,6,6,12
032 Franzensfeste,50,,4,4,8
032 Franzensfeste,51,,7,1,8
032 Franzensfeste,52,,11,3,14
032 Franzensfeste,53,,3,4,7
032 Franzensfeste,54,,4,4,8
032 Franzensfeste,55,,3,3,6
032 Franzensfeste,56,,9,6,15
032 Franzensfeste,57,,4,7,11
032 Franzensfeste,58,,4,9,13
032 Franzensfeste,59,,3,2,5
032 Franzensfeste,60,,5,1,6
032 Franzensfeste,61,,5,2,7
032 Franzensfeste,62,,4,4,8
032 Franzensfeste,63,,7,4,11
032 Franzensfeste,64,,1,3,4
032 Franzensfeste,65,,8,6,14
032 Franzensfeste,66,,4,2,6
032 Franzensfeste,67,,3,3,6
032 Franzensfeste,68,,3,3,6
032 Franzensfeste,69,,2,6,8
032 Franzensfeste,70,,3,7,10
032 Franzensfeste,71,,2,8,10
032 Franzensfeste,72,,6,4,10
032 Franzensfeste,73,,4,8,12
032 Franzensfeste,74,,2,2,4
032 Franzensfeste,75,,3,6,9
032 Franzensfeste,76,,4,10,14
032 Franzensfeste,77,,4,1,5
032 Franzensfeste,78,,7,5,12
032 Franzensfeste,79,,4,6,10
032 Franzensfeste,80,,4,5,9
032 Franzensfeste,81,,1,4,5
032 Franzensfeste,82,,1,4,5
032 Franzensfeste,83,,2,1,3
032 Franzensfeste,84,,-,2,2
032 Franzensfeste,87,,1,2,3
032 Franzensfeste,89,,1,-,1
032 Franzensfeste,90,,-,1,1
032 Franzensfeste,91,,-,1,1
032 Franzensfeste,93,,-,1,1
032 Franzensfeste,94,,-,1,1
032 Franzensfeste,98,,-,1,1
033 Villnöss,0,,20,15,35
033 Villnöss,1,,14,19,33
033 Villnöss,2,,18,14,32
033 Villnöss,3,,16,31,47
033 Villnöss,4,,23,19,42
033 Villnöss,5,,16,23,39
033 Villnöss,6,,22,17,39
033 Villnöss,7,,16,14,30
033 Villnöss,8,,14,12,26
033 Villnöss,9,,17,12,29
033 Villnöss,10,,12,14,26
033 Villnöss,11,,20,16,36
033 Villnöss,12,,13,11,24
033 Villnöss,13,,12,7,19
033 Villnöss,14,,16,23,39
033 Villnöss,15,,16,21,37
033 Villnöss,16,,11,17,28
033 Villnöss,17,,16,17,33
033 Villnöss,18,,15,14,29
033 Villnöss,19,,16,14,30
033 Villnöss,20,,12,16,28
033 Villnöss,21,,12,17,29
033 Villnöss,22,,21,12,33
033 Villnöss,23,,11,11,22
033 Villnöss,24,,16,15,31
033 Villnöss,25,,17,14,31
033 Villnöss,26,,16,13,29
033 Villnöss,27,,25,18,43
033 Villnöss,28,,20,22,42
033 Villnöss,29,,12,16,28
033 Villnöss,30,,18,25,43
033 Villnöss,31,,26,24,50
033 Villnöss,32,,19,25,44
033 Villnöss,33,,30,20,50
033 Villnöss,34,,28,17,45
033 Villnöss,35,,20,16,36
033 Villnöss,36,,26,21,47
033 Villnöss,37,,30,24,54
033 Villnöss,38,,31,26,57
033 Villnöss,39,,30,19,49
033 Villnöss,40,,26,19,45
033 Villnöss,41,,23,14,37
033 Villnöss,42,,20,13,33
033 Villnöss,43,,11,11,22
033 Villnöss,44,,9,15,24
033 Villnöss,45,,13,12,25
033 Villnöss,46,,15,15,30
033 Villnöss,47,,13,3,16
033 Villnöss,48,,17,13,30
033 Villnöss,49,,13,13,26
033 Villnöss,50,,13,11,24
033 Villnöss,51,,10,9,19
033 Villnöss,52,,7,9,16
033 Villnöss,53,,9,14,23
033 Villnöss,54,,10,9,19
033 Villnöss,55,,11,11,22
033 Villnöss,56,,9,5,14
033 Villnöss,57,,8,4,12
033 Villnöss,58,,9,14,23
033 Villnöss,59,,12,10,22
033 Villnöss,60,,11,18,29
033 Villnöss,61,,13,10,23
033 Villnöss,62,,8,18,26
033 Villnöss,63,,12,13,25
033 Villnöss,64,,12,9,21
033 Villnöss,65,,10,13,23
033 Villnöss,66,,5,16,21
033 Villnöss,67,,6,10,16
033 Villnöss,68,,11,9,20
033 Villnöss,69,,10,11,21
033 Villnöss,70,,15,13,28
033 Villnöss,71,,10,11,21
033 Villnöss,72,,10,10,20
033 Villnöss,73,,9,12,21
033 Villnöss,74,,15,6,21
033 Villnöss,75,,7,11,18
033 Villnöss,76,,3,8,11
033 Villnöss,77,,7,6,13
033 Villnöss,78,,5,10,15
033 Villnöss,79,,7,11,18
033 Villnöss,80,,4,9,13
033 Villnöss,81,,1,6,7
033 Villnöss,82,,1,6,7
033 Villnöss,83,,2,5,7
033 Villnöss,84,,-,2,2
033 Villnöss,85,,2,3,5
033 Villnöss,86,,-,1,1
033 Villnöss,87,,1,3,4
033 Villnöss,88,,4,3,7
033 Villnöss,89,,1,2,3
033 Villnöss,91,,1,1,2
033 Villnöss,92,,1,1,2
033 Villnöss,93,,1,3,4
033 Villnöss,96,,1,1,2
033 Villnöss,97,,-,1,1
034 Gais,0,,21,19,40
034 Gais,1,,23,17,40
034 Gais,2,,20,21,41
034 Gais,3,,21,29,50
034 Gais,4,,23,22,45
034 Gais,5,,27,12,39
034 Gais,6,,10,21,31
034 Gais,7,,25,16,41
034 Gais,8,,22,24,46
034 Gais,9,,12,18,30
034 Gais,10,,21,28,49
034 Gais,11,,25,30,55
034 Gais,12,,13,20,33
034 Gais,13,,16,13,29
034 Gais,14,,17,16,33
034 Gais,15,,17,22,39
034 Gais,16,,16,18,34
034 Gais,17,,22,16,38
034 Gais,18,,22,16,38
034 Gais,19,,21,19,40
034 Gais,20,,18,18,36
034 Gais,21,,22,19,41
034 Gais,22,,24,23,47
034 Gais,23,,23,15,38
034 Gais,24,,19,19,38
034 Gais,25,,17,22,39
034 Gais,26,,23,20,43
034 Gais,27,,22,19,41
034 Gais,28,,27,26,53
034 Gais,29,,25,27,52
034 Gais,30,,28,36,64
034 Gais,31,,34,28,62
034 Gais,32,,26,25,51
034 Gais,33,,37,33,70
034 Gais,34,,23,21,44
034 Gais,35,,26,30,56
034 Gais,36,,33,19,52
034 Gais,37,,31,27,58
034 Gais,38,,27,28,55
034 Gais,39,,17,16,33
034 Gais,40,,29,19,48
034 Gais,41,,23,28,51
034 Gais,42,,17,11,28
034 Gais,43,,18,21,39
034 Gais,44,,24,19,43
034 Gais,45,,12,15,27
034 Gais,46,,26,21,47
034 Gais,47,,17,13,30
034 Gais,48,,15,13,28
034 Gais,49,,15,14,29
034 Gais,50,,15,17,32
034 Gais,51,,17,19,36
034 Gais,52,,21,21,42
034 Gais,53,,15,11,26
034 Gais,54,,25,14,39
034 Gais,55,,21,10,31
034 Gais,56,,18,19,37
034 Gais,57,,10,9,19
034 Gais,58,,12,13,25
034 Gais,59,,14,16,30
034 Gais,60,,14,15,29
034 Gais,61,,20,12,32
034 Gais,62,,18,13,31
034 Gais,63,,13,16,29
034 Gais,64,,14,14,28
034 Gais,65,,18,16,34
034 Gais,66,,10,13,23
034 Gais,67,,13,12,25
034 Gais,68,,7,6,13
034 Gais,69,,4,10,14
034 Gais,70,,8,10,18
034 Gais,71,,11,8,19
034 Gais,72,,4,13,17
034 Gais,73,,5,5,10
034 Gais,74,,10,8,18
034 Gais,75,,7,8,15
034 Gais,76,,12,8,20
034 Gais,77,,4,5,9
034 Gais,78,,5,8,13
034 Gais,79,,5,10,15
034 Gais,80,,3,4,7
034 Gais,81,,3,5,8
034 Gais,82,,2,2,4
034 Gais,83,,1,2,3
034 Gais,84,,2,4,6
034 Gais,85,,1,2,3
034 Gais,86,,-,2,2
034 Gais,87,,-,3,3
034 Gais,88,,1,3,4
034 Gais,89,,2,2,4
034 Gais,90,,-,2,2
034 Gais,91,,1,1,2
034 Gais,92,,1,-,1
034 Gais,93,,-,1,1
034 Gais,95,,-,1,1
035 Gargazon,0,,6,14,20
035 Gargazon,1,,4,7,11
035 Gargazon,2,,10,6,16
035 Gargazon,3,,11,7,18
035 Gargazon,4,,14,8,22
035 Gargazon,5,,5,13,18
035 Gargazon,6,,11,5,16
035 Gargazon,7,,12,5,17
035 Gargazon,8,,3,7,10
035 Gargazon,9,,11,8,19
035 Gargazon,10,,13,8,21
035 Gargazon,11,,17,10,27
035 Gargazon,12,,7,11,18
035 Gargazon,13,,8,7,15
035 Gargazon,14,,9,4,13
035 Gargazon,15,,6,10,16
035 Gargazon,16,,5,10,15
035 Gargazon,17,,11,3,14
035 Gargazon,18,,10,4,14
035 Gargazon,19,,4,7,11
035 Gargazon,20,,5,7,12
035 Gargazon,21,,11,5,16
035 Gargazon,22,,6,13,19
035 Gargazon,23,,5,8,13
035 Gargazon,24,,1,11,12
035 Gargazon,25,,4,6,10
035 Gargazon,26,,4,7,11
035 Gargazon,27,,9,7,16
035 Gargazon,28,,6,9,15
035 Gargazon,29,,11,8,19
035 Gargazon,30,,7,23,30
035 Gargazon,31,,12,11,23
035 Gargazon,32,,11,10,21
035 Gargazon,33,,14,12,26
035 Gargazon,34,,15,18,33
035 Gargazon,35,,17,16,33
035 Gargazon,36,,14,14,28
035 Gargazon,37,,14,9,23
035 Gargazon,38,,15,16,31
035 Gargazon,39,,15,16,31
035 Gargazon,40,,14,13,27
035 Gargazon,41,,12,11,23
035 Gargazon,42,,10,12,22
035 Gargazon,43,,16,12,28
035 Gargazon,44,,7,7,14
035 Gargazon,45,,18,11,29
035 Gargazon,46,,13,6,19
035 Gargazon,47,,7,2,9
035 Gargazon,48,,9,11,20
035 Gargazon,49,,15,9,24
035 Gargazon,50,,3,6,9
035 Gargazon,51,,10,9,19
035 Gargazon,52,,8,6,14
035 Gargazon,53,,7,11,18
035 Gargazon,54,,8,8,16
035 Gargazon,55,,5,9,14
035 Gargazon,56,,7,13,20
035 Gargazon,57,,7,5,12
035 Gargazon,58,,2,5,7
035 Gargazon,59,,4,7,11
035 Gargazon,60,,6,12,18
035 Gargazon,61,,10,9,19
035 Gargazon,62,,5,17,22
035 Gargazon,63,,9,6,15
035 Gargazon,64,,10,7,17
035 Gargazon,65,,8,13,21
035 Gargazon,66,,5,4,9
035 Gargazon,67,,12,2,14
035 Gargazon,68,,8,5,13
035 Gargazon,69,,3,10,13
035 Gargazon,70,,7,2,9
035 Gargazon,71,,4,7,11
035 Gargazon,72,,3,5,8
035 Gargazon,73,,2,11,13
035 Gargazon,74,,3,5,8
035 Gargazon,75,,3,5,8
035 Gargazon,76,,5,3,8
035 Gargazon,77,,2,6,8
035 Gargazon,78,,1,3,4
035 Gargazon,79,,5,6,11
035 Gargazon,80,,3,7,10
035 Gargazon,81,,5,5,10
035 Gargazon,82,,1,1,2
035 Gargazon,83,,2,2,4
035 Gargazon,84,,-,2,2
035 Gargazon,85,,-,1,1
035 Gargazon,86,,-,2,2
035 Gargazon,87,,2,3,5
035 Gargazon,88,,2,1,3
035 Gargazon,89,,2,4,6
035 Gargazon,90,,2,3,5
035 Gargazon,93,,-,1,1
035 Gargazon,96,,-,1,1
036 Glurns,0,,3,5,8
036 Glurns,1,,5,-,5
036 Glurns,2,,4,4,8
036 Glurns,3,,4,5,9
036 Glurns,4,,9,4,13
036 Glurns,5,,4,7,11
036 Glurns,6,,8,5,13
036 Glurns,7,,7,4,11
036 Glurns,8,,2,3,5
036 Glurns,9,,8,7,15
036 Glurns,10,,4,8,12
036 Glurns,11,,6,4,10
036 Glurns,12,,8,6,14
036 Glurns,13,,4,3,7
036 Glurns,14,,6,9,15
036 Glurns,15,,6,6,12
036 Glurns,16,,5,8,13
036 Glurns,17,,3,3,6
036 Glurns,18,,7,7,14
036 Glurns,19,,9,6,15
036 Glurns,20,,11,8,19
036 Glurns,21,,7,6,13
036 Glurns,22,,13,6,19
036 Glurns,23,,6,9,15
036 Glurns,24,,5,10,15
036 Glurns,25,,5,3,8
036 Glurns,26,,10,4,14
036 Glurns,27,,7,8,15
036 Glurns,28,,9,9,18
036 Glurns,29,,3,4,7
036 Glurns,30,,4,6,10
036 Glurns,31,,6,5,11
036 Glurns,32,,3,-,3
036 Glurns,33,,4,6,10
036 Glurns,34,,6,5,11
036 Glurns,35,,7,10,17
036 Glurns,36,,5,8,13
036 Glurns,37,,1,5,6
036 Glurns,38,,9,4,13
036 Glurns,39,,6,9,15
036 Glurns,40,,4,5,9
036 Glurns,41,,4,6,10
036 Glurns,42,,7,8,15
036 Glurns,43,,12,9,21
036 Glurns,44,,4,10,14
036 Glurns,45,,6,12,18
036 Glurns,46,,8,5,13
036 Glurns,47,,10,7,17
036 Glurns,48,,12,4,16
036 Glurns,49,,8,9,17
036 Glurns,50,,5,10,15
036 Glurns,51,,8,10,18
036 Glurns,52,,6,5,11
036 Glurns,53,,6,3,9
036 Glurns,54,,8,5,13
036 Glurns,55,,11,7,18
036 Glurns,56,,8,2,10
036 Glurns,57,,6,1,7
036 Glurns,58,,4,4,8
036 Glurns,59,,1,4,5
036 Glurns,60,,5,5,10
036 Glurns,61,,4,2,6
036 Glurns,62,,5,1,6
036 Glurns,63,,1,3,4
036 Glurns,64,,4,4,8
036 Glurns,65,,5,5,10
036 Glurns,66,,-,1,1
036 Glurns,67,,2,4,6
036 Glurns,68,,1,5,6
036 Glurns,69,,1,1,2
036 Glurns,70,,7,3,10
036 Glurns,71,,4,1,5
036 Glurns,72,,4,2,6
036 Glurns,73,,3,7,10
036 Glurns,74,,1,3,4
036 Glurns,75,,1,3,4
036 Glurns,76,,-,2,2
036 Glurns,77,,1,6,7
036 Glurns,78,,2,2,4
036 Glurns,79,,-,1,1
036 Glurns,80,,1,-,1
036 Glurns,81,,2,3,5
036 Glurns,82,,1,1,2
036 Glurns,83,,1,3,4
036 Glurns,84,,-,1,1
036 Glurns,85,,1,2,3
036 Glurns,87,,-,2,2
036 Glurns,88,,-,2,2
036 Glurns,89,,-,3,3
036 Glurns,90,,-,3,3
036 Glurns,91,,1,2,3
036 Glurns,93,,-,1,1
036 Glurns,95,,-,1,1
037 Latsch,0,,24,25,49
037 Latsch,1,,32,23,55
037 Latsch,2,,33,35,68
037 Latsch,3,,26,20,46
037 Latsch,4,,25,21,46
037 Latsch,5,,35,39,74
037 Latsch,6,,35,36,71
037 Latsch,7,,46,35,81
037 Latsch,8,,41,23,64
037 Latsch,9,,33,32,65
037 Latsch,10,,34,35,69
037 Latsch,11,,28,36,64
037 Latsch,12,,34,51,85
037 Latsch,13,,35,30,65
037 Latsch,14,,39,33,72
037 Latsch,15,,31,38,69
037 Latsch,16,,34,25,59
037 Latsch,17,,33,33,66
037 Latsch,18,,32,36,68
037 Latsch,19,,25,31,56
037 Latsch,20,,31,47,78
037 Latsch,21,,27,41,68
037 Latsch,22,,32,36,68
037 Latsch,23,,40,28,68
037 Latsch,24,,31,24,55
037 Latsch,25,,21,32,53
037 Latsch,26,,22,20,42
037 Latsch,27,,31,30,61
037 Latsch,28,,27,31,58
037 Latsch,29,,29,33,62
037 Latsch,30,,31,40,71
037 Latsch,31,,40,41,81
037 Latsch,32,,37,38,75
037 Latsch,33,,41,45,86
037 Latsch,34,,45,54,99
037 Latsch,35,,50,49,99
037 Latsch,36,,32,47,79
037 Latsch,37,,53,48,101
037 Latsch,38,,58,42,100
037 Latsch,39,,51,46,97
037 Latsch,40,,45,45,90
037 Latsch,41,,48,39,87
037 Latsch,42,,43,56,99
037 Latsch,43,,43,44,87
037 Latsch,44,,39,29,68
037 Latsch,45,,30,32,62
037 Latsch,46,,31,33,64
037 Latsch,47,,38,28,66
037 Latsch,48,,31,23,54
037 Latsch,49,,26,21,47
037 Latsch,50,,41,21,62
037 Latsch,51,,20,34,54
037 Latsch,52,,31,16,47
037 Latsch,53,,16,22,38
037 Latsch,54,,15,21,36
037 Latsch,55,,18,15,33
037 Latsch,56,,19,22,41
037 Latsch,57,,21,18,39
037 Latsch,58,,23,13,36
037 Latsch,59,,26,22,48
037 Latsch,60,,27,24,51
037 Latsch,61,,17,26,43
037 Latsch,62,,21,25,46
037 Latsch,63,,19,19,38
037 Latsch,64,,17,30,47
037 Latsch,65,,13,27,40
037 Latsch,66,,19,14,33
037 Latsch,67,,30,15,45
037 Latsch,68,,17,26,43
037 Latsch,69,,19,22,41
037 Latsch,70,,24,21,45
037 Latsch,71,,17,19,36
037 Latsch,72,,20,20,40
037 Latsch,73,,17,16,33
037 Latsch,74,,17,19,36
037 Latsch,75,,14,30,44
037 Latsch,76,,21,16,37
037 Latsch,77,,16,22,38
037 Latsch,78,,8,18,26
037 Latsch,79,,10,18,28
037 Latsch,80,,9,22,31
037 Latsch,81,,15,15,30
037 Latsch,82,,9,8,17
037 Latsch,83,,7,10,17
037 Latsch,84,,2,3,5
037 Latsch,85,,2,5,7
037 Latsch,86,,1,4,5
037 Latsch,87,,1,4,5
037 Latsch,88,,3,5,8
037 Latsch,89,,2,7,9
037 Latsch,90,,3,3,6
037 Latsch,91,,1,3,4
037 Latsch,92,,1,1,2
037 Latsch,93,,1,1,2
037 Latsch,94,,2,3,5
037 Latsch,96,,-,1,1
038 Algund,0,,21,28,49
038 Algund,1,,28,24,52
038 Algund,2,,21,25,46
038 Algund,3,,34,26,60
038 Algund,4,,20,20,40
038 Algund,5,,18,17,35
038 Algund,6,,14,19,33
038 Algund,7,,32,23,55
038 Algund,8,,24,13,37
038 Algund,9,,24,17,41
038 Algund,10,,30,19,49
038 Algund,11,,24,22,46
038 Algund,12,,28,19,47
038 Algund,13,,19,26,45
038 Algund,14,,19,23,42
038 Algund,15,,28,21,49
038 Algund,16,,21,31,52
038 Algund,17,,24,21,45
038 Algund,18,,22,19,41
038 Algund,19,,25,32,57
038 Algund,20,,26,20,46
038 Algund,21,,25,19,44
038 Algund,22,,25,25,50
038 Algund,23,,18,25,43
038 Algund,24,,17,31,48
038 Algund,25,,20,37,57
038 Algund,26,,22,23,45
038 Algund,27,,28,21,49
038 Algund,28,,25,24,49
038 Algund,29,,35,16,51
038 Algund,30,,33,29,62
038 Algund,31,,24,32,56
038 Algund,32,,42,25,67
038 Algund,33,,37,36,73
038 Algund,34,,38,28,66
038 Algund,35,,33,38,71
038 Algund,36,,32,35,67
038 Algund,37,,34,40,74
038 Algund,38,,43,27,70
038 Algund,39,,29,37,66
038 Algund,40,,32,41,73
038 Algund,41,,24,45,69
038 Algund,42,,29,38,67
038 Algund,43,,37,30,67
038 Algund,44,,39,30,69
038 Algund,45,,28,32,60
038 Algund,46,,31,27,58
038 Algund,47,,23,26,49
038 Algund,48,,30,21,51
038 Algund,49,,18,32,50
038 Algund,50,,24,25,49
038 Algund,51,,26,29,55
038 Algund,52,,22,24,46
038 Algund,53,,26,25,51
038 Algund,54,,28,23,51
038 Algund,55,,22,20,42
038 Algund,56,,35,27,62
038 Algund,57,,24,25,49
038 Algund,58,,26,25,51
038 Algund,59,,21,21,42
038 Algund,60,,16,36,52
038 Algund,61,,21,22,43
038 Algund,62,,14,26,40
038 Algund,63,,24,30,54
038 Algund,64,,22,23,45
038 Algund,65,,16,13,29
038 Algund,66,,16,27,43
038 Algund,67,,14,19,33
038 Algund,68,,22,23,45
038 Algund,69,,23,23,46
038 Algund,70,,16,22,38
038 Algund,71,,13,23,36
038 Algund,72,,14,22,36
038 Algund,73,,14,22,36
038 Algund,74,,12,21,33
038 Algund,75,,12,18,30
038 Algund,76,,13,20,33
038 Algund,77,,10,15,25
038 Algund,78,,7,18,25
038 Algund,79,,5,12,17
038 Algund,80,,11,17,28
038 Algund,81,,11,11,22
038 Algund,82,,10,11,21
038 Algund,83,,5,12,17
038 Algund,84,,4,6,10
038 Algund,85,,1,6,7
038 Algund,86,,2,4,6
038 Algund,87,,2,5,7
038 Algund,88,,3,6,9
038 Algund,89,,2,3,5
038 Algund,90,,2,9,11
038 Algund,91,,1,7,8
038 Algund,92,,4,4,8
038 Algund,93,,3,-,3
038 Algund,94,,2,3,5
038 Algund,95,,-,2,2
038 Algund,96,,-,1,1
038 Algund,97,,-,1,1
039 Lajen,0,,22,7,29
039 Lajen,1,,22,22,44
039 Lajen,2,,23,16,39
039 Lajen,3,,17,17,34
039 Lajen,4,,19,15,34
039 Lajen,5,,14,22,36
039 Lajen,6,,16,11,27
039 Lajen,7,,8,11,19
039 Lajen,8,,11,15,26
039 Lajen,9,,13,14,27
039 Lajen,10,,14,10,24
039 Lajen,11,,19,18,37
039 Lajen,12,,8,8,16
039 Lajen,13,,17,15,32
039 Lajen,14,,12,10,22
039 Lajen,15,,13,6,19
039 Lajen,16,,18,13,31
039 Lajen,17,,19,11,30
039 Lajen,18,,10,14,24
039 Lajen,19,,9,18,27
039 Lajen,20,,18,15,33
039 Lajen,21,,10,23,33
039 Lajen,22,,20,20,40
039 Lajen,23,,20,15,35
039 Lajen,24,,23,19,42
039 Lajen,25,,23,11,34
039 Lajen,26,,18,17,35
039 Lajen,27,,19,25,44
039 Lajen,28,,31,19,50
039 Lajen,29,,20,20,40
039 Lajen,30,,20,27,47
039 Lajen,31,,18,27,45
039 Lajen,32,,23,25,48
039 Lajen,33,,32,19,51
039 Lajen,34,,22,21,43
039 Lajen,35,,25,21,46
039 Lajen,36,,22,17,39
039 Lajen,37,,30,18,48
039 Lajen,38,,20,19,39
039 Lajen,39,,15,11,26
039 Lajen,40,,27,15,42
039 Lajen,41,,12,20,32
039 Lajen,42,,11,9,20
039 Lajen,43,,16,25,41
039 Lajen,44,,21,10,31
039 Lajen,45,,13,11,24
039 Lajen,46,,12,14,26
039 Lajen,47,,13,12,25
039 Lajen,48,,5,13,18
039 Lajen,49,,9,8,17
039 Lajen,50,,8,11,19
039 Lajen,51,,10,13,23
039 Lajen,52,,14,14,28
039 Lajen,53,,6,13,19
039 Lajen,54,,9,16,25
039 Lajen,55,,15,7,22
039 Lajen,56,,13,13,26
039 Lajen,57,,13,9,22
039 Lajen,58,,13,8,21
039 Lajen,59,,11,12,23
039 Lajen,60,,19,13,32
039 Lajen,61,,18,17,35
039 Lajen,62,,15,10,25
039 Lajen,63,,15,10,25
039 Lajen,64,,5,16,21
039 Lajen,65,,7,7,14
039 Lajen,66,,7,9,16
039 Lajen,67,,7,9,16
039 Lajen,68,,8,7,15
039 Lajen,69,,5,12,17
039 Lajen,70,,10,4,14
039 Lajen,71,,1,8,9
039 Lajen,72,,8,4,12
039 Lajen,73,,5,5,10
039 Lajen,74,,8,8,16
039 Lajen,75,,7,11,18
039 Lajen,76,,10,6,16
039 Lajen,77,,4,9,13
039 Lajen,78,,4,8,12
039 Lajen,79,,2,9,11
039 Lajen,80,,4,5,9
039 Lajen,81,,4,7,11
039 Lajen,82,,2,2,4
039 Lajen,83,,1,3,4
039 Lajen,84,,-,2,2
039 Lajen,85,,1,2,3
039 Lajen,86,,-,2,2
039 Lajen,87,,1,3,4
039 Lajen,88,,-,2,2
039 Lajen,89,,2,2,4
039 Lajen,90,,2,2,4
039 Lajen,91,,-,1,1
039 Lajen,93,,1,2,3
039 Lajen,94,,-,2,2
039 Lajen,95,,-,2,2
039 Lajen,96,,1,1,2
040 Leifers,0,,86,87,173
040 Leifers,1,,81,80,161
040 Leifers,2,,92,88,180
040 Leifers,3,,89,91,180
040 Leifers,4,,83,101,184
040 Leifers,5,,105,82,187
040 Leifers,6,,98,79,177
040 Leifers,7,,90,88,178
040 Leifers,8,,86,92,178
040 Leifers,9,,81,68,149
040 Leifers,10,,82,75,157
040 Leifers,11,,86,80,166
040 Leifers,12,,92,80,172
040 Leifers,13,,65,79,144
040 Leifers,14,,68,82,150
040 Leifers,15,,64,67,131
040 Leifers,16,,80,82,162
040 Leifers,17,,77,63,140
040 Leifers,18,,72,68,140
040 Leifers,19,,77,89,166
040 Leifers,20,,65,66,131
040 Leifers,21,,70,65,135
040 Leifers,22,,64,73,137
040 Leifers,23,,73,81,154
040 Leifers,24,,87,85,172
040 Leifers,25,,104,88,192
040 Leifers,26,,124,98,222
040 Leifers,27,,117,113,230
040 Leifers,28,,157,123,280
040 Leifers,29,,137,122,259
040 Leifers,30,,126,128,254
040 Leifers,31,,126,142,268
040 Leifers,32,,128,140,268
040 Leifers,33,,149,132,281
040 Leifers,34,,145,155,300
040 Leifers,35,,143,132,275
040 Leifers,36,,146,121,267
040 Leifers,37,,158,130,288
040 Leifers,38,,164,158,322
040 Leifers,39,,152,142,294
040 Leifers,40,,141,124,265
040 Leifers,41,,125,133,258
040 Leifers,42,,128,118,246
040 Leifers,43,,117,104,221
040 Leifers,44,,87,106,193
040 Leifers,45,,105,111,216
040 Leifers,46,,139,134,273
040 Leifers,47,,111,121,232
040 Leifers,48,,92,107,199
040 Leifers,49,,109,117,226
040 Leifers,50,,101,92,193
040 Leifers,51,,105,92,197
040 Leifers,52,,97,89,186
040 Leifers,53,,96,95,191
040 Leifers,54,,115,103,218
040 Leifers,55,,103,100,203
040 Leifers,56,,119,151,270
040 Leifers,57,,83,83,166
040 Leifers,58,,96,91,187
040 Leifers,59,,95,93,188
040 Leifers,60,,97,95,192
040 Leifers,61,,90,83,173
040 Leifers,62,,94,93,187
040 Leifers,63,,96,91,187
040 Leifers,64,,93,77,170
040 Leifers,65,,59,81,140
040 Leifers,66,,60,66,126
040 Leifers,67,,57,67,124
040 Leifers,68,,61,64,125
040 Leifers,69,,54,63,117
040 Leifers,70,,65,78,143
040 Leifers,71,,56,63,119
040 Leifers,72,,56,65,121
040 Leifers,73,,44,57,101
040 Leifers,74,,44,41,85
040 Leifers,75,,32,57,89
040 Leifers,76,,34,50,84
040 Leifers,77,,27,46,73
040 Leifers,78,,25,48,73
040 Leifers,79,,26,38,64
040 Leifers,80,,23,43,66
040 Leifers,81,,21,27,48
040 Leifers,82,,14,24,38
040 Leifers,83,,11,35,46
040 Leifers,84,,3,17,20
040 Leifers,85,,3,13,16
040 Leifers,86,,6,14,20
040 Leifers,87,,2,16,18
040 Leifers,88,,2,20,22
040 Leifers,89,,10,12,22
040 Leifers,90,,3,18,21
040 Leifers,91,,4,9,13
040 Leifers,92,,1,10,11
040 Leifers,93,,5,4,9
040 Leifers,94,,2,1,3
040 Leifers,95,,2,3,5
040 Leifers,96,,-,2,2
040 Leifers,97,,-,3,3
040 Leifers,98,,-,1,1
040 Leifers,99,,-,1,1
041 Lana,0,,58,45,103
041 Lana,1,,64,55,119
041 Lana,2,,67,70,137
041 Lana,3,,70,50,120
041 Lana,4,,58,60,118
041 Lana,5,,58,62,120
041 Lana,6,,70,74,144
041 Lana,7,,56,58,114
041 Lana,8,,62,71,133
041 Lana,9,,56,57,113
041 Lana,10,,60,56,116
041 Lana,11,,53,60,113
041 Lana,12,,52,60,112
041 Lana,13,,46,75,121
041 Lana,14,,60,47,107
041 Lana,15,,71,46,117
041 Lana,16,,56,50,106
041 Lana,17,,62,58,120
041 Lana,18,,59,48,107
041 Lana,19,,67,54,121
041 Lana,20,,65,50,115
041 Lana,21,,45,65,110
041 Lana,22,,49,48,97
041 Lana,23,,56,72,128
041 Lana,24,,69,49,118
041 Lana,25,,67,50,117
041 Lana,26,,61,70,131
041 Lana,27,,58,59,117
041 Lana,28,,72,63,135
041 Lana,29,,66,91,157
041 Lana,30,,95,90,185
041 Lana,31,,81,85,166
041 Lana,32,,82,104,186
041 Lana,33,,121,81,202
041 Lana,34,,86,84,170
041 Lana,35,,91,91,182
041 Lana,36,,90,101,191
041 Lana,37,,90,91,181
041 Lana,38,,92,94,186
041 Lana,39,,103,82,185
041 Lana,40,,85,75,160
041 Lana,41,,80,84,164
041 Lana,42,,78,78,156
041 Lana,43,,78,74,152
041 Lana,44,,76,83,159
041 Lana,45,,76,71,147
041 Lana,46,,57,58,115
041 Lana,47,,62,70,132
041 Lana,48,,60,64,124
041 Lana,49,,58,64,122
041 Lana,50,,50,57,107
041 Lana,51,,55,62,117
041 Lana,52,,53,54,107
041 Lana,53,,54,52,106
041 Lana,54,,54,66,120
041 Lana,55,,54,46,100
041 Lana,56,,63,59,122
041 Lana,57,,44,50,94
041 Lana,58,,48,57,105
041 Lana,59,,61,56,117
041 Lana,60,,57,65,122
041 Lana,61,,52,46,98
041 Lana,62,,39,46,85
041 Lana,63,,55,52,107
041 Lana,64,,44,55,99
041 Lana,65,,35,40,75
041 Lana,66,,43,49,92
041 Lana,67,,36,39,75
041 Lana,68,,39,47,86
041 Lana,69,,33,44,77
041 Lana,70,,30,35,65
041 Lana,71,,27,46,73
041 Lana,72,,28,38,66
041 Lana,73,,23,36,59
041 Lana,74,,35,28,63
041 Lana,75,,29,36,65
041 Lana,76,,21,40,61
041 Lana,77,,27,41,68
041 Lana,78,,11,25,36
041 Lana,79,,20,27,47
041 Lana,80,,21,35,56
041 Lana,81,,12,33,45
041 Lana,82,,15,31,46
041 Lana,83,,10,24,34
041 Lana,84,,3,12,15
041 Lana,85,,2,17,19
041 Lana,86,,3,6,9
041 Lana,87,,11,18,29
041 Lana,88,,7,15,22
041 Lana,89,,4,15,19
041 Lana,90,,4,12,16
041 Lana,91,,1,9,10
041 Lana,92,,1,12,13
041 Lana,93,,-,7,7
041 Lana,94,,-,4,4
041 Lana,95,,2,7,9
041 Lana,96,,-,3,3
041 Lana,97,,-,1,1
041 Lana,98,,-,3,3
041 Lana,99,,1,1,2
042 Laas,0,,25,22,47
042 Laas,1,,13,18,31
042 Laas,2,,24,26,50
042 Laas,3,,20,11,31
042 Laas,4,,25,31,56
042 Laas,5,,26,26,52
042 Laas,6,,30,33,63
042 Laas,7,,30,24,54
042 Laas,8,,25,25,50
042 Laas,9,,22,20,42
042 Laas,10,,15,27,42
042 Laas,11,,22,21,43
042 Laas,12,,19,26,45
042 Laas,13,,21,24,45
042 Laas,14,,24,19,43
042 Laas,15,,29,22,51
042 Laas,16,,32,20,52
042 Laas,17,,30,28,58
042 Laas,18,,28,25,53
042 Laas,19,,22,39,61
042 Laas,20,,33,25,58
042 Laas,21,,26,27,53
042 Laas,22,,18,26,44
042 Laas,23,,28,32,60
042 Laas,24,,31,24,55
042 Laas,25,,27,17,44
042 Laas,26,,24,30,54
042 Laas,27,,30,25,55
042 Laas,28,,37,25,62
042 Laas,29,,32,32,64
042 Laas,30,,28,24,52
042 Laas,31,,28,26,54
042 Laas,32,,35,23,58
042 Laas,33,,33,37,70
042 Laas,34,,38,22,60
042 Laas,35,,32,24,56
042 Laas,36,,32,24,56
042 Laas,37,,40,33,73
042 Laas,38,,25,30,55
042 Laas,39,,26,29,55
042 Laas,40,,33,27,60
042 Laas,41,,27,28,55
042 Laas,42,,37,24,61
042 Laas,43,,34,27,61
042 Laas,44,,28,25,53
042 Laas,45,,20,28,48
042 Laas,46,,23,18,41
042 Laas,47,,16,14,30
042 Laas,48,,16,24,40
042 Laas,49,,24,12,36
042 Laas,50,,29,24,53
042 Laas,51,,15,17,32
042 Laas,52,,21,25,46
042 Laas,53,,19,19,38
042 Laas,54,,16,20,36
042 Laas,55,,28,12,40
042 Laas,56,,15,14,29
042 Laas,57,,15,12,27
042 Laas,58,,12,15,27
042 Laas,59,,13,15,28
042 Laas,60,,17,19,36
042 Laas,61,,16,22,38
042 Laas,62,,20,24,44
042 Laas,63,,14,25,39
042 Laas,64,,19,13,32
042 Laas,65,,15,14,29
042 Laas,66,,22,11,33
042 Laas,67,,18,22,40
042 Laas,68,,13,20,33
042 Laas,69,,19,12,31
042 Laas,70,,17,17,34
042 Laas,71,,20,22,42
042 Laas,72,,16,19,35
042 Laas,73,,16,11,27
042 Laas,74,,13,12,25
042 Laas,75,,14,18,32
042 Laas,76,,15,12,27
042 Laas,77,,9,11,20
042 Laas,78,,8,20,28
042 Laas,79,,13,10,23
042 Laas,80,,7,19,26
042 Laas,81,,4,6,10
042 Laas,82,,6,10,16
042 Laas,83,,4,8,12
042 Laas,84,,5,3,8
042 Laas,85,,3,2,5
042 Laas,86,,1,4,5
042 Laas,87,,-,2,2
042 Laas,88,,1,7,8
042 Laas,89,,1,6,7
042 Laas,90,,2,5,7
042 Laas,91,,-,4,4
042 Laas,92,,2,2,4
042 Laas,93,,-,2,2
042 Laas,95,,-,1,1
042 Laas,97,,-,1,1
043 Laurein,0,,2,3,5
043 Laurein,1,,7,-,7
043 Laurein,2,,3,7,10
043 Laurein,3,,3,2,5
043 Laurein,4,,2,3,5
043 Laurein,5,,3,6,9
043 Laurein,6,,1,2,3
043 Laurein,7,,2,2,4
043 Laurein,8,,3,4,7
043 Laurein,9,,1,5,6
043 Laurein,10,,1,1,2
043 Laurein,11,,1,1,2
043 Laurein,12,,4,-,4
043 Laurein,13,,3,2,5
043 Laurein,14,,1,-,1
043 Laurein,15,,2,2,4
043 Laurein,16,,4,2,6
043 Laurein,17,,2,2,4
043 Laurein,18,,1,2,3
043 Laurein,20,,2,2,4
043 Laurein,21,,3,1,4
043 Laurein,22,,2,-,2
043 Laurein,23,,2,-,2
043 Laurein,24,,2,5,7
043 Laurein,25,,1,2,3
043 Laurein,26,,5,1,6
043 Laurein,27,,-,6,6
043 Laurein,28,,1,3,4
043 Laurein,29,,5,1,6
043 Laurein,30,,1,2,3
043 Laurein,31,,5,6,11
043 Laurein,32,,4,2,6
043 Laurein,33,,5,4,9
043 Laurein,34,,-,3,3
043 Laurein,35,,4,7,11
043 Laurein,36,,6,3,9
043 Laurein,37,,5,1,6
043 Laurein,38,,4,2,6
043 Laurein,39,,-,2,2
043 Laurein,40,,1,2,3
043 Laurein,41,,5,5,10
043 Laurein,42,,1,1,2
043 Laurein,43,,3,4,7
043 Laurein,44,,3,2,5
043 Laurein,45,,7,-,7
043 Laurein,47,,2,-,2
043 Laurein,48,,4,1,5
043 Laurein,49,,2,1,3
043 Laurein,50,,2,2,4
043 Laurein,52,,2,1,3
043 Laurein,53,,3,2,5
043 Laurein,54,,2,-,2
043 Laurein,55,,2,4,6
043 Laurein,56,,-,1,1
043 Laurein,57,,-,1,1
043 Laurein,58,,-,1,1
043 Laurein,59,,1,-,1
043 Laurein,60,,2,-,2
043 Laurein,62,,4,2,6
043 Laurein,63,,1,3,4
043 Laurein,64,,1,1,2
043 Laurein,65,,2,1,3
043 Laurein,66,,1,2,3
043 Laurein,67,,1,3,4
043 Laurein,68,,1,5,6
043 Laurein,69,,1,3,4
043 Laurein,70,,3,2,5
043 Laurein,71,,1,3,4
043 Laurein,72,,1,5,6
043 Laurein,73,,3,-,3
043 Laurein,74,,5,1,6
043 Laurein,75,,5,1,6
043 Laurein,76,,2,2,4
043 Laurein,77,,2,2,4
043 Laurein,78,,-,1,1
043 Laurein,79,,1,-,1
043 Laurein,80,,-,3,3
043 Laurein,81,,1,-,1
043 Laurein,82,,2,2,4
043 Laurein,83,,-,1,1
043 Laurein,86,,1,-,1
043 Laurein,88,,-,2,2
043 Laurein,89,,1,1,2
043 Laurein,91,,-,1,1
043 Laurein,92,,1,-,1
044 Lüsen,0,,10,9,19
044 Lüsen,1,,11,11,22
044 Lüsen,2,,14,9,23
044 Lüsen,3,,5,10,15
044 Lüsen,4,,10,10,20
044 Lüsen,5,,16,6,22
044 Lüsen,6,,8,13,21
044 Lüsen,7,,10,12,22
044 Lüsen,8,,14,14,28
044 Lüsen,9,,9,8,17
044 Lüsen,10,,12,10,22
044 Lüsen,11,,9,10,19
044 Lüsen,12,,7,12,19
044 Lüsen,13,,16,9,25
044 Lüsen,14,,10,9,19
044 Lüsen,15,,7,8,15
044 Lüsen,16,,12,13,25
044 Lüsen,17,,3,2,5
044 Lüsen,18,,9,18,27
044 Lüsen,19,,6,11,17
044 Lüsen,20,,15,10,25
044 Lüsen,21,,11,13,24
044 Lüsen,22,,15,11,26
044 Lüsen,23,,8,8,16
044 Lüsen,24,,15,18,33
044 Lüsen,25,,7,6,13
044 Lüsen,26,,15,10,25
044 Lüsen,27,,15,11,26
044 Lüsen,28,,16,14,30
044 Lüsen,29,,10,6,16
044 Lüsen,30,,8,8,16
044 Lüsen,31,,15,9,24
044 Lüsen,32,,17,16,33
044 Lüsen,33,,8,9,17
044 Lüsen,34,,11,16,27
044 Lüsen,35,,12,21,33
044 Lüsen,36,,12,14,26
044 Lüsen,37,,18,13,31
044 Lüsen,38,,13,9,22
044 Lüsen,39,,15,9,24
044 Lüsen,40,,8,12,20
044 Lüsen,41,,12,10,22
044 Lüsen,42,,9,12,21
044 Lüsen,43,,7,5,12
044 Lüsen,44,,11,12,23
044 Lüsen,45,,9,10,19
044 Lüsen,46,,9,9,18
044 Lüsen,47,,7,6,13
044 Lüsen,48,,15,4,19
044 Lüsen,49,,6,11,17
044 Lüsen,50,,10,4,14
044 Lüsen,51,,5,7,12
044 Lüsen,52,,5,7,12
044 Lüsen,53,,8,12,20
044 Lüsen,54,,7,2,9
044 Lüsen,55,,7,4,11
044 Lüsen,56,,10,6,16
044 Lüsen,57,,4,9,13
044 Lüsen,58,,4,6,10
044 Lüsen,59,,7,7,14
044 Lüsen,60,,2,6,8
044 Lüsen,61,,7,4,11
044 Lüsen,62,,5,9,14
044 Lüsen,63,,9,7,16
044 Lüsen,64,,7,4,11
044 Lüsen,65,,7,5,12
044 Lüsen,66,,6,9,15
044 Lüsen,67,,7,5,12
044 Lüsen,68,,4,5,9
044 Lüsen,69,,7,3,10
044 Lüsen,70,,2,11,13
044 Lüsen,71,,8,5,13
044 Lüsen,72,,4,5,9
044 Lüsen,73,,5,8,13
044 Lüsen,74,,8,7,15
044 Lüsen,75,,5,4,9
044 Lüsen,76,,2,7,9
044 Lüsen,77,,4,5,9
044 Lüsen,78,,4,3,7
044 Lüsen,79,,2,4,6
044 Lüsen,80,,1,2,3
044 Lüsen,81,,2,7,9
044 Lüsen,82,,2,5,7
044 Lüsen,83,,3,2,5
044 Lüsen,84,,-,3,3
044 Lüsen,85,,1,2,3
044 Lüsen,86,,-,2,2
044 Lüsen,87,,-,3,3
044 Lüsen,88,,2,1,3
044 Lüsen,89,,1,3,4
044 Lüsen,90,,1,1,2
044 Lüsen,93,,1,-,1
045 Margreid a.d. Weinstr.,0,,9,9,18
045 Margreid a.d. Weinstr.,1,,13,8,21
045 Margreid a.d. Weinstr.,2,,10,7,17
045 Margreid a.d. Weinstr.,3,,9,8,17
045 Margreid a.d. Weinstr.,4,,4,12,16
045 Margreid a.d. Weinstr.,5,,9,13,22
045 Margreid a.d. Weinstr.,6,,4,4,8
045 Margreid a.d. Weinstr.,7,,1,7,8
045 Margreid a.d. Weinstr.,8,,5,7,12
045 Margreid a.d. Weinstr.,9,,3,12,15
045 Margreid a.d. Weinstr.,10,,5,2,7
045 Margreid a.d. Weinstr.,11,,7,6,13
045 Margreid a.d. Weinstr.,12,,6,9,15
045 Margreid a.d. Weinstr.,13,,7,6,13
045 Margreid a.d. Weinstr.,14,,7,6,13
045 Margreid a.d. Weinstr.,15,,9,5,14
045 Margreid a.d. Weinstr.,16,,6,11,17
045 Margreid a.d. Weinstr.,17,,11,-,11
045 Margreid a.d. Weinstr.,18,,4,13,17
045 Margreid a.d. Weinstr.,19,,6,8,14
045 Margreid a.d. Weinstr.,20,,8,9,17
045 Margreid a.d. Weinstr.,21,,14,2,16
045 Margreid a.d. Weinstr.,22,,2,2,4
045 Margreid a.d. Weinstr.,23,,10,5,15
045 Margreid a.d. Weinstr.,24,,9,5,14
045 Margreid a.d. Weinstr.,25,,8,9,17
045 Margreid a.d. Weinstr.,26,,11,16,27
045 Margreid a.d. Weinstr.,27,,5,6,11
045 Margreid a.d. Weinstr.,28,,3,8,11
045 Margreid a.d. Weinstr.,29,,10,11,21
045 Margreid a.d. Weinstr.,30,,8,3,11
045 Margreid a.d. Weinstr.,31,,12,13,25
045 Margreid a.d. Weinstr.,32,,12,9,21
045 Margreid a.d. Weinstr.,33,,9,10,19
045 Margreid a.d. Weinstr.,34,,21,15,36
045 Margreid a.d. Weinstr.,35,,12,17,29
045 Margreid a.d. Weinstr.,36,,22,15,37
045 Margreid a.d. Weinstr.,37,,10,6,16
045 Margreid a.d. Weinstr.,38,,8,6,14
045 Margreid a.d. Weinstr.,39,,14,14,28
045 Margreid a.d. Weinstr.,40,,8,12,20
045 Margreid a.d. Weinstr.,41,,15,12,27
045 Margreid a.d. Weinstr.,42,,15,9,24
045 Margreid a.d. Weinstr.,43,,9,12,21
045 Margreid a.d. Weinstr.,44,,6,6,12
045 Margreid a.d. Weinstr.,45,,8,5,13
045 Margreid a.d. Weinstr.,46,,15,5,20
045 Margreid a.d. Weinstr.,47,,7,6,13
045 Margreid a.d. Weinstr.,48,,4,5,9
045 Margreid a.d. Weinstr.,49,,9,7,16
045 Margreid a.d. Weinstr.,50,,6,8,14
045 Margreid a.d. Weinstr.,51,,3,8,11
045 Margreid a.d. Weinstr.,52,,7,6,13
045 Margreid a.d. Weinstr.,53,,8,4,12
045 Margreid a.d. Weinstr.,54,,7,8,15
045 Margreid a.d. Weinstr.,55,,6,7,13
045 Margreid a.d. Weinstr.,56,,3,4,7
045 Margreid a.d. Weinstr.,57,,6,7,13
045 Margreid a.d. Weinstr.,58,,3,6,9
045 Margreid a.d. Weinstr.,59,,6,4,10
045 Margreid a.d. Weinstr.,60,,11,4,15
045 Margreid a.d. Weinstr.,61,,7,7,14
045 Margreid a.d. Weinstr.,62,,5,3,8
045 Margreid a.d. Weinstr.,63,,3,6,9
045 Margreid a.d. Weinstr.,64,,4,8,12
045 Margreid a.d. Weinstr.,65,,4,3,7
045 Margreid a.d. Weinstr.,66,,7,4,11
045 Margreid a.d. Weinstr.,67,,2,7,9
045 Margreid a.d. Weinstr.,68,,5,3,8
045 Margreid a.d. Weinstr.,69,,5,4,9
045 Margreid a.d. Weinstr.,70,,4,7,11
045 Margreid a.d. Weinstr.,71,,5,6,11
045 Margreid a.d. Weinstr.,72,,7,3,10
045 Margreid a.d. Weinstr.,73,,1,4,5
045 Margreid a.d. Weinstr.,74,,6,3,9
045 Margreid a.d. Weinstr.,75,,2,5,7
045 Margreid a.d. Weinstr.,76,,3,8,11
045 Margreid a.d. Weinstr.,77,,3,2,5
045 Margreid a.d. Weinstr.,78,,1,4,5
045 Margreid a.d. Weinstr.,79,,2,4,6
045 Margreid a.d. Weinstr.,80,,1,3,4
045 Margreid a.d. Weinstr.,81,,-,4,4
045 Margreid a.d. Weinstr.,82,,1,1,2
045 Margreid a.d. Weinstr.,83,,2,5,7
045 Margreid a.d. Weinstr.,84,,1,1,2
045 Margreid a.d. Weinstr.,85,,-,1,1
045 Margreid a.d. Weinstr.,86,,2,2,4
045 Margreid a.d. Weinstr.,88,,-,1,1
045 Margreid a.d. Weinstr.,89,,2,-,2
045 Margreid a.d. Weinstr.,90,,-,2,2
045 Margreid a.d. Weinstr.,91,,-,3,3
045 Margreid a.d. Weinstr.,92,,-,1,1
045 Margreid a.d. Weinstr.,95,,-,1,1
045 Margreid a.d. Weinstr.,96,,-,1,1
046 Mals,0,,19,27,46
046 Mals,1,,29,29,58
046 Mals,2,,31,35,66
046 Mals,3,,37,29,66
046 Mals,4,,32,29,61
046 Mals,5,,34,32,66
046 Mals,6,,31,24,55
046 Mals,7,,32,41,73
046 Mals,8,,38,31,69
046 Mals,9,,35,31,66
046 Mals,10,,31,30,61
046 Mals,11,,33,33,66
046 Mals,12,,37,26,63
046 Mals,13,,41,34,75
046 Mals,14,,29,25,54
046 Mals,15,,31,29,60
046 Mals,16,,28,36,64
046 Mals,17,,36,35,71
046 Mals,18,,35,36,71
046 Mals,19,,30,31,61
046 Mals,20,,36,33,69
046 Mals,21,,37,39,76
046 Mals,22,,33,31,64
046 Mals,23,,30,31,61
046 Mals,24,,44,32,76
046 Mals,25,,32,23,55
046 Mals,26,,36,25,61
046 Mals,27,,40,34,74
046 Mals,28,,43,27,70
046 Mals,29,,29,32,61
046 Mals,30,,32,42,74
046 Mals,31,,38,50,88
046 Mals,32,,48,45,93
046 Mals,33,,50,39,89
046 Mals,34,,52,42,94
046 Mals,35,,44,26,70
046 Mals,36,,54,49,103
046 Mals,37,,48,39,87
046 Mals,38,,52,43,95
046 Mals,39,,51,52,103
046 Mals,40,,38,28,66
046 Mals,41,,49,37,86
046 Mals,42,,30,40,70
046 Mals,43,,32,33,65
046 Mals,44,,35,24,59
046 Mals,45,,38,33,71
046 Mals,46,,34,26,60
046 Mals,47,,30,24,54
046 Mals,48,,22,20,42
046 Mals,49,,34,31,65
046 Mals,50,,28,20,48
046 Mals,51,,30,22,52
046 Mals,52,,36,21,57
046 Mals,53,,19,28,47
046 Mals,54,,28,17,45
046 Mals,55,,22,20,42
046 Mals,56,,23,28,51
046 Mals,57,,11,19,30
046 Mals,58,,30,13,43
046 Mals,59,,24,18,42
046 Mals,60,,25,23,48
046 Mals,61,,20,18,38
046 Mals,62,,22,28,50
046 Mals,63,,24,26,50
046 Mals,64,,21,21,42
046 Mals,65,,13,29,42
046 Mals,66,,20,18,38
046 Mals,67,,16,18,34
046 Mals,68,,17,20,37
046 Mals,69,,18,21,39
046 Mals,70,,18,13,31
046 Mals,71,,11,18,29
046 Mals,72,,23,18,41
046 Mals,73,,24,18,42
046 Mals,74,,24,15,39
046 Mals,75,,15,15,30
046 Mals,76,,10,19,29
046 Mals,77,,11,18,29
046 Mals,78,,10,17,27
046 Mals,79,,5,14,19
046 Mals,80,,13,16,29
046 Mals,81,,9,13,22
046 Mals,82,,6,18,24
046 Mals,83,,5,18,23
046 Mals,84,,1,7,8
046 Mals,85,,3,2,5
046 Mals,86,,1,6,7
046 Mals,87,,3,6,9
046 Mals,88,,2,6,8
046 Mals,89,,9,13,22
046 Mals,90,,2,5,7
046 Mals,91,,2,3,5
046 Mals,92,,1,2,3
046 Mals,93,,2,1,3
046 Mals,94,,-,2,2
046 Mals,98,,-,1,1
047 Enneberg,0,,19,13,32
047 Enneberg,1,,24,17,41
047 Enneberg,2,,16,20,36
047 Enneberg,3,,25,15,40
047 Enneberg,4,,19,10,29
047 Enneberg,5,,23,14,37
047 Enneberg,6,,17,13,30
047 Enneberg,7,,20,8,28
047 Enneberg,8,,20,14,34
047 Enneberg,9,,20,17,37
047 Enneberg,10,,14,14,28
047 Enneberg,11,,16,23,39
047 Enneberg,12,,14,17,31
047 Enneberg,13,,20,17,37
047 Enneberg,14,,22,16,38
047 Enneberg,15,,17,13,30
047 Enneberg,16,,18,10,28
047 Enneberg,17,,23,15,38
047 Enneberg,18,,19,19,38
047 Enneberg,19,,14,17,31
047 Enneberg,20,,24,20,44
047 Enneberg,21,,22,20,42
047 Enneberg,22,,24,18,42
047 Enneberg,23,,11,18,29
047 Enneberg,24,,13,25,38
047 Enneberg,25,,21,22,43
047 Enneberg,26,,12,17,29
047 Enneberg,27,,13,29,42
047 Enneberg,28,,25,32,57
047 Enneberg,29,,22,22,44
047 Enneberg,30,,23,28,51
047 Enneberg,31,,29,34,63
047 Enneberg,32,,26,21,47
047 Enneberg,33,,25,19,44
047 Enneberg,34,,22,18,40
047 Enneberg,35,,25,20,45
047 Enneberg,36,,21,18,39
047 Enneberg,37,,28,21,49
047 Enneberg,38,,23,22,45
047 Enneberg,39,,23,18,41
047 Enneberg,40,,15,17,32
047 Enneberg,41,,20,16,36
047 Enneberg,42,,15,18,33
047 Enneberg,43,,22,14,36
047 Enneberg,44,,22,8,30
047 Enneberg,45,,15,14,29
047 Enneberg,46,,16,17,33
047 Enneberg,47,,15,13,28
047 Enneberg,48,,14,11,25
047 Enneberg,49,,17,20,37
047 Enneberg,50,,14,17,31
047 Enneberg,51,,17,10,27
047 Enneberg,52,,10,15,25
047 Enneberg,53,,18,8,26
047 Enneberg,54,,15,13,28
047 Enneberg,55,,8,11,19
047 Enneberg,56,,14,17,31
047 Enneberg,57,,5,14,19
047 Enneberg,58,,20,16,36
047 Enneberg,59,,17,11,28
047 Enneberg,60,,12,19,31
047 Enneberg,61,,14,11,25
047 Enneberg,62,,12,7,19
047 Enneberg,63,,18,10,28
047 Enneberg,64,,13,18,31
047 Enneberg,65,,14,13,27
047 Enneberg,66,,12,12,24
047 Enneberg,67,,14,16,30
047 Enneberg,68,,9,11,20
047 Enneberg,69,,12,9,21
047 Enneberg,70,,8,17,25
047 Enneberg,71,,13,11,24
047 Enneberg,72,,13,14,27
047 Enneberg,73,,9,7,16
047 Enneberg,74,,11,13,24
047 Enneberg,75,,12,8,20
047 Enneberg,76,,7,9,16
047 Enneberg,77,,12,8,20
047 Enneberg,78,,4,8,12
047 Enneberg,79,,5,13,18
047 Enneberg,80,,7,7,14
047 Enneberg,81,,2,9,11
047 Enneberg,82,,6,5,11
047 Enneberg,83,,2,4,6
047 Enneberg,84,,4,3,7
047 Enneberg,85,,-,6,6
047 Enneberg,86,,1,7,8
047 Enneberg,87,,-,5,5
047 Enneberg,88,,2,5,7
047 Enneberg,89,,1,2,3
047 Enneberg,90,,-,4,4
047 Enneberg,91,,3,1,4
047 Enneberg,92,,1,1,2
047 Enneberg,93,,1,1,2
047 Enneberg,94,,-,2,2
047 Enneberg,95,,1,1,2
047 Enneberg,97,,-,1,1
047 Enneberg,98,,-,1,1
048 Marling,0,,14,13,27
048 Marling,1,,10,14,24
048 Marling,2,,13,13,26
048 Marling,3,,14,7,21
048 Marling,4,,10,9,19
048 Marling,5,,11,9,20
048 Marling,6,,13,13,26
048 Marling,7,,17,10,27
048 Marling,8,,9,7,16
048 Marling,9,,16,9,25
048 Marling,10,,17,14,31
048 Marling,11,,12,10,22
048 Marling,12,,9,14,23
048 Marling,13,,9,16,25
048 Marling,14,,9,14,23
048 Marling,15,,5,9,14
048 Marling,16,,13,10,23
048 Marling,17,,9,15,24
048 Marling,18,,11,6,17
048 Marling,19,,11,10,21
048 Marling,20,,12,7,19
048 Marling,21,,14,10,24
048 Marling,22,,13,9,22
048 Marling,23,,12,16,28
048 Marling,24,,15,14,29
048 Marling,25,,10,21,31
048 Marling,26,,15,19,34
048 Marling,27,,13,11,24
048 Marling,28,,8,9,17
048 Marling,29,,13,19,32
048 Marling,30,,14,13,27
048 Marling,31,,24,14,38
048 Marling,32,,13,17,30
048 Marling,33,,19,20,39
048 Marling,34,,27,21,48
048 Marling,35,,21,13,34
048 Marling,36,,23,27,50
048 Marling,37,,23,19,42
048 Marling,38,,24,16,40
048 Marling,39,,28,29,57
048 Marling,40,,22,17,39
048 Marling,41,,22,12,34
048 Marling,42,,16,19,35
048 Marling,43,,16,16,32
048 Marling,44,,16,11,27
048 Marling,45,,11,9,20
048 Marling,46,,10,11,21
048 Marling,47,,10,6,16
048 Marling,48,,18,11,29
048 Marling,49,,12,16,28
048 Marling,50,,13,13,26
048 Marling,51,,6,12,18
048 Marling,52,,18,15,33
048 Marling,53,,19,18,37
048 Marling,54,,6,15,21
048 Marling,55,,17,12,29
048 Marling,56,,12,16,28
048 Marling,57,,20,15,35
048 Marling,58,,15,15,30
048 Marling,59,,11,18,29
048 Marling,60,,12,13,25
048 Marling,61,,21,18,39
048 Marling,62,,12,13,25
048 Marling,63,,15,16,31
048 Marling,64,,13,13,26
048 Marling,65,,11,16,27
048 Marling,66,,14,8,22
048 Marling,67,,8,16,24
048 Marling,68,,12,11,23
048 Marling,69,,8,13,21
048 Marling,70,,11,9,20
048 Marling,71,,12,9,21
048 Marling,72,,5,10,15
048 Marling,73,,7,8,15
048 Marling,74,,9,4,13
048 Marling,75,,10,9,19
048 Marling,76,,5,12,17
048 Marling,77,,4,14,18
048 Marling,78,,3,7,10
048 Marling,79,,6,7,13
048 Marling,80,,3,5,8
048 Marling,81,,5,8,13
048 Marling,82,,-,3,3
048 Marling,83,,3,4,7
048 Marling,84,,1,3,4
048 Marling,85,,1,2,3
048 Marling,86,,1,3,4
048 Marling,87,,2,4,6
048 Marling,88,,2,4,6
048 Marling,89,,2,2,4
048 Marling,90,,2,3,5
048 Marling,92,,-,1,1
048 Marling,93,,2,-,2
048 Marling,94,,1,-,1
048 Marling,95,,1,2,3
048 Marling,97,,-,1,1
048 Marling,98,,1,-,1
049 Martell,0,,4,5,9
049 Martell,1,,5,8,13
049 Martell,2,,6,4,10
049 Martell,3,,2,7,9
049 Martell,4,,6,6,12
049 Martell,5,,5,8,13
049 Martell,6,,4,6,10
049 Martell,7,,7,7,14
049 Martell,8,,6,8,14
049 Martell,9,,8,6,14
049 Martell,10,,5,5,10
049 Martell,11,,8,5,13
049 Martell,12,,6,6,12
049 Martell,13,,9,4,13
049 Martell,14,,5,1,6
049 Martell,15,,8,3,11
049 Martell,16,,-,5,5
049 Martell,17,,6,7,13
049 Martell,18,,6,4,10
049 Martell,19,,9,3,12
049 Martell,20,,5,6,11
049 Martell,21,,7,4,11
049 Martell,22,,9,5,14
049 Martell,23,,9,8,17
049 Martell,24,,4,6,10
049 Martell,25,,5,3,8
049 Martell,26,,5,7,12
049 Martell,27,,3,6,9
049 Martell,28,,6,11,17
049 Martell,29,,9,5,14
049 Martell,30,,4,8,12
049 Martell,31,,11,4,15
049 Martell,32,,8,4,12
049 Martell,33,,7,13,20
049 Martell,34,,8,6,14
049 Martell,35,,4,7,11
049 Martell,36,,16,6,22
049 Martell,37,,17,9,26
049 Martell,38,,9,9,18
049 Martell,39,,13,2,15
049 Martell,40,,9,9,18
049 Martell,41,,7,5,12
049 Martell,42,,9,3,12
049 Martell,43,,7,6,13
049 Martell,44,,7,6,13
049 Martell,45,,7,3,10
049 Martell,46,,5,4,9
049 Martell,47,,7,2,9
049 Martell,48,,7,6,13
049 Martell,49,,5,4,9
049 Martell,50,,4,3,7
049 Martell,51,,7,8,15
049 Martell,52,,3,4,7
049 Martell,53,,4,2,6
049 Martell,54,,6,4,10
049 Martell,55,,5,3,8
049 Martell,56,,3,-,3
049 Martell,57,,4,1,5
049 Martell,58,,1,3,4
049 Martell,59,,2,4,6
049 Martell,60,,6,5,11
049 Martell,61,,4,4,8
049 Martell,62,,6,2,8
049 Martell,63,,2,4,6
049 Martell,64,,2,6,8
049 Martell,65,,3,4,7
049 Martell,66,,3,4,7
049 Martell,67,,4,9,13
049 Martell,68,,7,1,8
049 Martell,69,,5,6,11
049 Martell,70,,2,4,6
049 Martell,71,,5,1,6
049 Martell,72,,7,4,11
049 Martell,73,,4,3,7
049 Martell,74,,3,6,9
049 Martell,75,,2,3,5
049 Martell,76,,2,8,10
049 Martell,77,,2,3,5
049 Martell,78,,4,7,11
049 Martell,79,,1,7,8
049 Martell,80,,2,1,3
049 Martell,81,,1,1,2
049 Martell,82,,-,1,1
049 Martell,83,,1,1,2
049 Martell,84,,2,2,4
049 Martell,85,,1,-,1
049 Martell,86,,-,1,1
049 Martell,87,,2,1,3
049 Martell,88,,-,1,1
049 Martell,89,,1,-,1
049 Martell,90,,1,-,1
049 Martell,91,,3,1,4
049 Martell,92,,-,1,1
049 Martell,93,,-,1,1
049 Martell,95,,-,1,1
050 Mölten,0,,10,13,23
050 Mölten,1,,14,14,28
050 Mölten,2,,15,12,27
050 Mölten,3,,10,17,27
050 Mölten,4,,8,16,24
050 Mölten,5,,9,9,18
050 Mölten,6,,15,11,26
050 Mölten,7,,12,10,22
050 Mölten,8,,13,4,17
050 Mölten,9,,12,11,23
050 Mölten,10,,7,13,20
050 Mölten,11,,10,6,16
050 Mölten,12,,12,6,18
050 Mölten,13,,13,5,18
050 Mölten,14,,7,9,16
050 Mölten,15,,9,8,17
050 Mölten,16,,10,6,16
050 Mölten,17,,7,13,20
050 Mölten,18,,6,3,9
050 Mölten,19,,7,15,22
050 Mölten,20,,9,6,15
050 Mölten,21,,13,5,18
050 Mölten,22,,12,9,21
050 Mölten,23,,13,9,22
050 Mölten,24,,11,5,16
050 Mölten,25,,8,8,16
050 Mölten,26,,8,14,22
050 Mölten,27,,18,10,28
050 Mölten,28,,13,11,24
050 Mölten,29,,13,14,27
050 Mölten,30,,12,10,22
050 Mölten,31,,16,10,26
050 Mölten,32,,16,11,27
050 Mölten,33,,15,15,30
050 Mölten,34,,17,18,35
050 Mölten,35,,18,13,31
050 Mölten,36,,15,14,29
050 Mölten,37,,10,15,25
050 Mölten,38,,21,12,33
050 Mölten,39,,17,6,23
050 Mölten,40,,11,9,20
050 Mölten,41,,17,9,26
050 Mölten,42,,6,7,13
050 Mölten,43,,13,4,17
050 Mölten,44,,2,10,12
050 Mölten,45,,6,3,9
050 Mölten,46,,4,7,11
050 Mölten,47,,14,7,21
050 Mölten,48,,7,5,12
050 Mölten,49,,6,7,13
050 Mölten,50,,6,5,11
050 Mölten,51,,5,5,10
050 Mölten,52,,10,9,19
050 Mölten,53,,6,5,11
050 Mölten,54,,5,4,9
050 Mölten,55,,5,8,13
050 Mölten,56,,9,3,12
050 Mölten,57,,5,5,10
050 Mölten,58,,2,6,8
050 Mölten,59,,12,8,20
050 Mölten,60,,6,11,17
050 Mölten,61,,9,3,12
050 Mölten,62,,6,7,13
050 Mölten,63,,6,7,13
050 Mölten,64,,2,3,5
050 Mölten,65,,5,6,11
050 Mölten,66,,5,6,11
050 Mölten,67,,9,6,15
050 Mölten,68,,9,5,14
050 Mölten,69,,11,8,19
050 Mölten,70,,3,5,8
050 Mölten,71,,8,3,11
050 Mölten,72,,7,5,12
050 Mölten,73,,3,7,10
050 Mölten,74,,2,6,8
050 Mölten,75,,3,4,7
050 Mölten,76,,3,5,8
050 Mölten,77,,2,4,6
050 Mölten,78,,1,2,3
050 Mölten,79,,7,6,13
050 Mölten,80,,4,1,5
050 Mölten,81,,1,6,7
050 Mölten,82,,1,7,8
050 Mölten,83,,-,5,5
050 Mölten,84,,1,1,2
050 Mölten,85,,-,1,1
050 Mölten,86,,2,2,4
050 Mölten,87,,-,2,2
050 Mölten,88,,-,6,6
050 Mölten,89,,3,-,3
050 Mölten,90,,-,1,1
050 Mölten,91,,-,2,2
050 Mölten,92,,-,1,1
050 Mölten,93,,1,3,4
050 Mölten,94,,-,2,2
050 Mölten,96,,-,1,1
051 Meran,0,,164,142,306
051 Meran,1,,159,162,321
051 Meran,2,,172,142,314
051 Meran,3,,161,170,331
051 Meran,4,,142,136,278
051 Meran,5,,173,156,329
051 Meran,6,,181,142,323
051 Meran,7,,158,140,298
051 Meran,8,,155,166,321
051 Meran,9,,122,140,262
051 Meran,10,,166,132,298
051 Meran,11,,152,166,318
051 Meran,12,,150,154,304
051 Meran,13,,166,151,317
051 Meran,14,,159,125,284
051 Meran,15,,156,140,296
051 Meran,16,,151,109,260
051 Meran,17,,127,179,306
051 Meran,18,,157,140,297
051 Meran,19,,135,143,278
051 Meran,20,,147,153,300
051 Meran,21,,159,157,316
051 Meran,22,,160,145,305
051 Meran,23,,144,158,302
051 Meran,24,,170,172,342
051 Meran,25,,167,203,370
051 Meran,26,,188,213,401
051 Meran,27,,217,230,447
051 Meran,28,,250,259,509
051 Meran,29,,237,253,490
051 Meran,30,,256,252,508
051 Meran,31,,273,257,530
051 Meran,32,,268,283,551
051 Meran,33,,298,277,575
051 Meran,34,,309,310,619
051 Meran,35,,313,316,629
051 Meran,36,,302,274,576
051 Meran,37,,318,304,622
051 Meran,38,,331,285,616
051 Meran,39,,336,259,595
051 Meran,40,,249,273,522
051 Meran,41,,292,293,585
051 Meran,42,,284,257,541
051 Meran,43,,261,236,497
051 Meran,44,,246,225,471
051 Meran,45,,227,236,463
051 Meran,46,,222,217,439
051 Meran,47,,187,211,398
051 Meran,48,,177,218,395
051 Meran,49,,182,219,401
051 Meran,50,,207,221,428
051 Meran,51,,206,204,410
051 Meran,52,,195,219,414
051 Meran,53,,220,244,464
051 Meran,54,,220,252,472
051 Meran,55,,217,279,496
051 Meran,56,,237,298,535
051 Meran,57,,209,213,422
051 Meran,58,,209,238,447
051 Meran,59,,257,240,497
051 Meran,60,,259,299,558
051 Meran,61,,233,285,518
051 Meran,62,,202,222,424
051 Meran,63,,202,247,449
051 Meran,64,,192,228,420
051 Meran,65,,191,229,420
051 Meran,66,,174,206,380
051 Meran,67,,172,205,377
051 Meran,68,,164,186,350
051 Meran,69,,156,177,333
051 Meran,70,,139,200,339
051 Meran,71,,125,182,307
051 Meran,72,,142,192,334
051 Meran,73,,117,148,265
051 Meran,74,,122,195,317
051 Meran,75,,110,162,272
051 Meran,76,,109,180,289
051 Meran,77,,83,167,250
051 Meran,78,,95,167,262
051 Meran,79,,75,166,241
051 Meran,80,,86,184,270
051 Meran,81,,55,180,235
051 Meran,82,,65,161,226
051 Meran,83,,52,113,165
051 Meran,84,,36,81,117
051 Meran,85,,32,72,104
051 Meran,86,,22,57,79
051 Meran,87,,33,79,112
051 Meran,88,,34,91,125
051 Meran,89,,30,71,101
051 Meran,90,,25,69,94
051 Meran,91,,20,55,75
051 Meran,92,,11,46,57
051 Meran,93,,12,41,53
051 Meran,94,,12,22,34
051 Meran,95,,4,13,17
051 Meran,96,,3,20,23
051 Meran,97,,-,9,9
051 Meran,98,,1,9,10
051 Meran,99,,-,3,3
051 Meran,100,,-,2,2
051 Meran,101,,1,1,2
052 Welsberg-Taisten,0,,21,19,40
052 Welsberg-Taisten,1,,30,16,46
052 Welsberg-Taisten,2,,16,17,33
052 Welsberg-Taisten,3,,21,19,40
052 Welsberg-Taisten,4,,19,13,32
052 Welsberg-Taisten,5,,24,19,43
052 Welsberg-Taisten,6,,17,18,35
052 Welsberg-Taisten,7,,18,14,32
052 Welsberg-Taisten,8,,12,15,27
052 Welsberg-Taisten,9,,15,19,34
052 Welsberg-Taisten,10,,11,10,21
052 Welsberg-Taisten,11,,20,17,37
052 Welsberg-Taisten,12,,11,19,30
052 Welsberg-Taisten,13,,5,19,24
052 Welsberg-Taisten,14,,12,18,30
052 Welsberg-Taisten,15,,14,15,29
052 Welsberg-Taisten,16,,10,13,23
052 Welsberg-Taisten,17,,9,13,22
052 Welsberg-Taisten,18,,25,14,39
052 Welsberg-Taisten,19,,19,16,35
052 Welsberg-Taisten,20,,20,13,33
052 Welsberg-Taisten,21,,9,9,18
052 Welsberg-Taisten,22,,14,16,30
052 Welsberg-Taisten,23,,25,16,41
052 Welsberg-Taisten,24,,22,17,39
052 Welsberg-Taisten,25,,14,20,34
052 Welsberg-Taisten,26,,16,17,33
052 Welsberg-Taisten,27,,11,21,32
052 Welsberg-Taisten,28,,25,19,44
052 Welsberg-Taisten,29,,27,8,35
052 Welsberg-Taisten,30,,17,24,41
052 Welsberg-Taisten,31,,32,23,55
052 Welsberg-Taisten,32,,24,21,45
052 Welsberg-Taisten,33,,20,22,42
052 Welsberg-Taisten,34,,22,16,38
052 Welsberg-Taisten,35,,31,21,52
052 Welsberg-Taisten,36,,27,23,50
052 Welsberg-Taisten,37,,24,19,43
052 Welsberg-Taisten,38,,33,22,55
052 Welsberg-Taisten,39,,25,23,48
052 Welsberg-Taisten,40,,20,23,43
052 Welsberg-Taisten,41,,20,18,38
052 Welsberg-Taisten,42,,13,13,26
052 Welsberg-Taisten,43,,22,21,43
052 Welsberg-Taisten,44,,27,18,45
052 Welsberg-Taisten,45,,12,19,31
052 Welsberg-Taisten,46,,20,19,39
052 Welsberg-Taisten,47,,18,12,30
052 Welsberg-Taisten,48,,15,14,29
052 Welsberg-Taisten,49,,19,12,31
052 Welsberg-Taisten,50,,19,11,30
052 Welsberg-Taisten,51,,17,9,26
052 Welsberg-Taisten,52,,15,14,29
052 Welsberg-Taisten,53,,14,13,27
052 Welsberg-Taisten,54,,16,16,32
052 Welsberg-Taisten,55,,10,10,20
052 Welsberg-Taisten,56,,12,13,25
052 Welsberg-Taisten,57,,10,14,24
052 Welsberg-Taisten,58,,13,10,23
052 Welsberg-Taisten,59,,12,14,26
052 Welsberg-Taisten,60,,10,12,22
052 Welsberg-Taisten,61,,19,19,38
052 Welsberg-Taisten,62,,6,13,19
052 Welsberg-Taisten,63,,13,14,27
052 Welsberg-Taisten,64,,14,11,25
052 Welsberg-Taisten,65,,11,8,19
052 Welsberg-Taisten,66,,10,11,21
052 Welsberg-Taisten,67,,4,16,20
052 Welsberg-Taisten,68,,16,16,32
052 Welsberg-Taisten,69,,11,11,22
052 Welsberg-Taisten,70,,11,13,24
052 Welsberg-Taisten,71,,7,12,19
052 Welsberg-Taisten,72,,10,7,17
052 Welsberg-Taisten,73,,9,12,21
052 Welsberg-Taisten,74,,5,21,26
052 Welsberg-Taisten,75,,10,12,22
052 Welsberg-Taisten,76,,7,7,14
052 Welsberg-Taisten,77,,-,8,8
052 Welsberg-Taisten,78,,7,9,16
052 Welsberg-Taisten,79,,5,11,16
052 Welsberg-Taisten,80,,5,8,13
052 Welsberg-Taisten,81,,4,9,13
052 Welsberg-Taisten,82,,3,8,11
052 Welsberg-Taisten,83,,-,7,7
052 Welsberg-Taisten,84,,2,1,3
052 Welsberg-Taisten,85,,3,3,6
052 Welsberg-Taisten,86,,2,-,2
052 Welsberg-Taisten,87,,4,4,8
052 Welsberg-Taisten,88,,2,2,4
052 Welsberg-Taisten,89,,-,4,4
052 Welsberg-Taisten,90,,1,4,5
052 Welsberg-Taisten,91,,-,4,4
052 Welsberg-Taisten,92,,1,4,5
052 Welsberg-Taisten,93,,-,3,3
052 Welsberg-Taisten,94,,-,2,2
052 Welsberg-Taisten,95,,1,2,3
052 Welsberg-Taisten,98,,-,1,1
052 Welsberg-Taisten,102,,1,-,1
052 Welsberg-Taisten,114,,-,1,1
053 Montan,0,,6,5,11
053 Montan,1,,10,6,16
053 Montan,2,,9,6,15
053 Montan,3,,7,10,17
053 Montan,4,,9,11,20
053 Montan,5,,7,7,14
053 Montan,6,,13,10,23
053 Montan,7,,15,15,30
053 Montan,8,,13,5,18
053 Montan,9,,5,8,13
053 Montan,10,,7,10,17
053 Montan,11,,14,10,24
053 Montan,12,,12,8,20
053 Montan,13,,10,11,21
053 Montan,14,,12,14,26
053 Montan,15,,9,17,26
053 Montan,16,,14,5,19
053 Montan,17,,10,9,19
053 Montan,18,,7,3,10
053 Montan,19,,10,5,15
053 Montan,20,,10,8,18
053 Montan,21,,11,7,18
053 Montan,22,,4,5,9
053 Montan,23,,9,9,18
053 Montan,24,,10,7,17
053 Montan,25,,7,4,11
053 Montan,26,,5,3,8
053 Montan,27,,11,10,21
053 Montan,28,,8,11,19
053 Montan,29,,12,4,16
053 Montan,30,,10,6,16
053 Montan,31,,11,8,19
053 Montan,32,,14,10,24
053 Montan,33,,11,17,28
053 Montan,34,,13,19,32
053 Montan,35,,11,10,21
053 Montan,36,,12,15,27
053 Montan,37,,26,13,39
053 Montan,38,,18,11,29
053 Montan,39,,12,17,29
053 Montan,40,,14,16,30
053 Montan,41,,18,11,29
053 Montan,42,,14,12,26
053 Montan,43,,13,11,24
053 Montan,44,,12,11,23
053 Montan,45,,16,11,27
053 Montan,46,,7,14,21
053 Montan,47,,7,11,18
053 Montan,48,,12,11,23
053 Montan,49,,11,7,18
053 Montan,50,,12,3,15
053 Montan,51,,7,6,13
053 Montan,52,,4,4,8
053 Montan,53,,9,3,12
053 Montan,54,,5,6,11
053 Montan,55,,6,10,16
053 Montan,56,,5,2,7
053 Montan,57,,3,3,6
053 Montan,58,,2,5,7
053 Montan,59,,5,7,12
053 Montan,60,,7,6,13
053 Montan,61,,7,5,12
053 Montan,62,,9,7,16
053 Montan,63,,6,10,16
053 Montan,64,,9,9,18
053 Montan,65,,2,7,9
053 Montan,66,,7,10,17
053 Montan,67,,1,9,10
053 Montan,68,,3,6,9
053 Montan,69,,15,5,20
053 Montan,70,,5,8,13
053 Montan,71,,7,11,18
053 Montan,72,,10,13,23
053 Montan,73,,7,9,16
053 Montan,74,,7,3,10
053 Montan,75,,6,5,11
053 Montan,76,,7,8,15
053 Montan,77,,4,9,13
053 Montan,78,,2,7,9
053 Montan,79,,5,11,16
053 Montan,80,,5,8,13
053 Montan,81,,2,3,5
053 Montan,82,,1,8,9
053 Montan,83,,2,4,6
053 Montan,84,,1,4,5
053 Montan,85,,2,5,7
053 Montan,86,,-,2,2
053 Montan,87,,-,6,6
053 Montan,88,,1,2,3
053 Montan,89,,1,5,6
053 Montan,90,,1,1,2
053 Montan,91,,1,2,3
053 Montan,92,,1,-,1
053 Montan,93,,-,1,1
053 Montan,94,,-,2,2
053 Montan,95,,1,-,1
053 Montan,101,,-,1,1
054 Moos in Passeier,0,,17,17,34
054 Moos in Passeier,1,,14,12,26
054 Moos in Passeier,2,,13,19,32
054 Moos in Passeier,3,,24,10,34
054 Moos in Passeier,4,,13,16,29
054 Moos in Passeier,5,,12,17,29
054 Moos in Passeier,6,,18,20,38
054 Moos in Passeier,7,,9,14,23
054 Moos in Passeier,8,,17,21,38
054 Moos in Passeier,9,,20,12,32
054 Moos in Passeier,10,,18,18,36
054 Moos in Passeier,11,,18,21,39
054 Moos in Passeier,12,,15,13,28
054 Moos in Passeier,13,,17,19,36
054 Moos in Passeier,14,,16,16,32
054 Moos in Passeier,15,,15,14,29
054 Moos in Passeier,16,,17,15,32
054 Moos in Passeier,17,,19,11,30
054 Moos in Passeier,18,,23,21,44
054 Moos in Passeier,19,,15,13,28
054 Moos in Passeier,20,,17,23,40
054 Moos in Passeier,21,,19,20,39
054 Moos in Passeier,22,,20,18,38
054 Moos in Passeier,23,,20,16,36
054 Moos in Passeier,24,,26,15,41
054 Moos in Passeier,25,,21,18,39
054 Moos in Passeier,26,,15,11,26
054 Moos in Passeier,27,,22,20,42
054 Moos in Passeier,28,,25,14,39
054 Moos in Passeier,29,,9,23,32
054 Moos in Passeier,30,,20,16,36
054 Moos in Passeier,31,,20,18,38
054 Moos in Passeier,32,,23,11,34
054 Moos in Passeier,33,,18,20,38
054 Moos in Passeier,34,,18,21,39
054 Moos in Passeier,35,,22,18,40
054 Moos in Passeier,36,,26,20,46
054 Moos in Passeier,37,,23,8,31
054 Moos in Passeier,38,,27,10,37
054 Moos in Passeier,39,,17,18,35
054 Moos in Passeier,40,,11,21,32
054 Moos in Passeier,41,,9,7,16
054 Moos in Passeier,42,,18,16,34
054 Moos in Passeier,43,,16,14,30
054 Moos in Passeier,44,,14,15,29
054 Moos in Passeier,45,,21,7,28
054 Moos in Passeier,46,,9,8,17
054 Moos in Passeier,47,,9,9,18
054 Moos in Passeier,48,,17,9,26
054 Moos in Passeier,49,,6,9,15
054 Moos in Passeier,50,,8,5,13
054 Moos in Passeier,51,,10,10,20
054 Moos in Passeier,52,,8,10,18
054 Moos in Passeier,53,,16,9,25
054 Moos in Passeier,54,,6,6,12
054 Moos in Passeier,55,,19,10,29
054 Moos in Passeier,56,,9,8,17
054 Moos in Passeier,57,,9,7,16
054 Moos in Passeier,58,,9,9,18
054 Moos in Passeier,59,,15,12,27
054 Moos in Passeier,60,,5,12,17
054 Moos in Passeier,61,,10,15,25
054 Moos in Passeier,62,,9,10,19
054 Moos in Passeier,63,,5,6,11
054 Moos in Passeier,64,,11,8,19
054 Moos in Passeier,65,,5,6,11
054 Moos in Passeier,66,,8,7,15
054 Moos in Passeier,67,,8,7,15
054 Moos in Passeier,68,,10,14,24
054 Moos in Passeier,69,,7,9,16
054 Moos in Passeier,70,,8,4,12
054 Moos in Passeier,71,,9,7,16
054 Moos in Passeier,72,,9,7,16
054 Moos in Passeier,73,,8,13,21
054 Moos in Passeier,74,,4,10,14
054 Moos in Passeier,75,,7,5,12
054 Moos in Passeier,76,,9,3,12
054 Moos in Passeier,77,,7,7,14
054 Moos in Passeier,78,,3,6,9
054 Moos in Passeier,79,,4,3,7
054 Moos in Passeier,80,,1,6,7
054 Moos in Passeier,81,,1,2,3
054 Moos in Passeier,82,,2,3,5
054 Moos in Passeier,83,,1,4,5
054 Moos in Passeier,84,,1,-,1
054 Moos in Passeier,85,,1,2,3
054 Moos in Passeier,86,,1,3,4
054 Moos in Passeier,87,,2,1,3
054 Moos in Passeier,88,,1,4,5
054 Moos in Passeier,89,,1,1,2
054 Moos in Passeier,90,,1,1,2
054 Moos in Passeier,92,,-,1,1
054 Moos in Passeier,94,,1,-,1
055 Nals,0,,9,10,19
055 Nals,1,,8,11,19
055 Nals,2,,7,13,20
055 Nals,3,,15,9,24
055 Nals,4,,12,7,19
055 Nals,5,,13,6,19
055 Nals,6,,11,9,20
055 Nals,7,,9,6,15
055 Nals,8,,9,8,17
055 Nals,9,,7,12,19
055 Nals,10,,13,10,23
055 Nals,11,,7,11,18
055 Nals,12,,9,7,16
055 Nals,13,,11,8,19
055 Nals,14,,9,12,21
055 Nals,15,,11,11,22
055 Nals,16,,5,2,7
055 Nals,17,,11,5,16
055 Nals,18,,8,11,19
055 Nals,19,,5,8,13
055 Nals,20,,8,13,21
055 Nals,21,,10,11,21
055 Nals,22,,14,9,23
055 Nals,23,,8,6,14
055 Nals,24,,10,8,18
055 Nals,25,,5,5,10
055 Nals,26,,10,13,23
055 Nals,27,,6,11,17
055 Nals,28,,18,10,28
055 Nals,29,,11,9,20
055 Nals,30,,10,14,24
055 Nals,31,,14,12,26
055 Nals,32,,20,10,30
055 Nals,33,,11,14,25
055 Nals,34,,21,17,38
055 Nals,35,,18,14,32
055 Nals,36,,14,9,23
055 Nals,37,,17,13,30
055 Nals,38,,20,17,37
055 Nals,39,,11,20,31
055 Nals,40,,13,14,27
055 Nals,41,,17,14,31
055 Nals,42,,11,9,20
055 Nals,43,,15,14,29
055 Nals,44,,17,17,34
055 Nals,45,,9,9,18
055 Nals,46,,8,8,16
055 Nals,47,,19,16,35
055 Nals,48,,6,7,13
055 Nals,49,,6,7,13
055 Nals,50,,7,6,13
055 Nals,51,,3,10,13
055 Nals,52,,7,10,17
055 Nals,53,,11,9,20
055 Nals,54,,11,12,23
055 Nals,55,,12,6,18
055 Nals,56,,7,13,20
055 Nals,57,,7,12,19
055 Nals,58,,7,12,19
055 Nals,59,,10,6,16
055 Nals,60,,5,8,13
055 Nals,61,,12,6,18
055 Nals,62,,7,11,18
055 Nals,63,,10,10,20
055 Nals,64,,8,9,17
055 Nals,65,,3,13,16
055 Nals,66,,5,3,8
055 Nals,67,,7,6,13
055 Nals,68,,6,6,12
055 Nals,69,,9,11,20
055 Nals,70,,6,4,10
055 Nals,71,,3,7,10
055 Nals,72,,4,5,9
055 Nals,73,,9,7,16
055 Nals,74,,7,8,15
055 Nals,75,,6,6,12
055 Nals,76,,9,6,15
055 Nals,77,,4,5,9
055 Nals,78,,3,2,5
055 Nals,79,,1,6,7
055 Nals,80,,2,6,8
055 Nals,81,,2,8,10
055 Nals,82,,1,1,2
055 Nals,83,,1,5,6
055 Nals,85,,1,-,1
055 Nals,86,,-,1,1
055 Nals,87,,3,3,6
055 Nals,88,,-,4,4
055 Nals,89,,1,1,2
055 Nals,90,,2,1,3
055 Nals,91,,-,2,2
055 Nals,92,,1,1,2
056 Naturns,0,,21,25,46
056 Naturns,1,,33,31,64
056 Naturns,2,,28,26,54
056 Naturns,3,,30,27,57
056 Naturns,4,,31,33,64
056 Naturns,5,,22,18,40
056 Naturns,6,,32,34,66
056 Naturns,7,,48,34,82
056 Naturns,8,,36,38,74
056 Naturns,9,,31,40,71
056 Naturns,10,,31,41,72
056 Naturns,11,,43,39,82
056 Naturns,12,,35,32,67
056 Naturns,13,,37,23,60
056 Naturns,14,,43,35,78
056 Naturns,15,,34,17,51
056 Naturns,16,,28,26,54
056 Naturns,17,,36,24,60
056 Naturns,18,,38,20,58
056 Naturns,19,,30,32,62
056 Naturns,20,,36,28,64
056 Naturns,21,,36,47,83
056 Naturns,22,,31,29,60
056 Naturns,23,,40,37,77
056 Naturns,24,,35,40,75
056 Naturns,25,,34,39,73
056 Naturns,26,,34,33,67
056 Naturns,27,,37,37,74
056 Naturns,28,,42,41,83
056 Naturns,29,,43,42,85
056 Naturns,30,,40,42,82
056 Naturns,31,,42,40,82
056 Naturns,32,,50,45,95
056 Naturns,33,,37,47,84
056 Naturns,34,,47,44,91
056 Naturns,35,,50,41,91
056 Naturns,36,,51,43,94
056 Naturns,37,,38,49,87
056 Naturns,38,,47,37,84
056 Naturns,39,,41,48,89
056 Naturns,40,,40,45,85
056 Naturns,41,,37,49,86
056 Naturns,42,,53,38,91
056 Naturns,43,,45,42,87
056 Naturns,44,,30,34,64
056 Naturns,45,,36,33,69
056 Naturns,46,,41,35,76
056 Naturns,47,,32,31,63
056 Naturns,48,,39,31,70
056 Naturns,49,,34,27,61
056 Naturns,50,,36,34,70
056 Naturns,51,,36,36,72
056 Naturns,52,,29,33,62
056 Naturns,53,,26,20,46
056 Naturns,54,,30,25,55
056 Naturns,55,,13,21,34
056 Naturns,56,,25,32,57
056 Naturns,57,,25,18,43
056 Naturns,58,,21,20,41
056 Naturns,59,,27,35,62
056 Naturns,60,,31,35,66
056 Naturns,61,,41,31,72
056 Naturns,62,,21,20,41
056 Naturns,63,,20,21,41
056 Naturns,64,,23,18,41
056 Naturns,65,,23,23,46
056 Naturns,66,,21,21,42
056 Naturns,67,,22,10,32
056 Naturns,68,,17,20,37
056 Naturns,69,,17,13,30
056 Naturns,70,,12,20,32
056 Naturns,71,,13,22,35
056 Naturns,72,,18,24,42
056 Naturns,73,,16,18,34
056 Naturns,74,,17,16,33
056 Naturns,75,,12,19,31
056 Naturns,76,,13,16,29
056 Naturns,77,,15,17,32
056 Naturns,78,,16,15,31
056 Naturns,79,,9,12,21
056 Naturns,80,,5,12,17
056 Naturns,81,,7,17,24
056 Naturns,82,,4,8,12
056 Naturns,83,,3,9,12
056 Naturns,84,,2,3,5
056 Naturns,85,,3,2,5
056 Naturns,86,,2,4,6
056 Naturns,87,,1,5,6
056 Naturns,88,,3,8,11
056 Naturns,89,,5,12,17
056 Naturns,90,,3,6,9
056 Naturns,91,,2,3,5
056 Naturns,92,,2,-,2
056 Naturns,93,,-,5,5
056 Naturns,94,,-,2,2
056 Naturns,95,,1,2,3
056 Naturns,97,,1,2,3
056 Naturns,98,,-,1,1
056 Naturns,101,,-,1,1
057 Natz-Schabs,0,,22,17,39
057 Natz-Schabs,1,,9,19,28
057 Natz-Schabs,2,,18,17,35
057 Natz-Schabs,3,,14,20,34
057 Natz-Schabs,4,,20,16,36
057 Natz-Schabs,5,,18,17,35
057 Natz-Schabs,6,,23,18,41
057 Natz-Schabs,7,,15,15,30
057 Natz-Schabs,8,,21,16,37
057 Natz-Schabs,9,,15,18,33
057 Natz-Schabs,10,,14,13,27
057 Natz-Schabs,11,,21,21,42
057 Natz-Schabs,12,,14,24,38
057 Natz-Schabs,13,,15,24,39
057 Natz-Schabs,14,,24,15,39
057 Natz-Schabs,15,,20,21,41
057 Natz-Schabs,16,,17,20,37
057 Natz-Schabs,17,,20,24,44
057 Natz-Schabs,18,,17,15,32
057 Natz-Schabs,19,,21,18,39
057 Natz-Schabs,20,,10,20,30
057 Natz-Schabs,21,,19,21,40
057 Natz-Schabs,22,,23,13,36
057 Natz-Schabs,23,,13,13,26
057 Natz-Schabs,24,,14,13,27
057 Natz-Schabs,25,,17,12,29
057 Natz-Schabs,26,,11,18,29
057 Natz-Schabs,27,,14,20,34
057 Natz-Schabs,28,,12,20,32
057 Natz-Schabs,29,,21,20,41
057 Natz-Schabs,30,,25,20,45
057 Natz-Schabs,31,,21,25,46
057 Natz-Schabs,32,,26,24,50
057 Natz-Schabs,33,,28,19,47
057 Natz-Schabs,34,,31,17,48
057 Natz-Schabs,35,,28,27,55
057 Natz-Schabs,36,,27,16,43
057 Natz-Schabs,37,,30,26,56
057 Natz-Schabs,38,,27,24,51
057 Natz-Schabs,39,,25,25,50
057 Natz-Schabs,40,,16,24,40
057 Natz-Schabs,41,,19,17,36
057 Natz-Schabs,42,,28,22,50
057 Natz-Schabs,43,,21,20,41
057 Natz-Schabs,44,,22,18,40
057 Natz-Schabs,45,,20,19,39
057 Natz-Schabs,46,,19,21,40
057 Natz-Schabs,47,,20,17,37
057 Natz-Schabs,48,,10,14,24
057 Natz-Schabs,49,,21,16,37
057 Natz-Schabs,50,,13,10,23
057 Natz-Schabs,51,,15,9,24
057 Natz-Schabs,52,,16,16,32
057 Natz-Schabs,53,,18,14,32
057 Natz-Schabs,54,,13,13,26
057 Natz-Schabs,55,,11,12,23
057 Natz-Schabs,56,,15,10,25
057 Natz-Schabs,57,,10,6,16
057 Natz-Schabs,58,,13,12,25
057 Natz-Schabs,59,,11,8,19
057 Natz-Schabs,60,,13,7,20
057 Natz-Schabs,61,,14,9,23
057 Natz-Schabs,62,,3,8,11
057 Natz-Schabs,63,,2,6,8
057 Natz-Schabs,64,,6,6,12
057 Natz-Schabs,65,,12,6,18
057 Natz-Schabs,66,,9,4,13
057 Natz-Schabs,67,,7,7,14
057 Natz-Schabs,68,,5,3,8
057 Natz-Schabs,69,,7,10,17
057 Natz-Schabs,70,,5,7,12
057 Natz-Schabs,71,,6,4,10
057 Natz-Schabs,72,,5,7,12
057 Natz-Schabs,73,,10,2,12
057 Natz-Schabs,74,,4,7,11
057 Natz-Schabs,75,,2,4,6
057 Natz-Schabs,76,,4,7,11
057 Natz-Schabs,77,,3,6,9
057 Natz-Schabs,78,,2,7,9
057 Natz-Schabs,79,,1,10,11
057 Natz-Schabs,80,,6,5,11
057 Natz-Schabs,81,,5,3,8
057 Natz-Schabs,82,,2,7,9
057 Natz-Schabs,83,,-,2,2
057 Natz-Schabs,84,,1,4,5
057 Natz-Schabs,85,,1,2,3
057 Natz-Schabs,86,,1,-,1
057 Natz-Schabs,87,,1,2,3
057 Natz-Schabs,89,,2,-,2
057 Natz-Schabs,90,,-,2,2
057 Natz-Schabs,91,,-,2,2
057 Natz-Schabs,93,,1,-,1
057 Natz-Schabs,94,,-,1,1
058 Welschnofen,0,,20,6,26
058 Welschnofen,1,,5,12,17
058 Welschnofen,2,,9,8,17
058 Welschnofen,3,,10,13,23
058 Welschnofen,4,,14,8,22
058 Welschnofen,5,,12,12,24
058 Welschnofen,6,,9,10,19
058 Welschnofen,7,,14,13,27
058 Welschnofen,8,,11,11,22
058 Welschnofen,9,,12,10,22
058 Welschnofen,10,,14,10,24
058 Welschnofen,11,,14,11,25
058 Welschnofen,12,,11,14,25
058 Welschnofen,13,,14,9,23
058 Welschnofen,14,,11,15,26
058 Welschnofen,15,,10,9,19
058 Welschnofen,16,,7,10,17
058 Welschnofen,17,,10,7,17
058 Welschnofen,18,,7,8,15
058 Welschnofen,19,,10,12,22
058 Welschnofen,20,,10,16,26
058 Welschnofen,21,,13,11,24
058 Welschnofen,22,,13,8,21
058 Welschnofen,23,,10,3,13
058 Welschnofen,24,,12,14,26
058 Welschnofen,25,,11,20,31
058 Welschnofen,26,,20,10,30
058 Welschnofen,27,,18,11,29
058 Welschnofen,28,,13,15,28
058 Welschnofen,29,,14,16,30
058 Welschnofen,30,,11,13,24
058 Welschnofen,31,,13,15,28
058 Welschnofen,32,,18,12,30
058 Welschnofen,33,,13,14,27
058 Welschnofen,34,,17,17,34
058 Welschnofen,35,,18,14,32
058 Welschnofen,36,,15,12,27
058 Welschnofen,37,,21,14,35
058 Welschnofen,38,,14,7,21
058 Welschnofen,39,,18,17,35
058 Welschnofen,40,,11,16,27
058 Welschnofen,41,,16,18,34
058 Welschnofen,42,,20,9,29
058 Welschnofen,43,,13,13,26
058 Welschnofen,44,,16,10,26
058 Welschnofen,45,,12,13,25
058 Welschnofen,46,,11,13,24
058 Welschnofen,47,,14,14,28
058 Welschnofen,48,,14,11,25
058 Welschnofen,49,,10,14,24
058 Welschnofen,50,,11,8,19
058 Welschnofen,51,,16,7,23
058 Welschnofen,52,,9,9,18
058 Welschnofen,53,,12,13,25
058 Welschnofen,54,,8,11,19
058 Welschnofen,55,,9,8,17
058 Welschnofen,56,,10,10,20
058 Welschnofen,57,,11,6,17
058 Welschnofen,58,,7,11,18
058 Welschnofen,59,,14,9,23
058 Welschnofen,60,,12,13,25
058 Welschnofen,61,,10,7,17
058 Welschnofen,62,,7,7,14
058 Welschnofen,63,,11,7,18
058 Welschnofen,64,,7,7,14
058 Welschnofen,65,,9,4,13
058 Welschnofen,66,,4,12,16
058 Welschnofen,67,,8,6,14
058 Welschnofen,68,,12,10,22
058 Welschnofen,69,,9,14,23
058 Welschnofen,70,,7,7,14
058 Welschnofen,71,,5,7,12
058 Welschnofen,72,,7,8,15
058 Welschnofen,73,,8,12,20
058 Welschnofen,74,,7,6,13
058 Welschnofen,75,,2,3,5
058 Welschnofen,76,,5,8,13
058 Welschnofen,77,,5,6,11
058 Welschnofen,78,,3,13,16
058 Welschnofen,79,,7,8,15
058 Welschnofen,80,,6,6,12
058 Welschnofen,81,,2,10,12
058 Welschnofen,82,,3,4,7
058 Welschnofen,83,,1,6,7
058 Welschnofen,84,,2,1,3
058 Welschnofen,85,,1,-,1
058 Welschnofen,86,,3,4,7
058 Welschnofen,87,,-,4,4
058 Welschnofen,88,,-,2,2
058 Welschnofen,89,,-,3,3
058 Welschnofen,90,,2,5,7
058 Welschnofen,91,,1,-,1
058 Welschnofen,92,,1,1,2
058 Welschnofen,93,,1,3,4
058 Welschnofen,94,,1,-,1
058 Welschnofen,95,,-,1,1
058 Welschnofen,96,,-,2,2
058 Welschnofen,100,,1,-,1
059 Deutschnofen,0,,31,13,44
059 Deutschnofen,1,,23,30,53
059 Deutschnofen,2,,17,27,44
059 Deutschnofen,3,,28,23,51
059 Deutschnofen,4,,32,14,46
059 Deutschnofen,5,,21,28,49
059 Deutschnofen,6,,17,29,46
059 Deutschnofen,7,,25,24,49
059 Deutschnofen,8,,28,14,42
059 Deutschnofen,9,,22,26,48
059 Deutschnofen,10,,33,28,61
059 Deutschnofen,11,,20,21,41
059 Deutschnofen,12,,36,28,64
059 Deutschnofen,13,,24,22,46
059 Deutschnofen,14,,24,34,58
059 Deutschnofen,15,,21,24,45
059 Deutschnofen,16,,29,18,47
059 Deutschnofen,17,,25,19,44
059 Deutschnofen,18,,31,27,58
059 Deutschnofen,19,,22,22,44
059 Deutschnofen,20,,21,35,56
059 Deutschnofen,21,,19,16,35
059 Deutschnofen,22,,27,20,47
059 Deutschnofen,23,,21,21,42
059 Deutschnofen,24,,23,18,41
059 Deutschnofen,25,,29,25,54
059 Deutschnofen,26,,18,21,39
059 Deutschnofen,27,,22,28,50
059 Deutschnofen,28,,28,33,61
059 Deutschnofen,29,,17,30,47
059 Deutschnofen,30,,23,32,55
059 Deutschnofen,31,,26,21,47
059 Deutschnofen,32,,28,27,55
059 Deutschnofen,33,,46,29,75
059 Deutschnofen,34,,24,24,48
059 Deutschnofen,35,,29,28,57
059 Deutschnofen,36,,32,35,67
059 Deutschnofen,37,,38,23,61
059 Deutschnofen,38,,32,27,59
059 Deutschnofen,39,,32,26,58
059 Deutschnofen,40,,28,27,55
059 Deutschnofen,41,,36,22,58
059 Deutschnofen,42,,41,25,66
059 Deutschnofen,43,,27,17,44
059 Deutschnofen,44,,23,32,55
059 Deutschnofen,45,,23,26,49
059 Deutschnofen,46,,34,27,61
059 Deutschnofen,47,,28,22,50
059 Deutschnofen,48,,28,19,47
059 Deutschnofen,49,,23,19,42
059 Deutschnofen,50,,24,22,46
059 Deutschnofen,51,,20,14,34
059 Deutschnofen,52,,17,21,38
059 Deutschnofen,53,,21,14,35
059 Deutschnofen,54,,23,16,39
059 Deutschnofen,55,,13,15,28
059 Deutschnofen,56,,18,22,40
059 Deutschnofen,57,,17,16,33
059 Deutschnofen,58,,16,16,32
059 Deutschnofen,59,,24,22,46
059 Deutschnofen,60,,20,17,37
059 Deutschnofen,61,,16,24,40
059 Deutschnofen,62,,13,19,32
059 Deutschnofen,63,,26,14,40
059 Deutschnofen,64,,18,21,39
059 Deutschnofen,65,,13,7,20
059 Deutschnofen,66,,14,10,24
059 Deutschnofen,67,,8,13,21
059 Deutschnofen,68,,16,10,26
059 Deutschnofen,69,,9,14,23
059 Deutschnofen,70,,14,15,29
059 Deutschnofen,71,,12,9,21
059 Deutschnofen,72,,10,10,20
059 Deutschnofen,73,,8,10,18
059 Deutschnofen,74,,10,23,33
059 Deutschnofen,75,,9,15,24
059 Deutschnofen,76,,16,10,26
059 Deutschnofen,77,,9,20,29
059 Deutschnofen,78,,6,12,18
059 Deutschnofen,79,,4,11,15
059 Deutschnofen,80,,8,17,25
059 Deutschnofen,81,,6,15,21
059 Deutschnofen,82,,3,11,14
059 Deutschnofen,83,,1,7,8
059 Deutschnofen,84,,3,5,8
059 Deutschnofen,85,,1,4,5
059 Deutschnofen,86,,3,3,6
059 Deutschnofen,87,,5,5,10
059 Deutschnofen,88,,2,5,7
059 Deutschnofen,89,,2,9,11
059 Deutschnofen,90,,-,5,5
059 Deutschnofen,91,,1,6,7
059 Deutschnofen,92,,2,2,4
059 Deutschnofen,93,,-,1,1
059 Deutschnofen,94,,2,-,2
059 Deutschnofen,95,,1,-,1
059 Deutschnofen,96,,-,1,1
060 Auer,0,,28,12,40
060 Auer,1,,15,20,35
060 Auer,2,,17,19,36
060 Auer,3,,20,24,44
060 Auer,4,,17,20,37
060 Auer,5,,19,19,38
060 Auer,6,,18,22,40
060 Auer,7,,18,14,32
060 Auer,8,,21,20,41
060 Auer,9,,11,23,34
060 Auer,10,,19,20,39
060 Auer,11,,24,13,37
060 Auer,12,,17,18,35
060 Auer,13,,21,19,40
060 Auer,14,,17,24,41
060 Auer,15,,21,16,37
060 Auer,16,,15,15,30
060 Auer,17,,22,18,40
060 Auer,18,,15,12,27
060 Auer,19,,15,16,31
060 Auer,20,,17,25,42
060 Auer,21,,13,16,29
060 Auer,22,,13,12,25
060 Auer,23,,18,15,33
060 Auer,24,,12,11,23
060 Auer,25,,14,22,36
060 Auer,26,,19,28,47
060 Auer,27,,9,14,23
060 Auer,28,,29,19,48
060 Auer,29,,30,18,48
060 Auer,30,,17,23,40
060 Auer,31,,31,21,52
060 Auer,32,,22,24,46
060 Auer,33,,19,29,48
060 Auer,34,,31,37,68
060 Auer,35,,25,25,50
060 Auer,36,,30,38,68
060 Auer,37,,34,21,55
060 Auer,38,,33,19,52
060 Auer,39,,34,37,71
060 Auer,40,,22,23,45
060 Auer,41,,38,33,71
060 Auer,42,,22,31,53
060 Auer,43,,35,28,63
060 Auer,44,,32,19,51
060 Auer,45,,24,25,49
060 Auer,46,,30,27,57
060 Auer,47,,14,23,37
060 Auer,48,,19,14,33
060 Auer,49,,15,22,37
060 Auer,50,,21,20,41
060 Auer,51,,15,22,37
060 Auer,52,,14,21,35
060 Auer,53,,11,12,23
060 Auer,54,,27,14,41
060 Auer,55,,15,24,39
060 Auer,56,,18,24,42
060 Auer,57,,13,12,25
060 Auer,58,,21,16,37
060 Auer,59,,17,18,35
060 Auer,60,,17,18,35
060 Auer,61,,20,14,34
060 Auer,62,,13,10,23
060 Auer,63,,12,19,31
060 Auer,64,,17,20,37
060 Auer,65,,11,13,24
060 Auer,66,,11,10,21
060 Auer,67,,10,16,26
060 Auer,68,,18,14,32
060 Auer,69,,4,8,12
060 Auer,70,,4,17,21
060 Auer,71,,12,9,21
060 Auer,72,,9,9,18
060 Auer,73,,8,15,23
060 Auer,74,,12,8,20
060 Auer,75,,8,13,21
060 Auer,76,,5,17,22
060 Auer,77,,11,10,21
060 Auer,78,,9,10,19
060 Auer,79,,9,14,23
060 Auer,80,,1,16,17
060 Auer,81,,3,12,15
060 Auer,82,,8,10,18
060 Auer,83,,3,4,7
060 Auer,84,,3,9,12
060 Auer,85,,2,3,5
060 Auer,86,,1,3,4
060 Auer,87,,-,2,2
060 Auer,88,,1,3,4
060 Auer,89,,1,7,8
060 Auer,90,,1,5,6
060 Auer,91,,-,1,1
060 Auer,92,,2,1,3
060 Auer,93,,1,2,3
060 Auer,95,,-,1,1
061 St.Ulrich,0,,30,33,63
061 St.Ulrich,1,,21,23,44
061 St.Ulrich,2,,30,32,62
061 St.Ulrich,3,,44,31,75
061 St.Ulrich,4,,40,35,75
061 St.Ulrich,5,,30,30,60
061 St.Ulrich,6,,29,23,52
061 St.Ulrich,7,,30,33,63
061 St.Ulrich,8,,29,31,60
061 St.Ulrich,9,,21,29,50
061 St.Ulrich,10,,35,31,66
061 St.Ulrich,11,,30,34,64
061 St.Ulrich,12,,28,22,50
061 St.Ulrich,13,,17,24,41
061 St.Ulrich,14,,17,21,38
061 St.Ulrich,15,,26,18,44
061 St.Ulrich,16,,19,18,37
061 St.Ulrich,17,,24,21,45
061 St.Ulrich,18,,22,20,42
061 St.Ulrich,19,,21,18,39
061 St.Ulrich,20,,25,26,51
061 St.Ulrich,21,,22,25,47
061 St.Ulrich,22,,24,30,54
061 St.Ulrich,23,,29,26,55
061 St.Ulrich,24,,25,31,56
061 St.Ulrich,25,,23,21,44
061 St.Ulrich,26,,33,35,68
061 St.Ulrich,27,,37,26,63
061 St.Ulrich,28,,34,32,66
061 St.Ulrich,29,,38,33,71
061 St.Ulrich,30,,43,38,81
061 St.Ulrich,31,,40,38,78
061 St.Ulrich,32,,43,33,76
061 St.Ulrich,33,,49,43,92
061 St.Ulrich,34,,47,40,87
061 St.Ulrich,35,,40,42,82
061 St.Ulrich,36,,37,37,74
061 St.Ulrich,37,,33,34,67
061 St.Ulrich,38,,39,42,81
061 St.Ulrich,39,,40,33,73
061 St.Ulrich,40,,30,36,66
061 St.Ulrich,41,,29,21,50
061 St.Ulrich,42,,34,25,59
061 St.Ulrich,43,,40,27,67
061 St.Ulrich,44,,22,18,40
061 St.Ulrich,45,,27,34,61
061 St.Ulrich,46,,16,29,45
061 St.Ulrich,47,,27,37,64
061 St.Ulrich,48,,25,34,59
061 St.Ulrich,49,,29,17,46
061 St.Ulrich,50,,14,25,39
061 St.Ulrich,51,,25,23,48
061 St.Ulrich,52,,20,24,44
061 St.Ulrich,53,,19,27,46
061 St.Ulrich,54,,30,30,60
061 St.Ulrich,55,,22,24,46
061 St.Ulrich,56,,33,27,60
061 St.Ulrich,57,,18,19,37
061 St.Ulrich,58,,30,32,62
061 St.Ulrich,59,,41,39,80
061 St.Ulrich,60,,31,37,68
061 St.Ulrich,61,,36,44,80
061 St.Ulrich,62,,32,28,60
061 St.Ulrich,63,,19,20,39
061 St.Ulrich,64,,26,26,52
061 St.Ulrich,65,,24,26,50
061 St.Ulrich,66,,24,17,41
061 St.Ulrich,67,,13,24,37
061 St.Ulrich,68,,20,13,33
061 St.Ulrich,69,,19,13,32
061 St.Ulrich,70,,15,23,38
061 St.Ulrich,71,,20,15,35
061 St.Ulrich,72,,19,9,28
061 St.Ulrich,73,,17,3,20
061 St.Ulrich,74,,17,13,30
061 St.Ulrich,75,,16,15,31
061 St.Ulrich,76,,10,15,25
061 St.Ulrich,77,,10,10,20
061 St.Ulrich,78,,10,21,31
061 St.Ulrich,79,,11,23,34
061 St.Ulrich,80,,6,19,25
061 St.Ulrich,81,,7,15,22
061 St.Ulrich,82,,5,18,23
061 St.Ulrich,83,,6,9,15
061 St.Ulrich,84,,5,8,13
061 St.Ulrich,85,,2,7,9
061 St.Ulrich,86,,4,6,10
061 St.Ulrich,87,,1,9,10
061 St.Ulrich,88,,8,7,15
061 St.Ulrich,89,,3,10,13
061 St.Ulrich,90,,4,7,11
061 St.Ulrich,91,,-,6,6
061 St.Ulrich,92,,4,1,5
061 St.Ulrich,93,,3,1,4
061 St.Ulrich,94,,1,1,2
061 St.Ulrich,95,,-,1,1
061 St.Ulrich,96,,-,1,1
061 St.Ulrich,98,,-,1,1
062 Partschins,0,,22,22,44
062 Partschins,1,,19,17,36
062 Partschins,2,,19,15,34
062 Partschins,3,,16,15,31
062 Partschins,4,,18,10,28
062 Partschins,5,,22,22,44
062 Partschins,6,,13,19,32
062 Partschins,7,,22,16,38
062 Partschins,8,,22,18,40
062 Partschins,9,,22,18,40
062 Partschins,10,,19,18,37
062 Partschins,11,,22,25,47
062 Partschins,12,,26,23,49
062 Partschins,13,,11,24,35
062 Partschins,14,,19,27,46
062 Partschins,15,,17,14,31
062 Partschins,16,,22,20,42
062 Partschins,17,,11,14,25
062 Partschins,18,,17,20,37
062 Partschins,19,,17,21,38
062 Partschins,20,,17,19,36
062 Partschins,21,,21,26,47
062 Partschins,22,,25,20,45
062 Partschins,23,,17,18,35
062 Partschins,24,,17,16,33
062 Partschins,25,,26,17,43
062 Partschins,26,,20,22,42
062 Partschins,27,,25,20,45
062 Partschins,28,,22,19,41
062 Partschins,29,,29,18,47
062 Partschins,30,,26,28,54
062 Partschins,31,,24,33,57
062 Partschins,32,,22,32,54
062 Partschins,33,,34,24,58
062 Partschins,34,,25,28,53
062 Partschins,35,,33,26,59
062 Partschins,36,,36,38,74
062 Partschins,37,,30,33,63
062 Partschins,38,,29,38,67
062 Partschins,39,,34,26,60
062 Partschins,40,,31,25,56
062 Partschins,41,,22,24,46
062 Partschins,42,,26,36,62
062 Partschins,43,,27,17,44
062 Partschins,44,,19,18,37
062 Partschins,45,,24,24,48
062 Partschins,46,,23,21,44
062 Partschins,47,,25,27,52
062 Partschins,48,,12,27,39
062 Partschins,49,,23,15,38
062 Partschins,50,,16,15,31
062 Partschins,51,,20,15,35
062 Partschins,52,,17,19,36
062 Partschins,53,,10,11,21
062 Partschins,54,,17,18,35
062 Partschins,55,,17,16,33
062 Partschins,56,,28,27,55
062 Partschins,57,,13,18,31
062 Partschins,58,,17,17,34
062 Partschins,59,,23,25,48
062 Partschins,60,,15,16,31
062 Partschins,61,,23,30,53
062 Partschins,62,,14,13,27
062 Partschins,63,,11,16,27
062 Partschins,64,,19,14,33
062 Partschins,65,,15,17,32
062 Partschins,66,,13,17,30
062 Partschins,67,,11,11,22
062 Partschins,68,,13,17,30
062 Partschins,69,,14,16,30
062 Partschins,70,,14,10,24
062 Partschins,71,,13,21,34
062 Partschins,72,,11,11,22
062 Partschins,73,,12,10,22
062 Partschins,74,,11,13,24
062 Partschins,75,,11,13,24
062 Partschins,76,,8,8,16
062 Partschins,77,,8,11,19
062 Partschins,78,,4,14,18
062 Partschins,79,,7,9,16
062 Partschins,80,,6,8,14
062 Partschins,81,,15,8,23
062 Partschins,82,,3,6,9
062 Partschins,83,,3,6,9
062 Partschins,84,,2,3,5
062 Partschins,85,,1,5,6
062 Partschins,86,,1,3,4
062 Partschins,87,,2,1,3
062 Partschins,88,,2,6,8
062 Partschins,89,,1,7,8
062 Partschins,90,,1,3,4
062 Partschins,91,,1,1,2
062 Partschins,92,,-,5,5
062 Partschins,95,,-,1,1
062 Partschins,96,,1,-,1
062 Partschins,97,,1,1,2
062 Partschins,99,,-,1,1
063 Percha,0,,12,8,20
063 Percha,1,,5,3,8
063 Percha,2,,11,13,24
063 Percha,3,,5,8,13
063 Percha,4,,7,9,16
063 Percha,5,,10,17,27
063 Percha,6,,9,4,13
063 Percha,7,,8,9,17
063 Percha,8,,9,11,20
063 Percha,9,,7,9,16
063 Percha,10,,12,6,18
063 Percha,11,,10,9,19
063 Percha,12,,9,6,15
063 Percha,13,,6,8,14
063 Percha,14,,6,5,11
063 Percha,15,,9,18,27
063 Percha,16,,5,7,12
063 Percha,17,,8,13,21
063 Percha,18,,18,9,27
063 Percha,19,,14,10,24
063 Percha,20,,6,11,17
063 Percha,21,,9,5,14
063 Percha,22,,11,5,16
063 Percha,23,,6,13,19
063 Percha,24,,9,9,18
063 Percha,25,,8,9,17
063 Percha,26,,14,11,25
063 Percha,27,,10,9,19
063 Percha,28,,7,10,17
063 Percha,29,,12,10,22
063 Percha,30,,13,10,23
063 Percha,31,,15,12,27
063 Percha,32,,8,11,19
063 Percha,33,,17,15,32
063 Percha,34,,15,13,28
063 Percha,35,,10,12,22
063 Percha,36,,17,6,23
063 Percha,37,,14,23,37
063 Percha,38,,16,10,26
063 Percha,39,,11,17,28
063 Percha,40,,14,11,25
063 Percha,41,,12,12,24
063 Percha,42,,10,5,15
063 Percha,43,,7,8,15
063 Percha,44,,10,8,18
063 Percha,45,,9,5,14
063 Percha,46,,7,12,19
063 Percha,47,,11,11,22
063 Percha,48,,4,4,8
063 Percha,49,,8,6,14
063 Percha,50,,4,8,12
063 Percha,51,,7,7,14
063 Percha,52,,6,7,13
063 Percha,53,,10,6,16
063 Percha,54,,4,4,8
063 Percha,55,,5,5,10
063 Percha,56,,6,8,14
063 Percha,57,,8,5,13
063 Percha,58,,12,4,16
063 Percha,59,,8,7,15
063 Percha,60,,8,7,15
063 Percha,61,,9,6,15
063 Percha,62,,5,5,10
063 Percha,63,,6,5,11
063 Percha,64,,5,9,14
063 Percha,65,,1,5,6
063 Percha,66,,3,3,6
063 Percha,67,,4,5,9
063 Percha,68,,7,6,13
063 Percha,69,,4,5,9
063 Percha,70,,5,3,8
063 Percha,71,,7,2,9
063 Percha,72,,10,3,13
063 Percha,73,,3,5,8
063 Percha,74,,3,3,6
063 Percha,75,,4,5,9
063 Percha,76,,2,7,9
063 Percha,77,,4,5,9
063 Percha,78,,2,3,5
063 Percha,79,,1,4,5
063 Percha,80,,2,2,4
063 Percha,81,,-,2,2
063 Percha,82,,-,1,1
063 Percha,84,,1,1,2
063 Percha,87,,1,1,2
063 Percha,88,,-,4,4
063 Percha,90,,-,2,2
063 Percha,92,,1,-,1
064 Plaus,0,,5,5,10
064 Plaus,1,,8,3,11
064 Plaus,2,,9,4,13
064 Plaus,3,,10,5,15
064 Plaus,4,,4,6,10
064 Plaus,5,,6,5,11
064 Plaus,6,,6,2,8
064 Plaus,7,,2,2,4
064 Plaus,8,,4,1,5
064 Plaus,9,,8,3,11
064 Plaus,10,,6,6,12
064 Plaus,11,,3,8,11
064 Plaus,12,,4,2,6
064 Plaus,13,,5,6,11
064 Plaus,14,,3,2,5
064 Plaus,15,,4,2,6
064 Plaus,16,,-,4,4
064 Plaus,17,,2,5,7
064 Plaus,18,,5,-,5
064 Plaus,19,,1,2,3
064 Plaus,20,,-,3,3
064 Plaus,21,,2,5,7
064 Plaus,22,,1,4,5
064 Plaus,23,,2,6,8
064 Plaus,24,,3,5,8
064 Plaus,25,,2,6,8
064 Plaus,26,,3,3,6
064 Plaus,27,,10,1,11
064 Plaus,28,,5,6,11
064 Plaus,29,,9,3,12
064 Plaus,30,,4,2,6
064 Plaus,31,,3,6,9
064 Plaus,32,,8,4,12
064 Plaus,33,,7,8,15
064 Plaus,34,,3,7,10
064 Plaus,35,,10,9,19
064 Plaus,36,,6,6,12
064 Plaus,37,,13,2,15
064 Plaus,38,,6,8,14
064 Plaus,39,,2,5,7
064 Plaus,40,,5,5,10
064 Plaus,41,,6,2,8
064 Plaus,42,,2,6,8
064 Plaus,43,,7,2,9
064 Plaus,44,,4,3,7
064 Plaus,45,,2,2,4
064 Plaus,46,,3,1,4
064 Plaus,47,,3,4,7
064 Plaus,48,,1,1,2
064 Plaus,49,,2,4,6
064 Plaus,50,,5,2,7
064 Plaus,51,,3,3,6
064 Plaus,52,,1,2,3
064 Plaus,53,,3,3,6
064 Plaus,54,,1,3,4
064 Plaus,55,,2,5,7
064 Plaus,56,,5,2,7
064 Plaus,57,,3,1,4
064 Plaus,58,,2,3,5
064 Plaus,59,,4,1,5
064 Plaus,60,,-,4,4
064 Plaus,61,,4,5,9
064 Plaus,62,,3,2,5
064 Plaus,63,,3,2,5
064 Plaus,64,,1,1,2
064 Plaus,65,,3,3,6
064 Plaus,67,,2,2,4
064 Plaus,68,,4,2,6
064 Plaus,69,,1,3,4
064 Plaus,70,,1,3,4
064 Plaus,71,,1,1,2
064 Plaus,72,,-,1,1
064 Plaus,73,,1,1,2
064 Plaus,74,,1,-,1
064 Plaus,75,,1,1,2
064 Plaus,76,,1,1,2
064 Plaus,77,,1,-,1
064 Plaus,78,,-,4,4
064 Plaus,79,,-,2,2
064 Plaus,80,,1,1,2
064 Plaus,81,,-,1,1
064 Plaus,82,,1,1,2
064 Plaus,83,,-,2,2
064 Plaus,84,,-,1,1
064 Plaus,90,,1,-,1
064 Plaus,91,,-,1,1
065 Waidbruck,0,,-,1,1
065 Waidbruck,1,,1,-,1
065 Waidbruck,2,,1,2,3
065 Waidbruck,3,,2,1,3
065 Waidbruck,5,,3,3,6
065 Waidbruck,6,,2,-,2
065 Waidbruck,7,,1,2,3
065 Waidbruck,8,,3,1,4
065 Waidbruck,9,,1,1,2
065 Waidbruck,10,,-,2,2
065 Waidbruck,11,,1,-,1
065 Waidbruck,12,,1,1,2
065 Waidbruck,13,,1,-,1
065 Waidbruck,14,,-,1,1
065 Waidbruck,15,,1,1,2
065 Waidbruck,17,,-,1,1
065 Waidbruck,18,,1,1,2
065 Waidbruck,19,,1,-,1
065 Waidbruck,21,,-,2,2
065 Waidbruck,22,,2,-,2
065 Waidbruck,23,,1,-,1
065 Waidbruck,24,,3,-,3
065 Waidbruck,25,,-,1,1
065 Waidbruck,26,,-,1,1
065 Waidbruck,27,,2,-,2
065 Waidbruck,28,,3,-,3
065 Waidbruck,29,,-,1,1
065 Waidbruck,30,,2,1,3
065 Waidbruck,31,,4,-,4
065 Waidbruck,32,,1,1,2
065 Waidbruck,33,,1,3,4
065 Waidbruck,34,,3,1,4
065 Waidbruck,35,,3,4,7
065 Waidbruck,36,,3,2,5
065 Waidbruck,37,,3,1,4
065 Waidbruck,38,,3,-,3
065 Waidbruck,39,,2,1,3
065 Waidbruck,40,,2,-,2
065 Waidbruck,41,,2,1,3
065 Waidbruck,42,,3,1,4
065 Waidbruck,43,,4,1,5
065 Waidbruck,44,,-,1,1
065 Waidbruck,45,,2,1,3
065 Waidbruck,46,,2,-,2
065 Waidbruck,47,,2,1,3
065 Waidbruck,49,,1,1,2
065 Waidbruck,50,,1,1,2
065 Waidbruck,51,,1,2,3
065 Waidbruck,53,,1,-,1
065 Waidbruck,56,,-,3,3
065 Waidbruck,57,,1,1,2
065 Waidbruck,58,,2,2,4
065 Waidbruck,60,,1,-,1
065 Waidbruck,61,,1,2,3
065 Waidbruck,62,,-,3,3
065 Waidbruck,63,,1,-,1
065 Waidbruck,64,,-,3,3
065 Waidbruck,65,,1,1,2
065 Waidbruck,66,,2,2,4
065 Waidbruck,67,,-,3,3
065 Waidbruck,68,,4,1,5
065 Waidbruck,69,,2,-,2
065 Waidbruck,70,,1,4,5
065 Waidbruck,71,,1,-,1
065 Waidbruck,72,,1,-,1
065 Waidbruck,73,,-,3,3
065 Waidbruck,74,,1,-,1
065 Waidbruck,75,,2,1,3
065 Waidbruck,76,,-,1,1
065 Waidbruck,77,,1,1,2
065 Waidbruck,79,,-,2,2
065 Waidbruck,80,,-,1,1
065 Waidbruck,82,,-,2,2
065 Waidbruck,83,,-,2,2
065 Waidbruck,88,,-,1,1
065 Waidbruck,92,,-,1,1
066 Burgstall,0,,9,8,17
066 Burgstall,1,,10,10,20
066 Burgstall,2,,10,11,21
066 Burgstall,3,,9,8,17
066 Burgstall,4,,10,11,21
066 Burgstall,5,,8,5,13
066 Burgstall,6,,6,9,15
066 Burgstall,7,,11,10,21
066 Burgstall,8,,6,6,12
066 Burgstall,9,,7,9,16
066 Burgstall,10,,4,6,10
066 Burgstall,11,,8,11,19
066 Burgstall,12,,13,8,21
066 Burgstall,13,,8,3,11
066 Burgstall,14,,6,6,12
066 Burgstall,15,,9,9,18
066 Burgstall,16,,10,4,14
066 Burgstall,17,,6,11,17
066 Burgstall,18,,9,12,21
066 Burgstall,19,,7,10,17
066 Burgstall,20,,13,8,21
066 Burgstall,21,,4,6,10
066 Burgstall,22,,11,9,20
066 Burgstall,23,,5,6,11
066 Burgstall,24,,7,8,15
066 Burgstall,25,,3,13,16
066 Burgstall,26,,11,4,15
066 Burgstall,27,,16,12,28
066 Burgstall,28,,11,12,23
066 Burgstall,29,,15,11,26
066 Burgstall,30,,9,16,25
066 Burgstall,31,,15,10,25
066 Burgstall,32,,13,9,22
066 Burgstall,33,,11,10,21
066 Burgstall,34,,15,20,35
066 Burgstall,35,,9,16,25
066 Burgstall,36,,15,18,33
066 Burgstall,37,,23,17,40
066 Burgstall,38,,16,12,28
066 Burgstall,39,,16,13,29
066 Burgstall,40,,18,12,30
066 Burgstall,41,,8,15,23
066 Burgstall,42,,16,10,26
066 Burgstall,43,,7,9,16
066 Burgstall,44,,16,8,24
066 Burgstall,45,,8,9,17
066 Burgstall,46,,12,11,23
066 Burgstall,47,,7,11,18
066 Burgstall,48,,10,13,23
066 Burgstall,49,,7,10,17
066 Burgstall,50,,11,14,25
066 Burgstall,51,,13,7,20
066 Burgstall,52,,10,12,22
066 Burgstall,53,,8,7,15
066 Burgstall,54,,7,15,22
066 Burgstall,55,,7,8,15
066 Burgstall,56,,11,8,19
066 Burgstall,57,,8,8,16
066 Burgstall,58,,12,10,22
066 Burgstall,59,,10,8,18
066 Burgstall,60,,5,6,11
066 Burgstall,61,,8,4,12
066 Burgstall,62,,5,13,18
066 Burgstall,63,,6,10,16
066 Burgstall,64,,10,14,24
066 Burgstall,65,,4,9,13
066 Burgstall,66,,5,6,11
066 Burgstall,67,,7,3,10
066 Burgstall,68,,9,8,17
066 Burgstall,69,,8,4,12
066 Burgstall,70,,3,8,11
066 Burgstall,71,,6,3,9
066 Burgstall,72,,5,7,12
066 Burgstall,73,,2,4,6
066 Burgstall,74,,4,8,12
066 Burgstall,75,,2,12,14
066 Burgstall,76,,4,9,13
066 Burgstall,77,,7,5,12
066 Burgstall,78,,1,7,8
066 Burgstall,79,,5,3,8
066 Burgstall,80,,6,6,12
066 Burgstall,81,,2,1,3
066 Burgstall,82,,2,3,5
066 Burgstall,83,,1,3,4
066 Burgstall,84,,-,1,1
066 Burgstall,85,,1,1,2
066 Burgstall,86,,2,2,4
066 Burgstall,87,,1,3,4
066 Burgstall,88,,1,3,4
066 Burgstall,89,,1,1,2
066 Burgstall,90,,-,2,2
066 Burgstall,91,,-,4,4
066 Burgstall,92,,-,1,1
066 Burgstall,93,,-,2,2
066 Burgstall,95,,1,-,1
066 Burgstall,100,,-,1,1
067 Prad am Stilfser Joch,0,,13,16,29
067 Prad am Stilfser Joch,1,,22,18,40
067 Prad am Stilfser Joch,2,,15,13,28
067 Prad am Stilfser Joch,3,,15,17,32
067 Prad am Stilfser Joch,4,,20,21,41
067 Prad am Stilfser Joch,5,,23,16,39
067 Prad am Stilfser Joch,6,,21,18,39
067 Prad am Stilfser Joch,7,,21,12,33
067 Prad am Stilfser Joch,8,,19,25,44
067 Prad am Stilfser Joch,9,,22,28,50
067 Prad am Stilfser Joch,10,,16,21,37
067 Prad am Stilfser Joch,11,,21,11,32
067 Prad am Stilfser Joch,12,,19,21,40
067 Prad am Stilfser Joch,13,,18,23,41
067 Prad am Stilfser Joch,14,,31,17,48
067 Prad am Stilfser Joch,15,,15,18,33
067 Prad am Stilfser Joch,16,,29,28,57
067 Prad am Stilfser Joch,17,,29,22,51
067 Prad am Stilfser Joch,18,,29,31,60
067 Prad am Stilfser Joch,19,,28,24,52
067 Prad am Stilfser Joch,20,,27,22,49
067 Prad am Stilfser Joch,21,,23,25,48
067 Prad am Stilfser Joch,22,,27,21,48
067 Prad am Stilfser Joch,23,,20,12,32
067 Prad am Stilfser Joch,24,,20,19,39
067 Prad am Stilfser Joch,25,,18,34,52
067 Prad am Stilfser Joch,26,,24,23,47
067 Prad am Stilfser Joch,27,,19,15,34
067 Prad am Stilfser Joch,28,,30,17,47
067 Prad am Stilfser Joch,29,,21,33,54
067 Prad am Stilfser Joch,30,,27,21,48
067 Prad am Stilfser Joch,31,,28,20,48
067 Prad am Stilfser Joch,32,,25,23,48
067 Prad am Stilfser Joch,33,,29,27,56
067 Prad am Stilfser Joch,34,,31,31,62
067 Prad am Stilfser Joch,35,,22,26,48
067 Prad am Stilfser Joch,36,,33,31,64
067 Prad am Stilfser Joch,37,,33,22,55
067 Prad am Stilfser Joch,38,,27,27,54
067 Prad am Stilfser Joch,39,,24,10,34
067 Prad am Stilfser Joch,40,,26,30,56
067 Prad am Stilfser Joch,41,,18,26,44
067 Prad am Stilfser Joch,42,,18,23,41
067 Prad am Stilfser Joch,43,,33,14,47
067 Prad am Stilfser Joch,44,,20,29,49
067 Prad am Stilfser Joch,45,,27,24,51
067 Prad am Stilfser Joch,46,,24,24,48
067 Prad am Stilfser Joch,47,,28,16,44
067 Prad am Stilfser Joch,48,,28,17,45
067 Prad am Stilfser Joch,49,,25,17,42
067 Prad am Stilfser Joch,50,,14,20,34
067 Prad am Stilfser Joch,51,,20,21,41
067 Prad am Stilfser Joch,52,,23,17,40
067 Prad am Stilfser Joch,53,,21,21,42
067 Prad am Stilfser Joch,54,,19,11,30
067 Prad am Stilfser Joch,55,,16,12,28
067 Prad am Stilfser Joch,56,,16,14,30
067 Prad am Stilfser Joch,57,,16,10,26
067 Prad am Stilfser Joch,58,,11,16,27
067 Prad am Stilfser Joch,59,,25,16,41
067 Prad am Stilfser Joch,60,,17,16,33
067 Prad am Stilfser Joch,61,,21,10,31
067 Prad am Stilfser Joch,62,,11,16,27
067 Prad am Stilfser Joch,63,,15,14,29
067 Prad am Stilfser Joch,64,,17,14,31
067 Prad am Stilfser Joch,65,,10,12,22
067 Prad am Stilfser Joch,66,,12,10,22
067 Prad am Stilfser Joch,67,,15,14,29
067 Prad am Stilfser Joch,68,,8,23,31
067 Prad am Stilfser Joch,69,,13,10,23
067 Prad am Stilfser Joch,70,,13,18,31
067 Prad am Stilfser Joch,71,,7,14,21
067 Prad am Stilfser Joch,72,,12,14,26
067 Prad am Stilfser Joch,73,,8,12,20
067 Prad am Stilfser Joch,74,,8,9,17
067 Prad am Stilfser Joch,75,,6,12,18
067 Prad am Stilfser Joch,76,,9,13,22
067 Prad am Stilfser Joch,77,,10,7,17
067 Prad am Stilfser Joch,78,,5,10,15
067 Prad am Stilfser Joch,79,,4,10,14
067 Prad am Stilfser Joch,80,,6,13,19
067 Prad am Stilfser Joch,81,,5,7,12
067 Prad am Stilfser Joch,82,,4,6,10
067 Prad am Stilfser Joch,83,,5,5,10
067 Prad am Stilfser Joch,84,,1,4,5
067 Prad am Stilfser Joch,85,,-,4,4
067 Prad am Stilfser Joch,86,,-,5,5
067 Prad am Stilfser Joch,87,,4,-,4
067 Prad am Stilfser Joch,88,,2,6,8
067 Prad am Stilfser Joch,89,,-,2,2
067 Prad am Stilfser Joch,90,,3,3,6
067 Prad am Stilfser Joch,91,,-,3,3
067 Prad am Stilfser Joch,92,,1,4,5
067 Prad am Stilfser Joch,93,,-,1,1
067 Prad am Stilfser Joch,94,,-,1,1
067 Prad am Stilfser Joch,95,,1,1,2
067 Prad am Stilfser Joch,97,,-,1,1
068 Prettau,0,,1,3,4
068 Prettau,1,,3,4,7
068 Prettau,2,,2,5,7
068 Prettau,3,,6,7,13
068 Prettau,4,,6,4,10
068 Prettau,5,,4,5,9
068 Prettau,6,,1,2,3
068 Prettau,7,,6,5,11
068 Prettau,8,,5,7,12
068 Prettau,9,,4,7,11
068 Prettau,10,,3,3,6
068 Prettau,11,,1,4,5
068 Prettau,12,,1,7,8
068 Prettau,13,,-,4,4
068 Prettau,14,,5,3,8
068 Prettau,15,,5,1,6
068 Prettau,16,,2,2,4
068 Prettau,17,,2,1,3
068 Prettau,18,,3,6,9
068 Prettau,19,,4,2,6
068 Prettau,20,,2,2,4
068 Prettau,21,,2,1,3
068 Prettau,22,,4,2,6
068 Prettau,23,,5,3,8
068 Prettau,24,,1,-,1
068 Prettau,25,,4,2,6
068 Prettau,26,,2,1,3
068 Prettau,27,,4,3,7
068 Prettau,28,,6,1,7
068 Prettau,29,,5,8,13
068 Prettau,30,,9,4,13
068 Prettau,31,,4,5,9
068 Prettau,32,,3,6,9
068 Prettau,33,,8,6,14
068 Prettau,34,,5,4,9
068 Prettau,35,,9,5,14
068 Prettau,36,,6,1,7
068 Prettau,37,,5,11,16
068 Prettau,38,,8,6,14
068 Prettau,39,,5,6,11
068 Prettau,40,,2,5,7
068 Prettau,41,,5,5,10
068 Prettau,42,,8,4,12
068 Prettau,43,,5,2,7
068 Prettau,44,,7,-,7
068 Prettau,45,,4,1,5
068 Prettau,46,,6,5,11
068 Prettau,47,,6,5,11
068 Prettau,48,,6,2,8
068 Prettau,49,,3,3,6
068 Prettau,50,,4,3,7
068 Prettau,51,,2,2,4
068 Prettau,52,,2,2,4
068 Prettau,53,,2,3,5
068 Prettau,54,,2,2,4
068 Prettau,55,,4,5,9
068 Prettau,56,,9,4,13
068 Prettau,57,,1,3,4
068 Prettau,58,,6,5,11
068 Prettau,59,,4,2,6
068 Prettau,60,,3,2,5
068 Prettau,61,,3,3,6
068 Prettau,62,,4,5,9
068 Prettau,63,,4,3,7
068 Prettau,64,,5,7,12
068 Prettau,65,,2,6,8
068 Prettau,66,,4,2,6
068 Prettau,67,,6,3,9
068 Prettau,68,,1,3,4
068 Prettau,69,,3,3,6
068 Prettau,70,,3,-,3
068 Prettau,71,,2,1,3
068 Prettau,72,,5,4,9
068 Prettau,73,,4,5,9
068 Prettau,74,,-,3,3
068 Prettau,75,,3,1,4
068 Prettau,76,,1,7,8
068 Prettau,77,,1,2,3
068 Prettau,78,,2,1,3
068 Prettau,79,,-,4,4
068 Prettau,80,,2,-,2
068 Prettau,81,,1,2,3
068 Prettau,82,,1,3,4
068 Prettau,83,,3,-,3
068 Prettau,84,,1,1,2
068 Prettau,85,,1,-,1
068 Prettau,86,,1,2,3
068 Prettau,87,,-,1,1
068 Prettau,88,,-,3,3
068 Prettau,89,,-,2,2
068 Prettau,90,,-,2,2
068 Prettau,91,,-,2,2
068 Prettau,96,,-,1,1
068 Prettau,97,,-,1,1
069 Proveis,0,,4,-,4
069 Proveis,1,,3,1,4
069 Proveis,2,,-,1,1
069 Proveis,3,,4,-,4
069 Proveis,4,,2,2,4
069 Proveis,5,,1,2,3
069 Proveis,6,,1,1,2
069 Proveis,7,,-,5,5
069 Proveis,8,,2,-,2
069 Proveis,9,,2,1,3
069 Proveis,10,,3,1,4
069 Proveis,11,,3,2,5
069 Proveis,12,,-,1,1
069 Proveis,13,,1,1,2
069 Proveis,14,,2,3,5
069 Proveis,15,,2,2,4
069 Proveis,16,,3,1,4
069 Proveis,17,,5,-,5
069 Proveis,18,,3,3,6
069 Proveis,19,,3,3,6
069 Proveis,20,,2,-,2
069 Proveis,21,,3,3,6
069 Proveis,23,,3,1,4
069 Proveis,24,,3,2,5
069 Proveis,25,,2,2,4
069 Proveis,26,,1,3,4
069 Proveis,27,,2,2,4
069 Proveis,28,,4,2,6
069 Proveis,29,,2,-,2
069 Proveis,30,,-,2,2
069 Proveis,31,,1,1,2
069 Proveis,32,,3,3,6
069 Proveis,33,,3,3,6
069 Proveis,34,,6,1,7
069 Proveis,35,,2,1,3
069 Proveis,36,,2,2,4
069 Proveis,37,,1,1,2
069 Proveis,38,,3,-,3
069 Proveis,39,,4,2,6
069 Proveis,40,,4,2,6
069 Proveis,41,,4,1,5
069 Proveis,42,,-,4,4
069 Proveis,43,,4,-,4
069 Proveis,44,,1,3,4
069 Proveis,45,,2,3,5
069 Proveis,46,,4,1,5
069 Proveis,47,,4,4,8
069 Proveis,48,,3,2,5
069 Proveis,49,,1,1,2
069 Proveis,50,,3,3,6
069 Proveis,51,,2,-,2
069 Proveis,52,,1,1,2
069 Proveis,53,,1,-,1
069 Proveis,54,,2,1,3
069 Proveis,55,,2,2,4
069 Proveis,56,,3,-,3
069 Proveis,57,,1,1,2
069 Proveis,58,,2,-,2
069 Proveis,59,,2,1,3
069 Proveis,60,,1,1,2
069 Proveis,61,,1,1,2
069 Proveis,62,,3,-,3
069 Proveis,63,,1,3,4
069 Proveis,64,,-,2,2
069 Proveis,65,,2,1,3
069 Proveis,66,,2,1,3
069 Proveis,67,,1,1,2
069 Proveis,68,,-,1,1
069 Proveis,69,,-,2,2
069 Proveis,70,,1,1,2
069 Proveis,71,,2,1,3
069 Proveis,73,,3,3,6
069 Proveis,74,,3,1,4
069 Proveis,75,,-,1,1
069 Proveis,76,,-,1,1
069 Proveis,77,,-,1,1
069 Proveis,78,,2,-,2
069 Proveis,79,,1,-,1
069 Proveis,80,,-,2,2
069 Proveis,81,,-,4,4
069 Proveis,82,,-,1,1
069 Proveis,85,,-,1,1
069 Proveis,95,,1,-,1
070 Ratschings,0,,15,26,41
070 Ratschings,1,,25,31,56
070 Ratschings,2,,33,24,57
070 Ratschings,3,,26,18,44
070 Ratschings,4,,31,20,51
070 Ratschings,5,,35,37,72
070 Ratschings,6,,29,34,63
070 Ratschings,7,,28,25,53
070 Ratschings,8,,22,29,51
070 Ratschings,9,,25,22,47
070 Ratschings,10,,39,31,70
070 Ratschings,11,,24,19,43
070 Ratschings,12,,31,27,58
070 Ratschings,13,,25,17,42
070 Ratschings,14,,35,29,64
070 Ratschings,15,,28,31,59
070 Ratschings,16,,28,26,54
070 Ratschings,17,,29,34,63
070 Ratschings,18,,26,19,45
070 Ratschings,19,,30,20,50
070 Ratschings,20,,35,24,59
070 Ratschings,21,,30,30,60
070 Ratschings,22,,23,22,45
070 Ratschings,23,,33,20,53
070 Ratschings,24,,30,24,54
070 Ratschings,25,,33,15,48
070 Ratschings,26,,23,27,50
070 Ratschings,27,,31,29,60
070 Ratschings,28,,37,25,62
070 Ratschings,29,,30,32,62
070 Ratschings,30,,33,37,70
070 Ratschings,31,,38,38,76
070 Ratschings,32,,30,36,66
070 Ratschings,33,,33,44,77
070 Ratschings,34,,46,38,84
070 Ratschings,35,,39,39,78
070 Ratschings,36,,45,42,87
070 Ratschings,37,,36,47,83
070 Ratschings,38,,48,38,86
070 Ratschings,39,,48,25,73
070 Ratschings,40,,37,39,76
070 Ratschings,41,,33,27,60
070 Ratschings,42,,39,24,63
070 Ratschings,43,,40,25,65
070 Ratschings,44,,31,20,51
070 Ratschings,45,,33,18,51
070 Ratschings,46,,34,18,52
070 Ratschings,47,,14,33,47
070 Ratschings,48,,28,15,43
070 Ratschings,49,,21,24,45
070 Ratschings,50,,22,19,41
070 Ratschings,51,,16,15,31
070 Ratschings,52,,24,20,44
070 Ratschings,53,,23,23,46
070 Ratschings,54,,32,20,52
070 Ratschings,55,,18,15,33
070 Ratschings,56,,23,6,29
070 Ratschings,57,,18,20,38
070 Ratschings,58,,19,11,30
070 Ratschings,59,,16,13,29
070 Ratschings,60,,20,19,39
070 Ratschings,61,,24,20,44
070 Ratschings,62,,17,16,33
070 Ratschings,63,,19,17,36
070 Ratschings,64,,15,20,35
070 Ratschings,65,,19,9,28
070 Ratschings,66,,15,12,27
070 Ratschings,67,,15,17,32
070 Ratschings,68,,13,9,22
070 Ratschings,69,,16,19,35
070 Ratschings,70,,16,13,29
070 Ratschings,71,,11,13,24
070 Ratschings,72,,12,18,30
070 Ratschings,73,,9,20,29
070 Ratschings,74,,10,11,21
070 Ratschings,75,,15,13,28
070 Ratschings,76,,13,14,27
070 Ratschings,77,,13,9,22
070 Ratschings,78,,11,12,23
070 Ratschings,79,,9,9,18
070 Ratschings,80,,3,11,14
070 Ratschings,81,,5,12,17
070 Ratschings,82,,2,12,14
070 Ratschings,83,,2,3,5
070 Ratschings,84,,-,6,6
070 Ratschings,86,,2,2,4
070 Ratschings,87,,2,4,6
070 Ratschings,88,,-,4,4
070 Ratschings,89,,2,1,3
070 Ratschings,90,,2,1,3
070 Ratschings,91,,1,-,1
070 Ratschings,93,,-,1,1
070 Ratschings,94,,-,1,1
070 Ratschings,96,,-,1,1
071 Rasen-Antholz,0,,16,24,40
071 Rasen-Antholz,1,,17,23,40
071 Rasen-Antholz,2,,25,23,48
071 Rasen-Antholz,3,,14,18,32
071 Rasen-Antholz,4,,19,16,35
071 Rasen-Antholz,5,,27,20,47
071 Rasen-Antholz,6,,24,14,38
071 Rasen-Antholz,7,,10,15,25
071 Rasen-Antholz,8,,21,11,32
071 Rasen-Antholz,9,,17,14,31
071 Rasen-Antholz,10,,27,19,46
071 Rasen-Antholz,11,,16,14,30
071 Rasen-Antholz,12,,12,26,38
071 Rasen-Antholz,13,,19,17,36
071 Rasen-Antholz,14,,20,16,36
071 Rasen-Antholz,15,,26,9,35
071 Rasen-Antholz,16,,16,19,35
071 Rasen-Antholz,17,,23,13,36
071 Rasen-Antholz,18,,18,17,35
071 Rasen-Antholz,19,,15,18,33
071 Rasen-Antholz,20,,20,24,44
071 Rasen-Antholz,21,,15,14,29
071 Rasen-Antholz,22,,18,12,30
071 Rasen-Antholz,23,,16,19,35
071 Rasen-Antholz,24,,15,17,32
071 Rasen-Antholz,25,,16,16,32
071 Rasen-Antholz,26,,21,24,45
071 Rasen-Antholz,27,,23,29,52
071 Rasen-Antholz,28,,29,21,50
071 Rasen-Antholz,29,,34,24,58
071 Rasen-Antholz,30,,28,17,45
071 Rasen-Antholz,31,,28,24,52
071 Rasen-Antholz,32,,25,26,51
071 Rasen-Antholz,33,,27,27,54
071 Rasen-Antholz,34,,26,30,56
071 Rasen-Antholz,35,,26,27,53
071 Rasen-Antholz,36,,29,18,47
071 Rasen-Antholz,37,,34,25,59
071 Rasen-Antholz,38,,28,20,48
071 Rasen-Antholz,39,,24,22,46
071 Rasen-Antholz,40,,28,20,48
071 Rasen-Antholz,41,,17,24,41
071 Rasen-Antholz,42,,20,24,44
071 Rasen-Antholz,43,,26,19,45
071 Rasen-Antholz,44,,21,16,37
071 Rasen-Antholz,45,,22,11,33
071 Rasen-Antholz,46,,17,16,33
071 Rasen-Antholz,47,,18,14,32
071 Rasen-Antholz,48,,14,12,26
071 Rasen-Antholz,49,,16,11,27
071 Rasen-Antholz,50,,12,15,27
071 Rasen-Antholz,51,,13,12,25
071 Rasen-Antholz,52,,16,8,24
071 Rasen-Antholz,53,,14,8,22
071 Rasen-Antholz,54,,14,9,23
071 Rasen-Antholz,55,,9,14,23
071 Rasen-Antholz,56,,10,14,24
071 Rasen-Antholz,57,,11,10,21
071 Rasen-Antholz,58,,10,8,18
071 Rasen-Antholz,59,,13,13,26
071 Rasen-Antholz,60,,11,14,25
071 Rasen-Antholz,61,,14,12,26
071 Rasen-Antholz,62,,10,17,27
071 Rasen-Antholz,63,,17,13,30
071 Rasen-Antholz,64,,14,8,22
071 Rasen-Antholz,65,,10,12,22
071 Rasen-Antholz,66,,9,12,21
071 Rasen-Antholz,67,,10,8,18
071 Rasen-Antholz,68,,12,10,22
071 Rasen-Antholz,69,,12,15,27
071 Rasen-Antholz,70,,15,10,25
071 Rasen-Antholz,71,,14,15,29
071 Rasen-Antholz,72,,4,11,15
071 Rasen-Antholz,73,,11,4,15
071 Rasen-Antholz,74,,5,3,8
071 Rasen-Antholz,75,,11,10,21
071 Rasen-Antholz,76,,7,6,13
071 Rasen-Antholz,77,,7,12,19
071 Rasen-Antholz,78,,7,12,19
071 Rasen-Antholz,79,,1,11,12
071 Rasen-Antholz,80,,5,5,10
071 Rasen-Antholz,81,,6,6,12
071 Rasen-Antholz,82,,2,6,8
071 Rasen-Antholz,83,,3,6,9
071 Rasen-Antholz,84,,1,3,4
071 Rasen-Antholz,85,,2,3,5
071 Rasen-Antholz,86,,-,2,2
071 Rasen-Antholz,87,,3,2,5
071 Rasen-Antholz,88,,1,2,3
071 Rasen-Antholz,89,,1,3,4
071 Rasen-Antholz,90,,1,1,2
071 Rasen-Antholz,91,,-,2,2
071 Rasen-Antholz,92,,-,1,1
071 Rasen-Antholz,93,,-,1,1
071 Rasen-Antholz,94,,1,-,1
071 Rasen-Antholz,96,,-,1,1
071 Rasen-Antholz,97,,-,1,1
072 Ritten,0,,35,49,84
072 Ritten,1,,53,48,101
072 Ritten,2,,42,41,83
072 Ritten,3,,53,53,106
072 Ritten,4,,43,49,92
072 Ritten,5,,58,56,114
072 Ritten,6,,37,53,90
072 Ritten,7,,57,44,101
072 Ritten,8,,61,48,109
072 Ritten,9,,57,52,109
072 Ritten,10,,49,71,120
072 Ritten,11,,61,50,111
072 Ritten,12,,60,46,106
072 Ritten,13,,51,43,94
072 Ritten,14,,58,55,113
072 Ritten,15,,49,40,89
072 Ritten,16,,50,43,93
072 Ritten,17,,44,46,90
072 Ritten,18,,44,25,69
072 Ritten,19,,51,41,92
072 Ritten,20,,40,48,88
072 Ritten,21,,46,52,98
072 Ritten,22,,42,37,79
072 Ritten,23,,52,40,92
072 Ritten,24,,44,37,81
072 Ritten,25,,61,41,102
072 Ritten,26,,41,43,84
072 Ritten,27,,53,42,95
072 Ritten,28,,62,59,121
072 Ritten,29,,62,45,107
072 Ritten,30,,53,57,110
072 Ritten,31,,52,67,119
072 Ritten,32,,55,67,122
072 Ritten,33,,51,64,115
072 Ritten,34,,70,63,133
072 Ritten,35,,72,52,124
072 Ritten,36,,60,52,112
072 Ritten,37,,79,47,126
072 Ritten,38,,64,59,123
072 Ritten,39,,63,52,115
072 Ritten,40,,59,62,121
072 Ritten,41,,51,59,110
072 Ritten,42,,63,61,124
072 Ritten,43,,65,48,113
072 Ritten,44,,39,44,83
072 Ritten,45,,40,39,79
072 Ritten,46,,44,41,85
072 Ritten,47,,48,38,86
072 Ritten,48,,37,32,69
072 Ritten,49,,49,32,81
072 Ritten,50,,41,44,85
072 Ritten,51,,44,35,79
072 Ritten,52,,36,42,78
072 Ritten,53,,37,41,78
072 Ritten,54,,52,33,85
072 Ritten,55,,33,29,62
072 Ritten,56,,28,38,66
072 Ritten,57,,21,25,46
072 Ritten,58,,34,40,74
072 Ritten,59,,36,40,76
072 Ritten,60,,45,36,81
072 Ritten,61,,37,39,76
072 Ritten,62,,35,25,60
072 Ritten,63,,37,32,69
072 Ritten,64,,33,34,67
072 Ritten,65,,29,26,55
072 Ritten,66,,23,23,46
072 Ritten,67,,23,30,53
072 Ritten,68,,26,28,54
072 Ritten,69,,19,26,45
072 Ritten,70,,23,24,47
072 Ritten,71,,16,32,48
072 Ritten,72,,15,21,36
072 Ritten,73,,23,21,44
072 Ritten,74,,18,13,31
072 Ritten,75,,21,18,39
072 Ritten,76,,13,22,35
072 Ritten,77,,15,35,50
072 Ritten,78,,15,29,44
072 Ritten,79,,18,25,43
072 Ritten,80,,6,20,26
072 Ritten,81,,11,22,33
072 Ritten,82,,7,20,27
072 Ritten,83,,6,14,20
072 Ritten,84,,2,6,8
072 Ritten,85,,2,10,12
072 Ritten,86,,1,3,4
072 Ritten,87,,4,6,10
072 Ritten,88,,3,6,9
072 Ritten,89,,3,6,9
072 Ritten,90,,2,5,7
072 Ritten,91,,2,3,5
072 Ritten,92,,4,5,9
072 Ritten,93,,2,1,3
072 Ritten,94,,-,2,2
072 Ritten,95,,1,3,4
073 Riffian,0,,5,5,10
073 Riffian,1,,10,8,18
073 Riffian,2,,12,9,21
073 Riffian,3,,8,11,19
073 Riffian,4,,11,10,21
073 Riffian,5,,9,8,17
073 Riffian,6,,5,6,11
073 Riffian,7,,9,10,19
073 Riffian,8,,5,9,14
073 Riffian,9,,6,8,14
073 Riffian,10,,8,9,17
073 Riffian,11,,9,12,21
073 Riffian,12,,6,7,13
073 Riffian,13,,12,5,17
073 Riffian,14,,6,11,17
073 Riffian,15,,6,9,15
073 Riffian,16,,8,6,14
073 Riffian,17,,8,2,10
073 Riffian,18,,8,6,14
073 Riffian,19,,8,7,15
073 Riffian,20,,9,10,19
073 Riffian,21,,10,6,16
073 Riffian,22,,6,5,11
073 Riffian,23,,6,8,14
073 Riffian,24,,9,5,14
073 Riffian,25,,12,7,19
073 Riffian,26,,9,2,11
073 Riffian,27,,6,12,18
073 Riffian,28,,10,3,13
073 Riffian,29,,10,9,19
073 Riffian,30,,9,18,27
073 Riffian,31,,11,15,26
073 Riffian,32,,7,9,16
073 Riffian,33,,9,12,21
073 Riffian,34,,9,13,22
073 Riffian,35,,14,14,28
073 Riffian,36,,8,7,15
073 Riffian,37,,10,6,16
073 Riffian,38,,10,8,18
073 Riffian,39,,13,10,23
073 Riffian,40,,9,9,18
073 Riffian,41,,8,9,17
073 Riffian,42,,15,5,20
073 Riffian,43,,6,13,19
073 Riffian,44,,7,6,13
073 Riffian,45,,6,12,18
073 Riffian,46,,10,4,14
073 Riffian,47,,4,9,13
073 Riffian,48,,10,6,16
073 Riffian,49,,9,5,14
073 Riffian,50,,7,3,10
073 Riffian,51,,6,10,16
073 Riffian,52,,4,3,7
073 Riffian,53,,6,6,12
073 Riffian,54,,8,3,11
073 Riffian,55,,3,4,7
073 Riffian,56,,2,6,8
073 Riffian,57,,6,3,9
073 Riffian,58,,7,8,15
073 Riffian,59,,7,7,14
073 Riffian,60,,12,7,19
073 Riffian,61,,8,3,11
073 Riffian,62,,4,3,7
073 Riffian,63,,4,9,13
073 Riffian,64,,10,4,14
073 Riffian,65,,4,6,10
073 Riffian,66,,2,5,7
073 Riffian,67,,1,3,4
073 Riffian,68,,1,3,4
073 Riffian,69,,6,5,11
073 Riffian,70,,2,3,5
073 Riffian,71,,6,9,15
073 Riffian,72,,4,3,7
073 Riffian,73,,2,7,9
073 Riffian,74,,3,4,7
073 Riffian,75,,4,6,10
073 Riffian,76,,5,2,7
073 Riffian,77,,5,3,8
073 Riffian,78,,5,3,8
073 Riffian,79,,3,6,9
073 Riffian,80,,2,1,3
073 Riffian,81,,1,3,4
073 Riffian,82,,2,3,5
073 Riffian,83,,-,2,2
073 Riffian,84,,1,-,1
073 Riffian,85,,-,3,3
073 Riffian,87,,1,-,1
073 Riffian,88,,1,5,6
073 Riffian,89,,-,2,2
073 Riffian,90,,-,1,1
073 Riffian,92,,1,-,1
073 Riffian,93,,-,2,2
073 Riffian,94,,-,2,2
074 Mühlbach,0,,18,16,34
074 Mühlbach,1,,11,19,30
074 Mühlbach,2,,18,18,36
074 Mühlbach,3,,19,11,30
074 Mühlbach,4,,18,15,33
074 Mühlbach,5,,18,16,34
074 Mühlbach,6,,16,18,34
074 Mühlbach,7,,12,15,27
074 Mühlbach,8,,19,14,33
074 Mühlbach,9,,17,19,36
074 Mühlbach,10,,15,23,38
074 Mühlbach,11,,14,19,33
074 Mühlbach,12,,13,14,27
074 Mühlbach,13,,14,21,35
074 Mühlbach,14,,20,17,37
074 Mühlbach,15,,20,13,33
074 Mühlbach,16,,15,9,24
074 Mühlbach,17,,17,18,35
074 Mühlbach,18,,16,21,37
074 Mühlbach,19,,20,17,37
074 Mühlbach,20,,25,25,50
074 Mühlbach,21,,22,17,39
074 Mühlbach,22,,17,15,32
074 Mühlbach,23,,18,16,34
074 Mühlbach,24,,26,24,50
074 Mühlbach,25,,22,15,37
074 Mühlbach,26,,18,26,44
074 Mühlbach,27,,17,21,38
074 Mühlbach,28,,20,17,37
074 Mühlbach,29,,21,18,39
074 Mühlbach,30,,22,19,41
074 Mühlbach,31,,23,24,47
074 Mühlbach,32,,25,12,37
074 Mühlbach,33,,27,31,58
074 Mühlbach,34,,36,20,56
074 Mühlbach,35,,19,19,38
074 Mühlbach,36,,27,17,44
074 Mühlbach,37,,18,24,42
074 Mühlbach,38,,14,20,34
074 Mühlbach,39,,21,18,39
074 Mühlbach,40,,22,17,39
074 Mühlbach,41,,24,23,47
074 Mühlbach,42,,25,14,39
074 Mühlbach,43,,20,18,38
074 Mühlbach,44,,21,13,34
074 Mühlbach,45,,16,20,36
074 Mühlbach,46,,18,21,39
074 Mühlbach,47,,21,16,37
074 Mühlbach,48,,14,21,35
074 Mühlbach,49,,19,17,36
074 Mühlbach,50,,15,20,35
074 Mühlbach,51,,13,22,35
074 Mühlbach,52,,21,17,38
074 Mühlbach,53,,13,14,27
074 Mühlbach,54,,17,13,30
074 Mühlbach,55,,12,19,31
074 Mühlbach,56,,23,13,36
074 Mühlbach,57,,9,8,17
074 Mühlbach,58,,14,13,27
074 Mühlbach,59,,13,10,23
074 Mühlbach,60,,17,14,31
074 Mühlbach,61,,19,15,34
074 Mühlbach,62,,14,10,24
074 Mühlbach,63,,13,16,29
074 Mühlbach,64,,15,7,22
074 Mühlbach,65,,6,12,18
074 Mühlbach,66,,7,7,14
074 Mühlbach,67,,8,11,19
074 Mühlbach,68,,12,12,24
074 Mühlbach,69,,9,10,19
074 Mühlbach,70,,7,10,17
074 Mühlbach,71,,8,11,19
074 Mühlbach,72,,12,7,19
074 Mühlbach,73,,7,1,8
074 Mühlbach,74,,11,18,29
074 Mühlbach,75,,5,10,15
074 Mühlbach,76,,9,9,18
074 Mühlbach,77,,6,7,13
074 Mühlbach,78,,6,7,13
074 Mühlbach,79,,5,11,16
074 Mühlbach,80,,3,11,14
074 Mühlbach,81,,4,6,10
074 Mühlbach,82,,2,9,11
074 Mühlbach,83,,2,10,12
074 Mühlbach,84,,-,3,3
074 Mühlbach,85,,1,3,4
074 Mühlbach,86,,-,1,1
074 Mühlbach,87,,-,2,2
074 Mühlbach,88,,1,5,6
074 Mühlbach,89,,1,4,5
074 Mühlbach,90,,-,1,1
074 Mühlbach,91,,-,1,1
074 Mühlbach,92,,1,1,2
074 Mühlbach,95,,-,1,1
074 Mühlbach,96,,-,2,2
074 Mühlbach,97,,-,1,1
075 Rodeneck,0,,6,3,9
075 Rodeneck,1,,9,5,14
075 Rodeneck,2,,5,14,19
075 Rodeneck,3,,8,8,16
075 Rodeneck,4,,11,6,17
075 Rodeneck,5,,11,7,18
075 Rodeneck,6,,13,9,22
075 Rodeneck,7,,5,10,15
075 Rodeneck,8,,8,10,18
075 Rodeneck,9,,7,7,14
075 Rodeneck,10,,9,10,19
075 Rodeneck,11,,6,9,15
075 Rodeneck,12,,12,8,20
075 Rodeneck,13,,7,6,13
075 Rodeneck,14,,14,8,22
075 Rodeneck,15,,6,5,11
075 Rodeneck,16,,10,11,21
075 Rodeneck,17,,12,9,21
075 Rodeneck,18,,16,10,26
075 Rodeneck,19,,11,7,18
075 Rodeneck,20,,7,5,12
075 Rodeneck,21,,10,6,16
075 Rodeneck,22,,6,11,17
075 Rodeneck,23,,8,5,13
075 Rodeneck,24,,6,8,14
075 Rodeneck,25,,8,9,17
075 Rodeneck,26,,7,7,14
075 Rodeneck,27,,9,5,14
075 Rodeneck,28,,8,7,15
075 Rodeneck,29,,15,9,24
075 Rodeneck,30,,9,10,19
075 Rodeneck,31,,13,7,20
075 Rodeneck,32,,11,12,23
075 Rodeneck,33,,15,11,26
075 Rodeneck,34,,10,12,22
075 Rodeneck,35,,11,10,21
075 Rodeneck,36,,13,8,21
075 Rodeneck,37,,9,6,15
075 Rodeneck,38,,10,10,20
075 Rodeneck,39,,8,9,17
075 Rodeneck,40,,9,12,21
075 Rodeneck,41,,9,11,20
075 Rodeneck,42,,5,10,15
075 Rodeneck,43,,11,6,17
075 Rodeneck,44,,8,5,13
075 Rodeneck,45,,6,6,12
075 Rodeneck,46,,9,4,13
075 Rodeneck,47,,6,6,12
075 Rodeneck,48,,11,3,14
075 Rodeneck,49,,4,1,5
075 Rodeneck,50,,8,5,13
075 Rodeneck,51,,3,3,6
075 Rodeneck,52,,2,7,9
075 Rodeneck,53,,3,6,9
075 Rodeneck,54,,4,7,11
075 Rodeneck,55,,6,4,10
075 Rodeneck,56,,10,7,17
075 Rodeneck,57,,-,5,5
075 Rodeneck,58,,5,5,10
075 Rodeneck,59,,3,2,5
075 Rodeneck,60,,2,6,8
075 Rodeneck,61,,10,3,13
075 Rodeneck,62,,5,4,9
075 Rodeneck,63,,3,9,12
075 Rodeneck,64,,3,3,6
075 Rodeneck,65,,2,4,6
075 Rodeneck,66,,4,5,9
075 Rodeneck,67,,5,2,7
075 Rodeneck,68,,1,11,12
075 Rodeneck,69,,3,2,5
075 Rodeneck,70,,5,5,10
075 Rodeneck,71,,6,5,11
075 Rodeneck,72,,4,4,8
075 Rodeneck,73,,8,2,10
075 Rodeneck,74,,5,5,10
075 Rodeneck,75,,4,5,9
075 Rodeneck,76,,4,5,9
075 Rodeneck,77,,2,7,9
075 Rodeneck,78,,3,5,8
075 Rodeneck,79,,2,1,3
075 Rodeneck,80,,1,3,4
075 Rodeneck,81,,2,1,3
075 Rodeneck,82,,2,2,4
075 Rodeneck,83,,4,1,5
075 Rodeneck,84,,-,3,3
075 Rodeneck,86,,-,1,1
075 Rodeneck,87,,1,-,1
075 Rodeneck,88,,1,-,1
075 Rodeneck,89,,1,1,2
075 Rodeneck,90,,1,-,1
075 Rodeneck,91,,-,1,1
075 Rodeneck,92,,3,-,3
076 Salurn,0,,12,12,24
076 Salurn,1,,12,12,24
076 Salurn,2,,14,15,29
076 Salurn,3,,19,11,30
076 Salurn,4,,16,23,39
076 Salurn,5,,17,11,28
076 Salurn,6,,21,21,42
076 Salurn,7,,19,9,28
076 Salurn,8,,20,18,38
076 Salurn,9,,17,13,30
076 Salurn,10,,21,17,38
076 Salurn,11,,11,13,24
076 Salurn,12,,10,14,24
076 Salurn,13,,18,18,36
076 Salurn,14,,17,19,36
076 Salurn,15,,20,14,34
076 Salurn,16,,14,17,31
076 Salurn,17,,18,15,33
076 Salurn,18,,12,12,24
076 Salurn,19,,11,17,28
076 Salurn,20,,19,14,33
076 Salurn,21,,15,15,30
076 Salurn,22,,18,17,35
076 Salurn,23,,9,15,24
076 Salurn,24,,13,11,24
076 Salurn,25,,21,19,40
076 Salurn,26,,15,16,31
076 Salurn,27,,14,22,36
076 Salurn,28,,13,18,31
076 Salurn,29,,17,21,38
076 Salurn,30,,25,25,50
076 Salurn,31,,34,21,55
076 Salurn,32,,25,26,51
076 Salurn,33,,29,27,56
076 Salurn,34,,31,19,50
076 Salurn,35,,20,23,43
076 Salurn,36,,24,23,47
076 Salurn,37,,30,23,53
076 Salurn,38,,36,27,63
076 Salurn,39,,37,26,63
076 Salurn,40,,31,23,54
076 Salurn,41,,30,34,64
076 Salurn,42,,20,29,49
076 Salurn,43,,27,28,55
076 Salurn,44,,26,17,43
076 Salurn,45,,17,21,38
076 Salurn,46,,20,13,33
076 Salurn,47,,18,18,36
076 Salurn,48,,24,18,42
076 Salurn,49,,15,13,28
076 Salurn,50,,27,19,46
076 Salurn,51,,27,19,46
076 Salurn,52,,23,14,37
076 Salurn,53,,25,12,37
076 Salurn,54,,17,20,37
076 Salurn,55,,19,17,36
076 Salurn,56,,20,16,36
076 Salurn,57,,13,9,22
076 Salurn,58,,17,19,36
076 Salurn,59,,18,17,35
076 Salurn,60,,19,17,36
076 Salurn,61,,19,16,35
076 Salurn,62,,15,10,25
076 Salurn,63,,10,11,21
076 Salurn,64,,6,13,19
076 Salurn,65,,11,12,23
076 Salurn,66,,13,22,35
076 Salurn,67,,17,17,34
076 Salurn,68,,11,6,17
076 Salurn,69,,11,7,18
076 Salurn,70,,10,20,30
076 Salurn,71,,6,11,17
076 Salurn,72,,10,11,21
076 Salurn,73,,21,12,33
076 Salurn,74,,9,22,31
076 Salurn,75,,5,20,25
076 Salurn,76,,7,15,22
076 Salurn,77,,6,23,29
076 Salurn,78,,7,16,23
076 Salurn,79,,6,10,16
076 Salurn,80,,7,20,27
076 Salurn,81,,3,14,17
076 Salurn,82,,9,12,21
076 Salurn,83,,6,14,20
076 Salurn,84,,5,3,8
076 Salurn,85,,1,4,5
076 Salurn,86,,2,6,8
076 Salurn,87,,4,5,9
076 Salurn,88,,4,5,9
076 Salurn,89,,1,3,4
076 Salurn,90,,3,6,9
076 Salurn,91,,-,2,2
076 Salurn,92,,1,3,4
076 Salurn,93,,-,2,2
076 Salurn,94,,1,4,5
077 Innichen,0,,14,18,32
077 Innichen,1,,25,22,47
077 Innichen,2,,17,14,31
077 Innichen,3,,14,15,29
077 Innichen,4,,21,11,32
077 Innichen,5,,21,15,36
077 Innichen,6,,17,17,34
077 Innichen,7,,22,11,33
077 Innichen,8,,19,16,35
077 Innichen,9,,23,21,44
077 Innichen,10,,23,16,39
077 Innichen,11,,20,26,46
077 Innichen,12,,19,14,33
077 Innichen,13,,19,22,41
077 Innichen,14,,29,19,48
077 Innichen,15,,23,21,44
077 Innichen,16,,20,17,37
077 Innichen,17,,21,20,41
077 Innichen,18,,21,21,42
077 Innichen,19,,21,16,37
077 Innichen,20,,18,23,41
077 Innichen,21,,13,20,33
077 Innichen,22,,22,17,39
077 Innichen,23,,24,21,45
077 Innichen,24,,12,16,28
077 Innichen,25,,15,24,39
077 Innichen,26,,18,24,42
077 Innichen,27,,22,8,30
077 Innichen,28,,25,21,46
077 Innichen,29,,23,25,48
077 Innichen,30,,26,27,53
077 Innichen,31,,25,15,40
077 Innichen,32,,24,25,49
077 Innichen,33,,25,28,53
077 Innichen,34,,29,31,60
077 Innichen,35,,22,24,46
077 Innichen,36,,27,32,59
077 Innichen,37,,33,30,63
077 Innichen,38,,35,33,68
077 Innichen,39,,29,27,56
077 Innichen,40,,31,23,54
077 Innichen,41,,21,27,48
077 Innichen,42,,32,18,50
077 Innichen,43,,25,26,51
077 Innichen,44,,20,24,44
077 Innichen,45,,20,25,45
077 Innichen,46,,29,16,45
077 Innichen,47,,26,19,45
077 Innichen,48,,24,11,35
077 Innichen,49,,23,17,40
077 Innichen,50,,14,26,40
077 Innichen,51,,12,19,31
077 Innichen,52,,18,21,39
077 Innichen,53,,21,16,37
077 Innichen,54,,18,11,29
077 Innichen,55,,10,15,25
077 Innichen,56,,15,14,29
077 Innichen,57,,11,8,19
077 Innichen,58,,7,13,20
077 Innichen,59,,23,9,32
077 Innichen,60,,17,18,35
077 Innichen,61,,13,18,31
077 Innichen,62,,11,23,34
077 Innichen,63,,14,12,26
077 Innichen,64,,8,11,19
077 Innichen,65,,12,11,23
077 Innichen,66,,10,18,28
077 Innichen,67,,8,19,27
077 Innichen,68,,12,13,25
077 Innichen,69,,11,10,21
077 Innichen,70,,15,16,31
077 Innichen,71,,14,21,35
077 Innichen,72,,15,11,26
077 Innichen,73,,13,17,30
077 Innichen,74,,11,19,30
077 Innichen,75,,6,12,18
077 Innichen,76,,17,11,28
077 Innichen,77,,6,21,27
077 Innichen,78,,9,4,13
077 Innichen,79,,8,12,20
077 Innichen,80,,4,12,16
077 Innichen,81,,7,13,20
077 Innichen,82,,7,12,19
077 Innichen,83,,2,2,4
077 Innichen,84,,-,4,4
077 Innichen,85,,1,2,3
077 Innichen,86,,2,3,5
077 Innichen,87,,4,4,8
077 Innichen,88,,3,4,7
077 Innichen,89,,3,4,7
077 Innichen,90,,1,6,7
077 Innichen,91,,-,1,1
077 Innichen,92,,1,1,2
077 Innichen,93,,-,2,2
077 Innichen,94,,-,3,3
077 Innichen,95,,1,-,1
077 Innichen,96,,-,1,1
077 Innichen,97,,-,1,1
077 Innichen,100,,-,1,1
079 Jenesien,0,,12,16,28
079 Jenesien,1,,18,24,42
079 Jenesien,2,,18,16,34
079 Jenesien,3,,25,24,49
079 Jenesien,4,,16,27,43
079 Jenesien,5,,19,20,39
079 Jenesien,6,,25,11,36
079 Jenesien,7,,27,15,42
079 Jenesien,8,,21,23,44
079 Jenesien,9,,16,19,35
079 Jenesien,10,,28,22,50
079 Jenesien,11,,18,21,39
079 Jenesien,12,,18,15,33
079 Jenesien,13,,18,13,31
079 Jenesien,14,,24,16,40
079 Jenesien,15,,14,21,35
079 Jenesien,16,,16,16,32
079 Jenesien,17,,14,6,20
079 Jenesien,18,,19,14,33
079 Jenesien,19,,17,21,38
079 Jenesien,20,,13,22,35
079 Jenesien,21,,6,20,26
079 Jenesien,22,,14,22,36
079 Jenesien,23,,20,17,37
079 Jenesien,24,,12,13,25
079 Jenesien,25,,18,21,39
079 Jenesien,26,,15,15,30
079 Jenesien,27,,12,16,28
079 Jenesien,28,,18,18,36
079 Jenesien,29,,20,29,49
079 Jenesien,30,,20,21,41
079 Jenesien,31,,31,23,54
079 Jenesien,32,,29,29,58
079 Jenesien,33,,30,19,49
079 Jenesien,34,,18,30,48
079 Jenesien,35,,17,22,39
079 Jenesien,36,,35,28,63
079 Jenesien,37,,35,28,63
079 Jenesien,38,,35,33,68
079 Jenesien,39,,26,23,49
079 Jenesien,40,,29,22,51
079 Jenesien,41,,32,20,52
079 Jenesien,42,,26,12,38
079 Jenesien,43,,24,18,42
079 Jenesien,44,,21,9,30
079 Jenesien,45,,13,17,30
079 Jenesien,46,,17,14,31
079 Jenesien,47,,10,11,21
079 Jenesien,48,,16,14,30
079 Jenesien,49,,15,11,26
079 Jenesien,50,,14,20,34
079 Jenesien,51,,11,9,20
079 Jenesien,52,,13,20,33
079 Jenesien,53,,11,13,24
079 Jenesien,54,,12,7,19
079 Jenesien,55,,14,11,25
079 Jenesien,56,,10,12,22
079 Jenesien,57,,9,12,21
079 Jenesien,58,,13,14,27
079 Jenesien,59,,17,10,27
079 Jenesien,60,,15,10,25
079 Jenesien,61,,16,20,36
079 Jenesien,62,,17,11,28
079 Jenesien,63,,15,18,33
079 Jenesien,64,,20,9,29
079 Jenesien,65,,10,16,26
079 Jenesien,66,,6,18,24
079 Jenesien,67,,6,7,13
079 Jenesien,68,,8,7,15
079 Jenesien,69,,18,13,31
079 Jenesien,70,,7,10,17
079 Jenesien,71,,9,10,19
079 Jenesien,72,,7,15,22
079 Jenesien,73,,8,15,23
079 Jenesien,74,,12,10,22
079 Jenesien,75,,7,11,18
079 Jenesien,76,,9,12,21
079 Jenesien,77,,4,13,17
079 Jenesien,78,,9,9,18
079 Jenesien,79,,5,8,13
079 Jenesien,80,,8,8,16
079 Jenesien,81,,1,6,7
079 Jenesien,82,,3,7,10
079 Jenesien,83,,1,4,5
079 Jenesien,84,,-,1,1
079 Jenesien,85,,-,1,1
079 Jenesien,86,,2,1,3
079 Jenesien,87,,1,4,5
079 Jenesien,88,,1,2,3
079 Jenesien,89,,-,5,5
079 Jenesien,90,,1,2,3
079 Jenesien,91,,1,3,4
079 Jenesien,92,,-,1,1
079 Jenesien,94,,1,2,3
080 St.Leonhard in Pass.,0,,21,18,39
080 St.Leonhard in Pass.,1,,27,12,39
080 St.Leonhard in Pass.,2,,19,19,38
080 St.Leonhard in Pass.,3,,20,20,40
080 St.Leonhard in Pass.,4,,24,17,41
080 St.Leonhard in Pass.,5,,23,19,42
080 St.Leonhard in Pass.,6,,25,19,44
080 St.Leonhard in Pass.,7,,22,11,33
080 St.Leonhard in Pass.,8,,24,19,43
080 St.Leonhard in Pass.,9,,23,22,45
080 St.Leonhard in Pass.,10,,23,19,42
080 St.Leonhard in Pass.,11,,22,19,41
080 St.Leonhard in Pass.,12,,25,21,46
080 St.Leonhard in Pass.,13,,35,30,65
080 St.Leonhard in Pass.,14,,22,28,50
080 St.Leonhard in Pass.,15,,30,25,55
080 St.Leonhard in Pass.,16,,34,32,66
080 St.Leonhard in Pass.,17,,23,27,50
080 St.Leonhard in Pass.,18,,30,24,54
080 St.Leonhard in Pass.,19,,28,24,52
080 St.Leonhard in Pass.,20,,31,21,52
080 St.Leonhard in Pass.,21,,23,26,49
080 St.Leonhard in Pass.,22,,25,35,60
080 St.Leonhard in Pass.,23,,26,24,50
080 St.Leonhard in Pass.,24,,30,21,51
080 St.Leonhard in Pass.,25,,35,26,61
080 St.Leonhard in Pass.,26,,20,23,43
080 St.Leonhard in Pass.,27,,24,13,37
080 St.Leonhard in Pass.,28,,34,29,63
080 St.Leonhard in Pass.,29,,35,34,69
080 St.Leonhard in Pass.,30,,30,25,55
080 St.Leonhard in Pass.,31,,31,20,51
080 St.Leonhard in Pass.,32,,28,26,54
080 St.Leonhard in Pass.,33,,24,22,46
080 St.Leonhard in Pass.,34,,34,23,57
080 St.Leonhard in Pass.,35,,27,26,53
080 St.Leonhard in Pass.,36,,31,36,67
080 St.Leonhard in Pass.,37,,33,30,63
080 St.Leonhard in Pass.,38,,23,30,53
080 St.Leonhard in Pass.,39,,24,27,51
080 St.Leonhard in Pass.,40,,24,30,54
080 St.Leonhard in Pass.,41,,29,22,51
080 St.Leonhard in Pass.,42,,29,18,47
080 St.Leonhard in Pass.,43,,26,28,54
080 St.Leonhard in Pass.,44,,24,21,45
080 St.Leonhard in Pass.,45,,20,27,47
080 St.Leonhard in Pass.,46,,24,17,41
080 St.Leonhard in Pass.,47,,25,18,43
080 St.Leonhard in Pass.,48,,21,15,36
080 St.Leonhard in Pass.,49,,30,26,56
080 St.Leonhard in Pass.,50,,22,27,49
080 St.Leonhard in Pass.,51,,25,16,41
080 St.Leonhard in Pass.,52,,19,15,34
080 St.Leonhard in Pass.,53,,23,12,35
080 St.Leonhard in Pass.,54,,22,13,35
080 St.Leonhard in Pass.,55,,18,16,34
080 St.Leonhard in Pass.,56,,16,19,35
080 St.Leonhard in Pass.,57,,11,11,22
080 St.Leonhard in Pass.,58,,16,13,29
080 St.Leonhard in Pass.,59,,10,24,34
080 St.Leonhard in Pass.,60,,8,15,23
080 St.Leonhard in Pass.,61,,15,15,30
080 St.Leonhard in Pass.,62,,21,13,34
080 St.Leonhard in Pass.,63,,20,19,39
080 St.Leonhard in Pass.,64,,12,13,25
080 St.Leonhard in Pass.,65,,20,9,29
080 St.Leonhard in Pass.,66,,19,11,30
080 St.Leonhard in Pass.,67,,12,14,26
080 St.Leonhard in Pass.,68,,11,15,26
080 St.Leonhard in Pass.,69,,11,15,26
080 St.Leonhard in Pass.,70,,9,12,21
080 St.Leonhard in Pass.,71,,7,13,20
080 St.Leonhard in Pass.,72,,8,11,19
080 St.Leonhard in Pass.,73,,9,11,20
080 St.Leonhard in Pass.,74,,6,14,20
080 St.Leonhard in Pass.,75,,5,16,21
080 St.Leonhard in Pass.,76,,6,13,19
080 St.Leonhard in Pass.,77,,8,10,18
080 St.Leonhard in Pass.,78,,5,10,15
080 St.Leonhard in Pass.,79,,7,15,22
080 St.Leonhard in Pass.,80,,6,10,16
080 St.Leonhard in Pass.,81,,3,8,11
080 St.Leonhard in Pass.,82,,3,9,12
080 St.Leonhard in Pass.,83,,3,3,6
080 St.Leonhard in Pass.,84,,1,3,4
080 St.Leonhard in Pass.,85,,-,6,6
080 St.Leonhard in Pass.,86,,1,-,1
080 St.Leonhard in Pass.,87,,2,4,6
080 St.Leonhard in Pass.,88,,1,7,8
080 St.Leonhard in Pass.,89,,1,3,4
080 St.Leonhard in Pass.,90,,1,7,8
080 St.Leonhard in Pass.,91,,-,4,4
080 St.Leonhard in Pass.,93,,-,2,2
080 St.Leonhard in Pass.,94,,2,1,3
080 St.Leonhard in Pass.,95,,-,1,1
080 St.Leonhard in Pass.,98,,-,1,1
081 St.Lorenzen,0,,17,20,37
081 St.Lorenzen,1,,32,18,50
081 St.Lorenzen,2,,21,21,42
081 St.Lorenzen,3,,29,32,61
081 St.Lorenzen,4,,29,26,55
081 St.Lorenzen,5,,14,28,42
081 St.Lorenzen,6,,31,27,58
081 St.Lorenzen,7,,24,13,37
081 St.Lorenzen,8,,32,20,52
081 St.Lorenzen,9,,22,31,53
081 St.Lorenzen,10,,24,21,45
081 St.Lorenzen,11,,20,14,34
081 St.Lorenzen,12,,24,21,45
081 St.Lorenzen,13,,17,18,35
081 St.Lorenzen,14,,18,25,43
081 St.Lorenzen,15,,22,24,46
081 St.Lorenzen,16,,24,20,44
081 St.Lorenzen,17,,25,21,46
081 St.Lorenzen,18,,26,26,52
081 St.Lorenzen,19,,22,19,41
081 St.Lorenzen,20,,30,19,49
081 St.Lorenzen,21,,23,20,43
081 St.Lorenzen,22,,16,19,35
081 St.Lorenzen,23,,26,28,54
081 St.Lorenzen,24,,23,21,44
081 St.Lorenzen,25,,26,18,44
081 St.Lorenzen,26,,25,19,44
081 St.Lorenzen,27,,22,26,48
081 St.Lorenzen,28,,22,28,50
081 St.Lorenzen,29,,34,25,59
081 St.Lorenzen,30,,35,32,67
081 St.Lorenzen,31,,33,23,56
081 St.Lorenzen,32,,24,28,52
081 St.Lorenzen,33,,29,31,60
081 St.Lorenzen,34,,39,36,75
081 St.Lorenzen,35,,33,39,72
081 St.Lorenzen,36,,38,35,73
081 St.Lorenzen,37,,40,23,63
081 St.Lorenzen,38,,30,23,53
081 St.Lorenzen,39,,34,32,66
081 St.Lorenzen,40,,25,34,59
081 St.Lorenzen,41,,23,39,62
081 St.Lorenzen,42,,31,20,51
081 St.Lorenzen,43,,32,28,60
081 St.Lorenzen,44,,30,33,63
081 St.Lorenzen,45,,26,26,52
081 St.Lorenzen,46,,27,27,54
081 St.Lorenzen,47,,17,18,35
081 St.Lorenzen,48,,19,19,38
081 St.Lorenzen,49,,24,16,40
081 St.Lorenzen,50,,19,12,31
081 St.Lorenzen,51,,18,16,34
081 St.Lorenzen,52,,15,19,34
081 St.Lorenzen,53,,12,21,33
081 St.Lorenzen,54,,14,13,27
081 St.Lorenzen,55,,20,10,30
081 St.Lorenzen,56,,20,11,31
081 St.Lorenzen,57,,13,19,32
081 St.Lorenzen,58,,17,16,33
081 St.Lorenzen,59,,15,16,31
081 St.Lorenzen,60,,17,25,42
081 St.Lorenzen,61,,19,17,36
081 St.Lorenzen,62,,14,13,27
081 St.Lorenzen,63,,15,18,33
081 St.Lorenzen,64,,15,15,30
081 St.Lorenzen,65,,18,16,34
081 St.Lorenzen,66,,13,16,29
081 St.Lorenzen,67,,10,16,26
081 St.Lorenzen,68,,15,13,28
081 St.Lorenzen,69,,12,12,24
081 St.Lorenzen,70,,13,12,25
081 St.Lorenzen,71,,11,15,26
081 St.Lorenzen,72,,10,9,19
081 St.Lorenzen,73,,11,20,31
081 St.Lorenzen,74,,12,17,29
081 St.Lorenzen,75,,10,7,17
081 St.Lorenzen,76,,9,11,20
081 St.Lorenzen,77,,7,16,23
081 St.Lorenzen,78,,3,11,14
081 St.Lorenzen,79,,8,12,20
081 St.Lorenzen,80,,5,7,12
081 St.Lorenzen,81,,6,5,11
081 St.Lorenzen,82,,1,7,8
081 St.Lorenzen,83,,4,7,11
081 St.Lorenzen,84,,2,6,8
081 St.Lorenzen,85,,-,3,3
081 St.Lorenzen,86,,1,1,2
081 St.Lorenzen,87,,-,2,2
081 St.Lorenzen,88,,4,3,7
081 St.Lorenzen,89,,1,2,3
081 St.Lorenzen,90,,1,2,3
081 St.Lorenzen,91,,1,3,4
081 St.Lorenzen,92,,1,-,1
081 St.Lorenzen,93,,1,-,1
081 St.Lorenzen,95,,-,2,2
081 St.Lorenzen,97,,-,1,1
081 St.Lorenzen,99,,-,1,1
082 St.Martin in Thurn,0,,16,8,24
082 St.Martin in Thurn,1,,10,13,23
082 St.Martin in Thurn,2,,10,9,19
082 St.Martin in Thurn,3,,9,22,31
082 St.Martin in Thurn,4,,11,11,22
082 St.Martin in Thurn,5,,17,13,30
082 St.Martin in Thurn,6,,24,14,38
082 St.Martin in Thurn,7,,15,11,26
082 St.Martin in Thurn,8,,15,8,23
082 St.Martin in Thurn,9,,9,9,18
082 St.Martin in Thurn,10,,16,14,30
082 St.Martin in Thurn,11,,11,11,22
082 St.Martin in Thurn,12,,6,16,22
082 St.Martin in Thurn,13,,16,15,31
082 St.Martin in Thurn,14,,8,6,14
082 St.Martin in Thurn,15,,14,12,26
082 St.Martin in Thurn,16,,13,10,23
082 St.Martin in Thurn,17,,12,14,26
082 St.Martin in Thurn,18,,8,6,14
082 St.Martin in Thurn,19,,14,9,23
082 St.Martin in Thurn,20,,14,13,27
082 St.Martin in Thurn,21,,16,8,24
082 St.Martin in Thurn,22,,9,13,22
082 St.Martin in Thurn,23,,9,12,21
082 St.Martin in Thurn,24,,17,9,26
082 St.Martin in Thurn,25,,13,12,25
082 St.Martin in Thurn,26,,12,10,22
082 St.Martin in Thurn,27,,6,13,19
082 St.Martin in Thurn,28,,6,11,17
082 St.Martin in Thurn,29,,11,11,22
082 St.Martin in Thurn,30,,13,8,21
082 St.Martin in Thurn,31,,16,14,30
082 St.Martin in Thurn,32,,14,14,28
082 St.Martin in Thurn,33,,15,16,31
082 St.Martin in Thurn,34,,14,16,30
082 St.Martin in Thurn,35,,10,10,20
082 St.Martin in Thurn,36,,15,25,40
082 St.Martin in Thurn,37,,15,20,35
082 St.Martin in Thurn,38,,13,16,29
082 St.Martin in Thurn,39,,16,13,29
082 St.Martin in Thurn,40,,15,15,30
082 St.Martin in Thurn,41,,14,22,36
082 St.Martin in Thurn,42,,14,6,20
082 St.Martin in Thurn,43,,12,12,24
082 St.Martin in Thurn,44,,13,8,21
082 St.Martin in Thurn,45,,12,9,21
082 St.Martin in Thurn,46,,7,7,14
082 St.Martin in Thurn,47,,13,9,22
082 St.Martin in Thurn,48,,8,8,16
082 St.Martin in Thurn,49,,5,12,17
082 St.Martin in Thurn,50,,3,3,6
082 St.Martin in Thurn,51,,8,8,16
082 St.Martin in Thurn,52,,11,6,17
082 St.Martin in Thurn,53,,4,7,11
082 St.Martin in Thurn,54,,10,6,16
082 St.Martin in Thurn,55,,9,6,15
082 St.Martin in Thurn,56,,9,7,16
082 St.Martin in Thurn,57,,7,4,11
082 St.Martin in Thurn,58,,11,8,19
082 St.Martin in Thurn,59,,4,8,12
082 St.Martin in Thurn,60,,7,6,13
082 St.Martin in Thurn,61,,7,7,14
082 St.Martin in Thurn,62,,5,5,10
082 St.Martin in Thurn,63,,5,8,13
082 St.Martin in Thurn,64,,9,7,16
082 St.Martin in Thurn,65,,7,12,19
082 St.Martin in Thurn,66,,4,5,9
082 St.Martin in Thurn,67,,7,5,12
082 St.Martin in Thurn,68,,7,4,11
082 St.Martin in Thurn,69,,2,10,12
082 St.Martin in Thurn,70,,8,7,15
082 St.Martin in Thurn,71,,10,7,17
082 St.Martin in Thurn,72,,8,6,14
082 St.Martin in Thurn,73,,7,7,14
082 St.Martin in Thurn,74,,4,5,9
082 St.Martin in Thurn,75,,5,5,10
082 St.Martin in Thurn,76,,7,5,12
082 St.Martin in Thurn,77,,8,4,12
082 St.Martin in Thurn,78,,8,9,17
082 St.Martin in Thurn,79,,4,8,12
082 St.Martin in Thurn,80,,7,4,11
082 St.Martin in Thurn,81,,7,4,11
082 St.Martin in Thurn,82,,7,8,15
082 St.Martin in Thurn,83,,2,4,6
082 St.Martin in Thurn,84,,2,-,2
082 St.Martin in Thurn,85,,1,2,3
082 St.Martin in Thurn,86,,1,1,2
082 St.Martin in Thurn,87,,1,2,3
082 St.Martin in Thurn,88,,-,3,3
082 St.Martin in Thurn,89,,-,2,2
082 St.Martin in Thurn,90,,1,1,2
082 St.Martin in Thurn,91,,1,2,3
082 St.Martin in Thurn,92,,2,2,4
082 St.Martin in Thurn,93,,-,1,1
082 St.Martin in Thurn,94,,2,2,4
083 St.Martin in Passeier,0,,19,13,32
083 St.Martin in Passeier,1,,15,19,34
083 St.Martin in Passeier,2,,15,18,33
083 St.Martin in Passeier,3,,8,20,28
083 St.Martin in Passeier,4,,16,20,36
083 St.Martin in Passeier,5,,28,24,52
083 St.Martin in Passeier,6,,22,22,44
083 St.Martin in Passeier,7,,19,17,36
083 St.Martin in Passeier,8,,20,23,43
083 St.Martin in Passeier,9,,20,23,43
083 St.Martin in Passeier,10,,21,19,40
083 St.Martin in Passeier,11,,21,24,45
083 St.Martin in Passeier,12,,19,25,44
083 St.Martin in Passeier,13,,19,21,40
083 St.Martin in Passeier,14,,15,15,30
083 St.Martin in Passeier,15,,18,22,40
083 St.Martin in Passeier,16,,21,25,46
083 St.Martin in Passeier,17,,16,20,36
083 St.Martin in Passeier,18,,16,24,40
083 St.Martin in Passeier,19,,19,9,28
083 St.Martin in Passeier,20,,21,20,41
083 St.Martin in Passeier,21,,21,22,43
083 St.Martin in Passeier,22,,19,23,42
083 St.Martin in Passeier,23,,22,15,37
083 St.Martin in Passeier,24,,29,18,47
083 St.Martin in Passeier,25,,21,21,42
083 St.Martin in Passeier,26,,19,24,43
083 St.Martin in Passeier,27,,24,21,45
083 St.Martin in Passeier,28,,19,20,39
083 St.Martin in Passeier,29,,21,29,50
083 St.Martin in Passeier,30,,27,23,50
083 St.Martin in Passeier,31,,30,26,56
083 St.Martin in Passeier,32,,25,26,51
083 St.Martin in Passeier,33,,30,27,57
083 St.Martin in Passeier,34,,24,22,46
083 St.Martin in Passeier,35,,22,23,45
083 St.Martin in Passeier,36,,28,29,57
083 St.Martin in Passeier,37,,31,23,54
083 St.Martin in Passeier,38,,21,20,41
083 St.Martin in Passeier,39,,35,19,54
083 St.Martin in Passeier,40,,23,28,51
083 St.Martin in Passeier,41,,35,18,53
083 St.Martin in Passeier,42,,20,24,44
083 St.Martin in Passeier,43,,26,20,46
083 St.Martin in Passeier,44,,24,22,46
083 St.Martin in Passeier,45,,25,11,36
083 St.Martin in Passeier,46,,21,15,36
083 St.Martin in Passeier,47,,32,16,48
083 St.Martin in Passeier,48,,14,8,22
083 St.Martin in Passeier,49,,22,16,38
083 St.Martin in Passeier,50,,5,19,24
083 St.Martin in Passeier,51,,18,14,32
083 St.Martin in Passeier,52,,12,16,28
083 St.Martin in Passeier,53,,12,8,20
083 St.Martin in Passeier,54,,11,10,21
083 St.Martin in Passeier,55,,14,13,27
083 St.Martin in Passeier,56,,14,11,25
083 St.Martin in Passeier,57,,12,12,24
083 St.Martin in Passeier,58,,16,12,28
083 St.Martin in Passeier,59,,14,11,25
083 St.Martin in Passeier,60,,15,14,29
083 St.Martin in Passeier,61,,10,15,25
083 St.Martin in Passeier,62,,4,12,16
083 St.Martin in Passeier,63,,6,13,19
083 St.Martin in Passeier,64,,14,8,22
083 St.Martin in Passeier,65,,14,19,33
083 St.Martin in Passeier,66,,14,15,29
083 St.Martin in Passeier,67,,7,13,20
083 St.Martin in Passeier,68,,19,9,28
083 St.Martin in Passeier,69,,13,9,22
083 St.Martin in Passeier,70,,9,8,17
083 St.Martin in Passeier,71,,7,13,20
083 St.Martin in Passeier,72,,7,13,20
083 St.Martin in Passeier,73,,12,9,21
083 St.Martin in Passeier,74,,8,8,16
083 St.Martin in Passeier,75,,12,6,18
083 St.Martin in Passeier,76,,4,11,15
083 St.Martin in Passeier,77,,5,8,13
083 St.Martin in Passeier,78,,5,12,17
083 St.Martin in Passeier,79,,1,8,9
083 St.Martin in Passeier,80,,5,5,10
083 St.Martin in Passeier,81,,6,12,18
083 St.Martin in Passeier,82,,-,5,5
083 St.Martin in Passeier,83,,1,4,5
083 St.Martin in Passeier,84,,1,2,3
083 St.Martin in Passeier,85,,2,4,6
083 St.Martin in Passeier,86,,-,1,1
083 St.Martin in Passeier,87,,1,1,2
083 St.Martin in Passeier,88,,1,4,5
083 St.Martin in Passeier,89,,1,1,2
083 St.Martin in Passeier,90,,-,3,3
083 St.Martin in Passeier,91,,1,1,2
083 St.Martin in Passeier,92,,-,1,1
084 St.Pankraz,0,,7,4,11
084 St.Pankraz,1,,13,15,28
084 St.Pankraz,2,,13,16,29
084 St.Pankraz,3,,8,5,13
084 St.Pankraz,4,,13,6,19
084 St.Pankraz,5,,8,11,19
084 St.Pankraz,6,,12,10,22
084 St.Pankraz,7,,11,5,16
084 St.Pankraz,8,,9,9,18
084 St.Pankraz,9,,5,12,17
084 St.Pankraz,10,,6,8,14
084 St.Pankraz,11,,13,12,25
084 St.Pankraz,12,,9,4,13
084 St.Pankraz,13,,11,14,25
084 St.Pankraz,14,,14,7,21
084 St.Pankraz,15,,10,8,18
084 St.Pankraz,16,,9,6,15
084 St.Pankraz,17,,9,7,16
084 St.Pankraz,18,,10,5,15
084 St.Pankraz,19,,11,7,18
084 St.Pankraz,20,,11,9,20
084 St.Pankraz,21,,9,14,23
084 St.Pankraz,22,,13,9,22
084 St.Pankraz,23,,6,5,11
084 St.Pankraz,24,,14,10,24
084 St.Pankraz,25,,8,13,21
084 St.Pankraz,26,,6,11,17
084 St.Pankraz,27,,10,9,19
084 St.Pankraz,28,,15,12,27
084 St.Pankraz,29,,12,9,21
084 St.Pankraz,30,,11,15,26
084 St.Pankraz,31,,17,9,26
084 St.Pankraz,32,,12,9,21
084 St.Pankraz,33,,19,12,31
084 St.Pankraz,34,,19,19,38
084 St.Pankraz,35,,13,15,28
084 St.Pankraz,36,,14,7,21
084 St.Pankraz,37,,23,14,37
084 St.Pankraz,38,,15,15,30
084 St.Pankraz,39,,9,10,19
084 St.Pankraz,40,,17,7,24
084 St.Pankraz,41,,14,13,27
084 St.Pankraz,42,,13,6,19
084 St.Pankraz,43,,18,12,30
084 St.Pankraz,44,,7,9,16
084 St.Pankraz,45,,11,9,20
084 St.Pankraz,46,,10,15,25
084 St.Pankraz,47,,7,3,10
084 St.Pankraz,48,,10,8,18
084 St.Pankraz,49,,11,9,20
084 St.Pankraz,50,,15,10,25
084 St.Pankraz,51,,5,3,8
084 St.Pankraz,52,,11,6,17
084 St.Pankraz,53,,7,6,13
084 St.Pankraz,54,,8,3,11
084 St.Pankraz,55,,7,8,15
084 St.Pankraz,56,,4,8,12
084 St.Pankraz,57,,3,6,9
084 St.Pankraz,58,,5,8,13
084 St.Pankraz,59,,10,15,25
084 St.Pankraz,60,,9,14,23
084 St.Pankraz,61,,8,12,20
084 St.Pankraz,62,,9,6,15
084 St.Pankraz,63,,10,7,17
084 St.Pankraz,64,,5,11,16
084 St.Pankraz,65,,9,10,19
084 St.Pankraz,66,,6,5,11
084 St.Pankraz,67,,5,7,12
084 St.Pankraz,68,,7,7,14
084 St.Pankraz,69,,8,3,11
084 St.Pankraz,70,,7,9,16
084 St.Pankraz,71,,9,5,14
084 St.Pankraz,72,,8,7,15
084 St.Pankraz,73,,7,10,17
084 St.Pankraz,74,,8,9,17
084 St.Pankraz,75,,7,5,12
084 St.Pankraz,76,,6,6,12
084 St.Pankraz,77,,7,8,15
084 St.Pankraz,78,,6,8,14
084 St.Pankraz,79,,11,4,15
084 St.Pankraz,80,,9,8,17
084 St.Pankraz,81,,2,10,12
084 St.Pankraz,82,,2,10,12
084 St.Pankraz,83,,2,2,4
084 St.Pankraz,84,,2,2,4
084 St.Pankraz,85,,-,3,3
084 St.Pankraz,86,,2,-,2
084 St.Pankraz,87,,2,2,4
084 St.Pankraz,88,,1,1,2
084 St.Pankraz,89,,1,1,2
084 St.Pankraz,90,,1,2,3
084 St.Pankraz,91,,-,1,1
084 St.Pankraz,92,,1,1,2
084 St.Pankraz,93,,-,4,4
085 St.Christina in Gröden,0,,12,20,32
085 St.Christina in Gröden,1,,10,12,22
085 St.Christina in Gröden,2,,20,14,34
085 St.Christina in Gröden,3,,20,11,31
085 St.Christina in Gröden,4,,13,15,28
085 St.Christina in Gröden,5,,11,11,22
085 St.Christina in Gröden,6,,13,6,19
085 St.Christina in Gröden,7,,15,9,24
085 St.Christina in Gröden,8,,7,14,21
085 St.Christina in Gröden,9,,13,14,27
085 St.Christina in Gröden,10,,13,13,26
085 St.Christina in Gröden,11,,12,16,28
085 St.Christina in Gröden,12,,7,13,20
085 St.Christina in Gröden,13,,5,6,11
085 St.Christina in Gröden,14,,10,10,20
085 St.Christina in Gröden,15,,12,6,18
085 St.Christina in Gröden,16,,11,8,19
085 St.Christina in Gröden,17,,5,11,16
085 St.Christina in Gröden,18,,11,5,16
085 St.Christina in Gröden,19,,18,13,31
085 St.Christina in Gröden,20,,12,5,17
085 St.Christina in Gröden,21,,8,14,22
085 St.Christina in Gröden,22,,10,13,23
085 St.Christina in Gröden,23,,13,10,23
085 St.Christina in Gröden,24,,5,11,16
085 St.Christina in Gröden,25,,4,9,13
085 St.Christina in Gröden,26,,13,9,22
085 St.Christina in Gröden,27,,14,16,30
085 St.Christina in Gröden,28,,7,16,23
085 St.Christina in Gröden,29,,7,12,19
085 St.Christina in Gröden,30,,18,9,27
085 St.Christina in Gröden,31,,11,15,26
085 St.Christina in Gröden,32,,21,18,39
085 St.Christina in Gröden,33,,17,12,29
085 St.Christina in Gröden,34,,22,22,44
085 St.Christina in Gröden,35,,18,17,35
085 St.Christina in Gröden,36,,19,12,31
085 St.Christina in Gröden,37,,15,18,33
085 St.Christina in Gröden,38,,10,21,31
085 St.Christina in Gröden,39,,15,17,32
085 St.Christina in Gröden,40,,19,15,34
085 St.Christina in Gröden,41,,22,15,37
085 St.Christina in Gröden,42,,19,18,37
085 St.Christina in Gröden,43,,9,7,16
085 St.Christina in Gröden,44,,7,11,18
085 St.Christina in Gröden,45,,17,11,28
085 St.Christina in Gröden,46,,10,10,20
085 St.Christina in Gröden,47,,10,8,18
085 St.Christina in Gröden,48,,16,14,30
085 St.Christina in Gröden,49,,10,9,19
085 St.Christina in Gröden,50,,4,6,10
085 St.Christina in Gröden,51,,11,5,16
085 St.Christina in Gröden,52,,6,6,12
085 St.Christina in Gröden,53,,7,13,20
085 St.Christina in Gröden,54,,8,5,13
085 St.Christina in Gröden,55,,6,8,14
085 St.Christina in Gröden,56,,9,11,20
085 St.Christina in Gröden,57,,6,6,12
085 St.Christina in Gröden,58,,6,11,17
085 St.Christina in Gröden,59,,12,15,27
085 St.Christina in Gröden,60,,11,7,18
085 St.Christina in Gröden,61,,12,8,20
085 St.Christina in Gröden,62,,9,11,20
085 St.Christina in Gröden,63,,10,11,21
085 St.Christina in Gröden,64,,7,8,15
085 St.Christina in Gröden,65,,9,6,15
085 St.Christina in Gröden,66,,13,10,23
085 St.Christina in Gröden,67,,13,5,18
085 St.Christina in Gröden,68,,7,12,19
085 St.Christina in Gröden,69,,6,13,19
085 St.Christina in Gröden,70,,9,9,18
085 St.Christina in Gröden,71,,5,7,12
085 St.Christina in Gröden,72,,14,5,19
085 St.Christina in Gröden,73,,3,10,13
085 St.Christina in Gröden,74,,6,5,11
085 St.Christina in Gröden,75,,5,6,11
085 St.Christina in Gröden,76,,9,7,16
085 St.Christina in Gröden,77,,7,9,16
085 St.Christina in Gröden,78,,2,4,6
085 St.Christina in Gröden,79,,6,4,10
085 St.Christina in Gröden,80,,-,10,10
085 St.Christina in Gröden,81,,1,4,5
085 St.Christina in Gröden,82,,2,4,6
085 St.Christina in Gröden,83,,3,1,4
085 St.Christina in Gröden,84,,-,1,1
085 St.Christina in Gröden,86,,-,2,2
085 St.Christina in Gröden,87,,2,1,3
085 St.Christina in Gröden,88,,1,2,3
085 St.Christina in Gröden,89,,2,-,2
085 St.Christina in Gröden,90,,-,1,1
085 St.Christina in Gröden,92,,-,1,1
085 St.Christina in Gröden,93,,-,2,2
085 St.Christina in Gröden,95,,-,1,1
086 Sarntal,0,,29,45,74
086 Sarntal,1,,50,26,76
086 Sarntal,2,,37,42,79
086 Sarntal,3,,35,34,69
086 Sarntal,4,,50,43,93
086 Sarntal,5,,45,48,93
086 Sarntal,6,,48,41,89
086 Sarntal,7,,43,42,85
086 Sarntal,8,,33,41,74
086 Sarntal,9,,33,39,72
086 Sarntal,10,,46,35,81
086 Sarntal,11,,43,41,84
086 Sarntal,12,,44,33,77
086 Sarntal,13,,55,36,91
086 Sarntal,14,,45,42,87
086 Sarntal,15,,36,31,67
086 Sarntal,16,,37,43,80
086 Sarntal,17,,43,38,81
086 Sarntal,18,,39,42,81
086 Sarntal,19,,51,41,92
086 Sarntal,20,,62,49,111
086 Sarntal,21,,42,59,101
086 Sarntal,22,,59,46,105
086 Sarntal,23,,57,54,111
086 Sarntal,24,,59,55,114
086 Sarntal,25,,62,44,106
086 Sarntal,26,,52,42,94
086 Sarntal,27,,60,53,113
086 Sarntal,28,,52,62,114
086 Sarntal,29,,61,63,124
086 Sarntal,30,,69,41,110
086 Sarntal,31,,46,49,95
086 Sarntal,32,,69,59,128
086 Sarntal,33,,66,56,122
086 Sarntal,34,,53,43,96
086 Sarntal,35,,54,47,101
086 Sarntal,36,,54,51,105
086 Sarntal,37,,66,52,118
086 Sarntal,38,,61,61,122
086 Sarntal,39,,44,41,85
086 Sarntal,40,,60,34,94
086 Sarntal,41,,39,47,86
086 Sarntal,42,,65,46,111
086 Sarntal,43,,43,41,84
086 Sarntal,44,,53,44,97
086 Sarntal,45,,39,43,82
086 Sarntal,46,,43,31,74
086 Sarntal,47,,41,41,82
086 Sarntal,48,,36,28,64
086 Sarntal,49,,39,30,69
086 Sarntal,50,,38,41,79
086 Sarntal,51,,46,34,80
086 Sarntal,52,,37,35,72
086 Sarntal,53,,50,25,75
086 Sarntal,54,,33,38,71
086 Sarntal,55,,39,28,67
086 Sarntal,56,,37,37,74
086 Sarntal,57,,29,33,62
086 Sarntal,58,,29,31,60
086 Sarntal,59,,41,41,82
086 Sarntal,60,,40,39,79
086 Sarntal,61,,34,32,66
086 Sarntal,62,,29,43,72
086 Sarntal,63,,41,32,73
086 Sarntal,64,,32,27,59
086 Sarntal,65,,26,33,59
086 Sarntal,66,,22,25,47
086 Sarntal,67,,23,25,48
086 Sarntal,68,,27,19,46
086 Sarntal,69,,23,24,47
086 Sarntal,70,,29,26,55
086 Sarntal,71,,19,25,44
086 Sarntal,72,,19,25,44
086 Sarntal,73,,20,30,50
086 Sarntal,74,,21,28,49
086 Sarntal,75,,18,32,50
086 Sarntal,76,,20,14,34
086 Sarntal,77,,19,22,41
086 Sarntal,78,,15,25,40
086 Sarntal,79,,10,24,34
086 Sarntal,80,,14,32,46
086 Sarntal,81,,7,13,20
086 Sarntal,82,,12,16,28
086 Sarntal,83,,3,16,19
086 Sarntal,84,,2,8,10
086 Sarntal,85,,3,8,11
086 Sarntal,86,,-,7,7
086 Sarntal,87,,2,5,7
086 Sarntal,88,,4,5,9
086 Sarntal,89,,7,10,17
086 Sarntal,90,,3,9,12
086 Sarntal,91,,2,4,6
086 Sarntal,92,,1,6,7
086 Sarntal,93,,1,3,4
086 Sarntal,94,,-,1,1
086 Sarntal,95,,1,2,3
086 Sarntal,101,,-,1,1
087 Schenna,0,,12,16,28
087 Schenna,1,,20,12,32
087 Schenna,2,,21,17,38
087 Schenna,3,,21,16,37
087 Schenna,4,,18,10,28
087 Schenna,5,,11,18,29
087 Schenna,6,,19,16,35
087 Schenna,7,,17,17,34
087 Schenna,8,,21,17,38
087 Schenna,9,,13,9,22
087 Schenna,10,,16,16,32
087 Schenna,11,,12,20,32
087 Schenna,12,,19,15,34
087 Schenna,13,,20,10,30
087 Schenna,14,,21,19,40
087 Schenna,15,,22,18,40
087 Schenna,16,,18,13,31
087 Schenna,17,,16,16,32
087 Schenna,18,,18,13,31
087 Schenna,19,,16,15,31
087 Schenna,20,,11,16,27
087 Schenna,21,,23,10,33
087 Schenna,22,,19,18,37
087 Schenna,23,,24,20,44
087 Schenna,24,,14,16,30
087 Schenna,25,,17,16,33
087 Schenna,26,,23,16,39
087 Schenna,27,,17,27,44
087 Schenna,28,,31,21,52
087 Schenna,29,,28,24,52
087 Schenna,30,,27,16,43
087 Schenna,31,,30,26,56
087 Schenna,32,,23,24,47
087 Schenna,33,,24,21,45
087 Schenna,34,,21,21,42
087 Schenna,35,,29,20,49
087 Schenna,36,,16,21,37
087 Schenna,37,,23,26,49
087 Schenna,38,,21,24,45
087 Schenna,39,,27,20,47
087 Schenna,40,,22,13,35
087 Schenna,41,,30,21,51
087 Schenna,42,,32,24,56
087 Schenna,43,,15,13,28
087 Schenna,44,,20,19,39
087 Schenna,45,,13,18,31
087 Schenna,46,,17,16,33
087 Schenna,47,,12,15,27
087 Schenna,48,,14,18,32
087 Schenna,49,,15,15,30
087 Schenna,50,,14,16,30
087 Schenna,51,,14,12,26
087 Schenna,52,,19,14,33
087 Schenna,53,,20,19,39
087 Schenna,54,,15,15,30
087 Schenna,55,,16,17,33
087 Schenna,56,,18,23,41
087 Schenna,57,,15,13,28
087 Schenna,58,,17,10,27
087 Schenna,59,,20,11,31
087 Schenna,60,,11,19,30
087 Schenna,61,,12,13,25
087 Schenna,62,,10,9,19
087 Schenna,63,,11,14,25
087 Schenna,64,,17,19,36
087 Schenna,65,,7,10,17
087 Schenna,66,,8,11,19
087 Schenna,67,,14,10,24
087 Schenna,68,,13,14,27
087 Schenna,69,,7,9,16
087 Schenna,70,,11,12,23
087 Schenna,71,,13,13,26
087 Schenna,72,,12,7,19
087 Schenna,73,,7,11,18
087 Schenna,74,,7,10,17
087 Schenna,75,,5,15,20
087 Schenna,76,,6,7,13
087 Schenna,77,,4,10,14
087 Schenna,78,,9,8,17
087 Schenna,79,,5,4,9
087 Schenna,80,,10,5,15
087 Schenna,81,,6,13,19
087 Schenna,82,,5,5,10
087 Schenna,83,,2,6,8
087 Schenna,84,,-,4,4
087 Schenna,85,,1,1,2
087 Schenna,86,,1,1,2
087 Schenna,87,,2,2,4
087 Schenna,88,,3,5,8
087 Schenna,89,,-,2,2
087 Schenna,90,,4,2,6
087 Schenna,92,,1,1,2
087 Schenna,93,,1,1,2
087 Schenna,96,,-,1,1
087 Schenna,98,,-,1,1
087 Schenna,102,,-,1,1
088 Mühlwald,0,,9,13,22
088 Mühlwald,1,,10,13,23
088 Mühlwald,2,,8,11,19
088 Mühlwald,3,,12,8,20
088 Mühlwald,4,,12,14,26
088 Mühlwald,5,,11,8,19
088 Mühlwald,6,,14,13,27
088 Mühlwald,7,,13,4,17
088 Mühlwald,8,,9,6,15
088 Mühlwald,9,,13,12,25
088 Mühlwald,10,,5,7,12
088 Mühlwald,11,,11,6,17
088 Mühlwald,12,,9,6,15
088 Mühlwald,13,,16,8,24
088 Mühlwald,14,,7,3,10
088 Mühlwald,15,,9,14,23
088 Mühlwald,16,,6,7,13
088 Mühlwald,17,,11,17,28
088 Mühlwald,18,,11,18,29
088 Mühlwald,19,,12,9,21
088 Mühlwald,20,,8,17,25
088 Mühlwald,21,,16,14,30
088 Mühlwald,22,,21,5,26
088 Mühlwald,23,,7,20,27
088 Mühlwald,24,,12,9,21
088 Mühlwald,25,,8,8,16
088 Mühlwald,26,,13,10,23
088 Mühlwald,27,,11,10,21
088 Mühlwald,28,,10,7,17
088 Mühlwald,29,,17,8,25
088 Mühlwald,30,,10,11,21
088 Mühlwald,31,,17,16,33
088 Mühlwald,32,,9,10,19
088 Mühlwald,33,,14,17,31
088 Mühlwald,34,,17,10,27
088 Mühlwald,35,,18,14,32
088 Mühlwald,36,,15,8,23
088 Mühlwald,37,,18,13,31
088 Mühlwald,38,,17,8,25
088 Mühlwald,39,,11,11,22
088 Mühlwald,40,,9,11,20
088 Mühlwald,41,,6,10,16
088 Mühlwald,42,,15,9,24
088 Mühlwald,43,,14,5,19
088 Mühlwald,44,,10,7,17
088 Mühlwald,45,,14,12,26
088 Mühlwald,46,,8,8,16
088 Mühlwald,47,,7,7,14
088 Mühlwald,48,,10,4,14
088 Mühlwald,49,,10,9,19
088 Mühlwald,50,,10,8,18
088 Mühlwald,51,,9,4,13
088 Mühlwald,52,,5,9,14
088 Mühlwald,53,,9,3,12
088 Mühlwald,54,,12,4,16
088 Mühlwald,55,,10,7,17
088 Mühlwald,56,,8,3,11
088 Mühlwald,57,,5,4,9
088 Mühlwald,58,,8,4,12
088 Mühlwald,59,,10,2,12
088 Mühlwald,60,,6,7,13
088 Mühlwald,61,,4,7,11
088 Mühlwald,62,,3,8,11
088 Mühlwald,63,,6,11,17
088 Mühlwald,64,,9,4,13
088 Mühlwald,65,,11,3,14
088 Mühlwald,66,,4,3,7
088 Mühlwald,67,,5,3,8
088 Mühlwald,68,,3,8,11
088 Mühlwald,69,,4,10,14
088 Mühlwald,70,,1,2,3
088 Mühlwald,71,,6,6,12
088 Mühlwald,72,,5,5,10
088 Mühlwald,73,,7,9,16
088 Mühlwald,74,,4,4,8
088 Mühlwald,75,,9,2,11
088 Mühlwald,76,,4,5,9
088 Mühlwald,77,,3,3,6
088 Mühlwald,78,,6,5,11
088 Mühlwald,79,,1,6,7
088 Mühlwald,80,,1,4,5
088 Mühlwald,81,,-,5,5
088 Mühlwald,82,,2,1,3
088 Mühlwald,83,,-,2,2
088 Mühlwald,84,,1,2,3
088 Mühlwald,85,,4,2,6
088 Mühlwald,86,,-,1,1
088 Mühlwald,87,,-,3,3
088 Mühlwald,88,,1,1,2
088 Mühlwald,89,,-,2,2
088 Mühlwald,91,,-,2,2
088 Mühlwald,94,,1,-,1
089 Wolkenstein in Gröden,0,,25,14,39
089 Wolkenstein in Gröden,1,,21,19,40
089 Wolkenstein in Gröden,2,,20,21,41
089 Wolkenstein in Gröden,3,,13,20,33
089 Wolkenstein in Gröden,4,,16,24,40
089 Wolkenstein in Gröden,5,,22,29,51
089 Wolkenstein in Gröden,6,,15,12,27
089 Wolkenstein in Gröden,7,,18,12,30
089 Wolkenstein in Gröden,8,,16,17,33
089 Wolkenstein in Gröden,9,,12,13,25
089 Wolkenstein in Gröden,10,,23,14,37
089 Wolkenstein in Gröden,11,,19,16,35
089 Wolkenstein in Gröden,12,,13,12,25
089 Wolkenstein in Gröden,13,,17,14,31
089 Wolkenstein in Gröden,14,,17,17,34
089 Wolkenstein in Gröden,15,,11,20,31
089 Wolkenstein in Gröden,16,,16,14,30
089 Wolkenstein in Gröden,17,,17,11,28
089 Wolkenstein in Gröden,18,,13,11,24
089 Wolkenstein in Gröden,19,,16,11,27
089 Wolkenstein in Gröden,20,,11,16,27
089 Wolkenstein in Gröden,21,,16,12,28
089 Wolkenstein in Gröden,22,,15,15,30
089 Wolkenstein in Gröden,23,,6,14,20
089 Wolkenstein in Gröden,24,,7,9,16
089 Wolkenstein in Gröden,25,,11,13,24
089 Wolkenstein in Gröden,26,,18,15,33
089 Wolkenstein in Gröden,27,,20,17,37
089 Wolkenstein in Gröden,28,,11,19,30
089 Wolkenstein in Gröden,29,,27,21,48
089 Wolkenstein in Gröden,30,,17,19,36
089 Wolkenstein in Gröden,31,,20,26,46
089 Wolkenstein in Gröden,32,,21,25,46
089 Wolkenstein in Gröden,33,,28,20,48
089 Wolkenstein in Gröden,34,,27,29,56
089 Wolkenstein in Gröden,35,,31,25,56
089 Wolkenstein in Gröden,36,,29,22,51
089 Wolkenstein in Gröden,37,,25,31,56
089 Wolkenstein in Gröden,38,,29,22,51
089 Wolkenstein in Gröden,39,,21,20,41
089 Wolkenstein in Gröden,40,,20,25,45
089 Wolkenstein in Gröden,41,,25,29,54
089 Wolkenstein in Gröden,42,,24,22,46
089 Wolkenstein in Gröden,43,,17,17,34
089 Wolkenstein in Gröden,44,,20,16,36
089 Wolkenstein in Gröden,45,,20,16,36
089 Wolkenstein in Gröden,46,,12,13,25
089 Wolkenstein in Gröden,47,,15,10,25
089 Wolkenstein in Gröden,48,,16,9,25
089 Wolkenstein in Gröden,49,,8,14,22
089 Wolkenstein in Gröden,50,,13,6,19
089 Wolkenstein in Gröden,51,,14,11,25
089 Wolkenstein in Gröden,52,,6,17,23
089 Wolkenstein in Gröden,53,,17,12,29
089 Wolkenstein in Gröden,54,,14,14,28
089 Wolkenstein in Gröden,55,,10,17,27
089 Wolkenstein in Gröden,56,,16,19,35
089 Wolkenstein in Gröden,57,,5,14,19
089 Wolkenstein in Gröden,58,,14,10,24
089 Wolkenstein in Gröden,59,,21,16,37
089 Wolkenstein in Gröden,60,,13,12,25
089 Wolkenstein in Gröden,61,,16,19,35
089 Wolkenstein in Gröden,62,,16,18,34
089 Wolkenstein in Gröden,63,,17,15,32
089 Wolkenstein in Gröden,64,,20,7,27
089 Wolkenstein in Gröden,65,,11,19,30
089 Wolkenstein in Gröden,66,,11,15,26
089 Wolkenstein in Gröden,67,,14,9,23
089 Wolkenstein in Gröden,68,,17,10,27
089 Wolkenstein in Gröden,69,,7,11,18
089 Wolkenstein in Gröden,70,,5,9,14
089 Wolkenstein in Gröden,71,,8,10,18
089 Wolkenstein in Gröden,72,,10,11,21
089 Wolkenstein in Gröden,73,,8,7,15
089 Wolkenstein in Gröden,74,,6,10,16
089 Wolkenstein in Gröden,75,,11,7,18
089 Wolkenstein in Gröden,76,,9,6,15
089 Wolkenstein in Gröden,77,,6,7,13
089 Wolkenstein in Gröden,78,,3,12,15
089 Wolkenstein in Gröden,79,,5,6,11
089 Wolkenstein in Gröden,80,,5,10,15
089 Wolkenstein in Gröden,81,,2,5,7
089 Wolkenstein in Gröden,82,,3,4,7
089 Wolkenstein in Gröden,83,,1,3,4
089 Wolkenstein in Gröden,84,,-,2,2
089 Wolkenstein in Gröden,85,,1,3,4
089 Wolkenstein in Gröden,86,,-,1,1
089 Wolkenstein in Gröden,87,,-,4,4
089 Wolkenstein in Gröden,88,,1,2,3
089 Wolkenstein in Gröden,89,,-,2,2
089 Wolkenstein in Gröden,90,,-,5,5
089 Wolkenstein in Gröden,91,,-,3,3
089 Wolkenstein in Gröden,92,,1,-,1
089 Wolkenstein in Gröden,93,,-,2,2
089 Wolkenstein in Gröden,94,,-,2,2
089 Wolkenstein in Gröden,95,,-,1,1
091 Schnals,0,,13,-,13
091 Schnals,1,,6,6,12
091 Schnals,2,,5,4,9
091 Schnals,3,,6,10,16
091 Schnals,4,,6,16,22
091 Schnals,5,,12,10,22
091 Schnals,6,,7,13,20
091 Schnals,7,,4,10,14
091 Schnals,8,,5,7,12
091 Schnals,9,,11,5,16
091 Schnals,10,,13,10,23
091 Schnals,11,,12,9,21
091 Schnals,12,,5,7,12
091 Schnals,13,,20,9,29
091 Schnals,14,,10,5,15
091 Schnals,15,,12,11,23
091 Schnals,16,,9,10,19
091 Schnals,17,,7,9,16
091 Schnals,18,,12,16,28
091 Schnals,19,,9,10,19
091 Schnals,20,,10,6,16
091 Schnals,21,,16,11,27
091 Schnals,22,,14,11,25
091 Schnals,23,,12,10,22
091 Schnals,24,,12,11,23
091 Schnals,25,,8,8,16
091 Schnals,26,,12,2,14
091 Schnals,27,,6,7,13
091 Schnals,28,,15,8,23
091 Schnals,29,,7,10,17
091 Schnals,30,,10,8,18
091 Schnals,31,,11,11,22
091 Schnals,32,,13,11,24
091 Schnals,33,,13,10,23
091 Schnals,34,,11,9,20
091 Schnals,35,,16,11,27
091 Schnals,36,,14,15,29
091 Schnals,37,,16,8,24
091 Schnals,38,,7,9,16
091 Schnals,39,,10,15,25
091 Schnals,40,,16,12,28
091 Schnals,41,,12,14,26
091 Schnals,42,,10,8,18
091 Schnals,43,,16,13,29
091 Schnals,44,,13,11,24
091 Schnals,45,,12,5,17
091 Schnals,46,,14,5,19
091 Schnals,47,,9,6,15
091 Schnals,48,,10,9,19
091 Schnals,49,,13,9,22
091 Schnals,50,,13,7,20
091 Schnals,51,,11,8,19
091 Schnals,52,,10,7,17
091 Schnals,53,,10,9,19
091 Schnals,54,,3,3,6
091 Schnals,55,,10,8,18
091 Schnals,56,,5,6,11
091 Schnals,57,,8,4,12
091 Schnals,58,,4,7,11
091 Schnals,59,,6,10,16
091 Schnals,60,,4,4,8
091 Schnals,61,,5,5,10
091 Schnals,62,,7,7,14
091 Schnals,63,,7,7,14
091 Schnals,64,,2,11,13
091 Schnals,65,,7,5,12
091 Schnals,66,,6,6,12
091 Schnals,67,,3,5,8
091 Schnals,68,,2,4,6
091 Schnals,69,,6,4,10
091 Schnals,70,,3,9,12
091 Schnals,71,,3,5,8
091 Schnals,72,,-,5,5
091 Schnals,73,,6,6,12
091 Schnals,74,,2,7,9
091 Schnals,75,,3,6,9
091 Schnals,76,,9,3,12
091 Schnals,77,,7,11,18
091 Schnals,78,,1,6,7
091 Schnals,79,,1,2,3
091 Schnals,80,,7,4,11
091 Schnals,81,,1,5,6
091 Schnals,82,,2,4,6
091 Schnals,83,,1,1,2
091 Schnals,84,,3,3,6
091 Schnals,85,,-,3,3
091 Schnals,86,,-,2,2
091 Schnals,87,,2,2,4
091 Schnals,88,,-,2,2
091 Schnals,89,,-,1,1
091 Schnals,90,,2,2,4
091 Schnals,91,,-,2,2
091 Schnals,92,,-,1,1
091 Schnals,93,,-,1,1
092 Sexten,0,,17,17,34
092 Sexten,1,,18,11,29
092 Sexten,2,,8,13,21
092 Sexten,3,,8,17,25
092 Sexten,4,,11,8,19
092 Sexten,5,,11,10,21
092 Sexten,6,,12,12,24
092 Sexten,7,,15,14,29
092 Sexten,8,,16,11,27
092 Sexten,9,,8,5,13
092 Sexten,10,,13,10,23
092 Sexten,11,,11,12,23
092 Sexten,12,,10,19,29
092 Sexten,13,,9,9,18
092 Sexten,14,,10,6,16
092 Sexten,15,,12,9,21
092 Sexten,16,,6,9,15
092 Sexten,17,,12,11,23
092 Sexten,18,,6,10,16
092 Sexten,19,,11,9,20
092 Sexten,20,,11,19,30
092 Sexten,21,,15,13,28
092 Sexten,22,,16,8,24
092 Sexten,23,,12,19,31
092 Sexten,24,,10,12,22
092 Sexten,25,,9,6,15
092 Sexten,26,,17,10,27
092 Sexten,27,,10,6,16
092 Sexten,28,,8,7,15
092 Sexten,29,,11,8,19
092 Sexten,30,,16,14,30
092 Sexten,31,,11,15,26
092 Sexten,32,,11,20,31
092 Sexten,33,,22,16,38
092 Sexten,34,,16,17,33
092 Sexten,35,,19,18,37
092 Sexten,36,,17,17,34
092 Sexten,37,,19,18,37
092 Sexten,38,,20,19,39
092 Sexten,39,,28,18,46
092 Sexten,40,,16,14,30
092 Sexten,41,,19,14,33
092 Sexten,42,,19,10,29
092 Sexten,43,,16,15,31
092 Sexten,44,,22,15,37
092 Sexten,45,,17,13,30
092 Sexten,46,,13,14,27
092 Sexten,47,,10,13,23
092 Sexten,48,,11,11,22
092 Sexten,49,,6,11,17
092 Sexten,50,,6,11,17
092 Sexten,51,,7,8,15
092 Sexten,52,,13,7,20
092 Sexten,53,,6,6,12
092 Sexten,54,,10,7,17
092 Sexten,55,,11,4,15
092 Sexten,56,,6,9,15
092 Sexten,57,,9,4,13
092 Sexten,58,,7,12,19
092 Sexten,59,,8,6,14
092 Sexten,60,,5,7,12
092 Sexten,61,,10,15,25
092 Sexten,62,,9,14,23
092 Sexten,63,,7,10,17
092 Sexten,64,,14,12,26
092 Sexten,65,,12,9,21
092 Sexten,66,,7,11,18
092 Sexten,67,,11,16,27
092 Sexten,68,,12,7,19
092 Sexten,69,,5,11,16
092 Sexten,70,,7,8,15
092 Sexten,71,,10,13,23
092 Sexten,72,,9,12,21
092 Sexten,73,,8,13,21
092 Sexten,74,,11,12,23
092 Sexten,75,,12,17,29
092 Sexten,76,,7,3,10
092 Sexten,77,,6,12,18
092 Sexten,78,,6,7,13
092 Sexten,79,,6,10,16
092 Sexten,80,,8,9,17
092 Sexten,81,,4,8,12
092 Sexten,82,,2,4,6
092 Sexten,83,,2,4,6
092 Sexten,84,,-,1,1
092 Sexten,85,,1,1,2
092 Sexten,86,,-,2,2
092 Sexten,87,,1,-,1
092 Sexten,88,,1,1,2
092 Sexten,89,,-,3,3
092 Sexten,90,,1,5,6
092 Sexten,93,,-,1,1
092 Sexten,94,,-,2,2
092 Sexten,97,,-,1,1
092 Sexten,99,,-,1,1
093 Schlanders,0,,26,27,53
093 Schlanders,1,,31,35,66
093 Schlanders,2,,40,35,75
093 Schlanders,3,,33,40,73
093 Schlanders,4,,45,37,82
093 Schlanders,5,,55,48,103
093 Schlanders,6,,48,38,86
093 Schlanders,7,,37,28,65
093 Schlanders,8,,41,39,80
093 Schlanders,9,,44,43,87
093 Schlanders,10,,35,40,75
093 Schlanders,11,,41,39,80
093 Schlanders,12,,49,41,90
093 Schlanders,13,,37,35,72
093 Schlanders,14,,34,43,77
093 Schlanders,15,,36,30,66
093 Schlanders,16,,36,35,71
093 Schlanders,17,,41,37,78
093 Schlanders,18,,39,37,76
093 Schlanders,19,,32,36,68
093 Schlanders,20,,51,38,89
093 Schlanders,21,,44,31,75
093 Schlanders,22,,33,34,67
093 Schlanders,23,,33,39,72
093 Schlanders,24,,50,33,83
093 Schlanders,25,,36,38,74
093 Schlanders,26,,39,29,68
093 Schlanders,27,,38,38,76
093 Schlanders,28,,49,37,86
093 Schlanders,29,,42,48,90
093 Schlanders,30,,54,44,98
093 Schlanders,31,,52,48,100
093 Schlanders,32,,48,49,97
093 Schlanders,33,,58,43,101
093 Schlanders,34,,52,43,95
093 Schlanders,35,,52,49,101
093 Schlanders,36,,49,54,103
093 Schlanders,37,,54,47,101
093 Schlanders,38,,43,44,87
093 Schlanders,39,,56,58,114
093 Schlanders,40,,57,43,100
093 Schlanders,41,,48,55,103
093 Schlanders,42,,44,44,88
093 Schlanders,43,,41,40,81
093 Schlanders,44,,48,54,102
093 Schlanders,45,,43,34,77
093 Schlanders,46,,27,35,62
093 Schlanders,47,,29,37,66
093 Schlanders,48,,32,34,66
093 Schlanders,49,,34,37,71
093 Schlanders,50,,30,23,53
093 Schlanders,51,,30,32,62
093 Schlanders,52,,25,32,57
093 Schlanders,53,,29,35,64
093 Schlanders,54,,37,26,63
093 Schlanders,55,,23,24,47
093 Schlanders,56,,31,21,52
093 Schlanders,57,,31,15,46
093 Schlanders,58,,28,31,59
093 Schlanders,59,,31,32,63
093 Schlanders,60,,38,37,75
093 Schlanders,61,,34,36,70
093 Schlanders,62,,29,28,57
093 Schlanders,63,,28,36,64
093 Schlanders,64,,17,20,37
093 Schlanders,65,,28,26,54
093 Schlanders,66,,21,27,48
093 Schlanders,67,,16,25,41
093 Schlanders,68,,20,22,42
093 Schlanders,69,,20,31,51
093 Schlanders,70,,23,17,40
093 Schlanders,71,,23,18,41
093 Schlanders,72,,18,28,46
093 Schlanders,73,,12,17,29
093 Schlanders,74,,19,22,41
093 Schlanders,75,,19,25,44
093 Schlanders,76,,15,25,40
093 Schlanders,77,,11,18,29
093 Schlanders,78,,13,19,32
093 Schlanders,79,,10,18,28
093 Schlanders,80,,7,15,22
093 Schlanders,81,,8,10,18
093 Schlanders,82,,3,20,23
093 Schlanders,83,,5,13,18
093 Schlanders,84,,7,15,22
093 Schlanders,85,,6,2,8
093 Schlanders,86,,2,9,11
093 Schlanders,87,,4,2,6
093 Schlanders,88,,4,9,13
093 Schlanders,89,,3,9,12
093 Schlanders,90,,1,7,8
093 Schlanders,91,,2,6,8
093 Schlanders,92,,1,4,5
093 Schlanders,93,,-,4,4
093 Schlanders,94,,1,2,3
093 Schlanders,96,,-,2,2
093 Schlanders,98,,-,1,1
093 Schlanders,99,,-,2,2
094 Schluderns,0,,15,8,23
094 Schluderns,1,,12,8,20
094 Schluderns,2,,18,10,28
094 Schluderns,3,,10,14,24
094 Schluderns,4,,7,10,17
094 Schluderns,5,,13,11,24
094 Schluderns,6,,11,16,27
094 Schluderns,7,,9,13,22
094 Schluderns,8,,15,20,35
094 Schluderns,9,,18,7,25
094 Schluderns,10,,8,8,16
094 Schluderns,11,,9,9,18
094 Schluderns,12,,21,7,28
094 Schluderns,13,,15,13,28
094 Schluderns,14,,12,14,26
094 Schluderns,15,,6,10,16
094 Schluderns,16,,13,21,34
094 Schluderns,17,,18,11,29
094 Schluderns,18,,16,11,27
094 Schluderns,19,,13,9,22
094 Schluderns,20,,8,12,20
094 Schluderns,21,,20,14,34
094 Schluderns,22,,7,7,14
094 Schluderns,23,,7,20,27
094 Schluderns,24,,14,11,25
094 Schluderns,25,,16,12,28
094 Schluderns,26,,9,13,22
094 Schluderns,27,,15,9,24
094 Schluderns,28,,15,15,30
094 Schluderns,29,,23,15,38
094 Schluderns,30,,13,15,28
094 Schluderns,31,,12,15,27
094 Schluderns,32,,11,15,26
094 Schluderns,33,,19,9,28
094 Schluderns,34,,19,15,34
094 Schluderns,35,,16,17,33
094 Schluderns,36,,17,18,35
094 Schluderns,37,,25,10,35
094 Schluderns,38,,26,11,37
094 Schluderns,39,,15,19,34
094 Schluderns,40,,12,23,35
094 Schluderns,41,,18,16,34
094 Schluderns,42,,10,6,16
094 Schluderns,43,,13,19,32
094 Schluderns,44,,11,12,23
094 Schluderns,45,,17,7,24
094 Schluderns,46,,10,17,27
094 Schluderns,47,,17,11,28
094 Schluderns,48,,13,7,20
094 Schluderns,49,,11,7,18
094 Schluderns,50,,7,6,13
094 Schluderns,51,,11,3,14
094 Schluderns,52,,7,14,21
094 Schluderns,53,,14,10,24
094 Schluderns,54,,10,8,18
094 Schluderns,55,,7,6,13
094 Schluderns,56,,8,9,17
094 Schluderns,57,,7,3,10
094 Schluderns,58,,4,12,16
094 Schluderns,59,,3,8,11
094 Schluderns,60,,7,8,15
094 Schluderns,61,,11,13,24
094 Schluderns,62,,8,5,13
094 Schluderns,63,,12,8,20
094 Schluderns,64,,8,11,19
094 Schluderns,65,,7,10,17
094 Schluderns,66,,6,7,13
094 Schluderns,67,,6,10,16
094 Schluderns,68,,10,11,21
094 Schluderns,69,,5,9,14
094 Schluderns,70,,12,9,21
094 Schluderns,71,,4,8,12
094 Schluderns,72,,7,10,17
094 Schluderns,73,,9,7,16
094 Schluderns,74,,6,10,16
094 Schluderns,75,,6,1,7
094 Schluderns,76,,4,13,17
094 Schluderns,77,,3,7,10
094 Schluderns,78,,3,4,7
094 Schluderns,79,,1,6,7
094 Schluderns,80,,8,6,14
094 Schluderns,81,,2,8,10
094 Schluderns,82,,2,3,5
094 Schluderns,83,,3,5,8
094 Schluderns,84,,3,2,5
094 Schluderns,85,,1,3,4
094 Schluderns,86,,1,4,5
094 Schluderns,87,,1,3,4
094 Schluderns,88,,1,1,2
094 Schluderns,89,,1,-,1
094 Schluderns,90,,-,2,2
094 Schluderns,91,,-,1,1
094 Schluderns,92,,-,1,1
094 Schluderns,93,,-,2,2
094 Schluderns,94,,-,1,1
095 Stilfs,0,,4,3,7
095 Stilfs,1,,7,11,18
095 Stilfs,2,,11,4,15
095 Stilfs,3,,2,7,9
095 Stilfs,4,,8,3,11
095 Stilfs,5,,10,12,22
095 Stilfs,6,,12,2,14
095 Stilfs,7,,7,6,13
095 Stilfs,8,,8,7,15
095 Stilfs,9,,5,15,20
095 Stilfs,10,,4,9,13
095 Stilfs,11,,11,5,16
095 Stilfs,12,,17,7,24
095 Stilfs,13,,10,6,16
095 Stilfs,14,,6,4,10
095 Stilfs,15,,6,7,13
095 Stilfs,16,,8,8,16
095 Stilfs,17,,12,5,17
095 Stilfs,18,,15,5,20
095 Stilfs,19,,8,7,15
095 Stilfs,20,,12,4,16
095 Stilfs,21,,9,3,12
095 Stilfs,22,,9,4,13
095 Stilfs,23,,5,9,14
095 Stilfs,24,,10,5,15
095 Stilfs,25,,8,10,18
095 Stilfs,26,,13,5,18
095 Stilfs,27,,11,9,20
095 Stilfs,28,,9,8,17
095 Stilfs,29,,6,22,28
095 Stilfs,30,,15,10,25
095 Stilfs,31,,14,13,27
095 Stilfs,32,,10,15,25
095 Stilfs,33,,13,14,27
095 Stilfs,34,,11,12,23
095 Stilfs,35,,9,10,19
095 Stilfs,36,,16,8,24
095 Stilfs,37,,10,10,20
095 Stilfs,38,,11,5,16
095 Stilfs,39,,10,5,15
095 Stilfs,40,,12,15,27
095 Stilfs,41,,10,2,12
095 Stilfs,42,,8,6,14
095 Stilfs,43,,10,8,18
095 Stilfs,44,,6,12,18
095 Stilfs,45,,9,6,15
095 Stilfs,46,,6,12,18
095 Stilfs,47,,4,3,7
095 Stilfs,48,,14,8,22
095 Stilfs,49,,11,5,16
095 Stilfs,50,,12,5,17
095 Stilfs,51,,12,10,22
095 Stilfs,52,,3,8,11
095 Stilfs,53,,8,3,11
095 Stilfs,54,,9,10,19
095 Stilfs,55,,6,5,11
095 Stilfs,56,,9,10,19
095 Stilfs,57,,2,4,6
095 Stilfs,58,,13,8,21
095 Stilfs,59,,9,8,17
095 Stilfs,60,,5,13,18
095 Stilfs,61,,9,4,13
095 Stilfs,62,,7,11,18
095 Stilfs,63,,5,10,15
095 Stilfs,64,,6,5,11
095 Stilfs,65,,7,6,13
095 Stilfs,66,,3,10,13
095 Stilfs,67,,3,7,10
095 Stilfs,68,,6,4,10
095 Stilfs,69,,4,6,10
095 Stilfs,70,,5,7,12
095 Stilfs,71,,3,4,7
095 Stilfs,72,,6,7,13
095 Stilfs,73,,6,1,7
095 Stilfs,74,,4,8,12
095 Stilfs,75,,5,7,12
095 Stilfs,76,,4,5,9
095 Stilfs,77,,6,3,9
095 Stilfs,78,,1,9,10
095 Stilfs,79,,4,5,9
095 Stilfs,80,,2,5,7
095 Stilfs,81,,2,5,7
095 Stilfs,82,,2,10,12
095 Stilfs,83,,2,1,3
095 Stilfs,84,,2,2,4
095 Stilfs,85,,-,3,3
095 Stilfs,86,,-,3,3
095 Stilfs,87,,1,-,1
095 Stilfs,88,,2,3,5
095 Stilfs,89,,-,1,1
095 Stilfs,90,,-,3,3
095 Stilfs,91,,-,2,2
095 Stilfs,92,,-,2,2
095 Stilfs,93,,-,3,3
095 Stilfs,96,,-,1,1
096 Terenten,0,,8,8,16
096 Terenten,1,,10,12,22
096 Terenten,2,,11,9,20
096 Terenten,3,,8,18,26
096 Terenten,4,,20,19,39
096 Terenten,5,,9,7,16
096 Terenten,6,,13,11,24
096 Terenten,7,,12,8,20
096 Terenten,8,,14,14,28
096 Terenten,9,,6,13,19
096 Terenten,10,,10,8,18
096 Terenten,11,,6,15,21
096 Terenten,12,,14,16,30
096 Terenten,13,,15,7,22
096 Terenten,14,,10,8,18
096 Terenten,15,,16,6,22
096 Terenten,16,,9,10,19
096 Terenten,17,,11,15,26
096 Terenten,18,,13,12,25
096 Terenten,19,,14,15,29
096 Terenten,20,,12,9,21
096 Terenten,21,,13,6,19
096 Terenten,22,,11,14,25
096 Terenten,23,,9,9,18
096 Terenten,24,,17,18,35
096 Terenten,25,,11,6,17
096 Terenten,26,,14,10,24
096 Terenten,27,,18,8,26
096 Terenten,28,,14,15,29
096 Terenten,29,,6,17,23
096 Terenten,30,,17,10,27
096 Terenten,31,,14,14,28
096 Terenten,32,,21,14,35
096 Terenten,33,,15,13,28
096 Terenten,34,,12,13,25
096 Terenten,35,,15,17,32
096 Terenten,36,,13,19,32
096 Terenten,37,,15,9,24
096 Terenten,38,,16,15,31
096 Terenten,39,,25,12,37
096 Terenten,40,,22,10,32
096 Terenten,41,,10,16,26
096 Terenten,42,,12,9,21
096 Terenten,43,,15,11,26
096 Terenten,44,,12,8,20
096 Terenten,45,,12,9,21
096 Terenten,46,,11,12,23
096 Terenten,47,,12,10,22
096 Terenten,48,,15,11,26
096 Terenten,49,,9,6,15
096 Terenten,50,,6,7,13
096 Terenten,51,,5,6,11
096 Terenten,52,,9,7,16
096 Terenten,53,,9,6,15
096 Terenten,54,,10,8,18
096 Terenten,55,,7,3,10
096 Terenten,56,,8,3,11
096 Terenten,57,,6,3,9
096 Terenten,58,,3,6,9
096 Terenten,59,,8,4,12
096 Terenten,60,,5,5,10
096 Terenten,61,,6,4,10
096 Terenten,62,,7,5,12
096 Terenten,63,,2,6,8
096 Terenten,64,,6,9,15
096 Terenten,65,,7,5,12
096 Terenten,66,,4,9,13
096 Terenten,67,,7,5,12
096 Terenten,68,,2,4,6
096 Terenten,69,,5,3,8
096 Terenten,70,,4,4,8
096 Terenten,71,,6,11,17
096 Terenten,72,,5,6,11
096 Terenten,73,,5,4,9
096 Terenten,74,,6,6,12
096 Terenten,75,,2,4,6
096 Terenten,76,,3,9,12
096 Terenten,77,,6,3,9
096 Terenten,78,,1,7,8
096 Terenten,79,,4,4,8
096 Terenten,80,,3,1,4
096 Terenten,81,,-,2,2
096 Terenten,82,,4,3,7
096 Terenten,83,,1,2,3
096 Terenten,84,,-,3,3
096 Terenten,85,,1,-,1
096 Terenten,86,,1,1,2
096 Terenten,87,,-,1,1
096 Terenten,88,,2,1,3
096 Terenten,89,,1,-,1
096 Terenten,90,,-,1,1
096 Terenten,92,,-,2,2
096 Terenten,93,,-,1,1
097 Terlan,0,,17,23,40
097 Terlan,1,,21,24,45
097 Terlan,2,,31,27,58
097 Terlan,3,,29,21,50
097 Terlan,4,,17,18,35
097 Terlan,5,,32,27,59
097 Terlan,6,,17,25,42
097 Terlan,7,,26,24,50
097 Terlan,8,,19,17,36
097 Terlan,9,,22,23,45
097 Terlan,10,,23,29,52
097 Terlan,11,,25,19,44
097 Terlan,12,,15,22,37
097 Terlan,13,,21,31,52
097 Terlan,14,,22,17,39
097 Terlan,15,,26,16,42
097 Terlan,16,,15,22,37
097 Terlan,17,,27,20,47
097 Terlan,18,,13,12,25
097 Terlan,19,,23,17,40
097 Terlan,20,,20,18,38
097 Terlan,21,,15,16,31
097 Terlan,22,,26,22,48
097 Terlan,23,,19,26,45
097 Terlan,24,,18,17,35
097 Terlan,25,,29,21,50
097 Terlan,26,,30,26,56
097 Terlan,27,,26,19,45
097 Terlan,28,,29,38,67
097 Terlan,29,,22,30,52
097 Terlan,30,,42,25,67
097 Terlan,31,,34,26,60
097 Terlan,32,,33,36,69
097 Terlan,33,,34,30,64
097 Terlan,34,,35,28,63
097 Terlan,35,,23,36,59
097 Terlan,36,,34,22,56
097 Terlan,37,,33,28,61
097 Terlan,38,,32,30,62
097 Terlan,39,,34,38,72
097 Terlan,40,,33,34,67
097 Terlan,41,,45,26,71
097 Terlan,42,,25,36,61
097 Terlan,43,,18,24,42
097 Terlan,44,,34,23,57
097 Terlan,45,,22,25,47
097 Terlan,46,,30,30,60
097 Terlan,47,,19,22,41
097 Terlan,48,,25,19,44
097 Terlan,49,,18,22,40
097 Terlan,50,,21,25,46
097 Terlan,51,,22,20,42
097 Terlan,52,,21,24,45
097 Terlan,53,,21,15,36
097 Terlan,54,,21,24,45
097 Terlan,55,,13,18,31
097 Terlan,56,,13,25,38
097 Terlan,57,,22,20,42
097 Terlan,58,,22,25,47
097 Terlan,59,,18,29,47
097 Terlan,60,,33,19,52
097 Terlan,61,,22,25,47
097 Terlan,62,,21,15,36
097 Terlan,63,,16,19,35
097 Terlan,64,,21,17,38
097 Terlan,65,,14,17,31
097 Terlan,66,,7,12,19
097 Terlan,67,,16,23,39
097 Terlan,68,,7,24,31
097 Terlan,69,,16,16,32
097 Terlan,70,,15,11,26
097 Terlan,71,,20,15,35
097 Terlan,72,,15,16,31
097 Terlan,73,,13,14,27
097 Terlan,74,,13,12,25
097 Terlan,75,,11,12,23
097 Terlan,76,,12,21,33
097 Terlan,77,,11,12,23
097 Terlan,78,,7,14,21
097 Terlan,79,,7,24,31
097 Terlan,80,,8,11,19
097 Terlan,81,,8,13,21
097 Terlan,82,,2,8,10
097 Terlan,83,,-,9,9
097 Terlan,84,,3,3,6
097 Terlan,85,,-,4,4
097 Terlan,86,,-,4,4
097 Terlan,87,,2,4,6
097 Terlan,88,,-,6,6
097 Terlan,89,,2,7,9
097 Terlan,90,,-,5,5
097 Terlan,91,,-,6,6
097 Terlan,92,,1,3,4
097 Terlan,93,,3,-,3
097 Terlan,94,,-,1,1
097 Terlan,95,,-,1,1
097 Terlan,97,,-,1,1
098 Tramin a.d. Weinstr.,0,,12,18,30
098 Tramin a.d. Weinstr.,1,,16,23,39
098 Tramin a.d. Weinstr.,2,,24,15,39
098 Tramin a.d. Weinstr.,3,,22,18,40
098 Tramin a.d. Weinstr.,4,,15,20,35
098 Tramin a.d. Weinstr.,5,,31,15,46
098 Tramin a.d. Weinstr.,6,,20,27,47
098 Tramin a.d. Weinstr.,7,,18,20,38
098 Tramin a.d. Weinstr.,8,,21,21,42
098 Tramin a.d. Weinstr.,9,,17,17,34
098 Tramin a.d. Weinstr.,10,,21,24,45
098 Tramin a.d. Weinstr.,11,,18,11,29
098 Tramin a.d. Weinstr.,12,,23,20,43
098 Tramin a.d. Weinstr.,13,,11,30,41
098 Tramin a.d. Weinstr.,14,,12,25,37
098 Tramin a.d. Weinstr.,15,,18,25,43
098 Tramin a.d. Weinstr.,16,,10,15,25
098 Tramin a.d. Weinstr.,17,,21,20,41
098 Tramin a.d. Weinstr.,18,,20,16,36
098 Tramin a.d. Weinstr.,19,,17,14,31
098 Tramin a.d. Weinstr.,20,,25,19,44
098 Tramin a.d. Weinstr.,21,,29,18,47
098 Tramin a.d. Weinstr.,22,,19,15,34
098 Tramin a.d. Weinstr.,23,,10,15,25
098 Tramin a.d. Weinstr.,24,,10,21,31
098 Tramin a.d. Weinstr.,25,,17,18,35
098 Tramin a.d. Weinstr.,26,,22,11,33
098 Tramin a.d. Weinstr.,27,,19,19,38
098 Tramin a.d. Weinstr.,28,,20,17,37
098 Tramin a.d. Weinstr.,29,,22,17,39
098 Tramin a.d. Weinstr.,30,,23,28,51
098 Tramin a.d. Weinstr.,31,,26,31,57
098 Tramin a.d. Weinstr.,32,,29,18,47
098 Tramin a.d. Weinstr.,33,,32,24,56
098 Tramin a.d. Weinstr.,34,,22,26,48
098 Tramin a.d. Weinstr.,35,,26,26,52
098 Tramin a.d. Weinstr.,36,,30,30,60
098 Tramin a.d. Weinstr.,37,,34,30,64
098 Tramin a.d. Weinstr.,38,,27,29,56
098 Tramin a.d. Weinstr.,39,,25,27,52
098 Tramin a.d. Weinstr.,40,,22,14,36
098 Tramin a.d. Weinstr.,41,,32,26,58
098 Tramin a.d. Weinstr.,42,,30,33,63
098 Tramin a.d. Weinstr.,43,,19,32,51
098 Tramin a.d. Weinstr.,44,,26,20,46
098 Tramin a.d. Weinstr.,45,,20,18,38
098 Tramin a.d. Weinstr.,46,,23,19,42
098 Tramin a.d. Weinstr.,47,,18,19,37
098 Tramin a.d. Weinstr.,48,,19,18,37
098 Tramin a.d. Weinstr.,49,,16,14,30
098 Tramin a.d. Weinstr.,50,,19,16,35
098 Tramin a.d. Weinstr.,51,,10,12,22
098 Tramin a.d. Weinstr.,52,,14,19,33
098 Tramin a.d. Weinstr.,53,,15,15,30
098 Tramin a.d. Weinstr.,54,,18,18,36
098 Tramin a.d. Weinstr.,55,,14,22,36
098 Tramin a.d. Weinstr.,56,,24,17,41
098 Tramin a.d. Weinstr.,57,,7,9,16
098 Tramin a.d. Weinstr.,58,,23,24,47
098 Tramin a.d. Weinstr.,59,,19,22,41
098 Tramin a.d. Weinstr.,60,,21,20,41
098 Tramin a.d. Weinstr.,61,,13,25,38
098 Tramin a.d. Weinstr.,62,,22,16,38
098 Tramin a.d. Weinstr.,63,,14,13,27
098 Tramin a.d. Weinstr.,64,,8,20,28
098 Tramin a.d. Weinstr.,65,,15,13,28
098 Tramin a.d. Weinstr.,66,,13,15,28
098 Tramin a.d. Weinstr.,67,,15,13,28
098 Tramin a.d. Weinstr.,68,,11,12,23
098 Tramin a.d. Weinstr.,69,,10,14,24
098 Tramin a.d. Weinstr.,70,,11,19,30
098 Tramin a.d. Weinstr.,71,,8,19,27
098 Tramin a.d. Weinstr.,72,,21,14,35
098 Tramin a.d. Weinstr.,73,,10,15,25
098 Tramin a.d. Weinstr.,74,,16,16,32
098 Tramin a.d. Weinstr.,75,,17,14,31
098 Tramin a.d. Weinstr.,76,,16,18,34
098 Tramin a.d. Weinstr.,77,,12,20,32
098 Tramin a.d. Weinstr.,78,,6,15,21
098 Tramin a.d. Weinstr.,79,,10,18,28
098 Tramin a.d. Weinstr.,80,,5,11,16
098 Tramin a.d. Weinstr.,81,,11,11,22
098 Tramin a.d. Weinstr.,82,,6,14,20
098 Tramin a.d. Weinstr.,83,,2,13,15
098 Tramin a.d. Weinstr.,84,,3,3,6
098 Tramin a.d. Weinstr.,85,,1,5,6
098 Tramin a.d. Weinstr.,86,,1,1,2
098 Tramin a.d. Weinstr.,87,,2,5,7
098 Tramin a.d. Weinstr.,88,,5,9,14
098 Tramin a.d. Weinstr.,89,,1,1,2
098 Tramin a.d. Weinstr.,90,,1,5,6
098 Tramin a.d. Weinstr.,91,,-,5,5
098 Tramin a.d. Weinstr.,92,,1,3,4
098 Tramin a.d. Weinstr.,93,,-,1,1
098 Tramin a.d. Weinstr.,94,,1,3,4
098 Tramin a.d. Weinstr.,95,,-,2,2
098 Tramin a.d. Weinstr.,96,,-,2,2
098 Tramin a.d. Weinstr.,98,,-,1,1
098 Tramin a.d. Weinstr.,102,,-,1,1
099 Tisens,0,,10,8,18
099 Tisens,1,,10,13,23
099 Tisens,2,,10,12,22
099 Tisens,3,,10,10,20
099 Tisens,4,,11,14,25
099 Tisens,5,,5,6,11
099 Tisens,6,,9,8,17
099 Tisens,7,,10,8,18
099 Tisens,8,,12,12,24
099 Tisens,9,,6,10,16
099 Tisens,10,,6,15,21
099 Tisens,11,,16,8,24
099 Tisens,12,,10,15,25
099 Tisens,13,,12,10,22
099 Tisens,14,,7,13,20
099 Tisens,15,,15,9,24
099 Tisens,16,,15,8,23
099 Tisens,17,,10,4,14
099 Tisens,18,,12,12,24
099 Tisens,19,,18,7,25
099 Tisens,20,,10,15,25
099 Tisens,21,,4,18,22
099 Tisens,22,,15,12,27
099 Tisens,23,,10,9,19
099 Tisens,24,,12,13,25
099 Tisens,25,,12,9,21
099 Tisens,26,,8,4,12
099 Tisens,27,,14,15,29
099 Tisens,28,,10,9,19
099 Tisens,29,,10,10,20
099 Tisens,30,,8,12,20
099 Tisens,31,,20,15,35
099 Tisens,32,,17,20,37
099 Tisens,33,,16,16,32
099 Tisens,34,,19,15,34
099 Tisens,35,,19,24,43
099 Tisens,36,,20,12,32
099 Tisens,37,,17,27,44
099 Tisens,38,,16,4,20
099 Tisens,39,,18,14,32
099 Tisens,40,,22,7,29
099 Tisens,41,,14,14,28
099 Tisens,42,,16,7,23
099 Tisens,43,,14,10,24
099 Tisens,44,,10,11,21
099 Tisens,45,,15,19,34
099 Tisens,46,,9,12,21
099 Tisens,47,,20,10,30
099 Tisens,48,,8,8,16
099 Tisens,49,,12,10,22
099 Tisens,50,,7,13,20
099 Tisens,51,,10,11,21
099 Tisens,52,,9,7,16
099 Tisens,53,,5,8,13
099 Tisens,54,,15,9,24
099 Tisens,55,,7,8,15
099 Tisens,56,,8,6,14
099 Tisens,57,,3,7,10
099 Tisens,58,,10,10,20
099 Tisens,59,,12,10,22
099 Tisens,60,,8,9,17
099 Tisens,61,,8,14,22
099 Tisens,62,,7,8,15
099 Tisens,63,,14,10,24
099 Tisens,64,,8,11,19
099 Tisens,65,,6,4,10
099 Tisens,66,,7,8,15
099 Tisens,67,,4,12,16
099 Tisens,68,,7,7,14
099 Tisens,69,,2,10,12
099 Tisens,70,,9,11,20
099 Tisens,71,,7,9,16
099 Tisens,72,,4,15,19
099 Tisens,73,,10,11,21
099 Tisens,74,,10,13,23
099 Tisens,75,,14,9,23
099 Tisens,76,,6,8,14
099 Tisens,77,,4,7,11
099 Tisens,78,,2,4,6
099 Tisens,79,,4,8,12
099 Tisens,80,,5,5,10
099 Tisens,81,,4,7,11
099 Tisens,82,,3,5,8
099 Tisens,83,,2,6,8
099 Tisens,84,,2,3,5
099 Tisens,85,,1,4,5
099 Tisens,86,,1,3,4
099 Tisens,87,,2,3,5
099 Tisens,88,,1,4,5
099 Tisens,89,,-,2,2
099 Tisens,90,,1,2,3
099 Tisens,91,,2,1,3
099 Tisens,92,,-,5,5
099 Tisens,94,,-,3,3
099 Tisens,95,,-,1,1
099 Tisens,99,,-,1,1
100 Tiers,0,,8,4,12
100 Tiers,1,,3,8,11
100 Tiers,2,,2,8,10
100 Tiers,3,,5,8,13
100 Tiers,4,,4,9,13
100 Tiers,5,,7,5,12
100 Tiers,6,,9,4,13
100 Tiers,7,,6,10,16
100 Tiers,8,,5,7,12
100 Tiers,9,,4,1,5
100 Tiers,10,,6,3,9
100 Tiers,11,,4,3,7
100 Tiers,12,,6,5,11
100 Tiers,13,,5,6,11
100 Tiers,14,,6,8,14
100 Tiers,15,,5,4,9
100 Tiers,16,,8,6,14
100 Tiers,17,,5,6,11
100 Tiers,18,,3,9,12
100 Tiers,19,,6,6,12
100 Tiers,20,,6,6,12
100 Tiers,21,,5,5,10
100 Tiers,22,,2,4,6
100 Tiers,23,,1,9,10
100 Tiers,24,,8,6,14
100 Tiers,25,,5,2,7
100 Tiers,26,,1,3,4
100 Tiers,27,,7,3,10
100 Tiers,28,,4,8,12
100 Tiers,29,,9,11,20
100 Tiers,30,,10,7,17
100 Tiers,31,,6,8,14
100 Tiers,32,,8,8,16
100 Tiers,33,,13,11,24
100 Tiers,34,,6,5,11
100 Tiers,35,,10,12,22
100 Tiers,36,,10,6,16
100 Tiers,37,,7,6,13
100 Tiers,38,,9,2,11
100 Tiers,39,,6,10,16
100 Tiers,40,,5,7,12
100 Tiers,41,,6,4,10
100 Tiers,42,,4,6,10
100 Tiers,43,,11,5,16
100 Tiers,44,,7,4,11
100 Tiers,45,,6,9,15
100 Tiers,46,,10,8,18
100 Tiers,47,,5,3,8
100 Tiers,48,,8,5,13
100 Tiers,49,,6,5,11
100 Tiers,50,,3,3,6
100 Tiers,51,,1,3,4
100 Tiers,52,,8,4,12
100 Tiers,53,,2,5,7
100 Tiers,54,,3,5,8
100 Tiers,55,,1,3,4
100 Tiers,56,,5,4,9
100 Tiers,57,,10,3,13
100 Tiers,58,,1,5,6
100 Tiers,59,,8,10,18
100 Tiers,60,,2,5,7
100 Tiers,61,,4,6,10
100 Tiers,62,,2,3,5
100 Tiers,63,,4,6,10
100 Tiers,64,,6,5,11
100 Tiers,65,,7,5,12
100 Tiers,66,,4,5,9
100 Tiers,67,,7,2,9
100 Tiers,68,,2,5,7
100 Tiers,69,,7,3,10
100 Tiers,70,,2,5,7
100 Tiers,71,,7,2,9
100 Tiers,72,,4,-,4
100 Tiers,73,,2,3,5
100 Tiers,74,,4,3,7
100 Tiers,75,,4,4,8
100 Tiers,76,,4,2,6
100 Tiers,77,,6,4,10
100 Tiers,78,,2,6,8
100 Tiers,79,,2,3,5
100 Tiers,80,,3,2,5
100 Tiers,81,,1,9,10
100 Tiers,82,,2,3,5
100 Tiers,83,,3,1,4
100 Tiers,84,,1,1,2
100 Tiers,85,,3,1,4
100 Tiers,87,,1,2,3
100 Tiers,88,,2,-,2
100 Tiers,89,,-,1,1
100 Tiers,90,,-,2,2
100 Tiers,92,,-,1,1
101 Tirol,0,,11,11,22
101 Tirol,1,,16,7,23
101 Tirol,2,,19,10,29
101 Tirol,3,,14,17,31
101 Tirol,4,,19,14,33
101 Tirol,5,,20,20,40
101 Tirol,6,,21,19,40
101 Tirol,7,,9,16,25
101 Tirol,8,,15,16,31
101 Tirol,9,,21,9,30
101 Tirol,10,,13,14,27
101 Tirol,11,,8,9,17
101 Tirol,12,,16,11,27
101 Tirol,13,,11,18,29
101 Tirol,14,,11,14,25
101 Tirol,15,,17,9,26
101 Tirol,16,,10,13,23
101 Tirol,17,,10,16,26
101 Tirol,18,,16,11,27
101 Tirol,19,,19,14,33
101 Tirol,20,,12,13,25
101 Tirol,21,,17,23,40
101 Tirol,22,,18,8,26
101 Tirol,23,,18,3,21
101 Tirol,24,,9,12,21
101 Tirol,25,,13,19,32
101 Tirol,26,,16,9,25
101 Tirol,27,,19,18,37
101 Tirol,28,,16,18,34
101 Tirol,29,,23,13,36
101 Tirol,30,,23,16,39
101 Tirol,31,,24,14,38
101 Tirol,32,,16,13,29
101 Tirol,33,,23,20,43
101 Tirol,34,,23,21,44
101 Tirol,35,,21,20,41
101 Tirol,36,,20,17,37
101 Tirol,37,,21,22,43
101 Tirol,38,,30,24,54
101 Tirol,39,,19,13,32
101 Tirol,40,,17,14,31
101 Tirol,41,,18,22,40
101 Tirol,42,,25,14,39
101 Tirol,43,,16,12,28
101 Tirol,44,,13,18,31
101 Tirol,45,,16,16,32
101 Tirol,46,,9,15,24
101 Tirol,47,,13,15,28
101 Tirol,48,,15,17,32
101 Tirol,49,,19,17,36
101 Tirol,50,,13,11,24
101 Tirol,51,,15,20,35
101 Tirol,52,,15,12,27
101 Tirol,53,,21,16,37
101 Tirol,54,,20,16,36
101 Tirol,55,,8,16,24
101 Tirol,56,,13,6,19
101 Tirol,57,,12,14,26
101 Tirol,58,,16,17,33
101 Tirol,59,,13,12,25
101 Tirol,60,,13,20,33
101 Tirol,61,,12,17,29
101 Tirol,62,,10,13,23
101 Tirol,63,,14,12,26
101 Tirol,64,,8,9,17
101 Tirol,65,,11,15,26
101 Tirol,66,,6,11,17
101 Tirol,67,,10,11,21
101 Tirol,68,,16,7,23
101 Tirol,69,,7,12,19
101 Tirol,70,,8,8,16
101 Tirol,71,,7,7,14
101 Tirol,72,,5,7,12
101 Tirol,73,,10,15,25
101 Tirol,74,,8,9,17
101 Tirol,75,,10,8,18
101 Tirol,76,,5,10,15
101 Tirol,77,,6,9,15
101 Tirol,78,,9,11,20
101 Tirol,79,,5,6,11
101 Tirol,80,,4,6,10
101 Tirol,81,,6,6,12
101 Tirol,82,,2,7,9
101 Tirol,83,,3,5,8
101 Tirol,84,,2,4,6
101 Tirol,85,,-,1,1
101 Tirol,86,,1,2,3
101 Tirol,87,,1,3,4
101 Tirol,88,,3,3,6
101 Tirol,89,,2,4,6
101 Tirol,90,,1,2,3
101 Tirol,91,,1,3,4
101 Tirol,92,,-,2,2
101 Tirol,93,,-,3,3
101 Tirol,95,,1,-,1
101 Tirol,96,,1,-,1
101 Tirol,98,,-,1,1
102 Truden im Naturpark,0,,3,1,4
102 Truden im Naturpark,1,,5,7,12
102 Truden im Naturpark,2,,8,8,16
102 Truden im Naturpark,3,,-,4,4
102 Truden im Naturpark,4,,4,8,12
102 Truden im Naturpark,5,,6,6,12
102 Truden im Naturpark,6,,6,6,12
102 Truden im Naturpark,7,,4,6,10
102 Truden im Naturpark,8,,4,7,11
102 Truden im Naturpark,9,,10,4,14
102 Truden im Naturpark,10,,8,4,12
102 Truden im Naturpark,11,,6,6,12
102 Truden im Naturpark,12,,4,6,10
102 Truden im Naturpark,13,,11,7,18
102 Truden im Naturpark,14,,8,12,20
102 Truden im Naturpark,15,,6,5,11
102 Truden im Naturpark,16,,2,6,8
102 Truden im Naturpark,17,,7,6,13
102 Truden im Naturpark,18,,10,4,14
102 Truden im Naturpark,19,,6,6,12
102 Truden im Naturpark,20,,12,3,15
102 Truden im Naturpark,21,,4,8,12
102 Truden im Naturpark,22,,5,6,11
102 Truden im Naturpark,23,,9,7,16
102 Truden im Naturpark,24,,7,6,13
102 Truden im Naturpark,25,,4,4,8
102 Truden im Naturpark,26,,10,8,18
102 Truden im Naturpark,27,,8,3,11
102 Truden im Naturpark,28,,5,6,11
102 Truden im Naturpark,29,,7,9,16
102 Truden im Naturpark,30,,8,9,17
102 Truden im Naturpark,31,,4,4,8
102 Truden im Naturpark,32,,2,8,10
102 Truden im Naturpark,33,,7,8,15
102 Truden im Naturpark,34,,8,12,20
102 Truden im Naturpark,35,,11,9,20
102 Truden im Naturpark,36,,7,7,14
102 Truden im Naturpark,37,,8,8,16
102 Truden im Naturpark,38,,10,8,18
102 Truden im Naturpark,39,,10,6,16
102 Truden im Naturpark,40,,8,6,14
102 Truden im Naturpark,41,,7,5,12
102 Truden im Naturpark,42,,12,12,24
102 Truden im Naturpark,43,,7,8,15
102 Truden im Naturpark,44,,4,8,12
102 Truden im Naturpark,45,,6,9,15
102 Truden im Naturpark,46,,8,5,13
102 Truden im Naturpark,47,,8,10,18
102 Truden im Naturpark,48,,6,5,11
102 Truden im Naturpark,49,,8,5,13
102 Truden im Naturpark,50,,6,6,12
102 Truden im Naturpark,51,,9,6,15
102 Truden im Naturpark,52,,3,2,5
102 Truden im Naturpark,53,,5,3,8
102 Truden im Naturpark,54,,2,6,8
102 Truden im Naturpark,55,,7,2,9
102 Truden im Naturpark,56,,8,6,14
102 Truden im Naturpark,57,,4,2,6
102 Truden im Naturpark,58,,4,5,9
102 Truden im Naturpark,59,,5,5,10
102 Truden im Naturpark,60,,5,4,9
102 Truden im Naturpark,61,,5,5,10
102 Truden im Naturpark,62,,2,4,6
102 Truden im Naturpark,63,,8,2,10
102 Truden im Naturpark,64,,7,7,14
102 Truden im Naturpark,65,,3,4,7
102 Truden im Naturpark,66,,4,4,8
102 Truden im Naturpark,67,,3,3,6
102 Truden im Naturpark,68,,5,-,5
102 Truden im Naturpark,69,,6,7,13
102 Truden im Naturpark,70,,3,4,7
102 Truden im Naturpark,71,,5,4,9
102 Truden im Naturpark,72,,3,7,10
102 Truden im Naturpark,73,,-,7,7
102 Truden im Naturpark,74,,1,6,7
102 Truden im Naturpark,75,,6,6,12
102 Truden im Naturpark,76,,2,8,10
102 Truden im Naturpark,77,,-,6,6
102 Truden im Naturpark,78,,-,8,8
102 Truden im Naturpark,79,,4,7,11
102 Truden im Naturpark,80,,4,5,9
102 Truden im Naturpark,81,,1,5,6
102 Truden im Naturpark,82,,-,7,7
102 Truden im Naturpark,83,,1,4,5
102 Truden im Naturpark,84,,1,1,2
102 Truden im Naturpark,85,,-,1,1
102 Truden im Naturpark,87,,2,1,3
102 Truden im Naturpark,88,,-,2,2
102 Truden im Naturpark,91,,-,1,1
102 Truden im Naturpark,92,,-,2,2
102 Truden im Naturpark,93,,-,1,1
102 Truden im Naturpark,96,,-,1,1
103 Taufers im Münstertal,0,,3,5,8
103 Taufers im Münstertal,1,,6,7,13
103 Taufers im Münstertal,2,,4,4,8
103 Taufers im Münstertal,3,,3,3,6
103 Taufers im Münstertal,4,,8,8,16
103 Taufers im Münstertal,5,,4,4,8
103 Taufers im Münstertal,6,,6,4,10
103 Taufers im Münstertal,7,,9,9,18
103 Taufers im Münstertal,8,,5,8,13
103 Taufers im Münstertal,9,,3,5,8
103 Taufers im Münstertal,10,,9,9,18
103 Taufers im Münstertal,11,,6,10,16
103 Taufers im Münstertal,12,,7,7,14
103 Taufers im Münstertal,13,,7,2,9
103 Taufers im Münstertal,14,,6,8,14
103 Taufers im Münstertal,15,,5,6,11
103 Taufers im Münstertal,16,,6,3,9
103 Taufers im Münstertal,17,,5,3,8
103 Taufers im Münstertal,18,,4,7,11
103 Taufers im Münstertal,19,,5,5,10
103 Taufers im Münstertal,20,,5,11,16
103 Taufers im Münstertal,21,,9,2,11
103 Taufers im Münstertal,22,,9,5,14
103 Taufers im Münstertal,23,,7,4,11
103 Taufers im Münstertal,24,,7,5,12
103 Taufers im Münstertal,25,,7,5,12
103 Taufers im Münstertal,26,,5,4,9
103 Taufers im Münstertal,27,,13,2,15
103 Taufers im Münstertal,28,,6,6,12
103 Taufers im Münstertal,29,,2,4,6
103 Taufers im Münstertal,30,,5,7,12
103 Taufers im Münstertal,31,,7,14,21
103 Taufers im Münstertal,32,,7,7,14
103 Taufers im Münstertal,33,,10,6,16
103 Taufers im Münstertal,34,,9,10,19
103 Taufers im Münstertal,35,,4,5,9
103 Taufers im Münstertal,36,,8,8,16
103 Taufers im Münstertal,37,,12,7,19
103 Taufers im Münstertal,38,,7,12,19
103 Taufers im Münstertal,39,,11,10,21
103 Taufers im Münstertal,40,,11,9,20
103 Taufers im Münstertal,41,,9,8,17
103 Taufers im Münstertal,42,,14,7,21
103 Taufers im Münstertal,43,,6,9,15
103 Taufers im Münstertal,44,,5,6,11
103 Taufers im Münstertal,45,,9,7,16
103 Taufers im Münstertal,46,,10,10,20
103 Taufers im Münstertal,47,,3,3,6
103 Taufers im Münstertal,48,,3,6,9
103 Taufers im Münstertal,49,,7,3,10
103 Taufers im Münstertal,50,,6,2,8
103 Taufers im Münstertal,51,,5,4,9
103 Taufers im Münstertal,52,,7,1,8
103 Taufers im Münstertal,53,,5,1,6
103 Taufers im Münstertal,54,,6,1,7
103 Taufers im Münstertal,55,,3,7,10
103 Taufers im Münstertal,56,,3,3,6
103 Taufers im Münstertal,57,,2,3,5
103 Taufers im Münstertal,58,,1,-,1
103 Taufers im Münstertal,59,,6,5,11
103 Taufers im Münstertal,60,,5,5,10
103 Taufers im Münstertal,61,,4,6,10
103 Taufers im Münstertal,62,,3,3,6
103 Taufers im Münstertal,63,,4,4,8
103 Taufers im Münstertal,64,,8,9,17
103 Taufers im Münstertal,65,,3,4,7
103 Taufers im Münstertal,66,,2,9,11
103 Taufers im Münstertal,67,,6,2,8
103 Taufers im Münstertal,68,,4,8,12
103 Taufers im Münstertal,69,,6,5,11
103 Taufers im Münstertal,70,,5,2,7
103 Taufers im Münstertal,71,,9,3,12
103 Taufers im Münstertal,72,,3,3,6
103 Taufers im Münstertal,73,,4,6,10
103 Taufers im Münstertal,74,,4,3,7
103 Taufers im Münstertal,75,,3,3,6
103 Taufers im Münstertal,76,,3,5,8
103 Taufers im Münstertal,77,,1,5,6
103 Taufers im Münstertal,78,,-,7,7
103 Taufers im Münstertal,79,,4,5,9
103 Taufers im Münstertal,80,,2,2,4
103 Taufers im Münstertal,81,,3,-,3
103 Taufers im Münstertal,82,,3,2,5
103 Taufers im Münstertal,83,,1,2,3
103 Taufers im Münstertal,84,,-,1,1
103 Taufers im Münstertal,85,,2,3,5
103 Taufers im Münstertal,86,,1,-,1
103 Taufers im Münstertal,87,,2,1,3
103 Taufers im Münstertal,88,,1,-,1
103 Taufers im Münstertal,89,,-,1,1
103 Taufers im Münstertal,90,,-,2,2
103 Taufers im Münstertal,92,,1,1,2
103 Taufers im Münstertal,93,,-,1,1
103 Taufers im Münstertal,94,,-,1,1
103 Taufers im Münstertal,98,,-,1,1
104 Ulten,0,,14,21,35
104 Ulten,1,,23,15,38
104 Ulten,2,,19,19,38
104 Ulten,3,,15,14,29
104 Ulten,4,,18,20,38
104 Ulten,5,,15,20,35
104 Ulten,6,,11,13,24
104 Ulten,7,,12,16,28
104 Ulten,8,,19,15,34
104 Ulten,9,,23,15,38
104 Ulten,10,,17,17,34
104 Ulten,11,,23,31,54
104 Ulten,12,,16,18,34
104 Ulten,13,,18,29,47
104 Ulten,14,,16,20,36
104 Ulten,15,,20,17,37
104 Ulten,16,,22,11,33
104 Ulten,17,,14,16,30
104 Ulten,18,,20,22,42
104 Ulten,19,,22,19,41
104 Ulten,20,,16,24,40
104 Ulten,21,,19,17,36
104 Ulten,22,,20,22,42
104 Ulten,23,,18,18,36
104 Ulten,24,,22,17,39
104 Ulten,25,,22,13,35
104 Ulten,26,,16,21,37
104 Ulten,27,,23,23,46
104 Ulten,28,,23,32,55
104 Ulten,29,,27,18,45
104 Ulten,30,,25,22,47
104 Ulten,31,,27,20,47
104 Ulten,32,,23,26,49
104 Ulten,33,,29,21,50
104 Ulten,34,,28,26,54
104 Ulten,35,,14,23,37
104 Ulten,36,,21,20,41
104 Ulten,37,,25,26,51
104 Ulten,38,,24,21,45
104 Ulten,39,,30,26,56
104 Ulten,40,,31,22,53
104 Ulten,41,,30,18,48
104 Ulten,42,,25,20,45
104 Ulten,43,,23,21,44
104 Ulten,44,,26,16,42
104 Ulten,45,,36,22,58
104 Ulten,46,,18,15,33
104 Ulten,47,,13,12,25
104 Ulten,48,,19,16,35
104 Ulten,49,,23,14,37
104 Ulten,50,,19,13,32
104 Ulten,51,,19,18,37
104 Ulten,52,,22,14,36
104 Ulten,53,,17,10,27
104 Ulten,54,,13,13,26
104 Ulten,55,,17,8,25
104 Ulten,56,,16,15,31
104 Ulten,57,,9,12,21
104 Ulten,58,,14,20,34
104 Ulten,59,,17,16,33
104 Ulten,60,,11,19,30
104 Ulten,61,,13,12,25
104 Ulten,62,,16,9,25
104 Ulten,63,,21,16,37
104 Ulten,64,,8,11,19
104 Ulten,65,,11,11,22
104 Ulten,66,,9,10,19
104 Ulten,67,,10,15,25
104 Ulten,68,,12,14,26
104 Ulten,69,,5,14,19
104 Ulten,70,,13,8,21
104 Ulten,71,,11,8,19
104 Ulten,72,,16,17,33
104 Ulten,73,,7,16,23
104 Ulten,74,,10,17,27
104 Ulten,75,,11,18,29
104 Ulten,76,,9,14,23
104 Ulten,77,,16,13,29
104 Ulten,78,,11,11,22
104 Ulten,79,,11,25,36
104 Ulten,80,,10,10,20
104 Ulten,81,,9,14,23
104 Ulten,82,,8,13,21
104 Ulten,83,,2,12,14
104 Ulten,84,,3,5,8
104 Ulten,85,,1,2,3
104 Ulten,86,,-,3,3
104 Ulten,87,,3,2,5
104 Ulten,88,,1,9,10
104 Ulten,89,,4,5,9
104 Ulten,90,,1,3,4
104 Ulten,91,,3,4,7
104 Ulten,92,,2,4,6
104 Ulten,93,,2,-,2
104 Ulten,94,,-,1,1
104 Ulten,104,,-,1,1
105 Pfatten,0,,2,5,7
105 Pfatten,1,,6,-,6
105 Pfatten,2,,2,5,7
105 Pfatten,3,,5,6,11
105 Pfatten,4,,11,3,14
105 Pfatten,5,,3,1,4
105 Pfatten,6,,4,8,12
105 Pfatten,7,,4,5,9
105 Pfatten,8,,9,10,19
105 Pfatten,9,,3,5,8
105 Pfatten,10,,7,6,13
105 Pfatten,11,,7,4,11
105 Pfatten,12,,9,8,17
105 Pfatten,13,,6,4,10
105 Pfatten,14,,2,7,9
105 Pfatten,15,,6,4,10
105 Pfatten,16,,4,8,12
105 Pfatten,17,,4,6,10
105 Pfatten,18,,3,6,9
105 Pfatten,19,,3,3,6
105 Pfatten,20,,5,2,7
105 Pfatten,21,,8,2,10
105 Pfatten,22,,1,5,6
105 Pfatten,23,,2,8,10
105 Pfatten,24,,5,4,9
105 Pfatten,25,,7,1,8
105 Pfatten,26,,8,4,12
105 Pfatten,27,,1,4,5
105 Pfatten,28,,6,9,15
105 Pfatten,29,,7,8,15
105 Pfatten,30,,9,10,19
105 Pfatten,31,,11,7,18
105 Pfatten,32,,11,6,17
105 Pfatten,33,,7,3,10
105 Pfatten,34,,4,8,12
105 Pfatten,35,,14,5,19
105 Pfatten,36,,10,7,17
105 Pfatten,37,,12,10,22
105 Pfatten,38,,8,5,13
105 Pfatten,39,,7,9,16
105 Pfatten,40,,7,12,19
105 Pfatten,41,,10,15,25
105 Pfatten,42,,6,10,16
105 Pfatten,43,,4,12,16
105 Pfatten,44,,7,7,14
105 Pfatten,45,,15,6,21
105 Pfatten,46,,9,7,16
105 Pfatten,47,,8,4,12
105 Pfatten,48,,13,3,16
105 Pfatten,49,,7,7,14
105 Pfatten,50,,2,6,8
105 Pfatten,51,,4,2,6
105 Pfatten,52,,4,6,10
105 Pfatten,53,,6,2,8
105 Pfatten,54,,3,2,5
105 Pfatten,55,,6,8,14
105 Pfatten,56,,5,4,9
105 Pfatten,57,,5,4,9
105 Pfatten,58,,5,2,7
105 Pfatten,59,,2,2,4
105 Pfatten,60,,5,2,7
105 Pfatten,61,,4,6,10
105 Pfatten,62,,2,4,6
105 Pfatten,63,,4,2,6
105 Pfatten,64,,2,4,6
105 Pfatten,65,,4,1,5
105 Pfatten,66,,3,4,7
105 Pfatten,67,,6,2,8
105 Pfatten,68,,2,6,8
105 Pfatten,69,,2,3,5
105 Pfatten,70,,-,4,4
105 Pfatten,71,,2,4,6
105 Pfatten,72,,2,3,5
105 Pfatten,73,,-,6,6
105 Pfatten,74,,-,1,1
105 Pfatten,75,,2,-,2
105 Pfatten,76,,3,4,7
105 Pfatten,77,,2,4,6
105 Pfatten,78,,2,5,7
105 Pfatten,79,,3,1,4
105 Pfatten,80,,3,1,4
105 Pfatten,81,,-,1,1
105 Pfatten,82,,1,1,2
105 Pfatten,83,,1,-,1
105 Pfatten,84,,-,1,1
105 Pfatten,85,,1,1,2
105 Pfatten,86,,-,2,2
105 Pfatten,87,,-,1,1
105 Pfatten,89,,1,2,3
105 Pfatten,90,,-,1,1
105 Pfatten,93,,1,-,1
105 Pfatten,95,,-,2,2
106 Olang,0,,17,13,30
106 Olang,1,,19,20,39
106 Olang,2,,19,18,37
106 Olang,3,,18,14,32
106 Olang,4,,15,20,35
106 Olang,5,,21,18,39
106 Olang,6,,26,22,48
106 Olang,7,,20,9,29
106 Olang,8,,19,11,30
106 Olang,9,,19,23,42
106 Olang,10,,14,16,30
106 Olang,11,,26,19,45
106 Olang,12,,23,22,45
106 Olang,13,,20,19,39
106 Olang,14,,15,18,33
106 Olang,15,,26,17,43
106 Olang,16,,18,18,36
106 Olang,17,,13,23,36
106 Olang,18,,21,15,36
106 Olang,19,,16,21,37
106 Olang,20,,20,22,42
106 Olang,21,,16,23,39
106 Olang,22,,18,28,46
106 Olang,23,,19,18,37
106 Olang,24,,18,13,31
106 Olang,25,,26,26,52
106 Olang,26,,19,23,42
106 Olang,27,,24,26,50
106 Olang,28,,17,25,42
106 Olang,29,,28,25,53
106 Olang,30,,23,20,43
106 Olang,31,,27,18,45
106 Olang,32,,25,18,43
106 Olang,33,,20,30,50
106 Olang,34,,27,26,53
106 Olang,35,,29,24,53
106 Olang,36,,24,22,46
106 Olang,37,,13,23,36
106 Olang,38,,17,29,46
106 Olang,39,,23,22,45
106 Olang,40,,25,11,36
106 Olang,41,,16,27,43
106 Olang,42,,23,23,46
106 Olang,43,,23,16,39
106 Olang,44,,21,13,34
106 Olang,45,,26,14,40
106 Olang,46,,15,27,42
106 Olang,47,,17,18,35
106 Olang,48,,15,18,33
106 Olang,49,,15,19,34
106 Olang,50,,18,13,31
106 Olang,51,,9,12,21
106 Olang,52,,33,16,49
106 Olang,53,,24,12,36
106 Olang,54,,19,21,40
106 Olang,55,,15,23,38
106 Olang,56,,16,13,29
106 Olang,57,,18,10,28
106 Olang,58,,14,7,21
106 Olang,59,,10,17,27
106 Olang,60,,14,15,29
106 Olang,61,,16,14,30
106 Olang,62,,17,11,28
106 Olang,63,,11,9,20
106 Olang,64,,8,14,22
106 Olang,65,,10,9,19
106 Olang,66,,10,8,18
106 Olang,67,,8,15,23
106 Olang,68,,12,9,21
106 Olang,69,,11,14,25
106 Olang,70,,10,13,23
106 Olang,71,,5,6,11
106 Olang,72,,16,8,24
106 Olang,73,,12,13,25
106 Olang,74,,6,9,15
106 Olang,75,,7,9,16
106 Olang,76,,6,13,19
106 Olang,77,,4,6,10
106 Olang,78,,5,7,12
106 Olang,79,,7,5,12
106 Olang,80,,4,7,11
106 Olang,81,,6,4,10
106 Olang,82,,2,6,8
106 Olang,83,,1,4,5
106 Olang,84,,-,2,2
106 Olang,85,,1,3,4
106 Olang,86,,1,1,2
106 Olang,87,,2,5,7
106 Olang,88,,1,3,4
106 Olang,89,,-,2,2
106 Olang,90,,1,2,3
106 Olang,91,,1,4,5
106 Olang,92,,1,2,3
106 Olang,95,,-,1,1
106 Olang,96,,1,-,1
107 Pfitsch,0,,15,20,35
107 Pfitsch,1,,9,9,18
107 Pfitsch,2,,23,21,44
107 Pfitsch,3,,16,14,30
107 Pfitsch,4,,10,18,28
107 Pfitsch,5,,14,10,24
107 Pfitsch,6,,11,14,25
107 Pfitsch,7,,17,10,27
107 Pfitsch,8,,13,19,32
107 Pfitsch,9,,18,12,30
107 Pfitsch,10,,13,15,28
107 Pfitsch,11,,18,11,29
107 Pfitsch,12,,19,15,34
107 Pfitsch,13,,8,18,26
107 Pfitsch,14,,12,14,26
107 Pfitsch,15,,12,16,28
107 Pfitsch,16,,13,9,22
107 Pfitsch,17,,14,10,24
107 Pfitsch,18,,25,13,38
107 Pfitsch,19,,21,19,40
107 Pfitsch,20,,30,15,45
107 Pfitsch,21,,22,16,38
107 Pfitsch,22,,21,20,41
107 Pfitsch,23,,27,17,44
107 Pfitsch,24,,23,16,39
107 Pfitsch,25,,14,23,37
107 Pfitsch,26,,22,17,39
107 Pfitsch,27,,18,18,36
107 Pfitsch,28,,15,23,38
107 Pfitsch,29,,18,14,32
107 Pfitsch,30,,15,19,34
107 Pfitsch,31,,21,17,38
107 Pfitsch,32,,24,20,44
107 Pfitsch,33,,23,23,46
107 Pfitsch,34,,23,20,43
107 Pfitsch,35,,19,16,35
107 Pfitsch,36,,25,13,38
107 Pfitsch,37,,19,18,37
107 Pfitsch,38,,14,24,38
107 Pfitsch,39,,16,16,32
107 Pfitsch,40,,24,24,48
107 Pfitsch,41,,22,19,41
107 Pfitsch,42,,14,25,39
107 Pfitsch,43,,14,16,30
107 Pfitsch,44,,21,17,38
107 Pfitsch,45,,25,21,46
107 Pfitsch,46,,17,12,29
107 Pfitsch,47,,14,14,28
107 Pfitsch,48,,21,21,42
107 Pfitsch,49,,21,14,35
107 Pfitsch,50,,20,21,41
107 Pfitsch,51,,24,14,38
107 Pfitsch,52,,23,17,40
107 Pfitsch,53,,16,20,36
107 Pfitsch,54,,8,11,19
107 Pfitsch,55,,10,13,23
107 Pfitsch,56,,15,12,27
107 Pfitsch,57,,13,12,25
107 Pfitsch,58,,12,16,28
107 Pfitsch,59,,21,12,33
107 Pfitsch,60,,24,13,37
107 Pfitsch,61,,17,16,33
107 Pfitsch,62,,14,15,29
107 Pfitsch,63,,14,8,22
107 Pfitsch,64,,4,13,17
107 Pfitsch,65,,9,11,20
107 Pfitsch,66,,9,12,21
107 Pfitsch,67,,8,8,16
107 Pfitsch,68,,11,5,16
107 Pfitsch,69,,13,13,26
107 Pfitsch,70,,3,14,17
107 Pfitsch,71,,10,12,22
107 Pfitsch,72,,8,13,21
107 Pfitsch,73,,17,11,28
107 Pfitsch,74,,5,14,19
107 Pfitsch,75,,11,12,23
107 Pfitsch,76,,5,12,17
107 Pfitsch,77,,11,10,21
107 Pfitsch,78,,4,18,22
107 Pfitsch,79,,7,14,21
107 Pfitsch,80,,7,5,12
107 Pfitsch,81,,6,7,13
107 Pfitsch,82,,1,6,7
107 Pfitsch,83,,2,7,9
107 Pfitsch,84,,-,3,3
107 Pfitsch,85,,2,5,7
107 Pfitsch,86,,1,3,4
107 Pfitsch,87,,2,5,7
107 Pfitsch,88,,-,2,2
107 Pfitsch,89,,-,2,2
107 Pfitsch,90,,-,5,5
107 Pfitsch,91,,1,1,2
107 Pfitsch,92,,1,-,1
107 Pfitsch,93,,-,1,1
107 Pfitsch,94,,-,4,4
107 Pfitsch,101,,-,1,1
108 Ahrntal,0,,30,30,60
108 Ahrntal,1,,30,30,60
108 Ahrntal,2,,49,39,88
108 Ahrntal,3,,33,37,70
108 Ahrntal,4,,37,36,73
108 Ahrntal,5,,41,43,84
108 Ahrntal,6,,38,49,87
108 Ahrntal,7,,36,31,67
108 Ahrntal,8,,26,26,52
108 Ahrntal,9,,39,41,80
108 Ahrntal,10,,41,32,73
108 Ahrntal,11,,26,35,61
108 Ahrntal,12,,41,31,72
108 Ahrntal,13,,38,33,71
108 Ahrntal,14,,28,33,61
108 Ahrntal,15,,36,37,73
108 Ahrntal,16,,39,49,88
108 Ahrntal,17,,35,45,80
108 Ahrntal,18,,41,32,73
108 Ahrntal,19,,45,48,93
108 Ahrntal,20,,39,45,84
108 Ahrntal,21,,49,38,87
108 Ahrntal,22,,38,38,76
108 Ahrntal,23,,44,39,83
108 Ahrntal,24,,34,50,84
108 Ahrntal,25,,50,45,95
108 Ahrntal,26,,43,48,91
108 Ahrntal,27,,43,46,89
108 Ahrntal,28,,47,42,89
108 Ahrntal,29,,46,44,90
108 Ahrntal,30,,56,53,109
108 Ahrntal,31,,71,42,113
108 Ahrntal,32,,52,44,96
108 Ahrntal,33,,52,46,98
108 Ahrntal,34,,52,51,103
108 Ahrntal,35,,46,49,95
108 Ahrntal,36,,62,40,102
108 Ahrntal,37,,56,42,98
108 Ahrntal,38,,55,45,100
108 Ahrntal,39,,46,44,90
108 Ahrntal,40,,38,48,86
108 Ahrntal,41,,35,35,70
108 Ahrntal,42,,40,30,70
108 Ahrntal,43,,42,37,79
108 Ahrntal,44,,49,26,75
108 Ahrntal,45,,27,40,67
108 Ahrntal,46,,37,18,55
108 Ahrntal,47,,36,26,62
108 Ahrntal,48,,33,22,55
108 Ahrntal,49,,26,30,56
108 Ahrntal,50,,27,31,58
108 Ahrntal,51,,34,26,60
108 Ahrntal,52,,32,24,56
108 Ahrntal,53,,32,30,62
108 Ahrntal,54,,29,28,57
108 Ahrntal,55,,26,16,42
108 Ahrntal,56,,17,23,40
108 Ahrntal,57,,20,14,34
108 Ahrntal,58,,20,18,38
108 Ahrntal,59,,23,31,54
108 Ahrntal,60,,30,30,60
108 Ahrntal,61,,30,34,64
108 Ahrntal,62,,32,24,56
108 Ahrntal,63,,27,23,50
108 Ahrntal,64,,37,30,67
108 Ahrntal,65,,26,22,48
108 Ahrntal,66,,22,16,38
108 Ahrntal,67,,21,37,58
108 Ahrntal,68,,22,20,42
108 Ahrntal,69,,20,17,37
108 Ahrntal,70,,21,26,47
108 Ahrntal,71,,32,22,54
108 Ahrntal,72,,23,20,43
108 Ahrntal,73,,19,16,35
108 Ahrntal,74,,13,26,39
108 Ahrntal,75,,18,18,36
108 Ahrntal,76,,17,14,31
108 Ahrntal,77,,14,16,30
108 Ahrntal,78,,11,16,27
108 Ahrntal,79,,10,13,23
108 Ahrntal,80,,9,14,23
108 Ahrntal,81,,5,10,15
108 Ahrntal,82,,4,6,10
108 Ahrntal,83,,8,4,12
108 Ahrntal,84,,-,6,6
108 Ahrntal,85,,3,6,9
108 Ahrntal,86,,-,4,4
108 Ahrntal,87,,2,11,13
108 Ahrntal,88,,5,10,15
108 Ahrntal,89,,2,2,4
108 Ahrntal,90,,3,5,8
108 Ahrntal,91,,1,2,3
108 Ahrntal,92,,3,1,4
108 Ahrntal,93,,1,2,3
108 Ahrntal,94,,-,2,2
108 Ahrntal,95,,-,1,1
108 Ahrntal,96,,-,1,1
108 Ahrntal,97,,1,1,2
108 Ahrntal,99,,1,-,1
109 Gsies,0,,12,9,21
109 Gsies,1,,16,17,33
109 Gsies,2,,10,9,19
109 Gsies,3,,22,14,36
109 Gsies,4,,18,6,24
109 Gsies,5,,12,16,28
109 Gsies,6,,11,17,28
109 Gsies,7,,15,14,29
109 Gsies,8,,10,19,29
109 Gsies,9,,17,19,36
109 Gsies,10,,16,10,26
109 Gsies,11,,16,25,41
109 Gsies,12,,17,13,30
109 Gsies,13,,9,13,22
109 Gsies,14,,7,14,21
109 Gsies,15,,18,17,35
109 Gsies,16,,12,17,29
109 Gsies,17,,17,13,30
109 Gsies,18,,13,8,21
109 Gsies,19,,18,10,28
109 Gsies,20,,18,19,37
109 Gsies,21,,15,17,32
109 Gsies,22,,23,21,44
109 Gsies,23,,10,17,27
109 Gsies,24,,14,15,29
109 Gsies,25,,18,18,36
109 Gsies,26,,14,16,30
109 Gsies,27,,20,26,46
109 Gsies,28,,20,19,39
109 Gsies,29,,14,13,27
109 Gsies,30,,10,19,29
109 Gsies,31,,22,19,41
109 Gsies,32,,27,16,43
109 Gsies,33,,25,11,36
109 Gsies,34,,16,15,31
109 Gsies,35,,16,12,28
109 Gsies,36,,14,20,34
109 Gsies,37,,21,6,27
109 Gsies,38,,15,17,32
109 Gsies,39,,14,16,30
109 Gsies,40,,17,8,25
109 Gsies,41,,9,14,23
109 Gsies,42,,17,18,35
109 Gsies,43,,12,14,26
109 Gsies,44,,16,16,32
109 Gsies,45,,12,14,26
109 Gsies,46,,17,7,24
109 Gsies,47,,16,10,26
109 Gsies,48,,16,6,22
109 Gsies,49,,18,6,24
109 Gsies,50,,17,11,28
109 Gsies,51,,16,13,29
109 Gsies,52,,8,8,16
109 Gsies,53,,15,15,30
109 Gsies,54,,9,10,19
109 Gsies,55,,22,7,29
109 Gsies,56,,15,10,25
109 Gsies,57,,4,11,15
109 Gsies,58,,7,13,20
109 Gsies,59,,10,9,19
109 Gsies,60,,5,13,18
109 Gsies,61,,6,11,17
109 Gsies,62,,9,11,20
109 Gsies,63,,6,9,15
109 Gsies,64,,7,9,16
109 Gsies,65,,11,7,18
109 Gsies,66,,4,10,14
109 Gsies,67,,4,9,13
109 Gsies,68,,5,9,14
109 Gsies,69,,6,5,11
109 Gsies,70,,9,5,14
109 Gsies,71,,7,10,17
109 Gsies,72,,12,6,18
109 Gsies,73,,3,6,9
109 Gsies,74,,8,9,17
109 Gsies,75,,3,11,14
109 Gsies,76,,4,4,8
109 Gsies,77,,7,5,12
109 Gsies,78,,5,6,11
109 Gsies,79,,6,8,14
109 Gsies,80,,10,7,17
109 Gsies,81,,2,11,13
109 Gsies,82,,3,4,7
109 Gsies,83,,4,1,5
109 Gsies,84,,1,2,3
109 Gsies,85,,1,2,3
109 Gsies,87,,1,1,2
109 Gsies,88,,1,-,1
109 Gsies,89,,-,3,3
109 Gsies,90,,5,5,10
109 Gsies,91,,1,3,4
109 Gsies,94,,-,3,3
109 Gsies,95,,-,2,2
109 Gsies,97,,1,1,2
110 Vintl,0,,17,22,39
110 Vintl,1,,17,21,38
110 Vintl,2,,23,14,37
110 Vintl,3,,23,22,45
110 Vintl,4,,20,30,50
110 Vintl,5,,19,18,37
110 Vintl,6,,22,19,41
110 Vintl,7,,36,26,62
110 Vintl,8,,19,18,37
110 Vintl,9,,24,21,45
110 Vintl,10,,29,22,51
110 Vintl,11,,21,30,51
110 Vintl,12,,28,23,51
110 Vintl,13,,26,17,43
110 Vintl,14,,21,20,41
110 Vintl,15,,20,24,44
110 Vintl,16,,20,21,41
110 Vintl,17,,10,15,25
110 Vintl,18,,26,10,36
110 Vintl,19,,24,17,41
110 Vintl,20,,21,21,42
110 Vintl,21,,19,26,45
110 Vintl,22,,33,19,52
110 Vintl,23,,32,16,48
110 Vintl,24,,21,35,56
110 Vintl,25,,16,22,38
110 Vintl,26,,22,27,49
110 Vintl,27,,24,19,43
110 Vintl,28,,26,24,50
110 Vintl,29,,20,20,40
110 Vintl,30,,34,20,54
110 Vintl,31,,31,27,58
110 Vintl,32,,22,20,42
110 Vintl,33,,30,26,56
110 Vintl,34,,26,23,49
110 Vintl,35,,31,35,66
110 Vintl,36,,33,29,62
110 Vintl,37,,36,31,67
110 Vintl,38,,36,24,60
110 Vintl,39,,31,26,57
110 Vintl,40,,31,24,55
110 Vintl,41,,28,31,59
110 Vintl,42,,17,24,41
110 Vintl,43,,22,23,45
110 Vintl,44,,19,13,32
110 Vintl,45,,23,28,51
110 Vintl,46,,24,18,42
110 Vintl,47,,19,14,33
110 Vintl,48,,16,18,34
110 Vintl,49,,22,9,31
110 Vintl,50,,19,19,38
110 Vintl,51,,22,18,40
110 Vintl,52,,22,18,40
110 Vintl,53,,16,17,33
110 Vintl,54,,13,13,26
110 Vintl,55,,20,14,34
110 Vintl,56,,15,13,28
110 Vintl,57,,16,19,35
110 Vintl,58,,11,5,16
110 Vintl,59,,21,11,32
110 Vintl,60,,11,13,24
110 Vintl,61,,6,16,22
110 Vintl,62,,8,20,28
110 Vintl,63,,17,15,32
110 Vintl,64,,12,5,17
110 Vintl,65,,11,10,21
110 Vintl,66,,15,10,25
110 Vintl,67,,9,11,20
110 Vintl,68,,17,8,25
110 Vintl,69,,6,18,24
110 Vintl,70,,10,15,25
110 Vintl,71,,10,11,21
110 Vintl,72,,8,15,23
110 Vintl,73,,10,16,26
110 Vintl,74,,12,8,20
110 Vintl,75,,9,15,24
110 Vintl,76,,15,7,22
110 Vintl,77,,7,8,15
110 Vintl,78,,7,9,16
110 Vintl,79,,8,8,16
110 Vintl,80,,4,6,10
110 Vintl,81,,5,6,11
110 Vintl,82,,2,7,9
110 Vintl,83,,2,4,6
110 Vintl,84,,-,2,2
110 Vintl,85,,2,3,5
110 Vintl,86,,1,2,3
110 Vintl,87,,1,3,4
110 Vintl,88,,2,4,6
110 Vintl,89,,-,4,4
110 Vintl,90,,1,1,2
110 Vintl,91,,-,4,4
110 Vintl,92,,1,2,3
110 Vintl,93,,-,1,1
110 Vintl,94,,-,1,1
110 Vintl,95,,1,-,1
111 Vahrn,0,,30,23,53
111 Vahrn,1,,29,19,48
111 Vahrn,2,,24,20,44
111 Vahrn,3,,24,33,57
111 Vahrn,4,,23,21,44
111 Vahrn,5,,18,23,41
111 Vahrn,6,,32,19,51
111 Vahrn,7,,19,14,33
111 Vahrn,8,,20,22,42
111 Vahrn,9,,20,18,38
111 Vahrn,10,,17,21,38
111 Vahrn,11,,19,22,41
111 Vahrn,12,,13,25,38
111 Vahrn,13,,29,20,49
111 Vahrn,14,,23,20,43
111 Vahrn,15,,17,17,34
111 Vahrn,16,,19,15,34
111 Vahrn,17,,28,28,56
111 Vahrn,18,,19,19,38
111 Vahrn,19,,26,26,52
111 Vahrn,20,,24,24,48
111 Vahrn,21,,29,20,49
111 Vahrn,22,,24,23,47
111 Vahrn,23,,16,28,44
111 Vahrn,24,,19,24,43
111 Vahrn,25,,14,21,35
111 Vahrn,26,,34,19,53
111 Vahrn,27,,36,27,63
111 Vahrn,28,,23,35,58
111 Vahrn,29,,32,38,70
111 Vahrn,30,,32,28,60
111 Vahrn,31,,36,35,71
111 Vahrn,32,,38,38,76
111 Vahrn,33,,36,37,73
111 Vahrn,34,,27,28,55
111 Vahrn,35,,45,28,73
111 Vahrn,36,,36,31,67
111 Vahrn,37,,41,40,81
111 Vahrn,38,,37,33,70
111 Vahrn,39,,30,29,59
111 Vahrn,40,,34,34,68
111 Vahrn,41,,24,21,45
111 Vahrn,42,,33,29,62
111 Vahrn,43,,26,19,45
111 Vahrn,44,,19,18,37
111 Vahrn,45,,28,30,58
111 Vahrn,46,,20,17,37
111 Vahrn,47,,29,29,58
111 Vahrn,48,,20,30,50
111 Vahrn,49,,23,26,49
111 Vahrn,50,,24,17,41
111 Vahrn,51,,21,12,33
111 Vahrn,52,,17,17,34
111 Vahrn,53,,22,26,48
111 Vahrn,54,,18,13,31
111 Vahrn,55,,15,24,39
111 Vahrn,56,,20,22,42
111 Vahrn,57,,11,16,27
111 Vahrn,58,,18,20,38
111 Vahrn,59,,25,24,49
111 Vahrn,60,,19,22,41
111 Vahrn,61,,21,23,44
111 Vahrn,62,,20,15,35
111 Vahrn,63,,19,19,38
111 Vahrn,64,,14,10,24
111 Vahrn,65,,15,19,34
111 Vahrn,66,,12,17,29
111 Vahrn,67,,11,14,25
111 Vahrn,68,,10,15,25
111 Vahrn,69,,9,13,22
111 Vahrn,70,,11,14,25
111 Vahrn,71,,11,15,26
111 Vahrn,72,,15,16,31
111 Vahrn,73,,7,17,24
111 Vahrn,74,,10,12,22
111 Vahrn,75,,8,18,26
111 Vahrn,76,,7,4,11
111 Vahrn,77,,5,14,19
111 Vahrn,78,,7,18,25
111 Vahrn,79,,8,11,19
111 Vahrn,80,,5,12,17
111 Vahrn,81,,7,8,15
111 Vahrn,82,,3,4,7
111 Vahrn,83,,2,3,5
111 Vahrn,84,,3,4,7
111 Vahrn,85,,3,5,8
111 Vahrn,86,,1,-,1
111 Vahrn,87,,-,5,5
111 Vahrn,88,,1,2,3
111 Vahrn,89,,1,2,3
111 Vahrn,90,,1,2,3
111 Vahrn,91,,-,2,2
111 Vahrn,92,,-,2,2
111 Vahrn,93,,-,1,1
111 Vahrn,94,,-,1,1
111 Vahrn,96,,-,1,1
111 Vahrn,97,,-,1,1
112 Vöran,0,,5,6,11
112 Vöran,1,,7,4,11
112 Vöran,2,,12,5,17
112 Vöran,3,,6,3,9
112 Vöran,4,,6,4,10
112 Vöran,5,,14,5,19
112 Vöran,6,,9,6,15
112 Vöran,7,,6,9,15
112 Vöran,8,,7,8,15
112 Vöran,9,,7,7,14
112 Vöran,10,,6,3,9
112 Vöran,11,,7,3,10
112 Vöran,12,,5,7,12
112 Vöran,13,,11,6,17
112 Vöran,14,,8,8,16
112 Vöran,15,,11,6,17
112 Vöran,16,,6,7,13
112 Vöran,17,,9,11,20
112 Vöran,18,,9,4,13
112 Vöran,19,,6,6,12
112 Vöran,20,,8,8,16
112 Vöran,21,,10,9,19
112 Vöran,22,,4,4,8
112 Vöran,23,,4,7,11
112 Vöran,24,,10,9,19
112 Vöran,25,,12,7,19
112 Vöran,26,,6,4,10
112 Vöran,27,,6,5,11
112 Vöran,28,,9,8,17
112 Vöran,29,,4,5,9
112 Vöran,30,,10,7,17
112 Vöran,31,,5,11,16
112 Vöran,32,,9,6,15
112 Vöran,33,,6,3,9
112 Vöran,34,,14,3,17
112 Vöran,35,,4,7,11
112 Vöran,36,,8,7,15
112 Vöran,37,,4,3,7
112 Vöran,38,,11,4,15
112 Vöran,39,,8,7,15
112 Vöran,40,,12,15,27
112 Vöran,41,,6,7,13
112 Vöran,42,,6,6,12
112 Vöran,43,,5,9,14
112 Vöran,44,,6,5,11
112 Vöran,45,,4,9,13
112 Vöran,46,,2,2,4
112 Vöran,47,,5,2,7
112 Vöran,48,,6,6,12
112 Vöran,49,,5,4,9
112 Vöran,50,,9,1,10
112 Vöran,51,,2,-,2
112 Vöran,52,,7,4,11
112 Vöran,53,,6,5,11
112 Vöran,54,,2,3,5
112 Vöran,55,,6,4,10
112 Vöran,56,,4,2,6
112 Vöran,57,,-,3,3
112 Vöran,58,,4,3,7
112 Vöran,59,,3,5,8
112 Vöran,60,,6,4,10
112 Vöran,61,,5,6,11
112 Vöran,62,,3,5,8
112 Vöran,63,,2,3,5
112 Vöran,64,,8,4,12
112 Vöran,65,,2,2,4
112 Vöran,66,,3,5,8
112 Vöran,67,,2,1,3
112 Vöran,68,,1,7,8
112 Vöran,69,,6,6,12
112 Vöran,70,,3,5,8
112 Vöran,71,,5,1,6
112 Vöran,72,,5,1,6
112 Vöran,73,,1,3,4
112 Vöran,74,,5,1,6
112 Vöran,75,,-,2,2
112 Vöran,76,,-,3,3
112 Vöran,77,,4,4,8
112 Vöran,78,,-,2,2
112 Vöran,79,,2,1,3
112 Vöran,80,,2,-,2
112 Vöran,81,,1,1,2
112 Vöran,82,,-,2,2
112 Vöran,86,,1,2,3
112 Vöran,89,,-,1,1
112 Vöran,93,,-,1,1
112 Vöran,98,,-,1,1
113 Niederdorf,0,,5,10,15
113 Niederdorf,1,,6,9,15
113 Niederdorf,2,,10,11,21
113 Niederdorf,3,,5,5,10
113 Niederdorf,4,,7,8,15
113 Niederdorf,5,,9,9,18
113 Niederdorf,6,,7,8,15
113 Niederdorf,7,,6,11,17
113 Niederdorf,8,,13,7,20
113 Niederdorf,9,,9,7,16
113 Niederdorf,10,,7,9,16
113 Niederdorf,11,,7,12,19
113 Niederdorf,12,,12,10,22
113 Niederdorf,13,,9,7,16
113 Niederdorf,14,,7,10,17
113 Niederdorf,15,,2,8,10
113 Niederdorf,16,,4,7,11
113 Niederdorf,17,,8,5,13
113 Niederdorf,18,,8,5,13
113 Niederdorf,19,,7,8,15
113 Niederdorf,20,,2,10,12
113 Niederdorf,21,,10,7,17
113 Niederdorf,22,,10,4,14
113 Niederdorf,23,,10,3,13
113 Niederdorf,24,,4,2,6
113 Niederdorf,25,,6,4,10
113 Niederdorf,26,,11,5,16
113 Niederdorf,27,,6,9,15
113 Niederdorf,28,,9,9,18
113 Niederdorf,29,,13,6,19
113 Niederdorf,30,,15,10,25
113 Niederdorf,31,,11,13,24
113 Niederdorf,32,,11,12,23
113 Niederdorf,33,,20,12,32
113 Niederdorf,34,,15,10,25
113 Niederdorf,35,,12,14,26
113 Niederdorf,36,,24,10,34
113 Niederdorf,37,,9,14,23
113 Niederdorf,38,,18,13,31
113 Niederdorf,39,,12,10,22
113 Niederdorf,40,,17,9,26
113 Niederdorf,41,,13,13,26
113 Niederdorf,42,,9,8,17
113 Niederdorf,43,,10,9,19
113 Niederdorf,44,,6,6,12
113 Niederdorf,45,,11,9,20
113 Niederdorf,46,,9,10,19
113 Niederdorf,47,,11,7,18
113 Niederdorf,48,,12,7,19
113 Niederdorf,49,,7,3,10
113 Niederdorf,50,,8,4,12
113 Niederdorf,51,,1,1,2
113 Niederdorf,52,,5,4,9
113 Niederdorf,53,,9,4,13
113 Niederdorf,54,,4,9,13
113 Niederdorf,55,,6,9,15
113 Niederdorf,56,,6,7,13
113 Niederdorf,57,,2,6,8
113 Niederdorf,58,,9,5,14
113 Niederdorf,59,,5,9,14
113 Niederdorf,60,,6,11,17
113 Niederdorf,61,,5,5,10
113 Niederdorf,62,,5,6,11
113 Niederdorf,63,,1,4,5
113 Niederdorf,64,,5,6,11
113 Niederdorf,65,,6,7,13
113 Niederdorf,66,,6,8,14
113 Niederdorf,67,,7,7,14
113 Niederdorf,68,,2,13,15
113 Niederdorf,69,,6,7,13
113 Niederdorf,70,,8,7,15
113 Niederdorf,71,,8,7,15
113 Niederdorf,72,,6,9,15
113 Niederdorf,73,,3,9,12
113 Niederdorf,74,,5,6,11
113 Niederdorf,75,,8,9,17
113 Niederdorf,76,,4,6,10
113 Niederdorf,77,,1,6,7
113 Niederdorf,78,,3,9,12
113 Niederdorf,79,,2,3,5
113 Niederdorf,80,,3,9,12
113 Niederdorf,81,,5,4,9
113 Niederdorf,82,,1,4,5
113 Niederdorf,83,,1,3,4
113 Niederdorf,84,,1,2,3
113 Niederdorf,85,,1,1,2
113 Niederdorf,86,,-,2,2
113 Niederdorf,87,,-,3,3
113 Niederdorf,88,,-,2,2
113 Niederdorf,89,,1,1,2
113 Niederdorf,90,,-,2,2
113 Niederdorf,91,,-,1,1
113 Niederdorf,92,,-,1,1
113 Niederdorf,94,,-,1,1
113 Niederdorf,95,,-,1,1
113 Niederdorf,97,,-,1,1
114 Villanders,0,,9,13,22
114 Villanders,1,,14,12,26
114 Villanders,2,,11,15,26
114 Villanders,3,,13,11,24
114 Villanders,4,,13,8,21
114 Villanders,5,,10,13,23
114 Villanders,6,,15,8,23
114 Villanders,7,,18,6,24
114 Villanders,8,,11,13,24
114 Villanders,9,,7,18,25
114 Villanders,10,,14,8,22
114 Villanders,11,,19,16,35
114 Villanders,12,,16,14,30
114 Villanders,13,,13,10,23
114 Villanders,14,,10,12,22
114 Villanders,15,,7,15,22
114 Villanders,16,,8,8,16
114 Villanders,17,,10,10,20
114 Villanders,18,,13,12,25
114 Villanders,19,,14,6,20
114 Villanders,20,,15,12,27
114 Villanders,21,,20,14,34
114 Villanders,22,,10,17,27
114 Villanders,23,,17,8,25
114 Villanders,24,,13,14,27
114 Villanders,25,,15,13,28
114 Villanders,26,,13,12,25
114 Villanders,27,,9,12,21
114 Villanders,28,,14,16,30
114 Villanders,29,,12,19,31
114 Villanders,30,,13,15,28
114 Villanders,31,,18,24,42
114 Villanders,32,,18,8,26
114 Villanders,33,,26,20,46
114 Villanders,34,,23,10,33
114 Villanders,35,,19,17,36
114 Villanders,36,,21,17,38
114 Villanders,37,,21,16,37
114 Villanders,38,,20,17,37
114 Villanders,39,,15,15,30
114 Villanders,40,,18,12,30
114 Villanders,41,,14,13,27
114 Villanders,42,,19,7,26
114 Villanders,43,,16,11,27
114 Villanders,44,,17,7,24
114 Villanders,45,,9,7,16
114 Villanders,46,,10,13,23
114 Villanders,47,,11,17,28
114 Villanders,48,,9,5,14
114 Villanders,49,,10,8,18
114 Villanders,50,,11,7,18
114 Villanders,51,,10,7,17
114 Villanders,52,,10,9,19
114 Villanders,53,,10,6,16
114 Villanders,54,,7,12,19
114 Villanders,55,,7,8,15
114 Villanders,56,,11,10,21
114 Villanders,57,,6,4,10
114 Villanders,58,,5,9,14
114 Villanders,59,,7,8,15
114 Villanders,60,,10,8,18
114 Villanders,61,,8,9,17
114 Villanders,62,,8,12,20
114 Villanders,63,,8,5,13
114 Villanders,64,,9,6,15
114 Villanders,65,,5,9,14
114 Villanders,66,,6,6,12
114 Villanders,67,,2,8,10
114 Villanders,68,,1,9,10
114 Villanders,69,,10,9,19
114 Villanders,70,,8,9,17
114 Villanders,71,,5,7,12
114 Villanders,72,,9,6,15
114 Villanders,73,,3,9,12
114 Villanders,74,,3,8,11
114 Villanders,75,,8,6,14
114 Villanders,76,,5,5,10
114 Villanders,77,,2,7,9
114 Villanders,78,,5,4,9
114 Villanders,79,,6,3,9
114 Villanders,80,,3,5,8
114 Villanders,81,,2,11,13
114 Villanders,82,,4,4,8
114 Villanders,83,,-,2,2
114 Villanders,85,,-,1,1
114 Villanders,86,,-,1,1
114 Villanders,87,,-,3,3
114 Villanders,88,,1,4,5
114 Villanders,89,,1,3,4
114 Villanders,90,,1,4,5
114 Villanders,91,,-,6,6
114 Villanders,92,,1,2,3
114 Villanders,93,,-,2,2
114 Villanders,95,,-,1,1
114 Villanders,96,,1,-,1
114 Villanders,99,,-,1,1
114 Villanders,101,,-,1,1
115 Sterzing,0,,40,22,62
115 Sterzing,1,,34,37,71
115 Sterzing,2,,25,36,61
115 Sterzing,3,,25,29,54
115 Sterzing,4,,23,28,51
115 Sterzing,5,,34,34,68
115 Sterzing,6,,28,38,66
115 Sterzing,7,,34,29,63
115 Sterzing,8,,34,22,56
115 Sterzing,9,,34,29,63
115 Sterzing,10,,30,33,63
115 Sterzing,11,,36,35,71
115 Sterzing,12,,21,33,54
115 Sterzing,13,,36,22,58
115 Sterzing,14,,29,26,55
115 Sterzing,15,,29,25,54
115 Sterzing,16,,37,29,66
115 Sterzing,17,,16,30,46
115 Sterzing,18,,32,25,57
115 Sterzing,19,,27,32,59
115 Sterzing,20,,27,36,63
115 Sterzing,21,,47,35,82
115 Sterzing,22,,34,43,77
115 Sterzing,23,,36,50,86
115 Sterzing,24,,51,33,84
115 Sterzing,25,,43,33,76
115 Sterzing,26,,39,43,82
115 Sterzing,27,,62,46,108
115 Sterzing,28,,52,34,86
115 Sterzing,29,,48,56,104
115 Sterzing,30,,58,54,112
115 Sterzing,31,,67,52,119
115 Sterzing,32,,51,53,104
115 Sterzing,33,,44,35,79
115 Sterzing,34,,60,47,107
115 Sterzing,35,,63,42,105
115 Sterzing,36,,50,55,105
115 Sterzing,37,,56,48,104
115 Sterzing,38,,51,43,94
115 Sterzing,39,,60,51,111
115 Sterzing,40,,40,47,87
115 Sterzing,41,,43,39,82
115 Sterzing,42,,46,47,93
115 Sterzing,43,,54,41,95
115 Sterzing,44,,44,42,86
115 Sterzing,45,,34,49,83
115 Sterzing,46,,50,29,79
115 Sterzing,47,,35,46,81
115 Sterzing,48,,33,37,70
115 Sterzing,49,,32,40,72
115 Sterzing,50,,42,40,82
115 Sterzing,51,,38,40,78
115 Sterzing,52,,35,40,75
115 Sterzing,53,,33,50,83
115 Sterzing,54,,38,44,82
115 Sterzing,55,,32,28,60
115 Sterzing,56,,46,44,90
115 Sterzing,57,,35,35,70
115 Sterzing,58,,32,29,61
115 Sterzing,59,,46,45,91
115 Sterzing,60,,30,34,64
115 Sterzing,61,,32,28,60
115 Sterzing,62,,45,32,77
115 Sterzing,63,,30,31,61
115 Sterzing,64,,29,28,57
115 Sterzing,65,,23,35,58
115 Sterzing,66,,25,44,69
115 Sterzing,67,,22,23,45
115 Sterzing,68,,21,25,46
115 Sterzing,69,,27,29,56
115 Sterzing,70,,17,18,35
115 Sterzing,71,,23,33,56
115 Sterzing,72,,8,26,34
115 Sterzing,73,,21,19,40
115 Sterzing,74,,18,28,46
115 Sterzing,75,,21,20,41
115 Sterzing,76,,15,21,36
115 Sterzing,77,,7,22,29
115 Sterzing,78,,13,18,31
115 Sterzing,79,,12,19,31
115 Sterzing,80,,15,25,40
115 Sterzing,81,,5,17,22
115 Sterzing,82,,3,10,13
115 Sterzing,83,,6,8,14
115 Sterzing,84,,4,5,9
115 Sterzing,85,,4,5,9
115 Sterzing,86,,3,8,11
115 Sterzing,87,,2,6,8
115 Sterzing,88,,2,11,13
115 Sterzing,89,,1,5,6
115 Sterzing,90,,1,7,8
115 Sterzing,91,,-,4,4
115 Sterzing,92,,1,2,3
115 Sterzing,93,,1,3,4
115 Sterzing,94,,2,-,2
115 Sterzing,95,,-,1,1
115 Sterzing,96,,-,1,1
115 Sterzing,100,,-,1,1
115 Sterzing,101,,-,1,1
116 Feldthurns,0,,21,24,45
116 Feldthurns,1,,14,22,36
116 Feldthurns,2,,25,13,38
116 Feldthurns,3,,18,24,42
116 Feldthurns,4,,20,18,38
116 Feldthurns,5,,23,16,39
116 Feldthurns,6,,16,19,35
116 Feldthurns,7,,20,18,38
116 Feldthurns,8,,15,16,31
116 Feldthurns,9,,31,20,51
116 Feldthurns,10,,17,19,36
116 Feldthurns,11,,12,15,27
116 Feldthurns,12,,14,18,32
116 Feldthurns,13,,20,15,35
116 Feldthurns,14,,15,19,34
116 Feldthurns,15,,21,13,34
116 Feldthurns,16,,17,20,37
116 Feldthurns,17,,13,20,33
116 Feldthurns,18,,16,19,35
116 Feldthurns,19,,25,24,49
116 Feldthurns,20,,15,22,37
116 Feldthurns,21,,20,18,38
116 Feldthurns,22,,11,26,37
116 Feldthurns,23,,14,15,29
116 Feldthurns,24,,31,23,54
116 Feldthurns,25,,18,16,34
116 Feldthurns,26,,24,22,46
116 Feldthurns,27,,19,16,35
116 Feldthurns,28,,26,30,56
116 Feldthurns,29,,21,21,42
116 Feldthurns,30,,35,25,60
116 Feldthurns,31,,18,25,43
116 Feldthurns,32,,17,24,41
116 Feldthurns,33,,23,26,49
116 Feldthurns,34,,18,26,44
116 Feldthurns,35,,25,22,47
116 Feldthurns,36,,20,20,40
116 Feldthurns,37,,23,29,52
116 Feldthurns,38,,25,18,43
116 Feldthurns,39,,26,17,43
116 Feldthurns,40,,15,17,32
116 Feldthurns,41,,17,18,35
116 Feldthurns,42,,17,12,29
116 Feldthurns,43,,15,15,30
116 Feldthurns,44,,15,19,34
116 Feldthurns,45,,14,13,27
116 Feldthurns,46,,12,18,30
116 Feldthurns,47,,15,13,28
116 Feldthurns,48,,13,15,28
116 Feldthurns,49,,18,13,31
116 Feldthurns,50,,25,15,40
116 Feldthurns,51,,15,11,26
116 Feldthurns,52,,14,15,29
116 Feldthurns,53,,7,15,22
116 Feldthurns,54,,14,11,25
116 Feldthurns,55,,16,8,24
116 Feldthurns,56,,10,9,19
116 Feldthurns,57,,13,13,26
116 Feldthurns,58,,21,11,32
116 Feldthurns,59,,13,13,26
116 Feldthurns,60,,9,9,18
116 Feldthurns,61,,8,4,12
116 Feldthurns,62,,11,7,18
116 Feldthurns,63,,8,11,19
116 Feldthurns,64,,11,8,19
116 Feldthurns,65,,3,10,13
116 Feldthurns,66,,9,11,20
116 Feldthurns,67,,10,11,21
116 Feldthurns,68,,3,5,8
116 Feldthurns,69,,7,5,12
116 Feldthurns,70,,7,10,17
116 Feldthurns,71,,4,7,11
116 Feldthurns,72,,5,14,19
116 Feldthurns,73,,4,11,15
116 Feldthurns,74,,9,4,13
116 Feldthurns,75,,5,5,10
116 Feldthurns,76,,3,9,12
116 Feldthurns,77,,6,9,15
116 Feldthurns,78,,4,9,13
116 Feldthurns,79,,8,10,18
116 Feldthurns,80,,2,10,12
116 Feldthurns,81,,2,9,11
116 Feldthurns,82,,8,10,18
116 Feldthurns,83,,5,7,12
116 Feldthurns,84,,3,-,3
116 Feldthurns,85,,-,2,2
116 Feldthurns,86,,-,3,3
116 Feldthurns,87,,2,8,10
116 Feldthurns,88,,1,4,5
116 Feldthurns,89,,-,1,1
116 Feldthurns,90,,1,2,3
116 Feldthurns,91,,-,1,1
116 Feldthurns,93,,1,-,1
116 Feldthurns,96,,-,1,1
116 Feldthurns,98,,-,1,1
117 Wengen,0,,7,3,10
117 Wengen,1,,5,10,15
117 Wengen,2,,11,5,16
117 Wengen,3,,9,5,14
117 Wengen,4,,7,7,14
117 Wengen,5,,12,7,19
117 Wengen,6,,9,9,18
117 Wengen,7,,11,9,20
117 Wengen,8,,12,7,19
117 Wengen,9,,11,7,18
117 Wengen,10,,10,7,17
117 Wengen,11,,17,6,23
117 Wengen,12,,12,7,19
117 Wengen,13,,5,7,12
117 Wengen,14,,6,9,15
117 Wengen,15,,11,5,16
117 Wengen,16,,8,8,16
117 Wengen,17,,9,6,15
117 Wengen,18,,14,7,21
117 Wengen,19,,13,5,18
117 Wengen,20,,11,5,16
117 Wengen,21,,6,7,13
117 Wengen,22,,9,9,18
117 Wengen,23,,14,5,19
117 Wengen,24,,6,6,12
117 Wengen,25,,9,8,17
117 Wengen,26,,6,10,16
117 Wengen,27,,16,10,26
117 Wengen,28,,10,7,17
117 Wengen,29,,16,12,28
117 Wengen,30,,12,11,23
117 Wengen,31,,12,13,25
117 Wengen,32,,11,14,25
117 Wengen,33,,10,13,23
117 Wengen,34,,18,11,29
117 Wengen,35,,10,12,22
117 Wengen,36,,13,5,18
117 Wengen,37,,8,10,18
117 Wengen,38,,11,6,17
117 Wengen,39,,11,13,24
117 Wengen,40,,14,7,21
117 Wengen,41,,8,9,17
117 Wengen,42,,10,12,22
117 Wengen,43,,7,7,14
117 Wengen,44,,5,8,13
117 Wengen,45,,7,11,18
117 Wengen,46,,5,6,11
117 Wengen,47,,8,6,14
117 Wengen,48,,9,5,14
117 Wengen,49,,6,2,8
117 Wengen,50,,6,7,13
117 Wengen,51,,9,5,14
117 Wengen,52,,3,6,9
117 Wengen,53,,5,9,14
117 Wengen,54,,2,12,14
117 Wengen,55,,6,3,9
117 Wengen,56,,5,3,8
117 Wengen,57,,5,3,8
117 Wengen,58,,9,8,17
117 Wengen,59,,3,7,10
117 Wengen,60,,8,6,14
117 Wengen,61,,4,4,8
117 Wengen,62,,7,9,16
117 Wengen,63,,6,3,9
117 Wengen,64,,5,4,9
117 Wengen,65,,7,7,14
117 Wengen,66,,2,1,3
117 Wengen,67,,2,7,9
117 Wengen,68,,2,9,11
117 Wengen,69,,4,2,6
117 Wengen,70,,3,8,11
117 Wengen,71,,5,2,7
117 Wengen,72,,5,3,8
117 Wengen,73,,2,9,11
117 Wengen,74,,2,4,6
117 Wengen,75,,4,5,9
117 Wengen,76,,4,5,9
117 Wengen,77,,3,4,7
117 Wengen,78,,2,6,8
117 Wengen,79,,3,6,9
117 Wengen,80,,3,5,8
117 Wengen,81,,4,8,12
117 Wengen,82,,2,2,4
117 Wengen,83,,1,1,2
117 Wengen,85,,2,-,2
117 Wengen,87,,1,1,2
117 Wengen,89,,-,2,2
117 Wengen,90,,1,-,1
117 Wengen,92,,-,1,1
117 Wengen,94,,-,2,2
117 Wengen,96,,1,-,1
117 Wengen,98,,-,1,1
118 U.L.Frau i.W.-St.Felix,0,,5,3,8
118 U.L.Frau i.W.-St.Felix,1,,6,5,11
118 U.L.Frau i.W.-St.Felix,2,,3,2,5
118 U.L.Frau i.W.-St.Felix,3,,5,5,10
118 U.L.Frau i.W.-St.Felix,4,,6,8,14
118 U.L.Frau i.W.-St.Felix,5,,5,4,9
118 U.L.Frau i.W.-St.Felix,6,,8,5,13
118 U.L.Frau i.W.-St.Felix,7,,4,10,14
118 U.L.Frau i.W.-St.Felix,8,,7,8,15
118 U.L.Frau i.W.-St.Felix,9,,9,5,14
118 U.L.Frau i.W.-St.Felix,10,,7,4,11
118 U.L.Frau i.W.-St.Felix,11,,10,8,18
118 U.L.Frau i.W.-St.Felix,12,,7,4,11
118 U.L.Frau i.W.-St.Felix,13,,8,6,14
118 U.L.Frau i.W.-St.Felix,14,,8,6,14
118 U.L.Frau i.W.-St.Felix,15,,4,7,11
118 U.L.Frau i.W.-St.Felix,16,,7,4,11
118 U.L.Frau i.W.-St.Felix,17,,5,7,12
118 U.L.Frau i.W.-St.Felix,18,,5,6,11
118 U.L.Frau i.W.-St.Felix,19,,2,12,14
118 U.L.Frau i.W.-St.Felix,20,,3,6,9
118 U.L.Frau i.W.-St.Felix,21,,6,4,10
118 U.L.Frau i.W.-St.Felix,22,,3,6,9
118 U.L.Frau i.W.-St.Felix,23,,2,3,5
118 U.L.Frau i.W.-St.Felix,24,,1,4,5
118 U.L.Frau i.W.-St.Felix,25,,4,2,6
118 U.L.Frau i.W.-St.Felix,26,,4,9,13
118 U.L.Frau i.W.-St.Felix,27,,8,3,11
118 U.L.Frau i.W.-St.Felix,28,,5,6,11
118 U.L.Frau i.W.-St.Felix,29,,4,4,8
118 U.L.Frau i.W.-St.Felix,30,,8,4,12
118 U.L.Frau i.W.-St.Felix,31,,2,3,5
118 U.L.Frau i.W.-St.Felix,32,,5,8,13
118 U.L.Frau i.W.-St.Felix,33,,7,4,11
118 U.L.Frau i.W.-St.Felix,34,,5,10,15
118 U.L.Frau i.W.-St.Felix,35,,3,5,8
118 U.L.Frau i.W.-St.Felix,36,,8,7,15
118 U.L.Frau i.W.-St.Felix,37,,11,6,17
118 U.L.Frau i.W.-St.Felix,38,,4,8,12
118 U.L.Frau i.W.-St.Felix,39,,16,8,24
118 U.L.Frau i.W.-St.Felix,40,,8,10,18
118 U.L.Frau i.W.-St.Felix,41,,4,4,8
118 U.L.Frau i.W.-St.Felix,42,,8,9,17
118 U.L.Frau i.W.-St.Felix,43,,5,5,10
118 U.L.Frau i.W.-St.Felix,44,,5,2,7
118 U.L.Frau i.W.-St.Felix,45,,3,5,8
118 U.L.Frau i.W.-St.Felix,46,,5,7,12
118 U.L.Frau i.W.-St.Felix,47,,3,4,7
118 U.L.Frau i.W.-St.Felix,48,,7,3,10
118 U.L.Frau i.W.-St.Felix,49,,3,3,6
118 U.L.Frau i.W.-St.Felix,50,,6,3,9
118 U.L.Frau i.W.-St.Felix,51,,6,3,9
118 U.L.Frau i.W.-St.Felix,52,,3,3,6
118 U.L.Frau i.W.-St.Felix,53,,5,-,5
118 U.L.Frau i.W.-St.Felix,54,,4,2,6
118 U.L.Frau i.W.-St.Felix,55,,2,6,8
118 U.L.Frau i.W.-St.Felix,56,,1,5,6
118 U.L.Frau i.W.-St.Felix,57,,3,1,4
118 U.L.Frau i.W.-St.Felix,58,,5,1,6
118 U.L.Frau i.W.-St.Felix,59,,7,4,11
118 U.L.Frau i.W.-St.Felix,60,,4,4,8
118 U.L.Frau i.W.-St.Felix,61,,5,8,13
118 U.L.Frau i.W.-St.Felix,62,,3,1,4
118 U.L.Frau i.W.-St.Felix,63,,1,4,5
118 U.L.Frau i.W.-St.Felix,64,,3,4,7
118 U.L.Frau i.W.-St.Felix,65,,3,-,3
118 U.L.Frau i.W.-St.Felix,66,,5,2,7
118 U.L.Frau i.W.-St.Felix,67,,3,3,6
118 U.L.Frau i.W.-St.Felix,68,,3,3,6
118 U.L.Frau i.W.-St.Felix,69,,5,4,9
118 U.L.Frau i.W.-St.Felix,70,,7,1,8
118 U.L.Frau i.W.-St.Felix,71,,4,1,5
118 U.L.Frau i.W.-St.Felix,72,,4,5,9
118 U.L.Frau i.W.-St.Felix,73,,1,3,4
118 U.L.Frau i.W.-St.Felix,74,,3,5,8
118 U.L.Frau i.W.-St.Felix,75,,3,4,7
118 U.L.Frau i.W.-St.Felix,76,,2,3,5
118 U.L.Frau i.W.-St.Felix,77,,4,5,9
118 U.L.Frau i.W.-St.Felix,78,,4,4,8
118 U.L.Frau i.W.-St.Felix,79,,2,5,7
118 U.L.Frau i.W.-St.Felix,80,,1,1,2
118 U.L.Frau i.W.-St.Felix,81,,-,3,3
118 U.L.Frau i.W.-St.Felix,82,,-,1,1
118 U.L.Frau i.W.-St.Felix,83,,1,2,3
118 U.L.Frau i.W.-St.Felix,85,,1,-,1
118 U.L.Frau i.W.-St.Felix,87,,-,1,1
118 U.L.Frau i.W.-St.Felix,88,,-,1,1
118 U.L.Frau i.W.-St.Felix,89,,1,1,2
118 U.L.Frau i.W.-St.Felix,90,,2,2,4
118 U.L.Frau i.W.-St.Felix,92,,-,2,2
