Gemeinde,Altersklassen,Geschlecht,Männer,Frauen,Insgesamt
001 Aldein,0,,16,9,25
001 Aldein,1,,10,11,21
001 Aldein,2,,16,10,26
001 Aldein,3,,13,4,17
001 Aldein,4,,16,14,30
001 Aldein,5,,10,15,25
001 Aldein,6,,14,9,23
001 Aldein,7,,7,8,15
001 Aldein,8,,9,12,21
001 Aldein,9,,14,8,22
001 Aldein,10,,13,12,25
001 Aldein,11,,9,13,22
001 Aldein,12,,7,8,15
001 Aldein,13,,8,6,14
001 Aldein,14,,9,16,25
001 Aldein,15,,11,9,20
001 Aldein,16,,11,8,19
001 Aldein,17,,11,10,21
001 Aldein,18,,12,12,24
001 Aldein,19,,10,7,17
001 Aldein,20,,14,13,27
001 Aldein,21,,15,6,21
001 Aldein,22,,10,14,24
001 Aldein,23,,10,15,25
001 Aldein,24,,11,19,30
001 Aldein,25,,10,7,17
001 Aldein,26,,8,22,30
001 Aldein,27,,13,16,29
001 Aldein,28,,16,16,32
001 Aldein,29,,11,15,26
001 Aldein,30,,16,8,24
001 Aldein,31,,18,13,31
001 Aldein,32,,16,16,32
001 Aldein,33,,13,15,28
001 Aldein,34,,22,7,29
001 Aldein,35,,12,16,28
001 Aldein,36,,6,16,22
001 Aldein,37,,7,20,27
001 Aldein,38,,17,10,27
001 Aldein,39,,14,10,24
001 Aldein,40,,15,6,21
001 Aldein,41,,8,16,24
001 Aldein,42,,15,16,31
001 Aldein,43,,16,9,25
001 Aldein,44,,12,13,25
001 Aldein,45,,8,5,13
001 Aldein,46,,9,10,19
001 Aldein,47,,10,8,18
001 Aldein,48,,8,10,18
001 Aldein,49,,9,7,16
001 Aldein,50,,8,10,18
001 Aldein,51,,9,5,14
001 Aldein,52,,15,11,26
001 Aldein,53,,5,12,17
001 Aldein,54,,8,6,14
001 Aldein,55,,9,9,18
001 Aldein,56,,6,11,17
001 Aldein,57,,7,11,18
001 Aldein,58,,10,5,15
001 Aldein,59,,6,7,13
001 Aldein,60,,11,10,21
001 Aldein,61,,8,13,21
001 Aldein,62,,6,12,18
001 Aldein,63,,9,8,17
001 Aldein,64,,5,8,13
001 Aldein,65,,6,7,13
001 Aldein,66,,7,10,17
001 Aldein,67,,8,6,14
001 Aldein,68,,4,4,8
001 Aldein,69,,15,5,20
001 Aldein,70,,8,3,11
001 Aldein,71,,4,7,11
001 Aldein,72,,8,4,12
001 Aldein,73,,5,5,10
001 Aldein,74,,8,9,17
001 Aldein,75,,5,3,8
001 Aldein,76,,6,5,11
001 Aldein,77,,-,5,5
001 Aldein,78,,1,5,6
001 Aldein,79,,2,8,10
001 Aldein,80,,2,5,7
001 Aldein,81,,1,9,10
001 Aldein,82,,4,10,14
001 Aldein,83,,4,2,6
001 Aldein,84,,-,4,4
001 Aldein,86,,-,1,1
001 Aldein,87,,2,1,3
001 Aldein,89,,-,1,1
001 Aldein,90,,-,3,3
001 Aldein,91,,2,2,4
001 Aldein,93,,1,-,1
001 Aldein,96,,-,1,1
002 Andrian,0,,7,5,12
002 Andrian,1,,2,-,2
002 Andrian,2,,2,5,7
002 Andrian,3,,5,4,9
002 Andrian,4,,2,6,8
002 Andrian,5,,8,1,9
002 Andrian,6,,9,6,15
002 Andrian,7,,2,10,12
002 Andrian,8,,8,4,12
002 Andrian,9,,5,5,10
002 Andrian,10,,5,5,10
002 Andrian,11,,6,6,12
002 Andrian,12,,5,7,12
002 Andrian,13,,5,4,9
002 Andrian,14,,4,3,7
002 Andrian,15,,12,7,19
002 Andrian,16,,6,7,13
002 Andrian,17,,8,6,14
002 Andrian,18,,1,3,4
002 Andrian,19,,6,5,11
002 Andrian,20,,5,2,7
002 Andrian,21,,10,6,16
002 Andrian,22,,2,3,5
002 Andrian,23,,6,3,9
002 Andrian,24,,6,4,10
002 Andrian,25,,5,6,11
002 Andrian,26,,4,5,9
002 Andrian,27,,5,4,9
002 Andrian,28,,5,3,8
002 Andrian,29,,5,7,12
002 Andrian,30,,6,8,14
002 Andrian,31,,7,6,13
002 Andrian,32,,7,12,19
002 Andrian,33,,12,5,17
002 Andrian,34,,5,7,12
002 Andrian,35,,8,8,16
002 Andrian,36,,8,7,15
002 Andrian,37,,9,7,16
002 Andrian,38,,10,7,17
002 Andrian,39,,8,7,15
002 Andrian,40,,7,13,20
002 Andrian,41,,9,7,16
002 Andrian,42,,8,2,10
002 Andrian,43,,7,4,11
002 Andrian,44,,6,5,11
002 Andrian,45,,8,8,16
002 Andrian,46,,5,7,12
002 Andrian,47,,5,9,14
002 Andrian,48,,2,4,6
002 Andrian,49,,6,2,8
002 Andrian,50,,7,7,14
002 Andrian,51,,2,3,5
002 Andrian,52,,3,3,6
002 Andrian,53,,7,6,13
002 Andrian,54,,4,2,6
002 Andrian,55,,7,3,10
002 Andrian,56,,5,5,10
002 Andrian,57,,4,8,12
002 Andrian,58,,1,2,3
002 Andrian,59,,1,3,4
002 Andrian,60,,5,7,12
002 Andrian,61,,4,5,9
002 Andrian,62,,6,4,10
002 Andrian,63,,4,8,12
002 Andrian,64,,1,8,9
002 Andrian,65,,4,4,8
002 Andrian,66,,6,4,10
002 Andrian,67,,2,2,4
002 Andrian,68,,2,3,5
002 Andrian,69,,5,3,8
002 Andrian,70,,3,4,7
002 Andrian,71,,7,5,12
002 Andrian,72,,3,4,7
002 Andrian,73,,4,1,5
002 Andrian,74,,2,1,3
002 Andrian,75,,2,4,6
002 Andrian,76,,1,2,3
002 Andrian,77,,3,4,7
002 Andrian,78,,2,1,3
002 Andrian,79,,2,5,7
002 Andrian,80,,1,1,2
002 Andrian,81,,1,4,5
002 Andrian,82,,1,4,5
002 Andrian,83,,1,-,1
002 Andrian,84,,2,2,4
002 Andrian,85,,1,1,2
002 Andrian,87,,1,-,1
002 Andrian,88,,1,2,3
002 Andrian,89,,1,1,2
002 Andrian,90,,1,1,2
002 Andrian,92,,-,1,1
002 Andrian,96,,-,1,1
003 Altrei,0,,-,1,1
003 Altrei,1,,3,2,5
003 Altrei,2,,3,1,4
003 Altrei,3,,1,1,2
003 Altrei,4,,3,-,3
003 Altrei,5,,3,1,4
003 Altrei,6,,1,1,2
003 Altrei,7,,-,3,3
003 Altrei,8,,1,2,3
003 Altrei,9,,3,2,5
003 Altrei,10,,3,-,3
003 Altrei,11,,6,3,9
003 Altrei,12,,1,1,2
003 Altrei,13,,3,2,5
003 Altrei,14,,2,2,4
003 Altrei,15,,4,4,8
003 Altrei,16,,1,1,2
003 Altrei,17,,3,3,6
003 Altrei,18,,2,1,3
003 Altrei,19,,4,1,5
003 Altrei,20,,4,2,6
003 Altrei,21,,2,2,4
003 Altrei,22,,3,1,4
003 Altrei,23,,3,3,6
003 Altrei,24,,-,1,1
003 Altrei,25,,2,5,7
003 Altrei,26,,-,4,4
003 Altrei,27,,2,3,5
003 Altrei,28,,3,1,4
003 Altrei,29,,1,-,1
003 Altrei,30,,2,3,5
003 Altrei,31,,2,1,3
003 Altrei,32,,5,4,9
003 Altrei,33,,1,3,4
003 Altrei,34,,3,6,9
003 Altrei,35,,-,4,4
003 Altrei,36,,3,-,3
003 Altrei,37,,3,4,7
003 Altrei,38,,2,4,6
003 Altrei,39,,3,6,9
003 Altrei,40,,2,2,4
003 Altrei,41,,11,1,12
003 Altrei,42,,2,2,4
003 Altrei,43,,5,2,7
003 Altrei,44,,5,3,8
003 Altrei,45,,1,3,4
003 Altrei,46,,1,3,4
003 Altrei,47,,5,1,6
003 Altrei,48,,4,3,7
003 Altrei,49,,1,1,2
003 Altrei,50,,3,2,5
003 Altrei,51,,6,3,9
003 Altrei,52,,6,3,9
003 Altrei,53,,1,2,3
003 Altrei,54,,1,-,1
003 Altrei,55,,3,3,6
003 Altrei,56,,3,2,5
003 Altrei,57,,1,3,4
003 Altrei,58,,3,-,3
003 Altrei,59,,2,3,5
003 Altrei,60,,1,3,4
003 Altrei,61,,3,1,4
003 Altrei,62,,1,3,4
003 Altrei,63,,1,4,5
003 Altrei,64,,1,3,4
003 Altrei,65,,1,-,1
003 Altrei,66,,2,1,3
003 Altrei,67,,3,1,4
003 Altrei,68,,3,2,5
003 Altrei,69,,-,2,2
003 Altrei,70,,3,3,6
003 Altrei,71,,-,3,3
003 Altrei,72,,-,2,2
003 Altrei,73,,2,2,4
003 Altrei,74,,2,3,5
003 Altrei,75,,-,2,2
003 Altrei,76,,2,4,6
003 Altrei,77,,1,4,5
003 Altrei,78,,-,1,1
003 Altrei,79,,1,2,3
003 Altrei,80,,1,2,3
003 Altrei,81,,1,1,2
003 Altrei,82,,-,1,1
003 Altrei,83,,1,1,2
003 Altrei,86,,-,3,3
003 Altrei,88,,-,1,1
003 Altrei,89,,-,2,2
003 Altrei,90,,1,1,2
003 Altrei,91,,1,-,1
003 Altrei,92,,-,2,2
003 Altrei,95,,-,1,1
004 Eppan a.d. Weinstr.,0,,86,72,158
004 Eppan a.d. Weinstr.,1,,75,74,149
004 Eppan a.d. Weinstr.,2,,80,74,154
004 Eppan a.d. Weinstr.,3,,70,82,152
004 Eppan a.d. Weinstr.,4,,79,55,134
004 Eppan a.d. Weinstr.,5,,87,79,166
004 Eppan a.d. Weinstr.,6,,73,73,146
004 Eppan a.d. Weinstr.,7,,76,71,147
004 Eppan a.d. Weinstr.,8,,71,66,137
004 Eppan a.d. Weinstr.,9,,72,74,146
004 Eppan a.d. Weinstr.,10,,79,86,165
004 Eppan a.d. Weinstr.,11,,64,77,141
004 Eppan a.d. Weinstr.,12,,75,63,138
004 Eppan a.d. Weinstr.,13,,83,63,146
004 Eppan a.d. Weinstr.,14,,77,59,136
004 Eppan a.d. Weinstr.,15,,80,82,162
004 Eppan a.d. Weinstr.,16,,73,67,140
004 Eppan a.d. Weinstr.,17,,87,70,157
004 Eppan a.d. Weinstr.,18,,82,57,139
004 Eppan a.d. Weinstr.,19,,76,74,150
004 Eppan a.d. Weinstr.,20,,66,71,137
004 Eppan a.d. Weinstr.,21,,66,69,135
004 Eppan a.d. Weinstr.,22,,56,67,123
004 Eppan a.d. Weinstr.,23,,80,71,151
004 Eppan a.d. Weinstr.,24,,76,72,148
004 Eppan a.d. Weinstr.,25,,79,77,156
004 Eppan a.d. Weinstr.,26,,78,58,136
004 Eppan a.d. Weinstr.,27,,77,70,147
004 Eppan a.d. Weinstr.,28,,91,92,183
004 Eppan a.d. Weinstr.,29,,85,96,181
004 Eppan a.d. Weinstr.,30,,92,98,190
004 Eppan a.d. Weinstr.,31,,113,118,231
004 Eppan a.d. Weinstr.,32,,108,103,211
004 Eppan a.d. Weinstr.,33,,130,117,247
004 Eppan a.d. Weinstr.,34,,124,117,241
004 Eppan a.d. Weinstr.,35,,117,110,227
004 Eppan a.d. Weinstr.,36,,129,116,245
004 Eppan a.d. Weinstr.,37,,119,136,255
004 Eppan a.d. Weinstr.,38,,100,116,216
004 Eppan a.d. Weinstr.,39,,128,118,246
004 Eppan a.d. Weinstr.,40,,102,127,229
004 Eppan a.d. Weinstr.,41,,124,116,240
004 Eppan a.d. Weinstr.,42,,126,102,228
004 Eppan a.d. Weinstr.,43,,104,117,221
004 Eppan a.d. Weinstr.,44,,119,105,224
004 Eppan a.d. Weinstr.,45,,104,102,206
004 Eppan a.d. Weinstr.,46,,97,94,191
004 Eppan a.d. Weinstr.,47,,86,75,161
004 Eppan a.d. Weinstr.,48,,89,85,174
004 Eppan a.d. Weinstr.,49,,68,88,156
004 Eppan a.d. Weinstr.,50,,84,74,158
004 Eppan a.d. Weinstr.,51,,72,80,152
004 Eppan a.d. Weinstr.,52,,83,65,148
004 Eppan a.d. Weinstr.,53,,61,72,133
004 Eppan a.d. Weinstr.,54,,66,63,129
004 Eppan a.d. Weinstr.,55,,81,67,148
004 Eppan a.d. Weinstr.,56,,71,83,154
004 Eppan a.d. Weinstr.,57,,81,70,151
004 Eppan a.d. Weinstr.,58,,61,52,113
004 Eppan a.d. Weinstr.,59,,74,82,156
004 Eppan a.d. Weinstr.,60,,98,83,181
004 Eppan a.d. Weinstr.,61,,95,80,175
004 Eppan a.d. Weinstr.,62,,66,106,172
004 Eppan a.d. Weinstr.,63,,76,59,135
004 Eppan a.d. Weinstr.,64,,61,84,145
004 Eppan a.d. Weinstr.,65,,63,54,117
004 Eppan a.d. Weinstr.,66,,46,57,103
004 Eppan a.d. Weinstr.,67,,46,52,98
004 Eppan a.d. Weinstr.,68,,42,49,91
004 Eppan a.d. Weinstr.,69,,32,55,87
004 Eppan a.d. Weinstr.,70,,55,56,111
004 Eppan a.d. Weinstr.,71,,48,50,98
004 Eppan a.d. Weinstr.,72,,40,60,100
004 Eppan a.d. Weinstr.,73,,51,63,114
004 Eppan a.d. Weinstr.,74,,42,52,94
004 Eppan a.d. Weinstr.,75,,40,44,84
004 Eppan a.d. Weinstr.,76,,34,43,77
004 Eppan a.d. Weinstr.,77,,40,50,90
004 Eppan a.d. Weinstr.,78,,37,57,94
004 Eppan a.d. Weinstr.,79,,21,64,85
004 Eppan a.d. Weinstr.,80,,24,41,65
004 Eppan a.d. Weinstr.,81,,12,42,54
004 Eppan a.d. Weinstr.,82,,22,40,62
004 Eppan a.d. Weinstr.,83,,14,28,42
004 Eppan a.d. Weinstr.,84,,13,23,36
004 Eppan a.d. Weinstr.,85,,10,16,26
004 Eppan a.d. Weinstr.,86,,10,8,18
004 Eppan a.d. Weinstr.,87,,6,16,22
004 Eppan a.d. Weinstr.,88,,7,11,18
004 Eppan a.d. Weinstr.,89,,6,21,27
004 Eppan a.d. Weinstr.,90,,4,11,15
004 Eppan a.d. Weinstr.,91,,1,18,19
004 Eppan a.d. Weinstr.,92,,3,15,18
004 Eppan a.d. Weinstr.,93,,1,7,8
004 Eppan a.d. Weinstr.,94,,3,9,12
004 Eppan a.d. Weinstr.,95,,-,5,5
004 Eppan a.d. Weinstr.,96,,-,5,5
004 Eppan a.d. Weinstr.,97,,1,3,4
004 Eppan a.d. Weinstr.,98,,1,-,1
004 Eppan a.d. Weinstr.,99,,-,1,1
005 Hafling,0,,1,5,6
005 Hafling,1,,5,4,9
005 Hafling,2,,7,2,9
005 Hafling,3,,5,9,14
005 Hafling,4,,4,4,8
005 Hafling,5,,2,7,9
005 Hafling,6,,1,10,11
005 Hafling,7,,12,5,17
005 Hafling,8,,6,6,12
005 Hafling,9,,3,5,8
005 Hafling,10,,3,7,10
005 Hafling,11,,3,5,8
005 Hafling,12,,8,3,11
005 Hafling,13,,5,6,11
005 Hafling,14,,4,2,6
005 Hafling,15,,2,7,9
005 Hafling,16,,4,4,8
005 Hafling,17,,5,2,7
005 Hafling,18,,5,5,10
005 Hafling,19,,4,8,12
005 Hafling,20,,3,-,3
005 Hafling,21,,6,4,10
005 Hafling,22,,5,4,9
005 Hafling,23,,3,10,13
005 Hafling,24,,4,3,7
005 Hafling,25,,5,5,10
005 Hafling,26,,3,3,6
005 Hafling,27,,4,6,10
005 Hafling,28,,8,5,13
005 Hafling,29,,6,10,16
005 Hafling,30,,11,2,13
005 Hafling,31,,9,1,10
005 Hafling,32,,9,6,15
005 Hafling,33,,8,6,14
005 Hafling,34,,11,10,21
005 Hafling,35,,3,8,11
005 Hafling,36,,5,2,7
005 Hafling,37,,10,7,17
005 Hafling,38,,9,11,20
005 Hafling,39,,3,2,5
005 Hafling,40,,7,3,10
005 Hafling,41,,5,2,7
005 Hafling,42,,7,4,11
005 Hafling,43,,8,6,14
005 Hafling,44,,6,5,11
005 Hafling,45,,3,4,7
005 Hafling,46,,2,5,7
005 Hafling,47,,3,10,13
005 Hafling,48,,7,3,10
005 Hafling,49,,3,1,4
005 Hafling,50,,2,3,5
005 Hafling,51,,5,2,7
005 Hafling,52,,2,3,5
005 Hafling,53,,4,3,7
005 Hafling,54,,5,3,8
005 Hafling,55,,6,2,8
005 Hafling,56,,2,4,6
005 Hafling,57,,-,4,4
005 Hafling,58,,5,3,8
005 Hafling,59,,1,3,4
005 Hafling,60,,4,5,9
005 Hafling,61,,5,3,8
005 Hafling,62,,5,4,9
005 Hafling,63,,2,2,4
005 Hafling,64,,4,5,9
005 Hafling,65,,3,3,6
005 Hafling,66,,3,3,6
005 Hafling,67,,1,1,2
005 Hafling,68,,1,1,2
005 Hafling,69,,1,2,3
005 Hafling,70,,7,4,11
005 Hafling,71,,3,4,7
005 Hafling,72,,3,7,10
005 Hafling,73,,1,4,5
005 Hafling,74,,3,1,4
005 Hafling,75,,3,3,6
005 Hafling,76,,3,5,8
005 Hafling,77,,1,2,3
005 Hafling,78,,1,-,1
005 Hafling,79,,1,2,3
005 Hafling,80,,1,-,1
005 Hafling,81,,-,3,3
005 Hafling,82,,-,3,3
005 Hafling,83,,3,1,4
005 Hafling,84,,1,2,3
005 Hafling,86,,-,1,1
005 Hafling,87,,-,1,1
005 Hafling,88,,1,-,1
005 Hafling,90,,-,1,1
005 Hafling,91,,-,1,1
005 Hafling,92,,1,-,1
006 Abtei,0,,20,17,37
006 Abtei,1,,10,27,37
006 Abtei,2,,28,24,52
006 Abtei,3,,20,31,51
006 Abtei,4,,23,27,50
006 Abtei,5,,13,13,26
006 Abtei,6,,25,22,47
006 Abtei,7,,29,14,43
006 Abtei,8,,24,27,51
006 Abtei,9,,19,14,33
006 Abtei,10,,15,19,34
006 Abtei,11,,23,15,38
006 Abtei,12,,21,12,33
006 Abtei,13,,23,16,39
006 Abtei,14,,15,14,29
006 Abtei,15,,14,10,24
006 Abtei,16,,19,12,31
006 Abtei,17,,17,18,35
006 Abtei,18,,11,14,25
006 Abtei,19,,12,20,32
006 Abtei,20,,14,11,25
006 Abtei,21,,18,20,38
006 Abtei,22,,16,19,35
006 Abtei,23,,23,17,40
006 Abtei,24,,12,23,35
006 Abtei,25,,22,28,50
006 Abtei,26,,21,27,48
006 Abtei,27,,29,25,54
006 Abtei,28,,19,28,47
006 Abtei,29,,20,24,44
006 Abtei,30,,26,26,52
006 Abtei,31,,43,27,70
006 Abtei,32,,16,32,48
006 Abtei,33,,29,31,60
006 Abtei,34,,30,34,64
006 Abtei,35,,27,34,61
006 Abtei,36,,38,36,74
006 Abtei,37,,22,31,53
006 Abtei,38,,35,28,63
006 Abtei,39,,24,31,55
006 Abtei,40,,32,26,58
006 Abtei,41,,24,29,53
006 Abtei,42,,22,27,49
006 Abtei,43,,27,22,49
006 Abtei,44,,26,23,49
006 Abtei,45,,18,23,41
006 Abtei,46,,19,15,34
006 Abtei,47,,19,17,36
006 Abtei,48,,16,15,31
006 Abtei,49,,11,14,25
006 Abtei,50,,14,18,32
006 Abtei,51,,13,13,26
006 Abtei,52,,11,13,24
006 Abtei,53,,15,20,35
006 Abtei,54,,10,19,29
006 Abtei,55,,24,17,41
006 Abtei,56,,15,16,31
006 Abtei,57,,23,19,42
006 Abtei,58,,17,20,37
006 Abtei,59,,14,18,32
006 Abtei,60,,12,11,23
006 Abtei,61,,21,11,32
006 Abtei,62,,17,24,41
006 Abtei,63,,18,19,37
006 Abtei,64,,16,13,29
006 Abtei,65,,16,17,33
006 Abtei,66,,6,18,24
006 Abtei,67,,17,10,27
006 Abtei,68,,13,18,31
006 Abtei,69,,15,16,31
006 Abtei,70,,9,15,24
006 Abtei,71,,8,6,14
006 Abtei,72,,12,13,25
006 Abtei,73,,15,12,27
006 Abtei,74,,8,8,16
006 Abtei,75,,8,15,23
006 Abtei,76,,7,9,16
006 Abtei,77,,8,6,14
006 Abtei,78,,8,7,15
006 Abtei,79,,6,10,16
006 Abtei,80,,6,10,16
006 Abtei,81,,7,6,13
006 Abtei,82,,4,2,6
006 Abtei,83,,3,9,12
006 Abtei,84,,1,5,6
006 Abtei,85,,2,4,6
006 Abtei,87,,1,3,4
006 Abtei,88,,-,2,2
006 Abtei,89,,-,2,2
006 Abtei,90,,2,-,2
006 Abtei,91,,1,4,5
006 Abtei,92,,1,3,4
006 Abtei,93,,1,2,3
006 Abtei,94,,1,-,1
006 Abtei,95,,-,1,1
006 Abtei,96,,-,1,1
006 Abtei,98,,-,1,1
007 Barbian,0,,9,15,24
007 Barbian,1,,7,6,13
007 Barbian,2,,10,15,25
007 Barbian,3,,12,6,18
007 Barbian,4,,11,10,21
007 Barbian,5,,16,8,24
007 Barbian,6,,12,7,19
007 Barbian,7,,10,10,20
007 Barbian,8,,11,8,19
007 Barbian,9,,8,4,12
007 Barbian,10,,10,12,22
007 Barbian,11,,13,6,19
007 Barbian,12,,12,12,24
007 Barbian,13,,14,13,27
007 Barbian,14,,11,13,24
007 Barbian,15,,13,6,19
007 Barbian,16,,8,7,15
007 Barbian,17,,14,8,22
007 Barbian,18,,7,11,18
007 Barbian,19,,10,7,17
007 Barbian,20,,11,7,18
007 Barbian,21,,9,6,15
007 Barbian,22,,13,14,27
007 Barbian,23,,9,6,15
007 Barbian,24,,18,12,30
007 Barbian,25,,11,10,21
007 Barbian,26,,7,17,24
007 Barbian,27,,9,15,24
007 Barbian,28,,9,9,18
007 Barbian,29,,15,13,28
007 Barbian,30,,8,16,24
007 Barbian,31,,21,17,38
007 Barbian,32,,16,12,28
007 Barbian,33,,11,11,22
007 Barbian,34,,15,6,21
007 Barbian,35,,13,13,26
007 Barbian,36,,7,8,15
007 Barbian,37,,13,15,28
007 Barbian,38,,8,13,21
007 Barbian,39,,15,15,30
007 Barbian,40,,14,14,28
007 Barbian,41,,15,14,29
007 Barbian,42,,17,11,28
007 Barbian,43,,12,15,27
007 Barbian,44,,12,9,21
007 Barbian,45,,7,9,16
007 Barbian,46,,16,7,23
007 Barbian,47,,4,9,13
007 Barbian,48,,7,7,14
007 Barbian,49,,6,14,20
007 Barbian,50,,10,9,19
007 Barbian,51,,8,5,13
007 Barbian,52,,7,10,17
007 Barbian,53,,12,11,23
007 Barbian,54,,5,6,11
007 Barbian,55,,3,4,7
007 Barbian,56,,6,10,16
007 Barbian,57,,18,6,24
007 Barbian,58,,8,4,12
007 Barbian,59,,10,8,18
007 Barbian,60,,7,6,13
007 Barbian,61,,11,12,23
007 Barbian,62,,8,12,20
007 Barbian,63,,9,3,12
007 Barbian,64,,6,5,11
007 Barbian,65,,5,10,15
007 Barbian,66,,8,8,16
007 Barbian,67,,3,5,8
007 Barbian,68,,3,8,11
007 Barbian,69,,5,5,10
007 Barbian,70,,8,5,13
007 Barbian,71,,4,7,11
007 Barbian,72,,4,8,12
007 Barbian,73,,7,6,13
007 Barbian,74,,8,8,16
007 Barbian,75,,5,9,14
007 Barbian,76,,5,2,7
007 Barbian,77,,4,3,7
007 Barbian,78,,5,3,8
007 Barbian,79,,3,5,8
007 Barbian,80,,3,8,11
007 Barbian,81,,2,4,6
007 Barbian,82,,1,3,4
007 Barbian,83,,1,2,3
007 Barbian,84,,-,3,3
007 Barbian,85,,1,-,1
007 Barbian,86,,-,1,1
007 Barbian,87,,1,1,2
007 Barbian,88,,-,3,3
007 Barbian,89,,1,3,4
007 Barbian,90,,-,1,1
007 Barbian,92,,2,1,3
007 Barbian,93,,1,-,1
007 Barbian,95,,-,1,1
008 Bozen,0,,464,466,930
008 Bozen,1,,461,420,881
008 Bozen,2,,465,414,879
008 Bozen,3,,429,433,862
008 Bozen,4,,478,451,929
008 Bozen,5,,430,437,867
008 Bozen,6,,453,370,823
008 Bozen,7,,422,442,864
008 Bozen,8,,407,370,777
008 Bozen,9,,447,425,872
008 Bozen,10,,401,397,798
008 Bozen,11,,416,377,793
008 Bozen,12,,463,384,847
008 Bozen,13,,438,400,838
008 Bozen,14,,425,392,817
008 Bozen,15,,415,396,811
008 Bozen,16,,349,380,729
008 Bozen,17,,377,365,742
008 Bozen,18,,407,373,780
008 Bozen,19,,399,386,785
008 Bozen,20,,442,365,807
008 Bozen,21,,428,410,838
008 Bozen,22,,440,403,843
008 Bozen,23,,508,420,928
008 Bozen,24,,452,459,911
008 Bozen,25,,552,465,1.017
008 Bozen,26,,570,491,1.061
008 Bozen,27,,557,579,1.136
008 Bozen,28,,685,626,1.311
008 Bozen,29,,696,688,1.384
008 Bozen,30,,715,767,1.482
008 Bozen,31,,776,741,1.517
008 Bozen,32,,843,832,1.675
008 Bozen,33,,834,742,1.576
008 Bozen,34,,895,802,1.697
008 Bozen,35,,781,754,1.535
008 Bozen,36,,786,789,1.575
008 Bozen,37,,877,838,1.715
008 Bozen,38,,874,833,1.707
008 Bozen,39,,885,887,1.772
008 Bozen,40,,760,808,1.568
008 Bozen,41,,750,764,1.514
008 Bozen,42,,765,717,1.482
008 Bozen,43,,685,682,1.367
008 Bozen,44,,686,676,1.362
008 Bozen,45,,675,669,1.344
008 Bozen,46,,612,703,1.315
008 Bozen,47,,624,644,1.268
008 Bozen,48,,617,621,1.238
008 Bozen,49,,612,595,1.207
008 Bozen,50,,548,596,1.144
008 Bozen,51,,544,650,1.194
008 Bozen,52,,535,633,1.168
008 Bozen,53,,592,682,1.274
008 Bozen,54,,615,634,1.249
008 Bozen,55,,651,732,1.383
008 Bozen,56,,642,803,1.445
008 Bozen,57,,724,881,1.605
008 Bozen,58,,550,591,1.141
008 Bozen,59,,594,731,1.325
008 Bozen,60,,641,731,1.372
008 Bozen,61,,651,720,1.371
008 Bozen,62,,713,764,1.477
008 Bozen,63,,685,745,1.430
008 Bozen,64,,597,726,1.323
008 Bozen,65,,640,665,1.305
008 Bozen,66,,547,587,1.134
008 Bozen,67,,499,570,1.069
008 Bozen,68,,478,578,1.056
008 Bozen,69,,502,576,1.078
008 Bozen,70,,427,575,1.002
008 Bozen,71,,445,583,1.028
008 Bozen,72,,436,561,997
008 Bozen,73,,441,569,1.010
008 Bozen,74,,336,551,887
008 Bozen,75,,370,512,882
008 Bozen,76,,335,511,846
008 Bozen,77,,390,492,882
008 Bozen,78,,293,528,821
008 Bozen,79,,281,489,770
008 Bozen,80,,270,498,768
008 Bozen,81,,270,518,788
008 Bozen,82,,215,466,681
008 Bozen,83,,181,427,608
008 Bozen,84,,99,272,371
008 Bozen,85,,68,161,229
008 Bozen,86,,67,157,224
008 Bozen,87,,67,162,229
008 Bozen,88,,82,224,306
008 Bozen,89,,84,197,281
008 Bozen,90,,68,172,240
008 Bozen,91,,50,145,195
008 Bozen,92,,27,117,144
008 Bozen,93,,25,92,117
008 Bozen,94,,18,61,79
008 Bozen,95,,16,50,66
008 Bozen,96,,4,30,34
008 Bozen,97,,6,24,30
008 Bozen,98,,3,14,17
008 Bozen,99,,1,8,9
008 Bozen,100,,-,10,10
008 Bozen,101,,-,3,3
008 Bozen,102,,-,3,3
008 Bozen,103,,-,1,1
008 Bozen,104,,-,1,1
008 Bozen,106,,-,1,1
009 Prags,0,,2,3,5
009 Prags,1,,3,4,7
009 Prags,2,,4,5,9
009 Prags,3,,2,2,4
009 Prags,4,,4,9,13
009 Prags,5,,2,4,6
009 Prags,6,,3,5,8
009 Prags,7,,2,6,8
009 Prags,8,,2,2,4
009 Prags,9,,4,6,10
009 Prags,10,,7,4,11
009 Prags,11,,6,3,9
009 Prags,12,,9,2,11
009 Prags,13,,4,2,6
009 Prags,14,,8,3,11
009 Prags,15,,2,3,5
009 Prags,16,,3,3,6
009 Prags,17,,6,5,11
009 Prags,18,,8,2,10
009 Prags,19,,4,3,7
009 Prags,20,,3,7,10
009 Prags,21,,3,6,9
009 Prags,22,,1,6,7
009 Prags,23,,4,1,5
009 Prags,24,,2,1,3
009 Prags,25,,6,3,9
009 Prags,26,,5,2,7
009 Prags,27,,6,2,8
009 Prags,28,,3,5,8
009 Prags,29,,3,5,8
009 Prags,30,,7,5,12
009 Prags,31,,4,1,5
009 Prags,32,,5,4,9
009 Prags,33,,5,7,12
009 Prags,34,,8,4,12
009 Prags,35,,7,8,15
009 Prags,36,,6,7,13
009 Prags,37,,8,4,12
009 Prags,38,,8,6,14
009 Prags,39,,6,5,11
009 Prags,40,,6,5,11
009 Prags,41,,4,4,8
009 Prags,42,,5,11,16
009 Prags,43,,6,4,10
009 Prags,44,,11,5,16
009 Prags,45,,5,2,7
009 Prags,46,,5,4,9
009 Prags,47,,1,5,6
009 Prags,48,,3,4,7
009 Prags,49,,6,4,10
009 Prags,50,,4,2,6
009 Prags,51,,2,5,7
009 Prags,52,,3,1,4
009 Prags,53,,5,1,6
009 Prags,54,,1,1,2
009 Prags,55,,5,1,6
009 Prags,56,,1,-,1
009 Prags,57,,2,4,6
009 Prags,58,,2,2,4
009 Prags,59,,4,4,8
009 Prags,60,,1,4,5
009 Prags,61,,4,4,8
009 Prags,62,,5,2,7
009 Prags,63,,1,3,4
009 Prags,64,,3,5,8
009 Prags,65,,4,2,6
009 Prags,66,,1,3,4
009 Prags,67,,2,3,5
009 Prags,68,,1,3,4
009 Prags,69,,3,2,5
009 Prags,70,,5,2,7
009 Prags,71,,4,6,10
009 Prags,72,,1,4,5
009 Prags,73,,1,1,2
009 Prags,74,,3,1,4
009 Prags,75,,3,2,5
009 Prags,76,,1,5,6
009 Prags,77,,2,4,6
009 Prags,78,,1,5,6
009 Prags,79,,4,2,6
009 Prags,80,,-,4,4
009 Prags,81,,3,1,4
009 Prags,82,,1,3,4
009 Prags,83,,1,1,2
009 Prags,84,,-,2,2
009 Prags,86,,-,1,1
009 Prags,87,,-,1,1
009 Prags,88,,1,1,2
009 Prags,89,,-,1,1
009 Prags,91,,-,1,1
009 Prags,92,,-,1,1
010 Brenner,0,,10,9,19
010 Brenner,1,,13,14,27
010 Brenner,2,,8,8,16
010 Brenner,3,,15,12,27
010 Brenner,4,,11,15,26
010 Brenner,5,,17,2,19
010 Brenner,6,,16,6,22
010 Brenner,7,,5,11,16
010 Brenner,8,,6,9,15
010 Brenner,9,,20,12,32
010 Brenner,10,,13,8,21
010 Brenner,11,,11,9,20
010 Brenner,12,,8,18,26
010 Brenner,13,,10,8,18
010 Brenner,14,,15,5,20
010 Brenner,15,,11,4,15
010 Brenner,16,,8,8,16
010 Brenner,17,,12,10,22
010 Brenner,18,,19,8,27
010 Brenner,19,,14,16,30
010 Brenner,20,,18,19,37
010 Brenner,21,,14,6,20
010 Brenner,22,,9,14,23
010 Brenner,23,,8,11,19
010 Brenner,24,,15,11,26
010 Brenner,25,,21,11,32
010 Brenner,26,,16,12,28
010 Brenner,27,,12,10,22
010 Brenner,28,,11,26,37
010 Brenner,29,,18,12,30
010 Brenner,30,,15,11,26
010 Brenner,31,,18,23,41
010 Brenner,32,,26,14,40
010 Brenner,33,,25,18,43
010 Brenner,34,,16,17,33
010 Brenner,35,,13,19,32
010 Brenner,36,,21,16,37
010 Brenner,37,,17,18,35
010 Brenner,38,,25,20,45
010 Brenner,39,,22,16,38
010 Brenner,40,,12,20,32
010 Brenner,41,,20,13,33
010 Brenner,42,,23,11,34
010 Brenner,43,,20,11,31
010 Brenner,44,,17,12,29
010 Brenner,45,,17,10,27
010 Brenner,46,,15,19,34
010 Brenner,47,,15,13,28
010 Brenner,48,,15,9,24
010 Brenner,49,,9,15,24
010 Brenner,50,,10,15,25
010 Brenner,51,,20,8,28
010 Brenner,52,,15,11,26
010 Brenner,53,,12,12,24
010 Brenner,54,,17,16,33
010 Brenner,55,,5,8,13
010 Brenner,56,,22,13,35
010 Brenner,57,,9,17,26
010 Brenner,58,,7,9,16
010 Brenner,59,,18,14,32
010 Brenner,60,,22,14,36
010 Brenner,61,,6,9,15
010 Brenner,62,,12,12,24
010 Brenner,63,,11,11,22
010 Brenner,64,,9,7,16
010 Brenner,65,,10,17,27
010 Brenner,66,,10,14,24
010 Brenner,67,,13,7,20
010 Brenner,68,,5,6,11
010 Brenner,69,,9,9,18
010 Brenner,70,,6,8,14
010 Brenner,71,,2,4,6
010 Brenner,72,,6,10,16
010 Brenner,73,,8,11,19
010 Brenner,74,,12,10,22
010 Brenner,75,,9,9,18
010 Brenner,76,,7,3,10
010 Brenner,77,,8,9,17
010 Brenner,78,,3,8,11
010 Brenner,79,,2,10,12
010 Brenner,80,,5,10,15
010 Brenner,81,,1,7,8
010 Brenner,82,,1,4,5
010 Brenner,83,,2,7,9
010 Brenner,84,,3,3,6
010 Brenner,85,,2,-,2
010 Brenner,86,,-,2,2
010 Brenner,87,,1,-,1
010 Brenner,88,,1,3,4
010 Brenner,89,,1,3,4
010 Brenner,90,,-,2,2
010 Brenner,91,,-,4,4
010 Brenner,92,,2,-,2
010 Brenner,94,,-,1,1
011 Brixen,0,,100,90,190
011 Brixen,1,,100,106,206
011 Brixen,2,,116,113,229
011 Brixen,3,,113,114,227
011 Brixen,4,,137,116,253
011 Brixen,5,,106,139,245
011 Brixen,6,,114,98,212
011 Brixen,7,,114,107,221
011 Brixen,8,,106,114,220
011 Brixen,9,,119,118,237
011 Brixen,10,,105,102,207
011 Brixen,11,,112,116,228
011 Brixen,12,,114,101,215
011 Brixen,13,,95,109,204
011 Brixen,14,,114,90,204
011 Brixen,15,,115,98,213
011 Brixen,16,,100,92,192
011 Brixen,17,,99,109,208
011 Brixen,18,,111,91,202
011 Brixen,19,,118,85,203
011 Brixen,20,,115,120,235
011 Brixen,21,,119,107,226
011 Brixen,22,,116,101,217
011 Brixen,23,,94,100,194
011 Brixen,24,,121,93,214
011 Brixen,25,,83,106,189
011 Brixen,26,,126,114,240
011 Brixen,27,,124,131,255
011 Brixen,28,,116,107,223
011 Brixen,29,,139,143,282
011 Brixen,30,,139,153,292
011 Brixen,31,,150,149,299
011 Brixen,32,,150,144,294
011 Brixen,33,,167,145,312
011 Brixen,34,,189,180,369
011 Brixen,35,,167,187,354
011 Brixen,36,,169,154,323
011 Brixen,37,,167,188,355
011 Brixen,38,,178,164,342
011 Brixen,39,,182,181,363
011 Brixen,40,,151,170,321
011 Brixen,41,,167,161,328
011 Brixen,42,,137,165,302
011 Brixen,43,,145,147,292
011 Brixen,44,,153,139,292
011 Brixen,45,,152,115,267
011 Brixen,46,,131,137,268
011 Brixen,47,,110,139,249
011 Brixen,48,,121,90,211
011 Brixen,49,,100,110,210
011 Brixen,50,,84,108,192
011 Brixen,51,,97,101,198
011 Brixen,52,,99,103,202
011 Brixen,53,,107,97,204
011 Brixen,54,,78,122,200
011 Brixen,55,,113,115,228
011 Brixen,56,,92,112,204
011 Brixen,57,,103,110,213
011 Brixen,58,,68,98,166
011 Brixen,59,,117,107,224
011 Brixen,60,,131,117,248
011 Brixen,61,,93,99,192
011 Brixen,62,,106,123,229
011 Brixen,63,,88,123,211
011 Brixen,64,,97,108,205
011 Brixen,65,,90,97,187
011 Brixen,66,,86,94,180
011 Brixen,67,,67,92,159
011 Brixen,68,,77,83,160
011 Brixen,69,,72,96,168
011 Brixen,70,,79,68,147
011 Brixen,71,,73,81,154
011 Brixen,72,,69,87,156
011 Brixen,73,,65,97,162
011 Brixen,74,,55,93,148
011 Brixen,75,,62,75,137
011 Brixen,76,,40,93,133
011 Brixen,77,,42,69,111
011 Brixen,78,,53,78,131
011 Brixen,79,,43,79,122
011 Brixen,80,,42,63,105
011 Brixen,81,,32,76,108
011 Brixen,82,,23,72,95
011 Brixen,83,,24,55,79
011 Brixen,84,,17,40,57
011 Brixen,85,,10,26,36
011 Brixen,86,,14,32,46
011 Brixen,87,,5,19,24
011 Brixen,88,,7,28,35
011 Brixen,89,,17,31,48
011 Brixen,90,,7,35,42
011 Brixen,91,,6,26,32
011 Brixen,92,,3,21,24
011 Brixen,93,,3,19,22
011 Brixen,94,,3,10,13
011 Brixen,95,,2,8,10
011 Brixen,96,,2,6,8
011 Brixen,97,,-,3,3
011 Brixen,98,,2,1,3
011 Brixen,101,,-,1,1
011 Brixen,102,,-,1,1
012 Branzoll,0,,16,22,38
012 Branzoll,1,,13,9,22
012 Branzoll,2,,9,11,20
012 Branzoll,3,,18,9,27
012 Branzoll,4,,9,13,22
012 Branzoll,5,,12,8,20
012 Branzoll,6,,12,21,33
012 Branzoll,7,,15,7,22
012 Branzoll,8,,13,11,24
012 Branzoll,9,,15,8,23
012 Branzoll,10,,18,12,30
012 Branzoll,11,,16,10,26
012 Branzoll,12,,12,16,28
012 Branzoll,13,,9,17,26
012 Branzoll,14,,11,14,25
012 Branzoll,15,,15,13,28
012 Branzoll,16,,12,4,16
012 Branzoll,17,,8,12,20
012 Branzoll,18,,13,15,28
012 Branzoll,19,,14,9,23
012 Branzoll,20,,14,11,25
012 Branzoll,21,,16,14,30
012 Branzoll,22,,13,13,26
012 Branzoll,23,,8,14,22
012 Branzoll,24,,11,4,15
012 Branzoll,25,,11,17,28
012 Branzoll,26,,14,17,31
012 Branzoll,27,,19,13,32
012 Branzoll,28,,14,13,27
012 Branzoll,29,,17,22,39
012 Branzoll,30,,24,15,39
012 Branzoll,31,,17,15,32
012 Branzoll,32,,18,21,39
012 Branzoll,33,,19,21,40
012 Branzoll,34,,24,19,43
012 Branzoll,35,,22,22,44
012 Branzoll,36,,23,21,44
012 Branzoll,37,,21,19,40
012 Branzoll,38,,22,22,44
012 Branzoll,39,,28,26,54
012 Branzoll,40,,17,16,33
012 Branzoll,41,,19,19,38
012 Branzoll,42,,29,29,58
012 Branzoll,43,,24,18,42
012 Branzoll,44,,15,22,37
012 Branzoll,45,,21,15,36
012 Branzoll,46,,22,17,39
012 Branzoll,47,,13,15,28
012 Branzoll,48,,15,17,32
012 Branzoll,49,,21,16,37
012 Branzoll,50,,11,18,29
012 Branzoll,51,,15,18,33
012 Branzoll,52,,17,14,31
012 Branzoll,53,,18,14,32
012 Branzoll,54,,15,15,30
012 Branzoll,55,,15,17,32
012 Branzoll,56,,12,17,29
012 Branzoll,57,,15,22,37
012 Branzoll,58,,12,8,20
012 Branzoll,59,,13,10,23
012 Branzoll,60,,14,12,26
012 Branzoll,61,,18,7,25
012 Branzoll,62,,18,12,30
012 Branzoll,63,,11,13,24
012 Branzoll,64,,16,14,30
012 Branzoll,65,,9,11,20
012 Branzoll,66,,3,9,12
012 Branzoll,67,,8,9,17
012 Branzoll,68,,7,9,16
012 Branzoll,69,,5,10,15
012 Branzoll,70,,18,11,29
012 Branzoll,71,,10,11,21
012 Branzoll,72,,3,10,13
012 Branzoll,73,,8,16,24
012 Branzoll,74,,7,10,17
012 Branzoll,75,,7,10,17
012 Branzoll,76,,5,8,13
012 Branzoll,77,,7,11,18
012 Branzoll,78,,4,5,9
012 Branzoll,79,,3,8,11
012 Branzoll,80,,8,12,20
012 Branzoll,81,,1,5,6
012 Branzoll,82,,5,8,13
012 Branzoll,83,,1,5,6
012 Branzoll,84,,2,4,6
012 Branzoll,85,,2,4,6
012 Branzoll,86,,-,1,1
012 Branzoll,87,,1,-,1
012 Branzoll,88,,1,-,1
012 Branzoll,89,,-,4,4
012 Branzoll,90,,2,3,5
012 Branzoll,91,,1,3,4
012 Branzoll,92,,1,1,2
012 Branzoll,93,,1,1,2
012 Branzoll,94,,-,2,2
012 Branzoll,95,,-,1,1
012 Branzoll,96,,1,-,1
012 Branzoll,97,,1,-,1
013 Bruneck,0,,87,74,161
013 Bruneck,1,,62,87,149
013 Bruneck,2,,90,73,163
013 Bruneck,3,,77,87,164
013 Bruneck,4,,94,95,189
013 Bruneck,5,,91,82,173
013 Bruneck,6,,105,68,173
013 Bruneck,7,,71,82,153
013 Bruneck,8,,61,73,134
013 Bruneck,9,,81,74,155
013 Bruneck,10,,75,62,137
013 Bruneck,11,,88,74,162
013 Bruneck,12,,85,59,144
013 Bruneck,13,,85,70,155
013 Bruneck,14,,79,76,155
013 Bruneck,15,,67,72,139
013 Bruneck,16,,58,54,112
013 Bruneck,17,,106,71,177
013 Bruneck,18,,74,68,142
013 Bruneck,19,,79,74,153
013 Bruneck,20,,67,77,144
013 Bruneck,21,,72,74,146
013 Bruneck,22,,88,94,182
013 Bruneck,23,,105,90,195
013 Bruneck,24,,91,89,180
013 Bruneck,25,,117,93,210
013 Bruneck,26,,109,91,200
013 Bruneck,27,,94,99,193
013 Bruneck,28,,107,114,221
013 Bruneck,29,,104,99,203
013 Bruneck,30,,117,107,224
013 Bruneck,31,,114,118,232
013 Bruneck,32,,135,112,247
013 Bruneck,33,,119,131,250
013 Bruneck,34,,131,117,248
013 Bruneck,35,,116,140,256
013 Bruneck,36,,126,117,243
013 Bruneck,37,,130,110,240
013 Bruneck,38,,131,134,265
013 Bruneck,39,,131,133,264
013 Bruneck,40,,118,110,228
013 Bruneck,41,,123,108,231
013 Bruneck,42,,112,95,207
013 Bruneck,43,,103,115,218
013 Bruneck,44,,111,96,207
013 Bruneck,45,,102,102,204
013 Bruneck,46,,81,97,178
013 Bruneck,47,,85,94,179
013 Bruneck,48,,77,80,157
013 Bruneck,49,,86,83,169
013 Bruneck,50,,71,98,169
013 Bruneck,51,,86,97,183
013 Bruneck,52,,68,93,161
013 Bruneck,53,,83,93,176
013 Bruneck,54,,84,90,174
013 Bruneck,55,,79,106,185
013 Bruneck,56,,92,69,161
013 Bruneck,57,,101,81,182
013 Bruneck,58,,61,66,127
013 Bruneck,59,,90,94,184
013 Bruneck,60,,96,84,180
013 Bruneck,61,,90,85,175
013 Bruneck,62,,75,94,169
013 Bruneck,63,,77,86,163
013 Bruneck,64,,84,90,174
013 Bruneck,65,,56,54,110
013 Bruneck,66,,53,56,109
013 Bruneck,67,,55,55,110
013 Bruneck,68,,49,49,98
013 Bruneck,69,,44,51,95
013 Bruneck,70,,55,62,117
013 Bruneck,71,,55,50,105
013 Bruneck,72,,35,50,85
013 Bruneck,73,,40,64,104
013 Bruneck,74,,36,59,95
013 Bruneck,75,,41,60,101
013 Bruneck,76,,28,52,80
013 Bruneck,77,,30,38,68
013 Bruneck,78,,29,46,75
013 Bruneck,79,,15,57,72
013 Bruneck,80,,30,46,76
013 Bruneck,81,,23,41,64
013 Bruneck,82,,18,32,50
013 Bruneck,83,,13,34,47
013 Bruneck,84,,12,27,39
013 Bruneck,85,,3,18,21
013 Bruneck,86,,5,19,24
013 Bruneck,87,,2,25,27
013 Bruneck,88,,4,15,19
013 Bruneck,89,,6,17,23
013 Bruneck,90,,5,23,28
013 Bruneck,91,,8,17,25
013 Bruneck,92,,1,13,14
013 Bruneck,93,,6,3,9
013 Bruneck,94,,5,6,11
013 Bruneck,95,,-,5,5
013 Bruneck,96,,1,3,4
013 Bruneck,97,,-,2,2
013 Bruneck,98,,2,1,3
013 Bruneck,100,,-,1,1
013 Bruneck,101,,-,2,2
014 Kuens,0,,4,4,8
014 Kuens,1,,2,1,3
014 Kuens,2,,4,1,5
014 Kuens,3,,2,5,7
014 Kuens,4,,2,2,4
014 Kuens,5,,2,3,5
014 Kuens,6,,1,1,2
014 Kuens,7,,5,3,8
014 Kuens,8,,2,3,5
014 Kuens,9,,2,4,6
014 Kuens,10,,3,3,6
014 Kuens,11,,3,2,5
014 Kuens,12,,3,2,5
014 Kuens,13,,3,2,5
014 Kuens,14,,3,2,5
014 Kuens,15,,1,3,4
014 Kuens,16,,3,-,3
014 Kuens,17,,1,1,2
014 Kuens,19,,1,-,1
014 Kuens,20,,2,1,3
014 Kuens,21,,2,1,3
014 Kuens,22,,2,-,2
014 Kuens,23,,3,2,5
014 Kuens,24,,2,1,3
014 Kuens,25,,2,-,2
014 Kuens,26,,2,3,5
014 Kuens,27,,3,2,5
014 Kuens,28,,4,3,7
014 Kuens,29,,3,5,8
014 Kuens,30,,-,5,5
014 Kuens,31,,4,1,5
014 Kuens,32,,1,4,5
014 Kuens,33,,7,3,10
014 Kuens,34,,4,1,5
014 Kuens,35,,3,4,7
014 Kuens,36,,6,10,16
014 Kuens,37,,3,5,8
014 Kuens,38,,8,1,9
014 Kuens,39,,5,5,10
014 Kuens,40,,8,2,10
014 Kuens,41,,5,2,7
014 Kuens,42,,-,3,3
014 Kuens,44,,1,-,1
014 Kuens,45,,-,3,3
014 Kuens,46,,3,-,3
014 Kuens,47,,3,-,3
014 Kuens,48,,1,2,3
014 Kuens,50,,1,1,2
014 Kuens,51,,-,2,2
014 Kuens,53,,-,3,3
014 Kuens,54,,-,2,2
014 Kuens,55,,3,1,4
014 Kuens,56,,1,2,3
014 Kuens,57,,1,2,3
014 Kuens,58,,3,1,4
014 Kuens,60,,-,2,2
014 Kuens,61,,-,4,4
014 Kuens,62,,-,2,2
014 Kuens,63,,-,1,1
014 Kuens,64,,5,2,7
014 Kuens,65,,3,2,5
014 Kuens,66,,1,3,4
014 Kuens,67,,1,2,3
014 Kuens,68,,1,3,4
014 Kuens,69,,-,1,1
014 Kuens,70,,1,1,2
014 Kuens,71,,4,2,6
014 Kuens,72,,2,2,4
014 Kuens,73,,2,2,4
014 Kuens,74,,1,-,1
014 Kuens,75,,1,-,1
014 Kuens,76,,1,1,2
014 Kuens,77,,1,-,1
014 Kuens,81,,-,2,2
014 Kuens,84,,-,2,2
014 Kuens,87,,-,1,1
014 Kuens,88,,1,-,1
014 Kuens,91,,1,-,1
015 Kaltern a.d. Weinstr.,0,,42,34,76
015 Kaltern a.d. Weinstr.,1,,36,33,69
015 Kaltern a.d. Weinstr.,2,,34,46,80
015 Kaltern a.d. Weinstr.,3,,36,37,73
015 Kaltern a.d. Weinstr.,4,,44,36,80
015 Kaltern a.d. Weinstr.,5,,35,44,79
015 Kaltern a.d. Weinstr.,6,,42,41,83
015 Kaltern a.d. Weinstr.,7,,38,45,83
015 Kaltern a.d. Weinstr.,8,,43,36,79
015 Kaltern a.d. Weinstr.,9,,35,38,73
015 Kaltern a.d. Weinstr.,10,,29,38,67
015 Kaltern a.d. Weinstr.,11,,42,36,78
015 Kaltern a.d. Weinstr.,12,,33,41,74
015 Kaltern a.d. Weinstr.,13,,38,38,76
015 Kaltern a.d. Weinstr.,14,,53,28,81
015 Kaltern a.d. Weinstr.,15,,39,34,73
015 Kaltern a.d. Weinstr.,16,,40,31,71
015 Kaltern a.d. Weinstr.,17,,50,41,91
015 Kaltern a.d. Weinstr.,18,,47,38,85
015 Kaltern a.d. Weinstr.,19,,40,34,74
015 Kaltern a.d. Weinstr.,20,,44,44,88
015 Kaltern a.d. Weinstr.,21,,42,43,85
015 Kaltern a.d. Weinstr.,22,,45,40,85
015 Kaltern a.d. Weinstr.,23,,48,40,88
015 Kaltern a.d. Weinstr.,24,,42,42,84
015 Kaltern a.d. Weinstr.,25,,40,31,71
015 Kaltern a.d. Weinstr.,26,,36,43,79
015 Kaltern a.d. Weinstr.,27,,36,45,81
015 Kaltern a.d. Weinstr.,28,,43,54,97
015 Kaltern a.d. Weinstr.,29,,53,48,101
015 Kaltern a.d. Weinstr.,30,,35,46,81
015 Kaltern a.d. Weinstr.,31,,47,60,107
015 Kaltern a.d. Weinstr.,32,,66,54,120
015 Kaltern a.d. Weinstr.,33,,63,55,118
015 Kaltern a.d. Weinstr.,34,,58,64,122
015 Kaltern a.d. Weinstr.,35,,79,66,145
015 Kaltern a.d. Weinstr.,36,,62,63,125
015 Kaltern a.d. Weinstr.,37,,60,72,132
015 Kaltern a.d. Weinstr.,38,,55,59,114
015 Kaltern a.d. Weinstr.,39,,86,57,143
015 Kaltern a.d. Weinstr.,40,,53,56,109
015 Kaltern a.d. Weinstr.,41,,58,59,117
015 Kaltern a.d. Weinstr.,42,,62,61,123
015 Kaltern a.d. Weinstr.,43,,52,63,115
015 Kaltern a.d. Weinstr.,44,,54,53,107
015 Kaltern a.d. Weinstr.,45,,58,61,119
015 Kaltern a.d. Weinstr.,46,,54,60,114
015 Kaltern a.d. Weinstr.,47,,62,43,105
015 Kaltern a.d. Weinstr.,48,,54,43,97
015 Kaltern a.d. Weinstr.,49,,36,49,85
015 Kaltern a.d. Weinstr.,50,,33,38,71
015 Kaltern a.d. Weinstr.,51,,39,55,94
015 Kaltern a.d. Weinstr.,52,,32,33,65
015 Kaltern a.d. Weinstr.,53,,42,36,78
015 Kaltern a.d. Weinstr.,54,,31,39,70
015 Kaltern a.d. Weinstr.,55,,42,37,79
015 Kaltern a.d. Weinstr.,56,,35,57,92
015 Kaltern a.d. Weinstr.,57,,49,44,93
015 Kaltern a.d. Weinstr.,58,,39,38,77
015 Kaltern a.d. Weinstr.,59,,40,43,83
015 Kaltern a.d. Weinstr.,60,,40,36,76
015 Kaltern a.d. Weinstr.,61,,40,44,84
015 Kaltern a.d. Weinstr.,62,,45,42,87
015 Kaltern a.d. Weinstr.,63,,33,41,74
015 Kaltern a.d. Weinstr.,64,,23,34,57
015 Kaltern a.d. Weinstr.,65,,40,40,80
015 Kaltern a.d. Weinstr.,66,,27,34,61
015 Kaltern a.d. Weinstr.,67,,22,24,46
015 Kaltern a.d. Weinstr.,68,,26,26,52
015 Kaltern a.d. Weinstr.,69,,26,27,53
015 Kaltern a.d. Weinstr.,70,,27,37,64
015 Kaltern a.d. Weinstr.,71,,27,31,58
015 Kaltern a.d. Weinstr.,72,,27,36,63
015 Kaltern a.d. Weinstr.,73,,29,41,70
015 Kaltern a.d. Weinstr.,74,,24,32,56
015 Kaltern a.d. Weinstr.,75,,23,32,55
015 Kaltern a.d. Weinstr.,76,,18,39,57
015 Kaltern a.d. Weinstr.,77,,17,33,50
015 Kaltern a.d. Weinstr.,78,,21,37,58
015 Kaltern a.d. Weinstr.,79,,17,30,47
015 Kaltern a.d. Weinstr.,80,,9,31,40
015 Kaltern a.d. Weinstr.,81,,14,32,46
015 Kaltern a.d. Weinstr.,82,,11,32,43
015 Kaltern a.d. Weinstr.,83,,6,23,29
015 Kaltern a.d. Weinstr.,84,,5,17,22
015 Kaltern a.d. Weinstr.,85,,3,8,11
015 Kaltern a.d. Weinstr.,86,,2,9,11
015 Kaltern a.d. Weinstr.,87,,2,4,6
015 Kaltern a.d. Weinstr.,88,,3,10,13
015 Kaltern a.d. Weinstr.,89,,3,10,13
015 Kaltern a.d. Weinstr.,90,,6,13,19
015 Kaltern a.d. Weinstr.,91,,1,17,18
015 Kaltern a.d. Weinstr.,92,,2,4,6
015 Kaltern a.d. Weinstr.,93,,1,1,2
015 Kaltern a.d. Weinstr.,94,,2,2,4
015 Kaltern a.d. Weinstr.,95,,1,-,1
015 Kaltern a.d. Weinstr.,96,,-,3,3
016 Freienfeld,0,,19,17,36
016 Freienfeld,1,,18,22,40
016 Freienfeld,2,,15,20,35
016 Freienfeld,3,,15,17,32
016 Freienfeld,4,,16,20,36
016 Freienfeld,5,,13,16,29
016 Freienfeld,6,,22,18,40
016 Freienfeld,7,,22,13,35
016 Freienfeld,8,,14,16,30
016 Freienfeld,9,,15,9,24
016 Freienfeld,10,,15,11,26
016 Freienfeld,11,,20,21,41
016 Freienfeld,12,,10,12,22
016 Freienfeld,13,,19,19,38
016 Freienfeld,14,,26,20,46
016 Freienfeld,15,,20,15,35
016 Freienfeld,16,,15,19,34
016 Freienfeld,17,,15,12,27
016 Freienfeld,18,,17,14,31
016 Freienfeld,19,,23,15,38
016 Freienfeld,20,,24,19,43
016 Freienfeld,21,,14,16,30
016 Freienfeld,22,,23,22,45
016 Freienfeld,23,,18,16,34
016 Freienfeld,24,,20,21,41
016 Freienfeld,25,,14,14,28
016 Freienfeld,26,,16,20,36
016 Freienfeld,27,,18,9,27
016 Freienfeld,28,,19,18,37
016 Freienfeld,29,,23,19,42
016 Freienfeld,30,,23,20,43
016 Freienfeld,31,,22,25,47
016 Freienfeld,32,,25,26,51
016 Freienfeld,33,,23,15,38
016 Freienfeld,34,,25,25,50
016 Freienfeld,35,,25,19,44
016 Freienfeld,36,,19,30,49
016 Freienfeld,37,,28,20,48
016 Freienfeld,38,,25,16,41
016 Freienfeld,39,,25,20,45
016 Freienfeld,40,,21,17,38
016 Freienfeld,41,,27,28,55
016 Freienfeld,42,,25,20,45
016 Freienfeld,43,,27,22,49
016 Freienfeld,44,,27,14,41
016 Freienfeld,45,,15,20,35
016 Freienfeld,46,,14,19,33
016 Freienfeld,47,,24,17,41
016 Freienfeld,48,,21,9,30
016 Freienfeld,49,,19,17,36
016 Freienfeld,50,,17,10,27
016 Freienfeld,51,,13,18,31
016 Freienfeld,52,,15,11,26
016 Freienfeld,53,,20,10,30
016 Freienfeld,54,,16,13,29
016 Freienfeld,55,,20,13,33
016 Freienfeld,56,,5,12,17
016 Freienfeld,57,,11,16,27
016 Freienfeld,58,,12,2,14
016 Freienfeld,59,,10,5,15
016 Freienfeld,60,,13,10,23
016 Freienfeld,61,,12,9,21
016 Freienfeld,62,,13,11,24
016 Freienfeld,63,,11,4,15
016 Freienfeld,64,,11,9,20
016 Freienfeld,65,,13,11,24
016 Freienfeld,66,,6,10,16
016 Freienfeld,67,,8,12,20
016 Freienfeld,68,,7,12,19
016 Freienfeld,69,,5,6,11
016 Freienfeld,70,,9,8,17
016 Freienfeld,71,,11,10,21
016 Freienfeld,72,,9,9,18
016 Freienfeld,73,,8,7,15
016 Freienfeld,74,,5,7,12
016 Freienfeld,75,,6,5,11
016 Freienfeld,76,,6,9,15
016 Freienfeld,77,,8,14,22
016 Freienfeld,78,,7,8,15
016 Freienfeld,79,,3,3,6
016 Freienfeld,80,,2,14,16
016 Freienfeld,81,,2,9,11
016 Freienfeld,82,,1,3,4
016 Freienfeld,83,,6,3,9
016 Freienfeld,84,,3,4,7
016 Freienfeld,85,,-,2,2
016 Freienfeld,86,,-,1,1
016 Freienfeld,87,,1,1,2
016 Freienfeld,88,,-,2,2
016 Freienfeld,89,,2,4,6
016 Freienfeld,90,,1,2,3
016 Freienfeld,92,,1,2,3
016 Freienfeld,93,,2,1,3
016 Freienfeld,95,,-,2,2
017 Sand in Taufers,0,,32,28,60
017 Sand in Taufers,1,,28,34,62
017 Sand in Taufers,2,,35,39,74
017 Sand in Taufers,3,,43,21,64
017 Sand in Taufers,4,,40,34,74
017 Sand in Taufers,5,,27,34,61
017 Sand in Taufers,6,,35,38,73
017 Sand in Taufers,7,,27,32,59
017 Sand in Taufers,8,,27,29,56
017 Sand in Taufers,9,,39,35,74
017 Sand in Taufers,10,,26,33,59
017 Sand in Taufers,11,,32,35,67
017 Sand in Taufers,12,,28,34,62
017 Sand in Taufers,13,,25,32,57
017 Sand in Taufers,14,,29,28,57
017 Sand in Taufers,15,,29,28,57
017 Sand in Taufers,16,,21,23,44
017 Sand in Taufers,17,,22,21,43
017 Sand in Taufers,18,,23,25,48
017 Sand in Taufers,19,,31,25,56
017 Sand in Taufers,20,,34,30,64
017 Sand in Taufers,21,,23,36,59
017 Sand in Taufers,22,,33,34,67
017 Sand in Taufers,23,,32,32,64
017 Sand in Taufers,24,,30,38,68
017 Sand in Taufers,25,,39,32,71
017 Sand in Taufers,26,,30,39,69
017 Sand in Taufers,27,,38,39,77
017 Sand in Taufers,28,,43,40,83
017 Sand in Taufers,29,,60,41,101
017 Sand in Taufers,30,,59,44,103
017 Sand in Taufers,31,,50,49,99
017 Sand in Taufers,32,,44,49,93
017 Sand in Taufers,33,,42,52,94
017 Sand in Taufers,34,,54,41,95
017 Sand in Taufers,35,,51,42,93
017 Sand in Taufers,36,,32,46,78
017 Sand in Taufers,37,,48,33,81
017 Sand in Taufers,38,,49,38,87
017 Sand in Taufers,39,,47,42,89
017 Sand in Taufers,40,,50,47,97
017 Sand in Taufers,41,,35,39,74
017 Sand in Taufers,42,,43,42,85
017 Sand in Taufers,43,,42,32,74
017 Sand in Taufers,44,,35,32,67
017 Sand in Taufers,45,,34,21,55
017 Sand in Taufers,46,,22,37,59
017 Sand in Taufers,47,,28,36,64
017 Sand in Taufers,48,,24,21,45
017 Sand in Taufers,49,,30,29,59
017 Sand in Taufers,50,,31,24,55
017 Sand in Taufers,51,,18,28,46
017 Sand in Taufers,52,,27,22,49
017 Sand in Taufers,53,,34,34,68
017 Sand in Taufers,54,,30,20,50
017 Sand in Taufers,55,,21,25,46
017 Sand in Taufers,56,,25,29,54
017 Sand in Taufers,57,,26,24,50
017 Sand in Taufers,58,,27,9,36
017 Sand in Taufers,59,,17,30,47
017 Sand in Taufers,60,,29,29,58
017 Sand in Taufers,61,,28,33,61
017 Sand in Taufers,62,,27,32,59
017 Sand in Taufers,63,,23,19,42
017 Sand in Taufers,64,,26,30,56
017 Sand in Taufers,65,,18,26,44
017 Sand in Taufers,66,,28,12,40
017 Sand in Taufers,67,,15,25,40
017 Sand in Taufers,68,,30,17,47
017 Sand in Taufers,69,,15,13,28
017 Sand in Taufers,70,,15,18,33
017 Sand in Taufers,71,,10,17,27
017 Sand in Taufers,72,,12,12,24
017 Sand in Taufers,73,,14,18,32
017 Sand in Taufers,74,,13,12,25
017 Sand in Taufers,75,,11,15,26
017 Sand in Taufers,76,,14,11,25
017 Sand in Taufers,77,,10,19,29
017 Sand in Taufers,78,,8,14,22
017 Sand in Taufers,79,,6,15,21
017 Sand in Taufers,80,,11,10,21
017 Sand in Taufers,81,,7,15,22
017 Sand in Taufers,82,,8,16,24
017 Sand in Taufers,83,,5,9,14
017 Sand in Taufers,84,,7,8,15
017 Sand in Taufers,85,,3,4,7
017 Sand in Taufers,86,,1,8,9
017 Sand in Taufers,87,,-,4,4
017 Sand in Taufers,88,,3,5,8
017 Sand in Taufers,89,,1,8,9
017 Sand in Taufers,90,,-,5,5
017 Sand in Taufers,91,,-,3,3
017 Sand in Taufers,92,,-,6,6
017 Sand in Taufers,94,,1,3,4
017 Sand in Taufers,96,,-,2,2
018 Kastelbell-Tschars,0,,13,8,21
018 Kastelbell-Tschars,1,,9,9,18
018 Kastelbell-Tschars,2,,15,11,26
018 Kastelbell-Tschars,3,,11,9,20
018 Kastelbell-Tschars,4,,22,11,33
018 Kastelbell-Tschars,5,,16,9,25
018 Kastelbell-Tschars,6,,9,10,19
018 Kastelbell-Tschars,7,,14,18,32
018 Kastelbell-Tschars,8,,15,10,25
018 Kastelbell-Tschars,9,,14,15,29
018 Kastelbell-Tschars,10,,13,15,28
018 Kastelbell-Tschars,11,,14,13,27
018 Kastelbell-Tschars,12,,18,12,30
018 Kastelbell-Tschars,13,,15,10,25
018 Kastelbell-Tschars,14,,16,10,26
018 Kastelbell-Tschars,15,,19,7,26
018 Kastelbell-Tschars,16,,18,16,34
018 Kastelbell-Tschars,17,,16,21,37
018 Kastelbell-Tschars,18,,21,16,37
018 Kastelbell-Tschars,19,,8,11,19
018 Kastelbell-Tschars,20,,14,24,38
018 Kastelbell-Tschars,21,,24,13,37
018 Kastelbell-Tschars,22,,15,19,34
018 Kastelbell-Tschars,23,,18,20,38
018 Kastelbell-Tschars,24,,15,13,28
018 Kastelbell-Tschars,25,,14,21,35
018 Kastelbell-Tschars,26,,11,15,26
018 Kastelbell-Tschars,27,,20,19,39
018 Kastelbell-Tschars,28,,17,15,32
018 Kastelbell-Tschars,29,,18,12,30
018 Kastelbell-Tschars,30,,21,20,41
018 Kastelbell-Tschars,31,,15,18,33
018 Kastelbell-Tschars,32,,18,13,31
018 Kastelbell-Tschars,33,,14,14,28
018 Kastelbell-Tschars,34,,24,19,43
018 Kastelbell-Tschars,35,,16,14,30
018 Kastelbell-Tschars,36,,12,22,34
018 Kastelbell-Tschars,37,,22,10,32
018 Kastelbell-Tschars,38,,22,15,37
018 Kastelbell-Tschars,39,,21,14,35
018 Kastelbell-Tschars,40,,26,22,48
018 Kastelbell-Tschars,41,,6,22,28
018 Kastelbell-Tschars,42,,21,19,40
018 Kastelbell-Tschars,43,,25,20,45
018 Kastelbell-Tschars,44,,24,20,44
018 Kastelbell-Tschars,45,,16,13,29
018 Kastelbell-Tschars,46,,16,12,28
018 Kastelbell-Tschars,47,,12,15,27
018 Kastelbell-Tschars,48,,18,18,36
018 Kastelbell-Tschars,49,,8,13,21
018 Kastelbell-Tschars,50,,9,16,25
018 Kastelbell-Tschars,51,,14,16,30
018 Kastelbell-Tschars,52,,16,12,28
018 Kastelbell-Tschars,53,,12,13,25
018 Kastelbell-Tschars,54,,12,8,20
018 Kastelbell-Tschars,55,,12,10,22
018 Kastelbell-Tschars,56,,10,8,18
018 Kastelbell-Tschars,57,,14,13,27
018 Kastelbell-Tschars,58,,9,4,13
018 Kastelbell-Tschars,59,,10,7,17
018 Kastelbell-Tschars,60,,7,7,14
018 Kastelbell-Tschars,61,,13,12,25
018 Kastelbell-Tschars,62,,10,8,18
018 Kastelbell-Tschars,63,,8,10,18
018 Kastelbell-Tschars,64,,12,12,24
018 Kastelbell-Tschars,65,,7,15,22
018 Kastelbell-Tschars,66,,11,10,21
018 Kastelbell-Tschars,67,,10,16,26
018 Kastelbell-Tschars,68,,11,10,21
018 Kastelbell-Tschars,69,,5,15,20
018 Kastelbell-Tschars,70,,16,13,29
018 Kastelbell-Tschars,71,,7,14,21
018 Kastelbell-Tschars,72,,10,14,24
018 Kastelbell-Tschars,73,,21,16,37
018 Kastelbell-Tschars,74,,10,14,24
018 Kastelbell-Tschars,75,,6,11,17
018 Kastelbell-Tschars,76,,10,9,19
018 Kastelbell-Tschars,77,,11,15,26
018 Kastelbell-Tschars,78,,11,12,23
018 Kastelbell-Tschars,79,,3,9,12
018 Kastelbell-Tschars,80,,6,10,16
018 Kastelbell-Tschars,81,,3,8,11
018 Kastelbell-Tschars,82,,4,6,10
018 Kastelbell-Tschars,83,,5,7,12
018 Kastelbell-Tschars,84,,1,4,5
018 Kastelbell-Tschars,85,,-,4,4
018 Kastelbell-Tschars,86,,1,2,3
018 Kastelbell-Tschars,87,,-,1,1
018 Kastelbell-Tschars,88,,3,3,6
018 Kastelbell-Tschars,89,,1,3,4
018 Kastelbell-Tschars,90,,1,1,2
018 Kastelbell-Tschars,91,,1,2,3
018 Kastelbell-Tschars,92,,-,4,4
018 Kastelbell-Tschars,93,,-,1,1
018 Kastelbell-Tschars,94,,1,-,1
018 Kastelbell-Tschars,95,,-,2,2
019 Kastelruth,0,,44,34,78
019 Kastelruth,1,,34,34,68
019 Kastelruth,2,,41,31,72
019 Kastelruth,3,,33,30,63
019 Kastelruth,4,,34,38,72
019 Kastelruth,5,,50,45,95
019 Kastelruth,6,,48,47,95
019 Kastelruth,7,,42,36,78
019 Kastelruth,8,,53,40,93
019 Kastelruth,9,,31,31,62
019 Kastelruth,10,,39,35,74
019 Kastelruth,11,,35,50,85
019 Kastelruth,12,,35,38,73
019 Kastelruth,13,,38,39,77
019 Kastelruth,14,,45,38,83
019 Kastelruth,15,,26,24,50
019 Kastelruth,16,,36,41,77
019 Kastelruth,17,,35,24,59
019 Kastelruth,18,,26,33,59
019 Kastelruth,19,,34,29,63
019 Kastelruth,20,,35,44,79
019 Kastelruth,21,,44,33,77
019 Kastelruth,22,,35,43,78
019 Kastelruth,23,,44,37,81
019 Kastelruth,24,,31,39,70
019 Kastelruth,25,,31,37,68
019 Kastelruth,26,,37,40,77
019 Kastelruth,27,,38,57,95
019 Kastelruth,28,,53,35,88
019 Kastelruth,29,,53,46,99
019 Kastelruth,30,,45,57,102
019 Kastelruth,31,,72,37,109
019 Kastelruth,32,,62,43,105
019 Kastelruth,33,,53,55,108
019 Kastelruth,34,,63,52,115
019 Kastelruth,35,,62,55,117
019 Kastelruth,36,,69,57,126
019 Kastelruth,37,,72,46,118
019 Kastelruth,38,,42,79,121
019 Kastelruth,39,,58,39,97
019 Kastelruth,40,,56,31,87
019 Kastelruth,41,,36,47,83
019 Kastelruth,42,,55,44,99
019 Kastelruth,43,,49,39,88
019 Kastelruth,44,,47,42,89
019 Kastelruth,45,,47,41,88
019 Kastelruth,46,,39,37,76
019 Kastelruth,47,,34,32,66
019 Kastelruth,48,,37,36,73
019 Kastelruth,49,,38,29,67
019 Kastelruth,50,,28,28,56
019 Kastelruth,51,,37,25,62
019 Kastelruth,52,,28,25,53
019 Kastelruth,53,,43,21,64
019 Kastelruth,54,,17,34,51
019 Kastelruth,55,,28,38,66
019 Kastelruth,56,,36,31,67
019 Kastelruth,57,,21,36,57
019 Kastelruth,58,,23,19,42
019 Kastelruth,59,,20,45,65
019 Kastelruth,60,,40,39,79
019 Kastelruth,61,,33,28,61
019 Kastelruth,62,,32,48,80
019 Kastelruth,63,,27,36,63
019 Kastelruth,64,,27,28,55
019 Kastelruth,65,,26,26,52
019 Kastelruth,66,,28,24,52
019 Kastelruth,67,,30,20,50
019 Kastelruth,68,,29,29,58
019 Kastelruth,69,,22,24,46
019 Kastelruth,70,,34,28,62
019 Kastelruth,71,,19,37,56
019 Kastelruth,72,,40,26,66
019 Kastelruth,73,,12,26,38
019 Kastelruth,74,,23,27,50
019 Kastelruth,75,,11,18,29
019 Kastelruth,76,,20,30,50
019 Kastelruth,77,,14,23,37
019 Kastelruth,78,,11,20,31
019 Kastelruth,79,,15,22,37
019 Kastelruth,80,,9,18,27
019 Kastelruth,81,,11,15,26
019 Kastelruth,82,,9,19,28
019 Kastelruth,83,,9,15,24
019 Kastelruth,84,,8,7,15
019 Kastelruth,85,,3,8,11
019 Kastelruth,86,,1,5,6
019 Kastelruth,87,,-,4,4
019 Kastelruth,88,,1,12,13
019 Kastelruth,89,,5,8,13
019 Kastelruth,90,,2,4,6
019 Kastelruth,91,,3,7,10
019 Kastelruth,92,,1,4,5
019 Kastelruth,93,,-,1,1
019 Kastelruth,94,,-,4,4
019 Kastelruth,95,,1,-,1
019 Kastelruth,96,,-,1,1
019 Kastelruth,97,,-,4,4
019 Kastelruth,98,,-,1,1
020 Tscherms,0,,10,6,16
020 Tscherms,1,,9,7,16
020 Tscherms,2,,8,8,16
020 Tscherms,3,,9,5,14
020 Tscherms,4,,8,8,16
020 Tscherms,5,,5,9,14
020 Tscherms,6,,7,10,17
020 Tscherms,7,,5,4,9
020 Tscherms,8,,9,10,19
020 Tscherms,9,,10,16,26
020 Tscherms,10,,8,9,17
020 Tscherms,11,,11,7,18
020 Tscherms,12,,4,10,14
020 Tscherms,13,,7,7,14
020 Tscherms,14,,4,4,8
020 Tscherms,15,,5,15,20
020 Tscherms,16,,11,6,17
020 Tscherms,17,,10,7,17
020 Tscherms,18,,12,9,21
020 Tscherms,19,,13,5,18
020 Tscherms,20,,9,10,19
020 Tscherms,21,,5,9,14
020 Tscherms,22,,9,7,16
020 Tscherms,23,,8,6,14
020 Tscherms,24,,4,8,12
020 Tscherms,25,,2,10,12
020 Tscherms,26,,6,5,11
020 Tscherms,27,,8,7,15
020 Tscherms,28,,9,4,13
020 Tscherms,29,,9,5,14
020 Tscherms,30,,10,12,22
020 Tscherms,31,,9,9,18
020 Tscherms,32,,10,15,25
020 Tscherms,33,,11,7,18
020 Tscherms,34,,13,18,31
020 Tscherms,35,,17,8,25
020 Tscherms,36,,14,15,29
020 Tscherms,37,,13,5,18
020 Tscherms,38,,17,13,30
020 Tscherms,39,,11,13,24
020 Tscherms,40,,17,14,31
020 Tscherms,41,,15,9,24
020 Tscherms,42,,9,9,18
020 Tscherms,43,,11,13,24
020 Tscherms,44,,7,16,23
020 Tscherms,45,,9,10,19
020 Tscherms,46,,9,10,19
020 Tscherms,47,,8,7,15
020 Tscherms,48,,12,8,20
020 Tscherms,49,,8,8,16
020 Tscherms,50,,11,4,15
020 Tscherms,51,,14,6,20
020 Tscherms,52,,5,13,18
020 Tscherms,53,,8,7,15
020 Tscherms,54,,3,3,6
020 Tscherms,55,,6,5,11
020 Tscherms,56,,8,7,15
020 Tscherms,57,,5,8,13
020 Tscherms,58,,5,7,12
020 Tscherms,59,,5,9,14
020 Tscherms,60,,7,4,11
020 Tscherms,61,,8,3,11
020 Tscherms,62,,10,8,18
020 Tscherms,63,,5,5,10
020 Tscherms,64,,5,5,10
020 Tscherms,65,,7,2,9
020 Tscherms,66,,5,8,13
020 Tscherms,67,,5,7,12
020 Tscherms,68,,4,5,9
020 Tscherms,69,,2,9,11
020 Tscherms,70,,5,2,7
020 Tscherms,71,,5,5,10
020 Tscherms,72,,2,3,5
020 Tscherms,73,,3,5,8
020 Tscherms,74,,3,3,6
020 Tscherms,75,,5,5,10
020 Tscherms,76,,8,4,12
020 Tscherms,77,,3,2,5
020 Tscherms,78,,4,5,9
020 Tscherms,79,,3,5,8
020 Tscherms,80,,1,3,4
020 Tscherms,81,,1,5,6
020 Tscherms,82,,2,3,5
020 Tscherms,83,,4,3,7
020 Tscherms,84,,-,2,2
020 Tscherms,85,,2,2,4
020 Tscherms,86,,1,1,2
020 Tscherms,87,,1,1,2
020 Tscherms,88,,1,-,1
020 Tscherms,89,,-,1,1
020 Tscherms,90,,-,3,3
020 Tscherms,91,,2,-,2
020 Tscherms,92,,-,2,2
020 Tscherms,93,,1,1,2
021 Kiens,0,,14,18,32
021 Kiens,1,,10,12,22
021 Kiens,2,,22,19,41
021 Kiens,3,,11,21,32
021 Kiens,4,,14,18,32
021 Kiens,5,,23,6,29
021 Kiens,6,,17,13,30
021 Kiens,7,,16,19,35
021 Kiens,8,,14,21,35
021 Kiens,9,,17,17,34
021 Kiens,10,,19,16,35
021 Kiens,11,,26,17,43
021 Kiens,12,,12,26,38
021 Kiens,13,,15,20,35
021 Kiens,14,,12,18,30
021 Kiens,15,,13,14,27
021 Kiens,16,,11,13,24
021 Kiens,17,,18,11,29
021 Kiens,18,,19,13,32
021 Kiens,19,,17,11,28
021 Kiens,20,,13,18,31
021 Kiens,21,,22,17,39
021 Kiens,22,,13,20,33
021 Kiens,23,,16,24,40
021 Kiens,24,,15,18,33
021 Kiens,25,,27,19,46
021 Kiens,26,,18,16,34
021 Kiens,27,,28,23,51
021 Kiens,28,,19,22,41
021 Kiens,29,,20,22,42
021 Kiens,30,,33,27,60
021 Kiens,31,,23,20,43
021 Kiens,32,,29,24,53
021 Kiens,33,,26,27,53
021 Kiens,34,,31,25,56
021 Kiens,35,,42,18,60
021 Kiens,36,,23,23,46
021 Kiens,37,,26,25,51
021 Kiens,38,,25,22,47
021 Kiens,39,,32,24,56
021 Kiens,40,,20,23,43
021 Kiens,41,,30,18,48
021 Kiens,42,,20,24,44
021 Kiens,43,,22,19,41
021 Kiens,44,,24,15,39
021 Kiens,45,,14,13,27
021 Kiens,46,,11,16,27
021 Kiens,47,,19,13,32
021 Kiens,48,,15,10,25
021 Kiens,49,,10,16,26
021 Kiens,50,,14,23,37
021 Kiens,51,,11,8,19
021 Kiens,52,,12,12,24
021 Kiens,53,,16,10,26
021 Kiens,54,,10,14,24
021 Kiens,55,,15,18,33
021 Kiens,56,,16,14,30
021 Kiens,57,,19,13,32
021 Kiens,58,,8,12,20
021 Kiens,59,,11,13,24
021 Kiens,60,,21,12,33
021 Kiens,61,,16,11,27
021 Kiens,62,,19,11,30
021 Kiens,63,,13,16,29
021 Kiens,64,,11,8,19
021 Kiens,65,,14,13,27
021 Kiens,66,,10,12,22
021 Kiens,67,,11,11,22
021 Kiens,68,,4,17,21
021 Kiens,69,,9,14,23
021 Kiens,70,,12,8,20
021 Kiens,71,,14,13,27
021 Kiens,72,,16,9,25
021 Kiens,73,,8,11,19
021 Kiens,74,,7,9,16
021 Kiens,75,,3,5,8
021 Kiens,76,,5,6,11
021 Kiens,77,,3,5,8
021 Kiens,78,,6,3,9
021 Kiens,79,,4,7,11
021 Kiens,80,,6,6,12
021 Kiens,81,,4,4,8
021 Kiens,82,,1,7,8
021 Kiens,83,,5,3,8
021 Kiens,84,,1,3,4
021 Kiens,85,,-,2,2
021 Kiens,86,,1,1,2
021 Kiens,87,,-,2,2
021 Kiens,88,,1,2,3
021 Kiens,89,,2,1,3
021 Kiens,90,,3,2,5
021 Kiens,91,,1,3,4
021 Kiens,93,,-,1,1
022 Klausen,0,,31,31,62
022 Klausen,1,,39,26,65
022 Klausen,2,,33,34,67
022 Klausen,3,,29,32,61
022 Klausen,4,,30,28,58
022 Klausen,5,,21,29,50
022 Klausen,6,,42,35,77
022 Klausen,7,,25,29,54
022 Klausen,8,,33,24,57
022 Klausen,9,,17,31,48
022 Klausen,10,,29,25,54
022 Klausen,11,,41,26,67
022 Klausen,12,,33,31,64
022 Klausen,13,,39,24,63
022 Klausen,14,,28,30,58
022 Klausen,15,,30,32,62
022 Klausen,16,,22,33,55
022 Klausen,17,,37,29,66
022 Klausen,18,,38,38,76
022 Klausen,19,,32,27,59
022 Klausen,20,,23,38,61
022 Klausen,21,,39,37,76
022 Klausen,22,,33,30,63
022 Klausen,23,,27,33,60
022 Klausen,24,,29,38,67
022 Klausen,25,,38,45,83
022 Klausen,26,,37,36,73
022 Klausen,27,,45,21,66
022 Klausen,28,,34,40,74
022 Klausen,29,,40,30,70
022 Klausen,30,,44,28,72
022 Klausen,31,,36,40,76
022 Klausen,32,,46,40,86
022 Klausen,33,,42,49,91
022 Klausen,34,,46,53,99
022 Klausen,35,,48,44,92
022 Klausen,36,,47,42,89
022 Klausen,37,,57,41,98
022 Klausen,38,,39,38,77
022 Klausen,39,,39,48,87
022 Klausen,40,,37,39,76
022 Klausen,41,,32,41,73
022 Klausen,42,,48,40,88
022 Klausen,43,,38,26,64
022 Klausen,44,,31,37,68
022 Klausen,45,,28,31,59
022 Klausen,46,,30,25,55
022 Klausen,47,,29,24,53
022 Klausen,48,,30,34,64
022 Klausen,49,,31,41,72
022 Klausen,50,,19,31,50
022 Klausen,51,,25,15,40
022 Klausen,52,,33,26,59
022 Klausen,53,,28,24,52
022 Klausen,54,,28,26,54
022 Klausen,55,,30,26,56
022 Klausen,56,,27,20,47
022 Klausen,57,,30,20,50
022 Klausen,58,,13,16,29
022 Klausen,59,,23,18,41
022 Klausen,60,,21,28,49
022 Klausen,61,,21,26,47
022 Klausen,62,,27,21,48
022 Klausen,63,,24,22,46
022 Klausen,64,,26,20,46
022 Klausen,65,,18,20,38
022 Klausen,66,,18,17,35
022 Klausen,67,,19,23,42
022 Klausen,68,,12,18,30
022 Klausen,69,,18,15,33
022 Klausen,70,,22,16,38
022 Klausen,71,,12,22,34
022 Klausen,72,,12,14,26
022 Klausen,73,,13,19,32
022 Klausen,74,,19,20,39
022 Klausen,75,,7,17,24
022 Klausen,76,,6,15,21
022 Klausen,77,,13,11,24
022 Klausen,78,,12,9,21
022 Klausen,79,,11,15,26
022 Klausen,80,,3,15,18
022 Klausen,81,,5,15,20
022 Klausen,82,,2,11,13
022 Klausen,83,,4,11,15
022 Klausen,84,,2,10,12
022 Klausen,85,,2,9,11
022 Klausen,86,,3,7,10
022 Klausen,87,,1,2,3
022 Klausen,88,,1,-,1
022 Klausen,89,,4,8,12
022 Klausen,90,,-,9,9
022 Klausen,91,,2,2,4
022 Klausen,92,,1,1,2
022 Klausen,93,,-,3,3
022 Klausen,94,,-,3,3
023 Karneid,0,,20,18,38
023 Karneid,1,,13,15,28
023 Karneid,2,,23,21,44
023 Karneid,3,,17,19,36
023 Karneid,4,,23,28,51
023 Karneid,5,,17,20,37
023 Karneid,6,,31,19,50
023 Karneid,7,,19,19,38
023 Karneid,8,,23,21,44
023 Karneid,9,,21,23,44
023 Karneid,10,,21,18,39
023 Karneid,11,,23,18,41
023 Karneid,12,,16,20,36
023 Karneid,13,,23,15,38
023 Karneid,14,,15,18,33
023 Karneid,15,,18,19,37
023 Karneid,16,,13,21,34
023 Karneid,17,,19,19,38
023 Karneid,18,,22,13,35
023 Karneid,19,,26,14,40
023 Karneid,20,,19,11,30
023 Karneid,21,,25,17,42
023 Karneid,22,,27,28,55
023 Karneid,23,,25,18,43
023 Karneid,24,,27,28,55
023 Karneid,25,,25,14,39
023 Karneid,26,,19,14,33
023 Karneid,27,,21,27,48
023 Karneid,28,,22,20,42
023 Karneid,29,,29,26,55
023 Karneid,30,,29,26,55
023 Karneid,31,,29,28,57
023 Karneid,32,,33,32,65
023 Karneid,33,,34,18,52
023 Karneid,34,,18,26,44
023 Karneid,35,,38,36,74
023 Karneid,36,,35,33,68
023 Karneid,37,,37,34,71
023 Karneid,38,,27,26,53
023 Karneid,39,,33,23,56
023 Karneid,40,,38,23,61
023 Karneid,41,,28,36,64
023 Karneid,42,,28,20,48
023 Karneid,43,,29,27,56
023 Karneid,44,,31,21,52
023 Karneid,45,,19,19,38
023 Karneid,46,,19,17,36
023 Karneid,47,,21,19,40
023 Karneid,48,,17,10,27
023 Karneid,49,,15,16,31
023 Karneid,50,,23,16,39
023 Karneid,51,,10,20,30
023 Karneid,52,,20,12,32
023 Karneid,53,,22,17,39
023 Karneid,54,,12,15,27
023 Karneid,55,,16,25,41
023 Karneid,56,,8,15,23
023 Karneid,57,,11,21,32
023 Karneid,58,,13,15,28
023 Karneid,59,,13,15,28
023 Karneid,60,,20,14,34
023 Karneid,61,,18,24,42
023 Karneid,62,,23,15,38
023 Karneid,63,,14,15,29
023 Karneid,64,,18,17,35
023 Karneid,65,,22,11,33
023 Karneid,66,,9,9,18
023 Karneid,67,,12,12,24
023 Karneid,68,,9,13,22
023 Karneid,69,,14,15,29
023 Karneid,70,,10,15,25
023 Karneid,71,,13,5,18
023 Karneid,72,,18,11,29
023 Karneid,73,,7,8,15
023 Karneid,74,,12,10,22
023 Karneid,75,,10,8,18
023 Karneid,76,,3,9,12
023 Karneid,77,,9,10,19
023 Karneid,78,,5,7,12
023 Karneid,79,,8,11,19
023 Karneid,80,,4,4,8
023 Karneid,81,,2,8,10
023 Karneid,82,,1,6,7
023 Karneid,83,,3,8,11
023 Karneid,84,,6,2,8
023 Karneid,85,,-,6,6
023 Karneid,86,,1,3,4
023 Karneid,87,,-,2,2
023 Karneid,88,,-,1,1
023 Karneid,90,,-,3,3
023 Karneid,91,,-,4,4
023 Karneid,92,,-,1,1
023 Karneid,93,,1,-,1
023 Karneid,95,,-,1,1
023 Karneid,99,,-,1,1
024 Kurtatsch a.d.Weinstr.,0,,11,11,22
024 Kurtatsch a.d.Weinstr.,1,,12,17,29
024 Kurtatsch a.d.Weinstr.,2,,19,11,30
024 Kurtatsch a.d.Weinstr.,3,,15,13,28
024 Kurtatsch a.d.Weinstr.,4,,17,10,27
024 Kurtatsch a.d.Weinstr.,5,,16,15,31
024 Kurtatsch a.d.Weinstr.,6,,14,14,28
024 Kurtatsch a.d.Weinstr.,7,,25,18,43
024 Kurtatsch a.d.Weinstr.,8,,19,13,32
024 Kurtatsch a.d.Weinstr.,9,,16,5,21
024 Kurtatsch a.d.Weinstr.,10,,24,20,44
024 Kurtatsch a.d.Weinstr.,11,,23,10,33
024 Kurtatsch a.d.Weinstr.,12,,16,17,33
024 Kurtatsch a.d.Weinstr.,13,,11,7,18
024 Kurtatsch a.d.Weinstr.,14,,10,18,28
024 Kurtatsch a.d.Weinstr.,15,,7,14,21
024 Kurtatsch a.d.Weinstr.,16,,11,12,23
024 Kurtatsch a.d.Weinstr.,17,,10,9,19
024 Kurtatsch a.d.Weinstr.,18,,13,11,24
024 Kurtatsch a.d.Weinstr.,19,,15,8,23
024 Kurtatsch a.d.Weinstr.,20,,15,7,22
024 Kurtatsch a.d.Weinstr.,21,,11,20,31
024 Kurtatsch a.d.Weinstr.,22,,10,12,22
024 Kurtatsch a.d.Weinstr.,23,,8,13,21
024 Kurtatsch a.d.Weinstr.,24,,9,9,18
024 Kurtatsch a.d.Weinstr.,25,,8,8,16
024 Kurtatsch a.d.Weinstr.,26,,10,14,24
024 Kurtatsch a.d.Weinstr.,27,,12,12,24
024 Kurtatsch a.d.Weinstr.,28,,13,12,25
024 Kurtatsch a.d.Weinstr.,29,,10,19,29
024 Kurtatsch a.d.Weinstr.,30,,16,16,32
024 Kurtatsch a.d.Weinstr.,31,,13,21,34
024 Kurtatsch a.d.Weinstr.,32,,12,19,31
024 Kurtatsch a.d.Weinstr.,33,,15,23,38
024 Kurtatsch a.d.Weinstr.,34,,26,19,45
024 Kurtatsch a.d.Weinstr.,35,,25,14,39
024 Kurtatsch a.d.Weinstr.,36,,19,19,38
024 Kurtatsch a.d.Weinstr.,37,,32,17,49
024 Kurtatsch a.d.Weinstr.,38,,25,26,51
024 Kurtatsch a.d.Weinstr.,39,,14,26,40
024 Kurtatsch a.d.Weinstr.,40,,21,20,41
024 Kurtatsch a.d.Weinstr.,41,,25,8,33
024 Kurtatsch a.d.Weinstr.,42,,17,15,32
024 Kurtatsch a.d.Weinstr.,43,,20,21,41
024 Kurtatsch a.d.Weinstr.,44,,19,10,29
024 Kurtatsch a.d.Weinstr.,45,,15,17,32
024 Kurtatsch a.d.Weinstr.,46,,10,10,20
024 Kurtatsch a.d.Weinstr.,47,,10,9,19
024 Kurtatsch a.d.Weinstr.,48,,15,16,31
024 Kurtatsch a.d.Weinstr.,49,,14,7,21
024 Kurtatsch a.d.Weinstr.,50,,17,18,35
024 Kurtatsch a.d.Weinstr.,51,,11,8,19
024 Kurtatsch a.d.Weinstr.,52,,10,14,24
024 Kurtatsch a.d.Weinstr.,53,,14,6,20
024 Kurtatsch a.d.Weinstr.,54,,13,10,23
024 Kurtatsch a.d.Weinstr.,55,,7,8,15
024 Kurtatsch a.d.Weinstr.,56,,11,8,19
024 Kurtatsch a.d.Weinstr.,57,,12,8,20
024 Kurtatsch a.d.Weinstr.,58,,7,8,15
024 Kurtatsch a.d.Weinstr.,59,,5,8,13
024 Kurtatsch a.d.Weinstr.,60,,10,6,16
024 Kurtatsch a.d.Weinstr.,61,,11,12,23
024 Kurtatsch a.d.Weinstr.,62,,7,11,18
024 Kurtatsch a.d.Weinstr.,63,,11,11,22
024 Kurtatsch a.d.Weinstr.,64,,4,15,19
024 Kurtatsch a.d.Weinstr.,65,,11,11,22
024 Kurtatsch a.d.Weinstr.,66,,5,10,15
024 Kurtatsch a.d.Weinstr.,67,,9,7,16
024 Kurtatsch a.d.Weinstr.,68,,5,7,12
024 Kurtatsch a.d.Weinstr.,69,,7,9,16
024 Kurtatsch a.d.Weinstr.,70,,8,7,15
024 Kurtatsch a.d.Weinstr.,71,,11,16,27
024 Kurtatsch a.d.Weinstr.,72,,7,11,18
024 Kurtatsch a.d.Weinstr.,73,,11,15,26
024 Kurtatsch a.d.Weinstr.,74,,9,11,20
024 Kurtatsch a.d.Weinstr.,75,,7,8,15
024 Kurtatsch a.d.Weinstr.,76,,10,6,16
024 Kurtatsch a.d.Weinstr.,77,,5,6,11
024 Kurtatsch a.d.Weinstr.,78,,4,9,13
024 Kurtatsch a.d.Weinstr.,79,,6,10,16
024 Kurtatsch a.d.Weinstr.,80,,7,20,27
024 Kurtatsch a.d.Weinstr.,81,,-,3,3
024 Kurtatsch a.d.Weinstr.,82,,3,8,11
024 Kurtatsch a.d.Weinstr.,83,,5,3,8
024 Kurtatsch a.d.Weinstr.,84,,2,1,3
024 Kurtatsch a.d.Weinstr.,85,,-,1,1
024 Kurtatsch a.d.Weinstr.,86,,-,5,5
024 Kurtatsch a.d.Weinstr.,87,,-,1,1
024 Kurtatsch a.d.Weinstr.,88,,1,2,3
024 Kurtatsch a.d.Weinstr.,89,,3,2,5
024 Kurtatsch a.d.Weinstr.,90,,-,2,2
024 Kurtatsch a.d.Weinstr.,91,,2,3,5
024 Kurtatsch a.d.Weinstr.,92,,-,4,4
024 Kurtatsch a.d.Weinstr.,93,,-,1,1
024 Kurtatsch a.d.Weinstr.,95,,1,1,2
024 Kurtatsch a.d.Weinstr.,96,,-,1,1
024 Kurtatsch a.d.Weinstr.,97,,1,-,1
024 Kurtatsch a.d.Weinstr.,99,,1,-,1
025 Kurtinig a.d. Weinstr.,0,,6,3,9
025 Kurtinig a.d. Weinstr.,1,,3,4,7
025 Kurtinig a.d. Weinstr.,2,,2,7,9
025 Kurtinig a.d. Weinstr.,3,,3,4,7
025 Kurtinig a.d. Weinstr.,4,,3,3,6
025 Kurtinig a.d. Weinstr.,5,,2,5,7
025 Kurtinig a.d. Weinstr.,6,,3,4,7
025 Kurtinig a.d. Weinstr.,7,,1,2,3
025 Kurtinig a.d. Weinstr.,8,,4,3,7
025 Kurtinig a.d. Weinstr.,9,,2,4,6
025 Kurtinig a.d. Weinstr.,10,,4,4,8
025 Kurtinig a.d. Weinstr.,11,,2,3,5
025 Kurtinig a.d. Weinstr.,12,,5,2,7
025 Kurtinig a.d. Weinstr.,13,,3,2,5
025 Kurtinig a.d. Weinstr.,14,,6,4,10
025 Kurtinig a.d. Weinstr.,15,,6,4,10
025 Kurtinig a.d. Weinstr.,16,,5,6,11
025 Kurtinig a.d. Weinstr.,17,,4,4,8
025 Kurtinig a.d. Weinstr.,18,,2,4,6
025 Kurtinig a.d. Weinstr.,19,,3,3,6
025 Kurtinig a.d. Weinstr.,20,,3,4,7
025 Kurtinig a.d. Weinstr.,21,,6,5,11
025 Kurtinig a.d. Weinstr.,22,,5,5,10
025 Kurtinig a.d. Weinstr.,23,,5,3,8
025 Kurtinig a.d. Weinstr.,24,,4,9,13
025 Kurtinig a.d. Weinstr.,25,,4,2,6
025 Kurtinig a.d. Weinstr.,26,,3,1,4
025 Kurtinig a.d. Weinstr.,27,,3,-,3
025 Kurtinig a.d. Weinstr.,28,,2,5,7
025 Kurtinig a.d. Weinstr.,29,,4,2,6
025 Kurtinig a.d. Weinstr.,30,,6,2,8
025 Kurtinig a.d. Weinstr.,31,,2,5,7
025 Kurtinig a.d. Weinstr.,32,,4,3,7
025 Kurtinig a.d. Weinstr.,33,,6,4,10
025 Kurtinig a.d. Weinstr.,34,,7,6,13
025 Kurtinig a.d. Weinstr.,35,,5,4,9
025 Kurtinig a.d. Weinstr.,36,,5,5,10
025 Kurtinig a.d. Weinstr.,37,,2,5,7
025 Kurtinig a.d. Weinstr.,38,,4,4,8
025 Kurtinig a.d. Weinstr.,39,,7,5,12
025 Kurtinig a.d. Weinstr.,40,,7,7,14
025 Kurtinig a.d. Weinstr.,41,,5,5,10
025 Kurtinig a.d. Weinstr.,42,,8,9,17
025 Kurtinig a.d. Weinstr.,43,,5,4,9
025 Kurtinig a.d. Weinstr.,44,,11,5,16
025 Kurtinig a.d. Weinstr.,45,,3,8,11
025 Kurtinig a.d. Weinstr.,46,,8,7,15
025 Kurtinig a.d. Weinstr.,47,,4,3,7
025 Kurtinig a.d. Weinstr.,48,,3,1,4
025 Kurtinig a.d. Weinstr.,49,,7,2,9
025 Kurtinig a.d. Weinstr.,50,,5,6,11
025 Kurtinig a.d. Weinstr.,51,,2,4,6
025 Kurtinig a.d. Weinstr.,52,,3,4,7
025 Kurtinig a.d. Weinstr.,53,,3,3,6
025 Kurtinig a.d. Weinstr.,54,,3,3,6
025 Kurtinig a.d. Weinstr.,55,,4,5,9
025 Kurtinig a.d. Weinstr.,56,,5,1,6
025 Kurtinig a.d. Weinstr.,57,,-,5,5
025 Kurtinig a.d. Weinstr.,58,,3,2,5
025 Kurtinig a.d. Weinstr.,59,,3,2,5
025 Kurtinig a.d. Weinstr.,60,,4,2,6
025 Kurtinig a.d. Weinstr.,61,,2,2,4
025 Kurtinig a.d. Weinstr.,62,,4,2,6
025 Kurtinig a.d. Weinstr.,63,,2,2,4
025 Kurtinig a.d. Weinstr.,64,,5,3,8
025 Kurtinig a.d. Weinstr.,65,,2,2,4
025 Kurtinig a.d. Weinstr.,66,,2,4,6
025 Kurtinig a.d. Weinstr.,67,,6,3,9
025 Kurtinig a.d. Weinstr.,68,,-,6,6
025 Kurtinig a.d. Weinstr.,69,,2,4,6
025 Kurtinig a.d. Weinstr.,70,,1,2,3
025 Kurtinig a.d. Weinstr.,71,,3,4,7
025 Kurtinig a.d. Weinstr.,72,,3,2,5
025 Kurtinig a.d. Weinstr.,73,,4,4,8
025 Kurtinig a.d. Weinstr.,74,,1,3,4
025 Kurtinig a.d. Weinstr.,75,,2,4,6
025 Kurtinig a.d. Weinstr.,76,,2,4,6
025 Kurtinig a.d. Weinstr.,77,,3,1,4
025 Kurtinig a.d. Weinstr.,78,,-,5,5
025 Kurtinig a.d. Weinstr.,79,,1,3,4
025 Kurtinig a.d. Weinstr.,80,,1,1,2
025 Kurtinig a.d. Weinstr.,81,,-,3,3
025 Kurtinig a.d. Weinstr.,82,,2,1,3
025 Kurtinig a.d. Weinstr.,83,,1,-,1
025 Kurtinig a.d. Weinstr.,84,,-,2,2
025 Kurtinig a.d. Weinstr.,85,,-,1,1
025 Kurtinig a.d. Weinstr.,88,,-,2,2
025 Kurtinig a.d. Weinstr.,89,,-,2,2
025 Kurtinig a.d. Weinstr.,91,,-,1,1
025 Kurtinig a.d. Weinstr.,99,,-,1,1
026 Corvara,0,,13,6,19
026 Corvara,1,,5,6,11
026 Corvara,2,,4,9,13
026 Corvara,3,,7,4,11
026 Corvara,4,,8,7,15
026 Corvara,5,,10,7,17
026 Corvara,6,,4,6,10
026 Corvara,7,,8,4,12
026 Corvara,8,,7,9,16
026 Corvara,9,,6,4,10
026 Corvara,10,,6,3,9
026 Corvara,11,,6,10,16
026 Corvara,12,,2,5,7
026 Corvara,13,,9,7,16
026 Corvara,14,,5,5,10
026 Corvara,15,,5,3,8
026 Corvara,16,,9,7,16
026 Corvara,17,,3,-,3
026 Corvara,18,,5,8,13
026 Corvara,19,,7,3,10
026 Corvara,20,,7,7,14
026 Corvara,21,,8,11,19
026 Corvara,22,,14,2,16
026 Corvara,23,,11,7,18
026 Corvara,24,,10,7,17
026 Corvara,25,,10,3,13
026 Corvara,26,,15,10,25
026 Corvara,27,,11,4,15
026 Corvara,28,,8,20,28
026 Corvara,29,,7,17,24
026 Corvara,30,,13,7,20
026 Corvara,31,,7,7,14
026 Corvara,32,,13,6,19
026 Corvara,33,,10,12,22
026 Corvara,34,,14,13,27
026 Corvara,35,,7,14,21
026 Corvara,36,,16,19,35
026 Corvara,37,,12,17,29
026 Corvara,38,,16,17,33
026 Corvara,39,,7,7,14
026 Corvara,40,,11,11,22
026 Corvara,41,,13,12,25
026 Corvara,42,,8,7,15
026 Corvara,43,,15,13,28
026 Corvara,44,,6,7,13
026 Corvara,45,,10,6,16
026 Corvara,46,,7,5,12
026 Corvara,47,,4,8,12
026 Corvara,48,,11,7,18
026 Corvara,49,,10,8,18
026 Corvara,50,,6,13,19
026 Corvara,51,,5,8,13
026 Corvara,52,,6,8,14
026 Corvara,53,,7,8,15
026 Corvara,54,,2,9,11
026 Corvara,55,,5,5,10
026 Corvara,56,,4,10,14
026 Corvara,57,,13,11,24
026 Corvara,58,,5,5,10
026 Corvara,59,,7,9,16
026 Corvara,60,,5,10,15
026 Corvara,61,,5,9,14
026 Corvara,62,,13,12,25
026 Corvara,63,,9,6,15
026 Corvara,64,,7,4,11
026 Corvara,65,,4,8,12
026 Corvara,66,,5,8,13
026 Corvara,67,,5,8,13
026 Corvara,68,,8,4,12
026 Corvara,69,,7,8,15
026 Corvara,70,,4,4,8
026 Corvara,71,,6,4,10
026 Corvara,72,,7,11,18
026 Corvara,73,,7,3,10
026 Corvara,74,,5,4,9
026 Corvara,75,,2,2,4
026 Corvara,76,,5,3,8
026 Corvara,77,,3,2,5
026 Corvara,78,,1,3,4
026 Corvara,79,,3,1,4
026 Corvara,80,,4,2,6
026 Corvara,81,,3,4,7
026 Corvara,82,,4,1,5
026 Corvara,83,,3,1,4
026 Corvara,84,,2,2,4
026 Corvara,85,,1,1,2
026 Corvara,86,,1,2,3
026 Corvara,89,,-,3,3
026 Corvara,90,,-,4,4
026 Corvara,91,,2,3,5
026 Corvara,92,,2,-,2
026 Corvara,93,,-,2,2
026 Corvara,94,,-,1,1
026 Corvara,95,,-,1,1
026 Corvara,100,,1,-,1
027 Graun im Vinschgau,0,,9,11,20
027 Graun im Vinschgau,1,,11,12,23
027 Graun im Vinschgau,2,,15,15,30
027 Graun im Vinschgau,3,,19,17,36
027 Graun im Vinschgau,4,,14,10,24
027 Graun im Vinschgau,5,,10,16,26
027 Graun im Vinschgau,6,,19,16,35
027 Graun im Vinschgau,7,,23,19,42
027 Graun im Vinschgau,8,,19,16,35
027 Graun im Vinschgau,9,,19,12,31
027 Graun im Vinschgau,10,,21,14,35
027 Graun im Vinschgau,11,,17,17,34
027 Graun im Vinschgau,12,,10,12,22
027 Graun im Vinschgau,13,,19,19,38
027 Graun im Vinschgau,14,,26,18,44
027 Graun im Vinschgau,15,,21,11,32
027 Graun im Vinschgau,16,,16,12,28
027 Graun im Vinschgau,17,,8,8,16
027 Graun im Vinschgau,18,,19,10,29
027 Graun im Vinschgau,19,,19,15,34
027 Graun im Vinschgau,20,,8,14,22
027 Graun im Vinschgau,21,,18,16,34
027 Graun im Vinschgau,22,,20,19,39
027 Graun im Vinschgau,23,,23,16,39
027 Graun im Vinschgau,24,,15,21,36
027 Graun im Vinschgau,25,,16,16,32
027 Graun im Vinschgau,26,,15,19,34
027 Graun im Vinschgau,27,,15,20,35
027 Graun im Vinschgau,28,,19,16,35
027 Graun im Vinschgau,29,,21,14,35
027 Graun im Vinschgau,30,,22,19,41
027 Graun im Vinschgau,31,,22,22,44
027 Graun im Vinschgau,32,,20,11,31
027 Graun im Vinschgau,33,,22,14,36
027 Graun im Vinschgau,34,,27,20,47
027 Graun im Vinschgau,35,,17,22,39
027 Graun im Vinschgau,36,,28,24,52
027 Graun im Vinschgau,37,,20,22,42
027 Graun im Vinschgau,38,,16,20,36
027 Graun im Vinschgau,39,,19,23,42
027 Graun im Vinschgau,40,,23,17,40
027 Graun im Vinschgau,41,,22,25,47
027 Graun im Vinschgau,42,,18,15,33
027 Graun im Vinschgau,43,,20,21,41
027 Graun im Vinschgau,44,,21,11,32
027 Graun im Vinschgau,45,,20,15,35
027 Graun im Vinschgau,46,,12,12,24
027 Graun im Vinschgau,47,,15,10,25
027 Graun im Vinschgau,48,,14,9,23
027 Graun im Vinschgau,49,,17,17,34
027 Graun im Vinschgau,50,,14,6,20
027 Graun im Vinschgau,51,,18,11,29
027 Graun im Vinschgau,52,,13,16,29
027 Graun im Vinschgau,53,,12,12,24
027 Graun im Vinschgau,54,,7,21,28
027 Graun im Vinschgau,55,,13,12,25
027 Graun im Vinschgau,56,,5,10,15
027 Graun im Vinschgau,57,,9,8,17
027 Graun im Vinschgau,58,,8,8,16
027 Graun im Vinschgau,59,,11,10,21
027 Graun im Vinschgau,60,,9,12,21
027 Graun im Vinschgau,61,,10,13,23
027 Graun im Vinschgau,62,,15,10,25
027 Graun im Vinschgau,63,,14,9,23
027 Graun im Vinschgau,64,,11,11,22
027 Graun im Vinschgau,65,,11,11,22
027 Graun im Vinschgau,66,,11,3,14
027 Graun im Vinschgau,67,,13,14,27
027 Graun im Vinschgau,68,,9,8,17
027 Graun im Vinschgau,69,,11,9,20
027 Graun im Vinschgau,70,,8,7,15
027 Graun im Vinschgau,71,,12,7,19
027 Graun im Vinschgau,72,,10,10,20
027 Graun im Vinschgau,73,,5,6,11
027 Graun im Vinschgau,74,,11,14,25
027 Graun im Vinschgau,75,,9,11,20
027 Graun im Vinschgau,76,,6,10,16
027 Graun im Vinschgau,77,,8,12,20
027 Graun im Vinschgau,78,,6,5,11
027 Graun im Vinschgau,79,,6,8,14
027 Graun im Vinschgau,80,,4,11,15
027 Graun im Vinschgau,81,,7,8,15
027 Graun im Vinschgau,82,,6,10,16
027 Graun im Vinschgau,83,,3,1,4
027 Graun im Vinschgau,84,,1,5,6
027 Graun im Vinschgau,85,,2,2,4
027 Graun im Vinschgau,86,,-,1,1
027 Graun im Vinschgau,87,,1,2,3
027 Graun im Vinschgau,88,,-,3,3
027 Graun im Vinschgau,89,,1,4,5
027 Graun im Vinschgau,90,,-,1,1
027 Graun im Vinschgau,91,,1,1,2
027 Graun im Vinschgau,92,,-,2,2
027 Graun im Vinschgau,95,,-,2,2
027 Graun im Vinschgau,96,,-,1,1
027 Graun im Vinschgau,100,,-,1,1
028 Toblach,0,,18,25,43
028 Toblach,1,,11,24,35
028 Toblach,2,,28,17,45
028 Toblach,3,,21,16,37
028 Toblach,4,,15,19,34
028 Toblach,5,,19,11,30
028 Toblach,6,,25,17,42
028 Toblach,7,,27,22,49
028 Toblach,8,,17,10,27
028 Toblach,9,,22,19,41
028 Toblach,10,,19,19,38
028 Toblach,11,,15,18,33
028 Toblach,12,,17,29,46
028 Toblach,13,,17,23,40
028 Toblach,14,,10,15,25
028 Toblach,15,,13,24,37
028 Toblach,16,,31,16,47
028 Toblach,17,,15,21,36
028 Toblach,18,,24,23,47
028 Toblach,19,,20,28,48
028 Toblach,20,,22,20,42
028 Toblach,21,,22,28,50
028 Toblach,22,,26,22,48
028 Toblach,23,,27,18,45
028 Toblach,24,,26,25,51
028 Toblach,25,,23,23,46
028 Toblach,26,,16,24,40
028 Toblach,27,,27,35,62
028 Toblach,28,,22,22,44
028 Toblach,29,,30,16,46
028 Toblach,30,,31,25,56
028 Toblach,31,,29,33,62
028 Toblach,32,,29,21,50
028 Toblach,33,,24,19,43
028 Toblach,34,,40,26,66
028 Toblach,35,,36,29,65
028 Toblach,36,,29,22,51
028 Toblach,37,,28,29,57
028 Toblach,38,,37,28,65
028 Toblach,39,,33,31,64
028 Toblach,40,,31,25,56
028 Toblach,41,,37,30,67
028 Toblach,42,,22,30,52
028 Toblach,43,,20,16,36
028 Toblach,44,,37,27,64
028 Toblach,45,,25,15,40
028 Toblach,46,,27,22,49
028 Toblach,47,,16,23,39
028 Toblach,48,,18,26,44
028 Toblach,49,,20,19,39
028 Toblach,50,,20,25,45
028 Toblach,51,,18,17,35
028 Toblach,52,,27,11,38
028 Toblach,53,,15,17,32
028 Toblach,54,,20,13,33
028 Toblach,55,,15,24,39
028 Toblach,56,,20,15,35
028 Toblach,57,,12,15,27
028 Toblach,58,,13,17,30
028 Toblach,59,,18,12,30
028 Toblach,60,,14,18,32
028 Toblach,61,,15,19,34
028 Toblach,62,,18,12,30
028 Toblach,63,,13,13,26
028 Toblach,64,,15,13,28
028 Toblach,65,,15,8,23
028 Toblach,66,,5,10,15
028 Toblach,67,,9,15,24
028 Toblach,68,,8,18,26
028 Toblach,69,,14,16,30
028 Toblach,70,,9,10,19
028 Toblach,71,,13,17,30
028 Toblach,72,,16,14,30
028 Toblach,73,,9,11,20
028 Toblach,74,,10,13,23
028 Toblach,75,,13,10,23
028 Toblach,76,,8,14,22
028 Toblach,77,,9,13,22
028 Toblach,78,,13,9,22
028 Toblach,79,,7,10,17
028 Toblach,80,,10,8,18
028 Toblach,81,,6,15,21
028 Toblach,82,,4,11,15
028 Toblach,83,,4,8,12
028 Toblach,84,,3,12,15
028 Toblach,85,,4,3,7
028 Toblach,86,,4,4,8
028 Toblach,87,,2,4,6
028 Toblach,88,,1,7,8
028 Toblach,89,,1,2,3
028 Toblach,90,,1,3,4
028 Toblach,91,,1,2,3
028 Toblach,92,,1,3,4
028 Toblach,93,,-,2,2
028 Toblach,94,,1,1,2
028 Toblach,95,,-,1,1
028 Toblach,96,,1,-,1
028 Toblach,97,,-,1,1
028 Toblach,98,,-,1,1
029 Neumarkt,0,,37,25,62
029 Neumarkt,1,,27,30,57
029 Neumarkt,2,,23,34,57
029 Neumarkt,3,,27,18,45
029 Neumarkt,4,,17,26,43
029 Neumarkt,5,,21,35,56
029 Neumarkt,6,,18,17,35
029 Neumarkt,7,,20,24,44
029 Neumarkt,8,,23,25,48
029 Neumarkt,9,,22,24,46
029 Neumarkt,10,,23,36,59
029 Neumarkt,11,,20,26,46
029 Neumarkt,12,,24,18,42
029 Neumarkt,13,,26,24,50
029 Neumarkt,14,,21,31,52
029 Neumarkt,15,,21,25,46
029 Neumarkt,16,,25,29,54
029 Neumarkt,17,,21,16,37
029 Neumarkt,18,,25,18,43
029 Neumarkt,19,,19,22,41
029 Neumarkt,20,,14,24,38
029 Neumarkt,21,,25,26,51
029 Neumarkt,22,,24,20,44
029 Neumarkt,23,,20,23,43
029 Neumarkt,24,,28,19,47
029 Neumarkt,25,,35,30,65
029 Neumarkt,26,,18,17,35
029 Neumarkt,27,,28,35,63
029 Neumarkt,28,,35,33,68
029 Neumarkt,29,,30,38,68
029 Neumarkt,30,,25,27,52
029 Neumarkt,31,,34,43,77
029 Neumarkt,32,,30,49,79
029 Neumarkt,33,,31,28,59
029 Neumarkt,34,,34,37,71
029 Neumarkt,35,,29,47,76
029 Neumarkt,36,,43,43,86
029 Neumarkt,37,,53,44,97
029 Neumarkt,38,,51,38,89
029 Neumarkt,39,,50,39,89
029 Neumarkt,40,,47,42,89
029 Neumarkt,41,,52,33,85
029 Neumarkt,42,,33,38,71
029 Neumarkt,43,,49,43,92
029 Neumarkt,44,,42,34,76
029 Neumarkt,45,,28,35,63
029 Neumarkt,46,,36,31,67
029 Neumarkt,47,,32,26,58
029 Neumarkt,48,,37,41,78
029 Neumarkt,49,,36,29,65
029 Neumarkt,50,,19,20,39
029 Neumarkt,51,,26,22,48
029 Neumarkt,52,,22,25,47
029 Neumarkt,53,,24,24,48
029 Neumarkt,54,,18,25,43
029 Neumarkt,55,,21,22,43
029 Neumarkt,56,,27,31,58
029 Neumarkt,57,,34,31,65
029 Neumarkt,58,,26,23,49
029 Neumarkt,59,,21,17,38
029 Neumarkt,60,,25,22,47
029 Neumarkt,61,,22,26,48
029 Neumarkt,62,,37,25,62
029 Neumarkt,63,,29,32,61
029 Neumarkt,64,,17,28,45
029 Neumarkt,65,,20,19,39
029 Neumarkt,66,,22,17,39
029 Neumarkt,67,,19,17,36
029 Neumarkt,68,,22,23,45
029 Neumarkt,69,,14,22,36
029 Neumarkt,70,,19,19,38
029 Neumarkt,71,,19,22,41
029 Neumarkt,72,,23,30,53
029 Neumarkt,73,,17,23,40
029 Neumarkt,74,,14,17,31
029 Neumarkt,75,,6,20,26
029 Neumarkt,76,,18,19,37
029 Neumarkt,77,,15,18,33
029 Neumarkt,78,,16,23,39
029 Neumarkt,79,,9,15,24
029 Neumarkt,80,,14,26,40
029 Neumarkt,81,,9,16,25
029 Neumarkt,82,,5,23,28
029 Neumarkt,83,,5,18,23
029 Neumarkt,84,,5,8,13
029 Neumarkt,85,,6,3,9
029 Neumarkt,86,,1,7,8
029 Neumarkt,87,,1,2,3
029 Neumarkt,88,,1,6,7
029 Neumarkt,89,,4,5,9
029 Neumarkt,90,,4,6,10
029 Neumarkt,91,,2,6,8
029 Neumarkt,92,,1,3,4
029 Neumarkt,93,,1,2,3
029 Neumarkt,94,,2,1,3
029 Neumarkt,95,,-,1,1
029 Neumarkt,96,,-,1,1
029 Neumarkt,97,,1,2,3
030 Pfalzen,0,,18,11,29
030 Pfalzen,1,,13,13,26
030 Pfalzen,2,,16,12,28
030 Pfalzen,3,,11,17,28
030 Pfalzen,4,,19,18,37
030 Pfalzen,5,,16,16,32
030 Pfalzen,6,,13,15,28
030 Pfalzen,7,,15,16,31
030 Pfalzen,8,,23,17,40
030 Pfalzen,9,,11,15,26
030 Pfalzen,10,,11,17,28
030 Pfalzen,11,,13,21,34
030 Pfalzen,12,,14,19,33
030 Pfalzen,13,,18,12,30
030 Pfalzen,14,,16,19,35
030 Pfalzen,15,,13,8,21
030 Pfalzen,16,,14,23,37
030 Pfalzen,17,,20,18,38
030 Pfalzen,18,,22,13,35
030 Pfalzen,19,,15,10,25
030 Pfalzen,20,,13,11,24
030 Pfalzen,21,,19,19,38
030 Pfalzen,22,,18,19,37
030 Pfalzen,23,,20,17,37
030 Pfalzen,24,,15,20,35
030 Pfalzen,25,,18,17,35
030 Pfalzen,26,,21,16,37
030 Pfalzen,27,,17,12,29
030 Pfalzen,28,,11,20,31
030 Pfalzen,29,,26,18,44
030 Pfalzen,30,,16,21,37
030 Pfalzen,31,,18,17,35
030 Pfalzen,32,,22,23,45
030 Pfalzen,33,,19,23,42
030 Pfalzen,34,,30,13,43
030 Pfalzen,35,,23,34,57
030 Pfalzen,36,,22,22,44
030 Pfalzen,37,,23,22,45
030 Pfalzen,38,,22,23,45
030 Pfalzen,39,,19,16,35
030 Pfalzen,40,,27,17,44
030 Pfalzen,41,,19,29,48
030 Pfalzen,42,,25,18,43
030 Pfalzen,43,,20,13,33
030 Pfalzen,44,,15,15,30
030 Pfalzen,45,,16,21,37
030 Pfalzen,46,,24,18,42
030 Pfalzen,47,,15,14,29
030 Pfalzen,48,,15,11,26
030 Pfalzen,49,,13,12,25
030 Pfalzen,50,,13,11,24
030 Pfalzen,51,,9,10,19
030 Pfalzen,52,,16,17,33
030 Pfalzen,53,,11,11,22
030 Pfalzen,54,,15,6,21
030 Pfalzen,55,,10,10,20
030 Pfalzen,56,,11,3,14
030 Pfalzen,57,,8,9,17
030 Pfalzen,58,,7,9,16
030 Pfalzen,59,,10,6,16
030 Pfalzen,60,,8,12,20
030 Pfalzen,61,,6,13,19
030 Pfalzen,62,,11,8,19
030 Pfalzen,63,,13,9,22
030 Pfalzen,64,,10,5,15
030 Pfalzen,65,,11,10,21
030 Pfalzen,66,,6,5,11
030 Pfalzen,67,,2,9,11
030 Pfalzen,68,,8,5,13
030 Pfalzen,69,,8,13,21
030 Pfalzen,70,,6,8,14
030 Pfalzen,71,,9,5,14
030 Pfalzen,72,,11,7,18
030 Pfalzen,73,,8,11,19
030 Pfalzen,74,,9,6,15
030 Pfalzen,75,,3,5,8
030 Pfalzen,76,,6,5,11
030 Pfalzen,77,,4,4,8
030 Pfalzen,78,,6,3,9
030 Pfalzen,79,,3,10,13
030 Pfalzen,80,,5,5,10
030 Pfalzen,81,,3,3,6
030 Pfalzen,82,,-,5,5
030 Pfalzen,83,,2,7,9
030 Pfalzen,84,,3,3,6
030 Pfalzen,85,,1,1,2
030 Pfalzen,86,,-,1,1
030 Pfalzen,87,,-,2,2
030 Pfalzen,89,,1,4,5
030 Pfalzen,90,,1,2,3
030 Pfalzen,93,,-,3,3
030 Pfalzen,94,,1,1,2
030 Pfalzen,95,,1,-,1
031 Völs am Schlern,0,,15,22,37
031 Völs am Schlern,1,,21,29,50
031 Völs am Schlern,2,,20,23,43
031 Völs am Schlern,3,,22,28,50
031 Völs am Schlern,4,,21,17,38
031 Völs am Schlern,5,,27,26,53
031 Völs am Schlern,6,,20,23,43
031 Völs am Schlern,7,,14,19,33
031 Völs am Schlern,8,,20,23,43
031 Völs am Schlern,9,,20,8,28
031 Völs am Schlern,10,,17,17,34
031 Völs am Schlern,11,,18,17,35
031 Völs am Schlern,12,,14,20,34
031 Völs am Schlern,13,,19,18,37
031 Völs am Schlern,14,,19,16,35
031 Völs am Schlern,15,,16,14,30
031 Völs am Schlern,16,,18,14,32
031 Völs am Schlern,17,,22,12,34
031 Völs am Schlern,18,,16,14,30
031 Völs am Schlern,19,,16,6,22
031 Völs am Schlern,20,,11,23,34
031 Völs am Schlern,21,,19,21,40
031 Völs am Schlern,22,,28,18,46
031 Völs am Schlern,23,,31,17,48
031 Völs am Schlern,24,,20,24,44
031 Völs am Schlern,25,,25,19,44
031 Völs am Schlern,26,,21,26,47
031 Völs am Schlern,27,,27,20,47
031 Völs am Schlern,28,,24,19,43
031 Völs am Schlern,29,,24,24,48
031 Völs am Schlern,30,,25,31,56
031 Völs am Schlern,31,,35,27,62
031 Völs am Schlern,32,,34,33,67
031 Völs am Schlern,33,,31,33,64
031 Völs am Schlern,34,,33,31,64
031 Völs am Schlern,35,,29,35,64
031 Völs am Schlern,36,,30,23,53
031 Völs am Schlern,37,,37,24,61
031 Völs am Schlern,38,,27,26,53
031 Völs am Schlern,39,,27,25,52
031 Völs am Schlern,40,,33,25,58
031 Völs am Schlern,41,,28,19,47
031 Völs am Schlern,42,,22,20,42
031 Völs am Schlern,43,,23,21,44
031 Völs am Schlern,44,,17,11,28
031 Völs am Schlern,45,,21,16,37
031 Völs am Schlern,46,,21,17,38
031 Völs am Schlern,47,,20,17,37
031 Völs am Schlern,48,,17,14,31
031 Völs am Schlern,49,,15,26,41
031 Völs am Schlern,50,,17,24,41
031 Völs am Schlern,51,,19,17,36
031 Völs am Schlern,52,,17,22,39
031 Völs am Schlern,53,,22,15,37
031 Völs am Schlern,54,,17,9,26
031 Völs am Schlern,55,,16,12,28
031 Völs am Schlern,56,,16,19,35
031 Völs am Schlern,57,,16,11,27
031 Völs am Schlern,58,,11,12,23
031 Völs am Schlern,59,,14,10,24
031 Völs am Schlern,60,,14,23,37
031 Völs am Schlern,61,,14,17,31
031 Völs am Schlern,62,,20,20,40
031 Völs am Schlern,63,,11,20,31
031 Völs am Schlern,64,,13,11,24
031 Völs am Schlern,65,,12,15,27
031 Völs am Schlern,66,,11,9,20
031 Völs am Schlern,67,,8,20,28
031 Völs am Schlern,68,,16,13,29
031 Völs am Schlern,69,,15,8,23
031 Völs am Schlern,70,,7,14,21
031 Völs am Schlern,71,,13,8,21
031 Völs am Schlern,72,,13,14,27
031 Völs am Schlern,73,,6,12,18
031 Völs am Schlern,74,,7,11,18
031 Völs am Schlern,75,,5,13,18
031 Völs am Schlern,76,,10,10,20
031 Völs am Schlern,77,,9,6,15
031 Völs am Schlern,78,,7,11,18
031 Völs am Schlern,79,,10,12,22
031 Völs am Schlern,80,,4,5,9
031 Völs am Schlern,81,,3,7,10
031 Völs am Schlern,82,,4,11,15
031 Völs am Schlern,83,,4,7,11
031 Völs am Schlern,84,,1,5,6
031 Völs am Schlern,85,,1,4,5
031 Völs am Schlern,86,,1,5,6
031 Völs am Schlern,87,,2,2,4
031 Völs am Schlern,88,,1,3,4
031 Völs am Schlern,89,,3,4,7
031 Völs am Schlern,90,,5,-,5
031 Völs am Schlern,91,,-,1,1
031 Völs am Schlern,92,,1,1,2
031 Völs am Schlern,93,,1,1,2
031 Völs am Schlern,94,,2,-,2
031 Völs am Schlern,95,,-,2,2
031 Völs am Schlern,96,,-,1,1
032 Franzensfeste,0,,6,3,9
032 Franzensfeste,1,,7,6,13
032 Franzensfeste,2,,4,5,9
032 Franzensfeste,3,,3,4,7
032 Franzensfeste,4,,6,6,12
032 Franzensfeste,5,,4,6,10
032 Franzensfeste,6,,5,2,7
032 Franzensfeste,7,,6,3,9
032 Franzensfeste,8,,4,2,6
032 Franzensfeste,9,,5,5,10
032 Franzensfeste,10,,5,5,10
032 Franzensfeste,11,,5,9,14
032 Franzensfeste,12,,5,4,9
032 Franzensfeste,13,,2,4,6
032 Franzensfeste,14,,4,4,8
032 Franzensfeste,15,,3,3,6
032 Franzensfeste,16,,4,2,6
032 Franzensfeste,17,,5,5,10
032 Franzensfeste,18,,4,6,10
032 Franzensfeste,19,,5,7,12
032 Franzensfeste,20,,7,5,12
032 Franzensfeste,21,,3,8,11
032 Franzensfeste,22,,7,4,11
032 Franzensfeste,23,,6,8,14
032 Franzensfeste,24,,12,5,17
032 Franzensfeste,25,,4,3,7
032 Franzensfeste,26,,1,4,5
032 Franzensfeste,27,,3,6,9
032 Franzensfeste,28,,8,10,18
032 Franzensfeste,29,,9,8,17
032 Franzensfeste,30,,3,5,8
032 Franzensfeste,31,,6,10,16
032 Franzensfeste,32,,8,2,10
032 Franzensfeste,33,,12,7,19
032 Franzensfeste,34,,8,6,14
032 Franzensfeste,35,,9,12,21
032 Franzensfeste,36,,10,6,16
032 Franzensfeste,37,,9,7,16
032 Franzensfeste,38,,10,6,16
032 Franzensfeste,39,,15,8,23
032 Franzensfeste,40,,7,9,16
032 Franzensfeste,41,,9,2,11
032 Franzensfeste,42,,5,10,15
032 Franzensfeste,43,,5,7,12
032 Franzensfeste,44,,8,9,17
032 Franzensfeste,45,,13,4,17
032 Franzensfeste,46,,5,6,11
032 Franzensfeste,47,,4,7,11
032 Franzensfeste,48,,9,7,16
032 Franzensfeste,49,,5,10,15
032 Franzensfeste,50,,7,6,13
032 Franzensfeste,51,,5,4,9
032 Franzensfeste,52,,7,2,9
032 Franzensfeste,53,,12,3,15
032 Franzensfeste,54,,3,4,7
032 Franzensfeste,55,,5,4,9
032 Franzensfeste,56,,2,3,5
032 Franzensfeste,57,,8,6,14
032 Franzensfeste,58,,4,7,11
032 Franzensfeste,59,,4,9,13
032 Franzensfeste,60,,3,2,5
032 Franzensfeste,61,,5,1,6
032 Franzensfeste,62,,5,2,7
032 Franzensfeste,63,,4,4,8
032 Franzensfeste,64,,7,4,11
032 Franzensfeste,65,,1,3,4
032 Franzensfeste,66,,8,6,14
032 Franzensfeste,67,,4,2,6
032 Franzensfeste,68,,3,3,6
032 Franzensfeste,69,,3,3,6
032 Franzensfeste,70,,2,6,8
032 Franzensfeste,71,,3,6,9
032 Franzensfeste,72,,2,8,10
032 Franzensfeste,73,,6,4,10
032 Franzensfeste,74,,4,8,12
032 Franzensfeste,75,,2,2,4
032 Franzensfeste,76,,3,6,9
032 Franzensfeste,77,,4,10,14
032 Franzensfeste,78,,3,1,4
032 Franzensfeste,79,,7,5,12
032 Franzensfeste,80,,4,6,10
032 Franzensfeste,81,,3,4,7
032 Franzensfeste,82,,1,5,6
032 Franzensfeste,83,,1,2,3
032 Franzensfeste,84,,2,-,2
032 Franzensfeste,85,,-,2,2
032 Franzensfeste,88,,1,2,3
032 Franzensfeste,90,,1,-,1
032 Franzensfeste,91,,-,1,1
032 Franzensfeste,92,,-,1,1
032 Franzensfeste,94,,-,1,1
033 Villnöss,0,,16,13,29
033 Villnöss,1,,21,15,36
033 Villnöss,2,,14,22,36
033 Villnöss,3,,19,14,33
033 Villnöss,4,,16,31,47
033 Villnöss,5,,23,19,42
033 Villnöss,6,,16,22,38
033 Villnöss,7,,22,17,39
033 Villnöss,8,,16,13,29
033 Villnöss,9,,15,12,27
033 Villnöss,10,,17,12,29
033 Villnöss,11,,13,14,27
033 Villnöss,12,,20,16,36
033 Villnöss,13,,15,11,26
033 Villnöss,14,,13,7,20
033 Villnöss,15,,17,23,40
033 Villnöss,16,,16,21,37
033 Villnöss,17,,11,17,28
033 Villnöss,18,,16,17,33
033 Villnöss,19,,15,14,29
033 Villnöss,20,,16,14,30
033 Villnöss,21,,12,16,28
033 Villnöss,22,,12,17,29
033 Villnöss,23,,21,11,32
033 Villnöss,24,,11,11,22
033 Villnöss,25,,16,15,31
033 Villnöss,26,,17,14,31
033 Villnöss,27,,15,12,27
033 Villnöss,28,,25,18,43
033 Villnöss,29,,20,20,40
033 Villnöss,30,,9,17,26
033 Villnöss,31,,19,26,45
033 Villnöss,32,,27,25,52
033 Villnöss,33,,19,25,44
033 Villnöss,34,,31,22,53
033 Villnöss,35,,28,18,46
033 Villnöss,36,,20,16,36
033 Villnöss,37,,26,20,46
033 Villnöss,38,,30,24,54
033 Villnöss,39,,31,26,57
033 Villnöss,40,,30,19,49
033 Villnöss,41,,27,19,46
033 Villnöss,42,,23,15,38
033 Villnöss,43,,19,13,32
033 Villnöss,44,,11,11,22
033 Villnöss,45,,8,15,23
033 Villnöss,46,,13,12,25
033 Villnöss,47,,14,16,30
033 Villnöss,48,,13,3,16
033 Villnöss,49,,17,13,30
033 Villnöss,50,,13,13,26
033 Villnöss,51,,14,11,25
033 Villnöss,52,,11,9,20
033 Villnöss,53,,7,9,16
033 Villnöss,54,,8,14,22
033 Villnöss,55,,10,10,20
033 Villnöss,56,,11,11,22
033 Villnöss,57,,11,5,16
033 Villnöss,58,,8,4,12
033 Villnöss,59,,9,14,23
033 Villnöss,60,,12,10,22
033 Villnöss,61,,11,18,29
033 Villnöss,62,,13,10,23
033 Villnöss,63,,8,18,26
033 Villnöss,64,,12,12,24
033 Villnöss,65,,12,9,21
033 Villnöss,66,,10,14,24
033 Villnöss,67,,5,16,21
033 Villnöss,68,,7,10,17
033 Villnöss,69,,11,9,20
033 Villnöss,70,,10,11,21
033 Villnöss,71,,14,13,27
033 Villnöss,72,,9,11,20
033 Villnöss,73,,10,10,20
033 Villnöss,74,,9,12,21
033 Villnöss,75,,15,6,21
033 Villnöss,76,,7,11,18
033 Villnöss,77,,3,8,11
033 Villnöss,78,,7,6,13
033 Villnöss,79,,5,11,16
033 Villnöss,80,,7,11,18
033 Villnöss,81,,4,8,12
033 Villnöss,82,,1,5,6
033 Villnöss,83,,1,6,7
033 Villnöss,84,,2,5,7
033 Villnöss,85,,-,1,1
033 Villnöss,86,,1,3,4
033 Villnöss,87,,-,1,1
033 Villnöss,88,,1,3,4
033 Villnöss,89,,4,3,7
033 Villnöss,90,,1,2,3
033 Villnöss,92,,1,1,2
033 Villnöss,93,,2,1,3
033 Villnöss,94,,1,3,4
034 Gais,0,,16,14,30
034 Gais,1,,24,19,43
034 Gais,2,,23,17,40
034 Gais,3,,21,19,40
034 Gais,4,,21,28,49
034 Gais,5,,25,22,47
034 Gais,6,,27,12,39
034 Gais,7,,9,20,29
034 Gais,8,,25,16,41
034 Gais,9,,22,24,46
034 Gais,10,,12,18,30
034 Gais,11,,21,28,49
034 Gais,12,,25,30,55
034 Gais,13,,12,20,32
034 Gais,14,,16,13,29
034 Gais,15,,17,16,33
034 Gais,16,,17,23,40
034 Gais,17,,16,18,34
034 Gais,18,,22,16,38
034 Gais,19,,22,17,39
034 Gais,20,,20,20,40
034 Gais,21,,18,18,36
034 Gais,22,,22,19,41
034 Gais,23,,24,23,47
034 Gais,24,,23,16,39
034 Gais,25,,19,20,39
034 Gais,26,,17,22,39
034 Gais,27,,23,23,46
034 Gais,28,,22,19,41
034 Gais,29,,28,25,53
034 Gais,30,,26,26,52
034 Gais,31,,29,37,66
034 Gais,32,,34,27,61
034 Gais,33,,27,25,52
034 Gais,34,,36,32,68
034 Gais,35,,23,22,45
034 Gais,36,,27,29,56
034 Gais,37,,33,18,51
034 Gais,38,,30,27,57
034 Gais,39,,27,28,55
034 Gais,40,,17,16,33
034 Gais,41,,29,21,50
034 Gais,42,,24,29,53
034 Gais,43,,17,13,30
034 Gais,44,,18,21,39
034 Gais,45,,24,20,44
034 Gais,46,,12,16,28
034 Gais,47,,26,21,47
034 Gais,48,,19,13,32
034 Gais,49,,15,13,28
034 Gais,50,,16,14,30
034 Gais,51,,15,17,32
034 Gais,52,,17,19,36
034 Gais,53,,21,21,42
034 Gais,54,,15,12,27
034 Gais,55,,25,14,39
034 Gais,56,,20,11,31
034 Gais,57,,18,20,38
034 Gais,58,,10,9,19
034 Gais,59,,12,13,25
034 Gais,60,,13,16,29
034 Gais,61,,14,15,29
034 Gais,62,,20,12,32
034 Gais,63,,18,12,30
034 Gais,64,,13,16,29
034 Gais,65,,14,14,28
034 Gais,66,,18,16,34
034 Gais,67,,10,13,23
034 Gais,68,,12,12,24
034 Gais,69,,7,6,13
034 Gais,70,,4,10,14
034 Gais,71,,8,10,18
034 Gais,72,,11,8,19
034 Gais,73,,4,13,17
034 Gais,74,,5,5,10
034 Gais,75,,10,8,18
034 Gais,76,,7,8,15
034 Gais,77,,12,8,20
034 Gais,78,,4,5,9
034 Gais,79,,5,7,12
034 Gais,80,,4,9,13
034 Gais,81,,3,4,7
034 Gais,82,,3,4,7
034 Gais,83,,2,2,4
034 Gais,84,,1,2,3
034 Gais,85,,2,4,6
034 Gais,86,,1,-,1
034 Gais,87,,-,2,2
034 Gais,88,,-,3,3
034 Gais,89,,1,2,3
034 Gais,90,,2,2,4
034 Gais,91,,-,2,2
034 Gais,92,,1,1,2
034 Gais,93,,1,-,1
034 Gais,96,,-,1,1
035 Gargazon,0,,6,13,19
035 Gargazon,1,,5,15,20
035 Gargazon,2,,4,8,12
035 Gargazon,3,,11,6,17
035 Gargazon,4,,11,7,18
035 Gargazon,5,,14,9,23
035 Gargazon,6,,5,14,19
035 Gargazon,7,,11,5,16
035 Gargazon,8,,12,5,17
035 Gargazon,9,,3,7,10
035 Gargazon,10,,10,8,18
035 Gargazon,11,,13,8,21
035 Gargazon,12,,16,10,26
035 Gargazon,13,,8,10,18
035 Gargazon,14,,8,7,15
035 Gargazon,15,,9,5,14
035 Gargazon,16,,6,10,16
035 Gargazon,17,,5,11,16
035 Gargazon,18,,11,3,14
035 Gargazon,19,,10,4,14
035 Gargazon,20,,4,8,12
035 Gargazon,21,,5,8,13
035 Gargazon,22,,11,5,16
035 Gargazon,23,,6,13,19
035 Gargazon,24,,6,7,13
035 Gargazon,25,,4,10,14
035 Gargazon,26,,5,8,13
035 Gargazon,27,,4,8,12
035 Gargazon,28,,9,7,16
035 Gargazon,29,,9,9,18
035 Gargazon,30,,11,10,21
035 Gargazon,31,,10,20,30
035 Gargazon,32,,13,13,26
035 Gargazon,33,,10,11,21
035 Gargazon,34,,14,13,27
035 Gargazon,35,,16,19,35
035 Gargazon,36,,16,16,32
035 Gargazon,37,,15,15,30
035 Gargazon,38,,14,10,24
035 Gargazon,39,,15,17,32
035 Gargazon,40,,18,16,34
035 Gargazon,41,,13,14,27
035 Gargazon,42,,12,12,24
035 Gargazon,43,,10,11,21
035 Gargazon,44,,16,13,29
035 Gargazon,45,,7,8,15
035 Gargazon,46,,18,11,29
035 Gargazon,47,,12,6,18
035 Gargazon,48,,7,2,9
035 Gargazon,49,,9,11,20
035 Gargazon,50,,14,9,23
035 Gargazon,51,,3,6,9
035 Gargazon,52,,10,9,19
035 Gargazon,53,,8,6,14
035 Gargazon,54,,7,11,18
035 Gargazon,55,,8,8,16
035 Gargazon,56,,5,8,13
035 Gargazon,57,,7,13,20
035 Gargazon,58,,8,5,13
035 Gargazon,59,,2,4,6
035 Gargazon,60,,4,7,11
035 Gargazon,61,,6,12,18
035 Gargazon,62,,9,8,17
035 Gargazon,63,,5,17,22
035 Gargazon,64,,8,6,14
035 Gargazon,65,,10,7,17
035 Gargazon,66,,8,14,22
035 Gargazon,67,,5,4,9
035 Gargazon,68,,12,2,14
035 Gargazon,69,,8,5,13
035 Gargazon,70,,3,10,13
035 Gargazon,71,,7,2,9
035 Gargazon,72,,4,7,11
035 Gargazon,73,,3,5,8
035 Gargazon,74,,2,10,12
035 Gargazon,75,,3,5,8
035 Gargazon,76,,3,5,8
035 Gargazon,77,,5,3,8
035 Gargazon,78,,2,6,8
035 Gargazon,79,,1,3,4
035 Gargazon,80,,5,6,11
035 Gargazon,81,,3,7,10
035 Gargazon,82,,5,4,9
035 Gargazon,83,,1,1,2
035 Gargazon,84,,2,2,4
035 Gargazon,85,,-,2,2
035 Gargazon,86,,-,1,1
035 Gargazon,87,,-,2,2
035 Gargazon,88,,2,3,5
035 Gargazon,89,,2,-,2
035 Gargazon,90,,1,4,5
035 Gargazon,91,,2,3,5
035 Gargazon,94,,-,1,1
035 Gargazon,97,,-,1,1
036 Glurns,0,,6,5,11
036 Glurns,1,,3,5,8
036 Glurns,2,,5,-,5
036 Glurns,3,,4,4,8
036 Glurns,4,,4,4,8
036 Glurns,5,,10,4,14
036 Glurns,6,,4,7,11
036 Glurns,7,,8,5,13
036 Glurns,8,,7,4,11
036 Glurns,9,,2,3,5
036 Glurns,10,,7,7,14
036 Glurns,11,,5,8,13
036 Glurns,12,,6,4,10
036 Glurns,13,,8,6,14
036 Glurns,14,,4,3,7
036 Glurns,15,,7,9,16
036 Glurns,16,,6,6,12
036 Glurns,17,,6,8,14
036 Glurns,18,,3,3,6
036 Glurns,19,,7,7,14
036 Glurns,20,,8,6,14
036 Glurns,21,,11,8,19
036 Glurns,22,,7,6,13
036 Glurns,23,,13,6,19
036 Glurns,24,,6,9,15
036 Glurns,25,,5,7,12
036 Glurns,26,,5,3,8
036 Glurns,27,,10,6,16
036 Glurns,28,,6,9,15
036 Glurns,29,,9,11,20
036 Glurns,30,,3,5,8
036 Glurns,31,,4,6,10
036 Glurns,32,,6,5,11
036 Glurns,33,,4,-,4
036 Glurns,34,,4,6,10
036 Glurns,35,,6,5,11
036 Glurns,36,,7,9,16
036 Glurns,37,,5,8,13
036 Glurns,38,,1,5,6
036 Glurns,39,,9,4,13
036 Glurns,40,,6,9,15
036 Glurns,41,,4,6,10
036 Glurns,42,,4,5,9
036 Glurns,43,,7,9,16
036 Glurns,44,,12,9,21
036 Glurns,45,,4,10,14
036 Glurns,46,,6,12,18
036 Glurns,47,,8,5,13
036 Glurns,48,,9,7,16
036 Glurns,49,,12,4,16
036 Glurns,50,,8,9,17
036 Glurns,51,,5,10,15
036 Glurns,52,,8,10,18
036 Glurns,53,,5,5,10
036 Glurns,54,,6,3,9
036 Glurns,55,,8,5,13
036 Glurns,56,,11,7,18
036 Glurns,57,,8,2,10
036 Glurns,58,,6,1,7
036 Glurns,59,,4,4,8
036 Glurns,60,,1,4,5
036 Glurns,61,,5,5,10
036 Glurns,62,,4,2,6
036 Glurns,63,,5,1,6
036 Glurns,64,,1,3,4
036 Glurns,65,,4,4,8
036 Glurns,66,,5,5,10
036 Glurns,67,,-,1,1
036 Glurns,68,,2,4,6
036 Glurns,69,,1,5,6
036 Glurns,70,,1,1,2
036 Glurns,71,,7,3,10
036 Glurns,72,,4,1,5
036 Glurns,73,,4,2,6
036 Glurns,74,,3,7,10
036 Glurns,75,,1,3,4
036 Glurns,76,,1,3,4
036 Glurns,77,,-,2,2
036 Glurns,78,,1,6,7
036 Glurns,79,,2,2,4
036 Glurns,80,,-,1,1
036 Glurns,81,,1,-,1
036 Glurns,82,,1,3,4
036 Glurns,83,,1,1,2
036 Glurns,84,,1,3,4
036 Glurns,85,,-,1,1
036 Glurns,86,,1,2,3
036 Glurns,88,,-,1,1
036 Glurns,89,,-,2,2
036 Glurns,90,,-,3,3
036 Glurns,91,,-,2,2
036 Glurns,92,,1,-,1
036 Glurns,94,,-,1,1
036 Glurns,96,,-,1,1
037 Latsch,0,,27,20,47
037 Latsch,1,,24,27,51
037 Latsch,2,,34,25,59
037 Latsch,3,,33,34,67
037 Latsch,4,,27,22,49
037 Latsch,5,,26,20,46
037 Latsch,6,,36,39,75
037 Latsch,7,,35,36,71
037 Latsch,8,,48,35,83
037 Latsch,9,,39,22,61
037 Latsch,10,,34,31,65
037 Latsch,11,,36,35,71
037 Latsch,12,,28,37,65
037 Latsch,13,,32,51,83
037 Latsch,14,,35,32,67
037 Latsch,15,,39,33,72
037 Latsch,16,,31,39,70
037 Latsch,17,,36,26,62
037 Latsch,18,,32,32,64
037 Latsch,19,,32,36,68
037 Latsch,20,,25,31,56
037 Latsch,21,,33,48,81
037 Latsch,22,,28,45,73
037 Latsch,23,,31,39,70
037 Latsch,24,,40,29,69
037 Latsch,25,,32,24,56
037 Latsch,26,,24,33,57
037 Latsch,27,,24,21,45
037 Latsch,28,,34,32,66
037 Latsch,29,,28,32,60
037 Latsch,30,,30,34,64
037 Latsch,31,,33,39,72
037 Latsch,32,,43,41,84
037 Latsch,33,,37,37,74
037 Latsch,34,,40,43,83
037 Latsch,35,,47,53,100
037 Latsch,36,,53,50,103
037 Latsch,37,,31,48,79
037 Latsch,38,,55,47,102
037 Latsch,39,,60,43,103
037 Latsch,40,,51,45,96
037 Latsch,41,,44,44,88
037 Latsch,42,,48,36,84
037 Latsch,43,,40,58,98
037 Latsch,44,,43,43,86
037 Latsch,45,,39,30,69
037 Latsch,46,,30,33,63
037 Latsch,47,,31,33,64
037 Latsch,48,,37,28,65
037 Latsch,49,,32,22,54
037 Latsch,50,,26,22,48
037 Latsch,51,,42,21,63
037 Latsch,52,,20,34,54
037 Latsch,53,,30,15,45
037 Latsch,54,,16,21,37
037 Latsch,55,,16,21,37
037 Latsch,56,,18,15,33
037 Latsch,57,,20,21,41
037 Latsch,58,,21,18,39
037 Latsch,59,,24,13,37
037 Latsch,60,,25,22,47
037 Latsch,61,,26,24,50
037 Latsch,62,,18,26,44
037 Latsch,63,,21,23,44
037 Latsch,64,,18,19,37
037 Latsch,65,,17,30,47
037 Latsch,66,,13,26,39
037 Latsch,67,,17,14,31
037 Latsch,68,,30,15,45
037 Latsch,69,,17,26,43
037 Latsch,70,,18,22,40
037 Latsch,71,,22,21,43
037 Latsch,72,,17,19,36
037 Latsch,73,,20,20,40
037 Latsch,74,,18,16,34
037 Latsch,75,,17,19,36
037 Latsch,76,,14,29,43
037 Latsch,77,,20,16,36
037 Latsch,78,,16,22,38
037 Latsch,79,,8,18,26
037 Latsch,80,,11,18,29
037 Latsch,81,,9,20,29
037 Latsch,82,,13,13,26
037 Latsch,83,,8,9,17
037 Latsch,84,,6,10,16
037 Latsch,85,,3,3,6
037 Latsch,86,,1,3,4
037 Latsch,87,,1,4,5
037 Latsch,88,,1,4,5
037 Latsch,89,,3,5,8
037 Latsch,90,,2,7,9
037 Latsch,91,,3,3,6
037 Latsch,92,,1,3,4
037 Latsch,93,,1,1,2
037 Latsch,94,,1,1,2
037 Latsch,95,,2,3,5
038 Algund,0,,28,18,46
038 Algund,1,,21,28,49
038 Algund,2,,27,25,52
038 Algund,3,,21,26,47
038 Algund,4,,35,24,59
038 Algund,5,,20,23,43
038 Algund,6,,19,18,37
038 Algund,7,,14,19,33
038 Algund,8,,32,22,54
038 Algund,9,,26,14,40
038 Algund,10,,24,17,41
038 Algund,11,,30,20,50
038 Algund,12,,24,22,46
038 Algund,13,,29,19,48
038 Algund,14,,19,27,46
038 Algund,15,,19,23,42
038 Algund,16,,28,21,49
038 Algund,17,,23,31,54
038 Algund,18,,25,20,45
038 Algund,19,,22,20,42
038 Algund,20,,25,29,54
038 Algund,21,,25,21,46
038 Algund,22,,24,25,49
038 Algund,23,,27,25,52
038 Algund,24,,18,26,44
038 Algund,25,,17,31,48
038 Algund,26,,19,35,54
038 Algund,27,,22,23,45
038 Algund,28,,28,22,50
038 Algund,29,,22,23,45
038 Algund,30,,37,15,52
038 Algund,31,,32,31,63
038 Algund,32,,27,33,60
038 Algund,33,,46,26,72
038 Algund,34,,38,37,75
038 Algund,35,,40,29,69
038 Algund,36,,38,42,80
038 Algund,37,,34,36,70
038 Algund,38,,33,38,71
038 Algund,39,,41,29,70
038 Algund,40,,29,37,66
038 Algund,41,,32,42,74
038 Algund,42,,27,45,72
038 Algund,43,,31,38,69
038 Algund,44,,37,29,66
038 Algund,45,,40,30,70
038 Algund,46,,28,34,62
038 Algund,47,,32,26,58
038 Algund,48,,22,25,47
038 Algund,49,,30,22,52
038 Algund,50,,18,33,51
038 Algund,51,,25,24,49
038 Algund,52,,25,29,54
038 Algund,53,,22,24,46
038 Algund,54,,25,25,50
038 Algund,55,,29,22,51
038 Algund,56,,22,20,42
038 Algund,57,,32,27,59
038 Algund,58,,24,24,48
038 Algund,59,,26,26,52
038 Algund,60,,19,21,40
038 Algund,61,,17,36,53
038 Algund,62,,20,21,41
038 Algund,63,,17,26,43
038 Algund,64,,24,30,54
038 Algund,65,,22,22,44
038 Algund,66,,16,14,30
038 Algund,67,,16,28,44
038 Algund,68,,14,19,33
038 Algund,69,,22,24,46
038 Algund,70,,22,23,45
038 Algund,71,,16,21,37
038 Algund,72,,13,23,36
038 Algund,73,,16,22,38
038 Algund,74,,14,22,36
038 Algund,75,,11,19,30
038 Algund,76,,12,18,30
038 Algund,77,,14,18,32
038 Algund,78,,10,15,25
038 Algund,79,,6,19,25
038 Algund,80,,5,12,17
038 Algund,81,,9,17,26
038 Algund,82,,9,11,20
038 Algund,83,,8,10,18
038 Algund,84,,3,12,15
038 Algund,85,,4,5,9
038 Algund,86,,-,6,6
038 Algund,87,,2,4,6
038 Algund,88,,2,4,6
038 Algund,89,,1,6,7
038 Algund,90,,2,3,5
038 Algund,91,,2,9,11
038 Algund,92,,1,7,8
038 Algund,93,,2,4,6
038 Algund,94,,2,-,2
038 Algund,95,,-,3,3
038 Algund,96,,-,2,2
038 Algund,97,,-,1,1
038 Algund,98,,-,1,1
039 Lajen,0,,22,21,43
039 Lajen,1,,23,7,30
039 Lajen,2,,21,21,42
039 Lajen,3,,24,15,39
039 Lajen,4,,17,16,33
039 Lajen,5,,17,16,33
039 Lajen,6,,14,22,36
039 Lajen,7,,16,12,28
039 Lajen,8,,8,12,20
039 Lajen,9,,11,16,27
039 Lajen,10,,13,14,27
039 Lajen,11,,14,10,24
039 Lajen,12,,19,18,37
039 Lajen,13,,8,8,16
039 Lajen,14,,17,15,32
039 Lajen,15,,12,10,22
039 Lajen,16,,13,6,19
039 Lajen,17,,18,13,31
039 Lajen,18,,19,11,30
039 Lajen,19,,11,14,25
039 Lajen,20,,9,19,28
039 Lajen,21,,17,16,33
039 Lajen,22,,9,22,31
039 Lajen,23,,20,21,41
039 Lajen,24,,20,16,36
039 Lajen,25,,23,20,43
039 Lajen,26,,21,12,33
039 Lajen,27,,20,15,35
039 Lajen,28,,20,25,45
039 Lajen,29,,30,19,49
039 Lajen,30,,21,22,43
039 Lajen,31,,19,25,44
039 Lajen,32,,18,26,44
039 Lajen,33,,23,27,50
039 Lajen,34,,32,18,50
039 Lajen,35,,24,21,45
039 Lajen,36,,25,22,47
039 Lajen,37,,23,17,40
039 Lajen,38,,31,18,49
039 Lajen,39,,21,18,39
039 Lajen,40,,15,13,28
039 Lajen,41,,26,15,41
039 Lajen,42,,13,19,32
039 Lajen,43,,12,9,21
039 Lajen,44,,17,25,42
039 Lajen,45,,22,11,33
039 Lajen,46,,13,11,24
039 Lajen,47,,12,14,26
039 Lajen,48,,14,12,26
039 Lajen,49,,5,13,18
039 Lajen,50,,9,8,17
039 Lajen,51,,8,11,19
039 Lajen,52,,9,12,21
039 Lajen,53,,13,13,26
039 Lajen,54,,6,13,19
039 Lajen,55,,9,15,24
039 Lajen,56,,15,8,23
039 Lajen,57,,13,13,26
039 Lajen,58,,12,9,21
039 Lajen,59,,14,8,22
039 Lajen,60,,11,12,23
039 Lajen,61,,18,14,32
039 Lajen,62,,17,17,34
039 Lajen,63,,15,10,25
039 Lajen,64,,15,10,25
039 Lajen,65,,6,16,22
039 Lajen,66,,7,9,16
039 Lajen,67,,7,9,16
039 Lajen,68,,6,9,15
039 Lajen,69,,8,6,14
039 Lajen,70,,5,12,17
039 Lajen,71,,10,3,13
039 Lajen,72,,1,8,9
039 Lajen,73,,8,4,12
039 Lajen,74,,5,5,10
039 Lajen,75,,8,7,15
039 Lajen,76,,7,11,18
039 Lajen,77,,10,6,16
039 Lajen,78,,4,8,12
039 Lajen,79,,3,8,11
039 Lajen,80,,2,9,11
039 Lajen,81,,4,5,9
039 Lajen,82,,4,5,9
039 Lajen,83,,2,3,5
039 Lajen,84,,1,2,3
039 Lajen,85,,-,2,2
039 Lajen,86,,1,2,3
039 Lajen,87,,-,1,1
039 Lajen,88,,1,2,3
039 Lajen,89,,-,3,3
039 Lajen,90,,2,2,4
039 Lajen,91,,1,2,3
039 Lajen,93,,-,1,1
039 Lajen,94,,-,2,2
039 Lajen,95,,-,1,1
039 Lajen,96,,-,2,2
039 Lajen,97,,1,1,2
040 Leifers,0,,94,69,163
040 Leifers,1,,92,87,179
040 Leifers,2,,82,78,160
040 Leifers,3,,94,91,185
040 Leifers,4,,90,89,179
040 Leifers,5,,81,102,183
040 Leifers,6,,107,80,187
040 Leifers,7,,102,82,184
040 Leifers,8,,92,91,183
040 Leifers,9,,87,92,179
040 Leifers,10,,80,70,150
040 Leifers,11,,85,75,160
040 Leifers,12,,84,80,164
040 Leifers,13,,94,80,174
040 Leifers,14,,68,77,145
040 Leifers,15,,70,81,151
040 Leifers,16,,65,69,134
040 Leifers,17,,79,81,160
040 Leifers,18,,79,66,145
040 Leifers,19,,70,69,139
040 Leifers,20,,75,92,167
040 Leifers,21,,65,69,134
040 Leifers,22,,69,65,134
040 Leifers,23,,67,76,143
040 Leifers,24,,82,87,169
040 Leifers,25,,94,83,177
040 Leifers,26,,101,94,195
040 Leifers,27,,127,106,233
040 Leifers,28,,121,125,246
040 Leifers,29,,156,126,282
040 Leifers,30,,142,130,272
040 Leifers,31,,132,135,267
040 Leifers,32,,127,135,262
040 Leifers,33,,142,136,278
040 Leifers,34,,148,135,283
040 Leifers,35,,148,158,306
040 Leifers,36,,144,132,276
040 Leifers,37,,151,127,278
040 Leifers,38,,157,135,292
040 Leifers,39,,169,157,326
040 Leifers,40,,151,139,290
040 Leifers,41,,141,128,269
040 Leifers,42,,129,136,265
040 Leifers,43,,140,117,257
040 Leifers,44,,118,105,223
040 Leifers,45,,90,106,196
040 Leifers,46,,104,112,216
040 Leifers,47,,139,135,274
040 Leifers,48,,106,122,228
040 Leifers,49,,94,107,201
040 Leifers,50,,107,117,224
040 Leifers,51,,103,95,198
040 Leifers,52,,104,93,197
040 Leifers,53,,99,89,188
040 Leifers,54,,96,97,193
040 Leifers,55,,113,103,216
040 Leifers,56,,103,99,202
040 Leifers,57,,119,150,269
040 Leifers,58,,85,83,168
040 Leifers,59,,97,92,189
040 Leifers,60,,91,94,185
040 Leifers,61,,96,97,193
040 Leifers,62,,92,82,174
040 Leifers,63,,95,94,189
040 Leifers,64,,97,91,188
040 Leifers,65,,92,76,168
040 Leifers,66,,59,80,139
040 Leifers,67,,59,66,125
040 Leifers,68,,56,66,122
040 Leifers,69,,59,63,122
040 Leifers,70,,53,63,116
040 Leifers,71,,66,76,142
040 Leifers,72,,55,60,115
040 Leifers,73,,56,64,120
040 Leifers,74,,44,55,99
040 Leifers,75,,40,41,81
040 Leifers,76,,30,56,86
040 Leifers,77,,34,51,85
040 Leifers,78,,25,46,71
040 Leifers,79,,24,44,68
040 Leifers,80,,25,38,63
040 Leifers,81,,22,40,62
040 Leifers,82,,18,27,45
040 Leifers,83,,14,24,38
040 Leifers,84,,8,37,45
040 Leifers,85,,2,15,17
040 Leifers,86,,2,13,15
040 Leifers,87,,5,14,19
040 Leifers,88,,2,16,18
040 Leifers,89,,2,17,19
040 Leifers,90,,10,10,20
040 Leifers,91,,2,14,16
040 Leifers,92,,3,6,9
040 Leifers,93,,1,10,11
040 Leifers,94,,3,3,6
040 Leifers,95,,2,2,4
040 Leifers,96,,2,1,3
040 Leifers,97,,-,1,1
040 Leifers,98,,-,2,2
040 Leifers,99,,-,1,1
040 Leifers,100,,-,1,1
041 Lana,0,,56,60,116
041 Lana,1,,59,45,104
041 Lana,2,,62,53,115
041 Lana,3,,70,71,141
041 Lana,4,,71,52,123
041 Lana,5,,59,61,120
041 Lana,6,,56,62,118
041 Lana,7,,70,74,144
041 Lana,8,,59,57,116
041 Lana,9,,63,71,134
041 Lana,10,,57,57,114
041 Lana,11,,61,55,116
041 Lana,12,,52,59,111
041 Lana,13,,50,61,111
041 Lana,14,,49,75,124
041 Lana,15,,59,46,105
041 Lana,16,,72,46,118
041 Lana,17,,56,50,106
041 Lana,18,,61,58,119
041 Lana,19,,59,49,108
041 Lana,20,,66,59,125
041 Lana,21,,67,55,122
041 Lana,22,,47,68,115
041 Lana,23,,50,51,101
041 Lana,24,,58,76,134
041 Lana,25,,73,58,131
041 Lana,26,,68,53,121
041 Lana,27,,61,73,134
041 Lana,28,,55,70,125
041 Lana,29,,72,67,139
041 Lana,30,,67,91,158
041 Lana,31,,105,96,201
041 Lana,32,,85,91,176
041 Lana,33,,86,105,191
041 Lana,34,,121,82,203
041 Lana,35,,90,87,177
041 Lana,36,,92,91,183
041 Lana,37,,94,102,196
041 Lana,38,,98,88,186
041 Lana,39,,97,96,193
041 Lana,40,,100,81,181
041 Lana,41,,85,77,162
041 Lana,42,,80,83,163
041 Lana,43,,80,78,158
041 Lana,44,,79,76,155
041 Lana,45,,80,84,164
041 Lana,46,,72,72,144
041 Lana,47,,58,62,120
041 Lana,48,,66,70,136
041 Lana,49,,61,63,124
041 Lana,50,,57,62,119
041 Lana,51,,51,58,109
041 Lana,52,,56,62,118
041 Lana,53,,53,52,105
041 Lana,54,,52,52,104
041 Lana,55,,55,66,121
041 Lana,56,,58,46,104
041 Lana,57,,62,60,122
041 Lana,58,,44,51,95
041 Lana,59,,49,56,105
041 Lana,60,,60,58,118
041 Lana,61,,55,66,121
041 Lana,62,,51,46,97
041 Lana,63,,41,46,87
041 Lana,64,,55,51,106
041 Lana,65,,44,55,99
041 Lana,66,,37,39,76
041 Lana,67,,43,51,94
041 Lana,68,,35,39,74
041 Lana,69,,37,47,84
041 Lana,70,,33,44,77
041 Lana,71,,30,35,65
041 Lana,72,,26,45,71
041 Lana,73,,28,38,66
041 Lana,74,,23,36,59
041 Lana,75,,35,28,63
041 Lana,76,,28,36,64
041 Lana,77,,20,39,59
041 Lana,78,,28,40,68
041 Lana,79,,10,24,34
041 Lana,80,,20,25,45
041 Lana,81,,21,36,57
041 Lana,82,,11,32,43
041 Lana,83,,15,32,47
041 Lana,84,,9,23,32
041 Lana,85,,3,11,14
041 Lana,86,,3,14,17
041 Lana,87,,3,6,9
041 Lana,88,,10,15,25
041 Lana,89,,6,13,19
041 Lana,90,,3,13,16
041 Lana,91,,4,10,14
041 Lana,92,,1,9,10
041 Lana,93,,1,10,11
041 Lana,94,,-,8,8
041 Lana,95,,-,3,3
041 Lana,96,,-,6,6
041 Lana,97,,-,2,2
041 Lana,98,,-,1,1
041 Lana,99,,-,2,2
041 Lana,100,,-,1,1
042 Laas,0,,16,18,34
042 Laas,1,,27,22,49
042 Laas,2,,14,18,32
042 Laas,3,,23,25,48
042 Laas,4,,20,10,30
042 Laas,5,,25,31,56
042 Laas,6,,27,26,53
042 Laas,7,,30,34,64
042 Laas,8,,30,24,54
042 Laas,9,,25,25,50
042 Laas,10,,22,20,42
042 Laas,11,,15,27,42
042 Laas,12,,22,21,43
042 Laas,13,,19,26,45
042 Laas,14,,21,24,45
042 Laas,15,,24,19,43
042 Laas,16,,30,22,52
042 Laas,17,,32,20,52
042 Laas,18,,29,28,57
042 Laas,19,,26,26,52
042 Laas,20,,23,38,61
042 Laas,21,,34,26,60
042 Laas,22,,26,27,53
042 Laas,23,,19,28,47
042 Laas,24,,28,31,59
042 Laas,25,,29,25,54
042 Laas,26,,28,17,45
042 Laas,27,,25,30,55
042 Laas,28,,29,24,53
042 Laas,29,,39,27,66
042 Laas,30,,33,31,64
042 Laas,31,,28,27,55
042 Laas,32,,28,26,54
042 Laas,33,,36,22,58
042 Laas,34,,34,38,72
042 Laas,35,,39,23,62
042 Laas,36,,33,24,57
042 Laas,37,,33,23,56
042 Laas,38,,40,34,74
042 Laas,39,,25,30,55
042 Laas,40,,28,29,57
042 Laas,41,,34,27,61
042 Laas,42,,27,28,55
042 Laas,43,,37,24,61
042 Laas,44,,34,27,61
042 Laas,45,,28,25,53
042 Laas,46,,20,28,48
042 Laas,47,,23,18,41
042 Laas,48,,15,14,29
042 Laas,49,,16,24,40
042 Laas,50,,24,12,36
042 Laas,51,,29,25,54
042 Laas,52,,14,17,31
042 Laas,53,,22,25,47
042 Laas,54,,19,19,38
042 Laas,55,,16,21,37
042 Laas,56,,28,12,40
042 Laas,57,,14,14,28
042 Laas,58,,14,12,26
042 Laas,59,,12,15,27
042 Laas,60,,14,15,29
042 Laas,61,,17,19,36
042 Laas,62,,16,20,36
042 Laas,63,,19,25,44
042 Laas,64,,14,23,37
042 Laas,65,,19,13,32
042 Laas,66,,15,14,29
042 Laas,67,,20,11,31
042 Laas,68,,18,23,41
042 Laas,69,,12,19,31
042 Laas,70,,18,12,30
042 Laas,71,,17,17,34
042 Laas,72,,20,22,42
042 Laas,73,,16,18,34
042 Laas,74,,16,11,27
042 Laas,75,,12,12,24
042 Laas,76,,14,18,32
042 Laas,77,,15,12,27
042 Laas,78,,8,11,19
042 Laas,79,,6,19,25
042 Laas,80,,12,10,22
042 Laas,81,,7,19,26
042 Laas,82,,4,6,10
042 Laas,83,,6,10,16
042 Laas,84,,3,8,11
042 Laas,85,,5,2,7
042 Laas,86,,2,2,4
042 Laas,87,,1,4,5
042 Laas,88,,-,1,1
042 Laas,89,,1,4,5
042 Laas,90,,1,6,7
042 Laas,91,,1,4,5
042 Laas,92,,-,3,3
042 Laas,93,,2,2,4
042 Laas,94,,-,2,2
042 Laas,96,,-,1,1
042 Laas,98,,-,1,1
043 Laurein,0,,3,3,6
043 Laurein,1,,2,3,5
043 Laurein,2,,7,-,7
043 Laurein,3,,3,7,10
043 Laurein,4,,3,2,5
043 Laurein,5,,4,3,7
043 Laurein,6,,3,6,9
043 Laurein,7,,1,2,3
043 Laurein,8,,2,2,4
043 Laurein,9,,3,4,7
043 Laurein,10,,1,5,6
043 Laurein,11,,1,1,2
043 Laurein,12,,1,1,2
043 Laurein,13,,4,-,4
043 Laurein,14,,3,2,5
043 Laurein,15,,1,-,1
043 Laurein,16,,2,2,4
043 Laurein,17,,4,2,6
043 Laurein,18,,2,2,4
043 Laurein,19,,1,2,3
043 Laurein,21,,2,2,4
043 Laurein,22,,3,1,4
043 Laurein,23,,2,-,2
043 Laurein,24,,2,-,2
043 Laurein,25,,3,5,8
043 Laurein,26,,1,3,4
043 Laurein,27,,5,1,6
043 Laurein,28,,-,6,6
043 Laurein,29,,1,3,4
043 Laurein,30,,5,1,6
043 Laurein,31,,1,2,3
043 Laurein,32,,5,6,11
043 Laurein,33,,4,2,6
043 Laurein,34,,5,4,9
043 Laurein,35,,-,3,3
043 Laurein,36,,4,7,11
043 Laurein,37,,6,3,9
043 Laurein,38,,5,1,6
043 Laurein,39,,4,2,6
043 Laurein,40,,-,2,2
043 Laurein,41,,1,2,3
043 Laurein,42,,5,5,10
043 Laurein,43,,1,1,2
043 Laurein,44,,3,4,7
043 Laurein,45,,4,2,6
043 Laurein,46,,7,-,7
043 Laurein,48,,2,-,2
043 Laurein,49,,3,1,4
043 Laurein,50,,2,1,3
043 Laurein,51,,2,2,4
043 Laurein,53,,2,1,3
043 Laurein,54,,3,2,5
043 Laurein,55,,2,-,2
043 Laurein,56,,2,3,5
043 Laurein,57,,-,1,1
043 Laurein,58,,-,1,1
043 Laurein,59,,-,1,1
043 Laurein,60,,1,-,1
043 Laurein,61,,2,-,2
043 Laurein,63,,3,2,5
043 Laurein,64,,1,3,4
043 Laurein,65,,1,1,2
043 Laurein,66,,2,1,3
043 Laurein,67,,1,2,3
043 Laurein,68,,1,3,4
043 Laurein,69,,1,5,6
043 Laurein,70,,1,2,3
043 Laurein,71,,2,2,4
043 Laurein,72,,1,3,4
043 Laurein,73,,1,5,6
043 Laurein,74,,3,-,3
043 Laurein,75,,4,1,5
043 Laurein,76,,5,1,6
043 Laurein,77,,2,2,4
043 Laurein,78,,2,2,4
043 Laurein,79,,-,1,1
043 Laurein,80,,1,-,1
043 Laurein,81,,-,3,3
043 Laurein,82,,1,-,1
043 Laurein,83,,2,2,4
043 Laurein,84,,-,1,1
043 Laurein,87,,1,-,1
043 Laurein,89,,-,2,2
043 Laurein,90,,-,1,1
043 Laurein,92,,-,1,1
043 Laurein,93,,1,-,1
044 Lüsen,0,,7,6,13
044 Lüsen,1,,11,9,20
044 Lüsen,2,,11,11,22
044 Lüsen,3,,16,9,25
044 Lüsen,4,,6,10,16
044 Lüsen,5,,10,10,20
044 Lüsen,6,,16,6,22
044 Lüsen,7,,8,13,21
044 Lüsen,8,,10,12,22
044 Lüsen,9,,14,14,28
044 Lüsen,10,,10,8,18
044 Lüsen,11,,12,11,23
044 Lüsen,12,,8,10,18
044 Lüsen,13,,7,12,19
044 Lüsen,14,,16,9,25
044 Lüsen,15,,9,9,18
044 Lüsen,16,,7,8,15
044 Lüsen,17,,12,12,24
044 Lüsen,18,,3,2,5
044 Lüsen,19,,9,18,27
044 Lüsen,20,,6,11,17
044 Lüsen,21,,15,11,26
044 Lüsen,22,,11,13,24
044 Lüsen,23,,15,11,26
044 Lüsen,24,,8,8,16
044 Lüsen,25,,15,19,34
044 Lüsen,26,,7,6,13
044 Lüsen,27,,15,9,24
044 Lüsen,28,,15,13,28
044 Lüsen,29,,15,14,29
044 Lüsen,30,,10,7,17
044 Lüsen,31,,9,8,17
044 Lüsen,32,,16,9,25
044 Lüsen,33,,16,16,32
044 Lüsen,34,,6,9,15
044 Lüsen,35,,12,16,28
044 Lüsen,36,,12,21,33
044 Lüsen,37,,12,14,26
044 Lüsen,38,,18,13,31
044 Lüsen,39,,13,10,23
044 Lüsen,40,,15,10,25
044 Lüsen,41,,8,13,21
044 Lüsen,42,,12,10,22
044 Lüsen,43,,9,12,21
044 Lüsen,44,,7,5,12
044 Lüsen,45,,11,12,23
044 Lüsen,46,,9,11,20
044 Lüsen,47,,9,10,19
044 Lüsen,48,,7,6,13
044 Lüsen,49,,14,4,18
044 Lüsen,50,,6,10,16
044 Lüsen,51,,11,4,15
044 Lüsen,52,,5,7,12
044 Lüsen,53,,6,7,13
044 Lüsen,54,,8,12,20
044 Lüsen,55,,7,2,9
044 Lüsen,56,,7,4,11
044 Lüsen,57,,10,6,16
044 Lüsen,58,,4,9,13
044 Lüsen,59,,4,6,10
044 Lüsen,60,,7,7,14
044 Lüsen,61,,2,6,8
044 Lüsen,62,,7,4,11
044 Lüsen,63,,5,9,14
044 Lüsen,64,,8,7,15
044 Lüsen,65,,8,4,12
044 Lüsen,66,,7,5,12
044 Lüsen,67,,6,9,15
044 Lüsen,68,,7,4,11
044 Lüsen,69,,3,5,8
044 Lüsen,70,,7,3,10
044 Lüsen,71,,2,11,13
044 Lüsen,72,,6,5,11
044 Lüsen,73,,3,5,8
044 Lüsen,74,,4,8,12
044 Lüsen,75,,7,6,13
044 Lüsen,76,,5,4,9
044 Lüsen,77,,2,7,9
044 Lüsen,78,,3,4,7
044 Lüsen,79,,2,3,5
044 Lüsen,80,,2,4,6
044 Lüsen,81,,1,2,3
044 Lüsen,82,,2,7,9
044 Lüsen,83,,2,5,7
044 Lüsen,84,,1,1,2
044 Lüsen,85,,-,3,3
044 Lüsen,86,,1,2,3
044 Lüsen,87,,-,2,2
044 Lüsen,88,,-,2,2
044 Lüsen,89,,2,1,3
044 Lüsen,90,,1,3,4
044 Lüsen,94,,1,-,1
045 Margreid a.d. Weinstr.,0,,5,6,11
045 Margreid a.d. Weinstr.,1,,12,9,21
045 Margreid a.d. Weinstr.,2,,12,8,20
045 Margreid a.d. Weinstr.,3,,9,7,16
045 Margreid a.d. Weinstr.,4,,8,8,16
045 Margreid a.d. Weinstr.,5,,3,12,15
045 Margreid a.d. Weinstr.,6,,9,13,22
045 Margreid a.d. Weinstr.,7,,4,4,8
045 Margreid a.d. Weinstr.,8,,1,7,8
045 Margreid a.d. Weinstr.,9,,5,7,12
045 Margreid a.d. Weinstr.,10,,3,12,15
045 Margreid a.d. Weinstr.,11,,5,2,7
045 Margreid a.d. Weinstr.,12,,6,6,12
045 Margreid a.d. Weinstr.,13,,6,10,16
045 Margreid a.d. Weinstr.,14,,7,5,12
045 Margreid a.d. Weinstr.,15,,8,6,14
045 Margreid a.d. Weinstr.,16,,9,4,13
045 Margreid a.d. Weinstr.,17,,6,11,17
045 Margreid a.d. Weinstr.,18,,11,-,11
045 Margreid a.d. Weinstr.,19,,4,12,16
045 Margreid a.d. Weinstr.,20,,6,8,14
045 Margreid a.d. Weinstr.,21,,8,9,17
045 Margreid a.d. Weinstr.,22,,14,2,16
045 Margreid a.d. Weinstr.,23,,2,3,5
045 Margreid a.d. Weinstr.,24,,10,6,16
045 Margreid a.d. Weinstr.,25,,9,4,13
045 Margreid a.d. Weinstr.,26,,10,11,21
045 Margreid a.d. Weinstr.,27,,11,15,26
045 Margreid a.d. Weinstr.,28,,6,7,13
045 Margreid a.d. Weinstr.,29,,5,8,13
045 Margreid a.d. Weinstr.,30,,9,11,20
045 Margreid a.d. Weinstr.,31,,12,4,16
045 Margreid a.d. Weinstr.,32,,12,12,24
045 Margreid a.d. Weinstr.,33,,11,11,22
045 Margreid a.d. Weinstr.,34,,7,10,17
045 Margreid a.d. Weinstr.,35,,23,15,38
045 Margreid a.d. Weinstr.,36,,11,16,27
045 Margreid a.d. Weinstr.,37,,22,15,37
045 Margreid a.d. Weinstr.,38,,10,6,16
045 Margreid a.d. Weinstr.,39,,8,5,13
045 Margreid a.d. Weinstr.,40,,15,15,30
045 Margreid a.d. Weinstr.,41,,9,13,22
045 Margreid a.d. Weinstr.,42,,15,12,27
045 Margreid a.d. Weinstr.,43,,15,9,24
045 Margreid a.d. Weinstr.,44,,9,12,21
045 Margreid a.d. Weinstr.,45,,6,6,12
045 Margreid a.d. Weinstr.,46,,8,5,13
045 Margreid a.d. Weinstr.,47,,15,5,20
045 Margreid a.d. Weinstr.,48,,7,7,14
045 Margreid a.d. Weinstr.,49,,4,5,9
045 Margreid a.d. Weinstr.,50,,9,7,16
045 Margreid a.d. Weinstr.,51,,6,8,14
045 Margreid a.d. Weinstr.,52,,3,8,11
045 Margreid a.d. Weinstr.,53,,6,6,12
045 Margreid a.d. Weinstr.,54,,8,4,12
045 Margreid a.d. Weinstr.,55,,7,8,15
045 Margreid a.d. Weinstr.,56,,6,7,13
045 Margreid a.d. Weinstr.,57,,3,4,7
045 Margreid a.d. Weinstr.,58,,6,7,13
045 Margreid a.d. Weinstr.,59,,3,6,9
045 Margreid a.d. Weinstr.,60,,6,4,10
045 Margreid a.d. Weinstr.,61,,11,4,15
045 Margreid a.d. Weinstr.,62,,7,7,14
045 Margreid a.d. Weinstr.,63,,5,3,8
045 Margreid a.d. Weinstr.,64,,3,6,9
045 Margreid a.d. Weinstr.,65,,4,8,12
045 Margreid a.d. Weinstr.,66,,4,3,7
045 Margreid a.d. Weinstr.,67,,7,4,11
045 Margreid a.d. Weinstr.,68,,2,7,9
045 Margreid a.d. Weinstr.,69,,6,3,9
045 Margreid a.d. Weinstr.,70,,5,4,9
045 Margreid a.d. Weinstr.,71,,4,7,11
045 Margreid a.d. Weinstr.,72,,4,6,10
045 Margreid a.d. Weinstr.,73,,6,3,9
045 Margreid a.d. Weinstr.,74,,1,4,5
045 Margreid a.d. Weinstr.,75,,6,3,9
045 Margreid a.d. Weinstr.,76,,2,5,7
045 Margreid a.d. Weinstr.,77,,3,8,11
045 Margreid a.d. Weinstr.,78,,3,2,5
045 Margreid a.d. Weinstr.,79,,1,4,5
045 Margreid a.d. Weinstr.,80,,1,4,5
045 Margreid a.d. Weinstr.,81,,1,3,4
045 Margreid a.d. Weinstr.,82,,-,4,4
045 Margreid a.d. Weinstr.,83,,-,1,1
045 Margreid a.d. Weinstr.,84,,1,5,6
045 Margreid a.d. Weinstr.,85,,1,1,2
045 Margreid a.d. Weinstr.,86,,-,1,1
045 Margreid a.d. Weinstr.,87,,2,2,4
045 Margreid a.d. Weinstr.,89,,-,1,1
045 Margreid a.d. Weinstr.,90,,2,-,2
045 Margreid a.d. Weinstr.,91,,-,1,1
045 Margreid a.d. Weinstr.,92,,-,3,3
045 Margreid a.d. Weinstr.,96,,-,1,1
045 Margreid a.d. Weinstr.,97,,-,1,1
046 Mals,0,,33,21,54
046 Mals,1,,19,26,45
046 Mals,2,,32,29,61
046 Mals,3,,31,36,67
046 Mals,4,,39,28,67
046 Mals,5,,35,32,67
046 Mals,6,,35,32,67
046 Mals,7,,32,25,57
046 Mals,8,,34,41,75
046 Mals,9,,37,31,68
046 Mals,10,,35,31,66
046 Mals,11,,31,30,61
046 Mals,12,,35,32,67
046 Mals,13,,36,27,63
046 Mals,14,,41,34,75
046 Mals,15,,30,25,55
046 Mals,16,,30,30,60
046 Mals,17,,28,36,64
046 Mals,18,,36,36,72
046 Mals,19,,35,34,69
046 Mals,20,,32,31,63
046 Mals,21,,36,31,67
046 Mals,22,,36,40,76
046 Mals,23,,33,33,66
046 Mals,24,,29,30,59
046 Mals,25,,45,35,80
046 Mals,26,,32,26,58
046 Mals,27,,36,25,61
046 Mals,28,,40,32,72
046 Mals,29,,45,29,74
046 Mals,30,,29,34,63
046 Mals,31,,32,42,74
046 Mals,32,,39,51,90
046 Mals,33,,49,48,97
046 Mals,34,,53,43,96
046 Mals,35,,54,42,96
046 Mals,36,,47,28,75
046 Mals,37,,50,51,101
046 Mals,38,,49,38,87
046 Mals,39,,52,43,95
046 Mals,40,,51,53,104
046 Mals,41,,39,25,64
046 Mals,42,,49,38,87
046 Mals,43,,30,40,70
046 Mals,44,,32,33,65
046 Mals,45,,36,24,60
046 Mals,46,,38,33,71
046 Mals,47,,34,27,61
046 Mals,48,,31,24,55
046 Mals,49,,22,20,42
046 Mals,50,,34,31,65
046 Mals,51,,28,20,48
046 Mals,52,,30,22,52
046 Mals,53,,34,21,55
046 Mals,54,,19,27,46
046 Mals,55,,28,17,45
046 Mals,56,,22,20,42
046 Mals,57,,22,29,51
046 Mals,58,,11,19,30
046 Mals,59,,30,14,44
046 Mals,60,,24,19,43
046 Mals,61,,25,23,48
046 Mals,62,,20,18,38
046 Mals,63,,22,28,50
046 Mals,64,,23,26,49
046 Mals,65,,21,21,42
046 Mals,66,,13,29,42
046 Mals,67,,21,18,39
046 Mals,68,,16,18,34
046 Mals,69,,16,20,36
046 Mals,70,,18,21,39
046 Mals,71,,17,11,28
046 Mals,72,,12,18,30
046 Mals,73,,23,18,41
046 Mals,74,,22,17,39
046 Mals,75,,23,14,37
046 Mals,76,,13,15,28
046 Mals,77,,10,20,30
046 Mals,78,,10,17,27
046 Mals,79,,7,16,23
046 Mals,80,,4,13,17
046 Mals,81,,13,16,29
046 Mals,82,,9,15,24
046 Mals,83,,5,17,22
046 Mals,84,,4,18,22
046 Mals,85,,1,7,8
046 Mals,86,,3,2,5
046 Mals,87,,1,4,5
046 Mals,88,,3,4,7
046 Mals,89,,2,5,7
046 Mals,90,,8,12,20
046 Mals,91,,2,4,6
046 Mals,92,,-,2,2
046 Mals,93,,2,2,4
046 Mals,94,,2,1,3
046 Mals,95,,-,1,1
046 Mals,99,,-,1,1
047 Enneberg,0,,23,24,47
047 Enneberg,1,,17,13,30
047 Enneberg,2,,23,16,39
047 Enneberg,3,,16,21,37
047 Enneberg,4,,25,15,40
047 Enneberg,5,,19,9,28
047 Enneberg,6,,23,15,38
047 Enneberg,7,,17,13,30
047 Enneberg,8,,20,8,28
047 Enneberg,9,,21,14,35
047 Enneberg,10,,20,17,37
047 Enneberg,11,,14,14,28
047 Enneberg,12,,17,21,38
047 Enneberg,13,,14,17,31
047 Enneberg,14,,19,18,37
047 Enneberg,15,,21,16,37
047 Enneberg,16,,17,13,30
047 Enneberg,17,,19,10,29
047 Enneberg,18,,23,15,38
047 Enneberg,19,,19,20,39
047 Enneberg,20,,14,17,31
047 Enneberg,21,,25,20,45
047 Enneberg,22,,22,20,42
047 Enneberg,23,,24,17,41
047 Enneberg,24,,12,18,30
047 Enneberg,25,,13,23,36
047 Enneberg,26,,21,21,42
047 Enneberg,27,,12,17,29
047 Enneberg,28,,13,30,43
047 Enneberg,29,,24,31,55
047 Enneberg,30,,22,22,44
047 Enneberg,31,,23,27,50
047 Enneberg,32,,29,34,63
047 Enneberg,33,,27,20,47
047 Enneberg,34,,27,19,46
047 Enneberg,35,,23,19,42
047 Enneberg,36,,25,21,46
047 Enneberg,37,,21,18,39
047 Enneberg,38,,28,21,49
047 Enneberg,39,,23,21,44
047 Enneberg,40,,22,18,40
047 Enneberg,41,,16,15,31
047 Enneberg,42,,20,16,36
047 Enneberg,43,,15,18,33
047 Enneberg,44,,22,14,36
047 Enneberg,45,,22,8,30
047 Enneberg,46,,16,14,30
047 Enneberg,47,,16,17,33
047 Enneberg,48,,15,13,28
047 Enneberg,49,,14,12,26
047 Enneberg,50,,17,20,37
047 Enneberg,51,,14,16,30
047 Enneberg,52,,17,10,27
047 Enneberg,53,,10,15,25
047 Enneberg,54,,18,8,26
047 Enneberg,55,,16,13,29
047 Enneberg,56,,7,11,18
047 Enneberg,57,,14,17,31
047 Enneberg,58,,5,14,19
047 Enneberg,59,,20,16,36
047 Enneberg,60,,17,11,28
047 Enneberg,61,,12,20,32
047 Enneberg,62,,14,11,25
047 Enneberg,63,,12,7,19
047 Enneberg,64,,18,10,28
047 Enneberg,65,,14,18,32
047 Enneberg,66,,14,13,27
047 Enneberg,67,,12,12,24
047 Enneberg,68,,13,16,29
047 Enneberg,69,,9,11,20
047 Enneberg,70,,12,9,21
047 Enneberg,71,,8,17,25
047 Enneberg,72,,13,11,24
047 Enneberg,73,,13,14,27
047 Enneberg,74,,9,7,16
047 Enneberg,75,,11,12,23
047 Enneberg,76,,12,7,19
047 Enneberg,77,,6,9,15
047 Enneberg,78,,12,8,20
047 Enneberg,79,,4,8,12
047 Enneberg,80,,5,13,18
047 Enneberg,81,,7,7,14
047 Enneberg,82,,2,8,10
047 Enneberg,83,,6,5,11
047 Enneberg,84,,2,4,6
047 Enneberg,85,,4,3,7
047 Enneberg,86,,-,5,5
047 Enneberg,87,,1,7,8
047 Enneberg,88,,-,4,4
047 Enneberg,89,,2,5,7
047 Enneberg,90,,1,1,2
047 Enneberg,91,,-,4,4
047 Enneberg,92,,2,1,3
047 Enneberg,93,,1,1,2
047 Enneberg,94,,1,-,1
047 Enneberg,95,,-,1,1
047 Enneberg,96,,1,1,2
047 Enneberg,98,,-,1,1
048 Marling,0,,9,12,21
048 Marling,1,,15,14,29
048 Marling,2,,9,15,24
048 Marling,3,,15,15,30
048 Marling,4,,13,7,20
048 Marling,5,,9,10,19
048 Marling,6,,12,10,22
048 Marling,7,,13,12,25
048 Marling,8,,17,11,28
048 Marling,9,,9,7,16
048 Marling,10,,16,8,24
048 Marling,11,,17,14,31
048 Marling,12,,12,11,23
048 Marling,13,,9,14,23
048 Marling,14,,9,16,25
048 Marling,15,,10,14,24
048 Marling,16,,6,9,15
048 Marling,17,,12,9,21
048 Marling,18,,7,16,23
048 Marling,19,,11,6,17
048 Marling,20,,11,12,23
048 Marling,21,,12,8,20
048 Marling,22,,14,10,24
048 Marling,23,,13,9,22
048 Marling,24,,13,17,30
048 Marling,25,,17,16,33
048 Marling,26,,10,22,32
048 Marling,27,,16,21,37
048 Marling,28,,14,10,24
048 Marling,29,,10,9,19
048 Marling,30,,13,19,32
048 Marling,31,,16,19,35
048 Marling,32,,25,14,39
048 Marling,33,,12,17,29
048 Marling,34,,22,20,42
048 Marling,35,,28,20,48
048 Marling,36,,19,14,33
048 Marling,37,,25,27,52
048 Marling,38,,26,20,46
048 Marling,39,,24,16,40
048 Marling,40,,28,30,58
048 Marling,41,,21,18,39
048 Marling,42,,25,12,37
048 Marling,43,,17,22,39
048 Marling,44,,15,15,30
048 Marling,45,,16,11,27
048 Marling,46,,11,9,20
048 Marling,47,,9,11,20
048 Marling,48,,10,8,18
048 Marling,49,,18,11,29
048 Marling,50,,11,17,28
048 Marling,51,,13,13,26
048 Marling,52,,6,12,18
048 Marling,53,,18,14,32
048 Marling,54,,18,18,36
048 Marling,55,,6,15,21
048 Marling,56,,17,13,30
048 Marling,57,,12,16,28
048 Marling,58,,20,15,35
048 Marling,59,,15,15,30
048 Marling,60,,11,18,29
048 Marling,61,,11,13,24
048 Marling,62,,21,18,39
048 Marling,63,,12,12,24
048 Marling,64,,16,16,32
048 Marling,65,,13,12,25
048 Marling,66,,11,16,27
048 Marling,67,,14,8,22
048 Marling,68,,7,16,23
048 Marling,69,,10,9,19
048 Marling,70,,9,13,22
048 Marling,71,,11,10,21
048 Marling,72,,10,9,19
048 Marling,73,,4,10,14
048 Marling,74,,7,7,14
048 Marling,75,,9,4,13
048 Marling,76,,10,9,19
048 Marling,77,,5,12,17
048 Marling,78,,3,14,17
048 Marling,79,,2,7,9
048 Marling,80,,6,5,11
048 Marling,81,,3,5,8
048 Marling,82,,4,7,11
048 Marling,83,,-,3,3
048 Marling,84,,4,4,8
048 Marling,85,,1,3,4
048 Marling,86,,1,-,1
048 Marling,87,,1,3,4
048 Marling,88,,2,4,6
048 Marling,89,,2,3,5
048 Marling,90,,2,2,4
048 Marling,91,,2,3,5
048 Marling,93,,-,1,1
048 Marling,94,,2,-,2
048 Marling,96,,1,2,3
048 Marling,98,,-,1,1
049 Martell,0,,5,6,11
049 Martell,1,,4,5,9
049 Martell,2,,5,8,13
049 Martell,3,,6,4,10
049 Martell,4,,2,7,9
049 Martell,5,,6,6,12
049 Martell,6,,5,8,13
049 Martell,7,,4,6,10
049 Martell,8,,7,7,14
049 Martell,9,,6,8,14
049 Martell,10,,7,6,13
049 Martell,11,,5,5,10
049 Martell,12,,8,5,13
049 Martell,13,,6,5,11
049 Martell,14,,9,4,13
049 Martell,15,,4,1,5
049 Martell,16,,8,3,11
049 Martell,17,,-,4,4
049 Martell,18,,6,6,12
049 Martell,19,,6,4,10
049 Martell,20,,8,3,11
049 Martell,21,,5,6,11
049 Martell,22,,7,4,11
049 Martell,23,,9,5,14
049 Martell,24,,9,8,17
049 Martell,25,,4,5,9
049 Martell,26,,5,3,8
049 Martell,27,,5,7,12
049 Martell,28,,1,6,7
049 Martell,29,,6,10,16
049 Martell,30,,9,5,14
049 Martell,31,,4,8,12
049 Martell,32,,11,4,15
049 Martell,33,,8,4,12
049 Martell,34,,6,13,19
049 Martell,35,,8,6,14
049 Martell,36,,5,7,12
049 Martell,37,,16,6,22
049 Martell,38,,18,9,27
049 Martell,39,,10,9,19
049 Martell,40,,13,2,15
049 Martell,41,,9,8,17
049 Martell,42,,7,5,12
049 Martell,43,,9,3,12
049 Martell,44,,7,6,13
049 Martell,45,,8,6,14
049 Martell,46,,7,3,10
049 Martell,47,,5,4,9
049 Martell,48,,7,2,9
049 Martell,49,,7,6,13
049 Martell,50,,5,4,9
049 Martell,51,,4,3,7
049 Martell,52,,6,8,14
049 Martell,53,,3,4,7
049 Martell,54,,4,2,6
049 Martell,55,,6,4,10
049 Martell,56,,5,3,8
049 Martell,57,,3,-,3
049 Martell,58,,4,1,5
049 Martell,59,,1,3,4
049 Martell,60,,2,4,6
049 Martell,61,,6,5,11
049 Martell,62,,3,4,7
049 Martell,63,,6,2,8
049 Martell,64,,2,4,6
049 Martell,65,,2,6,8
049 Martell,66,,3,4,7
049 Martell,67,,3,4,7
049 Martell,68,,4,9,13
049 Martell,69,,7,1,8
049 Martell,70,,5,6,11
049 Martell,71,,2,4,6
049 Martell,72,,5,1,6
049 Martell,73,,7,4,11
049 Martell,74,,4,3,7
049 Martell,75,,3,6,9
049 Martell,76,,2,3,5
049 Martell,77,,2,8,10
049 Martell,78,,2,3,5
049 Martell,79,,4,6,10
049 Martell,80,,1,7,8
049 Martell,81,,1,1,2
049 Martell,82,,1,1,2
049 Martell,83,,-,1,1
049 Martell,84,,1,1,2
049 Martell,85,,1,1,2
049 Martell,86,,1,-,1
049 Martell,88,,2,1,3
049 Martell,89,,-,1,1
049 Martell,90,,1,-,1
049 Martell,91,,1,-,1
049 Martell,92,,3,1,4
049 Martell,94,,-,1,1
049 Martell,96,,-,1,1
050 Mölten,0,,10,7,17
050 Mölten,1,,12,13,25
050 Mölten,2,,15,14,29
050 Mölten,3,,14,13,27
050 Mölten,4,,10,18,28
050 Mölten,5,,8,16,24
050 Mölten,6,,10,9,19
050 Mölten,7,,16,11,27
050 Mölten,8,,12,10,22
050 Mölten,9,,13,4,17
050 Mölten,10,,12,11,23
050 Mölten,11,,7,13,20
050 Mölten,12,,10,6,16
050 Mölten,13,,12,6,18
050 Mölten,14,,13,5,18
050 Mölten,15,,7,9,16
050 Mölten,16,,9,8,17
050 Mölten,17,,10,6,16
050 Mölten,18,,7,13,20
050 Mölten,19,,7,4,11
050 Mölten,20,,7,15,22
050 Mölten,21,,9,6,15
050 Mölten,22,,13,7,20
050 Mölten,23,,13,10,23
050 Mölten,24,,13,10,23
050 Mölten,25,,11,6,17
050 Mölten,26,,7,7,14
050 Mölten,27,,9,15,24
050 Mölten,28,,18,9,27
050 Mölten,29,,13,12,25
050 Mölten,30,,14,15,29
050 Mölten,31,,12,10,22
050 Mölten,32,,18,10,28
050 Mölten,33,,17,13,30
050 Mölten,34,,15,16,31
050 Mölten,35,,16,17,33
050 Mölten,36,,18,14,32
050 Mölten,37,,14,14,28
050 Mölten,38,,10,15,25
050 Mölten,39,,21,12,33
050 Mölten,40,,18,6,24
050 Mölten,41,,11,9,20
050 Mölten,42,,18,9,27
050 Mölten,43,,6,8,14
050 Mölten,44,,13,4,17
050 Mölten,45,,2,10,12
050 Mölten,46,,7,3,10
050 Mölten,47,,4,7,11
050 Mölten,48,,12,9,21
050 Mölten,49,,7,6,13
050 Mölten,50,,6,7,13
050 Mölten,51,,7,5,12
050 Mölten,52,,5,5,10
050 Mölten,53,,9,9,18
050 Mölten,54,,6,5,11
050 Mölten,55,,5,4,9
050 Mölten,56,,4,8,12
050 Mölten,57,,9,3,12
050 Mölten,58,,5,5,10
050 Mölten,59,,2,7,9
050 Mölten,60,,12,8,20
050 Mölten,61,,6,11,17
050 Mölten,62,,9,3,12
050 Mölten,63,,6,7,13
050 Mölten,64,,6,7,13
050 Mölten,65,,2,3,5
050 Mölten,66,,5,6,11
050 Mölten,67,,5,6,11
050 Mölten,68,,10,6,16
050 Mölten,69,,9,5,14
050 Mölten,70,,10,9,19
050 Mölten,71,,3,5,8
050 Mölten,72,,8,3,11
050 Mölten,73,,7,5,12
050 Mölten,74,,3,7,10
050 Mölten,75,,1,6,7
050 Mölten,76,,3,4,7
050 Mölten,77,,3,5,8
050 Mölten,78,,2,4,6
050 Mölten,79,,1,2,3
050 Mölten,80,,6,6,12
050 Mölten,81,,3,1,4
050 Mölten,82,,1,4,5
050 Mölten,83,,1,7,8
050 Mölten,84,,1,5,6
050 Mölten,85,,1,1,2
050 Mölten,86,,-,1,1
050 Mölten,87,,2,2,4
050 Mölten,88,,-,1,1
050 Mölten,89,,-,6,6
050 Mölten,90,,3,-,3
050 Mölten,92,,-,2,2
050 Mölten,93,,-,1,1
050 Mölten,94,,-,1,1
050 Mölten,95,,-,1,1
050 Mölten,97,,-,1,1
051 Meran,0,,171,158,329
051 Meran,1,,171,147,318
051 Meran,2,,167,164,331
051 Meran,3,,170,146,316
051 Meran,4,,165,174,339
051 Meran,5,,148,136,284
051 Meran,6,,179,153,332
051 Meran,7,,186,150,336
051 Meran,8,,161,139,300
051 Meran,9,,155,170,325
051 Meran,10,,128,143,271
051 Meran,11,,170,135,305
051 Meran,12,,154,169,323
051 Meran,13,,154,152,306
051 Meran,14,,171,152,323
051 Meran,15,,158,124,282
051 Meran,16,,156,148,304
051 Meran,17,,153,112,265
051 Meran,18,,136,183,319
051 Meran,19,,164,144,308
051 Meran,20,,146,149,295
051 Meran,21,,150,159,309
051 Meran,22,,169,160,329
051 Meran,23,,165,148,313
051 Meran,24,,151,170,321
051 Meran,25,,176,172,348
051 Meran,26,,182,218,400
051 Meran,27,,195,221,416
051 Meran,28,,236,238,474
051 Meran,29,,257,269,526
051 Meran,30,,246,260,506
051 Meran,31,,261,266,527
051 Meran,32,,290,256,546
051 Meran,33,,278,286,564
051 Meran,34,,310,293,603
051 Meran,35,,309,320,629
051 Meran,36,,325,320,645
051 Meran,37,,308,279,587
051 Meran,38,,328,311,639
051 Meran,39,,342,296,638
051 Meran,40,,333,266,599
051 Meran,41,,259,278,537
051 Meran,42,,297,296,593
051 Meran,43,,285,261,546
051 Meran,44,,269,242,511
051 Meran,45,,245,233,478
051 Meran,46,,229,242,471
051 Meran,47,,227,218,445
051 Meran,48,,196,218,414
051 Meran,49,,179,224,403
051 Meran,50,,184,222,406
051 Meran,51,,207,219,426
051 Meran,52,,207,204,411
051 Meran,53,,199,222,421
051 Meran,54,,224,244,468
051 Meran,55,,220,253,473
051 Meran,56,,214,282,496
051 Meran,57,,238,296,534
051 Meran,58,,212,214,426
051 Meran,59,,208,234,442
051 Meran,60,,257,239,496
051 Meran,61,,262,298,560
051 Meran,62,,231,284,515
051 Meran,63,,197,224,421
051 Meran,64,,205,249,454
051 Meran,65,,187,227,414
051 Meran,66,,191,222,413
051 Meran,67,,173,206,379
051 Meran,68,,168,202,370
051 Meran,69,,164,185,349
051 Meran,70,,150,175,325
051 Meran,71,,136,200,336
051 Meran,72,,124,180,304
051 Meran,73,,134,190,324
051 Meran,74,,112,148,260
051 Meran,75,,117,188,305
051 Meran,76,,105,158,263
051 Meran,77,,103,175,278
051 Meran,78,,79,169,248
051 Meran,79,,93,161,254
051 Meran,80,,69,157,226
051 Meran,81,,81,178,259
051 Meran,82,,50,171,221
051 Meran,83,,59,150,209
051 Meran,84,,49,106,155
051 Meran,85,,31,77,108
051 Meran,86,,29,71,100
051 Meran,87,,21,51,72
051 Meran,88,,30,75,105
051 Meran,89,,29,80,109
051 Meran,90,,24,64,88
051 Meran,91,,19,60,79
051 Meran,92,,14,46,60
051 Meran,93,,8,39,47
051 Meran,94,,10,33,43
051 Meran,95,,9,17,26
051 Meran,96,,2,13,15
051 Meran,97,,3,14,17
051 Meran,98,,1,7,8
051 Meran,99,,-,7,7
051 Meran,100,,-,3,3
051 Meran,101,,-,2,2
051 Meran,102,,-,1,1
051 Meran,103,,-,1,1
052 Welsberg-Taisten,0,,15,13,28
052 Welsberg-Taisten,1,,23,19,42
052 Welsberg-Taisten,2,,30,17,47
052 Welsberg-Taisten,3,,16,17,33
052 Welsberg-Taisten,4,,23,19,42
052 Welsberg-Taisten,5,,19,13,32
052 Welsberg-Taisten,6,,24,19,43
052 Welsberg-Taisten,7,,17,19,36
052 Welsberg-Taisten,8,,18,14,32
052 Welsberg-Taisten,9,,12,15,27
052 Welsberg-Taisten,10,,15,20,35
052 Welsberg-Taisten,11,,11,10,21
052 Welsberg-Taisten,12,,20,17,37
052 Welsberg-Taisten,13,,11,19,30
052 Welsberg-Taisten,14,,4,19,23
052 Welsberg-Taisten,15,,12,17,29
052 Welsberg-Taisten,16,,14,15,29
052 Welsberg-Taisten,17,,10,13,23
052 Welsberg-Taisten,18,,9,13,22
052 Welsberg-Taisten,19,,25,14,39
052 Welsberg-Taisten,20,,19,16,35
052 Welsberg-Taisten,21,,20,13,33
052 Welsberg-Taisten,22,,9,10,19
052 Welsberg-Taisten,23,,14,16,30
052 Welsberg-Taisten,24,,23,17,40
052 Welsberg-Taisten,25,,21,17,38
052 Welsberg-Taisten,26,,14,20,34
052 Welsberg-Taisten,27,,15,16,31
052 Welsberg-Taisten,28,,11,24,35
052 Welsberg-Taisten,29,,26,20,46
052 Welsberg-Taisten,30,,28,9,37
052 Welsberg-Taisten,31,,16,26,42
052 Welsberg-Taisten,32,,32,24,56
052 Welsberg-Taisten,33,,25,21,46
052 Welsberg-Taisten,34,,19,22,41
052 Welsberg-Taisten,35,,23,16,39
052 Welsberg-Taisten,36,,31,20,51
052 Welsberg-Taisten,37,,27,23,50
052 Welsberg-Taisten,38,,23,18,41
052 Welsberg-Taisten,39,,35,22,57
052 Welsberg-Taisten,40,,24,22,46
052 Welsberg-Taisten,41,,20,23,43
052 Welsberg-Taisten,42,,19,18,37
052 Welsberg-Taisten,43,,12,13,25
052 Welsberg-Taisten,44,,22,21,43
052 Welsberg-Taisten,45,,27,19,46
052 Welsberg-Taisten,46,,11,19,30
052 Welsberg-Taisten,47,,19,19,38
052 Welsberg-Taisten,48,,17,12,29
052 Welsberg-Taisten,49,,15,14,29
052 Welsberg-Taisten,50,,19,12,31
052 Welsberg-Taisten,51,,19,11,30
052 Welsberg-Taisten,52,,17,9,26
052 Welsberg-Taisten,53,,15,13,28
052 Welsberg-Taisten,54,,14,12,26
052 Welsberg-Taisten,55,,16,16,32
052 Welsberg-Taisten,56,,10,9,19
052 Welsberg-Taisten,57,,12,13,25
052 Welsberg-Taisten,58,,10,14,24
052 Welsberg-Taisten,59,,13,10,23
052 Welsberg-Taisten,60,,12,15,27
052 Welsberg-Taisten,61,,10,12,22
052 Welsberg-Taisten,62,,19,19,38
052 Welsberg-Taisten,63,,6,13,19
052 Welsberg-Taisten,64,,13,14,27
052 Welsberg-Taisten,65,,14,11,25
052 Welsberg-Taisten,66,,11,8,19
052 Welsberg-Taisten,67,,10,11,21
052 Welsberg-Taisten,68,,4,16,20
052 Welsberg-Taisten,69,,16,15,31
052 Welsberg-Taisten,70,,10,11,21
052 Welsberg-Taisten,71,,11,13,24
052 Welsberg-Taisten,72,,7,12,19
052 Welsberg-Taisten,73,,10,7,17
052 Welsberg-Taisten,74,,9,12,21
052 Welsberg-Taisten,75,,5,19,24
052 Welsberg-Taisten,76,,10,11,21
052 Welsberg-Taisten,77,,7,7,14
052 Welsberg-Taisten,78,,-,8,8
052 Welsberg-Taisten,79,,6,9,15
052 Welsberg-Taisten,80,,5,11,16
052 Welsberg-Taisten,81,,4,7,11
052 Welsberg-Taisten,82,,3,9,12
052 Welsberg-Taisten,83,,3,7,10
052 Welsberg-Taisten,84,,1,7,8
052 Welsberg-Taisten,85,,2,1,3
052 Welsberg-Taisten,86,,1,3,4
052 Welsberg-Taisten,87,,2,-,2
052 Welsberg-Taisten,88,,3,4,7
052 Welsberg-Taisten,89,,1,2,3
052 Welsberg-Taisten,90,,-,4,4
052 Welsberg-Taisten,91,,1,4,5
052 Welsberg-Taisten,92,,-,3,3
052 Welsberg-Taisten,93,,1,2,3
052 Welsberg-Taisten,94,,-,2,2
052 Welsberg-Taisten,95,,-,2,2
052 Welsberg-Taisten,96,,1,2,3
052 Welsberg-Taisten,99,,-,1,1
052 Welsberg-Taisten,103,,1,-,1
052 Welsberg-Taisten,115,,-,1,1
053 Montan,0,,10,5,15
053 Montan,1,,7,6,13
053 Montan,2,,10,7,17
053 Montan,3,,9,6,15
053 Montan,4,,7,10,17
053 Montan,5,,9,11,20
053 Montan,6,,7,7,14
053 Montan,7,,13,10,23
053 Montan,8,,16,15,31
053 Montan,9,,13,5,18
053 Montan,10,,5,7,12
053 Montan,11,,8,10,18
053 Montan,12,,14,9,23
053 Montan,13,,11,8,19
053 Montan,14,,10,11,21
053 Montan,15,,12,14,26
053 Montan,16,,10,17,27
053 Montan,17,,14,5,19
053 Montan,18,,11,9,20
053 Montan,19,,7,3,10
053 Montan,20,,11,6,17
053 Montan,21,,10,8,18
053 Montan,22,,11,10,21
053 Montan,23,,6,5,11
053 Montan,24,,9,6,15
053 Montan,25,,12,7,19
053 Montan,26,,9,5,14
053 Montan,27,,9,6,15
053 Montan,28,,9,14,23
053 Montan,29,,10,12,22
053 Montan,30,,14,3,17
053 Montan,31,,11,7,18
053 Montan,32,,13,9,22
053 Montan,33,,16,11,27
053 Montan,34,,16,18,34
053 Montan,35,,14,19,33
053 Montan,36,,13,11,24
053 Montan,37,,12,14,26
053 Montan,38,,29,13,42
053 Montan,39,,19,11,30
053 Montan,40,,12,18,30
053 Montan,41,,16,16,32
053 Montan,42,,19,11,30
053 Montan,43,,15,13,28
053 Montan,44,,14,11,25
053 Montan,45,,15,11,26
053 Montan,46,,16,11,27
053 Montan,47,,7,14,21
053 Montan,48,,7,11,18
053 Montan,49,,13,11,24
053 Montan,50,,12,8,20
053 Montan,51,,12,3,15
053 Montan,52,,7,6,13
053 Montan,53,,4,4,8
053 Montan,54,,9,3,12
053 Montan,55,,5,6,11
053 Montan,56,,6,10,16
053 Montan,57,,5,2,7
053 Montan,58,,3,3,6
053 Montan,59,,2,5,7
053 Montan,60,,5,7,12
053 Montan,61,,7,6,13
053 Montan,62,,7,5,12
053 Montan,63,,9,7,16
053 Montan,64,,5,10,15
053 Montan,65,,9,9,18
053 Montan,66,,2,7,9
053 Montan,67,,7,10,17
053 Montan,68,,1,9,10
053 Montan,69,,3,6,9
053 Montan,70,,15,5,20
053 Montan,71,,5,8,13
053 Montan,72,,7,11,18
053 Montan,73,,10,13,23
053 Montan,74,,7,9,16
053 Montan,75,,7,3,10
053 Montan,76,,5,5,10
053 Montan,77,,6,9,15
053 Montan,78,,3,9,12
053 Montan,79,,2,7,9
053 Montan,80,,5,11,16
053 Montan,81,,4,7,11
053 Montan,82,,1,3,4
053 Montan,83,,1,8,9
053 Montan,84,,2,4,6
053 Montan,85,,-,4,4
053 Montan,86,,2,4,6
053 Montan,87,,-,2,2
053 Montan,88,,-,5,5
053 Montan,89,,1,2,3
053 Montan,90,,1,5,6
053 Montan,91,,1,-,1
053 Montan,92,,1,2,3
053 Montan,93,,1,-,1
053 Montan,94,,-,1,1
053 Montan,95,,-,2,2
053 Montan,102,,-,1,1
054 Moos in Passeier,0,,13,10,23
054 Moos in Passeier,1,,19,17,36
054 Moos in Passeier,2,,15,12,27
054 Moos in Passeier,3,,14,19,33
054 Moos in Passeier,4,,27,10,37
054 Moos in Passeier,5,,13,16,29
054 Moos in Passeier,6,,12,17,29
054 Moos in Passeier,7,,18,20,38
054 Moos in Passeier,8,,9,14,23
054 Moos in Passeier,9,,17,21,38
054 Moos in Passeier,10,,20,12,32
054 Moos in Passeier,11,,18,18,36
054 Moos in Passeier,12,,18,21,39
054 Moos in Passeier,13,,15,13,28
054 Moos in Passeier,14,,17,19,36
054 Moos in Passeier,15,,16,16,32
054 Moos in Passeier,16,,15,14,29
054 Moos in Passeier,17,,17,15,32
054 Moos in Passeier,18,,19,11,30
054 Moos in Passeier,19,,23,21,44
054 Moos in Passeier,20,,15,13,28
054 Moos in Passeier,21,,17,21,38
054 Moos in Passeier,22,,18,20,38
054 Moos in Passeier,23,,19,18,37
054 Moos in Passeier,24,,20,17,37
054 Moos in Passeier,25,,25,12,37
054 Moos in Passeier,26,,20,19,39
054 Moos in Passeier,27,,15,10,25
054 Moos in Passeier,28,,20,20,40
054 Moos in Passeier,29,,26,14,40
054 Moos in Passeier,30,,9,23,32
054 Moos in Passeier,31,,21,16,37
054 Moos in Passeier,32,,19,18,37
054 Moos in Passeier,33,,22,11,33
054 Moos in Passeier,34,,17,21,38
054 Moos in Passeier,35,,20,21,41
054 Moos in Passeier,36,,23,19,42
054 Moos in Passeier,37,,27,20,47
054 Moos in Passeier,38,,22,8,30
054 Moos in Passeier,39,,27,10,37
054 Moos in Passeier,40,,17,18,35
054 Moos in Passeier,41,,11,20,31
054 Moos in Passeier,42,,9,7,16
054 Moos in Passeier,43,,18,16,34
054 Moos in Passeier,44,,16,14,30
054 Moos in Passeier,45,,14,14,28
054 Moos in Passeier,46,,21,7,28
054 Moos in Passeier,47,,9,8,17
054 Moos in Passeier,48,,9,9,18
054 Moos in Passeier,49,,17,9,26
054 Moos in Passeier,50,,6,9,15
054 Moos in Passeier,51,,8,5,13
054 Moos in Passeier,52,,9,10,19
054 Moos in Passeier,53,,8,10,18
054 Moos in Passeier,54,,16,9,25
054 Moos in Passeier,55,,6,6,12
054 Moos in Passeier,56,,19,10,29
054 Moos in Passeier,57,,9,8,17
054 Moos in Passeier,58,,9,7,16
054 Moos in Passeier,59,,8,9,17
054 Moos in Passeier,60,,14,12,26
054 Moos in Passeier,61,,5,12,17
054 Moos in Passeier,62,,10,14,24
054 Moos in Passeier,63,,9,10,19
054 Moos in Passeier,64,,5,7,12
054 Moos in Passeier,65,,11,8,19
054 Moos in Passeier,66,,5,6,11
054 Moos in Passeier,67,,8,6,14
054 Moos in Passeier,68,,8,7,15
054 Moos in Passeier,69,,10,14,24
054 Moos in Passeier,70,,7,10,17
054 Moos in Passeier,71,,8,4,12
054 Moos in Passeier,72,,9,7,16
054 Moos in Passeier,73,,9,7,16
054 Moos in Passeier,74,,7,13,20
054 Moos in Passeier,75,,4,10,14
054 Moos in Passeier,76,,7,4,11
054 Moos in Passeier,77,,9,3,12
054 Moos in Passeier,78,,7,7,14
054 Moos in Passeier,79,,3,6,9
054 Moos in Passeier,80,,4,3,7
054 Moos in Passeier,81,,1,6,7
054 Moos in Passeier,82,,1,2,3
054 Moos in Passeier,83,,2,2,4
054 Moos in Passeier,84,,1,4,5
054 Moos in Passeier,85,,1,-,1
054 Moos in Passeier,86,,1,2,3
054 Moos in Passeier,87,,-,3,3
054 Moos in Passeier,88,,1,1,2
054 Moos in Passeier,89,,1,3,4
054 Moos in Passeier,90,,-,1,1
054 Moos in Passeier,91,,1,1,2
054 Moos in Passeier,93,,-,1,1
054 Moos in Passeier,95,,1,-,1
055 Nals,0,,7,6,13
055 Nals,1,,10,10,20
055 Nals,2,,8,9,17
055 Nals,3,,7,14,21
055 Nals,4,,14,8,22
055 Nals,5,,14,7,21
055 Nals,6,,12,6,18
055 Nals,7,,11,10,21
055 Nals,8,,9,6,15
055 Nals,9,,9,8,17
055 Nals,10,,7,12,19
055 Nals,11,,13,10,23
055 Nals,12,,7,11,18
055 Nals,13,,9,7,16
055 Nals,14,,11,8,19
055 Nals,15,,9,12,21
055 Nals,16,,11,10,21
055 Nals,17,,5,2,7
055 Nals,18,,11,5,16
055 Nals,19,,8,10,18
055 Nals,20,,5,9,14
055 Nals,21,,8,11,19
055 Nals,22,,9,11,20
055 Nals,23,,15,9,24
055 Nals,24,,8,7,15
055 Nals,25,,10,9,19
055 Nals,26,,6,6,12
055 Nals,27,,10,13,23
055 Nals,28,,7,12,19
055 Nals,29,,19,9,28
055 Nals,30,,10,8,18
055 Nals,31,,11,14,25
055 Nals,32,,16,14,30
055 Nals,33,,21,11,32
055 Nals,34,,16,15,31
055 Nals,35,,23,17,40
055 Nals,36,,19,14,33
055 Nals,37,,13,10,23
055 Nals,38,,16,12,28
055 Nals,39,,19,17,36
055 Nals,40,,11,19,30
055 Nals,41,,13,15,28
055 Nals,42,,17,14,31
055 Nals,43,,13,8,21
055 Nals,44,,16,14,30
055 Nals,45,,17,16,33
055 Nals,46,,8,9,17
055 Nals,47,,8,8,16
055 Nals,48,,19,15,34
055 Nals,49,,6,7,13
055 Nals,50,,6,7,13
055 Nals,51,,7,7,14
055 Nals,52,,3,10,13
055 Nals,53,,7,10,17
055 Nals,54,,10,9,19
055 Nals,55,,11,12,23
055 Nals,56,,12,6,18
055 Nals,57,,7,13,20
055 Nals,58,,7,11,18
055 Nals,59,,7,12,19
055 Nals,60,,10,6,16
055 Nals,61,,5,8,13
055 Nals,62,,12,6,18
055 Nals,63,,7,12,19
055 Nals,64,,10,10,20
055 Nals,65,,7,9,16
055 Nals,66,,3,14,17
055 Nals,67,,6,3,9
055 Nals,68,,7,6,13
055 Nals,69,,6,6,12
055 Nals,70,,9,10,19
055 Nals,71,,6,4,10
055 Nals,72,,3,7,10
055 Nals,73,,4,5,9
055 Nals,74,,9,7,16
055 Nals,75,,7,8,15
055 Nals,76,,6,6,12
055 Nals,77,,7,6,13
055 Nals,78,,4,4,8
055 Nals,79,,3,1,4
055 Nals,80,,1,6,7
055 Nals,81,,2,6,8
055 Nals,82,,2,8,10
055 Nals,83,,1,1,2
055 Nals,84,,1,5,6
055 Nals,86,,1,-,1
055 Nals,87,,-,1,1
055 Nals,88,,3,3,6
055 Nals,89,,-,3,3
055 Nals,90,,1,1,2
055 Nals,91,,2,1,3
055 Nals,92,,-,2,2
055 Nals,93,,1,1,2
056 Naturns,0,,35,26,61
056 Naturns,1,,21,26,47
056 Naturns,2,,32,31,63
056 Naturns,3,,29,25,54
056 Naturns,4,,30,28,58
056 Naturns,5,,31,32,63
056 Naturns,6,,22,18,40
056 Naturns,7,,32,35,67
056 Naturns,8,,47,34,81
056 Naturns,9,,36,38,74
056 Naturns,10,,31,40,71
056 Naturns,11,,30,40,70
056 Naturns,12,,44,39,83
056 Naturns,13,,35,31,66
056 Naturns,14,,36,24,60
056 Naturns,15,,43,35,78
056 Naturns,16,,34,17,51
056 Naturns,17,,28,26,54
056 Naturns,18,,36,23,59
056 Naturns,19,,39,20,59
056 Naturns,20,,30,32,62
056 Naturns,21,,36,28,64
056 Naturns,22,,38,48,86
056 Naturns,23,,31,29,60
056 Naturns,24,,40,38,78
056 Naturns,25,,35,40,75
056 Naturns,26,,36,35,71
056 Naturns,27,,34,35,69
056 Naturns,28,,41,37,78
056 Naturns,29,,42,44,86
056 Naturns,30,,44,43,87
056 Naturns,31,,38,44,82
056 Naturns,32,,41,39,80
056 Naturns,33,,49,44,93
056 Naturns,34,,41,45,86
056 Naturns,35,,49,44,93
056 Naturns,36,,50,42,92
056 Naturns,37,,52,43,95
056 Naturns,38,,40,49,89
056 Naturns,39,,47,37,84
056 Naturns,40,,41,47,88
056 Naturns,41,,41,46,87
056 Naturns,42,,37,48,85
056 Naturns,43,,53,37,90
056 Naturns,44,,43,40,83
056 Naturns,45,,31,34,65
056 Naturns,46,,36,33,69
056 Naturns,47,,41,35,76
056 Naturns,48,,32,32,64
056 Naturns,49,,38,31,69
056 Naturns,50,,35,25,60
056 Naturns,51,,36,35,71
056 Naturns,52,,36,36,72
056 Naturns,53,,28,32,60
056 Naturns,54,,26,20,46
056 Naturns,55,,29,25,54
056 Naturns,56,,13,21,34
056 Naturns,57,,25,32,57
056 Naturns,58,,24,19,43
056 Naturns,59,,21,20,41
056 Naturns,60,,27,35,62
056 Naturns,61,,31,34,65
056 Naturns,62,,40,31,71
056 Naturns,63,,21,20,41
056 Naturns,64,,20,21,41
056 Naturns,65,,23,18,41
056 Naturns,66,,23,23,46
056 Naturns,67,,20,21,41
056 Naturns,68,,22,10,32
056 Naturns,69,,17,20,37
056 Naturns,70,,14,13,27
056 Naturns,71,,12,20,32
056 Naturns,72,,12,22,34
056 Naturns,73,,17,24,41
056 Naturns,74,,15,17,32
056 Naturns,75,,16,16,32
056 Naturns,76,,12,18,30
056 Naturns,77,,13,16,29
056 Naturns,78,,15,16,31
056 Naturns,79,,15,14,29
056 Naturns,80,,8,12,20
056 Naturns,81,,5,10,15
056 Naturns,82,,5,16,21
056 Naturns,83,,4,8,12
056 Naturns,84,,1,9,10
056 Naturns,85,,2,3,5
056 Naturns,86,,3,2,5
056 Naturns,87,,2,3,5
056 Naturns,88,,1,5,6
056 Naturns,89,,3,8,11
056 Naturns,90,,5,12,17
056 Naturns,91,,1,6,7
056 Naturns,92,,2,3,5
056 Naturns,93,,2,-,2
056 Naturns,94,,-,5,5
056 Naturns,95,,-,2,2
056 Naturns,96,,-,2,2
056 Naturns,98,,1,1,2
057 Natz-Schabs,0,,17,14,31
057 Natz-Schabs,1,,22,16,38
057 Natz-Schabs,2,,9,19,28
057 Natz-Schabs,3,,18,17,35
057 Natz-Schabs,4,,14,22,36
057 Natz-Schabs,5,,20,15,35
057 Natz-Schabs,6,,18,17,35
057 Natz-Schabs,7,,24,17,41
057 Natz-Schabs,8,,14,14,28
057 Natz-Schabs,9,,22,16,38
057 Natz-Schabs,10,,15,17,32
057 Natz-Schabs,11,,16,13,29
057 Natz-Schabs,12,,21,21,42
057 Natz-Schabs,13,,14,25,39
057 Natz-Schabs,14,,16,24,40
057 Natz-Schabs,15,,24,15,39
057 Natz-Schabs,16,,20,20,40
057 Natz-Schabs,17,,17,20,37
057 Natz-Schabs,18,,21,23,44
057 Natz-Schabs,19,,17,14,31
057 Natz-Schabs,20,,22,17,39
057 Natz-Schabs,21,,11,20,31
057 Natz-Schabs,22,,17,21,38
057 Natz-Schabs,23,,22,13,35
057 Natz-Schabs,24,,14,15,29
057 Natz-Schabs,25,,17,14,31
057 Natz-Schabs,26,,18,14,32
057 Natz-Schabs,27,,10,17,27
057 Natz-Schabs,28,,14,20,34
057 Natz-Schabs,29,,14,21,35
057 Natz-Schabs,30,,26,20,46
057 Natz-Schabs,31,,25,21,46
057 Natz-Schabs,32,,24,27,51
057 Natz-Schabs,33,,25,22,47
057 Natz-Schabs,34,,28,21,49
057 Natz-Schabs,35,,30,16,46
057 Natz-Schabs,36,,26,26,52
057 Natz-Schabs,37,,28,16,44
057 Natz-Schabs,38,,32,27,59
057 Natz-Schabs,39,,27,25,52
057 Natz-Schabs,40,,24,27,51
057 Natz-Schabs,41,,18,23,41
057 Natz-Schabs,42,,18,18,36
057 Natz-Schabs,43,,30,22,52
057 Natz-Schabs,44,,23,20,43
057 Natz-Schabs,45,,22,18,40
057 Natz-Schabs,46,,19,19,38
057 Natz-Schabs,47,,19,21,40
057 Natz-Schabs,48,,20,17,37
057 Natz-Schabs,49,,10,14,24
057 Natz-Schabs,50,,20,16,36
057 Natz-Schabs,51,,14,10,24
057 Natz-Schabs,52,,15,9,24
057 Natz-Schabs,53,,16,15,31
057 Natz-Schabs,54,,18,14,32
057 Natz-Schabs,55,,13,12,25
057 Natz-Schabs,56,,11,11,22
057 Natz-Schabs,57,,14,10,24
057 Natz-Schabs,58,,10,6,16
057 Natz-Schabs,59,,13,12,25
057 Natz-Schabs,60,,11,7,18
057 Natz-Schabs,61,,12,7,19
057 Natz-Schabs,62,,14,9,23
057 Natz-Schabs,63,,3,8,11
057 Natz-Schabs,64,,2,6,8
057 Natz-Schabs,65,,6,6,12
057 Natz-Schabs,66,,12,6,18
057 Natz-Schabs,67,,9,4,13
057 Natz-Schabs,68,,8,7,15
057 Natz-Schabs,69,,5,3,8
057 Natz-Schabs,70,,6,10,16
057 Natz-Schabs,71,,5,7,12
057 Natz-Schabs,72,,5,4,9
057 Natz-Schabs,73,,5,7,12
057 Natz-Schabs,74,,10,2,12
057 Natz-Schabs,75,,4,7,11
057 Natz-Schabs,76,,2,4,6
057 Natz-Schabs,77,,4,7,11
057 Natz-Schabs,78,,3,5,8
057 Natz-Schabs,79,,2,7,9
057 Natz-Schabs,80,,1,10,11
057 Natz-Schabs,81,,6,3,9
057 Natz-Schabs,82,,5,3,8
057 Natz-Schabs,83,,2,7,9
057 Natz-Schabs,84,,-,2,2
057 Natz-Schabs,85,,1,4,5
057 Natz-Schabs,86,,1,1,2
057 Natz-Schabs,87,,1,-,1
057 Natz-Schabs,88,,1,1,2
057 Natz-Schabs,90,,2,-,2
057 Natz-Schabs,91,,-,2,2
057 Natz-Schabs,92,,-,2,2
057 Natz-Schabs,94,,1,-,1
057 Natz-Schabs,95,,-,1,1
058 Welschnofen,0,,10,9,19
058 Welschnofen,1,,20,6,26
058 Welschnofen,2,,6,12,18
058 Welschnofen,3,,9,8,17
058 Welschnofen,4,,10,12,22
058 Welschnofen,5,,14,9,23
058 Welschnofen,6,,12,12,24
058 Welschnofen,7,,9,10,19
058 Welschnofen,8,,14,13,27
058 Welschnofen,9,,11,11,22
058 Welschnofen,10,,13,10,23
058 Welschnofen,11,,14,10,24
058 Welschnofen,12,,15,11,26
058 Welschnofen,13,,12,14,26
058 Welschnofen,14,,14,9,23
058 Welschnofen,15,,11,17,28
058 Welschnofen,16,,10,9,19
058 Welschnofen,17,,7,10,17
058 Welschnofen,18,,10,8,18
058 Welschnofen,19,,7,8,15
058 Welschnofen,20,,10,11,21
058 Welschnofen,21,,10,17,27
058 Welschnofen,22,,13,12,25
058 Welschnofen,23,,12,8,20
058 Welschnofen,24,,10,3,13
058 Welschnofen,25,,13,15,28
058 Welschnofen,26,,11,18,29
058 Welschnofen,27,,18,10,28
058 Welschnofen,28,,17,11,28
058 Welschnofen,29,,13,15,28
058 Welschnofen,30,,15,16,31
058 Welschnofen,31,,12,13,25
058 Welschnofen,32,,13,16,29
058 Welschnofen,33,,18,12,30
058 Welschnofen,34,,13,14,27
058 Welschnofen,35,,17,17,34
058 Welschnofen,36,,18,15,33
058 Welschnofen,37,,15,12,27
058 Welschnofen,38,,21,15,36
058 Welschnofen,39,,14,7,21
058 Welschnofen,40,,17,17,34
058 Welschnofen,41,,12,16,28
058 Welschnofen,42,,16,18,34
058 Welschnofen,43,,21,8,29
058 Welschnofen,44,,13,13,26
058 Welschnofen,45,,16,10,26
058 Welschnofen,46,,11,13,24
058 Welschnofen,47,,11,14,25
058 Welschnofen,48,,15,14,29
058 Welschnofen,49,,15,11,26
058 Welschnofen,50,,10,14,24
058 Welschnofen,51,,12,8,20
058 Welschnofen,52,,16,8,24
058 Welschnofen,53,,10,9,19
058 Welschnofen,54,,12,13,25
058 Welschnofen,55,,8,10,18
058 Welschnofen,56,,9,8,17
058 Welschnofen,57,,10,10,20
058 Welschnofen,58,,11,6,17
058 Welschnofen,59,,7,10,17
058 Welschnofen,60,,14,9,23
058 Welschnofen,61,,11,13,24
058 Welschnofen,62,,10,7,17
058 Welschnofen,63,,7,7,14
058 Welschnofen,64,,10,7,17
058 Welschnofen,65,,7,6,13
058 Welschnofen,66,,9,4,13
058 Welschnofen,67,,4,12,16
058 Welschnofen,68,,8,6,14
058 Welschnofen,69,,11,10,21
058 Welschnofen,70,,10,14,24
058 Welschnofen,71,,7,7,14
058 Welschnofen,72,,5,8,13
058 Welschnofen,73,,5,8,13
058 Welschnofen,74,,8,12,20
058 Welschnofen,75,,7,5,12
058 Welschnofen,76,,2,3,5
058 Welschnofen,77,,5,9,14
058 Welschnofen,78,,5,6,11
058 Welschnofen,79,,3,13,16
058 Welschnofen,80,,7,7,14
058 Welschnofen,81,,6,6,12
058 Welschnofen,82,,1,10,11
058 Welschnofen,83,,3,4,7
058 Welschnofen,84,,1,6,7
058 Welschnofen,85,,1,1,2
058 Welschnofen,86,,1,-,1
058 Welschnofen,87,,2,4,6
058 Welschnofen,88,,-,3,3
058 Welschnofen,89,,-,2,2
058 Welschnofen,90,,-,3,3
058 Welschnofen,91,,2,6,8
058 Welschnofen,92,,1,-,1
058 Welschnofen,93,,1,1,2
058 Welschnofen,94,,-,2,2
058 Welschnofen,95,,1,-,1
058 Welschnofen,97,,-,1,1
059 Deutschnofen,0,,17,32,49
059 Deutschnofen,1,,33,10,43
059 Deutschnofen,2,,21,28,49
059 Deutschnofen,3,,19,26,45
059 Deutschnofen,4,,28,23,51
059 Deutschnofen,5,,31,14,45
059 Deutschnofen,6,,22,28,50
059 Deutschnofen,7,,18,28,46
059 Deutschnofen,8,,25,25,50
059 Deutschnofen,9,,28,14,42
059 Deutschnofen,10,,22,26,48
059 Deutschnofen,11,,34,28,62
059 Deutschnofen,12,,20,21,41
059 Deutschnofen,13,,34,28,62
059 Deutschnofen,14,,23,22,45
059 Deutschnofen,15,,23,34,57
059 Deutschnofen,16,,21,24,45
059 Deutschnofen,17,,29,18,47
059 Deutschnofen,18,,25,19,44
059 Deutschnofen,19,,31,28,59
059 Deutschnofen,20,,22,21,43
059 Deutschnofen,21,,21,35,56
059 Deutschnofen,22,,20,16,36
059 Deutschnofen,23,,26,21,47
059 Deutschnofen,24,,21,19,40
059 Deutschnofen,25,,24,18,42
059 Deutschnofen,26,,30,25,55
059 Deutschnofen,27,,19,18,37
059 Deutschnofen,28,,23,27,50
059 Deutschnofen,29,,27,33,60
059 Deutschnofen,30,,16,28,44
059 Deutschnofen,31,,23,36,59
059 Deutschnofen,32,,26,21,47
059 Deutschnofen,33,,30,27,57
059 Deutschnofen,34,,46,28,74
059 Deutschnofen,35,,24,26,50
059 Deutschnofen,36,,29,28,57
059 Deutschnofen,37,,33,35,68
059 Deutschnofen,38,,36,21,57
059 Deutschnofen,39,,29,28,57
059 Deutschnofen,40,,33,26,59
059 Deutschnofen,41,,28,27,55
059 Deutschnofen,42,,35,22,57
059 Deutschnofen,43,,42,26,68
059 Deutschnofen,44,,26,17,43
059 Deutschnofen,45,,23,32,55
059 Deutschnofen,46,,23,26,49
059 Deutschnofen,47,,33,28,61
059 Deutschnofen,48,,28,21,49
059 Deutschnofen,49,,27,20,47
059 Deutschnofen,50,,24,20,44
059 Deutschnofen,51,,24,22,46
059 Deutschnofen,52,,20,14,34
059 Deutschnofen,53,,16,20,36
059 Deutschnofen,54,,21,14,35
059 Deutschnofen,55,,23,16,39
059 Deutschnofen,56,,13,15,28
059 Deutschnofen,57,,18,22,40
059 Deutschnofen,58,,17,15,32
059 Deutschnofen,59,,16,16,32
059 Deutschnofen,60,,24,21,45
059 Deutschnofen,61,,18,17,35
059 Deutschnofen,62,,16,24,40
059 Deutschnofen,63,,13,19,32
059 Deutschnofen,64,,27,14,41
059 Deutschnofen,65,,17,21,38
059 Deutschnofen,66,,13,7,20
059 Deutschnofen,67,,14,10,24
059 Deutschnofen,68,,8,13,21
059 Deutschnofen,69,,16,10,26
059 Deutschnofen,70,,9,14,23
059 Deutschnofen,71,,14,15,29
059 Deutschnofen,72,,12,9,21
059 Deutschnofen,73,,10,10,20
059 Deutschnofen,74,,8,10,18
059 Deutschnofen,75,,9,23,32
059 Deutschnofen,76,,8,15,23
059 Deutschnofen,77,,15,10,25
059 Deutschnofen,78,,9,19,28
059 Deutschnofen,79,,5,10,15
059 Deutschnofen,80,,4,10,14
059 Deutschnofen,81,,8,16,24
059 Deutschnofen,82,,6,15,21
059 Deutschnofen,83,,2,11,13
059 Deutschnofen,84,,1,6,7
059 Deutschnofen,85,,3,5,8
059 Deutschnofen,86,,-,4,4
059 Deutschnofen,87,,3,3,6
059 Deutschnofen,88,,5,5,10
059 Deutschnofen,89,,2,5,7
059 Deutschnofen,90,,1,8,9
059 Deutschnofen,91,,-,4,4
059 Deutschnofen,92,,1,6,7
059 Deutschnofen,93,,2,2,4
059 Deutschnofen,94,,-,1,1
059 Deutschnofen,95,,1,-,1
059 Deutschnofen,96,,1,-,1
060 Auer,0,,23,17,40
060 Auer,1,,29,14,43
060 Auer,2,,16,19,35
060 Auer,3,,20,20,40
060 Auer,4,,21,24,45
060 Auer,5,,19,21,40
060 Auer,6,,19,18,37
060 Auer,7,,19,21,40
060 Auer,8,,18,14,32
060 Auer,9,,20,20,40
060 Auer,10,,11,24,35
060 Auer,11,,19,20,39
060 Auer,12,,26,15,41
060 Auer,13,,17,18,35
060 Auer,14,,21,19,40
060 Auer,15,,17,25,42
060 Auer,16,,22,17,39
060 Auer,17,,15,14,29
060 Auer,18,,24,18,42
060 Auer,19,,16,15,31
060 Auer,20,,15,17,32
060 Auer,21,,18,25,43
060 Auer,22,,15,19,34
060 Auer,23,,14,16,30
060 Auer,24,,17,18,35
060 Auer,25,,13,12,25
060 Auer,26,,16,26,42
060 Auer,27,,18,30,48
060 Auer,28,,12,14,26
060 Auer,29,,29,20,49
060 Auer,30,,29,19,48
060 Auer,31,,18,22,40
060 Auer,32,,30,21,51
060 Auer,33,,25,26,51
060 Auer,34,,23,30,53
060 Auer,35,,32,38,70
060 Auer,36,,24,24,48
060 Auer,37,,31,37,68
060 Auer,38,,36,23,59
060 Auer,39,,32,21,53
060 Auer,40,,33,39,72
060 Auer,41,,22,23,45
060 Auer,42,,40,35,75
060 Auer,43,,24,35,59
060 Auer,44,,36,27,63
060 Auer,45,,32,19,51
060 Auer,46,,24,26,50
060 Auer,47,,31,27,58
060 Auer,48,,15,22,37
060 Auer,49,,19,13,32
060 Auer,50,,16,22,38
060 Auer,51,,20,20,40
060 Auer,52,,14,21,35
060 Auer,53,,14,21,35
060 Auer,54,,12,13,25
060 Auer,55,,27,14,41
060 Auer,56,,15,24,39
060 Auer,57,,18,24,42
060 Auer,58,,12,12,24
060 Auer,59,,22,14,36
060 Auer,60,,17,18,35
060 Auer,61,,17,18,35
060 Auer,62,,21,14,35
060 Auer,63,,13,9,22
060 Auer,64,,13,20,33
060 Auer,65,,17,20,37
060 Auer,66,,11,12,23
060 Auer,67,,11,10,21
060 Auer,68,,9,16,25
060 Auer,69,,18,14,32
060 Auer,70,,5,9,14
060 Auer,71,,3,17,20
060 Auer,72,,12,11,23
060 Auer,73,,9,9,18
060 Auer,74,,8,15,23
060 Auer,75,,12,8,20
060 Auer,76,,8,13,21
060 Auer,77,,5,18,23
060 Auer,78,,10,10,20
060 Auer,79,,9,11,20
060 Auer,80,,9,14,23
060 Auer,81,,2,14,16
060 Auer,82,,2,12,14
060 Auer,83,,8,9,17
060 Auer,84,,2,4,6
060 Auer,85,,2,9,11
060 Auer,86,,2,3,5
060 Auer,87,,-,2,2
060 Auer,88,,-,2,2
060 Auer,89,,1,3,4
060 Auer,90,,1,7,8
060 Auer,91,,-,3,3
060 Auer,92,,-,1,1
060 Auer,93,,2,1,3
060 Auer,94,,1,1,2
060 Auer,96,,-,1,1
061 St.Ulrich,0,,23,35,58
061 St.Ulrich,1,,29,37,66
061 St.Ulrich,2,,20,24,44
061 St.Ulrich,3,,30,32,62
061 St.Ulrich,4,,44,30,74
061 St.Ulrich,5,,42,35,77
061 St.Ulrich,6,,30,31,61
061 St.Ulrich,7,,31,24,55
061 St.Ulrich,8,,30,33,63
061 St.Ulrich,9,,29,32,61
061 St.Ulrich,10,,21,29,50
061 St.Ulrich,11,,36,31,67
061 St.Ulrich,12,,30,34,64
061 St.Ulrich,13,,29,21,50
061 St.Ulrich,14,,17,23,40
061 St.Ulrich,15,,17,22,39
061 St.Ulrich,16,,26,18,44
061 St.Ulrich,17,,19,18,37
061 St.Ulrich,18,,23,21,44
061 St.Ulrich,19,,22,18,40
061 St.Ulrich,20,,21,18,39
061 St.Ulrich,21,,25,26,51
061 St.Ulrich,22,,21,26,47
061 St.Ulrich,23,,25,33,58
061 St.Ulrich,24,,29,30,59
061 St.Ulrich,25,,25,29,54
061 St.Ulrich,26,,25,22,47
061 St.Ulrich,27,,33,36,69
061 St.Ulrich,28,,37,30,67
061 St.Ulrich,29,,38,36,74
061 St.Ulrich,30,,38,31,69
061 St.Ulrich,31,,39,38,77
061 St.Ulrich,32,,41,37,78
061 St.Ulrich,33,,42,33,75
061 St.Ulrich,34,,47,42,89
061 St.Ulrich,35,,41,43,84
061 St.Ulrich,36,,40,42,82
061 St.Ulrich,37,,36,39,75
061 St.Ulrich,38,,36,34,70
061 St.Ulrich,39,,40,42,82
061 St.Ulrich,40,,40,34,74
061 St.Ulrich,41,,34,35,69
061 St.Ulrich,42,,28,21,49
061 St.Ulrich,43,,34,25,59
061 St.Ulrich,44,,40,27,67
061 St.Ulrich,45,,22,18,40
061 St.Ulrich,46,,27,33,60
061 St.Ulrich,47,,16,28,44
061 St.Ulrich,48,,26,39,65
061 St.Ulrich,49,,26,34,60
061 St.Ulrich,50,,28,18,46
061 St.Ulrich,51,,14,24,38
061 St.Ulrich,52,,25,24,49
061 St.Ulrich,53,,21,25,46
061 St.Ulrich,54,,19,27,46
061 St.Ulrich,55,,30,31,61
061 St.Ulrich,56,,22,24,46
061 St.Ulrich,57,,32,27,59
061 St.Ulrich,58,,18,19,37
061 St.Ulrich,59,,31,32,63
061 St.Ulrich,60,,39,38,77
061 St.Ulrich,61,,31,36,67
061 St.Ulrich,62,,37,44,81
061 St.Ulrich,63,,32,28,60
061 St.Ulrich,64,,19,20,39
061 St.Ulrich,65,,25,26,51
061 St.Ulrich,66,,24,26,50
061 St.Ulrich,67,,24,17,41
061 St.Ulrich,68,,13,25,38
061 St.Ulrich,69,,18,13,31
061 St.Ulrich,70,,19,13,32
061 St.Ulrich,71,,16,23,39
061 St.Ulrich,72,,20,15,35
061 St.Ulrich,73,,19,9,28
061 St.Ulrich,74,,16,4,20
061 St.Ulrich,75,,16,13,29
061 St.Ulrich,76,,16,15,31
061 St.Ulrich,77,,10,15,25
061 St.Ulrich,78,,10,10,20
061 St.Ulrich,79,,10,19,29
061 St.Ulrich,80,,10,23,33
061 St.Ulrich,81,,6,18,24
061 St.Ulrich,82,,7,15,22
061 St.Ulrich,83,,4,18,22
061 St.Ulrich,84,,6,9,15
061 St.Ulrich,85,,5,8,13
061 St.Ulrich,86,,2,6,8
061 St.Ulrich,87,,4,6,10
061 St.Ulrich,88,,1,8,9
061 St.Ulrich,89,,7,7,14
061 St.Ulrich,90,,3,8,11
061 St.Ulrich,91,,4,6,10
061 St.Ulrich,92,,-,6,6
061 St.Ulrich,93,,3,1,4
061 St.Ulrich,94,,2,1,3
061 St.Ulrich,95,,1,1,2
061 St.Ulrich,96,,-,1,1
061 St.Ulrich,97,,-,1,1
062 Partschins,0,,23,17,40
062 Partschins,1,,24,22,46
062 Partschins,2,,18,18,36
062 Partschins,3,,20,15,35
062 Partschins,4,,17,16,33
062 Partschins,5,,18,12,30
062 Partschins,6,,24,23,47
062 Partschins,7,,13,18,31
062 Partschins,8,,23,16,39
062 Partschins,9,,22,18,40
062 Partschins,10,,22,17,39
062 Partschins,11,,19,17,36
062 Partschins,12,,23,26,49
062 Partschins,13,,26,23,49
062 Partschins,14,,11,23,34
062 Partschins,15,,18,27,45
062 Partschins,16,,18,14,32
062 Partschins,17,,22,20,42
062 Partschins,18,,11,14,25
062 Partschins,19,,17,20,37
062 Partschins,20,,17,22,39
062 Partschins,21,,17,19,36
062 Partschins,22,,21,25,46
062 Partschins,23,,25,22,47
062 Partschins,24,,17,21,38
062 Partschins,25,,18,17,35
062 Partschins,26,,26,17,43
062 Partschins,27,,20,22,42
062 Partschins,28,,26,22,48
062 Partschins,29,,22,20,42
062 Partschins,30,,29,23,52
062 Partschins,31,,28,31,59
062 Partschins,32,,25,36,61
062 Partschins,33,,21,33,54
062 Partschins,34,,34,22,56
062 Partschins,35,,26,27,53
062 Partschins,36,,35,24,59
062 Partschins,37,,36,38,74
062 Partschins,38,,29,32,61
062 Partschins,39,,30,36,66
062 Partschins,40,,34,26,60
062 Partschins,41,,32,25,57
062 Partschins,42,,22,25,47
062 Partschins,43,,26,36,62
062 Partschins,44,,27,17,44
062 Partschins,45,,20,19,39
062 Partschins,46,,24,24,48
062 Partschins,47,,23,20,43
062 Partschins,48,,22,26,48
062 Partschins,49,,12,27,39
062 Partschins,50,,23,15,38
062 Partschins,51,,17,15,32
062 Partschins,52,,20,16,36
062 Partschins,53,,17,19,36
062 Partschins,54,,10,11,21
062 Partschins,55,,18,18,36
062 Partschins,56,,15,16,31
062 Partschins,57,,27,27,54
062 Partschins,58,,13,19,32
062 Partschins,59,,18,16,34
062 Partschins,60,,23,25,48
062 Partschins,61,,15,16,31
062 Partschins,62,,21,30,51
062 Partschins,63,,13,14,27
062 Partschins,64,,11,16,27
062 Partschins,65,,19,14,33
062 Partschins,66,,15,16,31
062 Partschins,67,,14,17,31
062 Partschins,68,,12,11,23
062 Partschins,69,,11,17,28
062 Partschins,70,,12,16,28
062 Partschins,71,,14,11,25
062 Partschins,72,,13,21,34
062 Partschins,73,,11,10,21
062 Partschins,74,,12,9,21
062 Partschins,75,,11,13,24
062 Partschins,76,,11,13,24
062 Partschins,77,,8,8,16
062 Partschins,78,,7,11,18
062 Partschins,79,,4,14,18
062 Partschins,80,,7,9,16
062 Partschins,81,,4,8,12
062 Partschins,82,,14,8,22
062 Partschins,83,,3,6,9
062 Partschins,84,,3,5,8
062 Partschins,85,,2,2,4
062 Partschins,86,,1,5,6
062 Partschins,87,,1,2,3
062 Partschins,88,,1,1,2
062 Partschins,89,,2,5,7
062 Partschins,90,,1,5,6
062 Partschins,91,,1,3,4
062 Partschins,93,,-,3,3
062 Partschins,96,,-,1,1
062 Partschins,98,,1,1,2
063 Percha,0,,11,4,15
063 Percha,1,,12,7,19
063 Percha,2,,4,3,7
063 Percha,3,,12,14,26
063 Percha,4,,5,8,13
063 Percha,5,,7,8,15
063 Percha,6,,10,16,26
063 Percha,7,,9,4,13
063 Percha,8,,8,9,17
063 Percha,9,,9,12,21
063 Percha,10,,7,9,16
063 Percha,11,,12,6,18
063 Percha,12,,10,9,19
063 Percha,13,,8,6,14
063 Percha,14,,6,8,14
063 Percha,15,,6,5,11
063 Percha,16,,9,18,27
063 Percha,17,,6,7,13
063 Percha,18,,7,13,20
063 Percha,19,,18,9,27
063 Percha,20,,14,9,23
063 Percha,21,,6,10,16
063 Percha,22,,9,5,14
063 Percha,23,,11,5,16
063 Percha,24,,4,13,17
063 Percha,25,,10,10,20
063 Percha,26,,8,8,16
063 Percha,27,,12,9,21
063 Percha,28,,10,8,18
063 Percha,29,,8,12,20
063 Percha,30,,11,9,20
063 Percha,31,,14,9,23
063 Percha,32,,17,13,30
063 Percha,33,,7,11,18
063 Percha,34,,18,15,33
063 Percha,35,,16,12,28
063 Percha,36,,7,11,18
063 Percha,37,,17,6,23
063 Percha,38,,14,24,38
063 Percha,39,,15,8,23
063 Percha,40,,11,17,28
063 Percha,41,,14,11,25
063 Percha,42,,12,11,23
063 Percha,43,,10,5,15
063 Percha,44,,7,8,15
063 Percha,45,,9,8,17
063 Percha,46,,10,5,15
063 Percha,47,,7,12,19
063 Percha,48,,11,11,22
063 Percha,49,,4,4,8
063 Percha,50,,8,6,14
063 Percha,51,,4,8,12
063 Percha,52,,7,7,14
063 Percha,53,,6,7,13
063 Percha,54,,10,6,16
063 Percha,55,,4,4,8
063 Percha,56,,5,6,11
063 Percha,57,,5,8,13
063 Percha,58,,8,5,13
063 Percha,59,,13,4,17
063 Percha,60,,8,7,15
063 Percha,61,,8,7,15
063 Percha,62,,8,6,14
063 Percha,63,,5,5,10
063 Percha,64,,7,5,12
063 Percha,65,,5,9,14
063 Percha,66,,1,5,6
063 Percha,67,,3,3,6
063 Percha,68,,3,4,7
063 Percha,69,,8,6,14
063 Percha,70,,4,5,9
063 Percha,71,,5,3,8
063 Percha,72,,7,2,9
063 Percha,73,,9,3,12
063 Percha,74,,3,5,8
063 Percha,75,,3,4,7
063 Percha,76,,4,5,9
063 Percha,77,,2,6,8
063 Percha,78,,4,5,9
063 Percha,79,,1,3,4
063 Percha,80,,1,4,5
063 Percha,81,,2,1,3
063 Percha,82,,-,2,2
063 Percha,83,,-,1,1
063 Percha,85,,-,1,1
063 Percha,88,,1,1,2
063 Percha,89,,-,4,4
063 Percha,91,,-,1,1
064 Plaus,0,,4,1,5
064 Plaus,1,,5,5,10
064 Plaus,2,,8,3,11
064 Plaus,3,,9,3,12
064 Plaus,4,,10,5,15
064 Plaus,5,,4,6,10
064 Plaus,6,,6,5,11
064 Plaus,7,,4,2,6
064 Plaus,8,,2,2,4
064 Plaus,9,,4,1,5
064 Plaus,10,,9,3,12
064 Plaus,11,,6,6,12
064 Plaus,12,,3,8,11
064 Plaus,13,,4,3,7
064 Plaus,14,,5,7,12
064 Plaus,15,,3,2,5
064 Plaus,16,,4,2,6
064 Plaus,17,,-,4,4
064 Plaus,18,,2,5,7
064 Plaus,19,,5,-,5
064 Plaus,20,,1,2,3
064 Plaus,21,,-,3,3
064 Plaus,22,,2,4,6
064 Plaus,23,,-,4,4
064 Plaus,24,,3,6,9
064 Plaus,25,,4,4,8
064 Plaus,26,,2,5,7
064 Plaus,27,,3,3,6
064 Plaus,28,,10,1,11
064 Plaus,29,,5,6,11
064 Plaus,30,,9,4,13
064 Plaus,31,,4,2,6
064 Plaus,32,,3,5,8
064 Plaus,33,,8,4,12
064 Plaus,34,,7,8,15
064 Plaus,35,,3,7,10
064 Plaus,36,,8,10,18
064 Plaus,37,,6,6,12
064 Plaus,38,,14,2,16
064 Plaus,39,,6,8,14
064 Plaus,40,,2,4,6
064 Plaus,41,,6,5,11
064 Plaus,42,,6,2,8
064 Plaus,43,,3,6,9
064 Plaus,44,,7,2,9
064 Plaus,45,,4,3,7
064 Plaus,46,,2,2,4
064 Plaus,47,,2,1,3
064 Plaus,48,,3,4,7
064 Plaus,49,,2,1,3
064 Plaus,50,,2,4,6
064 Plaus,51,,5,2,7
064 Plaus,52,,5,3,8
064 Plaus,53,,1,2,3
064 Plaus,54,,3,2,5
064 Plaus,55,,1,3,4
064 Plaus,56,,2,5,7
064 Plaus,57,,5,2,7
064 Plaus,58,,3,1,4
064 Plaus,59,,2,3,5
064 Plaus,60,,4,1,5
064 Plaus,61,,-,4,4
064 Plaus,62,,3,5,8
064 Plaus,63,,3,1,4
064 Plaus,64,,3,2,5
064 Plaus,65,,1,1,2
064 Plaus,66,,3,3,6
064 Plaus,68,,2,2,4
064 Plaus,69,,4,2,6
064 Plaus,70,,1,3,4
064 Plaus,71,,1,3,4
064 Plaus,72,,1,1,2
064 Plaus,73,,-,1,1
064 Plaus,74,,1,1,2
064 Plaus,75,,1,-,1
064 Plaus,76,,1,1,2
064 Plaus,77,,1,1,2
064 Plaus,78,,1,-,1
064 Plaus,79,,-,4,4
064 Plaus,80,,-,2,2
064 Plaus,81,,1,1,2
064 Plaus,82,,-,1,1
064 Plaus,83,,1,-,1
064 Plaus,84,,-,2,2
064 Plaus,85,,-,1,1
064 Plaus,88,,-,1,1
064 Plaus,91,,1,-,1
065 Waidbruck,0,,-,1,1
065 Waidbruck,1,,-,1,1
065 Waidbruck,2,,1,1,2
065 Waidbruck,3,,1,2,3
065 Waidbruck,4,,2,2,4
065 Waidbruck,6,,3,3,6
065 Waidbruck,7,,2,-,2
065 Waidbruck,8,,1,3,4
065 Waidbruck,9,,3,1,4
065 Waidbruck,10,,1,1,2
065 Waidbruck,11,,-,2,2
065 Waidbruck,12,,1,-,1
065 Waidbruck,13,,1,1,2
065 Waidbruck,14,,2,-,2
065 Waidbruck,15,,-,1,1
065 Waidbruck,16,,1,1,2
065 Waidbruck,18,,-,1,1
065 Waidbruck,19,,3,2,5
065 Waidbruck,20,,1,-,1
065 Waidbruck,22,,-,2,2
065 Waidbruck,23,,2,-,2
065 Waidbruck,24,,1,-,1
065 Waidbruck,25,,4,1,5
065 Waidbruck,26,,-,1,1
065 Waidbruck,27,,-,1,1
065 Waidbruck,28,,3,-,3
065 Waidbruck,29,,6,1,7
065 Waidbruck,30,,1,1,2
065 Waidbruck,31,,2,1,3
065 Waidbruck,32,,7,-,7
065 Waidbruck,33,,1,1,2
065 Waidbruck,34,,2,3,5
065 Waidbruck,35,,3,1,4
065 Waidbruck,36,,2,4,6
065 Waidbruck,37,,2,2,4
065 Waidbruck,38,,3,1,4
065 Waidbruck,39,,3,-,3
065 Waidbruck,40,,2,1,3
065 Waidbruck,41,,2,-,2
065 Waidbruck,42,,-,1,1
065 Waidbruck,43,,4,1,5
065 Waidbruck,44,,4,1,5
065 Waidbruck,45,,-,1,1
065 Waidbruck,46,,2,1,3
065 Waidbruck,47,,2,-,2
065 Waidbruck,48,,2,-,2
065 Waidbruck,50,,1,1,2
065 Waidbruck,51,,1,1,2
065 Waidbruck,52,,1,2,3
065 Waidbruck,54,,1,-,1
065 Waidbruck,57,,-,3,3
065 Waidbruck,58,,1,1,2
065 Waidbruck,59,,2,2,4
065 Waidbruck,61,,1,-,1
065 Waidbruck,62,,1,2,3
065 Waidbruck,63,,-,3,3
065 Waidbruck,64,,1,-,1
065 Waidbruck,65,,-,3,3
065 Waidbruck,66,,1,1,2
065 Waidbruck,67,,2,2,4
065 Waidbruck,68,,-,3,3
065 Waidbruck,69,,4,1,5
065 Waidbruck,70,,2,-,2
065 Waidbruck,71,,1,4,5
065 Waidbruck,72,,1,-,1
065 Waidbruck,73,,1,-,1
065 Waidbruck,74,,-,3,3
065 Waidbruck,75,,1,1,2
065 Waidbruck,76,,2,1,3
065 Waidbruck,77,,-,1,1
065 Waidbruck,78,,1,1,2
065 Waidbruck,80,,-,2,2
065 Waidbruck,83,,-,1,1
065 Waidbruck,84,,-,2,2
065 Waidbruck,89,,-,1,1
065 Waidbruck,93,,-,1,1
066 Burgstall,0,,10,11,21
066 Burgstall,1,,9,9,18
066 Burgstall,2,,9,9,18
066 Burgstall,3,,10,11,21
066 Burgstall,4,,10,9,19
066 Burgstall,5,,9,11,20
066 Burgstall,6,,9,6,15
066 Burgstall,7,,5,9,14
066 Burgstall,8,,11,10,21
066 Burgstall,9,,6,5,11
066 Burgstall,10,,7,9,16
066 Burgstall,11,,4,7,11
066 Burgstall,12,,8,10,18
066 Burgstall,13,,14,9,23
066 Burgstall,14,,10,3,13
066 Burgstall,15,,7,7,14
066 Burgstall,16,,10,9,19
066 Burgstall,17,,10,4,14
066 Burgstall,18,,8,11,19
066 Burgstall,19,,10,12,22
066 Burgstall,20,,7,10,17
066 Burgstall,21,,13,8,21
066 Burgstall,22,,5,7,12
066 Burgstall,23,,11,11,22
066 Burgstall,24,,5,6,11
066 Burgstall,25,,8,9,17
066 Burgstall,26,,5,13,18
066 Burgstall,27,,10,6,16
066 Burgstall,28,,16,13,29
066 Burgstall,29,,10,11,21
066 Burgstall,30,,14,12,26
066 Burgstall,31,,7,18,25
066 Burgstall,32,,15,11,26
066 Burgstall,33,,13,9,22
066 Burgstall,34,,13,9,22
066 Burgstall,35,,16,19,35
066 Burgstall,36,,10,17,27
066 Burgstall,37,,13,19,32
066 Burgstall,38,,21,17,38
066 Burgstall,39,,16,13,29
066 Burgstall,40,,16,14,30
066 Burgstall,41,,19,12,31
066 Burgstall,42,,9,15,24
066 Burgstall,43,,17,9,26
066 Burgstall,44,,8,10,18
066 Burgstall,45,,16,7,23
066 Burgstall,46,,8,9,17
066 Burgstall,47,,13,11,24
066 Burgstall,48,,7,12,19
066 Burgstall,49,,10,15,25
066 Burgstall,50,,7,9,16
066 Burgstall,51,,12,16,28
066 Burgstall,52,,14,7,21
066 Burgstall,53,,10,12,22
066 Burgstall,54,,8,7,15
066 Burgstall,55,,7,14,21
066 Burgstall,56,,7,8,15
066 Burgstall,57,,11,8,19
066 Burgstall,58,,8,9,17
066 Burgstall,59,,12,10,22
066 Burgstall,60,,11,9,20
066 Burgstall,61,,5,6,11
066 Burgstall,62,,8,4,12
066 Burgstall,63,,5,12,17
066 Burgstall,64,,6,9,15
066 Burgstall,65,,10,14,24
066 Burgstall,66,,4,9,13
066 Burgstall,67,,5,6,11
066 Burgstall,68,,7,3,10
066 Burgstall,69,,9,8,17
066 Burgstall,70,,8,4,12
066 Burgstall,71,,3,8,11
066 Burgstall,72,,6,3,9
066 Burgstall,73,,5,7,12
066 Burgstall,74,,1,4,5
066 Burgstall,75,,4,7,11
066 Burgstall,76,,2,12,14
066 Burgstall,77,,4,9,13
066 Burgstall,78,,7,5,12
066 Burgstall,79,,1,7,8
066 Burgstall,80,,5,3,8
066 Burgstall,81,,6,6,12
066 Burgstall,82,,2,1,3
066 Burgstall,83,,1,3,4
066 Burgstall,84,,1,3,4
066 Burgstall,85,,-,1,1
066 Burgstall,86,,1,1,2
066 Burgstall,87,,2,2,4
066 Burgstall,88,,1,3,4
066 Burgstall,89,,1,3,4
066 Burgstall,90,,1,1,2
066 Burgstall,91,,-,2,2
066 Burgstall,92,,-,2,2
066 Burgstall,93,,-,1,1
066 Burgstall,94,,-,2,2
066 Burgstall,96,,1,-,1
067 Prad am Stilfser Joch,0,,14,10,24
067 Prad am Stilfser Joch,1,,14,14,28
067 Prad am Stilfser Joch,2,,22,17,39
067 Prad am Stilfser Joch,3,,18,14,32
067 Prad am Stilfser Joch,4,,15,18,33
067 Prad am Stilfser Joch,5,,21,21,42
067 Prad am Stilfser Joch,6,,23,16,39
067 Prad am Stilfser Joch,7,,20,18,38
067 Prad am Stilfser Joch,8,,21,12,33
067 Prad am Stilfser Joch,9,,20,26,46
067 Prad am Stilfser Joch,10,,21,30,51
067 Prad am Stilfser Joch,11,,17,21,38
067 Prad am Stilfser Joch,12,,21,11,32
067 Prad am Stilfser Joch,13,,19,22,41
067 Prad am Stilfser Joch,14,,19,23,42
067 Prad am Stilfser Joch,15,,32,17,49
067 Prad am Stilfser Joch,16,,13,18,31
067 Prad am Stilfser Joch,17,,29,28,57
067 Prad am Stilfser Joch,18,,29,21,50
067 Prad am Stilfser Joch,19,,29,30,59
067 Prad am Stilfser Joch,20,,29,25,54
067 Prad am Stilfser Joch,21,,27,25,52
067 Prad am Stilfser Joch,22,,22,25,47
067 Prad am Stilfser Joch,23,,27,20,47
067 Prad am Stilfser Joch,24,,19,12,31
067 Prad am Stilfser Joch,25,,24,18,42
067 Prad am Stilfser Joch,26,,18,37,55
067 Prad am Stilfser Joch,27,,23,22,45
067 Prad am Stilfser Joch,28,,20,17,37
067 Prad am Stilfser Joch,29,,30,15,45
067 Prad am Stilfser Joch,30,,21,38,59
067 Prad am Stilfser Joch,31,,27,22,49
067 Prad am Stilfser Joch,32,,30,21,51
067 Prad am Stilfser Joch,33,,26,23,49
067 Prad am Stilfser Joch,34,,27,28,55
067 Prad am Stilfser Joch,35,,35,30,65
067 Prad am Stilfser Joch,36,,22,26,48
067 Prad am Stilfser Joch,37,,36,29,65
067 Prad am Stilfser Joch,38,,32,22,54
067 Prad am Stilfser Joch,39,,27,27,54
067 Prad am Stilfser Joch,40,,25,10,35
067 Prad am Stilfser Joch,41,,26,30,56
067 Prad am Stilfser Joch,42,,19,28,47
067 Prad am Stilfser Joch,43,,19,23,42
067 Prad am Stilfser Joch,44,,32,13,45
067 Prad am Stilfser Joch,45,,21,29,50
067 Prad am Stilfser Joch,46,,27,25,52
067 Prad am Stilfser Joch,47,,24,24,48
067 Prad am Stilfser Joch,48,,29,17,46
067 Prad am Stilfser Joch,49,,28,17,45
067 Prad am Stilfser Joch,50,,25,18,43
067 Prad am Stilfser Joch,51,,14,20,34
067 Prad am Stilfser Joch,52,,20,21,41
067 Prad am Stilfser Joch,53,,22,17,39
067 Prad am Stilfser Joch,54,,21,20,41
067 Prad am Stilfser Joch,55,,19,10,29
067 Prad am Stilfser Joch,56,,15,12,27
067 Prad am Stilfser Joch,57,,17,14,31
067 Prad am Stilfser Joch,58,,16,10,26
067 Prad am Stilfser Joch,59,,11,16,27
067 Prad am Stilfser Joch,60,,25,16,41
067 Prad am Stilfser Joch,61,,16,15,31
067 Prad am Stilfser Joch,62,,21,9,30
067 Prad am Stilfser Joch,63,,11,16,27
067 Prad am Stilfser Joch,64,,14,14,28
067 Prad am Stilfser Joch,65,,17,14,31
067 Prad am Stilfser Joch,66,,9,12,21
067 Prad am Stilfser Joch,67,,12,10,22
067 Prad am Stilfser Joch,68,,16,14,30
067 Prad am Stilfser Joch,69,,8,22,30
067 Prad am Stilfser Joch,70,,12,11,23
067 Prad am Stilfser Joch,71,,13,18,31
067 Prad am Stilfser Joch,72,,7,14,21
067 Prad am Stilfser Joch,73,,12,13,25
067 Prad am Stilfser Joch,74,,8,12,20
067 Prad am Stilfser Joch,75,,7,9,16
067 Prad am Stilfser Joch,76,,6,12,18
067 Prad am Stilfser Joch,77,,9,13,22
067 Prad am Stilfser Joch,78,,9,7,16
067 Prad am Stilfser Joch,79,,4,10,14
067 Prad am Stilfser Joch,80,,3,10,13
067 Prad am Stilfser Joch,81,,6,13,19
067 Prad am Stilfser Joch,82,,5,7,12
067 Prad am Stilfser Joch,83,,4,5,9
067 Prad am Stilfser Joch,84,,5,5,10
067 Prad am Stilfser Joch,85,,1,4,5
067 Prad am Stilfser Joch,86,,-,4,4
067 Prad am Stilfser Joch,87,,-,4,4
067 Prad am Stilfser Joch,88,,3,-,3
067 Prad am Stilfser Joch,89,,2,5,7
067 Prad am Stilfser Joch,90,,-,1,1
067 Prad am Stilfser Joch,91,,3,3,6
067 Prad am Stilfser Joch,92,,-,2,2
067 Prad am Stilfser Joch,93,,1,4,5
067 Prad am Stilfser Joch,94,,-,1,1
067 Prad am Stilfser Joch,95,,-,1,1
067 Prad am Stilfser Joch,96,,1,1,2
068 Prettau,0,,3,3,6
068 Prettau,1,,1,3,4
068 Prettau,2,,3,4,7
068 Prettau,3,,2,4,6
068 Prettau,4,,6,7,13
068 Prettau,5,,6,4,10
068 Prettau,6,,3,5,8
068 Prettau,7,,1,2,3
068 Prettau,8,,6,5,11
068 Prettau,9,,5,7,12
068 Prettau,10,,4,7,11
068 Prettau,11,,3,3,6
068 Prettau,12,,1,4,5
068 Prettau,13,,1,7,8
068 Prettau,14,,-,4,4
068 Prettau,15,,5,3,8
068 Prettau,16,,5,1,6
068 Prettau,17,,2,2,4
068 Prettau,18,,2,1,3
068 Prettau,19,,3,6,9
068 Prettau,20,,4,2,6
068 Prettau,21,,2,1,3
068 Prettau,22,,2,1,3
068 Prettau,23,,4,2,6
068 Prettau,24,,5,3,8
068 Prettau,25,,1,1,2
068 Prettau,26,,4,3,7
068 Prettau,27,,2,1,3
068 Prettau,28,,4,2,6
068 Prettau,29,,5,1,6
068 Prettau,30,,5,7,12
068 Prettau,31,,9,4,13
068 Prettau,32,,4,6,10
068 Prettau,33,,3,5,8
068 Prettau,34,,8,6,14
068 Prettau,35,,4,4,8
068 Prettau,36,,10,5,15
068 Prettau,37,,6,1,7
068 Prettau,38,,5,11,16
068 Prettau,39,,8,6,14
068 Prettau,40,,5,6,11
068 Prettau,41,,2,5,7
068 Prettau,42,,5,5,10
068 Prettau,43,,8,4,12
068 Prettau,44,,5,2,7
068 Prettau,45,,7,-,7
068 Prettau,46,,4,1,5
068 Prettau,47,,6,5,11
068 Prettau,48,,6,5,11
068 Prettau,49,,6,2,8
068 Prettau,50,,3,3,6
068 Prettau,51,,4,3,7
068 Prettau,52,,2,2,4
068 Prettau,53,,2,2,4
068 Prettau,54,,2,3,5
068 Prettau,55,,2,2,4
068 Prettau,56,,4,5,9
068 Prettau,57,,8,4,12
068 Prettau,58,,1,3,4
068 Prettau,59,,6,5,11
068 Prettau,60,,4,2,6
068 Prettau,61,,3,2,5
068 Prettau,62,,3,3,6
068 Prettau,63,,4,4,8
068 Prettau,64,,4,3,7
068 Prettau,65,,5,7,12
068 Prettau,66,,2,6,8
068 Prettau,67,,3,3,6
068 Prettau,68,,6,3,9
068 Prettau,69,,1,3,4
068 Prettau,70,,3,3,6
068 Prettau,71,,3,-,3
068 Prettau,72,,2,1,3
068 Prettau,73,,5,4,9
068 Prettau,74,,4,5,9
068 Prettau,75,,-,2,2
068 Prettau,76,,3,1,4
068 Prettau,77,,1,7,8
068 Prettau,78,,1,2,3
068 Prettau,79,,1,1,2
068 Prettau,80,,-,4,4
068 Prettau,81,,2,-,2
068 Prettau,82,,1,2,3
068 Prettau,83,,1,3,4
068 Prettau,84,,3,-,3
068 Prettau,85,,1,1,2
068 Prettau,86,,1,-,1
068 Prettau,87,,2,2,4
068 Prettau,89,,-,1,1
068 Prettau,90,,-,2,2
068 Prettau,91,,-,2,2
068 Prettau,97,,-,1,1
068 Prettau,98,,-,1,1
069 Proveis,0,,1,1,2
069 Proveis,1,,4,1,5
069 Proveis,2,,3,1,4
069 Proveis,3,,-,1,1
069 Proveis,4,,4,-,4
069 Proveis,5,,2,2,4
069 Proveis,6,,1,2,3
069 Proveis,7,,1,1,2
069 Proveis,8,,-,5,5
069 Proveis,9,,2,-,2
069 Proveis,10,,2,1,3
069 Proveis,11,,3,1,4
069 Proveis,12,,3,2,5
069 Proveis,13,,-,1,1
069 Proveis,14,,1,1,2
069 Proveis,15,,2,3,5
069 Proveis,16,,2,2,4
069 Proveis,17,,3,1,4
069 Proveis,18,,5,-,5
069 Proveis,19,,3,3,6
069 Proveis,20,,3,3,6
069 Proveis,21,,2,-,2
069 Proveis,22,,2,3,5
069 Proveis,24,,3,1,4
069 Proveis,25,,2,2,4
069 Proveis,26,,2,1,3
069 Proveis,27,,2,3,5
069 Proveis,28,,2,2,4
069 Proveis,29,,5,2,7
069 Proveis,30,,2,-,2
069 Proveis,31,,1,2,3
069 Proveis,32,,-,1,1
069 Proveis,33,,3,3,6
069 Proveis,34,,3,4,7
069 Proveis,35,,5,1,6
069 Proveis,36,,2,1,3
069 Proveis,37,,2,2,4
069 Proveis,38,,1,1,2
069 Proveis,39,,3,-,3
069 Proveis,40,,4,2,6
069 Proveis,41,,4,2,6
069 Proveis,42,,4,1,5
069 Proveis,43,,-,4,4
069 Proveis,44,,4,-,4
069 Proveis,45,,1,3,4
069 Proveis,46,,2,2,4
069 Proveis,47,,4,1,5
069 Proveis,48,,4,4,8
069 Proveis,49,,3,2,5
069 Proveis,50,,1,1,2
069 Proveis,51,,2,3,5
069 Proveis,52,,2,-,2
069 Proveis,53,,1,1,2
069 Proveis,54,,1,-,1
069 Proveis,55,,2,1,3
069 Proveis,56,,2,2,4
069 Proveis,57,,3,-,3
069 Proveis,58,,1,1,2
069 Proveis,59,,2,-,2
069 Proveis,60,,2,1,3
069 Proveis,61,,1,1,2
069 Proveis,62,,1,1,2
069 Proveis,63,,3,-,3
069 Proveis,64,,1,3,4
069 Proveis,65,,-,2,2
069 Proveis,66,,2,1,3
069 Proveis,67,,2,1,3
069 Proveis,68,,1,1,2
069 Proveis,69,,-,1,1
069 Proveis,70,,-,2,2
069 Proveis,71,,1,1,2
069 Proveis,72,,2,1,3
069 Proveis,74,,3,3,6
069 Proveis,75,,3,1,4
069 Proveis,76,,-,1,1
069 Proveis,78,,-,1,1
069 Proveis,79,,2,-,2
069 Proveis,80,,1,-,1
069 Proveis,81,,-,2,2
069 Proveis,82,,-,4,4
070 Ratschings,0,,26,19,45
070 Ratschings,1,,14,30,44
070 Ratschings,2,,26,33,59
070 Ratschings,3,,35,23,58
070 Ratschings,4,,27,18,45
070 Ratschings,5,,33,22,55
070 Ratschings,6,,35,37,72
070 Ratschings,7,,29,34,63
070 Ratschings,8,,29,25,54
070 Ratschings,9,,22,29,51
070 Ratschings,10,,25,22,47
070 Ratschings,11,,40,31,71
070 Ratschings,12,,23,19,42
070 Ratschings,13,,31,27,58
070 Ratschings,14,,25,18,43
070 Ratschings,15,,35,29,64
070 Ratschings,16,,28,31,59
070 Ratschings,17,,28,26,54
070 Ratschings,18,,28,34,62
070 Ratschings,19,,26,19,45
070 Ratschings,20,,31,19,50
070 Ratschings,21,,35,24,59
070 Ratschings,22,,29,30,59
070 Ratschings,23,,23,22,45
070 Ratschings,24,,34,21,55
070 Ratschings,25,,31,24,55
070 Ratschings,26,,35,16,51
070 Ratschings,27,,23,26,49
070 Ratschings,28,,31,30,61
070 Ratschings,29,,38,25,63
070 Ratschings,30,,31,33,64
070 Ratschings,31,,34,35,69
070 Ratschings,32,,37,39,76
070 Ratschings,33,,30,37,67
070 Ratschings,34,,35,43,78
070 Ratschings,35,,47,39,86
070 Ratschings,36,,39,40,79
070 Ratschings,37,,44,43,87
070 Ratschings,38,,36,47,83
070 Ratschings,39,,48,38,86
070 Ratschings,40,,47,27,74
070 Ratschings,41,,37,39,76
070 Ratschings,42,,33,27,60
070 Ratschings,43,,39,23,62
070 Ratschings,44,,41,26,67
070 Ratschings,45,,30,20,50
070 Ratschings,46,,33,18,51
070 Ratschings,47,,34,18,52
070 Ratschings,48,,14,33,47
070 Ratschings,49,,27,15,42
070 Ratschings,50,,21,24,45
070 Ratschings,51,,22,19,41
070 Ratschings,52,,16,15,31
070 Ratschings,53,,24,20,44
070 Ratschings,54,,25,23,48
070 Ratschings,55,,32,19,51
070 Ratschings,56,,18,15,33
070 Ratschings,57,,23,6,29
070 Ratschings,58,,18,20,38
070 Ratschings,59,,18,11,29
070 Ratschings,60,,16,13,29
070 Ratschings,61,,20,19,39
070 Ratschings,62,,24,20,44
070 Ratschings,63,,17,16,33
070 Ratschings,64,,18,17,35
070 Ratschings,65,,15,20,35
070 Ratschings,66,,19,9,28
070 Ratschings,67,,14,12,26
070 Ratschings,68,,14,17,31
070 Ratschings,69,,12,8,20
070 Ratschings,70,,16,19,35
070 Ratschings,71,,16,13,29
070 Ratschings,72,,11,11,22
070 Ratschings,73,,12,17,29
070 Ratschings,74,,8,21,29
070 Ratschings,75,,9,12,21
070 Ratschings,76,,13,12,25
070 Ratschings,77,,11,13,24
070 Ratschings,78,,13,9,22
070 Ratschings,79,,10,12,22
070 Ratschings,80,,7,10,17
070 Ratschings,81,,3,10,13
070 Ratschings,82,,5,11,16
070 Ratschings,83,,2,12,14
070 Ratschings,84,,2,2,4
070 Ratschings,85,,-,6,6
070 Ratschings,87,,2,1,3
070 Ratschings,88,,2,3,5
070 Ratschings,89,,-,4,4
070 Ratschings,90,,2,1,3
070 Ratschings,91,,2,-,2
070 Ratschings,95,,-,1,1
071 Rasen-Antholz,0,,12,24,36
071 Rasen-Antholz,1,,15,24,39
071 Rasen-Antholz,2,,16,22,38
071 Rasen-Antholz,3,,25,22,47
071 Rasen-Antholz,4,,15,19,34
071 Rasen-Antholz,5,,19,13,32
071 Rasen-Antholz,6,,27,19,46
071 Rasen-Antholz,7,,26,15,41
071 Rasen-Antholz,8,,10,15,25
071 Rasen-Antholz,9,,21,11,32
071 Rasen-Antholz,10,,17,14,31
071 Rasen-Antholz,11,,27,19,46
071 Rasen-Antholz,12,,16,14,30
071 Rasen-Antholz,13,,13,26,39
071 Rasen-Antholz,14,,19,17,36
071 Rasen-Antholz,15,,20,17,37
071 Rasen-Antholz,16,,26,9,35
071 Rasen-Antholz,17,,16,20,36
071 Rasen-Antholz,18,,24,13,37
071 Rasen-Antholz,19,,18,17,35
071 Rasen-Antholz,20,,14,19,33
071 Rasen-Antholz,21,,20,24,44
071 Rasen-Antholz,22,,16,16,32
071 Rasen-Antholz,23,,19,12,31
071 Rasen-Antholz,24,,16,19,35
071 Rasen-Antholz,25,,17,18,35
071 Rasen-Antholz,26,,16,17,33
071 Rasen-Antholz,27,,20,22,42
071 Rasen-Antholz,28,,23,28,51
071 Rasen-Antholz,29,,26,20,46
071 Rasen-Antholz,30,,34,24,58
071 Rasen-Antholz,31,,27,20,47
071 Rasen-Antholz,32,,29,25,54
071 Rasen-Antholz,33,,22,27,49
071 Rasen-Antholz,34,,27,27,54
071 Rasen-Antholz,35,,27,28,55
071 Rasen-Antholz,36,,26,28,54
071 Rasen-Antholz,37,,29,19,48
071 Rasen-Antholz,38,,33,25,58
071 Rasen-Antholz,39,,28,21,49
071 Rasen-Antholz,40,,23,22,45
071 Rasen-Antholz,41,,27,20,47
071 Rasen-Antholz,42,,17,25,42
071 Rasen-Antholz,43,,20,24,44
071 Rasen-Antholz,44,,26,18,44
071 Rasen-Antholz,45,,21,16,37
071 Rasen-Antholz,46,,22,11,33
071 Rasen-Antholz,47,,18,15,33
071 Rasen-Antholz,48,,18,14,32
071 Rasen-Antholz,49,,14,13,27
071 Rasen-Antholz,50,,16,10,26
071 Rasen-Antholz,51,,12,15,27
071 Rasen-Antholz,52,,13,12,25
071 Rasen-Antholz,53,,15,8,23
071 Rasen-Antholz,54,,14,8,22
071 Rasen-Antholz,55,,14,9,23
071 Rasen-Antholz,56,,9,14,23
071 Rasen-Antholz,57,,10,14,24
071 Rasen-Antholz,58,,11,10,21
071 Rasen-Antholz,59,,10,8,18
071 Rasen-Antholz,60,,13,13,26
071 Rasen-Antholz,61,,11,14,25
071 Rasen-Antholz,62,,15,12,27
071 Rasen-Antholz,63,,10,16,26
071 Rasen-Antholz,64,,17,13,30
071 Rasen-Antholz,65,,14,8,22
071 Rasen-Antholz,66,,10,12,22
071 Rasen-Antholz,67,,9,12,21
071 Rasen-Antholz,68,,10,8,18
071 Rasen-Antholz,69,,12,10,22
071 Rasen-Antholz,70,,11,15,26
071 Rasen-Antholz,71,,15,10,25
071 Rasen-Antholz,72,,14,15,29
071 Rasen-Antholz,73,,4,11,15
071 Rasen-Antholz,74,,11,4,15
071 Rasen-Antholz,75,,4,3,7
071 Rasen-Antholz,76,,10,10,20
071 Rasen-Antholz,77,,6,6,12
071 Rasen-Antholz,78,,7,12,19
071 Rasen-Antholz,79,,6,11,17
071 Rasen-Antholz,80,,1,10,11
071 Rasen-Antholz,81,,4,6,10
071 Rasen-Antholz,82,,6,5,11
071 Rasen-Antholz,83,,2,6,8
071 Rasen-Antholz,84,,1,5,6
071 Rasen-Antholz,85,,1,3,4
071 Rasen-Antholz,86,,2,3,5
071 Rasen-Antholz,87,,-,2,2
071 Rasen-Antholz,88,,3,2,5
071 Rasen-Antholz,89,,1,1,2
071 Rasen-Antholz,90,,1,2,3
071 Rasen-Antholz,91,,1,1,2
071 Rasen-Antholz,92,,-,2,2
071 Rasen-Antholz,93,,-,1,1
071 Rasen-Antholz,94,,-,1,1
071 Rasen-Antholz,95,,1,-,1
071 Rasen-Antholz,97,,-,1,1
071 Rasen-Antholz,98,,-,1,1
072 Ritten,0,,42,37,79
072 Ritten,1,,36,50,86
072 Ritten,2,,54,47,101
072 Ritten,3,,43,42,85
072 Ritten,4,,54,53,107
072 Ritten,5,,40,47,87
072 Ritten,6,,57,54,111
072 Ritten,7,,39,52,91
072 Ritten,8,,56,45,101
072 Ritten,9,,61,48,109
072 Ritten,10,,57,52,109
072 Ritten,11,,47,72,119
072 Ritten,12,,60,50,110
072 Ritten,13,,61,46,107
072 Ritten,14,,51,44,95
072 Ritten,15,,59,55,114
072 Ritten,16,,50,40,90
072 Ritten,17,,50,43,93
072 Ritten,18,,44,46,90
072 Ritten,19,,45,24,69
072 Ritten,20,,52,41,93
072 Ritten,21,,40,49,89
072 Ritten,22,,47,51,98
072 Ritten,23,,42,39,81
072 Ritten,24,,52,40,92
072 Ritten,25,,45,36,81
072 Ritten,26,,58,39,97
072 Ritten,27,,45,43,88
072 Ritten,28,,59,43,102
072 Ritten,29,,64,61,125
072 Ritten,30,,65,47,112
072 Ritten,31,,51,57,108
072 Ritten,32,,52,67,119
072 Ritten,33,,54,68,122
072 Ritten,34,,50,64,114
072 Ritten,35,,69,63,132
072 Ritten,36,,73,54,127
072 Ritten,37,,63,51,114
072 Ritten,38,,79,45,124
072 Ritten,39,,64,57,121
072 Ritten,40,,62,54,116
072 Ritten,41,,57,61,118
072 Ritten,42,,49,58,107
072 Ritten,43,,65,62,127
072 Ritten,44,,65,48,113
072 Ritten,45,,39,44,83
072 Ritten,46,,40,40,80
072 Ritten,47,,44,42,86
072 Ritten,48,,48,38,86
072 Ritten,49,,38,32,70
072 Ritten,50,,50,32,82
072 Ritten,51,,41,44,85
072 Ritten,52,,43,34,77
072 Ritten,53,,35,42,77
072 Ritten,54,,36,43,79
072 Ritten,55,,51,32,83
072 Ritten,56,,32,29,61
072 Ritten,57,,27,38,65
072 Ritten,58,,21,25,46
072 Ritten,59,,33,40,73
072 Ritten,60,,36,38,74
072 Ritten,61,,45,36,81
072 Ritten,62,,38,39,77
072 Ritten,63,,35,25,60
072 Ritten,64,,37,33,70
072 Ritten,65,,34,33,67
072 Ritten,66,,28,26,54
072 Ritten,67,,21,24,45
072 Ritten,68,,23,30,53
072 Ritten,69,,26,28,54
072 Ritten,70,,19,26,45
072 Ritten,71,,21,23,44
072 Ritten,72,,16,34,50
072 Ritten,73,,15,21,36
072 Ritten,74,,22,21,43
072 Ritten,75,,17,13,30
072 Ritten,76,,20,18,38
072 Ritten,77,,12,21,33
072 Ritten,78,,14,35,49
072 Ritten,79,,15,28,43
072 Ritten,80,,18,25,43
072 Ritten,81,,5,21,26
072 Ritten,82,,9,20,29
072 Ritten,83,,8,19,27
072 Ritten,84,,6,13,19
072 Ritten,85,,1,6,7
072 Ritten,86,,2,9,11
072 Ritten,87,,-,3,3
072 Ritten,88,,4,6,10
072 Ritten,89,,3,5,8
072 Ritten,90,,4,6,10
072 Ritten,91,,1,4,5
072 Ritten,92,,2,3,5
072 Ritten,93,,1,4,5
072 Ritten,94,,1,1,2
072 Ritten,95,,-,1,1
072 Ritten,96,,1,1,2
072 Ritten,98,,-,1,1
073 Riffian,0,,8,1,9
073 Riffian,1,,5,5,10
073 Riffian,2,,10,8,18
073 Riffian,3,,11,8,19
073 Riffian,4,,7,11,18
073 Riffian,5,,11,9,20
073 Riffian,6,,9,8,17
073 Riffian,7,,5,6,11
073 Riffian,8,,7,10,17
073 Riffian,9,,5,8,13
073 Riffian,10,,6,6,12
073 Riffian,11,,9,9,18
073 Riffian,12,,9,12,21
073 Riffian,13,,6,7,13
073 Riffian,14,,12,5,17
073 Riffian,15,,6,11,17
073 Riffian,16,,5,8,13
073 Riffian,17,,8,6,14
073 Riffian,18,,8,2,10
073 Riffian,19,,8,7,15
073 Riffian,20,,7,8,15
073 Riffian,21,,8,11,19
073 Riffian,22,,9,6,15
073 Riffian,23,,6,5,11
073 Riffian,24,,5,8,13
073 Riffian,25,,10,6,16
073 Riffian,26,,13,7,20
073 Riffian,27,,9,3,12
073 Riffian,28,,8,9,17
073 Riffian,29,,10,5,15
073 Riffian,30,,10,9,19
073 Riffian,31,,9,18,27
073 Riffian,32,,12,14,26
073 Riffian,33,,7,7,14
073 Riffian,34,,9,12,21
073 Riffian,35,,8,13,21
073 Riffian,36,,14,14,28
073 Riffian,37,,10,5,15
073 Riffian,38,,10,6,16
073 Riffian,39,,10,8,18
073 Riffian,40,,15,10,25
073 Riffian,41,,9,9,18
073 Riffian,42,,8,8,16
073 Riffian,43,,14,5,19
073 Riffian,44,,6,13,19
073 Riffian,45,,7,6,13
073 Riffian,46,,6,11,17
073 Riffian,47,,10,4,14
073 Riffian,48,,4,8,12
073 Riffian,49,,10,6,16
073 Riffian,50,,9,5,14
073 Riffian,51,,7,3,10
073 Riffian,52,,6,10,16
073 Riffian,53,,3,3,6
073 Riffian,54,,6,6,12
073 Riffian,55,,7,3,10
073 Riffian,56,,3,4,7
073 Riffian,57,,2,6,8
073 Riffian,58,,6,3,9
073 Riffian,59,,7,9,16
073 Riffian,60,,7,7,14
073 Riffian,61,,13,7,20
073 Riffian,62,,8,3,11
073 Riffian,63,,4,3,7
073 Riffian,64,,4,9,13
073 Riffian,65,,10,4,14
073 Riffian,66,,4,5,9
073 Riffian,67,,2,5,7
073 Riffian,68,,-,3,3
073 Riffian,69,,1,3,4
073 Riffian,70,,6,5,11
073 Riffian,71,,2,3,5
073 Riffian,72,,5,9,14
073 Riffian,73,,4,3,7
073 Riffian,74,,2,7,9
073 Riffian,75,,3,4,7
073 Riffian,76,,4,6,10
073 Riffian,77,,5,2,7
073 Riffian,78,,4,3,7
073 Riffian,79,,4,2,6
073 Riffian,80,,3,6,9
073 Riffian,81,,2,-,2
073 Riffian,82,,1,3,4
073 Riffian,83,,-,3,3
073 Riffian,84,,-,2,2
073 Riffian,85,,1,-,1
073 Riffian,86,,-,3,3
073 Riffian,88,,1,-,1
073 Riffian,89,,1,3,4
073 Riffian,90,,-,1,1
073 Riffian,91,,-,1,1
073 Riffian,93,,1,-,1
073 Riffian,94,,-,2,2
073 Riffian,95,,-,2,2
074 Mühlbach,0,,22,11,33
074 Mühlbach,1,,19,17,36
074 Mühlbach,2,,12,19,31
074 Mühlbach,3,,18,18,36
074 Mühlbach,4,,19,11,30
074 Mühlbach,5,,18,15,33
074 Mühlbach,6,,18,16,34
074 Mühlbach,7,,16,18,34
074 Mühlbach,8,,13,15,28
074 Mühlbach,9,,19,13,32
074 Mühlbach,10,,18,20,38
074 Mühlbach,11,,15,23,38
074 Mühlbach,12,,14,19,33
074 Mühlbach,13,,14,14,28
074 Mühlbach,14,,14,21,35
074 Mühlbach,15,,20,17,37
074 Mühlbach,16,,21,12,33
074 Mühlbach,17,,15,9,24
074 Mühlbach,18,,17,17,34
074 Mühlbach,19,,17,22,39
074 Mühlbach,20,,17,17,34
074 Mühlbach,21,,25,25,50
074 Mühlbach,22,,22,17,39
074 Mühlbach,23,,17,14,31
074 Mühlbach,24,,19,16,35
074 Mühlbach,25,,28,23,51
074 Mühlbach,26,,22,17,39
074 Mühlbach,27,,18,24,42
074 Mühlbach,28,,16,21,37
074 Mühlbach,29,,21,17,38
074 Mühlbach,30,,22,17,39
074 Mühlbach,31,,22,21,43
074 Mühlbach,32,,25,23,48
074 Mühlbach,33,,26,14,40
074 Mühlbach,34,,27,31,58
074 Mühlbach,35,,36,19,55
074 Mühlbach,36,,21,20,41
074 Mühlbach,37,,28,17,45
074 Mühlbach,38,,18,24,42
074 Mühlbach,39,,13,19,32
074 Mühlbach,40,,22,19,41
074 Mühlbach,41,,22,16,38
074 Mühlbach,42,,24,23,47
074 Mühlbach,43,,23,14,37
074 Mühlbach,44,,20,19,39
074 Mühlbach,45,,20,12,32
074 Mühlbach,46,,16,21,37
074 Mühlbach,47,,18,21,39
074 Mühlbach,48,,21,16,37
074 Mühlbach,49,,13,22,35
074 Mühlbach,50,,19,17,36
074 Mühlbach,51,,15,20,35
074 Mühlbach,52,,13,22,35
074 Mühlbach,53,,21,17,38
074 Mühlbach,54,,15,14,29
074 Mühlbach,55,,18,13,31
074 Mühlbach,56,,12,20,32
074 Mühlbach,57,,23,11,34
074 Mühlbach,58,,10,9,19
074 Mühlbach,59,,14,12,26
074 Mühlbach,60,,11,10,21
074 Mühlbach,61,,17,14,31
074 Mühlbach,62,,19,15,34
074 Mühlbach,63,,14,9,23
074 Mühlbach,64,,13,17,30
074 Mühlbach,65,,14,7,21
074 Mühlbach,66,,5,12,17
074 Mühlbach,67,,7,7,14
074 Mühlbach,68,,8,11,19
074 Mühlbach,69,,12,13,25
074 Mühlbach,70,,9,10,19
074 Mühlbach,71,,6,10,16
074 Mühlbach,72,,6,11,17
074 Mühlbach,73,,12,7,19
074 Mühlbach,74,,7,1,8
074 Mühlbach,75,,11,18,29
074 Mühlbach,76,,5,9,14
074 Mühlbach,77,,8,8,16
074 Mühlbach,78,,6,6,12
074 Mühlbach,79,,6,7,13
074 Mühlbach,80,,5,10,15
074 Mühlbach,81,,3,11,14
074 Mühlbach,82,,4,4,8
074 Mühlbach,83,,2,8,10
074 Mühlbach,84,,2,8,10
074 Mühlbach,85,,-,3,3
074 Mühlbach,86,,1,2,3
074 Mühlbach,87,,-,1,1
074 Mühlbach,88,,-,2,2
074 Mühlbach,89,,1,4,5
074 Mühlbach,90,,1,3,4
074 Mühlbach,91,,-,1,1
074 Mühlbach,92,,1,1,2
074 Mühlbach,93,,1,1,2
074 Mühlbach,96,,-,1,1
074 Mühlbach,97,,-,2,2
074 Mühlbach,98,,-,1,1
075 Rodeneck,0,,8,8,16
075 Rodeneck,1,,8,2,10
075 Rodeneck,2,,8,5,13
075 Rodeneck,3,,6,15,21
075 Rodeneck,4,,8,9,17
075 Rodeneck,5,,12,6,18
075 Rodeneck,6,,10,7,17
075 Rodeneck,7,,13,9,22
075 Rodeneck,8,,5,9,14
075 Rodeneck,9,,8,10,18
075 Rodeneck,10,,7,7,14
075 Rodeneck,11,,9,10,19
075 Rodeneck,12,,6,9,15
075 Rodeneck,13,,12,8,20
075 Rodeneck,14,,7,6,13
075 Rodeneck,15,,13,8,21
075 Rodeneck,16,,6,5,11
075 Rodeneck,17,,9,11,20
075 Rodeneck,18,,12,9,21
075 Rodeneck,19,,15,10,25
075 Rodeneck,20,,11,7,18
075 Rodeneck,21,,7,6,13
075 Rodeneck,22,,10,6,16
075 Rodeneck,23,,7,12,19
075 Rodeneck,24,,9,4,13
075 Rodeneck,25,,6,8,14
075 Rodeneck,26,,8,10,18
075 Rodeneck,27,,7,8,15
075 Rodeneck,28,,10,7,17
075 Rodeneck,29,,8,5,13
075 Rodeneck,30,,14,10,24
075 Rodeneck,31,,9,9,18
075 Rodeneck,32,,14,5,19
075 Rodeneck,33,,11,12,23
075 Rodeneck,34,,15,11,26
075 Rodeneck,35,,9,12,21
075 Rodeneck,36,,11,10,21
075 Rodeneck,37,,13,10,23
075 Rodeneck,38,,9,7,16
075 Rodeneck,39,,10,11,21
075 Rodeneck,40,,8,9,17
075 Rodeneck,41,,9,12,21
075 Rodeneck,42,,9,11,20
075 Rodeneck,43,,5,10,15
075 Rodeneck,44,,11,6,17
075 Rodeneck,45,,8,5,13
075 Rodeneck,46,,6,6,12
075 Rodeneck,47,,9,4,13
075 Rodeneck,48,,7,6,13
075 Rodeneck,49,,11,3,14
075 Rodeneck,50,,4,1,5
075 Rodeneck,51,,8,5,13
075 Rodeneck,52,,3,3,6
075 Rodeneck,53,,2,7,9
075 Rodeneck,54,,3,6,9
075 Rodeneck,55,,4,7,11
075 Rodeneck,56,,6,4,10
075 Rodeneck,57,,10,7,17
075 Rodeneck,58,,-,5,5
075 Rodeneck,59,,5,5,10
075 Rodeneck,60,,3,2,5
075 Rodeneck,61,,2,6,8
075 Rodeneck,62,,10,3,13
075 Rodeneck,63,,5,4,9
075 Rodeneck,64,,3,9,12
075 Rodeneck,65,,4,3,7
075 Rodeneck,66,,2,4,6
075 Rodeneck,67,,4,5,9
075 Rodeneck,68,,5,2,7
075 Rodeneck,69,,1,11,12
075 Rodeneck,70,,3,2,5
075 Rodeneck,71,,6,5,11
075 Rodeneck,72,,5,4,9
075 Rodeneck,73,,4,5,9
075 Rodeneck,74,,7,2,9
075 Rodeneck,75,,4,4,8
075 Rodeneck,76,,3,5,8
075 Rodeneck,77,,4,5,9
075 Rodeneck,78,,2,7,9
075 Rodeneck,79,,3,5,8
075 Rodeneck,80,,2,1,3
075 Rodeneck,81,,1,3,4
075 Rodeneck,82,,2,1,3
075 Rodeneck,83,,2,2,4
075 Rodeneck,84,,4,2,6
075 Rodeneck,85,,-,3,3
075 Rodeneck,87,,-,1,1
075 Rodeneck,88,,1,-,1
075 Rodeneck,89,,1,-,1
075 Rodeneck,90,,-,1,1
075 Rodeneck,91,,1,-,1
075 Rodeneck,93,,2,-,2
076 Salurn,0,,21,15,36
076 Salurn,1,,13,15,28
076 Salurn,2,,12,13,25
076 Salurn,3,,16,15,31
076 Salurn,4,,19,12,31
076 Salurn,5,,16,24,40
076 Salurn,6,,16,12,28
076 Salurn,7,,21,22,43
076 Salurn,8,,18,9,27
076 Salurn,9,,19,20,39
076 Salurn,10,,17,13,30
076 Salurn,11,,19,17,36
076 Salurn,12,,12,15,27
076 Salurn,13,,12,15,27
076 Salurn,14,,18,19,37
076 Salurn,15,,17,20,37
076 Salurn,16,,21,14,35
076 Salurn,17,,13,18,31
076 Salurn,18,,18,15,33
076 Salurn,19,,10,12,22
076 Salurn,20,,11,18,29
076 Salurn,21,,19,18,37
076 Salurn,22,,16,18,34
076 Salurn,23,,19,17,36
076 Salurn,24,,11,14,25
076 Salurn,25,,15,14,29
076 Salurn,26,,24,20,44
076 Salurn,27,,17,19,36
076 Salurn,28,,19,23,42
076 Salurn,29,,13,19,32
076 Salurn,30,,19,26,45
076 Salurn,31,,23,24,47
076 Salurn,32,,36,22,58
076 Salurn,33,,27,26,53
076 Salurn,34,,30,26,56
076 Salurn,35,,30,19,49
076 Salurn,36,,22,24,46
076 Salurn,37,,26,25,51
076 Salurn,38,,31,28,59
076 Salurn,39,,36,28,64
076 Salurn,40,,38,27,65
076 Salurn,41,,31,26,57
076 Salurn,42,,31,34,65
076 Salurn,43,,20,29,49
076 Salurn,44,,27,31,58
076 Salurn,45,,27,18,45
076 Salurn,46,,17,20,37
076 Salurn,47,,21,13,34
076 Salurn,48,,18,19,37
076 Salurn,49,,24,18,42
076 Salurn,50,,14,13,27
076 Salurn,51,,27,20,47
076 Salurn,52,,28,20,48
076 Salurn,53,,23,14,37
076 Salurn,54,,24,12,36
076 Salurn,55,,16,20,36
076 Salurn,56,,18,18,36
076 Salurn,57,,21,16,37
076 Salurn,58,,13,10,23
076 Salurn,59,,17,19,36
076 Salurn,60,,19,17,36
076 Salurn,61,,18,18,36
076 Salurn,62,,19,16,35
076 Salurn,63,,13,10,23
076 Salurn,64,,10,11,21
076 Salurn,65,,6,12,18
076 Salurn,66,,11,12,23
076 Salurn,67,,12,21,33
076 Salurn,68,,16,17,33
076 Salurn,69,,11,7,18
076 Salurn,70,,11,7,18
076 Salurn,71,,10,17,27
076 Salurn,72,,6,11,17
076 Salurn,73,,10,11,21
076 Salurn,74,,20,12,32
076 Salurn,75,,9,22,31
076 Salurn,76,,5,20,25
076 Salurn,77,,7,15,22
076 Salurn,78,,6,22,28
076 Salurn,79,,6,16,22
076 Salurn,80,,6,10,16
076 Salurn,81,,7,20,27
076 Salurn,82,,3,13,16
076 Salurn,83,,9,12,21
076 Salurn,84,,6,13,19
076 Salurn,85,,5,3,8
076 Salurn,86,,1,4,5
076 Salurn,87,,2,5,7
076 Salurn,88,,4,5,9
076 Salurn,89,,4,4,8
076 Salurn,90,,-,3,3
076 Salurn,91,,3,5,8
076 Salurn,92,,-,2,2
076 Salurn,93,,1,2,3
076 Salurn,94,,-,2,2
076 Salurn,95,,-,2,2
077 Innichen,0,,20,16,36
077 Innichen,1,,14,19,33
077 Innichen,2,,24,21,45
077 Innichen,3,,16,15,31
077 Innichen,4,,12,15,27
077 Innichen,5,,21,13,34
077 Innichen,6,,22,16,38
077 Innichen,7,,16,17,33
077 Innichen,8,,22,11,33
077 Innichen,9,,19,17,36
077 Innichen,10,,23,21,44
077 Innichen,11,,22,16,38
077 Innichen,12,,20,26,46
077 Innichen,13,,19,14,33
077 Innichen,14,,18,22,40
077 Innichen,15,,29,19,48
077 Innichen,16,,23,21,44
077 Innichen,17,,20,17,37
077 Innichen,18,,21,20,41
077 Innichen,19,,21,21,42
077 Innichen,20,,21,17,38
077 Innichen,21,,19,23,42
077 Innichen,22,,13,21,34
077 Innichen,23,,23,17,40
077 Innichen,24,,28,25,53
077 Innichen,25,,12,18,30
077 Innichen,26,,16,23,39
077 Innichen,27,,17,25,42
077 Innichen,28,,23,10,33
077 Innichen,29,,28,21,49
077 Innichen,30,,22,25,47
077 Innichen,31,,26,26,52
077 Innichen,32,,25,15,40
077 Innichen,33,,24,29,53
077 Innichen,34,,23,25,48
077 Innichen,35,,26,28,54
077 Innichen,36,,23,26,49
077 Innichen,37,,26,30,56
077 Innichen,38,,34,30,64
077 Innichen,39,,34,33,67
077 Innichen,40,,29,26,55
077 Innichen,41,,29,23,52
077 Innichen,42,,22,27,49
077 Innichen,43,,32,18,50
077 Innichen,44,,26,26,52
077 Innichen,45,,20,24,44
077 Innichen,46,,20,25,45
077 Innichen,47,,29,15,44
077 Innichen,48,,26,19,45
077 Innichen,49,,24,12,36
077 Innichen,50,,23,17,40
077 Innichen,51,,13,26,39
077 Innichen,52,,12,18,30
077 Innichen,53,,18,21,39
077 Innichen,54,,21,16,37
077 Innichen,55,,19,11,30
077 Innichen,56,,10,15,25
077 Innichen,57,,15,15,30
077 Innichen,58,,11,8,19
077 Innichen,59,,8,13,21
077 Innichen,60,,23,8,31
077 Innichen,61,,17,18,35
077 Innichen,62,,13,19,32
077 Innichen,63,,11,23,34
077 Innichen,64,,15,12,27
077 Innichen,65,,9,11,20
077 Innichen,66,,12,11,23
077 Innichen,67,,9,18,27
077 Innichen,68,,8,19,27
077 Innichen,69,,12,13,25
077 Innichen,70,,11,10,21
077 Innichen,71,,11,16,27
077 Innichen,72,,14,20,34
077 Innichen,73,,15,11,26
077 Innichen,74,,13,16,29
077 Innichen,75,,11,19,30
077 Innichen,76,,6,12,18
077 Innichen,77,,16,11,27
077 Innichen,78,,5,21,26
077 Innichen,79,,8,5,13
077 Innichen,80,,5,12,17
077 Innichen,81,,4,11,15
077 Innichen,82,,5,11,16
077 Innichen,83,,6,11,17
077 Innichen,84,,1,2,3
077 Innichen,85,,-,4,4
077 Innichen,86,,1,2,3
077 Innichen,87,,2,3,5
077 Innichen,88,,4,3,7
077 Innichen,89,,3,3,6
077 Innichen,90,,2,4,6
077 Innichen,91,,1,6,7
077 Innichen,92,,-,1,1
077 Innichen,94,,-,1,1
077 Innichen,95,,-,3,3
077 Innichen,97,,-,1,1
077 Innichen,98,,-,1,1
077 Innichen,101,,-,1,1
079 Jenesien,0,,13,18,31
079 Jenesien,1,,12,15,27
079 Jenesien,2,,18,24,42
079 Jenesien,3,,17,16,33
079 Jenesien,4,,25,23,48
079 Jenesien,5,,16,27,43
079 Jenesien,6,,20,19,39
079 Jenesien,7,,24,11,35
079 Jenesien,8,,27,15,42
079 Jenesien,9,,21,23,44
079 Jenesien,10,,16,19,35
079 Jenesien,11,,28,24,52
079 Jenesien,12,,19,22,41
079 Jenesien,13,,18,15,33
079 Jenesien,14,,18,13,31
079 Jenesien,15,,23,16,39
079 Jenesien,16,,15,21,36
079 Jenesien,17,,17,16,33
079 Jenesien,18,,15,6,21
079 Jenesien,19,,21,13,34
079 Jenesien,20,,19,21,40
079 Jenesien,21,,14,22,36
079 Jenesien,22,,7,20,27
079 Jenesien,23,,15,22,37
079 Jenesien,24,,20,17,37
079 Jenesien,25,,12,13,25
079 Jenesien,26,,18,20,38
079 Jenesien,27,,16,16,32
079 Jenesien,28,,13,15,28
079 Jenesien,29,,18,19,37
079 Jenesien,30,,21,28,49
079 Jenesien,31,,22,22,44
079 Jenesien,32,,31,23,54
079 Jenesien,33,,30,30,60
079 Jenesien,34,,29,22,51
079 Jenesien,35,,18,31,49
079 Jenesien,36,,17,22,39
079 Jenesien,37,,32,28,60
079 Jenesien,38,,35,29,64
079 Jenesien,39,,35,32,67
079 Jenesien,40,,26,24,50
079 Jenesien,41,,29,23,52
079 Jenesien,42,,30,20,50
079 Jenesien,43,,26,13,39
079 Jenesien,44,,24,18,42
079 Jenesien,45,,21,10,31
079 Jenesien,46,,13,17,30
079 Jenesien,47,,17,13,30
079 Jenesien,48,,10,11,21
079 Jenesien,49,,17,14,31
079 Jenesien,50,,15,11,26
079 Jenesien,51,,12,20,32
079 Jenesien,52,,11,9,20
079 Jenesien,53,,14,21,35
079 Jenesien,54,,11,12,23
079 Jenesien,55,,12,7,19
079 Jenesien,56,,14,11,25
079 Jenesien,57,,10,12,22
079 Jenesien,58,,9,13,22
079 Jenesien,59,,14,13,27
079 Jenesien,60,,17,10,27
079 Jenesien,61,,15,10,25
079 Jenesien,62,,16,20,36
079 Jenesien,63,,17,11,28
079 Jenesien,64,,15,18,33
079 Jenesien,65,,21,9,30
079 Jenesien,66,,10,16,26
079 Jenesien,67,,6,18,24
079 Jenesien,68,,6,7,13
079 Jenesien,69,,8,7,15
079 Jenesien,70,,18,13,31
079 Jenesien,71,,7,10,17
079 Jenesien,72,,9,10,19
079 Jenesien,73,,7,15,22
079 Jenesien,74,,8,15,23
079 Jenesien,75,,10,10,20
079 Jenesien,76,,7,11,18
079 Jenesien,77,,9,12,21
079 Jenesien,78,,4,13,17
079 Jenesien,79,,9,9,18
079 Jenesien,80,,5,7,12
079 Jenesien,81,,8,7,15
079 Jenesien,82,,1,6,7
079 Jenesien,83,,3,6,9
079 Jenesien,84,,1,4,5
079 Jenesien,85,,-,1,1
079 Jenesien,86,,1,1,2
079 Jenesien,87,,2,1,3
079 Jenesien,88,,1,3,4
079 Jenesien,89,,2,2,4
079 Jenesien,90,,-,5,5
079 Jenesien,91,,1,1,2
079 Jenesien,92,,-,3,3
079 Jenesien,93,,-,1,1
079 Jenesien,95,,-,1,1
080 St.Leonhard in Pass.,0,,23,15,38
080 St.Leonhard in Pass.,1,,23,22,45
080 St.Leonhard in Pass.,2,,29,12,41
080 St.Leonhard in Pass.,3,,21,19,40
080 St.Leonhard in Pass.,4,,20,21,41
080 St.Leonhard in Pass.,5,,23,19,42
080 St.Leonhard in Pass.,6,,23,17,40
080 St.Leonhard in Pass.,7,,26,19,45
080 St.Leonhard in Pass.,8,,22,11,33
080 St.Leonhard in Pass.,9,,22,20,42
080 St.Leonhard in Pass.,10,,23,22,45
080 St.Leonhard in Pass.,11,,21,19,40
080 St.Leonhard in Pass.,12,,21,19,40
080 St.Leonhard in Pass.,13,,24,21,45
080 St.Leonhard in Pass.,14,,35,30,65
080 St.Leonhard in Pass.,15,,21,28,49
080 St.Leonhard in Pass.,16,,30,25,55
080 St.Leonhard in Pass.,17,,35,32,67
080 St.Leonhard in Pass.,18,,23,27,50
080 St.Leonhard in Pass.,19,,30,22,52
080 St.Leonhard in Pass.,20,,28,24,52
080 St.Leonhard in Pass.,21,,31,21,52
080 St.Leonhard in Pass.,22,,22,28,50
080 St.Leonhard in Pass.,23,,24,34,58
080 St.Leonhard in Pass.,24,,26,23,49
080 St.Leonhard in Pass.,25,,30,24,54
080 St.Leonhard in Pass.,26,,35,24,59
080 St.Leonhard in Pass.,27,,21,20,41
080 St.Leonhard in Pass.,28,,28,13,41
080 St.Leonhard in Pass.,29,,33,31,64
080 St.Leonhard in Pass.,30,,34,31,65
080 St.Leonhard in Pass.,31,,29,24,53
080 St.Leonhard in Pass.,32,,30,20,50
080 St.Leonhard in Pass.,33,,28,24,52
080 St.Leonhard in Pass.,34,,24,22,46
080 St.Leonhard in Pass.,35,,31,21,52
080 St.Leonhard in Pass.,36,,27,27,54
080 St.Leonhard in Pass.,37,,31,33,64
080 St.Leonhard in Pass.,38,,32,30,62
080 St.Leonhard in Pass.,39,,25,30,55
080 St.Leonhard in Pass.,40,,22,27,49
080 St.Leonhard in Pass.,41,,24,30,54
080 St.Leonhard in Pass.,42,,29,22,51
080 St.Leonhard in Pass.,43,,29,18,47
080 St.Leonhard in Pass.,44,,26,28,54
080 St.Leonhard in Pass.,45,,24,20,44
080 St.Leonhard in Pass.,46,,21,27,48
080 St.Leonhard in Pass.,47,,24,17,41
080 St.Leonhard in Pass.,48,,24,18,42
080 St.Leonhard in Pass.,49,,20,15,35
080 St.Leonhard in Pass.,50,,30,25,55
080 St.Leonhard in Pass.,51,,21,27,48
080 St.Leonhard in Pass.,52,,26,16,42
080 St.Leonhard in Pass.,53,,19,15,34
080 St.Leonhard in Pass.,54,,23,12,35
080 St.Leonhard in Pass.,55,,22,13,35
080 St.Leonhard in Pass.,56,,18,16,34
080 St.Leonhard in Pass.,57,,16,19,35
080 St.Leonhard in Pass.,58,,11,11,22
080 St.Leonhard in Pass.,59,,16,13,29
080 St.Leonhard in Pass.,60,,10,24,34
080 St.Leonhard in Pass.,61,,8,15,23
080 St.Leonhard in Pass.,62,,14,15,29
080 St.Leonhard in Pass.,63,,21,13,34
080 St.Leonhard in Pass.,64,,19,19,38
080 St.Leonhard in Pass.,65,,12,12,24
080 St.Leonhard in Pass.,66,,19,9,28
080 St.Leonhard in Pass.,67,,19,11,30
080 St.Leonhard in Pass.,68,,11,14,25
080 St.Leonhard in Pass.,69,,11,15,26
080 St.Leonhard in Pass.,70,,11,14,25
080 St.Leonhard in Pass.,71,,9,11,20
080 St.Leonhard in Pass.,72,,6,14,20
080 St.Leonhard in Pass.,73,,8,11,19
080 St.Leonhard in Pass.,74,,8,9,17
080 St.Leonhard in Pass.,75,,6,14,20
080 St.Leonhard in Pass.,76,,5,16,21
080 St.Leonhard in Pass.,77,,6,13,19
080 St.Leonhard in Pass.,78,,8,10,18
080 St.Leonhard in Pass.,79,,5,10,15
080 St.Leonhard in Pass.,80,,7,14,21
080 St.Leonhard in Pass.,81,,4,9,13
080 St.Leonhard in Pass.,82,,3,7,10
080 St.Leonhard in Pass.,83,,2,9,11
080 St.Leonhard in Pass.,84,,2,3,5
080 St.Leonhard in Pass.,85,,1,3,4
080 St.Leonhard in Pass.,86,,-,5,5
080 St.Leonhard in Pass.,87,,1,-,1
080 St.Leonhard in Pass.,88,,2,4,6
080 St.Leonhard in Pass.,89,,1,7,8
080 St.Leonhard in Pass.,90,,1,2,3
080 St.Leonhard in Pass.,91,,1,6,7
080 St.Leonhard in Pass.,92,,-,3,3
080 St.Leonhard in Pass.,94,,-,1,1
080 St.Leonhard in Pass.,95,,2,1,3
080 St.Leonhard in Pass.,96,,-,1,1
081 St.Lorenzen,0,,26,15,41
081 St.Lorenzen,1,,18,23,41
081 St.Lorenzen,2,,29,18,47
081 St.Lorenzen,3,,22,22,44
081 St.Lorenzen,4,,29,29,58
081 St.Lorenzen,5,,29,29,58
081 St.Lorenzen,6,,14,30,44
081 St.Lorenzen,7,,32,27,59
081 St.Lorenzen,8,,24,14,38
081 St.Lorenzen,9,,33,20,53
081 St.Lorenzen,10,,23,31,54
081 St.Lorenzen,11,,26,22,48
081 St.Lorenzen,12,,20,14,34
081 St.Lorenzen,13,,25,20,45
081 St.Lorenzen,14,,18,20,38
081 St.Lorenzen,15,,18,25,43
081 St.Lorenzen,16,,22,24,46
081 St.Lorenzen,17,,24,20,44
081 St.Lorenzen,18,,26,21,47
081 St.Lorenzen,19,,26,25,51
081 St.Lorenzen,20,,23,17,40
081 St.Lorenzen,21,,32,19,51
081 St.Lorenzen,22,,24,21,45
081 St.Lorenzen,23,,15,19,34
081 St.Lorenzen,24,,25,27,52
081 St.Lorenzen,25,,24,23,47
081 St.Lorenzen,26,,24,19,43
081 St.Lorenzen,27,,27,18,45
081 St.Lorenzen,28,,22,23,45
081 St.Lorenzen,29,,22,31,53
081 St.Lorenzen,30,,33,24,57
081 St.Lorenzen,31,,36,31,67
081 St.Lorenzen,32,,34,22,56
081 St.Lorenzen,33,,28,30,58
081 St.Lorenzen,34,,28,34,62
081 St.Lorenzen,35,,40,38,78
081 St.Lorenzen,36,,31,40,71
081 St.Lorenzen,37,,38,34,72
081 St.Lorenzen,38,,40,23,63
081 St.Lorenzen,39,,30,24,54
081 St.Lorenzen,40,,34,31,65
081 St.Lorenzen,41,,26,35,61
081 St.Lorenzen,42,,24,39,63
081 St.Lorenzen,43,,30,21,51
081 St.Lorenzen,44,,32,27,59
081 St.Lorenzen,45,,31,34,65
081 St.Lorenzen,46,,25,26,51
081 St.Lorenzen,47,,27,27,54
081 St.Lorenzen,48,,17,18,35
081 St.Lorenzen,49,,19,20,39
081 St.Lorenzen,50,,23,16,39
081 St.Lorenzen,51,,17,11,28
081 St.Lorenzen,52,,18,16,34
081 St.Lorenzen,53,,15,19,34
081 St.Lorenzen,54,,13,22,35
081 St.Lorenzen,55,,14,14,28
081 St.Lorenzen,56,,21,10,31
081 St.Lorenzen,57,,19,11,30
081 St.Lorenzen,58,,13,18,31
081 St.Lorenzen,59,,17,16,33
081 St.Lorenzen,60,,15,16,31
081 St.Lorenzen,61,,17,25,42
081 St.Lorenzen,62,,19,17,36
081 St.Lorenzen,63,,15,13,28
081 St.Lorenzen,64,,15,18,33
081 St.Lorenzen,65,,15,15,30
081 St.Lorenzen,66,,18,16,34
081 St.Lorenzen,67,,13,15,28
081 St.Lorenzen,68,,9,15,24
081 St.Lorenzen,69,,15,13,28
081 St.Lorenzen,70,,11,12,23
081 St.Lorenzen,71,,13,12,25
081 St.Lorenzen,72,,11,15,26
081 St.Lorenzen,73,,10,9,19
081 St.Lorenzen,74,,10,18,28
081 St.Lorenzen,75,,12,16,28
081 St.Lorenzen,76,,10,7,17
081 St.Lorenzen,77,,8,11,19
081 St.Lorenzen,78,,6,16,22
081 St.Lorenzen,79,,3,11,14
081 St.Lorenzen,80,,8,12,20
081 St.Lorenzen,81,,4,6,10
081 St.Lorenzen,82,,5,5,10
081 St.Lorenzen,83,,1,5,6
081 St.Lorenzen,84,,4,6,10
081 St.Lorenzen,85,,2,5,7
081 St.Lorenzen,86,,-,3,3
081 St.Lorenzen,87,,1,-,1
081 St.Lorenzen,88,,-,2,2
081 St.Lorenzen,89,,3,2,5
081 St.Lorenzen,90,,1,1,2
081 St.Lorenzen,91,,1,2,3
081 St.Lorenzen,92,,1,3,4
081 St.Lorenzen,93,,1,-,1
081 St.Lorenzen,94,,1,-,1
081 St.Lorenzen,96,,-,2,2
081 St.Lorenzen,98,,-,1,1
081 St.Lorenzen,100,,-,1,1
082 St.Martin in Thurn,0,,4,7,11
082 St.Martin in Thurn,1,,16,9,25
082 St.Martin in Thurn,2,,9,13,22
082 St.Martin in Thurn,3,,9,9,18
082 St.Martin in Thurn,4,,9,21,30
082 St.Martin in Thurn,5,,11,11,22
082 St.Martin in Thurn,6,,17,12,29
082 St.Martin in Thurn,7,,24,14,38
082 St.Martin in Thurn,8,,15,11,26
082 St.Martin in Thurn,9,,15,8,23
082 St.Martin in Thurn,10,,9,9,18
082 St.Martin in Thurn,11,,17,14,31
082 St.Martin in Thurn,12,,11,11,22
082 St.Martin in Thurn,13,,6,16,22
082 St.Martin in Thurn,14,,16,15,31
082 St.Martin in Thurn,15,,8,6,14
082 St.Martin in Thurn,16,,14,12,26
082 St.Martin in Thurn,17,,13,10,23
082 St.Martin in Thurn,18,,12,14,26
082 St.Martin in Thurn,19,,8,6,14
082 St.Martin in Thurn,20,,14,9,23
082 St.Martin in Thurn,21,,14,13,27
082 St.Martin in Thurn,22,,16,8,24
082 St.Martin in Thurn,23,,9,13,22
082 St.Martin in Thurn,24,,9,12,21
082 St.Martin in Thurn,25,,17,12,29
082 St.Martin in Thurn,26,,13,12,25
082 St.Martin in Thurn,27,,12,10,22
082 St.Martin in Thurn,28,,5,13,18
082 St.Martin in Thurn,29,,6,11,17
082 St.Martin in Thurn,30,,11,11,22
082 St.Martin in Thurn,31,,13,9,22
082 St.Martin in Thurn,32,,17,14,31
082 St.Martin in Thurn,33,,14,14,28
082 St.Martin in Thurn,34,,15,16,31
082 St.Martin in Thurn,35,,14,14,28
082 St.Martin in Thurn,36,,11,10,21
082 St.Martin in Thurn,37,,15,25,40
082 St.Martin in Thurn,38,,16,21,37
082 St.Martin in Thurn,39,,13,16,29
082 St.Martin in Thurn,40,,16,13,29
082 St.Martin in Thurn,41,,16,15,31
082 St.Martin in Thurn,42,,15,21,36
082 St.Martin in Thurn,43,,14,5,19
082 St.Martin in Thurn,44,,12,11,23
082 St.Martin in Thurn,45,,13,8,21
082 St.Martin in Thurn,46,,12,9,21
082 St.Martin in Thurn,47,,7,7,14
082 St.Martin in Thurn,48,,13,9,22
082 St.Martin in Thurn,49,,8,8,16
082 St.Martin in Thurn,50,,5,12,17
082 St.Martin in Thurn,51,,3,3,6
082 St.Martin in Thurn,52,,8,8,16
082 St.Martin in Thurn,53,,11,6,17
082 St.Martin in Thurn,54,,4,7,11
082 St.Martin in Thurn,55,,10,6,16
082 St.Martin in Thurn,56,,8,6,14
082 St.Martin in Thurn,57,,9,7,16
082 St.Martin in Thurn,58,,7,4,11
082 St.Martin in Thurn,59,,11,8,19
082 St.Martin in Thurn,60,,4,8,12
082 St.Martin in Thurn,61,,7,6,13
082 St.Martin in Thurn,62,,7,7,14
082 St.Martin in Thurn,63,,5,5,10
082 St.Martin in Thurn,64,,5,8,13
082 St.Martin in Thurn,65,,9,7,16
082 St.Martin in Thurn,66,,7,13,20
082 St.Martin in Thurn,67,,4,5,9
082 St.Martin in Thurn,68,,7,5,12
082 St.Martin in Thurn,69,,5,3,8
082 St.Martin in Thurn,70,,3,9,12
082 St.Martin in Thurn,71,,8,7,15
082 St.Martin in Thurn,72,,9,8,17
082 St.Martin in Thurn,73,,8,6,14
082 St.Martin in Thurn,74,,6,7,13
082 St.Martin in Thurn,75,,4,4,8
082 St.Martin in Thurn,76,,5,5,10
082 St.Martin in Thurn,77,,7,4,11
082 St.Martin in Thurn,78,,8,4,12
082 St.Martin in Thurn,79,,8,9,17
082 St.Martin in Thurn,80,,4,8,12
082 St.Martin in Thurn,81,,7,4,11
082 St.Martin in Thurn,82,,6,3,9
082 St.Martin in Thurn,83,,7,7,14
082 St.Martin in Thurn,84,,2,4,6
082 St.Martin in Thurn,85,,2,-,2
082 St.Martin in Thurn,86,,1,2,3
082 St.Martin in Thurn,87,,1,1,2
082 St.Martin in Thurn,88,,1,2,3
082 St.Martin in Thurn,89,,-,2,2
082 St.Martin in Thurn,90,,-,2,2
082 St.Martin in Thurn,91,,1,-,1
082 St.Martin in Thurn,92,,1,1,2
082 St.Martin in Thurn,93,,1,1,2
082 St.Martin in Thurn,95,,2,-,2
082 St.Martin in Thurn,99,,1,-,1
083 St.Martin in Passeier,0,,18,18,36
083 St.Martin in Passeier,1,,17,11,28
083 St.Martin in Passeier,2,,16,18,34
083 St.Martin in Passeier,3,,13,19,32
083 St.Martin in Passeier,4,,7,19,26
083 St.Martin in Passeier,5,,19,21,40
083 St.Martin in Passeier,6,,28,26,54
083 St.Martin in Passeier,7,,21,22,43
083 St.Martin in Passeier,8,,18,17,35
083 St.Martin in Passeier,9,,20,22,42
083 St.Martin in Passeier,10,,20,23,43
083 St.Martin in Passeier,11,,21,20,41
083 St.Martin in Passeier,12,,21,24,45
083 St.Martin in Passeier,13,,19,25,44
083 St.Martin in Passeier,14,,19,21,40
083 St.Martin in Passeier,15,,15,15,30
083 St.Martin in Passeier,16,,18,22,40
083 St.Martin in Passeier,17,,21,25,46
083 St.Martin in Passeier,18,,16,18,34
083 St.Martin in Passeier,19,,16,25,41
083 St.Martin in Passeier,20,,19,10,29
083 St.Martin in Passeier,21,,21,21,42
083 St.Martin in Passeier,22,,21,22,43
083 St.Martin in Passeier,23,,19,22,41
083 St.Martin in Passeier,24,,22,15,37
083 St.Martin in Passeier,25,,29,17,46
083 St.Martin in Passeier,26,,22,24,46
083 St.Martin in Passeier,27,,19,22,41
083 St.Martin in Passeier,28,,25,20,45
083 St.Martin in Passeier,29,,19,21,40
083 St.Martin in Passeier,30,,26,28,54
083 St.Martin in Passeier,31,,26,23,49
083 St.Martin in Passeier,32,,29,26,55
083 St.Martin in Passeier,33,,29,24,53
083 St.Martin in Passeier,34,,31,27,58
083 St.Martin in Passeier,35,,25,23,48
083 St.Martin in Passeier,36,,22,23,45
083 St.Martin in Passeier,37,,29,30,59
083 St.Martin in Passeier,38,,30,24,54
083 St.Martin in Passeier,39,,21,20,41
083 St.Martin in Passeier,40,,34,19,53
083 St.Martin in Passeier,41,,22,28,50
083 St.Martin in Passeier,42,,35,20,55
083 St.Martin in Passeier,43,,20,24,44
083 St.Martin in Passeier,44,,26,20,46
083 St.Martin in Passeier,45,,24,21,45
083 St.Martin in Passeier,46,,25,11,36
083 St.Martin in Passeier,47,,21,15,36
083 St.Martin in Passeier,48,,32,16,48
083 St.Martin in Passeier,49,,14,10,24
083 St.Martin in Passeier,50,,21,16,37
083 St.Martin in Passeier,51,,5,19,24
083 St.Martin in Passeier,52,,19,14,33
083 St.Martin in Passeier,53,,12,15,27
083 St.Martin in Passeier,54,,13,8,21
083 St.Martin in Passeier,55,,11,10,21
083 St.Martin in Passeier,56,,14,13,27
083 St.Martin in Passeier,57,,14,11,25
083 St.Martin in Passeier,58,,12,12,24
083 St.Martin in Passeier,59,,17,13,30
083 St.Martin in Passeier,60,,14,11,25
083 St.Martin in Passeier,61,,15,14,29
083 St.Martin in Passeier,62,,10,15,25
083 St.Martin in Passeier,63,,4,13,17
083 St.Martin in Passeier,64,,6,12,18
083 St.Martin in Passeier,65,,13,8,21
083 St.Martin in Passeier,66,,15,19,34
083 St.Martin in Passeier,67,,13,15,28
083 St.Martin in Passeier,68,,7,13,20
083 St.Martin in Passeier,69,,17,9,26
083 St.Martin in Passeier,70,,13,9,22
083 St.Martin in Passeier,71,,8,9,17
083 St.Martin in Passeier,72,,7,12,19
083 St.Martin in Passeier,73,,7,12,19
083 St.Martin in Passeier,74,,12,9,21
083 St.Martin in Passeier,75,,7,8,15
083 St.Martin in Passeier,76,,12,6,18
083 St.Martin in Passeier,77,,4,11,15
083 St.Martin in Passeier,78,,5,8,13
083 St.Martin in Passeier,79,,5,12,17
083 St.Martin in Passeier,80,,1,8,9
083 St.Martin in Passeier,81,,5,5,10
083 St.Martin in Passeier,82,,4,10,14
083 St.Martin in Passeier,83,,-,5,5
083 St.Martin in Passeier,84,,1,3,4
083 St.Martin in Passeier,85,,1,2,3
083 St.Martin in Passeier,86,,2,4,6
083 St.Martin in Passeier,87,,-,1,1
083 St.Martin in Passeier,88,,1,1,2
083 St.Martin in Passeier,89,,1,4,5
083 St.Martin in Passeier,90,,-,1,1
083 St.Martin in Passeier,91,,-,3,3
083 St.Martin in Passeier,92,,1,1,2
083 St.Martin in Passeier,93,,-,1,1
084 St.Pankraz,0,,12,7,19
084 St.Pankraz,1,,8,4,12
084 St.Pankraz,2,,13,15,28
084 St.Pankraz,3,,12,15,27
084 St.Pankraz,4,,9,5,14
084 St.Pankraz,5,,13,6,19
084 St.Pankraz,6,,9,11,20
084 St.Pankraz,7,,12,9,21
084 St.Pankraz,8,,11,5,16
084 St.Pankraz,9,,9,9,18
084 St.Pankraz,10,,5,12,17
084 St.Pankraz,11,,6,8,14
084 St.Pankraz,12,,13,12,25
084 St.Pankraz,13,,9,4,13
084 St.Pankraz,14,,11,14,25
084 St.Pankraz,15,,15,7,22
084 St.Pankraz,16,,10,8,18
084 St.Pankraz,17,,9,6,15
084 St.Pankraz,18,,9,7,16
084 St.Pankraz,19,,10,5,15
084 St.Pankraz,20,,11,7,18
084 St.Pankraz,21,,12,9,21
084 St.Pankraz,22,,10,15,25
084 St.Pankraz,23,,13,8,21
084 St.Pankraz,24,,7,5,12
084 St.Pankraz,25,,15,10,25
084 St.Pankraz,26,,8,11,19
084 St.Pankraz,27,,5,10,15
084 St.Pankraz,28,,9,8,17
084 St.Pankraz,29,,13,12,25
084 St.Pankraz,30,,12,10,22
084 St.Pankraz,31,,10,17,27
084 St.Pankraz,32,,17,10,27
084 St.Pankraz,33,,12,11,23
084 St.Pankraz,34,,18,11,29
084 St.Pankraz,35,,18,19,37
084 St.Pankraz,36,,13,15,28
084 St.Pankraz,37,,15,6,21
084 St.Pankraz,38,,23,14,37
084 St.Pankraz,39,,15,16,31
084 St.Pankraz,40,,8,10,18
084 St.Pankraz,41,,17,7,24
084 St.Pankraz,42,,14,13,27
084 St.Pankraz,43,,13,6,19
084 St.Pankraz,44,,17,12,29
084 St.Pankraz,45,,7,9,16
084 St.Pankraz,46,,11,9,20
084 St.Pankraz,47,,10,15,25
084 St.Pankraz,48,,6,4,10
084 St.Pankraz,49,,10,8,18
084 St.Pankraz,50,,11,9,20
084 St.Pankraz,51,,16,10,26
084 St.Pankraz,52,,5,3,8
084 St.Pankraz,53,,11,6,17
084 St.Pankraz,54,,7,6,13
084 St.Pankraz,55,,8,3,11
084 St.Pankraz,56,,7,8,15
084 St.Pankraz,57,,4,7,11
084 St.Pankraz,58,,3,6,9
084 St.Pankraz,59,,5,7,12
084 St.Pankraz,60,,10,15,25
084 St.Pankraz,61,,9,14,23
084 St.Pankraz,62,,8,12,20
084 St.Pankraz,63,,8,6,14
084 St.Pankraz,64,,10,7,17
084 St.Pankraz,65,,5,11,16
084 St.Pankraz,66,,9,10,19
084 St.Pankraz,67,,6,5,11
084 St.Pankraz,68,,4,7,11
084 St.Pankraz,69,,7,6,13
084 St.Pankraz,70,,8,3,11
084 St.Pankraz,71,,7,10,17
084 St.Pankraz,72,,9,5,14
084 St.Pankraz,73,,8,7,15
084 St.Pankraz,74,,7,10,17
084 St.Pankraz,75,,7,9,16
084 St.Pankraz,76,,7,4,11
084 St.Pankraz,77,,6,6,12
084 St.Pankraz,78,,7,8,15
084 St.Pankraz,79,,6,8,14
084 St.Pankraz,80,,11,3,14
084 St.Pankraz,81,,8,8,16
084 St.Pankraz,82,,2,8,10
084 St.Pankraz,83,,2,9,11
084 St.Pankraz,84,,2,2,4
084 St.Pankraz,85,,2,2,4
084 St.Pankraz,86,,-,2,2
084 St.Pankraz,87,,2,-,2
084 St.Pankraz,88,,1,2,3
084 St.Pankraz,89,,1,2,3
084 St.Pankraz,90,,1,1,2
084 St.Pankraz,91,,1,1,2
084 St.Pankraz,92,,-,1,1
084 St.Pankraz,93,,-,1,1
084 St.Pankraz,94,,-,4,4
085 St.Christina in Gröden,0,,10,6,16
085 St.Christina in Gröden,1,,12,18,30
085 St.Christina in Gröden,2,,10,12,22
085 St.Christina in Gröden,3,,22,13,35
085 St.Christina in Gröden,4,,19,10,29
085 St.Christina in Gröden,5,,12,14,26
085 St.Christina in Gröden,6,,11,10,21
085 St.Christina in Gröden,7,,12,5,17
085 St.Christina in Gröden,8,,15,9,24
085 St.Christina in Gröden,9,,7,14,21
085 St.Christina in Gröden,10,,13,14,27
085 St.Christina in Gröden,11,,13,13,26
085 St.Christina in Gröden,12,,12,16,28
085 St.Christina in Gröden,13,,7,13,20
085 St.Christina in Gröden,14,,6,6,12
085 St.Christina in Gröden,15,,10,11,21
085 St.Christina in Gröden,16,,12,6,18
085 St.Christina in Gröden,17,,11,8,19
085 St.Christina in Gröden,18,,5,11,16
085 St.Christina in Gröden,19,,11,5,16
085 St.Christina in Gröden,20,,18,13,31
085 St.Christina in Gröden,21,,12,5,17
085 St.Christina in Gröden,22,,8,14,22
085 St.Christina in Gröden,23,,11,13,24
085 St.Christina in Gröden,24,,13,10,23
085 St.Christina in Gröden,25,,5,11,16
085 St.Christina in Gröden,26,,5,10,15
085 St.Christina in Gröden,27,,14,8,22
085 St.Christina in Gröden,28,,15,15,30
085 St.Christina in Gröden,29,,7,16,23
085 St.Christina in Gröden,30,,7,12,19
085 St.Christina in Gröden,31,,17,9,26
085 St.Christina in Gröden,32,,10,17,27
085 St.Christina in Gröden,33,,21,18,39
085 St.Christina in Gröden,34,,17,10,27
085 St.Christina in Gröden,35,,23,23,46
085 St.Christina in Gröden,36,,17,17,34
085 St.Christina in Gröden,37,,19,11,30
085 St.Christina in Gröden,38,,15,16,31
085 St.Christina in Gröden,39,,11,21,32
085 St.Christina in Gröden,40,,14,17,31
085 St.Christina in Gröden,41,,19,15,34
085 St.Christina in Gröden,42,,22,15,37
085 St.Christina in Gröden,43,,19,18,37
085 St.Christina in Gröden,44,,9,7,16
085 St.Christina in Gröden,45,,7,11,18
085 St.Christina in Gröden,46,,16,10,26
085 St.Christina in Gröden,47,,10,10,20
085 St.Christina in Gröden,48,,9,9,18
085 St.Christina in Gröden,49,,17,14,31
085 St.Christina in Gröden,50,,10,9,19
085 St.Christina in Gröden,51,,4,7,11
085 St.Christina in Gröden,52,,11,5,16
085 St.Christina in Gröden,53,,6,5,11
085 St.Christina in Gröden,54,,7,13,20
085 St.Christina in Gröden,55,,8,5,13
085 St.Christina in Gröden,56,,6,8,14
085 St.Christina in Gröden,57,,9,11,20
085 St.Christina in Gröden,58,,6,6,12
085 St.Christina in Gröden,59,,6,11,17
085 St.Christina in Gröden,60,,12,15,27
085 St.Christina in Gröden,61,,11,7,18
085 St.Christina in Gröden,62,,12,8,20
085 St.Christina in Gröden,63,,9,11,20
085 St.Christina in Gröden,64,,10,11,21
085 St.Christina in Gröden,65,,7,8,15
085 St.Christina in Gröden,66,,9,6,15
085 St.Christina in Gröden,67,,13,10,23
085 St.Christina in Gröden,68,,13,5,18
085 St.Christina in Gröden,69,,7,12,19
085 St.Christina in Gröden,70,,6,13,19
085 St.Christina in Gröden,71,,9,9,18
085 St.Christina in Gröden,72,,5,7,12
085 St.Christina in Gröden,73,,14,5,19
085 St.Christina in Gröden,74,,3,10,13
085 St.Christina in Gröden,75,,6,5,11
085 St.Christina in Gröden,76,,5,5,10
085 St.Christina in Gröden,77,,9,6,15
085 St.Christina in Gröden,78,,6,9,15
085 St.Christina in Gröden,79,,2,3,5
085 St.Christina in Gröden,80,,4,4,8
085 St.Christina in Gröden,81,,-,9,9
085 St.Christina in Gröden,82,,1,4,5
085 St.Christina in Gröden,83,,1,4,5
085 St.Christina in Gröden,84,,3,1,4
085 St.Christina in Gröden,85,,-,1,1
085 St.Christina in Gröden,87,,-,2,2
085 St.Christina in Gröden,88,,2,1,3
085 St.Christina in Gröden,89,,1,2,3
085 St.Christina in Gröden,90,,2,-,2
085 St.Christina in Gröden,91,,-,1,1
085 St.Christina in Gröden,93,,-,1,1
085 St.Christina in Gröden,94,,-,1,1
086 Sarntal,0,,45,34,79
086 Sarntal,1,,28,45,73
086 Sarntal,2,,51,27,78
086 Sarntal,3,,36,42,78
086 Sarntal,4,,35,35,70
086 Sarntal,5,,51,43,94
086 Sarntal,6,,43,48,91
086 Sarntal,7,,48,41,89
086 Sarntal,8,,44,42,86
086 Sarntal,9,,33,41,74
086 Sarntal,10,,33,40,73
086 Sarntal,11,,46,36,82
086 Sarntal,12,,43,41,84
086 Sarntal,13,,45,33,78
086 Sarntal,14,,55,36,91
086 Sarntal,15,,44,42,86
086 Sarntal,16,,36,31,67
086 Sarntal,17,,37,42,79
086 Sarntal,18,,43,38,81
086 Sarntal,19,,39,41,80
086 Sarntal,20,,53,43,96
086 Sarntal,21,,60,46,106
086 Sarntal,22,,42,57,99
086 Sarntal,23,,59,45,104
086 Sarntal,24,,59,54,113
086 Sarntal,25,,58,54,112
086 Sarntal,26,,62,43,105
086 Sarntal,27,,51,42,93
086 Sarntal,28,,60,52,112
086 Sarntal,29,,50,64,114
086 Sarntal,30,,62,63,125
086 Sarntal,31,,69,39,108
086 Sarntal,32,,46,50,96
086 Sarntal,33,,69,59,128
086 Sarntal,34,,65,55,120
086 Sarntal,35,,52,44,96
086 Sarntal,36,,54,47,101
086 Sarntal,37,,54,52,106
086 Sarntal,38,,67,53,120
086 Sarntal,39,,59,60,119
086 Sarntal,40,,44,41,85
086 Sarntal,41,,62,34,96
086 Sarntal,42,,39,46,85
086 Sarntal,43,,65,46,111
086 Sarntal,44,,43,40,83
086 Sarntal,45,,53,43,96
086 Sarntal,46,,39,43,82
086 Sarntal,47,,40,32,72
086 Sarntal,48,,41,40,81
086 Sarntal,49,,36,29,65
086 Sarntal,50,,40,30,70
086 Sarntal,51,,38,41,79
086 Sarntal,52,,46,34,80
086 Sarntal,53,,37,35,72
086 Sarntal,54,,51,25,76
086 Sarntal,55,,33,38,71
086 Sarntal,56,,39,28,67
086 Sarntal,57,,36,37,73
086 Sarntal,58,,29,33,62
086 Sarntal,59,,29,31,60
086 Sarntal,60,,40,41,81
086 Sarntal,61,,39,39,78
086 Sarntal,62,,34,32,66
086 Sarntal,63,,29,43,72
086 Sarntal,64,,40,32,72
086 Sarntal,65,,33,27,60
086 Sarntal,66,,26,33,59
086 Sarntal,67,,21,25,46
086 Sarntal,68,,23,25,48
086 Sarntal,69,,26,19,45
086 Sarntal,70,,23,24,47
086 Sarntal,71,,28,24,52
086 Sarntal,72,,19,25,44
086 Sarntal,73,,18,25,43
086 Sarntal,74,,20,30,50
086 Sarntal,75,,21,28,49
086 Sarntal,76,,18,32,50
086 Sarntal,77,,20,13,33
086 Sarntal,78,,19,19,38
086 Sarntal,79,,14,24,38
086 Sarntal,80,,9,24,33
086 Sarntal,81,,11,31,42
086 Sarntal,82,,6,13,19
086 Sarntal,83,,11,16,27
086 Sarntal,84,,3,16,19
086 Sarntal,85,,2,8,10
086 Sarntal,86,,3,7,10
086 Sarntal,87,,-,6,6
086 Sarntal,88,,2,4,6
086 Sarntal,89,,4,4,8
086 Sarntal,90,,7,8,15
086 Sarntal,91,,2,7,9
086 Sarntal,92,,2,3,5
086 Sarntal,93,,1,4,5
086 Sarntal,94,,1,3,4
086 Sarntal,95,,-,1,1
086 Sarntal,96,,1,2,3
087 Schenna,0,,12,13,25
087 Schenna,1,,15,18,33
087 Schenna,2,,20,12,32
087 Schenna,3,,20,18,38
087 Schenna,4,,21,16,37
087 Schenna,5,,17,12,29
087 Schenna,6,,11,18,29
087 Schenna,7,,17,16,33
087 Schenna,8,,17,17,34
087 Schenna,9,,20,17,37
087 Schenna,10,,13,8,21
087 Schenna,11,,16,16,32
087 Schenna,12,,12,20,32
087 Schenna,13,,19,16,35
087 Schenna,14,,20,10,30
087 Schenna,15,,21,19,40
087 Schenna,16,,22,17,39
087 Schenna,17,,19,13,32
087 Schenna,18,,16,16,32
087 Schenna,19,,14,14,28
087 Schenna,20,,16,13,29
087 Schenna,21,,11,15,26
087 Schenna,22,,22,10,32
087 Schenna,23,,19,19,38
087 Schenna,24,,24,19,43
087 Schenna,25,,16,19,35
087 Schenna,26,,18,20,38
087 Schenna,27,,24,17,41
087 Schenna,28,,18,28,46
087 Schenna,29,,31,21,52
087 Schenna,30,,26,21,47
087 Schenna,31,,28,15,43
087 Schenna,32,,30,25,55
087 Schenna,33,,22,25,47
087 Schenna,34,,24,20,44
087 Schenna,35,,23,20,43
087 Schenna,36,,30,21,51
087 Schenna,37,,17,19,36
087 Schenna,38,,24,26,50
087 Schenna,39,,20,25,45
087 Schenna,40,,26,19,45
087 Schenna,41,,22,13,35
087 Schenna,42,,30,22,52
087 Schenna,43,,32,24,56
087 Schenna,44,,16,13,29
087 Schenna,45,,20,19,39
087 Schenna,46,,14,18,32
087 Schenna,47,,17,16,33
087 Schenna,48,,12,15,27
087 Schenna,49,,14,18,32
087 Schenna,50,,15,15,30
087 Schenna,51,,14,16,30
087 Schenna,52,,14,13,27
087 Schenna,53,,19,14,33
087 Schenna,54,,21,18,39
087 Schenna,55,,15,15,30
087 Schenna,56,,16,17,33
087 Schenna,57,,18,23,41
087 Schenna,58,,15,13,28
087 Schenna,59,,17,9,26
087 Schenna,60,,20,11,31
087 Schenna,61,,11,19,30
087 Schenna,62,,12,13,25
087 Schenna,63,,10,9,19
087 Schenna,64,,11,14,25
087 Schenna,65,,17,20,37
087 Schenna,66,,7,10,17
087 Schenna,67,,8,11,19
087 Schenna,68,,13,10,23
087 Schenna,69,,13,15,28
087 Schenna,70,,7,9,16
087 Schenna,71,,10,11,21
087 Schenna,72,,13,11,24
087 Schenna,73,,11,7,18
087 Schenna,74,,6,10,16
087 Schenna,75,,7,10,17
087 Schenna,76,,5,15,20
087 Schenna,77,,5,7,12
087 Schenna,78,,3,9,12
087 Schenna,79,,9,8,17
087 Schenna,80,,5,4,9
087 Schenna,81,,10,5,15
087 Schenna,82,,6,12,18
087 Schenna,83,,4,5,9
087 Schenna,84,,2,6,8
087 Schenna,85,,-,4,4
087 Schenna,86,,1,1,2
087 Schenna,87,,1,1,2
087 Schenna,88,,2,2,4
087 Schenna,89,,3,3,6
087 Schenna,90,,-,2,2
087 Schenna,91,,3,2,5
087 Schenna,93,,1,1,2
087 Schenna,94,,1,1,2
087 Schenna,97,,-,1,1
087 Schenna,99,,-,1,1
087 Schenna,103,,-,1,1
088 Mühlwald,0,,17,9,26
088 Mühlwald,1,,10,13,23
088 Mühlwald,2,,10,13,23
088 Mühlwald,3,,8,11,19
088 Mühlwald,4,,12,8,20
088 Mühlwald,5,,12,14,26
088 Mühlwald,6,,11,8,19
088 Mühlwald,7,,14,13,27
088 Mühlwald,8,,13,4,17
088 Mühlwald,9,,9,6,15
088 Mühlwald,10,,13,12,25
088 Mühlwald,11,,5,7,12
088 Mühlwald,12,,11,6,17
088 Mühlwald,13,,9,6,15
088 Mühlwald,14,,16,8,24
088 Mühlwald,15,,7,3,10
088 Mühlwald,16,,9,14,23
088 Mühlwald,17,,6,7,13
088 Mühlwald,18,,11,18,29
088 Mühlwald,19,,11,18,29
088 Mühlwald,20,,12,9,21
088 Mühlwald,21,,8,17,25
088 Mühlwald,22,,16,15,31
088 Mühlwald,23,,21,4,25
088 Mühlwald,24,,7,20,27
088 Mühlwald,25,,12,9,21
088 Mühlwald,26,,8,8,16
088 Mühlwald,27,,13,9,22
088 Mühlwald,28,,11,9,20
088 Mühlwald,29,,10,7,17
088 Mühlwald,30,,17,8,25
088 Mühlwald,31,,10,10,20
088 Mühlwald,32,,17,16,33
088 Mühlwald,33,,9,11,20
088 Mühlwald,34,,14,16,30
088 Mühlwald,35,,17,9,26
088 Mühlwald,36,,18,14,32
088 Mühlwald,37,,15,8,23
088 Mühlwald,38,,17,13,30
088 Mühlwald,39,,17,10,27
088 Mühlwald,40,,11,11,22
088 Mühlwald,41,,8,11,19
088 Mühlwald,42,,6,10,16
088 Mühlwald,43,,15,9,24
088 Mühlwald,44,,13,5,18
088 Mühlwald,45,,9,6,15
088 Mühlwald,46,,13,12,25
088 Mühlwald,47,,8,8,16
088 Mühlwald,48,,7,8,15
088 Mühlwald,49,,10,4,14
088 Mühlwald,50,,10,9,19
088 Mühlwald,51,,10,8,18
088 Mühlwald,52,,9,4,13
088 Mühlwald,53,,5,9,14
088 Mühlwald,54,,9,3,12
088 Mühlwald,55,,12,4,16
088 Mühlwald,56,,10,7,17
088 Mühlwald,57,,8,3,11
088 Mühlwald,58,,5,4,9
088 Mühlwald,59,,8,4,12
088 Mühlwald,60,,10,2,12
088 Mühlwald,61,,5,7,12
088 Mühlwald,62,,4,7,11
088 Mühlwald,63,,3,8,11
088 Mühlwald,64,,6,11,17
088 Mühlwald,65,,9,4,13
088 Mühlwald,66,,11,3,14
088 Mühlwald,67,,4,3,7
088 Mühlwald,68,,5,3,8
088 Mühlwald,69,,3,7,10
088 Mühlwald,70,,4,10,14
088 Mühlwald,71,,1,2,3
088 Mühlwald,72,,5,5,10
088 Mühlwald,73,,4,5,9
088 Mühlwald,74,,7,8,15
088 Mühlwald,75,,4,4,8
088 Mühlwald,76,,9,2,11
088 Mühlwald,77,,4,5,9
088 Mühlwald,78,,3,3,6
088 Mühlwald,79,,6,5,11
088 Mühlwald,80,,1,5,6
088 Mühlwald,81,,-,4,4
088 Mühlwald,82,,-,5,5
088 Mühlwald,83,,1,1,2
088 Mühlwald,84,,-,2,2
088 Mühlwald,85,,1,2,3
088 Mühlwald,86,,3,2,5
088 Mühlwald,87,,-,1,1
088 Mühlwald,88,,-,3,3
088 Mühlwald,89,,1,1,2
088 Mühlwald,90,,-,2,2
088 Mühlwald,92,,-,2,2
088 Mühlwald,95,,1,-,1
089 Wolkenstein in Gröden,0,,12,16,28
089 Wolkenstein in Gröden,1,,25,15,40
089 Wolkenstein in Gröden,2,,22,19,41
089 Wolkenstein in Gröden,3,,21,21,42
089 Wolkenstein in Gröden,4,,14,20,34
089 Wolkenstein in Gröden,5,,14,24,38
089 Wolkenstein in Gröden,6,,22,29,51
089 Wolkenstein in Gröden,7,,15,12,27
089 Wolkenstein in Gröden,8,,18,12,30
089 Wolkenstein in Gröden,9,,16,17,33
089 Wolkenstein in Gröden,10,,12,13,25
089 Wolkenstein in Gröden,11,,23,14,37
089 Wolkenstein in Gröden,12,,19,17,36
089 Wolkenstein in Gröden,13,,13,12,25
089 Wolkenstein in Gröden,14,,17,14,31
089 Wolkenstein in Gröden,15,,17,17,34
089 Wolkenstein in Gröden,16,,11,20,31
089 Wolkenstein in Gröden,17,,16,14,30
089 Wolkenstein in Gröden,18,,16,11,27
089 Wolkenstein in Gröden,19,,13,11,24
089 Wolkenstein in Gröden,20,,16,10,26
089 Wolkenstein in Gröden,21,,11,16,27
089 Wolkenstein in Gröden,22,,16,11,27
089 Wolkenstein in Gröden,23,,15,15,30
089 Wolkenstein in Gröden,24,,7,12,19
089 Wolkenstein in Gröden,25,,7,9,16
089 Wolkenstein in Gröden,26,,10,12,22
089 Wolkenstein in Gröden,27,,18,14,32
089 Wolkenstein in Gröden,28,,19,18,37
089 Wolkenstein in Gröden,29,,10,21,31
089 Wolkenstein in Gröden,30,,27,20,47
089 Wolkenstein in Gröden,31,,17,19,36
089 Wolkenstein in Gröden,32,,21,26,47
089 Wolkenstein in Gröden,33,,22,27,49
089 Wolkenstein in Gröden,34,,28,20,48
089 Wolkenstein in Gröden,35,,27,29,56
089 Wolkenstein in Gröden,36,,31,25,56
089 Wolkenstein in Gröden,37,,28,21,49
089 Wolkenstein in Gröden,38,,25,32,57
089 Wolkenstein in Gröden,39,,29,22,51
089 Wolkenstein in Gröden,40,,22,20,42
089 Wolkenstein in Gröden,41,,20,24,44
089 Wolkenstein in Gröden,42,,25,28,53
089 Wolkenstein in Gröden,43,,25,22,47
089 Wolkenstein in Gröden,44,,16,17,33
089 Wolkenstein in Gröden,45,,20,16,36
089 Wolkenstein in Gröden,46,,20,17,37
089 Wolkenstein in Gröden,47,,12,13,25
089 Wolkenstein in Gröden,48,,15,9,24
089 Wolkenstein in Gröden,49,,15,9,24
089 Wolkenstein in Gröden,50,,8,14,22
089 Wolkenstein in Gröden,51,,12,7,19
089 Wolkenstein in Gröden,52,,15,11,26
089 Wolkenstein in Gröden,53,,6,17,23
089 Wolkenstein in Gröden,54,,17,12,29
089 Wolkenstein in Gröden,55,,13,14,27
089 Wolkenstein in Gröden,56,,11,17,28
089 Wolkenstein in Gröden,57,,16,19,35
089 Wolkenstein in Gröden,58,,5,14,19
089 Wolkenstein in Gröden,59,,14,10,24
089 Wolkenstein in Gröden,60,,20,16,36
089 Wolkenstein in Gröden,61,,13,12,25
089 Wolkenstein in Gröden,62,,16,18,34
089 Wolkenstein in Gröden,63,,16,18,34
089 Wolkenstein in Gröden,64,,17,15,32
089 Wolkenstein in Gröden,65,,19,7,26
089 Wolkenstein in Gröden,66,,11,19,30
089 Wolkenstein in Gröden,67,,11,15,26
089 Wolkenstein in Gröden,68,,14,9,23
089 Wolkenstein in Gröden,69,,17,10,27
089 Wolkenstein in Gröden,70,,7,11,18
089 Wolkenstein in Gröden,71,,5,9,14
089 Wolkenstein in Gröden,72,,8,10,18
089 Wolkenstein in Gröden,73,,10,11,21
089 Wolkenstein in Gröden,74,,8,7,15
089 Wolkenstein in Gröden,75,,6,10,16
089 Wolkenstein in Gröden,76,,10,6,16
089 Wolkenstein in Gröden,77,,9,6,15
089 Wolkenstein in Gröden,78,,6,7,13
089 Wolkenstein in Gröden,79,,3,11,14
089 Wolkenstein in Gröden,80,,4,6,10
089 Wolkenstein in Gröden,81,,5,9,14
089 Wolkenstein in Gröden,82,,2,5,7
089 Wolkenstein in Gröden,83,,3,4,7
089 Wolkenstein in Gröden,84,,1,2,3
089 Wolkenstein in Gröden,85,,-,2,2
089 Wolkenstein in Gröden,86,,1,3,4
089 Wolkenstein in Gröden,88,,-,4,4
089 Wolkenstein in Gröden,89,,1,2,3
089 Wolkenstein in Gröden,90,,-,1,1
089 Wolkenstein in Gröden,91,,-,4,4
089 Wolkenstein in Gröden,92,,-,3,3
089 Wolkenstein in Gröden,94,,-,1,1
089 Wolkenstein in Gröden,95,,-,2,2
089 Wolkenstein in Gröden,96,,-,1,1
091 Schnals,0,,4,5,9
091 Schnals,1,,12,-,12
091 Schnals,2,,4,5,9
091 Schnals,3,,5,4,9
091 Schnals,4,,6,9,15
091 Schnals,5,,7,16,23
091 Schnals,6,,13,10,23
091 Schnals,7,,7,13,20
091 Schnals,8,,4,9,13
091 Schnals,9,,5,7,12
091 Schnals,10,,11,5,16
091 Schnals,11,,13,10,23
091 Schnals,12,,12,9,21
091 Schnals,13,,5,7,12
091 Schnals,14,,20,9,29
091 Schnals,15,,9,5,14
091 Schnals,16,,12,11,23
091 Schnals,17,,9,10,19
091 Schnals,18,,7,9,16
091 Schnals,19,,12,17,29
091 Schnals,20,,10,10,20
091 Schnals,21,,10,5,15
091 Schnals,22,,16,10,26
091 Schnals,23,,13,11,24
091 Schnals,24,,11,10,21
091 Schnals,25,,12,10,22
091 Schnals,26,,8,9,17
091 Schnals,27,,12,2,14
091 Schnals,28,,6,6,12
091 Schnals,29,,14,7,21
091 Schnals,30,,8,9,17
091 Schnals,31,,10,8,18
091 Schnals,32,,11,11,22
091 Schnals,33,,12,11,23
091 Schnals,34,,13,10,23
091 Schnals,35,,11,10,21
091 Schnals,36,,16,10,26
091 Schnals,37,,14,16,30
091 Schnals,38,,16,8,24
091 Schnals,39,,7,10,17
091 Schnals,40,,10,15,25
091 Schnals,41,,16,13,29
091 Schnals,42,,12,14,26
091 Schnals,43,,11,8,19
091 Schnals,44,,17,13,30
091 Schnals,45,,14,11,25
091 Schnals,46,,13,5,18
091 Schnals,47,,14,5,19
091 Schnals,48,,9,6,15
091 Schnals,49,,10,8,18
091 Schnals,50,,13,9,22
091 Schnals,51,,13,7,20
091 Schnals,52,,12,8,20
091 Schnals,53,,10,7,17
091 Schnals,54,,10,9,19
091 Schnals,55,,3,3,6
091 Schnals,56,,10,8,18
091 Schnals,57,,5,6,11
091 Schnals,58,,8,4,12
091 Schnals,59,,4,7,11
091 Schnals,60,,6,10,16
091 Schnals,61,,4,4,8
091 Schnals,62,,5,5,10
091 Schnals,63,,7,6,13
091 Schnals,64,,7,7,14
091 Schnals,65,,2,11,13
091 Schnals,66,,7,5,12
091 Schnals,67,,6,5,11
091 Schnals,68,,3,5,8
091 Schnals,69,,2,4,6
091 Schnals,70,,6,4,10
091 Schnals,71,,3,10,13
091 Schnals,72,,3,4,7
091 Schnals,73,,-,5,5
091 Schnals,74,,5,6,11
091 Schnals,75,,2,6,8
091 Schnals,76,,3,6,9
091 Schnals,77,,9,3,12
091 Schnals,78,,7,11,18
091 Schnals,79,,-,6,6
091 Schnals,80,,-,2,2
091 Schnals,81,,7,3,10
091 Schnals,82,,-,5,5
091 Schnals,83,,1,4,5
091 Schnals,84,,1,1,2
091 Schnals,85,,3,3,6
091 Schnals,86,,-,3,3
091 Schnals,87,,-,2,2
091 Schnals,88,,2,2,4
091 Schnals,89,,-,2,2
091 Schnals,90,,-,1,1
091 Schnals,91,,2,2,4
091 Schnals,92,,-,2,2
091 Schnals,94,,-,1,1
092 Sexten,0,,10,11,21
092 Sexten,1,,17,19,36
092 Sexten,2,,18,12,30
092 Sexten,3,,8,15,23
092 Sexten,4,,9,16,25
092 Sexten,5,,11,8,19
092 Sexten,6,,12,9,21
092 Sexten,7,,12,12,24
092 Sexten,8,,15,14,29
092 Sexten,9,,16,11,27
092 Sexten,10,,8,5,13
092 Sexten,11,,13,10,23
092 Sexten,12,,11,12,23
092 Sexten,13,,10,19,29
092 Sexten,14,,9,9,18
092 Sexten,15,,10,5,15
092 Sexten,16,,12,9,21
092 Sexten,17,,6,9,15
092 Sexten,18,,12,11,23
092 Sexten,19,,6,10,16
092 Sexten,20,,11,9,20
092 Sexten,21,,11,19,30
092 Sexten,22,,15,13,28
092 Sexten,23,,16,8,24
092 Sexten,24,,12,21,33
092 Sexten,25,,9,12,21
092 Sexten,26,,9,5,14
092 Sexten,27,,17,11,28
092 Sexten,28,,8,6,14
092 Sexten,29,,8,8,16
092 Sexten,30,,10,10,20
092 Sexten,31,,15,15,30
092 Sexten,32,,11,15,26
092 Sexten,33,,11,20,31
092 Sexten,34,,22,18,40
092 Sexten,35,,15,18,33
092 Sexten,36,,21,16,37
092 Sexten,37,,15,15,30
092 Sexten,38,,19,18,37
092 Sexten,39,,20,19,39
092 Sexten,40,,29,18,47
092 Sexten,41,,16,15,31
092 Sexten,42,,19,14,33
092 Sexten,43,,19,9,28
092 Sexten,44,,16,15,31
092 Sexten,45,,23,15,38
092 Sexten,46,,17,13,30
092 Sexten,47,,13,14,27
092 Sexten,48,,10,13,23
092 Sexten,49,,12,11,23
092 Sexten,50,,6,12,18
092 Sexten,51,,6,11,17
092 Sexten,52,,7,9,16
092 Sexten,53,,13,7,20
092 Sexten,54,,6,6,12
092 Sexten,55,,10,7,17
092 Sexten,56,,11,4,15
092 Sexten,57,,6,9,15
092 Sexten,58,,9,4,13
092 Sexten,59,,7,12,19
092 Sexten,60,,8,6,14
092 Sexten,61,,6,6,12
092 Sexten,62,,10,16,26
092 Sexten,63,,10,14,24
092 Sexten,64,,7,10,17
092 Sexten,65,,14,12,26
092 Sexten,66,,12,9,21
092 Sexten,67,,7,10,17
092 Sexten,68,,11,16,27
092 Sexten,69,,12,7,19
092 Sexten,70,,5,10,15
092 Sexten,71,,7,8,15
092 Sexten,72,,9,13,22
092 Sexten,73,,9,12,21
092 Sexten,74,,7,13,20
092 Sexten,75,,9,11,20
092 Sexten,76,,12,16,28
092 Sexten,77,,7,3,10
092 Sexten,78,,6,12,18
092 Sexten,79,,6,7,13
092 Sexten,80,,6,10,16
092 Sexten,81,,7,8,15
092 Sexten,82,,4,8,12
092 Sexten,83,,2,4,6
092 Sexten,84,,2,3,5
092 Sexten,85,,-,1,1
092 Sexten,86,,1,1,2
092 Sexten,87,,-,2,2
092 Sexten,88,,1,-,1
092 Sexten,89,,1,-,1
092 Sexten,90,,-,3,3
092 Sexten,91,,1,5,6
092 Sexten,95,,-,1,1
092 Sexten,98,,-,1,1
092 Sexten,100,,-,1,1
093 Schlanders,0,,31,25,56
093 Schlanders,1,,26,28,54
093 Schlanders,2,,31,34,65
093 Schlanders,3,,39,38,77
093 Schlanders,4,,30,40,70
093 Schlanders,5,,42,39,81
093 Schlanders,6,,55,48,103
093 Schlanders,7,,46,36,82
093 Schlanders,8,,35,27,62
093 Schlanders,9,,41,38,79
093 Schlanders,10,,45,43,88
093 Schlanders,11,,34,41,75
093 Schlanders,12,,39,39,78
093 Schlanders,13,,50,41,91
093 Schlanders,14,,37,34,71
093 Schlanders,15,,36,42,78
093 Schlanders,16,,37,29,66
093 Schlanders,17,,35,36,71
093 Schlanders,18,,41,37,78
093 Schlanders,19,,39,36,75
093 Schlanders,20,,33,34,67
093 Schlanders,21,,51,37,88
093 Schlanders,22,,44,29,73
093 Schlanders,23,,36,30,66
093 Schlanders,24,,35,39,74
093 Schlanders,25,,49,32,81
093 Schlanders,26,,34,40,74
093 Schlanders,27,,40,30,70
093 Schlanders,28,,39,36,75
093 Schlanders,29,,51,38,89
093 Schlanders,30,,42,46,88
093 Schlanders,31,,55,42,97
093 Schlanders,32,,51,48,99
093 Schlanders,33,,49,52,101
093 Schlanders,34,,60,43,103
093 Schlanders,35,,51,44,95
093 Schlanders,36,,50,51,101
093 Schlanders,37,,51,54,105
093 Schlanders,38,,56,48,104
093 Schlanders,39,,42,44,86
093 Schlanders,40,,56,59,115
093 Schlanders,41,,55,43,98
093 Schlanders,42,,46,55,101
093 Schlanders,43,,44,44,88
093 Schlanders,44,,41,40,81
093 Schlanders,45,,45,53,98
093 Schlanders,46,,44,34,78
093 Schlanders,47,,27,35,62
093 Schlanders,48,,28,37,65
093 Schlanders,49,,32,34,66
093 Schlanders,50,,34,36,70
093 Schlanders,51,,30,23,53
093 Schlanders,52,,30,30,60
093 Schlanders,53,,24,32,56
093 Schlanders,54,,29,35,64
093 Schlanders,55,,37,26,63
093 Schlanders,56,,23,24,47
093 Schlanders,57,,32,21,53
093 Schlanders,58,,31,15,46
093 Schlanders,59,,28,31,59
093 Schlanders,60,,31,32,63
093 Schlanders,61,,36,37,73
093 Schlanders,62,,34,38,72
093 Schlanders,63,,29,28,57
093 Schlanders,64,,28,36,64
093 Schlanders,65,,16,20,36
093 Schlanders,66,,27,26,53
093 Schlanders,67,,20,27,47
093 Schlanders,68,,16,25,41
093 Schlanders,69,,20,22,42
093 Schlanders,70,,19,31,50
093 Schlanders,71,,23,17,40
093 Schlanders,72,,23,18,41
093 Schlanders,73,,18,26,44
093 Schlanders,74,,13,17,30
093 Schlanders,75,,20,22,42
093 Schlanders,76,,18,25,43
093 Schlanders,77,,15,24,39
093 Schlanders,78,,11,18,29
093 Schlanders,79,,13,18,31
093 Schlanders,80,,10,18,28
093 Schlanders,81,,6,14,20
093 Schlanders,82,,6,10,16
093 Schlanders,83,,3,20,23
093 Schlanders,84,,4,13,17
093 Schlanders,85,,6,13,19
093 Schlanders,86,,5,2,7
093 Schlanders,87,,2,7,9
093 Schlanders,88,,4,2,6
093 Schlanders,89,,4,8,12
093 Schlanders,90,,3,6,9
093 Schlanders,91,,1,6,7
093 Schlanders,92,,2,6,8
093 Schlanders,93,,1,3,4
093 Schlanders,94,,-,2,2
093 Schlanders,97,,-,1,1
093 Schlanders,99,,-,1,1
093 Schlanders,100,,-,2,2
094 Schluderns,0,,15,14,29
094 Schluderns,1,,14,9,23
094 Schluderns,2,,13,8,21
094 Schluderns,3,,18,10,28
094 Schluderns,4,,9,15,24
094 Schluderns,5,,7,10,17
094 Schluderns,6,,14,11,25
094 Schluderns,7,,11,16,27
094 Schluderns,8,,9,13,22
094 Schluderns,9,,15,20,35
094 Schluderns,10,,18,7,25
094 Schluderns,11,,8,8,16
094 Schluderns,12,,9,10,19
094 Schluderns,13,,21,7,28
094 Schluderns,14,,15,13,28
094 Schluderns,15,,12,14,26
094 Schluderns,16,,6,10,16
094 Schluderns,17,,13,21,34
094 Schluderns,18,,19,12,31
094 Schluderns,19,,16,11,27
094 Schluderns,20,,13,11,24
094 Schluderns,21,,8,14,22
094 Schluderns,22,,20,13,33
094 Schluderns,23,,7,7,14
094 Schluderns,24,,7,18,25
094 Schluderns,25,,14,12,26
094 Schluderns,26,,14,12,26
094 Schluderns,27,,9,16,25
094 Schluderns,28,,16,11,27
094 Schluderns,29,,17,14,31
094 Schluderns,30,,23,15,38
094 Schluderns,31,,13,15,28
094 Schluderns,32,,12,15,27
094 Schluderns,33,,11,15,26
094 Schluderns,34,,20,9,29
094 Schluderns,35,,18,15,33
094 Schluderns,36,,16,16,32
094 Schluderns,37,,17,18,35
094 Schluderns,38,,25,10,35
094 Schluderns,39,,26,11,37
094 Schluderns,40,,15,19,34
094 Schluderns,41,,12,23,35
094 Schluderns,42,,18,16,34
094 Schluderns,43,,10,7,17
094 Schluderns,44,,13,20,33
094 Schluderns,45,,11,12,23
094 Schluderns,46,,17,7,24
094 Schluderns,47,,10,17,27
094 Schluderns,48,,17,11,28
094 Schluderns,49,,13,7,20
094 Schluderns,50,,11,7,18
094 Schluderns,51,,7,6,13
094 Schluderns,52,,11,3,14
094 Schluderns,53,,8,15,23
094 Schluderns,54,,14,10,24
094 Schluderns,55,,10,8,18
094 Schluderns,56,,6,5,11
094 Schluderns,57,,8,9,17
094 Schluderns,58,,7,3,10
094 Schluderns,59,,4,12,16
094 Schluderns,60,,4,8,12
094 Schluderns,61,,7,8,15
094 Schluderns,62,,11,14,25
094 Schluderns,63,,8,5,13
094 Schluderns,64,,12,8,20
094 Schluderns,65,,9,10,19
094 Schluderns,66,,7,10,17
094 Schluderns,67,,4,7,11
094 Schluderns,68,,5,10,15
094 Schluderns,69,,10,11,21
094 Schluderns,70,,5,9,14
094 Schluderns,71,,12,9,21
094 Schluderns,72,,4,8,12
094 Schluderns,73,,7,10,17
094 Schluderns,74,,8,7,15
094 Schluderns,75,,6,10,16
094 Schluderns,76,,5,1,6
094 Schluderns,77,,4,13,17
094 Schluderns,78,,2,7,9
094 Schluderns,79,,2,4,6
094 Schluderns,80,,1,5,6
094 Schluderns,81,,7,6,13
094 Schluderns,82,,2,8,10
094 Schluderns,83,,1,3,4
094 Schluderns,84,,3,4,7
094 Schluderns,85,,3,2,5
094 Schluderns,86,,1,3,4
094 Schluderns,87,,1,4,5
094 Schluderns,88,,1,4,5
094 Schluderns,89,,1,1,2
094 Schluderns,90,,1,-,1
094 Schluderns,91,,-,1,1
094 Schluderns,93,,-,1,1
094 Schluderns,94,,-,2,2
094 Schluderns,95,,-,1,1
095 Stilfs,0,,6,6,12
095 Stilfs,1,,7,4,11
095 Stilfs,2,,5,11,16
095 Stilfs,3,,11,4,15
095 Stilfs,4,,2,7,9
095 Stilfs,5,,8,3,11
095 Stilfs,6,,9,11,20
095 Stilfs,7,,12,2,14
095 Stilfs,8,,7,6,13
095 Stilfs,9,,8,6,14
095 Stilfs,10,,5,15,20
095 Stilfs,11,,3,9,12
095 Stilfs,12,,11,5,16
095 Stilfs,13,,17,7,24
095 Stilfs,14,,10,6,16
095 Stilfs,15,,6,4,10
095 Stilfs,16,,6,7,13
095 Stilfs,17,,8,8,16
095 Stilfs,18,,12,5,17
095 Stilfs,19,,15,5,20
095 Stilfs,20,,8,8,16
095 Stilfs,21,,11,4,15
095 Stilfs,22,,10,4,14
095 Stilfs,23,,9,5,14
095 Stilfs,24,,5,9,14
095 Stilfs,25,,10,6,16
095 Stilfs,26,,8,9,17
095 Stilfs,27,,15,5,20
095 Stilfs,28,,11,10,21
095 Stilfs,29,,8,8,16
095 Stilfs,30,,6,19,25
095 Stilfs,31,,14,10,24
095 Stilfs,32,,13,13,26
095 Stilfs,33,,11,14,25
095 Stilfs,34,,12,14,26
095 Stilfs,35,,9,12,21
095 Stilfs,36,,9,9,18
095 Stilfs,37,,16,9,25
095 Stilfs,38,,11,10,21
095 Stilfs,39,,11,5,16
095 Stilfs,40,,9,5,14
095 Stilfs,41,,12,16,28
095 Stilfs,42,,9,2,11
095 Stilfs,43,,8,6,14
095 Stilfs,44,,10,8,18
095 Stilfs,45,,6,12,18
095 Stilfs,46,,9,6,15
095 Stilfs,47,,6,12,18
095 Stilfs,48,,4,3,7
095 Stilfs,49,,14,8,22
095 Stilfs,50,,11,5,16
095 Stilfs,51,,12,5,17
095 Stilfs,52,,13,10,23
095 Stilfs,53,,3,8,11
095 Stilfs,54,,8,3,11
095 Stilfs,55,,9,10,19
095 Stilfs,56,,5,5,10
095 Stilfs,57,,9,10,19
095 Stilfs,58,,2,4,6
095 Stilfs,59,,13,9,22
095 Stilfs,60,,9,8,17
095 Stilfs,61,,5,13,18
095 Stilfs,62,,9,4,13
095 Stilfs,63,,7,11,18
095 Stilfs,64,,5,9,14
095 Stilfs,65,,6,5,11
095 Stilfs,66,,7,6,13
095 Stilfs,67,,3,10,13
095 Stilfs,68,,3,7,10
095 Stilfs,69,,6,4,10
095 Stilfs,70,,4,6,10
095 Stilfs,71,,5,7,12
095 Stilfs,72,,3,4,7
095 Stilfs,73,,5,7,12
095 Stilfs,74,,5,1,6
095 Stilfs,75,,4,8,12
095 Stilfs,76,,5,7,12
095 Stilfs,77,,4,5,9
095 Stilfs,78,,6,3,9
095 Stilfs,79,,1,8,9
095 Stilfs,80,,4,5,9
095 Stilfs,81,,2,5,7
095 Stilfs,82,,1,5,6
095 Stilfs,83,,2,10,12
095 Stilfs,84,,1,1,2
095 Stilfs,85,,2,2,4
095 Stilfs,86,,-,3,3
095 Stilfs,87,,-,3,3
095 Stilfs,88,,1,-,1
095 Stilfs,89,,2,3,5
095 Stilfs,90,,-,1,1
095 Stilfs,91,,-,2,2
095 Stilfs,92,,-,2,2
095 Stilfs,93,,-,2,2
095 Stilfs,94,,-,2,2
096 Terenten,0,,8,11,19
096 Terenten,1,,8,8,16
096 Terenten,2,,11,12,23
096 Terenten,3,,10,9,19
096 Terenten,4,,9,17,26
096 Terenten,5,,20,19,39
096 Terenten,6,,9,7,16
096 Terenten,7,,13,11,24
096 Terenten,8,,12,8,20
096 Terenten,9,,14,14,28
096 Terenten,10,,7,13,20
096 Terenten,11,,9,9,18
096 Terenten,12,,6,15,21
096 Terenten,13,,13,17,30
096 Terenten,14,,15,7,22
096 Terenten,15,,10,8,18
096 Terenten,16,,16,7,23
096 Terenten,17,,10,10,20
096 Terenten,18,,11,15,26
096 Terenten,19,,13,12,25
096 Terenten,20,,14,15,29
096 Terenten,21,,12,9,21
096 Terenten,22,,13,6,19
096 Terenten,23,,10,14,24
096 Terenten,24,,9,9,18
096 Terenten,25,,17,19,36
096 Terenten,26,,10,6,16
096 Terenten,27,,15,10,25
096 Terenten,28,,17,11,28
096 Terenten,29,,14,15,29
096 Terenten,30,,8,16,24
096 Terenten,31,,18,10,28
096 Terenten,32,,15,16,31
096 Terenten,33,,21,11,32
096 Terenten,34,,16,12,28
096 Terenten,35,,12,13,25
096 Terenten,36,,16,17,33
096 Terenten,37,,13,18,31
096 Terenten,38,,18,10,28
096 Terenten,39,,17,15,32
096 Terenten,40,,24,13,37
096 Terenten,41,,22,10,32
096 Terenten,42,,10,16,26
096 Terenten,43,,12,9,21
096 Terenten,44,,15,11,26
096 Terenten,45,,12,8,20
096 Terenten,46,,12,9,21
096 Terenten,47,,10,12,22
096 Terenten,48,,12,10,22
096 Terenten,49,,15,11,26
096 Terenten,50,,9,6,15
096 Terenten,51,,6,7,13
096 Terenten,52,,5,6,11
096 Terenten,53,,9,7,16
096 Terenten,54,,9,6,15
096 Terenten,55,,10,8,18
096 Terenten,56,,7,3,10
096 Terenten,57,,8,3,11
096 Terenten,58,,6,3,9
096 Terenten,59,,3,6,9
096 Terenten,60,,8,4,12
096 Terenten,61,,5,5,10
096 Terenten,62,,6,4,10
096 Terenten,63,,8,5,13
096 Terenten,64,,2,6,8
096 Terenten,65,,4,9,13
096 Terenten,66,,6,5,11
096 Terenten,67,,4,8,12
096 Terenten,68,,7,5,12
096 Terenten,69,,2,4,6
096 Terenten,70,,5,3,8
096 Terenten,71,,4,4,8
096 Terenten,72,,6,11,17
096 Terenten,73,,5,6,11
096 Terenten,74,,5,4,9
096 Terenten,75,,6,6,12
096 Terenten,76,,2,3,5
096 Terenten,77,,3,9,12
096 Terenten,78,,6,2,8
096 Terenten,79,,1,7,8
096 Terenten,80,,4,3,7
096 Terenten,81,,3,1,4
096 Terenten,82,,-,2,2
096 Terenten,83,,4,3,7
096 Terenten,84,,1,2,3
096 Terenten,85,,-,3,3
096 Terenten,86,,1,-,1
096 Terenten,87,,-,1,1
096 Terenten,88,,-,1,1
096 Terenten,89,,2,1,3
096 Terenten,90,,1,-,1
096 Terenten,91,,-,1,1
096 Terenten,93,,-,2,2
096 Terenten,94,,-,1,1
097 Terlan,0,,23,24,47
097 Terlan,1,,18,23,41
097 Terlan,2,,21,26,47
097 Terlan,3,,31,29,60
097 Terlan,4,,30,20,50
097 Terlan,5,,18,19,37
097 Terlan,6,,32,27,59
097 Terlan,7,,17,25,42
097 Terlan,8,,26,23,49
097 Terlan,9,,19,18,37
097 Terlan,10,,24,24,48
097 Terlan,11,,24,29,53
097 Terlan,12,,24,20,44
097 Terlan,13,,15,22,37
097 Terlan,14,,21,31,52
097 Terlan,15,,22,17,39
097 Terlan,16,,25,17,42
097 Terlan,17,,15,22,37
097 Terlan,18,,27,19,46
097 Terlan,19,,13,13,26
097 Terlan,20,,26,15,41
097 Terlan,21,,20,17,37
097 Terlan,22,,16,15,31
097 Terlan,23,,25,21,46
097 Terlan,24,,20,25,45
097 Terlan,25,,18,16,34
097 Terlan,26,,27,20,47
097 Terlan,27,,30,30,60
097 Terlan,28,,30,23,53
097 Terlan,29,,31,43,74
097 Terlan,30,,23,34,57
097 Terlan,31,,41,25,66
097 Terlan,32,,34,26,60
097 Terlan,33,,38,40,78
097 Terlan,34,,36,32,68
097 Terlan,35,,38,26,64
097 Terlan,36,,25,36,61
097 Terlan,37,,34,23,57
097 Terlan,38,,37,29,66
097 Terlan,39,,33,32,65
097 Terlan,40,,37,38,75
097 Terlan,41,,32,35,67
097 Terlan,42,,45,25,70
097 Terlan,43,,24,34,58
097 Terlan,44,,19,23,42
097 Terlan,45,,34,24,58
097 Terlan,46,,23,24,47
097 Terlan,47,,31,30,61
097 Terlan,48,,18,23,41
097 Terlan,49,,24,21,45
097 Terlan,50,,18,23,41
097 Terlan,51,,19,25,44
097 Terlan,52,,22,19,41
097 Terlan,53,,21,26,47
097 Terlan,54,,20,16,36
097 Terlan,55,,22,24,46
097 Terlan,56,,13,19,32
097 Terlan,57,,13,25,38
097 Terlan,58,,21,20,41
097 Terlan,59,,21,25,46
097 Terlan,60,,18,29,47
097 Terlan,61,,33,19,52
097 Terlan,62,,23,24,47
097 Terlan,63,,20,16,36
097 Terlan,64,,16,19,35
097 Terlan,65,,21,17,38
097 Terlan,66,,14,17,31
097 Terlan,67,,7,12,19
097 Terlan,68,,15,23,38
097 Terlan,69,,7,23,30
097 Terlan,70,,15,16,31
097 Terlan,71,,15,11,26
097 Terlan,72,,19,15,34
097 Terlan,73,,15,16,31
097 Terlan,74,,13,14,27
097 Terlan,75,,12,11,23
097 Terlan,76,,11,11,22
097 Terlan,77,,12,19,31
097 Terlan,78,,10,12,22
097 Terlan,79,,7,13,20
097 Terlan,80,,7,24,31
097 Terlan,81,,8,10,18
097 Terlan,82,,8,13,21
097 Terlan,83,,2,8,10
097 Terlan,84,,-,7,7
097 Terlan,85,,3,3,6
097 Terlan,86,,-,4,4
097 Terlan,87,,-,5,5
097 Terlan,88,,1,3,4
097 Terlan,89,,-,6,6
097 Terlan,90,,1,6,7
097 Terlan,91,,-,5,5
097 Terlan,92,,-,5,5
097 Terlan,93,,1,2,3
097 Terlan,94,,3,-,3
097 Terlan,95,,-,1,1
097 Terlan,96,,-,1,1
097 Terlan,98,,-,1,1
098 Tramin a.d. Weinstr.,0,,24,16,40
098 Tramin a.d. Weinstr.,1,,12,16,28
098 Tramin a.d. Weinstr.,2,,16,23,39
098 Tramin a.d. Weinstr.,3,,23,15,38
098 Tramin a.d. Weinstr.,4,,21,18,39
098 Tramin a.d. Weinstr.,5,,14,20,34
098 Tramin a.d. Weinstr.,6,,30,15,45
098 Tramin a.d. Weinstr.,7,,19,26,45
098 Tramin a.d. Weinstr.,8,,18,20,38
098 Tramin a.d. Weinstr.,9,,20,20,40
098 Tramin a.d. Weinstr.,10,,17,17,34
098 Tramin a.d. Weinstr.,11,,20,24,44
098 Tramin a.d. Weinstr.,12,,17,10,27
098 Tramin a.d. Weinstr.,13,,23,20,43
098 Tramin a.d. Weinstr.,14,,11,30,41
098 Tramin a.d. Weinstr.,15,,12,25,37
098 Tramin a.d. Weinstr.,16,,17,26,43
098 Tramin a.d. Weinstr.,17,,10,16,26
098 Tramin a.d. Weinstr.,18,,21,20,41
098 Tramin a.d. Weinstr.,19,,21,16,37
098 Tramin a.d. Weinstr.,20,,17,14,31
098 Tramin a.d. Weinstr.,21,,25,19,44
098 Tramin a.d. Weinstr.,22,,29,16,45
098 Tramin a.d. Weinstr.,23,,18,16,34
098 Tramin a.d. Weinstr.,24,,12,15,27
098 Tramin a.d. Weinstr.,25,,11,22,33
098 Tramin a.d. Weinstr.,26,,17,19,36
098 Tramin a.d. Weinstr.,27,,22,10,32
098 Tramin a.d. Weinstr.,28,,21,20,41
098 Tramin a.d. Weinstr.,29,,20,17,37
098 Tramin a.d. Weinstr.,30,,22,18,40
098 Tramin a.d. Weinstr.,31,,22,30,52
098 Tramin a.d. Weinstr.,32,,25,32,57
098 Tramin a.d. Weinstr.,33,,30,20,50
098 Tramin a.d. Weinstr.,34,,31,21,52
098 Tramin a.d. Weinstr.,35,,22,26,48
098 Tramin a.d. Weinstr.,36,,27,26,53
098 Tramin a.d. Weinstr.,37,,28,30,58
098 Tramin a.d. Weinstr.,38,,34,32,66
098 Tramin a.d. Weinstr.,39,,27,28,55
098 Tramin a.d. Weinstr.,40,,23,27,50
098 Tramin a.d. Weinstr.,41,,22,14,36
098 Tramin a.d. Weinstr.,42,,33,27,60
098 Tramin a.d. Weinstr.,43,,30,33,63
098 Tramin a.d. Weinstr.,44,,19,31,50
098 Tramin a.d. Weinstr.,45,,25,21,46
098 Tramin a.d. Weinstr.,46,,20,18,38
098 Tramin a.d. Weinstr.,47,,23,19,42
098 Tramin a.d. Weinstr.,48,,17,19,36
098 Tramin a.d. Weinstr.,49,,20,18,38
098 Tramin a.d. Weinstr.,50,,17,15,32
098 Tramin a.d. Weinstr.,51,,19,16,35
098 Tramin a.d. Weinstr.,52,,10,12,22
098 Tramin a.d. Weinstr.,53,,15,20,35
098 Tramin a.d. Weinstr.,54,,15,15,30
098 Tramin a.d. Weinstr.,55,,17,18,35
098 Tramin a.d. Weinstr.,56,,14,22,36
098 Tramin a.d. Weinstr.,57,,24,18,42
098 Tramin a.d. Weinstr.,58,,7,9,16
098 Tramin a.d. Weinstr.,59,,23,25,48
098 Tramin a.d. Weinstr.,60,,19,22,41
098 Tramin a.d. Weinstr.,61,,21,20,41
098 Tramin a.d. Weinstr.,62,,13,25,38
098 Tramin a.d. Weinstr.,63,,22,15,37
098 Tramin a.d. Weinstr.,64,,14,13,27
098 Tramin a.d. Weinstr.,65,,8,20,28
098 Tramin a.d. Weinstr.,66,,15,13,28
098 Tramin a.d. Weinstr.,67,,13,15,28
098 Tramin a.d. Weinstr.,68,,15,14,29
098 Tramin a.d. Weinstr.,69,,11,12,23
098 Tramin a.d. Weinstr.,70,,9,14,23
098 Tramin a.d. Weinstr.,71,,11,18,29
098 Tramin a.d. Weinstr.,72,,8,19,27
098 Tramin a.d. Weinstr.,73,,21,14,35
098 Tramin a.d. Weinstr.,74,,10,14,24
098 Tramin a.d. Weinstr.,75,,15,16,31
098 Tramin a.d. Weinstr.,76,,17,14,31
098 Tramin a.d. Weinstr.,77,,13,18,31
098 Tramin a.d. Weinstr.,78,,11,20,31
098 Tramin a.d. Weinstr.,79,,6,15,21
098 Tramin a.d. Weinstr.,80,,7,18,25
098 Tramin a.d. Weinstr.,81,,5,10,15
098 Tramin a.d. Weinstr.,82,,9,11,20
098 Tramin a.d. Weinstr.,83,,6,11,17
098 Tramin a.d. Weinstr.,84,,2,11,13
098 Tramin a.d. Weinstr.,85,,2,3,5
098 Tramin a.d. Weinstr.,86,,1,5,6
098 Tramin a.d. Weinstr.,87,,1,1,2
098 Tramin a.d. Weinstr.,88,,2,5,7
098 Tramin a.d. Weinstr.,89,,4,9,13
098 Tramin a.d. Weinstr.,90,,1,-,1
098 Tramin a.d. Weinstr.,91,,1,2,3
098 Tramin a.d. Weinstr.,92,,-,4,4
098 Tramin a.d. Weinstr.,93,,1,3,4
098 Tramin a.d. Weinstr.,94,,-,1,1
098 Tramin a.d. Weinstr.,95,,1,2,3
098 Tramin a.d. Weinstr.,96,,-,2,2
098 Tramin a.d. Weinstr.,97,,-,1,1
098 Tramin a.d. Weinstr.,99,,-,1,1
098 Tramin a.d. Weinstr.,103,,-,1,1
099 Tisens,0,,7,10,17
099 Tisens,1,,10,8,18
099 Tisens,2,,10,15,25
099 Tisens,3,,10,13,23
099 Tisens,4,,11,9,20
099 Tisens,5,,11,14,25
099 Tisens,6,,6,6,12
099 Tisens,7,,9,8,17
099 Tisens,8,,10,9,19
099 Tisens,9,,12,12,24
099 Tisens,10,,6,9,15
099 Tisens,11,,6,15,21
099 Tisens,12,,16,8,24
099 Tisens,13,,10,15,25
099 Tisens,14,,11,10,21
099 Tisens,15,,7,13,20
099 Tisens,16,,15,9,24
099 Tisens,17,,15,8,23
099 Tisens,18,,10,5,15
099 Tisens,19,,11,12,23
099 Tisens,20,,18,7,25
099 Tisens,21,,10,15,25
099 Tisens,22,,5,20,25
099 Tisens,23,,15,10,25
099 Tisens,24,,10,9,19
099 Tisens,25,,13,14,27
099 Tisens,26,,12,10,22
099 Tisens,27,,8,4,12
099 Tisens,28,,14,15,29
099 Tisens,29,,11,9,20
099 Tisens,30,,11,10,21
099 Tisens,31,,8,10,18
099 Tisens,32,,20,15,35
099 Tisens,33,,14,21,35
099 Tisens,34,,16,16,32
099 Tisens,35,,18,17,35
099 Tisens,36,,20,24,44
099 Tisens,37,,20,11,31
099 Tisens,38,,15,28,43
099 Tisens,39,,15,4,19
099 Tisens,40,,18,14,32
099 Tisens,41,,23,7,30
099 Tisens,42,,14,16,30
099 Tisens,43,,17,7,24
099 Tisens,44,,14,10,24
099 Tisens,45,,10,11,21
099 Tisens,46,,15,19,34
099 Tisens,47,,9,12,21
099 Tisens,48,,21,10,31
099 Tisens,49,,8,8,16
099 Tisens,50,,12,11,23
099 Tisens,51,,7,12,19
099 Tisens,52,,10,11,21
099 Tisens,53,,9,7,16
099 Tisens,54,,5,8,13
099 Tisens,55,,15,9,24
099 Tisens,56,,7,8,15
099 Tisens,57,,8,6,14
099 Tisens,58,,3,7,10
099 Tisens,59,,10,10,20
099 Tisens,60,,12,10,22
099 Tisens,61,,8,9,17
099 Tisens,62,,8,14,22
099 Tisens,63,,7,8,15
099 Tisens,64,,13,9,22
099 Tisens,65,,7,12,19
099 Tisens,66,,6,4,10
099 Tisens,67,,7,8,15
099 Tisens,68,,4,12,16
099 Tisens,69,,7,7,14
099 Tisens,70,,2,10,12
099 Tisens,71,,9,10,19
099 Tisens,72,,7,9,16
099 Tisens,73,,4,15,19
099 Tisens,74,,10,10,20
099 Tisens,75,,9,13,22
099 Tisens,76,,12,9,21
099 Tisens,77,,6,9,15
099 Tisens,78,,4,7,11
099 Tisens,79,,2,3,5
099 Tisens,80,,4,9,13
099 Tisens,81,,5,5,10
099 Tisens,82,,4,7,11
099 Tisens,83,,3,5,8
099 Tisens,84,,2,6,8
099 Tisens,85,,2,4,6
099 Tisens,86,,1,4,5
099 Tisens,87,,1,3,4
099 Tisens,88,,2,3,5
099 Tisens,89,,1,4,5
099 Tisens,90,,-,2,2
099 Tisens,91,,-,2,2
099 Tisens,92,,1,1,2
099 Tisens,93,,-,4,4
099 Tisens,95,,-,3,3
099 Tisens,96,,-,1,1
099 Tisens,100,,-,1,1
100 Tiers,0,,5,8,13
100 Tiers,1,,8,4,12
100 Tiers,2,,3,8,11
100 Tiers,3,,2,8,10
100 Tiers,4,,4,9,13
100 Tiers,5,,4,9,13
100 Tiers,6,,7,5,12
100 Tiers,7,,8,4,12
100 Tiers,8,,6,10,16
100 Tiers,9,,5,7,12
100 Tiers,10,,4,1,5
100 Tiers,11,,6,3,9
100 Tiers,12,,4,3,7
100 Tiers,13,,6,5,11
100 Tiers,14,,5,6,11
100 Tiers,15,,6,8,14
100 Tiers,16,,5,4,9
100 Tiers,17,,8,6,14
100 Tiers,18,,5,6,11
100 Tiers,19,,3,9,12
100 Tiers,20,,6,7,13
100 Tiers,21,,6,6,12
100 Tiers,22,,5,5,10
100 Tiers,23,,2,4,6
100 Tiers,24,,1,8,9
100 Tiers,25,,8,8,16
100 Tiers,26,,6,3,9
100 Tiers,27,,1,3,4
100 Tiers,28,,8,4,12
100 Tiers,29,,4,9,13
100 Tiers,30,,9,10,19
100 Tiers,31,,10,7,17
100 Tiers,32,,6,7,13
100 Tiers,33,,8,8,16
100 Tiers,34,,13,11,24
100 Tiers,35,,6,5,11
100 Tiers,36,,9,11,20
100 Tiers,37,,9,6,15
100 Tiers,38,,7,6,13
100 Tiers,39,,8,3,11
100 Tiers,40,,6,10,16
100 Tiers,41,,5,7,12
100 Tiers,42,,6,4,10
100 Tiers,43,,4,6,10
100 Tiers,44,,11,5,16
100 Tiers,45,,7,4,11
100 Tiers,46,,6,9,15
100 Tiers,47,,10,8,18
100 Tiers,48,,5,3,8
100 Tiers,49,,8,5,13
100 Tiers,50,,6,5,11
100 Tiers,51,,3,2,5
100 Tiers,52,,1,3,4
100 Tiers,53,,8,4,12
100 Tiers,54,,3,5,8
100 Tiers,55,,3,5,8
100 Tiers,56,,2,3,5
100 Tiers,57,,6,4,10
100 Tiers,58,,9,3,12
100 Tiers,59,,1,5,6
100 Tiers,60,,9,10,19
100 Tiers,61,,2,5,7
100 Tiers,62,,4,6,10
100 Tiers,63,,2,3,5
100 Tiers,64,,4,6,10
100 Tiers,65,,6,5,11
100 Tiers,66,,7,5,12
100 Tiers,67,,4,5,9
100 Tiers,68,,7,2,9
100 Tiers,69,,2,5,7
100 Tiers,70,,7,3,10
100 Tiers,71,,2,5,7
100 Tiers,72,,7,2,9
100 Tiers,73,,3,-,3
100 Tiers,74,,2,2,4
100 Tiers,75,,4,3,7
100 Tiers,76,,4,4,8
100 Tiers,77,,4,2,6
100 Tiers,78,,6,4,10
100 Tiers,79,,2,5,7
100 Tiers,80,,2,3,5
100 Tiers,81,,3,1,4
100 Tiers,82,,1,9,10
100 Tiers,83,,2,3,5
100 Tiers,84,,3,1,4
100 Tiers,85,,-,1,1
100 Tiers,86,,2,1,3
100 Tiers,88,,1,2,3
100 Tiers,89,,1,-,1
100 Tiers,90,,-,1,1
100 Tiers,91,,-,1,1
100 Tiers,93,,-,1,1
101 Tirol,0,,11,13,24
101 Tirol,1,,12,12,24
101 Tirol,2,,17,7,24
101 Tirol,3,,19,10,29
101 Tirol,4,,14,16,30
101 Tirol,5,,18,13,31
101 Tirol,6,,19,22,41
101 Tirol,7,,20,17,37
101 Tirol,8,,9,16,25
101 Tirol,9,,15,15,30
101 Tirol,10,,21,9,30
101 Tirol,11,,12,14,26
101 Tirol,12,,8,9,17
101 Tirol,13,,16,11,27
101 Tirol,14,,11,18,29
101 Tirol,15,,11,15,26
101 Tirol,16,,16,9,25
101 Tirol,17,,11,13,24
101 Tirol,18,,10,16,26
101 Tirol,19,,16,10,26
101 Tirol,20,,19,14,33
101 Tirol,21,,12,13,25
101 Tirol,22,,17,22,39
101 Tirol,23,,17,9,26
101 Tirol,24,,19,3,22
101 Tirol,25,,10,11,21
101 Tirol,26,,14,20,34
101 Tirol,27,,17,9,26
101 Tirol,28,,17,16,33
101 Tirol,29,,16,20,36
101 Tirol,30,,23,13,36
101 Tirol,31,,26,17,43
101 Tirol,32,,22,14,36
101 Tirol,33,,18,15,33
101 Tirol,34,,23,21,44
101 Tirol,35,,24,20,44
101 Tirol,36,,22,19,41
101 Tirol,37,,19,17,36
101 Tirol,38,,21,19,40
101 Tirol,39,,30,23,53
101 Tirol,40,,21,13,34
101 Tirol,41,,17,14,31
101 Tirol,42,,17,23,40
101 Tirol,43,,23,14,37
101 Tirol,44,,16,12,28
101 Tirol,45,,14,18,32
101 Tirol,46,,16,18,34
101 Tirol,47,,9,15,24
101 Tirol,48,,13,15,28
101 Tirol,49,,14,17,31
101 Tirol,50,,18,17,35
101 Tirol,51,,12,10,22
101 Tirol,52,,15,20,35
101 Tirol,53,,15,12,27
101 Tirol,54,,20,15,35
101 Tirol,55,,20,16,36
101 Tirol,56,,9,16,25
101 Tirol,57,,13,6,19
101 Tirol,58,,12,14,26
101 Tirol,59,,16,17,33
101 Tirol,60,,13,12,25
101 Tirol,61,,13,20,33
101 Tirol,62,,12,17,29
101 Tirol,63,,10,13,23
101 Tirol,64,,12,12,24
101 Tirol,65,,7,10,17
101 Tirol,66,,11,14,25
101 Tirol,67,,6,11,17
101 Tirol,68,,10,11,21
101 Tirol,69,,16,7,23
101 Tirol,70,,6,12,18
101 Tirol,71,,8,7,15
101 Tirol,72,,7,7,14
101 Tirol,73,,4,7,11
101 Tirol,74,,9,14,23
101 Tirol,75,,8,9,17
101 Tirol,76,,10,8,18
101 Tirol,77,,5,9,14
101 Tirol,78,,6,9,15
101 Tirol,79,,9,10,19
101 Tirol,80,,4,5,9
101 Tirol,81,,4,6,10
101 Tirol,82,,6,5,11
101 Tirol,83,,2,7,9
101 Tirol,84,,2,4,6
101 Tirol,85,,2,4,6
101 Tirol,87,,1,1,2
101 Tirol,88,,1,3,4
101 Tirol,89,,1,3,4
101 Tirol,90,,2,4,6
101 Tirol,91,,2,2,4
101 Tirol,92,,-,4,4
101 Tirol,93,,-,1,1
101 Tirol,96,,1,-,1
101 Tirol,97,,1,-,1
101 Tirol,99,,-,1,1
102 Truden im Naturpark,0,,8,4,12
102 Truden im Naturpark,1,,3,1,4
102 Truden im Naturpark,2,,6,5,11
102 Truden im Naturpark,3,,6,8,14
102 Truden im Naturpark,4,,-,4,4
102 Truden im Naturpark,5,,2,8,10
102 Truden im Naturpark,6,,6,6,12
102 Truden im Naturpark,7,,7,6,13
102 Truden im Naturpark,8,,4,6,10
102 Truden im Naturpark,9,,4,6,10
102 Truden im Naturpark,10,,10,4,14
102 Truden im Naturpark,11,,8,4,12
102 Truden im Naturpark,12,,7,6,13
102 Truden im Naturpark,13,,4,6,10
102 Truden im Naturpark,14,,10,7,17
102 Truden im Naturpark,15,,9,12,21
102 Truden im Naturpark,16,,7,5,12
102 Truden im Naturpark,17,,2,6,8
102 Truden im Naturpark,18,,7,6,13
102 Truden im Naturpark,19,,10,4,14
102 Truden im Naturpark,20,,6,4,10
102 Truden im Naturpark,21,,12,3,15
102 Truden im Naturpark,22,,4,9,13
102 Truden im Naturpark,23,,4,4,8
102 Truden im Naturpark,24,,9,7,16
102 Truden im Naturpark,25,,7,6,13
102 Truden im Naturpark,26,,3,5,8
102 Truden im Naturpark,27,,10,7,17
102 Truden im Naturpark,28,,9,3,12
102 Truden im Naturpark,29,,5,8,13
102 Truden im Naturpark,30,,7,9,16
102 Truden im Naturpark,31,,9,9,18
102 Truden im Naturpark,32,,4,4,8
102 Truden im Naturpark,33,,2,7,9
102 Truden im Naturpark,34,,7,8,15
102 Truden im Naturpark,35,,6,11,17
102 Truden im Naturpark,36,,11,11,22
102 Truden im Naturpark,37,,7,7,14
102 Truden im Naturpark,38,,8,8,16
102 Truden im Naturpark,39,,10,8,18
102 Truden im Naturpark,40,,11,6,17
102 Truden im Naturpark,41,,7,5,12
102 Truden im Naturpark,42,,7,5,12
102 Truden im Naturpark,43,,12,12,24
102 Truden im Naturpark,44,,7,9,16
102 Truden im Naturpark,45,,4,8,12
102 Truden im Naturpark,46,,6,10,16
102 Truden im Naturpark,47,,9,5,14
102 Truden im Naturpark,48,,8,10,18
102 Truden im Naturpark,49,,6,5,11
102 Truden im Naturpark,50,,8,5,13
102 Truden im Naturpark,51,,6,6,12
102 Truden im Naturpark,52,,9,6,15
102 Truden im Naturpark,53,,3,2,5
102 Truden im Naturpark,54,,5,3,8
102 Truden im Naturpark,55,,2,6,8
102 Truden im Naturpark,56,,6,2,8
102 Truden im Naturpark,57,,8,6,14
102 Truden im Naturpark,58,,4,2,6
102 Truden im Naturpark,59,,4,5,9
102 Truden im Naturpark,60,,5,5,10
102 Truden im Naturpark,61,,5,4,9
102 Truden im Naturpark,62,,5,5,10
102 Truden im Naturpark,63,,2,4,6
102 Truden im Naturpark,64,,8,2,10
102 Truden im Naturpark,65,,7,7,14
102 Truden im Naturpark,66,,3,4,7
102 Truden im Naturpark,67,,4,4,8
102 Truden im Naturpark,68,,3,3,6
102 Truden im Naturpark,69,,5,-,5
102 Truden im Naturpark,70,,5,7,12
102 Truden im Naturpark,71,,3,4,7
102 Truden im Naturpark,72,,5,4,9
102 Truden im Naturpark,73,,3,8,11
102 Truden im Naturpark,74,,-,7,7
102 Truden im Naturpark,75,,1,6,7
102 Truden im Naturpark,76,,5,6,11
102 Truden im Naturpark,77,,2,8,10
102 Truden im Naturpark,78,,-,6,6
102 Truden im Naturpark,79,,-,7,7
102 Truden im Naturpark,80,,4,7,11
102 Truden im Naturpark,81,,3,5,8
102 Truden im Naturpark,82,,1,5,6
102 Truden im Naturpark,83,,-,7,7
102 Truden im Naturpark,84,,1,4,5
102 Truden im Naturpark,85,,1,1,2
102 Truden im Naturpark,88,,1,1,2
102 Truden im Naturpark,89,,-,2,2
102 Truden im Naturpark,92,,-,1,1
102 Truden im Naturpark,93,,-,1,1
102 Truden im Naturpark,94,,-,1,1
102 Truden im Naturpark,97,,-,1,1
103 Taufers im Münstertal,0,,4,3,7
103 Taufers im Münstertal,1,,4,5,9
103 Taufers im Münstertal,2,,6,6,12
103 Taufers im Münstertal,3,,4,5,9
103 Taufers im Münstertal,4,,4,3,7
103 Taufers im Münstertal,5,,8,8,16
103 Taufers im Münstertal,6,,4,4,8
103 Taufers im Münstertal,7,,6,4,10
103 Taufers im Münstertal,8,,9,10,19
103 Taufers im Münstertal,9,,6,8,14
103 Taufers im Münstertal,10,,3,5,8
103 Taufers im Münstertal,11,,9,8,17
103 Taufers im Münstertal,12,,6,10,16
103 Taufers im Münstertal,13,,9,7,16
103 Taufers im Münstertal,14,,8,2,10
103 Taufers im Münstertal,15,,6,8,14
103 Taufers im Münstertal,16,,4,6,10
103 Taufers im Münstertal,17,,6,3,9
103 Taufers im Münstertal,18,,4,3,7
103 Taufers im Münstertal,19,,5,7,12
103 Taufers im Münstertal,20,,5,5,10
103 Taufers im Münstertal,21,,5,12,17
103 Taufers im Münstertal,22,,11,2,13
103 Taufers im Münstertal,23,,9,5,14
103 Taufers im Münstertal,24,,8,5,13
103 Taufers im Münstertal,25,,7,3,10
103 Taufers im Münstertal,26,,7,5,12
103 Taufers im Münstertal,27,,8,3,11
103 Taufers im Münstertal,28,,11,4,15
103 Taufers im Münstertal,29,,6,6,12
103 Taufers im Münstertal,30,,2,4,6
103 Taufers im Münstertal,31,,5,8,13
103 Taufers im Münstertal,32,,7,14,21
103 Taufers im Münstertal,33,,6,8,14
103 Taufers im Münstertal,34,,9,6,15
103 Taufers im Münstertal,35,,9,10,19
103 Taufers im Münstertal,36,,4,5,9
103 Taufers im Münstertal,37,,9,8,17
103 Taufers im Münstertal,38,,12,7,19
103 Taufers im Münstertal,39,,7,12,19
103 Taufers im Münstertal,40,,10,10,20
103 Taufers im Münstertal,41,,11,9,20
103 Taufers im Münstertal,42,,9,9,18
103 Taufers im Münstertal,43,,14,6,20
103 Taufers im Münstertal,44,,6,9,15
103 Taufers im Münstertal,45,,5,6,11
103 Taufers im Münstertal,46,,9,7,16
103 Taufers im Münstertal,47,,10,10,20
103 Taufers im Münstertal,48,,4,3,7
103 Taufers im Münstertal,49,,3,6,9
103 Taufers im Münstertal,50,,7,3,10
103 Taufers im Münstertal,51,,6,2,8
103 Taufers im Münstertal,52,,5,4,9
103 Taufers im Münstertal,53,,7,1,8
103 Taufers im Münstertal,54,,5,1,6
103 Taufers im Münstertal,55,,6,1,7
103 Taufers im Münstertal,56,,3,7,10
103 Taufers im Münstertal,57,,3,3,6
103 Taufers im Münstertal,58,,2,3,5
103 Taufers im Münstertal,59,,1,-,1
103 Taufers im Münstertal,60,,6,5,11
103 Taufers im Münstertal,61,,5,5,10
103 Taufers im Münstertal,62,,4,6,10
103 Taufers im Münstertal,63,,3,3,6
103 Taufers im Münstertal,64,,4,4,8
103 Taufers im Münstertal,65,,8,9,17
103 Taufers im Münstertal,66,,3,4,7
103 Taufers im Münstertal,67,,2,9,11
103 Taufers im Münstertal,68,,6,2,8
103 Taufers im Münstertal,69,,4,8,12
103 Taufers im Münstertal,70,,6,5,11
103 Taufers im Münstertal,71,,5,2,7
103 Taufers im Münstertal,72,,9,3,12
103 Taufers im Münstertal,73,,3,3,6
103 Taufers im Münstertal,74,,4,6,10
103 Taufers im Münstertal,75,,4,3,7
103 Taufers im Münstertal,76,,3,4,7
103 Taufers im Münstertal,77,,3,5,8
103 Taufers im Münstertal,78,,1,5,6
103 Taufers im Münstertal,79,,-,6,6
103 Taufers im Münstertal,80,,3,5,8
103 Taufers im Münstertal,81,,2,2,4
103 Taufers im Münstertal,82,,2,-,2
103 Taufers im Münstertal,83,,3,2,5
103 Taufers im Münstertal,84,,1,2,3
103 Taufers im Münstertal,85,,-,1,1
103 Taufers im Münstertal,86,,2,3,5
103 Taufers im Münstertal,87,,1,-,1
103 Taufers im Münstertal,88,,1,1,2
103 Taufers im Münstertal,89,,1,-,1
103 Taufers im Münstertal,90,,-,1,1
103 Taufers im Münstertal,91,,-,2,2
103 Taufers im Münstertal,93,,-,1,1
103 Taufers im Münstertal,94,,-,1,1
103 Taufers im Münstertal,95,,-,1,1
103 Taufers im Münstertal,99,,-,1,1
104 Ulten,0,,25,20,45
104 Ulten,1,,13,21,34
104 Ulten,2,,22,16,38
104 Ulten,3,,19,17,36
104 Ulten,4,,15,15,30
104 Ulten,5,,18,19,37
104 Ulten,6,,14,20,34
104 Ulten,7,,11,13,24
104 Ulten,8,,11,17,28
104 Ulten,9,,19,15,34
104 Ulten,10,,23,14,37
104 Ulten,11,,17,17,34
104 Ulten,12,,23,31,54
104 Ulten,13,,16,18,34
104 Ulten,14,,18,29,47
104 Ulten,15,,16,20,36
104 Ulten,16,,20,17,37
104 Ulten,17,,22,11,33
104 Ulten,18,,14,16,30
104 Ulten,19,,20,22,42
104 Ulten,20,,22,18,40
104 Ulten,21,,16,24,40
104 Ulten,22,,18,15,33
104 Ulten,23,,20,21,41
104 Ulten,24,,17,18,35
104 Ulten,25,,22,16,38
104 Ulten,26,,22,12,34
104 Ulten,27,,17,22,39
104 Ulten,28,,25,23,48
104 Ulten,29,,23,30,53
104 Ulten,30,,27,17,44
104 Ulten,31,,25,21,46
104 Ulten,32,,27,20,47
104 Ulten,33,,23,25,48
104 Ulten,34,,29,22,51
104 Ulten,35,,28,26,54
104 Ulten,36,,14,23,37
104 Ulten,37,,21,19,40
104 Ulten,38,,25,26,51
104 Ulten,39,,23,21,44
104 Ulten,40,,30,26,56
104 Ulten,41,,31,22,53
104 Ulten,42,,29,18,47
104 Ulten,43,,25,20,45
104 Ulten,44,,23,22,45
104 Ulten,45,,25,16,41
104 Ulten,46,,34,22,56
104 Ulten,47,,18,16,34
104 Ulten,48,,12,12,24
104 Ulten,49,,19,16,35
104 Ulten,50,,24,13,37
104 Ulten,51,,18,13,31
104 Ulten,52,,19,19,38
104 Ulten,53,,21,14,35
104 Ulten,54,,17,10,27
104 Ulten,55,,13,13,26
104 Ulten,56,,17,8,25
104 Ulten,57,,15,15,30
104 Ulten,58,,8,12,20
104 Ulten,59,,14,20,34
104 Ulten,60,,16,16,32
104 Ulten,61,,9,18,27
104 Ulten,62,,13,11,24
104 Ulten,63,,16,9,25
104 Ulten,64,,20,16,36
104 Ulten,65,,8,11,19
104 Ulten,66,,11,10,21
104 Ulten,67,,9,10,19
104 Ulten,68,,10,15,25
104 Ulten,69,,12,14,26
104 Ulten,70,,5,14,19
104 Ulten,71,,12,8,20
104 Ulten,72,,11,8,19
104 Ulten,73,,16,17,33
104 Ulten,74,,7,14,21
104 Ulten,75,,9,17,26
104 Ulten,76,,7,18,25
104 Ulten,77,,8,14,22
104 Ulten,78,,16,13,29
104 Ulten,79,,10,11,21
104 Ulten,80,,11,25,36
104 Ulten,81,,9,10,19
104 Ulten,82,,9,14,23
104 Ulten,83,,9,12,21
104 Ulten,84,,2,12,14
104 Ulten,85,,3,5,8
104 Ulten,86,,1,2,3
104 Ulten,87,,-,3,3
104 Ulten,88,,3,2,5
104 Ulten,89,,1,7,8
104 Ulten,90,,3,5,8
104 Ulten,91,,1,2,3
104 Ulten,92,,2,4,6
104 Ulten,93,,1,3,4
104 Ulten,94,,2,-,2
104 Ulten,95,,-,1,1
104 Ulten,105,,-,1,1
105 Pfatten,0,,9,5,14
105 Pfatten,1,,2,4,6
105 Pfatten,2,,6,-,6
105 Pfatten,3,,4,5,9
105 Pfatten,4,,5,5,10
105 Pfatten,5,,11,3,14
105 Pfatten,6,,3,1,4
105 Pfatten,7,,4,8,12
105 Pfatten,8,,4,6,10
105 Pfatten,9,,9,10,19
105 Pfatten,10,,4,5,9
105 Pfatten,11,,6,6,12
105 Pfatten,12,,7,4,11
105 Pfatten,13,,9,7,16
105 Pfatten,14,,6,5,11
105 Pfatten,15,,2,7,9
105 Pfatten,16,,6,4,10
105 Pfatten,17,,4,8,12
105 Pfatten,18,,4,5,9
105 Pfatten,19,,3,5,8
105 Pfatten,20,,3,3,6
105 Pfatten,21,,6,2,8
105 Pfatten,22,,8,2,10
105 Pfatten,23,,1,5,6
105 Pfatten,24,,3,10,13
105 Pfatten,25,,4,3,7
105 Pfatten,26,,6,1,7
105 Pfatten,27,,7,3,10
105 Pfatten,28,,-,6,6
105 Pfatten,29,,6,9,15
105 Pfatten,30,,7,7,14
105 Pfatten,31,,9,9,18
105 Pfatten,32,,12,7,19
105 Pfatten,33,,9,6,15
105 Pfatten,34,,7,3,10
105 Pfatten,35,,6,8,14
105 Pfatten,36,,13,5,18
105 Pfatten,37,,9,7,16
105 Pfatten,38,,11,11,22
105 Pfatten,39,,8,5,13
105 Pfatten,40,,7,10,17
105 Pfatten,41,,7,12,19
105 Pfatten,42,,10,15,25
105 Pfatten,43,,6,9,15
105 Pfatten,44,,4,13,17
105 Pfatten,45,,7,7,14
105 Pfatten,46,,15,5,20
105 Pfatten,47,,8,7,15
105 Pfatten,48,,9,5,14
105 Pfatten,49,,11,3,14
105 Pfatten,50,,7,6,13
105 Pfatten,51,,2,6,8
105 Pfatten,52,,4,2,6
105 Pfatten,53,,4,6,10
105 Pfatten,54,,6,2,8
105 Pfatten,55,,3,2,5
105 Pfatten,56,,6,8,14
105 Pfatten,57,,5,4,9
105 Pfatten,58,,5,3,8
105 Pfatten,59,,5,2,7
105 Pfatten,60,,2,2,4
105 Pfatten,61,,5,2,7
105 Pfatten,62,,4,6,10
105 Pfatten,63,,2,4,6
105 Pfatten,64,,4,2,6
105 Pfatten,65,,2,4,6
105 Pfatten,66,,4,1,5
105 Pfatten,67,,3,4,7
105 Pfatten,68,,6,2,8
105 Pfatten,69,,2,6,8
105 Pfatten,70,,2,3,5
105 Pfatten,71,,-,4,4
105 Pfatten,72,,2,4,6
105 Pfatten,73,,2,3,5
105 Pfatten,74,,-,6,6
105 Pfatten,75,,-,1,1
105 Pfatten,76,,1,-,1
105 Pfatten,77,,3,3,6
105 Pfatten,78,,2,4,6
105 Pfatten,79,,2,4,6
105 Pfatten,80,,3,1,4
105 Pfatten,81,,2,1,3
105 Pfatten,82,,-,1,1
105 Pfatten,83,,1,1,2
105 Pfatten,84,,1,-,1
105 Pfatten,85,,-,1,1
105 Pfatten,86,,1,1,2
105 Pfatten,87,,-,2,2
105 Pfatten,90,,1,-,1
105 Pfatten,91,,-,1,1
105 Pfatten,96,,-,2,2
106 Olang,0,,16,17,33
106 Olang,1,,15,13,28
106 Olang,2,,19,22,41
106 Olang,3,,19,18,37
106 Olang,4,,16,16,32
106 Olang,5,,17,23,40
106 Olang,6,,21,19,40
106 Olang,7,,27,22,49
106 Olang,8,,20,9,29
106 Olang,9,,19,11,30
106 Olang,10,,20,22,42
106 Olang,11,,14,16,30
106 Olang,12,,26,18,44
106 Olang,13,,23,22,45
106 Olang,14,,20,20,40
106 Olang,15,,15,18,33
106 Olang,16,,26,17,43
106 Olang,17,,18,17,35
106 Olang,18,,13,23,36
106 Olang,19,,21,15,36
106 Olang,20,,16,20,36
106 Olang,21,,20,23,43
106 Olang,22,,16,22,38
106 Olang,23,,17,27,44
106 Olang,24,,19,20,39
106 Olang,25,,18,14,32
106 Olang,26,,27,27,54
106 Olang,27,,19,24,43
106 Olang,28,,24,30,54
106 Olang,29,,16,26,42
106 Olang,30,,28,26,54
106 Olang,31,,25,19,44
106 Olang,32,,27,18,45
106 Olang,33,,25,19,44
106 Olang,34,,20,30,50
106 Olang,35,,28,25,53
106 Olang,36,,31,25,56
106 Olang,37,,28,21,49
106 Olang,38,,16,24,40
106 Olang,39,,19,31,50
106 Olang,40,,23,23,46
106 Olang,41,,25,11,36
106 Olang,42,,16,27,43
106 Olang,43,,23,24,47
106 Olang,44,,24,16,40
106 Olang,45,,21,13,34
106 Olang,46,,26,14,40
106 Olang,47,,15,27,42
106 Olang,48,,17,18,35
106 Olang,49,,15,18,33
106 Olang,50,,15,19,34
106 Olang,51,,18,13,31
106 Olang,52,,9,12,21
106 Olang,53,,33,16,49
106 Olang,54,,24,12,36
106 Olang,55,,19,21,40
106 Olang,56,,15,23,38
106 Olang,57,,16,13,29
106 Olang,58,,17,10,27
106 Olang,59,,14,6,20
106 Olang,60,,10,17,27
106 Olang,61,,14,15,29
106 Olang,62,,15,14,29
106 Olang,63,,17,10,27
106 Olang,64,,12,8,20
106 Olang,65,,8,14,22
106 Olang,66,,10,9,19
106 Olang,67,,10,8,18
106 Olang,68,,8,15,23
106 Olang,69,,12,9,21
106 Olang,70,,11,15,26
106 Olang,71,,10,13,23
106 Olang,72,,4,7,11
106 Olang,73,,15,8,23
106 Olang,74,,12,13,25
106 Olang,75,,5,9,14
106 Olang,76,,7,9,16
106 Olang,77,,6,13,19
106 Olang,78,,4,6,10
106 Olang,79,,5,7,12
106 Olang,80,,6,4,10
106 Olang,81,,4,6,10
106 Olang,82,,6,4,10
106 Olang,83,,2,5,7
106 Olang,84,,1,3,4
106 Olang,85,,-,1,1
106 Olang,86,,1,2,3
106 Olang,87,,1,1,2
106 Olang,88,,1,4,5
106 Olang,89,,1,3,4
106 Olang,90,,-,1,1
106 Olang,91,,-,1,1
106 Olang,92,,1,4,5
106 Olang,93,,-,2,2
106 Olang,97,,1,-,1
107 Pfitsch,0,,18,13,31
107 Pfitsch,1,,18,20,38
107 Pfitsch,2,,10,9,19
107 Pfitsch,3,,23,22,45
107 Pfitsch,4,,17,15,32
107 Pfitsch,5,,10,18,28
107 Pfitsch,6,,14,11,25
107 Pfitsch,7,,11,14,25
107 Pfitsch,8,,17,10,27
107 Pfitsch,9,,13,21,34
107 Pfitsch,10,,16,13,29
107 Pfitsch,11,,13,15,28
107 Pfitsch,12,,19,12,31
107 Pfitsch,13,,18,15,33
107 Pfitsch,14,,8,18,26
107 Pfitsch,15,,14,13,27
107 Pfitsch,16,,12,17,29
107 Pfitsch,17,,14,9,23
107 Pfitsch,18,,14,10,24
107 Pfitsch,19,,25,12,37
107 Pfitsch,20,,21,20,41
107 Pfitsch,21,,28,15,43
107 Pfitsch,22,,24,15,39
107 Pfitsch,23,,21,21,42
107 Pfitsch,24,,26,17,43
107 Pfitsch,25,,24,15,39
107 Pfitsch,26,,14,19,33
107 Pfitsch,27,,21,20,41
107 Pfitsch,28,,19,18,37
107 Pfitsch,29,,16,21,37
107 Pfitsch,30,,19,12,31
107 Pfitsch,31,,16,19,35
107 Pfitsch,32,,23,18,41
107 Pfitsch,33,,24,21,45
107 Pfitsch,34,,24,25,49
107 Pfitsch,35,,23,19,42
107 Pfitsch,36,,20,17,37
107 Pfitsch,37,,27,15,42
107 Pfitsch,38,,21,19,40
107 Pfitsch,39,,13,25,38
107 Pfitsch,40,,17,18,35
107 Pfitsch,41,,24,24,48
107 Pfitsch,42,,22,21,43
107 Pfitsch,43,,14,27,41
107 Pfitsch,44,,15,18,33
107 Pfitsch,45,,22,15,37
107 Pfitsch,46,,25,22,47
107 Pfitsch,47,,17,12,29
107 Pfitsch,48,,15,14,29
107 Pfitsch,49,,21,20,41
107 Pfitsch,50,,21,14,35
107 Pfitsch,51,,19,23,42
107 Pfitsch,52,,24,13,37
107 Pfitsch,53,,22,17,39
107 Pfitsch,54,,15,20,35
107 Pfitsch,55,,8,11,19
107 Pfitsch,56,,10,13,23
107 Pfitsch,57,,15,12,27
107 Pfitsch,58,,12,11,23
107 Pfitsch,59,,11,15,26
107 Pfitsch,60,,21,12,33
107 Pfitsch,61,,24,13,37
107 Pfitsch,62,,17,16,33
107 Pfitsch,63,,13,14,27
107 Pfitsch,64,,15,8,23
107 Pfitsch,65,,4,12,16
107 Pfitsch,66,,9,11,20
107 Pfitsch,67,,9,12,21
107 Pfitsch,68,,8,8,16
107 Pfitsch,69,,11,5,16
107 Pfitsch,70,,12,13,25
107 Pfitsch,71,,3,14,17
107 Pfitsch,72,,10,12,22
107 Pfitsch,73,,6,12,18
107 Pfitsch,74,,17,12,29
107 Pfitsch,75,,5,13,18
107 Pfitsch,76,,10,12,22
107 Pfitsch,77,,4,12,16
107 Pfitsch,78,,11,10,21
107 Pfitsch,79,,1,17,18
107 Pfitsch,80,,6,13,19
107 Pfitsch,81,,7,4,11
107 Pfitsch,82,,6,7,13
107 Pfitsch,83,,1,5,6
107 Pfitsch,84,,2,7,9
107 Pfitsch,85,,-,3,3
107 Pfitsch,86,,2,2,4
107 Pfitsch,87,,1,2,3
107 Pfitsch,88,,2,4,6
107 Pfitsch,89,,-,1,1
107 Pfitsch,90,,-,2,2
107 Pfitsch,91,,-,4,4
107 Pfitsch,92,,1,1,2
107 Pfitsch,93,,1,-,1
107 Pfitsch,94,,-,1,1
107 Pfitsch,95,,-,2,2
107 Pfitsch,102,,-,1,1
108 Ahrntal,0,,37,41,78
108 Ahrntal,1,,30,34,64
108 Ahrntal,2,,30,30,60
108 Ahrntal,3,,49,39,88
108 Ahrntal,4,,32,39,71
108 Ahrntal,5,,35,36,71
108 Ahrntal,6,,41,43,84
108 Ahrntal,7,,38,49,87
108 Ahrntal,8,,36,31,67
108 Ahrntal,9,,26,26,52
108 Ahrntal,10,,39,41,80
108 Ahrntal,11,,41,32,73
108 Ahrntal,12,,26,35,61
108 Ahrntal,13,,41,31,72
108 Ahrntal,14,,38,33,71
108 Ahrntal,15,,28,33,61
108 Ahrntal,16,,36,37,73
108 Ahrntal,17,,39,49,88
108 Ahrntal,18,,34,45,79
108 Ahrntal,19,,41,32,73
108 Ahrntal,20,,45,47,92
108 Ahrntal,21,,39,44,83
108 Ahrntal,22,,49,38,87
108 Ahrntal,23,,37,38,75
108 Ahrntal,24,,45,38,83
108 Ahrntal,25,,34,50,84
108 Ahrntal,26,,50,48,98
108 Ahrntal,27,,45,47,92
108 Ahrntal,28,,44,47,91
108 Ahrntal,29,,48,41,89
108 Ahrntal,30,,46,44,90
108 Ahrntal,31,,55,50,105
108 Ahrntal,32,,71,42,113
108 Ahrntal,33,,52,45,97
108 Ahrntal,34,,51,45,96
108 Ahrntal,35,,52,49,101
108 Ahrntal,36,,45,50,95
108 Ahrntal,37,,61,40,101
108 Ahrntal,38,,57,42,99
108 Ahrntal,39,,56,44,100
108 Ahrntal,40,,48,44,92
108 Ahrntal,41,,38,48,86
108 Ahrntal,42,,35,35,70
108 Ahrntal,43,,41,30,71
108 Ahrntal,44,,42,38,80
108 Ahrntal,45,,49,26,75
108 Ahrntal,46,,27,40,67
108 Ahrntal,47,,37,18,55
108 Ahrntal,48,,35,26,61
108 Ahrntal,49,,33,21,54
108 Ahrntal,50,,26,30,56
108 Ahrntal,51,,27,32,59
108 Ahrntal,52,,35,26,61
108 Ahrntal,53,,32,24,56
108 Ahrntal,54,,32,30,62
108 Ahrntal,55,,29,28,57
108 Ahrntal,56,,27,18,45
108 Ahrntal,57,,17,23,40
108 Ahrntal,58,,20,14,34
108 Ahrntal,59,,20,18,38
108 Ahrntal,60,,23,32,55
108 Ahrntal,61,,31,30,61
108 Ahrntal,62,,29,34,63
108 Ahrntal,63,,31,25,56
108 Ahrntal,64,,27,23,50
108 Ahrntal,65,,37,29,66
108 Ahrntal,66,,26,22,48
108 Ahrntal,67,,22,16,38
108 Ahrntal,68,,21,37,58
108 Ahrntal,69,,22,20,42
108 Ahrntal,70,,18,17,35
108 Ahrntal,71,,21,26,47
108 Ahrntal,72,,32,21,53
108 Ahrntal,73,,22,19,41
108 Ahrntal,74,,18,16,34
108 Ahrntal,75,,12,26,38
108 Ahrntal,76,,18,18,36
108 Ahrntal,77,,16,14,30
108 Ahrntal,78,,11,17,28
108 Ahrntal,79,,10,15,25
108 Ahrntal,80,,8,13,21
108 Ahrntal,81,,9,16,25
108 Ahrntal,82,,5,9,14
108 Ahrntal,83,,3,6,9
108 Ahrntal,84,,8,4,12
108 Ahrntal,85,,-,4,4
108 Ahrntal,86,,2,7,9
108 Ahrntal,87,,-,4,4
108 Ahrntal,88,,2,9,11
108 Ahrntal,89,,3,9,12
108 Ahrntal,90,,2,2,4
108 Ahrntal,91,,2,5,7
108 Ahrntal,92,,1,-,1
108 Ahrntal,93,,3,1,4
108 Ahrntal,94,,1,2,3
108 Ahrntal,95,,-,1,1
108 Ahrntal,96,,-,1,1
108 Ahrntal,98,,1,1,2
109 Gsies,0,,19,19,38
109 Gsies,1,,11,10,21
109 Gsies,2,,16,15,31
109 Gsies,3,,10,9,19
109 Gsies,4,,22,13,35
109 Gsies,5,,18,6,24
109 Gsies,6,,12,16,28
109 Gsies,7,,10,17,27
109 Gsies,8,,15,14,29
109 Gsies,9,,10,19,29
109 Gsies,10,,17,19,36
109 Gsies,11,,16,10,26
109 Gsies,12,,16,25,41
109 Gsies,13,,16,13,29
109 Gsies,14,,9,12,21
109 Gsies,15,,7,14,21
109 Gsies,16,,18,17,35
109 Gsies,17,,12,17,29
109 Gsies,18,,17,13,30
109 Gsies,19,,14,8,22
109 Gsies,20,,18,10,28
109 Gsies,21,,18,19,37
109 Gsies,22,,15,17,32
109 Gsies,23,,23,21,44
109 Gsies,24,,10,18,28
109 Gsies,25,,14,15,29
109 Gsies,26,,18,19,37
109 Gsies,27,,15,16,31
109 Gsies,28,,20,25,45
109 Gsies,29,,20,18,38
109 Gsies,30,,15,12,27
109 Gsies,31,,9,19,28
109 Gsies,32,,23,18,41
109 Gsies,33,,26,15,41
109 Gsies,34,,26,11,37
109 Gsies,35,,16,15,31
109 Gsies,36,,16,11,27
109 Gsies,37,,14,19,33
109 Gsies,38,,21,5,26
109 Gsies,39,,13,17,30
109 Gsies,40,,14,16,30
109 Gsies,41,,17,8,25
109 Gsies,42,,9,14,23
109 Gsies,43,,17,18,35
109 Gsies,44,,12,14,26
109 Gsies,45,,16,16,32
109 Gsies,46,,12,14,26
109 Gsies,47,,17,7,24
109 Gsies,48,,15,10,25
109 Gsies,49,,16,6,22
109 Gsies,50,,18,6,24
109 Gsies,51,,17,12,29
109 Gsies,52,,16,13,29
109 Gsies,53,,8,8,16
109 Gsies,54,,15,15,30
109 Gsies,55,,9,10,19
109 Gsies,56,,22,7,29
109 Gsies,57,,15,10,25
109 Gsies,58,,4,11,15
109 Gsies,59,,8,13,21
109 Gsies,60,,10,10,20
109 Gsies,61,,5,13,18
109 Gsies,62,,6,11,17
109 Gsies,63,,9,11,20
109 Gsies,64,,6,9,15
109 Gsies,65,,7,9,16
109 Gsies,66,,11,7,18
109 Gsies,67,,4,10,14
109 Gsies,68,,4,9,13
109 Gsies,69,,5,9,14
109 Gsies,70,,6,5,11
109 Gsies,71,,9,5,14
109 Gsies,72,,7,10,17
109 Gsies,73,,12,6,18
109 Gsies,74,,3,6,9
109 Gsies,75,,8,9,17
109 Gsies,76,,2,11,13
109 Gsies,77,,4,4,8
109 Gsies,78,,6,5,11
109 Gsies,79,,5,6,11
109 Gsies,80,,6,8,14
109 Gsies,81,,9,7,16
109 Gsies,82,,2,11,13
109 Gsies,83,,3,4,7
109 Gsies,84,,3,1,4
109 Gsies,85,,1,2,3
109 Gsies,86,,1,2,3
109 Gsies,88,,1,1,2
109 Gsies,90,,-,3,3
109 Gsies,91,,3,3,6
109 Gsies,92,,1,3,4
109 Gsies,95,,-,2,2
109 Gsies,96,,-,2,2
109 Gsies,98,,1,1,2
110 Vintl,0,,17,20,37
110 Vintl,1,,15,22,37
110 Vintl,2,,17,22,39
110 Vintl,3,,22,15,37
110 Vintl,4,,21,22,43
110 Vintl,5,,19,30,49
110 Vintl,6,,19,18,37
110 Vintl,7,,23,19,42
110 Vintl,8,,36,25,61
110 Vintl,9,,18,18,36
110 Vintl,10,,23,21,44
110 Vintl,11,,28,22,50
110 Vintl,12,,21,30,51
110 Vintl,13,,29,22,51
110 Vintl,14,,27,16,43
110 Vintl,15,,21,21,42
110 Vintl,16,,20,23,43
110 Vintl,17,,21,20,41
110 Vintl,18,,10,15,25
110 Vintl,19,,26,11,37
110 Vintl,20,,24,19,43
110 Vintl,21,,21,21,42
110 Vintl,22,,18,27,45
110 Vintl,23,,32,18,50
110 Vintl,24,,31,18,49
110 Vintl,25,,21,35,56
110 Vintl,26,,17,23,40
110 Vintl,27,,25,29,54
110 Vintl,28,,24,19,43
110 Vintl,29,,25,24,49
110 Vintl,30,,20,22,42
110 Vintl,31,,33,19,52
110 Vintl,32,,32,25,57
110 Vintl,33,,22,22,44
110 Vintl,34,,28,24,52
110 Vintl,35,,28,22,50
110 Vintl,36,,33,37,70
110 Vintl,37,,31,31,62
110 Vintl,38,,34,30,64
110 Vintl,39,,35,23,58
110 Vintl,40,,32,26,58
110 Vintl,41,,31,24,55
110 Vintl,42,,28,31,59
110 Vintl,43,,18,23,41
110 Vintl,44,,23,23,46
110 Vintl,45,,20,13,33
110 Vintl,46,,23,27,50
110 Vintl,47,,25,17,42
110 Vintl,48,,18,14,32
110 Vintl,49,,16,18,34
110 Vintl,50,,22,9,31
110 Vintl,51,,19,20,39
110 Vintl,52,,22,18,40
110 Vintl,53,,22,18,40
110 Vintl,54,,16,17,33
110 Vintl,55,,13,13,26
110 Vintl,56,,20,14,34
110 Vintl,57,,15,12,27
110 Vintl,58,,15,20,35
110 Vintl,59,,13,5,18
110 Vintl,60,,20,11,31
110 Vintl,61,,11,13,24
110 Vintl,62,,6,16,22
110 Vintl,63,,8,19,27
110 Vintl,64,,15,15,30
110 Vintl,65,,11,5,16
110 Vintl,66,,11,10,21
110 Vintl,67,,15,11,26
110 Vintl,68,,9,11,20
110 Vintl,69,,16,9,25
110 Vintl,70,,6,18,24
110 Vintl,71,,9,15,24
110 Vintl,72,,9,11,20
110 Vintl,73,,8,14,22
110 Vintl,74,,10,15,25
110 Vintl,75,,12,8,20
110 Vintl,76,,9,14,23
110 Vintl,77,,13,5,18
110 Vintl,78,,6,8,14
110 Vintl,79,,7,8,15
110 Vintl,80,,7,8,15
110 Vintl,81,,3,6,9
110 Vintl,82,,5,6,11
110 Vintl,83,,2,8,10
110 Vintl,84,,2,4,6
110 Vintl,85,,-,2,2
110 Vintl,86,,-,3,3
110 Vintl,87,,1,2,3
110 Vintl,88,,1,3,4
110 Vintl,89,,1,4,5
110 Vintl,90,,-,2,2
110 Vintl,91,,1,-,1
110 Vintl,92,,-,1,1
110 Vintl,93,,-,2,2
110 Vintl,94,,-,1,1
110 Vintl,96,,1,-,1
111 Vahrn,0,,27,19,46
111 Vahrn,1,,29,24,53
111 Vahrn,2,,30,20,50
111 Vahrn,3,,24,20,44
111 Vahrn,4,,24,36,60
111 Vahrn,5,,22,22,44
111 Vahrn,6,,20,21,41
111 Vahrn,7,,35,20,55
111 Vahrn,8,,18,15,33
111 Vahrn,9,,21,22,43
111 Vahrn,10,,20,17,37
111 Vahrn,11,,16,22,38
111 Vahrn,12,,19,23,42
111 Vahrn,13,,12,26,38
111 Vahrn,14,,30,20,50
111 Vahrn,15,,24,19,43
111 Vahrn,16,,17,16,33
111 Vahrn,17,,22,15,37
111 Vahrn,18,,29,27,56
111 Vahrn,19,,21,19,40
111 Vahrn,20,,25,27,52
111 Vahrn,21,,24,23,47
111 Vahrn,22,,27,20,47
111 Vahrn,23,,24,24,48
111 Vahrn,24,,15,30,45
111 Vahrn,25,,19,25,44
111 Vahrn,26,,15,19,34
111 Vahrn,27,,37,19,56
111 Vahrn,28,,36,25,61
111 Vahrn,29,,23,33,56
111 Vahrn,30,,33,40,73
111 Vahrn,31,,30,29,59
111 Vahrn,32,,38,33,71
111 Vahrn,33,,39,39,78
111 Vahrn,34,,36,35,71
111 Vahrn,35,,29,27,56
111 Vahrn,36,,48,30,78
111 Vahrn,37,,34,30,64
111 Vahrn,38,,43,41,84
111 Vahrn,39,,35,34,69
111 Vahrn,40,,33,28,61
111 Vahrn,41,,31,32,63
111 Vahrn,42,,23,21,44
111 Vahrn,43,,33,30,63
111 Vahrn,44,,27,20,47
111 Vahrn,45,,18,18,36
111 Vahrn,46,,30,28,58
111 Vahrn,47,,20,17,37
111 Vahrn,48,,29,28,57
111 Vahrn,49,,19,30,49
111 Vahrn,50,,24,27,51
111 Vahrn,51,,24,17,41
111 Vahrn,52,,21,12,33
111 Vahrn,53,,16,19,35
111 Vahrn,54,,22,27,49
111 Vahrn,55,,18,15,33
111 Vahrn,56,,15,24,39
111 Vahrn,57,,20,23,43
111 Vahrn,58,,11,16,27
111 Vahrn,59,,17,20,37
111 Vahrn,60,,25,24,49
111 Vahrn,61,,18,22,40
111 Vahrn,62,,19,23,42
111 Vahrn,63,,20,15,35
111 Vahrn,64,,19,19,38
111 Vahrn,65,,15,9,24
111 Vahrn,66,,16,20,36
111 Vahrn,67,,12,17,29
111 Vahrn,68,,10,14,24
111 Vahrn,69,,10,15,25
111 Vahrn,70,,9,12,21
111 Vahrn,71,,11,13,24
111 Vahrn,72,,10,15,25
111 Vahrn,73,,15,16,31
111 Vahrn,74,,7,17,24
111 Vahrn,75,,10,12,22
111 Vahrn,76,,7,18,25
111 Vahrn,77,,7,4,11
111 Vahrn,78,,4,13,17
111 Vahrn,79,,6,18,24
111 Vahrn,80,,7,11,18
111 Vahrn,81,,5,11,16
111 Vahrn,82,,7,7,14
111 Vahrn,83,,2,4,6
111 Vahrn,84,,2,3,5
111 Vahrn,85,,1,4,5
111 Vahrn,86,,3,3,6
111 Vahrn,87,,1,-,1
111 Vahrn,88,,-,4,4
111 Vahrn,89,,1,2,3
111 Vahrn,90,,1,1,2
111 Vahrn,91,,1,2,3
111 Vahrn,92,,1,1,2
111 Vahrn,93,,-,2,2
111 Vahrn,94,,-,1,1
111 Vahrn,95,,-,1,1
111 Vahrn,97,,-,1,1
112 Vöran,0,,8,6,14
112 Vöran,1,,5,5,10
112 Vöran,2,,7,4,11
112 Vöran,3,,13,5,18
112 Vöran,4,,6,3,9
112 Vöran,5,,6,4,10
112 Vöran,6,,14,5,19
112 Vöran,7,,9,6,15
112 Vöran,8,,5,9,14
112 Vöran,9,,7,8,15
112 Vöran,10,,7,6,13
112 Vöran,11,,6,3,9
112 Vöran,12,,7,3,10
112 Vöran,13,,5,7,12
112 Vöran,14,,10,6,16
112 Vöran,15,,7,8,15
112 Vöran,16,,11,6,17
112 Vöran,17,,6,6,12
112 Vöran,18,,9,10,19
112 Vöran,19,,9,5,14
112 Vöran,20,,6,6,12
112 Vöran,21,,8,8,16
112 Vöran,22,,9,10,19
112 Vöran,23,,4,4,8
112 Vöran,24,,3,7,10
112 Vöran,25,,10,7,17
112 Vöran,26,,12,6,18
112 Vöran,27,,6,4,10
112 Vöran,28,,7,5,12
112 Vöran,29,,11,7,18
112 Vöran,30,,4,5,9
112 Vöran,31,,10,6,16
112 Vöran,32,,5,10,15
112 Vöran,33,,10,4,14
112 Vöran,34,,6,3,9
112 Vöran,35,,13,3,16
112 Vöran,36,,3,7,10
112 Vöran,37,,9,7,16
112 Vöran,38,,4,3,7
112 Vöran,39,,11,4,15
112 Vöran,40,,8,7,15
112 Vöran,41,,12,15,27
112 Vöran,42,,5,7,12
112 Vöran,43,,6,6,12
112 Vöran,44,,5,8,13
112 Vöran,45,,6,5,11
112 Vöran,46,,6,9,15
112 Vöran,47,,2,1,3
112 Vöran,48,,5,2,7
112 Vöran,49,,5,6,11
112 Vöran,50,,5,4,9
112 Vöran,51,,9,1,10
112 Vöran,52,,2,-,2
112 Vöran,53,,7,4,11
112 Vöran,54,,6,4,10
112 Vöran,55,,2,3,5
112 Vöran,56,,5,4,9
112 Vöran,57,,4,2,6
112 Vöran,58,,-,3,3
112 Vöran,59,,4,3,7
112 Vöran,60,,3,5,8
112 Vöran,61,,6,4,10
112 Vöran,62,,4,6,10
112 Vöran,63,,3,5,8
112 Vöran,64,,2,3,5
112 Vöran,65,,8,4,12
112 Vöran,66,,2,2,4
112 Vöran,67,,3,5,8
112 Vöran,68,,2,1,3
112 Vöran,69,,1,7,8
112 Vöran,70,,6,6,12
112 Vöran,71,,3,5,8
112 Vöran,72,,3,1,4
112 Vöran,73,,5,1,6
112 Vöran,74,,1,3,4
112 Vöran,75,,5,1,6
112 Vöran,76,,-,2,2
112 Vöran,77,,-,3,3
112 Vöran,78,,3,4,7
112 Vöran,79,,-,2,2
112 Vöran,80,,2,1,3
112 Vöran,81,,2,-,2
112 Vöran,82,,1,1,2
112 Vöran,83,,-,2,2
112 Vöran,87,,1,2,3
112 Vöran,94,,-,1,1
112 Vöran,99,,-,1,1
113 Niederdorf,0,,13,12,25
113 Niederdorf,1,,5,11,16
113 Niederdorf,2,,6,10,16
113 Niederdorf,3,,11,11,22
113 Niederdorf,4,,4,6,10
113 Niederdorf,5,,7,10,17
113 Niederdorf,6,,9,8,17
113 Niederdorf,7,,7,9,16
113 Niederdorf,8,,6,11,17
113 Niederdorf,9,,13,7,20
113 Niederdorf,10,,9,7,16
113 Niederdorf,11,,7,10,17
113 Niederdorf,12,,7,12,19
113 Niederdorf,13,,12,10,22
113 Niederdorf,14,,9,7,16
113 Niederdorf,15,,7,10,17
113 Niederdorf,16,,2,8,10
113 Niederdorf,17,,4,7,11
113 Niederdorf,18,,8,5,13
113 Niederdorf,19,,8,6,14
113 Niederdorf,20,,7,10,17
113 Niederdorf,21,,3,11,14
113 Niederdorf,22,,10,8,18
113 Niederdorf,23,,9,4,13
113 Niederdorf,24,,10,3,13
113 Niederdorf,25,,4,3,7
113 Niederdorf,26,,6,5,11
113 Niederdorf,27,,12,6,18
113 Niederdorf,28,,8,8,16
113 Niederdorf,29,,9,10,19
113 Niederdorf,30,,14,8,22
113 Niederdorf,31,,15,11,26
113 Niederdorf,32,,11,14,25
113 Niederdorf,33,,12,9,21
113 Niederdorf,34,,21,15,36
113 Niederdorf,35,,16,10,26
113 Niederdorf,36,,13,15,28
113 Niederdorf,37,,23,10,33
113 Niederdorf,38,,9,15,24
113 Niederdorf,39,,17,13,30
113 Niederdorf,40,,12,10,22
113 Niederdorf,41,,17,9,26
113 Niederdorf,42,,14,12,26
113 Niederdorf,43,,9,9,18
113 Niederdorf,44,,10,9,19
113 Niederdorf,45,,6,6,12
113 Niederdorf,46,,12,10,22
113 Niederdorf,47,,8,10,18
113 Niederdorf,48,,11,7,18
113 Niederdorf,49,,12,7,19
113 Niederdorf,50,,7,3,10
113 Niederdorf,51,,8,5,13
113 Niederdorf,52,,1,1,2
113 Niederdorf,53,,5,4,9
113 Niederdorf,54,,10,4,14
113 Niederdorf,55,,4,9,13
113 Niederdorf,56,,6,9,15
113 Niederdorf,57,,6,7,13
113 Niederdorf,58,,2,6,8
113 Niederdorf,59,,9,5,14
113 Niederdorf,60,,6,9,15
113 Niederdorf,61,,6,11,17
113 Niederdorf,62,,5,5,10
113 Niederdorf,63,,5,7,12
113 Niederdorf,64,,1,4,5
113 Niederdorf,65,,5,6,11
113 Niederdorf,66,,6,7,13
113 Niederdorf,67,,6,8,14
113 Niederdorf,68,,7,7,14
113 Niederdorf,69,,2,13,15
113 Niederdorf,70,,6,7,13
113 Niederdorf,71,,8,6,14
113 Niederdorf,72,,8,6,14
113 Niederdorf,73,,6,9,15
113 Niederdorf,74,,3,9,12
113 Niederdorf,75,,5,5,10
113 Niederdorf,76,,8,9,17
113 Niederdorf,77,,4,6,10
113 Niederdorf,78,,1,6,7
113 Niederdorf,79,,3,10,13
113 Niederdorf,80,,2,3,5
113 Niederdorf,81,,3,9,12
113 Niederdorf,82,,5,4,9
113 Niederdorf,83,,1,4,5
113 Niederdorf,84,,1,3,4
113 Niederdorf,85,,1,2,3
113 Niederdorf,86,,1,1,2
113 Niederdorf,87,,-,2,2
113 Niederdorf,88,,-,2,2
113 Niederdorf,89,,-,1,1
113 Niederdorf,90,,1,1,2
113 Niederdorf,91,,-,2,2
113 Niederdorf,92,,-,1,1
113 Niederdorf,93,,-,1,1
113 Niederdorf,98,,-,1,1
114 Villanders,0,,5,12,17
114 Villanders,1,,9,13,22
114 Villanders,2,,13,12,25
114 Villanders,3,,10,17,27
114 Villanders,4,,13,10,23
114 Villanders,5,,13,9,22
114 Villanders,6,,10,12,22
114 Villanders,7,,15,8,23
114 Villanders,8,,18,5,23
114 Villanders,9,,11,13,24
114 Villanders,10,,7,18,25
114 Villanders,11,,14,8,22
114 Villanders,12,,18,15,33
114 Villanders,13,,16,14,30
114 Villanders,14,,13,10,23
114 Villanders,15,,9,12,21
114 Villanders,16,,6,15,21
114 Villanders,17,,8,8,16
114 Villanders,18,,10,10,20
114 Villanders,19,,13,13,26
114 Villanders,20,,14,6,20
114 Villanders,21,,15,12,27
114 Villanders,22,,20,14,34
114 Villanders,23,,10,17,27
114 Villanders,24,,17,9,26
114 Villanders,25,,12,14,26
114 Villanders,26,,16,13,29
114 Villanders,27,,14,10,24
114 Villanders,28,,9,12,21
114 Villanders,29,,14,15,29
114 Villanders,30,,13,21,34
114 Villanders,31,,14,16,30
114 Villanders,32,,18,23,41
114 Villanders,33,,19,8,27
114 Villanders,34,,26,19,45
114 Villanders,35,,24,11,35
114 Villanders,36,,18,16,34
114 Villanders,37,,22,16,38
114 Villanders,38,,21,16,37
114 Villanders,39,,21,16,37
114 Villanders,40,,15,14,29
114 Villanders,41,,18,11,29
114 Villanders,42,,14,13,27
114 Villanders,43,,20,7,27
114 Villanders,44,,16,11,27
114 Villanders,45,,17,7,24
114 Villanders,46,,9,7,16
114 Villanders,47,,10,13,23
114 Villanders,48,,11,17,28
114 Villanders,49,,9,5,14
114 Villanders,50,,10,8,18
114 Villanders,51,,11,7,18
114 Villanders,52,,10,7,17
114 Villanders,53,,10,9,19
114 Villanders,54,,10,6,16
114 Villanders,55,,7,12,19
114 Villanders,56,,7,7,14
114 Villanders,57,,11,10,21
114 Villanders,58,,6,3,9
114 Villanders,59,,5,9,14
114 Villanders,60,,7,8,15
114 Villanders,61,,10,8,18
114 Villanders,62,,8,9,17
114 Villanders,63,,9,12,21
114 Villanders,64,,8,5,13
114 Villanders,65,,8,6,14
114 Villanders,66,,5,9,14
114 Villanders,67,,6,6,12
114 Villanders,68,,2,9,11
114 Villanders,69,,1,9,10
114 Villanders,70,,10,9,19
114 Villanders,71,,9,9,18
114 Villanders,72,,5,7,12
114 Villanders,73,,8,6,14
114 Villanders,74,,3,9,12
114 Villanders,75,,3,8,11
114 Villanders,76,,8,6,14
114 Villanders,77,,5,5,10
114 Villanders,78,,2,7,9
114 Villanders,79,,5,4,9
114 Villanders,80,,6,3,9
114 Villanders,81,,2,5,7
114 Villanders,82,,2,9,11
114 Villanders,83,,4,4,8
114 Villanders,84,,-,2,2
114 Villanders,86,,-,1,1
114 Villanders,87,,-,1,1
114 Villanders,88,,-,2,2
114 Villanders,89,,1,4,5
114 Villanders,90,,1,2,3
114 Villanders,91,,1,4,5
114 Villanders,92,,-,4,4
114 Villanders,93,,-,1,1
114 Villanders,94,,-,2,2
114 Villanders,97,,1,-,1
114 Villanders,100,,-,1,1
115 Sterzing,0,,25,36,61
115 Sterzing,1,,39,22,61
115 Sterzing,2,,35,34,69
115 Sterzing,3,,27,36,63
115 Sterzing,4,,24,27,51
115 Sterzing,5,,23,28,51
115 Sterzing,6,,33,33,66
115 Sterzing,7,,28,36,64
115 Sterzing,8,,34,28,62
115 Sterzing,9,,33,20,53
115 Sterzing,10,,34,27,61
115 Sterzing,11,,29,33,62
115 Sterzing,12,,35,35,70
115 Sterzing,13,,21,33,54
115 Sterzing,14,,36,21,57
115 Sterzing,15,,28,26,54
115 Sterzing,16,,28,24,52
115 Sterzing,17,,37,29,66
115 Sterzing,18,,16,30,46
115 Sterzing,19,,31,26,57
115 Sterzing,20,,30,33,63
115 Sterzing,21,,31,38,69
115 Sterzing,22,,56,36,92
115 Sterzing,23,,40,41,81
115 Sterzing,24,,42,51,93
115 Sterzing,25,,52,34,86
115 Sterzing,26,,47,35,82
115 Sterzing,27,,39,42,81
115 Sterzing,28,,64,47,111
115 Sterzing,29,,53,35,88
115 Sterzing,30,,46,57,103
115 Sterzing,31,,56,55,111
115 Sterzing,32,,63,50,113
115 Sterzing,33,,51,52,103
115 Sterzing,34,,48,37,85
115 Sterzing,35,,57,48,105
115 Sterzing,36,,63,40,103
115 Sterzing,37,,49,52,101
115 Sterzing,38,,57,47,104
115 Sterzing,39,,50,43,93
115 Sterzing,40,,57,51,108
115 Sterzing,41,,39,47,86
115 Sterzing,42,,43,37,80
115 Sterzing,43,,45,45,90
115 Sterzing,44,,52,42,94
115 Sterzing,45,,44,42,86
115 Sterzing,46,,35,49,84
115 Sterzing,47,,47,28,75
115 Sterzing,48,,34,46,80
115 Sterzing,49,,33,36,69
115 Sterzing,50,,32,40,72
115 Sterzing,51,,43,38,81
115 Sterzing,52,,38,41,79
115 Sterzing,53,,36,41,77
115 Sterzing,54,,34,49,83
115 Sterzing,55,,38,43,81
115 Sterzing,56,,30,29,59
115 Sterzing,57,,45,44,89
115 Sterzing,58,,35,36,71
115 Sterzing,59,,32,29,61
115 Sterzing,60,,47,45,92
115 Sterzing,61,,28,34,62
115 Sterzing,62,,31,28,59
115 Sterzing,63,,42,33,75
115 Sterzing,64,,30,30,60
115 Sterzing,65,,29,29,58
115 Sterzing,66,,23,35,58
115 Sterzing,67,,23,44,67
115 Sterzing,68,,23,23,46
115 Sterzing,69,,19,24,43
115 Sterzing,70,,28,29,57
115 Sterzing,71,,16,18,34
115 Sterzing,72,,23,32,55
115 Sterzing,73,,8,26,34
115 Sterzing,74,,20,19,39
115 Sterzing,75,,18,29,47
115 Sterzing,76,,21,20,41
115 Sterzing,77,,13,20,33
115 Sterzing,78,,7,21,28
115 Sterzing,79,,13,18,31
115 Sterzing,80,,12,20,32
115 Sterzing,81,,15,23,38
115 Sterzing,82,,3,15,18
115 Sterzing,83,,3,11,14
115 Sterzing,84,,6,8,14
115 Sterzing,85,,4,4,8
115 Sterzing,86,,3,3,6
115 Sterzing,87,,3,5,8
115 Sterzing,88,,2,4,6
115 Sterzing,89,,2,10,12
115 Sterzing,90,,1,4,5
115 Sterzing,91,,-,6,6
115 Sterzing,92,,-,3,3
115 Sterzing,93,,-,2,2
115 Sterzing,94,,1,1,2
115 Sterzing,95,,2,-,2
115 Sterzing,96,,-,1,1
115 Sterzing,97,,-,1,1
115 Sterzing,101,,-,1,1
115 Sterzing,102,,-,1,1
116 Feldthurns,0,,13,14,27
116 Feldthurns,1,,21,25,46
116 Feldthurns,2,,15,21,36
116 Feldthurns,3,,25,14,39
116 Feldthurns,4,,18,24,42
116 Feldthurns,5,,22,18,40
116 Feldthurns,6,,22,16,38
116 Feldthurns,7,,15,19,34
116 Feldthurns,8,,20,18,38
116 Feldthurns,9,,15,16,31
116 Feldthurns,10,,29,20,49
116 Feldthurns,11,,17,19,36
116 Feldthurns,12,,12,14,26
116 Feldthurns,13,,13,17,30
116 Feldthurns,14,,20,14,34
116 Feldthurns,15,,15,19,34
116 Feldthurns,16,,21,13,34
116 Feldthurns,17,,18,20,38
116 Feldthurns,18,,13,20,33
116 Feldthurns,19,,16,19,35
116 Feldthurns,20,,26,24,50
116 Feldthurns,21,,15,21,36
116 Feldthurns,22,,19,19,38
116 Feldthurns,23,,11,25,36
116 Feldthurns,24,,13,16,29
116 Feldthurns,25,,30,22,52
116 Feldthurns,26,,19,17,36
116 Feldthurns,27,,24,26,50
116 Feldthurns,28,,17,15,32
116 Feldthurns,29,,26,30,56
116 Feldthurns,30,,21,20,41
116 Feldthurns,31,,36,26,62
116 Feldthurns,32,,18,26,44
116 Feldthurns,33,,18,21,39
116 Feldthurns,34,,23,26,49
116 Feldthurns,35,,19,26,45
116 Feldthurns,36,,24,21,45
116 Feldthurns,37,,21,20,41
116 Feldthurns,38,,24,28,52
116 Feldthurns,39,,24,19,43
116 Feldthurns,40,,27,17,44
116 Feldthurns,41,,15,17,32
116 Feldthurns,42,,17,17,34
116 Feldthurns,43,,17,12,29
116 Feldthurns,44,,15,15,30
116 Feldthurns,45,,15,19,34
116 Feldthurns,46,,14,13,27
116 Feldthurns,47,,11,18,29
116 Feldthurns,48,,14,13,27
116 Feldthurns,49,,13,14,27
116 Feldthurns,50,,18,13,31
116 Feldthurns,51,,24,15,39
116 Feldthurns,52,,15,11,26
116 Feldthurns,53,,14,15,29
116 Feldthurns,54,,7,15,22
116 Feldthurns,55,,14,11,25
116 Feldthurns,56,,16,8,24
116 Feldthurns,57,,10,9,19
116 Feldthurns,58,,13,13,26
116 Feldthurns,59,,19,11,30
116 Feldthurns,60,,13,12,25
116 Feldthurns,61,,9,8,17
116 Feldthurns,62,,8,4,12
116 Feldthurns,63,,11,7,18
116 Feldthurns,64,,7,11,18
116 Feldthurns,65,,11,8,19
116 Feldthurns,66,,3,10,13
116 Feldthurns,67,,8,11,19
116 Feldthurns,68,,10,11,21
116 Feldthurns,69,,3,5,8
116 Feldthurns,70,,7,5,12
116 Feldthurns,71,,7,10,17
116 Feldthurns,72,,5,6,11
116 Feldthurns,73,,4,13,17
116 Feldthurns,74,,4,11,15
116 Feldthurns,75,,9,4,13
116 Feldthurns,76,,5,5,10
116 Feldthurns,77,,3,7,10
116 Feldthurns,78,,5,8,13
116 Feldthurns,79,,4,9,13
116 Feldthurns,80,,7,9,16
116 Feldthurns,81,,2,10,12
116 Feldthurns,82,,1,9,10
116 Feldthurns,83,,6,10,16
116 Feldthurns,84,,5,7,12
116 Feldthurns,85,,3,-,3
116 Feldthurns,86,,-,2,2
116 Feldthurns,87,,-,3,3
116 Feldthurns,88,,2,7,9
116 Feldthurns,89,,1,3,4
116 Feldthurns,90,,-,1,1
116 Feldthurns,91,,1,1,2
116 Feldthurns,92,,-,1,1
116 Feldthurns,94,,1,-,1
116 Feldthurns,99,,-,1,1
117 Wengen,0,,5,7,12
117 Wengen,1,,9,5,14
117 Wengen,2,,5,11,16
117 Wengen,3,,11,5,16
117 Wengen,4,,9,5,14
117 Wengen,5,,7,8,15
117 Wengen,6,,12,7,19
117 Wengen,7,,9,9,18
117 Wengen,8,,11,9,20
117 Wengen,9,,12,7,19
117 Wengen,10,,11,7,18
117 Wengen,11,,10,7,17
117 Wengen,12,,17,8,25
117 Wengen,13,,12,7,19
117 Wengen,14,,6,7,13
117 Wengen,15,,6,9,15
117 Wengen,16,,11,5,16
117 Wengen,17,,8,8,16
117 Wengen,18,,9,6,15
117 Wengen,19,,14,7,21
117 Wengen,20,,13,5,18
117 Wengen,21,,11,5,16
117 Wengen,22,,6,7,13
117 Wengen,23,,9,11,20
117 Wengen,24,,14,6,20
117 Wengen,25,,6,6,12
117 Wengen,26,,10,8,18
117 Wengen,27,,6,9,15
117 Wengen,28,,17,9,26
117 Wengen,29,,10,6,16
117 Wengen,30,,17,12,29
117 Wengen,31,,11,12,23
117 Wengen,32,,12,12,24
117 Wengen,33,,11,14,25
117 Wengen,34,,10,12,22
117 Wengen,35,,18,11,29
117 Wengen,36,,10,13,23
117 Wengen,37,,13,6,19
117 Wengen,38,,8,10,18
117 Wengen,39,,11,6,17
117 Wengen,40,,12,13,25
117 Wengen,41,,14,7,21
117 Wengen,42,,8,9,17
117 Wengen,43,,10,12,22
117 Wengen,44,,7,6,13
117 Wengen,45,,5,8,13
117 Wengen,46,,7,11,18
117 Wengen,47,,5,6,11
117 Wengen,48,,8,6,14
117 Wengen,49,,9,4,13
117 Wengen,50,,6,2,8
117 Wengen,51,,6,7,13
117 Wengen,52,,9,5,14
117 Wengen,53,,3,6,9
117 Wengen,54,,5,9,14
117 Wengen,55,,2,12,14
117 Wengen,56,,6,3,9
117 Wengen,57,,5,3,8
117 Wengen,58,,5,3,8
117 Wengen,59,,9,8,17
117 Wengen,60,,3,7,10
117 Wengen,61,,8,6,14
117 Wengen,62,,4,4,8
117 Wengen,63,,7,9,16
117 Wengen,64,,6,3,9
117 Wengen,65,,5,4,9
117 Wengen,66,,7,7,14
117 Wengen,67,,2,1,3
117 Wengen,68,,2,7,9
117 Wengen,69,,2,9,11
117 Wengen,70,,4,2,6
117 Wengen,71,,2,8,10
117 Wengen,72,,5,2,7
117 Wengen,73,,4,2,6
117 Wengen,74,,2,9,11
117 Wengen,75,,2,3,5
117 Wengen,76,,4,5,9
117 Wengen,77,,4,5,9
117 Wengen,78,,3,4,7
117 Wengen,79,,1,6,7
117 Wengen,80,,3,6,9
117 Wengen,81,,3,4,7
117 Wengen,82,,4,8,12
117 Wengen,83,,1,2,3
117 Wengen,84,,1,1,2
117 Wengen,86,,2,-,2
117 Wengen,88,,1,1,2
117 Wengen,90,,-,2,2
117 Wengen,91,,1,-,1
117 Wengen,93,,-,1,1
117 Wengen,95,,-,2,2
117 Wengen,97,,1,-,1
117 Wengen,99,,-,1,1
118 U.L.Frau i.W.-St.Felix,0,,8,6,14
118 U.L.Frau i.W.-St.Felix,1,,5,3,8
118 U.L.Frau i.W.-St.Felix,2,,6,5,11
118 U.L.Frau i.W.-St.Felix,3,,3,2,5
118 U.L.Frau i.W.-St.Felix,4,,5,5,10
118 U.L.Frau i.W.-St.Felix,5,,6,8,14
118 U.L.Frau i.W.-St.Felix,6,,5,5,10
118 U.L.Frau i.W.-St.Felix,7,,8,5,13
118 U.L.Frau i.W.-St.Felix,8,,4,10,14
118 U.L.Frau i.W.-St.Felix,9,,7,8,15
118 U.L.Frau i.W.-St.Felix,10,,9,5,14
118 U.L.Frau i.W.-St.Felix,11,,7,4,11
118 U.L.Frau i.W.-St.Felix,12,,10,8,18
118 U.L.Frau i.W.-St.Felix,13,,7,4,11
118 U.L.Frau i.W.-St.Felix,14,,8,6,14
118 U.L.Frau i.W.-St.Felix,15,,8,6,14
118 U.L.Frau i.W.-St.Felix,16,,4,7,11
118 U.L.Frau i.W.-St.Felix,17,,7,4,11
118 U.L.Frau i.W.-St.Felix,18,,5,7,12
118 U.L.Frau i.W.-St.Felix,19,,5,6,11
118 U.L.Frau i.W.-St.Felix,20,,2,12,14
118 U.L.Frau i.W.-St.Felix,21,,2,6,8
118 U.L.Frau i.W.-St.Felix,22,,6,4,10
118 U.L.Frau i.W.-St.Felix,23,,3,6,9
118 U.L.Frau i.W.-St.Felix,24,,2,3,5
118 U.L.Frau i.W.-St.Felix,25,,1,4,5
118 U.L.Frau i.W.-St.Felix,26,,4,3,7
118 U.L.Frau i.W.-St.Felix,27,,4,8,12
118 U.L.Frau i.W.-St.Felix,28,,8,3,11
118 U.L.Frau i.W.-St.Felix,29,,5,5,10
118 U.L.Frau i.W.-St.Felix,30,,3,4,7
118 U.L.Frau i.W.-St.Felix,31,,8,4,12
118 U.L.Frau i.W.-St.Felix,32,,2,3,5
118 U.L.Frau i.W.-St.Felix,33,,5,8,13
118 U.L.Frau i.W.-St.Felix,34,,7,4,11
118 U.L.Frau i.W.-St.Felix,35,,5,10,15
118 U.L.Frau i.W.-St.Felix,36,,4,5,9
118 U.L.Frau i.W.-St.Felix,37,,8,7,15
118 U.L.Frau i.W.-St.Felix,38,,10,6,16
118 U.L.Frau i.W.-St.Felix,39,,4,8,12
118 U.L.Frau i.W.-St.Felix,40,,17,8,25
118 U.L.Frau i.W.-St.Felix,41,,8,11,19
118 U.L.Frau i.W.-St.Felix,42,,4,4,8
118 U.L.Frau i.W.-St.Felix,43,,8,9,17
118 U.L.Frau i.W.-St.Felix,44,,5,5,10
118 U.L.Frau i.W.-St.Felix,45,,4,2,6
118 U.L.Frau i.W.-St.Felix,46,,3,5,8
118 U.L.Frau i.W.-St.Felix,47,,5,6,11
118 U.L.Frau i.W.-St.Felix,48,,3,4,7
118 U.L.Frau i.W.-St.Felix,49,,7,3,10
118 U.L.Frau i.W.-St.Felix,50,,3,3,6
118 U.L.Frau i.W.-St.Felix,51,,6,3,9
118 U.L.Frau i.W.-St.Felix,52,,6,3,9
118 U.L.Frau i.W.-St.Felix,53,,4,3,7
118 U.L.Frau i.W.-St.Felix,54,,5,-,5
118 U.L.Frau i.W.-St.Felix,55,,4,2,6
118 U.L.Frau i.W.-St.Felix,56,,2,6,8
118 U.L.Frau i.W.-St.Felix,57,,1,5,6
118 U.L.Frau i.W.-St.Felix,58,,3,1,4
118 U.L.Frau i.W.-St.Felix,59,,5,1,6
118 U.L.Frau i.W.-St.Felix,60,,7,4,11
118 U.L.Frau i.W.-St.Felix,61,,4,4,8
118 U.L.Frau i.W.-St.Felix,62,,5,8,13
118 U.L.Frau i.W.-St.Felix,63,,3,1,4
118 U.L.Frau i.W.-St.Felix,64,,1,4,5
118 U.L.Frau i.W.-St.Felix,65,,3,4,7
118 U.L.Frau i.W.-St.Felix,66,,3,-,3
118 U.L.Frau i.W.-St.Felix,67,,5,2,7
118 U.L.Frau i.W.-St.Felix,68,,3,3,6
118 U.L.Frau i.W.-St.Felix,69,,3,3,6
118 U.L.Frau i.W.-St.Felix,70,,5,4,9
118 U.L.Frau i.W.-St.Felix,71,,7,1,8
118 U.L.Frau i.W.-St.Felix,72,,4,1,5
118 U.L.Frau i.W.-St.Felix,73,,4,5,9
118 U.L.Frau i.W.-St.Felix,74,,1,3,4
118 U.L.Frau i.W.-St.Felix,75,,3,5,8
118 U.L.Frau i.W.-St.Felix,76,,3,4,7
118 U.L.Frau i.W.-St.Felix,77,,2,3,5
118 U.L.Frau i.W.-St.Felix,78,,4,5,9
118 U.L.Frau i.W.-St.Felix,79,,4,4,8
118 U.L.Frau i.W.-St.Felix,80,,2,5,7
118 U.L.Frau i.W.-St.Felix,81,,1,1,2
118 U.L.Frau i.W.-St.Felix,82,,-,3,3
118 U.L.Frau i.W.-St.Felix,83,,-,1,1
118 U.L.Frau i.W.-St.Felix,84,,1,2,3
118 U.L.Frau i.W.-St.Felix,86,,1,-,1
118 U.L.Frau i.W.-St.Felix,89,,-,1,1
118 U.L.Frau i.W.-St.Felix,90,,1,1,2
118 U.L.Frau i.W.-St.Felix,91,,2,2,4
118 U.L.Frau i.W.-St.Felix,93,,-,2,2

