Gemeinde,Altersklassen,Geschlecht,Männer,Frauen,Insgesamt
001 Aldein,0,,14,10,24
001 Aldein,1,,17,9,26
001 Aldein,2,,10,11,21
001 Aldein,3,,17,9,26
001 Aldein,4,,12,4,16
001 Aldein,5,,16,15,31
001 Aldein,6,,11,15,26
001 Aldein,7,,14,9,23
001 Aldein,8,,7,8,15
001 Aldein,9,,9,12,21
001 Aldein,10,,15,8,23
001 Aldein,11,,13,12,25
001 Aldein,12,,9,13,22
001 Aldein,13,,7,9,16
001 Aldein,14,,8,6,14
001 Aldein,15,,9,16,25
001 Aldein,16,,11,9,20
001 Aldein,17,,12,7,19
001 Aldein,18,,11,11,22
001 Aldein,19,,13,12,25
001 Aldein,20,,10,7,17
001 Aldein,21,,14,13,27
001 Aldein,22,,14,6,20
001 Aldein,23,,10,14,24
001 Aldein,24,,9,13,22
001 Aldein,25,,10,18,28
001 Aldein,26,,10,6,16
001 Aldein,27,,7,22,29
001 Aldein,28,,11,16,27
001 Aldein,29,,16,16,32
001 Aldein,30,,11,15,26
001 Aldein,31,,14,9,23
001 Aldein,32,,18,13,31
001 Aldein,33,,15,15,30
001 Aldein,34,,13,15,28
001 Aldein,35,,22,7,29
001 Aldein,36,,12,16,28
001 Aldein,37,,7,15,22
001 Aldein,38,,8,20,28
001 Aldein,39,,17,10,27
001 Aldein,40,,14,10,24
001 Aldein,41,,15,6,21
001 Aldein,42,,8,16,24
001 Aldein,43,,15,17,32
001 Aldein,44,,16,9,25
001 Aldein,45,,12,14,26
001 Aldein,46,,8,5,13
001 Aldein,47,,9,10,19
001 Aldein,48,,10,8,18
001 Aldein,49,,8,10,18
001 Aldein,50,,9,6,15
001 Aldein,51,,9,9,18
001 Aldein,52,,8,5,13
001 Aldein,53,,15,11,26
001 Aldein,54,,5,12,17
001 Aldein,55,,8,6,14
001 Aldein,56,,9,9,18
001 Aldein,57,,6,11,17
001 Aldein,58,,7,12,19
001 Aldein,59,,10,5,15
001 Aldein,60,,6,7,13
001 Aldein,61,,11,11,22
001 Aldein,62,,8,12,20
001 Aldein,63,,6,12,18
001 Aldein,64,,9,8,17
001 Aldein,65,,5,8,13
001 Aldein,66,,7,7,14
001 Aldein,67,,7,10,17
001 Aldein,68,,8,6,14
001 Aldein,69,,4,4,8
001 Aldein,70,,14,5,19
001 Aldein,71,,8,4,12
001 Aldein,72,,4,8,12
001 Aldein,73,,7,4,11
001 Aldein,74,,5,5,10
001 Aldein,75,,7,8,15
001 Aldein,76,,5,3,8
001 Aldein,77,,5,5,10
001 Aldein,78,,-,5,5
001 Aldein,79,,1,5,6
001 Aldein,80,,1,8,9
001 Aldein,81,,2,5,7
001 Aldein,82,,1,9,10
001 Aldein,83,,3,10,13
001 Aldein,84,,4,1,5
001 Aldein,85,,-,4,4
001 Aldein,87,,-,1,1
001 Aldein,88,,2,1,3
001 Aldein,90,,-,1,1
001 Aldein,91,,-,2,2
001 Aldein,92,,2,2,4
001 Aldein,94,,1,-,1
001 Aldein,97,,-,1,1
002 Andrian,0,,9,4,13
002 Andrian,1,,7,10,17
002 Andrian,2,,3,-,3
002 Andrian,3,,3,4,7
002 Andrian,4,,6,5,11
002 Andrian,5,,3,6,9
002 Andrian,6,,8,1,9
002 Andrian,7,,10,6,16
002 Andrian,8,,2,10,12
002 Andrian,9,,8,4,12
002 Andrian,10,,5,5,10
002 Andrian,11,,5,5,10
002 Andrian,12,,6,6,12
002 Andrian,13,,5,7,12
002 Andrian,14,,5,4,9
002 Andrian,15,,4,3,7
002 Andrian,16,,12,7,19
002 Andrian,17,,6,7,13
002 Andrian,18,,8,6,14
002 Andrian,19,,1,3,4
002 Andrian,20,,7,5,12
002 Andrian,21,,5,2,7
002 Andrian,22,,10,8,18
002 Andrian,23,,2,3,5
002 Andrian,24,,8,3,11
002 Andrian,25,,6,5,11
002 Andrian,26,,4,3,7
002 Andrian,27,,5,6,11
002 Andrian,28,,6,4,10
002 Andrian,29,,7,5,12
002 Andrian,30,,6,10,16
002 Andrian,31,,7,9,16
002 Andrian,32,,7,6,13
002 Andrian,33,,7,12,19
002 Andrian,34,,13,5,18
002 Andrian,35,,7,7,14
002 Andrian,36,,9,10,19
002 Andrian,37,,8,8,16
002 Andrian,38,,9,8,17
002 Andrian,39,,11,9,20
002 Andrian,40,,9,7,16
002 Andrian,41,,8,13,21
002 Andrian,42,,9,8,17
002 Andrian,43,,7,2,9
002 Andrian,44,,8,4,12
002 Andrian,45,,7,6,13
002 Andrian,46,,7,8,15
002 Andrian,47,,4,7,11
002 Andrian,48,,5,9,14
002 Andrian,49,,2,4,6
002 Andrian,50,,6,2,8
002 Andrian,51,,7,7,14
002 Andrian,52,,2,3,5
002 Andrian,53,,3,3,6
002 Andrian,54,,7,5,12
002 Andrian,55,,4,2,6
002 Andrian,56,,8,3,11
002 Andrian,57,,5,5,10
002 Andrian,58,,4,8,12
002 Andrian,59,,1,2,3
002 Andrian,60,,-,4,4
002 Andrian,61,,5,7,12
002 Andrian,62,,4,5,9
002 Andrian,63,,6,4,10
002 Andrian,64,,3,7,10
002 Andrian,65,,1,8,9
002 Andrian,66,,4,4,8
002 Andrian,67,,6,4,10
002 Andrian,68,,2,2,4
002 Andrian,69,,3,2,5
002 Andrian,70,,5,3,8
002 Andrian,71,,3,4,7
002 Andrian,72,,7,5,12
002 Andrian,73,,3,4,7
002 Andrian,74,,4,2,6
002 Andrian,75,,2,1,3
002 Andrian,76,,2,4,6
002 Andrian,77,,1,2,3
002 Andrian,78,,3,4,7
002 Andrian,79,,2,1,3
002 Andrian,80,,2,5,7
002 Andrian,81,,1,1,2
002 Andrian,82,,1,4,5
002 Andrian,83,,1,4,5
002 Andrian,84,,1,-,1
002 Andrian,85,,2,1,3
002 Andrian,86,,1,1,2
002 Andrian,88,,1,-,1
002 Andrian,89,,-,2,2
002 Andrian,90,,1,1,2
002 Andrian,91,,-,1,1
002 Andrian,93,,-,1,1
002 Andrian,97,,-,1,1
003 Altrei,0,,2,1,3
003 Altrei,1,,-,1,1
003 Altrei,2,,3,1,4
003 Altrei,3,,3,1,4
003 Altrei,4,,1,1,2
003 Altrei,5,,3,-,3
003 Altrei,6,,3,1,4
003 Altrei,7,,1,1,2
003 Altrei,8,,-,3,3
003 Altrei,9,,1,2,3
003 Altrei,10,,3,2,5
003 Altrei,11,,3,-,3
003 Altrei,12,,6,3,9
003 Altrei,13,,1,1,2
003 Altrei,14,,3,2,5
003 Altrei,15,,2,2,4
003 Altrei,16,,5,4,9
003 Altrei,17,,1,1,2
003 Altrei,18,,3,3,6
003 Altrei,19,,3,1,4
003 Altrei,20,,4,1,5
003 Altrei,21,,4,1,5
003 Altrei,22,,2,2,4
003 Altrei,23,,3,1,4
003 Altrei,24,,3,3,6
003 Altrei,25,,-,1,1
003 Altrei,26,,2,5,7
003 Altrei,27,,-,4,4
003 Altrei,28,,2,3,5
003 Altrei,29,,3,1,4
003 Altrei,30,,1,-,1
003 Altrei,31,,2,3,5
003 Altrei,32,,3,1,4
003 Altrei,33,,5,4,9
003 Altrei,34,,1,3,4
003 Altrei,35,,3,6,9
003 Altrei,36,,-,4,4
003 Altrei,37,,3,-,3
003 Altrei,38,,3,4,7
003 Altrei,39,,2,4,6
003 Altrei,40,,3,6,9
003 Altrei,41,,2,2,4
003 Altrei,42,,11,1,12
003 Altrei,43,,2,2,4
003 Altrei,44,,5,2,7
003 Altrei,45,,4,3,7
003 Altrei,46,,1,3,4
003 Altrei,47,,1,4,5
003 Altrei,48,,5,1,6
003 Altrei,49,,3,3,6
003 Altrei,50,,1,1,2
003 Altrei,51,,3,2,5
003 Altrei,52,,6,3,9
003 Altrei,53,,5,3,8
003 Altrei,54,,1,2,3
003 Altrei,55,,1,-,1
003 Altrei,56,,3,3,6
003 Altrei,57,,3,2,5
003 Altrei,58,,2,3,5
003 Altrei,59,,3,1,4
003 Altrei,60,,2,3,5
003 Altrei,61,,1,3,4
003 Altrei,62,,3,1,4
003 Altrei,63,,2,3,5
003 Altrei,64,,1,4,5
003 Altrei,65,,1,3,4
003 Altrei,66,,2,-,2
003 Altrei,67,,2,1,3
003 Altrei,68,,3,1,4
003 Altrei,69,,2,2,4
003 Altrei,70,,-,2,2
003 Altrei,71,,3,2,5
003 Altrei,72,,-,3,3
003 Altrei,73,,-,2,2
003 Altrei,74,,2,2,4
003 Altrei,75,,2,2,4
003 Altrei,76,,-,2,2
003 Altrei,77,,2,4,6
003 Altrei,78,,1,4,5
003 Altrei,79,,-,1,1
003 Altrei,80,,1,2,3
003 Altrei,81,,-,1,1
003 Altrei,82,,1,1,2
003 Altrei,83,,-,1,1
003 Altrei,84,,1,1,2
003 Altrei,87,,-,3,3
003 Altrei,89,,-,1,1
003 Altrei,90,,-,1,1
003 Altrei,91,,1,1,2
003 Altrei,93,,-,2,2
003 Altrei,96,,-,1,1
004 Eppan a.d. Weinstr.,0,,84,61,145
004 Eppan a.d. Weinstr.,1,,89,72,161
004 Eppan a.d. Weinstr.,2,,75,74,149
004 Eppan a.d. Weinstr.,3,,78,77,155
004 Eppan a.d. Weinstr.,4,,71,82,153
004 Eppan a.d. Weinstr.,5,,82,55,137
004 Eppan a.d. Weinstr.,6,,87,81,168
004 Eppan a.d. Weinstr.,7,,75,73,148
004 Eppan a.d. Weinstr.,8,,77,69,146
004 Eppan a.d. Weinstr.,9,,73,67,140
004 Eppan a.d. Weinstr.,10,,74,76,150
004 Eppan a.d. Weinstr.,11,,82,86,168
004 Eppan a.d. Weinstr.,12,,68,77,145
004 Eppan a.d. Weinstr.,13,,78,63,141
004 Eppan a.d. Weinstr.,14,,83,64,147
004 Eppan a.d. Weinstr.,15,,80,61,141
004 Eppan a.d. Weinstr.,16,,81,83,164
004 Eppan a.d. Weinstr.,17,,74,65,139
004 Eppan a.d. Weinstr.,18,,87,70,157
004 Eppan a.d. Weinstr.,19,,80,58,138
004 Eppan a.d. Weinstr.,20,,74,75,149
004 Eppan a.d. Weinstr.,21,,66,72,138
004 Eppan a.d. Weinstr.,22,,65,73,138
004 Eppan a.d. Weinstr.,23,,58,73,131
004 Eppan a.d. Weinstr.,24,,83,66,149
004 Eppan a.d. Weinstr.,25,,76,74,150
004 Eppan a.d. Weinstr.,26,,80,75,155
004 Eppan a.d. Weinstr.,27,,80,65,145
004 Eppan a.d. Weinstr.,28,,83,77,160
004 Eppan a.d. Weinstr.,29,,90,96,186
004 Eppan a.d. Weinstr.,30,,91,95,186
004 Eppan a.d. Weinstr.,31,,103,100,203
004 Eppan a.d. Weinstr.,32,,109,118,227
004 Eppan a.d. Weinstr.,33,,108,102,210
004 Eppan a.d. Weinstr.,34,,125,119,244
004 Eppan a.d. Weinstr.,35,,128,118,246
004 Eppan a.d. Weinstr.,36,,121,115,236
004 Eppan a.d. Weinstr.,37,,129,120,249
004 Eppan a.d. Weinstr.,38,,125,139,264
004 Eppan a.d. Weinstr.,39,,102,115,217
004 Eppan a.d. Weinstr.,40,,127,117,244
004 Eppan a.d. Weinstr.,41,,104,125,229
004 Eppan a.d. Weinstr.,42,,123,116,239
004 Eppan a.d. Weinstr.,43,,124,100,224
004 Eppan a.d. Weinstr.,44,,108,117,225
004 Eppan a.d. Weinstr.,45,,121,107,228
004 Eppan a.d. Weinstr.,46,,107,102,209
004 Eppan a.d. Weinstr.,47,,98,94,192
004 Eppan a.d. Weinstr.,48,,85,75,160
004 Eppan a.d. Weinstr.,49,,89,85,174
004 Eppan a.d. Weinstr.,50,,68,88,156
004 Eppan a.d. Weinstr.,51,,84,77,161
004 Eppan a.d. Weinstr.,52,,69,82,151
004 Eppan a.d. Weinstr.,53,,83,65,148
004 Eppan a.d. Weinstr.,54,,60,72,132
004 Eppan a.d. Weinstr.,55,,64,64,128
004 Eppan a.d. Weinstr.,56,,80,68,148
004 Eppan a.d. Weinstr.,57,,66,82,148
004 Eppan a.d. Weinstr.,58,,83,70,153
004 Eppan a.d. Weinstr.,59,,59,48,107
004 Eppan a.d. Weinstr.,60,,74,82,156
004 Eppan a.d. Weinstr.,61,,97,81,178
004 Eppan a.d. Weinstr.,62,,94,81,175
004 Eppan a.d. Weinstr.,63,,65,103,168
004 Eppan a.d. Weinstr.,64,,75,58,133
004 Eppan a.d. Weinstr.,65,,60,83,143
004 Eppan a.d. Weinstr.,66,,59,53,112
004 Eppan a.d. Weinstr.,67,,46,57,103
004 Eppan a.d. Weinstr.,68,,46,52,98
004 Eppan a.d. Weinstr.,69,,43,49,92
004 Eppan a.d. Weinstr.,70,,31,53,84
004 Eppan a.d. Weinstr.,71,,54,55,109
004 Eppan a.d. Weinstr.,72,,46,50,96
004 Eppan a.d. Weinstr.,73,,38,58,96
004 Eppan a.d. Weinstr.,74,,50,63,113
004 Eppan a.d. Weinstr.,75,,38,52,90
004 Eppan a.d. Weinstr.,76,,40,44,84
004 Eppan a.d. Weinstr.,77,,30,42,72
004 Eppan a.d. Weinstr.,78,,40,51,91
004 Eppan a.d. Weinstr.,79,,35,54,89
004 Eppan a.d. Weinstr.,80,,18,63,81
004 Eppan a.d. Weinstr.,81,,21,39,60
004 Eppan a.d. Weinstr.,82,,10,41,51
004 Eppan a.d. Weinstr.,83,,20,37,57
004 Eppan a.d. Weinstr.,84,,14,24,38
004 Eppan a.d. Weinstr.,85,,12,18,30
004 Eppan a.d. Weinstr.,86,,9,16,25
004 Eppan a.d. Weinstr.,87,,9,8,17
004 Eppan a.d. Weinstr.,88,,6,13,19
004 Eppan a.d. Weinstr.,89,,5,10,15
004 Eppan a.d. Weinstr.,90,,6,19,25
004 Eppan a.d. Weinstr.,91,,2,10,12
004 Eppan a.d. Weinstr.,92,,1,16,17
004 Eppan a.d. Weinstr.,93,,2,12,14
004 Eppan a.d. Weinstr.,94,,1,4,5
004 Eppan a.d. Weinstr.,95,,3,7,10
004 Eppan a.d. Weinstr.,96,,-,3,3
004 Eppan a.d. Weinstr.,97,,-,4,4
004 Eppan a.d. Weinstr.,98,,-,3,3
004 Eppan a.d. Weinstr.,99,,1,-,1
004 Eppan a.d. Weinstr.,100,,-,1,1
005 Hafling,0,,5,8,13
005 Hafling,1,,1,5,6
005 Hafling,2,,5,4,9
005 Hafling,3,,7,2,9
005 Hafling,4,,5,9,14
005 Hafling,5,,4,4,8
005 Hafling,6,,2,7,9
005 Hafling,7,,1,9,10
005 Hafling,8,,12,4,16
005 Hafling,9,,6,4,10
005 Hafling,10,,3,5,8
005 Hafling,11,,2,7,9
005 Hafling,12,,3,4,7
005 Hafling,13,,8,3,11
005 Hafling,14,,4,6,10
005 Hafling,15,,4,2,6
005 Hafling,16,,2,7,9
005 Hafling,17,,4,4,8
005 Hafling,18,,5,2,7
005 Hafling,19,,5,5,10
005 Hafling,20,,4,9,13
005 Hafling,21,,3,-,3
005 Hafling,22,,6,4,10
005 Hafling,23,,5,5,10
005 Hafling,24,,3,10,13
005 Hafling,25,,5,3,8
005 Hafling,26,,5,5,10
005 Hafling,27,,4,3,7
005 Hafling,28,,4,6,10
005 Hafling,29,,8,4,12
005 Hafling,30,,6,10,16
005 Hafling,31,,11,2,13
005 Hafling,32,,8,2,10
005 Hafling,33,,9,5,14
005 Hafling,34,,8,5,13
005 Hafling,35,,10,11,21
005 Hafling,36,,3,9,12
005 Hafling,37,,4,3,7
005 Hafling,38,,10,7,17
005 Hafling,39,,9,11,20
005 Hafling,40,,3,2,5
005 Hafling,41,,6,3,9
005 Hafling,42,,5,2,7
005 Hafling,43,,7,3,10
005 Hafling,44,,8,7,15
005 Hafling,45,,5,5,10
005 Hafling,46,,3,4,7
005 Hafling,47,,1,5,6
005 Hafling,48,,3,10,13
005 Hafling,49,,7,2,9
005 Hafling,50,,3,1,4
005 Hafling,51,,2,3,5
005 Hafling,52,,5,2,7
005 Hafling,53,,2,3,5
005 Hafling,54,,4,3,7
005 Hafling,55,,5,3,8
005 Hafling,56,,6,2,8
005 Hafling,57,,2,4,6
005 Hafling,58,,-,4,4
005 Hafling,59,,5,3,8
005 Hafling,60,,1,3,4
005 Hafling,61,,5,5,10
005 Hafling,62,,5,3,8
005 Hafling,63,,5,4,9
005 Hafling,64,,2,2,4
005 Hafling,65,,4,5,9
005 Hafling,66,,3,3,6
005 Hafling,67,,3,3,6
005 Hafling,68,,1,1,2
005 Hafling,69,,1,1,2
005 Hafling,70,,1,2,3
005 Hafling,71,,6,4,10
005 Hafling,72,,3,4,7
005 Hafling,73,,3,7,10
005 Hafling,74,,1,4,5
005 Hafling,75,,3,1,4
005 Hafling,76,,3,3,6
005 Hafling,77,,3,5,8
005 Hafling,78,,1,2,3
005 Hafling,79,,1,-,1
005 Hafling,80,,1,2,3
005 Hafling,81,,1,-,1
005 Hafling,82,,-,2,2
005 Hafling,83,,-,3,3
005 Hafling,84,,3,1,4
005 Hafling,85,,1,2,3
005 Hafling,87,,-,1,1
005 Hafling,88,,-,1,1
005 Hafling,89,,1,-,1
005 Hafling,93,,1,-,1
006 Abtei,0,,25,15,40
006 Abtei,1,,19,17,36
006 Abtei,2,,10,28,38
006 Abtei,3,,28,23,51
006 Abtei,4,,22,32,54
006 Abtei,5,,23,27,50
006 Abtei,6,,12,13,25
006 Abtei,7,,26,22,48
006 Abtei,8,,29,14,43
006 Abtei,9,,24,29,53
006 Abtei,10,,19,14,33
006 Abtei,11,,15,19,34
006 Abtei,12,,24,15,39
006 Abtei,13,,21,12,33
006 Abtei,14,,23,17,40
006 Abtei,15,,15,14,29
006 Abtei,16,,14,10,24
006 Abtei,17,,19,12,31
006 Abtei,18,,17,18,35
006 Abtei,19,,11,14,25
006 Abtei,20,,12,20,32
006 Abtei,21,,14,11,25
006 Abtei,22,,19,19,38
006 Abtei,23,,16,17,33
006 Abtei,24,,23,17,40
006 Abtei,25,,12,23,35
006 Abtei,26,,21,29,50
006 Abtei,27,,21,31,52
006 Abtei,28,,29,24,53
006 Abtei,29,,16,31,47
006 Abtei,30,,21,24,45
006 Abtei,31,,28,27,55
006 Abtei,32,,45,29,74
006 Abtei,33,,16,32,48
006 Abtei,34,,31,31,62
006 Abtei,35,,29,33,62
006 Abtei,36,,27,36,63
006 Abtei,37,,36,35,71
006 Abtei,38,,23,30,53
006 Abtei,39,,35,27,62
006 Abtei,40,,23,31,54
006 Abtei,41,,32,27,59
006 Abtei,42,,25,29,54
006 Abtei,43,,23,27,50
006 Abtei,44,,28,22,50
006 Abtei,45,,25,23,48
006 Abtei,46,,18,23,41
006 Abtei,47,,19,15,34
006 Abtei,48,,19,17,36
006 Abtei,49,,17,15,32
006 Abtei,50,,12,14,26
006 Abtei,51,,14,19,33
006 Abtei,52,,14,13,27
006 Abtei,53,,12,13,25
006 Abtei,54,,15,19,34
006 Abtei,55,,10,19,29
006 Abtei,56,,24,17,41
006 Abtei,57,,15,16,31
006 Abtei,58,,23,19,42
006 Abtei,59,,15,20,35
006 Abtei,60,,13,18,31
006 Abtei,61,,13,11,24
006 Abtei,62,,21,12,33
006 Abtei,63,,17,24,41
006 Abtei,64,,17,17,34
006 Abtei,65,,14,13,27
006 Abtei,66,,16,17,33
006 Abtei,67,,6,18,24
006 Abtei,68,,17,10,27
006 Abtei,69,,13,18,31
006 Abtei,70,,15,16,31
006 Abtei,71,,8,15,23
006 Abtei,72,,8,5,13
006 Abtei,73,,12,12,24
006 Abtei,74,,15,12,27
006 Abtei,75,,7,8,15
006 Abtei,76,,6,14,20
006 Abtei,77,,6,9,15
006 Abtei,78,,8,6,14
006 Abtei,79,,8,5,13
006 Abtei,80,,5,9,14
006 Abtei,81,,6,10,16
006 Abtei,82,,7,5,12
006 Abtei,83,,4,2,6
006 Abtei,84,,3,9,12
006 Abtei,85,,1,4,5
006 Abtei,86,,2,2,4
006 Abtei,88,,1,3,4
006 Abtei,89,,-,2,2
006 Abtei,90,,-,2,2
006 Abtei,91,,2,-,2
006 Abtei,92,,1,4,5
006 Abtei,93,,1,2,3
006 Abtei,94,,1,2,3
006 Abtei,95,,1,-,1
006 Abtei,96,,-,1,1
006 Abtei,97,,-,1,1
007 Barbian,0,,9,5,14
007 Barbian,1,,8,13,21
007 Barbian,2,,8,6,14
007 Barbian,3,,10,14,24
007 Barbian,4,,12,6,18
007 Barbian,5,,11,10,21
007 Barbian,6,,16,8,24
007 Barbian,7,,10,7,17
007 Barbian,8,,10,10,20
007 Barbian,9,,10,8,18
007 Barbian,10,,8,4,12
007 Barbian,11,,10,12,22
007 Barbian,12,,12,6,18
007 Barbian,13,,12,11,23
007 Barbian,14,,14,13,27
007 Barbian,15,,10,13,23
007 Barbian,16,,12,6,18
007 Barbian,17,,8,7,15
007 Barbian,18,,14,7,21
007 Barbian,19,,7,9,16
007 Barbian,20,,10,6,16
007 Barbian,21,,11,7,18
007 Barbian,22,,9,6,15
007 Barbian,23,,13,14,27
007 Barbian,24,,9,7,16
007 Barbian,25,,18,13,31
007 Barbian,26,,11,10,21
007 Barbian,27,,8,16,24
007 Barbian,28,,9,13,22
007 Barbian,29,,10,9,19
007 Barbian,30,,14,15,29
007 Barbian,31,,8,15,23
007 Barbian,32,,20,17,37
007 Barbian,33,,16,10,26
007 Barbian,34,,10,10,20
007 Barbian,35,,15,7,22
007 Barbian,36,,14,12,26
007 Barbian,37,,9,8,17
007 Barbian,38,,13,15,28
007 Barbian,39,,7,12,19
007 Barbian,40,,15,15,30
007 Barbian,41,,14,15,29
007 Barbian,42,,15,14,29
007 Barbian,43,,17,11,28
007 Barbian,44,,12,16,28
007 Barbian,45,,12,9,21
007 Barbian,46,,8,9,17
007 Barbian,47,,15,7,22
007 Barbian,48,,4,9,13
007 Barbian,49,,7,7,14
007 Barbian,50,,6,14,20
007 Barbian,51,,10,9,19
007 Barbian,52,,7,5,12
007 Barbian,53,,7,10,17
007 Barbian,54,,12,11,23
007 Barbian,55,,5,6,11
007 Barbian,56,,3,4,7
007 Barbian,57,,6,11,17
007 Barbian,58,,18,6,24
007 Barbian,59,,8,4,12
007 Barbian,60,,10,9,19
007 Barbian,61,,8,6,14
007 Barbian,62,,11,12,23
007 Barbian,63,,8,12,20
007 Barbian,64,,9,3,12
007 Barbian,65,,6,5,11
007 Barbian,66,,5,10,15
007 Barbian,67,,8,8,16
007 Barbian,68,,3,5,8
007 Barbian,69,,3,7,10
007 Barbian,70,,5,5,10
007 Barbian,71,,8,4,12
007 Barbian,72,,6,6,12
007 Barbian,73,,4,8,12
007 Barbian,74,,6,6,12
007 Barbian,75,,8,8,16
007 Barbian,76,,5,9,14
007 Barbian,77,,5,2,7
007 Barbian,78,,4,3,7
007 Barbian,79,,4,3,7
007 Barbian,80,,1,5,6
007 Barbian,81,,3,6,9
007 Barbian,82,,2,5,7
007 Barbian,83,,1,3,4
007 Barbian,84,,1,2,3
007 Barbian,85,,-,2,2
007 Barbian,86,,1,-,1
007 Barbian,87,,-,1,1
007 Barbian,88,,-,1,1
007 Barbian,89,,-,1,1
007 Barbian,90,,1,2,3
007 Barbian,91,,-,1,1
007 Barbian,93,,2,-,2
007 Barbian,94,,1,-,1
008 Bozen,0,,473,448,921
008 Bozen,1,,479,477,956
008 Bozen,2,,471,434,905
008 Bozen,3,,469,420,889
008 Bozen,4,,434,447,881
008 Bozen,5,,479,453,932
008 Bozen,6,,448,450,898
008 Bozen,7,,457,381,838
008 Bozen,8,,430,448,878
008 Bozen,9,,415,373,788
008 Bozen,10,,455,434,889
008 Bozen,11,,401,401,802
008 Bozen,12,,429,389,818
008 Bozen,13,,469,393,862
008 Bozen,14,,437,407,844
008 Bozen,15,,429,394,823
008 Bozen,16,,422,401,823
008 Bozen,17,,355,383,738
008 Bozen,18,,395,367,762
008 Bozen,19,,412,380,792
008 Bozen,20,,407,392,799
008 Bozen,21,,456,386,842
008 Bozen,22,,458,413,871
008 Bozen,23,,476,420,896
008 Bozen,24,,532,434,966
008 Bozen,25,,506,469,975
008 Bozen,26,,579,489,1.068
008 Bozen,27,,580,515,1.095
008 Bozen,28,,583,596,1.179
008 Bozen,29,,685,641,1.326
008 Bozen,30,,708,719,1.427
008 Bozen,31,,730,767,1.497
008 Bozen,32,,806,755,1.561
008 Bozen,33,,875,850,1.725
008 Bozen,34,,846,758,1.604
008 Bozen,35,,899,807,1.706
008 Bozen,36,,801,758,1.559
008 Bozen,37,,796,808,1.604
008 Bozen,38,,881,852,1.733
008 Bozen,39,,887,847,1.734
008 Bozen,40,,893,890,1.783
008 Bozen,41,,763,819,1.582
008 Bozen,42,,743,777,1.520
008 Bozen,43,,775,721,1.496
008 Bozen,44,,684,694,1.378
008 Bozen,45,,690,686,1.376
008 Bozen,46,,686,685,1.371
008 Bozen,47,,609,707,1.316
008 Bozen,48,,631,647,1.278
008 Bozen,49,,608,631,1.239
008 Bozen,50,,612,604,1.216
008 Bozen,51,,547,606,1.153
008 Bozen,52,,541,641,1.182
008 Bozen,53,,538,633,1.171
008 Bozen,54,,592,680,1.272
008 Bozen,55,,609,642,1.251
008 Bozen,56,,648,741,1.389
008 Bozen,57,,633,799,1.432
008 Bozen,58,,715,879,1.594
008 Bozen,59,,550,595,1.145
008 Bozen,60,,594,723,1.317
008 Bozen,61,,626,727,1.353
008 Bozen,62,,637,716,1.353
008 Bozen,63,,697,759,1.456
008 Bozen,64,,672,735,1.407
008 Bozen,65,,589,722,1.311
008 Bozen,66,,628,664,1.292
008 Bozen,67,,543,575,1.118
008 Bozen,68,,494,562,1.056
008 Bozen,69,,473,576,1.049
008 Bozen,70,,493,567,1.060
008 Bozen,71,,407,568,975
008 Bozen,72,,431,579,1.010
008 Bozen,73,,425,558,983
008 Bozen,74,,429,565,994
008 Bozen,75,,315,538,853
008 Bozen,76,,357,503,860
008 Bozen,77,,316,499,815
008 Bozen,78,,370,473,843
008 Bozen,79,,284,520,804
008 Bozen,80,,267,469,736
008 Bozen,81,,249,481,730
008 Bozen,82,,247,501,748
008 Bozen,83,,200,443,643
008 Bozen,84,,168,396,564
008 Bozen,85,,89,254,343
008 Bozen,86,,60,148,208
008 Bozen,87,,55,144,199
008 Bozen,88,,56,149,205
008 Bozen,89,,69,201,270
008 Bozen,90,,74,172,246
008 Bozen,91,,50,149,199
008 Bozen,92,,33,120,153
008 Bozen,93,,24,101,125
008 Bozen,94,,18,70,88
008 Bozen,95,,10,48,58
008 Bozen,96,,10,37,47
008 Bozen,97,,3,22,25
008 Bozen,98,,3,15,18
008 Bozen,99,,1,11,12
008 Bozen,100,,-,5,5
008 Bozen,101,,-,8,8
008 Bozen,102,,-,3,3
008 Bozen,103,,-,2,2
008 Bozen,107,,-,1,1
009 Prags,0,,3,4,7
009 Prags,1,,2,4,6
009 Prags,2,,2,4,6
009 Prags,3,,3,5,8
009 Prags,4,,2,3,5
009 Prags,5,,4,8,12
009 Prags,6,,2,4,6
009 Prags,7,,3,5,8
009 Prags,8,,2,6,8
009 Prags,9,,2,2,4
009 Prags,10,,4,6,10
009 Prags,11,,7,3,10
009 Prags,12,,6,3,9
009 Prags,13,,9,2,11
009 Prags,14,,4,2,6
009 Prags,15,,8,3,11
009 Prags,16,,2,3,5
009 Prags,17,,3,3,6
009 Prags,18,,6,5,11
009 Prags,19,,8,2,10
009 Prags,20,,4,3,7
009 Prags,21,,3,7,10
009 Prags,22,,3,6,9
009 Prags,23,,1,6,7
009 Prags,24,,4,1,5
009 Prags,25,,2,1,3
009 Prags,26,,6,3,9
009 Prags,27,,5,2,7
009 Prags,28,,5,2,7
009 Prags,29,,3,6,9
009 Prags,30,,3,5,8
009 Prags,31,,8,3,11
009 Prags,32,,3,1,4
009 Prags,33,,5,4,9
009 Prags,34,,5,7,12
009 Prags,35,,7,4,11
009 Prags,36,,7,8,15
009 Prags,37,,6,7,13
009 Prags,38,,7,4,11
009 Prags,39,,7,6,13
009 Prags,40,,6,5,11
009 Prags,41,,6,5,11
009 Prags,42,,4,4,8
009 Prags,43,,5,11,16
009 Prags,44,,6,4,10
009 Prags,45,,11,5,16
009 Prags,46,,5,2,7
009 Prags,47,,5,4,9
009 Prags,48,,1,5,6
009 Prags,49,,3,4,7
009 Prags,50,,6,4,10
009 Prags,51,,4,2,6
009 Prags,52,,2,5,7
009 Prags,53,,3,1,4
009 Prags,54,,5,1,6
009 Prags,55,,1,1,2
009 Prags,56,,5,1,6
009 Prags,57,,1,-,1
009 Prags,58,,2,4,6
009 Prags,59,,2,2,4
009 Prags,60,,4,4,8
009 Prags,61,,1,4,5
009 Prags,62,,4,4,8
009 Prags,63,,5,2,7
009 Prags,64,,1,3,4
009 Prags,65,,3,5,8
009 Prags,66,,4,2,6
009 Prags,67,,1,2,3
009 Prags,68,,2,3,5
009 Prags,69,,1,3,4
009 Prags,70,,3,2,5
009 Prags,71,,4,2,6
009 Prags,72,,4,6,10
009 Prags,73,,1,4,5
009 Prags,74,,1,1,2
009 Prags,75,,3,2,5
009 Prags,76,,3,2,5
009 Prags,77,,2,5,7
009 Prags,78,,2,4,6
009 Prags,79,,1,5,6
009 Prags,80,,4,2,6
009 Prags,81,,-,4,4
009 Prags,82,,2,1,3
009 Prags,83,,1,3,4
009 Prags,84,,1,1,2
009 Prags,85,,-,2,2
009 Prags,87,,-,1,1
009 Prags,88,,-,1,1
009 Prags,89,,-,1,1
009 Prags,90,,-,1,1
009 Prags,92,,-,1,1
009 Prags,93,,-,1,1
010 Brenner,0,,10,18,28
010 Brenner,1,,9,9,18
010 Brenner,2,,10,14,24
010 Brenner,3,,6,8,14
010 Brenner,4,,16,12,28
010 Brenner,5,,11,14,25
010 Brenner,6,,16,4,20
010 Brenner,7,,17,6,23
010 Brenner,8,,5,11,16
010 Brenner,9,,6,9,15
010 Brenner,10,,20,13,33
010 Brenner,11,,12,7,19
010 Brenner,12,,11,9,20
010 Brenner,13,,7,16,23
010 Brenner,14,,10,7,17
010 Brenner,15,,15,5,20
010 Brenner,16,,10,4,14
010 Brenner,17,,7,8,15
010 Brenner,18,,12,11,23
010 Brenner,19,,19,8,27
010 Brenner,20,,14,15,29
010 Brenner,21,,16,19,35
010 Brenner,22,,11,8,19
010 Brenner,23,,9,15,24
010 Brenner,24,,7,12,19
010 Brenner,25,,15,11,26
010 Brenner,26,,18,11,29
010 Brenner,27,,17,11,28
010 Brenner,28,,12,9,21
010 Brenner,29,,13,22,35
010 Brenner,30,,19,10,29
010 Brenner,31,,13,11,24
010 Brenner,32,,22,22,44
010 Brenner,33,,26,11,37
010 Brenner,34,,24,18,42
010 Brenner,35,,15,17,32
010 Brenner,36,,14,22,36
010 Brenner,37,,20,17,37
010 Brenner,38,,18,17,35
010 Brenner,39,,23,18,41
010 Brenner,40,,22,15,37
010 Brenner,41,,12,19,31
010 Brenner,42,,18,14,32
010 Brenner,43,,20,10,30
010 Brenner,44,,22,11,33
010 Brenner,45,,18,12,30
010 Brenner,46,,16,10,26
010 Brenner,47,,15,20,35
010 Brenner,48,,15,13,28
010 Brenner,49,,15,9,24
010 Brenner,50,,9,15,24
010 Brenner,51,,10,16,26
010 Brenner,52,,20,8,28
010 Brenner,53,,15,11,26
010 Brenner,54,,12,12,24
010 Brenner,55,,18,16,34
010 Brenner,56,,5,8,13
010 Brenner,57,,22,13,35
010 Brenner,58,,9,17,26
010 Brenner,59,,7,9,16
010 Brenner,60,,16,14,30
010 Brenner,61,,21,15,36
010 Brenner,62,,6,9,15
010 Brenner,63,,11,12,23
010 Brenner,64,,11,11,22
010 Brenner,65,,9,8,17
010 Brenner,66,,10,17,27
010 Brenner,67,,10,14,24
010 Brenner,68,,13,7,20
010 Brenner,69,,5,6,11
010 Brenner,70,,9,9,18
010 Brenner,71,,6,8,14
010 Brenner,72,,2,5,7
010 Brenner,73,,7,10,17
010 Brenner,74,,8,12,20
010 Brenner,75,,12,10,22
010 Brenner,76,,9,9,18
010 Brenner,77,,6,3,9
010 Brenner,78,,8,9,17
010 Brenner,79,,3,8,11
010 Brenner,80,,2,10,12
010 Brenner,81,,5,10,15
010 Brenner,82,,1,7,8
010 Brenner,83,,1,3,4
010 Brenner,84,,1,6,7
010 Brenner,85,,3,3,6
010 Brenner,86,,2,-,2
010 Brenner,87,,-,1,1
010 Brenner,88,,1,-,1
010 Brenner,89,,-,2,2
010 Brenner,90,,1,3,4
010 Brenner,91,,-,2,2
010 Brenner,92,,-,4,4
010 Brenner,93,,1,-,1
010 Brenner,95,,-,1,1
011 Brixen,0,,112,111,223
011 Brixen,1,,106,95,201
011 Brixen,2,,104,103,207
011 Brixen,3,,122,120,242
011 Brixen,4,,112,116,228
011 Brixen,5,,136,117,253
011 Brixen,6,,107,139,246
011 Brixen,7,,117,103,220
011 Brixen,8,,119,106,225
011 Brixen,9,,108,115,223
011 Brixen,10,,121,114,235
011 Brixen,11,,109,104,213
011 Brixen,12,,113,117,230
011 Brixen,13,,114,102,216
011 Brixen,14,,95,110,205
011 Brixen,15,,115,93,208
011 Brixen,16,,116,100,216
011 Brixen,17,,100,93,193
011 Brixen,18,,102,109,211
011 Brixen,19,,111,90,201
011 Brixen,20,,119,88,207
011 Brixen,21,,116,121,237
011 Brixen,22,,118,108,226
011 Brixen,23,,116,105,221
011 Brixen,24,,96,99,195
011 Brixen,25,,130,102,232
011 Brixen,26,,82,108,190
011 Brixen,27,,126,115,241
011 Brixen,28,,132,138,270
011 Brixen,29,,123,111,234
011 Brixen,30,,141,139,280
011 Brixen,31,,144,161,305
011 Brixen,32,,151,153,304
011 Brixen,33,,153,153,306
011 Brixen,34,,168,150,318
011 Brixen,35,,194,174,368
011 Brixen,36,,171,185,356
011 Brixen,37,,170,156,326
011 Brixen,38,,163,182,345
011 Brixen,39,,184,160,344
011 Brixen,40,,184,184,368
011 Brixen,41,,156,168,324
011 Brixen,42,,167,164,331
011 Brixen,43,,137,167,304
011 Brixen,44,,150,149,299
011 Brixen,45,,150,137,287
011 Brixen,46,,153,116,269
011 Brixen,47,,131,138,269
011 Brixen,48,,110,135,245
011 Brixen,49,,121,90,211
011 Brixen,50,,97,112,209
011 Brixen,51,,86,110,196
011 Brixen,52,,100,101,201
011 Brixen,53,,99,104,203
011 Brixen,54,,106,98,204
011 Brixen,55,,78,122,200
011 Brixen,56,,113,115,228
011 Brixen,57,,94,114,208
011 Brixen,58,,100,109,209
011 Brixen,59,,69,96,165
011 Brixen,60,,115,108,223
011 Brixen,61,,131,119,250
011 Brixen,62,,92,97,189
011 Brixen,63,,104,124,228
011 Brixen,64,,86,121,207
011 Brixen,65,,94,109,203
011 Brixen,66,,88,99,187
011 Brixen,67,,86,92,178
011 Brixen,68,,68,92,160
011 Brixen,69,,76,84,160
011 Brixen,70,,72,93,165
011 Brixen,71,,76,68,144
011 Brixen,72,,72,80,152
011 Brixen,73,,68,85,153
011 Brixen,74,,63,96,159
011 Brixen,75,,53,89,142
011 Brixen,76,,61,75,136
011 Brixen,77,,41,93,134
011 Brixen,78,,42,67,109
011 Brixen,79,,50,75,125
011 Brixen,80,,39,76,115
011 Brixen,81,,40,63,103
011 Brixen,82,,30,72,102
011 Brixen,83,,24,66,90
011 Brixen,84,,22,56,78
011 Brixen,85,,15,38,53
011 Brixen,86,,8,25,33
011 Brixen,87,,14,31,45
011 Brixen,88,,5,18,23
011 Brixen,89,,5,27,32
011 Brixen,90,,15,28,43
011 Brixen,91,,7,29,36
011 Brixen,92,,4,25,29
011 Brixen,93,,2,19,21
011 Brixen,94,,2,17,19
011 Brixen,95,,3,8,11
011 Brixen,96,,-,7,7
011 Brixen,97,,1,6,7
011 Brixen,98,,-,2,2
011 Brixen,99,,2,1,3
011 Brixen,102,,-,1,1
011 Brixen,103,,-,1,1
012 Branzoll,0,,13,18,31
012 Branzoll,1,,17,23,40
012 Branzoll,2,,14,8,22
012 Branzoll,3,,10,9,19
012 Branzoll,4,,18,7,25
012 Branzoll,5,,10,12,22
012 Branzoll,6,,14,7,21
012 Branzoll,7,,12,21,33
012 Branzoll,8,,15,8,23
012 Branzoll,9,,13,11,24
012 Branzoll,10,,16,8,24
012 Branzoll,11,,21,12,33
012 Branzoll,12,,16,11,27
012 Branzoll,13,,14,16,30
012 Branzoll,14,,10,17,27
012 Branzoll,15,,11,15,26
012 Branzoll,16,,15,13,28
012 Branzoll,17,,12,4,16
012 Branzoll,18,,9,12,21
012 Branzoll,19,,12,15,27
012 Branzoll,20,,15,10,25
012 Branzoll,21,,14,10,24
012 Branzoll,22,,17,13,30
012 Branzoll,23,,14,14,28
012 Branzoll,24,,9,14,23
012 Branzoll,25,,11,6,17
012 Branzoll,26,,11,19,30
012 Branzoll,27,,12,19,31
012 Branzoll,28,,20,15,35
012 Branzoll,29,,15,14,29
012 Branzoll,30,,19,21,40
012 Branzoll,31,,24,15,39
012 Branzoll,32,,18,15,33
012 Branzoll,33,,18,23,41
012 Branzoll,34,,17,18,35
012 Branzoll,35,,23,22,45
012 Branzoll,36,,21,20,41
012 Branzoll,37,,22,22,44
012 Branzoll,38,,20,18,38
012 Branzoll,39,,23,22,45
012 Branzoll,40,,26,26,52
012 Branzoll,41,,18,16,34
012 Branzoll,42,,18,19,37
012 Branzoll,43,,29,27,56
012 Branzoll,44,,26,18,44
012 Branzoll,45,,15,23,38
012 Branzoll,46,,21,16,37
012 Branzoll,47,,21,17,38
012 Branzoll,48,,13,16,29
012 Branzoll,49,,15,17,32
012 Branzoll,50,,21,16,37
012 Branzoll,51,,11,18,29
012 Branzoll,52,,16,18,34
012 Branzoll,53,,16,12,28
012 Branzoll,54,,17,14,31
012 Branzoll,55,,16,15,31
012 Branzoll,56,,14,16,30
012 Branzoll,57,,12,17,29
012 Branzoll,58,,15,21,36
012 Branzoll,59,,12,7,19
012 Branzoll,60,,13,10,23
012 Branzoll,61,,14,12,26
012 Branzoll,62,,18,7,25
012 Branzoll,63,,18,12,30
012 Branzoll,64,,11,13,24
012 Branzoll,65,,16,14,30
012 Branzoll,66,,9,11,20
012 Branzoll,67,,3,9,12
012 Branzoll,68,,9,9,18
012 Branzoll,69,,7,9,16
012 Branzoll,70,,5,10,15
012 Branzoll,71,,19,10,29
012 Branzoll,72,,10,11,21
012 Branzoll,73,,3,10,13
012 Branzoll,74,,8,15,23
012 Branzoll,75,,7,10,17
012 Branzoll,76,,6,10,16
012 Branzoll,77,,5,8,13
012 Branzoll,78,,7,11,18
012 Branzoll,79,,4,5,9
012 Branzoll,80,,2,7,9
012 Branzoll,81,,8,12,20
012 Branzoll,82,,1,4,5
012 Branzoll,83,,5,7,12
012 Branzoll,84,,1,5,6
012 Branzoll,85,,2,4,6
012 Branzoll,86,,2,4,6
012 Branzoll,88,,1,-,1
012 Branzoll,89,,1,-,1
012 Branzoll,90,,-,4,4
012 Branzoll,91,,1,3,4
012 Branzoll,92,,1,2,3
012 Branzoll,93,,1,-,1
012 Branzoll,95,,-,2,2
012 Branzoll,98,,1,-,1
013 Bruneck,0,,87,91,178
013 Bruneck,1,,90,74,164
013 Bruneck,2,,62,91,153
013 Bruneck,3,,90,70,160
013 Bruneck,4,,82,87,169
013 Bruneck,5,,93,95,188
013 Bruneck,6,,91,83,174
013 Bruneck,7,,106,69,175
013 Bruneck,8,,71,82,153
013 Bruneck,9,,62,73,135
013 Bruneck,10,,83,74,157
013 Bruneck,11,,76,61,137
013 Bruneck,12,,88,72,160
013 Bruneck,13,,87,59,146
013 Bruneck,14,,84,69,153
013 Bruneck,15,,79,76,155
013 Bruneck,16,,72,71,143
013 Bruneck,17,,61,55,116
013 Bruneck,18,,107,75,182
013 Bruneck,19,,76,64,140
013 Bruneck,20,,81,73,154
013 Bruneck,21,,69,73,142
013 Bruneck,22,,78,73,151
013 Bruneck,23,,93,95,188
013 Bruneck,24,,107,91,198
013 Bruneck,25,,95,95,190
013 Bruneck,26,,119,103,222
013 Bruneck,27,,109,96,205
013 Bruneck,28,,94,107,201
013 Bruneck,29,,107,115,222
013 Bruneck,30,,108,100,208
013 Bruneck,31,,119,104,223
013 Bruneck,32,,115,118,233
013 Bruneck,33,,127,119,246
013 Bruneck,34,,121,135,256
013 Bruneck,35,,129,120,249
013 Bruneck,36,,118,143,261
013 Bruneck,37,,129,115,244
013 Bruneck,38,,131,112,243
013 Bruneck,39,,132,137,269
013 Bruneck,40,,129,135,264
013 Bruneck,41,,118,109,227
013 Bruneck,42,,120,108,228
013 Bruneck,43,,115,94,209
013 Bruneck,44,,104,116,220
013 Bruneck,45,,110,95,205
013 Bruneck,46,,102,104,206
013 Bruneck,47,,82,95,177
013 Bruneck,48,,84,95,179
013 Bruneck,49,,77,80,157
013 Bruneck,50,,86,84,170
013 Bruneck,51,,75,98,173
013 Bruneck,52,,86,97,183
013 Bruneck,53,,67,91,158
013 Bruneck,54,,81,96,177
013 Bruneck,55,,83,91,174
013 Bruneck,56,,77,107,184
013 Bruneck,57,,89,69,158
013 Bruneck,58,,102,82,184
013 Bruneck,59,,60,66,126
013 Bruneck,60,,90,93,183
013 Bruneck,61,,97,86,183
013 Bruneck,62,,89,87,176
013 Bruneck,63,,75,95,170
013 Bruneck,64,,77,87,164
013 Bruneck,65,,85,90,175
013 Bruneck,66,,58,51,109
013 Bruneck,67,,53,57,110
013 Bruneck,68,,54,55,109
013 Bruneck,69,,48,50,98
013 Bruneck,70,,43,52,95
013 Bruneck,71,,54,60,114
013 Bruneck,72,,53,50,103
013 Bruneck,73,,35,48,83
013 Bruneck,74,,39,62,101
013 Bruneck,75,,35,61,96
013 Bruneck,76,,39,59,98
013 Bruneck,77,,27,50,77
013 Bruneck,78,,27,35,62
013 Bruneck,79,,27,45,72
013 Bruneck,80,,13,56,69
013 Bruneck,81,,28,43,71
013 Bruneck,82,,21,37,58
013 Bruneck,83,,16,29,45
013 Bruneck,84,,12,30,42
013 Bruneck,85,,11,21,32
013 Bruneck,86,,2,17,19
013 Bruneck,87,,5,18,23
013 Bruneck,88,,2,22,24
013 Bruneck,89,,4,11,15
013 Bruneck,90,,5,15,20
013 Bruneck,91,,5,18,23
013 Bruneck,92,,8,10,18
013 Bruneck,93,,1,12,13
013 Bruneck,94,,5,4,9
013 Bruneck,95,,5,5,10
013 Bruneck,96,,-,4,4
013 Bruneck,97,,-,2,2
013 Bruneck,98,,-,1,1
013 Bruneck,99,,2,-,2
013 Bruneck,101,,-,1,1
013 Bruneck,102,,-,2,2
014 Kuens,0,,2,4,6
014 Kuens,1,,4,5,9
014 Kuens,2,,2,1,3
014 Kuens,3,,4,2,6
014 Kuens,4,,2,5,7
014 Kuens,5,,2,3,5
014 Kuens,6,,2,3,5
014 Kuens,7,,2,1,3
014 Kuens,8,,5,3,8
014 Kuens,9,,2,3,5
014 Kuens,10,,2,4,6
014 Kuens,11,,3,3,6
014 Kuens,12,,3,2,5
014 Kuens,13,,3,2,5
014 Kuens,14,,3,2,5
014 Kuens,15,,3,2,5
014 Kuens,16,,1,3,4
014 Kuens,17,,3,-,3
014 Kuens,18,,1,1,2
014 Kuens,20,,1,-,1
014 Kuens,21,,2,1,3
014 Kuens,22,,2,-,2
014 Kuens,23,,2,1,3
014 Kuens,24,,3,2,5
014 Kuens,25,,2,1,3
014 Kuens,26,,2,-,2
014 Kuens,27,,2,-,2
014 Kuens,28,,3,2,5
014 Kuens,29,,3,3,6
014 Kuens,30,,2,6,8
014 Kuens,31,,1,5,6
014 Kuens,32,,4,1,5
014 Kuens,33,,2,4,6
014 Kuens,34,,8,3,11
014 Kuens,35,,4,1,5
014 Kuens,36,,3,4,7
014 Kuens,37,,5,10,15
014 Kuens,38,,4,5,9
014 Kuens,39,,7,1,8
014 Kuens,40,,5,5,10
014 Kuens,41,,8,2,10
014 Kuens,42,,6,2,8
014 Kuens,43,,-,3,3
014 Kuens,45,,1,-,1
014 Kuens,46,,-,3,3
014 Kuens,47,,3,-,3
014 Kuens,48,,3,-,3
014 Kuens,49,,1,2,3
014 Kuens,51,,1,1,2
014 Kuens,52,,-,2,2
014 Kuens,54,,-,3,3
014 Kuens,55,,-,2,2
014 Kuens,56,,3,1,4
014 Kuens,57,,1,2,3
014 Kuens,58,,1,2,3
014 Kuens,59,,3,1,4
014 Kuens,61,,-,2,2
014 Kuens,62,,-,4,4
014 Kuens,63,,-,2,2
014 Kuens,64,,-,1,1
014 Kuens,65,,5,2,7
014 Kuens,66,,3,2,5
014 Kuens,67,,1,3,4
014 Kuens,68,,2,2,4
014 Kuens,69,,1,3,4
014 Kuens,70,,-,1,1
014 Kuens,71,,1,1,2
014 Kuens,72,,4,2,6
014 Kuens,73,,2,2,4
014 Kuens,74,,2,2,4
014 Kuens,75,,1,-,1
014 Kuens,76,,1,-,1
014 Kuens,77,,1,-,1
014 Kuens,78,,1,-,1
014 Kuens,82,,-,2,2
014 Kuens,85,,-,2,2
014 Kuens,88,,-,1,1
014 Kuens,89,,1,-,1
014 Kuens,92,,1,-,1
015 Kaltern a.d. Weinstr.,0,,41,49,90
015 Kaltern a.d. Weinstr.,1,,42,35,77
015 Kaltern a.d. Weinstr.,2,,42,37,79
015 Kaltern a.d. Weinstr.,3,,34,49,83
015 Kaltern a.d. Weinstr.,4,,34,36,70
015 Kaltern a.d. Weinstr.,5,,43,40,83
015 Kaltern a.d. Weinstr.,6,,38,43,81
015 Kaltern a.d. Weinstr.,7,,43,41,84
015 Kaltern a.d. Weinstr.,8,,38,47,85
015 Kaltern a.d. Weinstr.,9,,43,36,79
015 Kaltern a.d. Weinstr.,10,,36,38,74
015 Kaltern a.d. Weinstr.,11,,30,38,68
015 Kaltern a.d. Weinstr.,12,,41,37,78
015 Kaltern a.d. Weinstr.,13,,32,40,72
015 Kaltern a.d. Weinstr.,14,,38,35,73
015 Kaltern a.d. Weinstr.,15,,54,29,83
015 Kaltern a.d. Weinstr.,16,,38,35,73
015 Kaltern a.d. Weinstr.,17,,39,31,70
015 Kaltern a.d. Weinstr.,18,,50,41,91
015 Kaltern a.d. Weinstr.,19,,49,38,87
015 Kaltern a.d. Weinstr.,20,,40,37,77
015 Kaltern a.d. Weinstr.,21,,46,43,89
015 Kaltern a.d. Weinstr.,22,,44,47,91
015 Kaltern a.d. Weinstr.,23,,44,40,84
015 Kaltern a.d. Weinstr.,24,,45,46,91
015 Kaltern a.d. Weinstr.,25,,42,45,87
015 Kaltern a.d. Weinstr.,26,,43,38,81
015 Kaltern a.d. Weinstr.,27,,40,43,83
015 Kaltern a.d. Weinstr.,28,,39,47,86
015 Kaltern a.d. Weinstr.,29,,47,62,109
015 Kaltern a.d. Weinstr.,30,,53,51,104
015 Kaltern a.d. Weinstr.,31,,38,50,88
015 Kaltern a.d. Weinstr.,32,,48,63,111
015 Kaltern a.d. Weinstr.,33,,68,52,120
015 Kaltern a.d. Weinstr.,34,,65,60,125
015 Kaltern a.d. Weinstr.,35,,61,64,125
015 Kaltern a.d. Weinstr.,36,,79,67,146
015 Kaltern a.d. Weinstr.,37,,64,63,127
015 Kaltern a.d. Weinstr.,38,,63,73,136
015 Kaltern a.d. Weinstr.,39,,58,61,119
015 Kaltern a.d. Weinstr.,40,,88,54,142
015 Kaltern a.d. Weinstr.,41,,53,56,109
015 Kaltern a.d. Weinstr.,42,,61,60,121
015 Kaltern a.d. Weinstr.,43,,62,63,125
015 Kaltern a.d. Weinstr.,44,,53,63,116
015 Kaltern a.d. Weinstr.,45,,52,54,106
015 Kaltern a.d. Weinstr.,46,,58,62,120
015 Kaltern a.d. Weinstr.,47,,51,58,109
015 Kaltern a.d. Weinstr.,48,,64,44,108
015 Kaltern a.d. Weinstr.,49,,55,42,97
015 Kaltern a.d. Weinstr.,50,,37,49,86
015 Kaltern a.d. Weinstr.,51,,33,39,72
015 Kaltern a.d. Weinstr.,52,,39,57,96
015 Kaltern a.d. Weinstr.,53,,32,33,65
015 Kaltern a.d. Weinstr.,54,,44,35,79
015 Kaltern a.d. Weinstr.,55,,31,39,70
015 Kaltern a.d. Weinstr.,56,,43,37,80
015 Kaltern a.d. Weinstr.,57,,36,56,92
015 Kaltern a.d. Weinstr.,58,,50,44,94
015 Kaltern a.d. Weinstr.,59,,39,38,77
015 Kaltern a.d. Weinstr.,60,,40,43,83
015 Kaltern a.d. Weinstr.,61,,38,38,76
015 Kaltern a.d. Weinstr.,62,,42,44,86
015 Kaltern a.d. Weinstr.,63,,45,44,89
015 Kaltern a.d. Weinstr.,64,,32,41,73
015 Kaltern a.d. Weinstr.,65,,23,34,57
015 Kaltern a.d. Weinstr.,66,,40,40,80
015 Kaltern a.d. Weinstr.,67,,27,33,60
015 Kaltern a.d. Weinstr.,68,,23,24,47
015 Kaltern a.d. Weinstr.,69,,26,26,52
015 Kaltern a.d. Weinstr.,70,,26,26,52
015 Kaltern a.d. Weinstr.,71,,27,37,64
015 Kaltern a.d. Weinstr.,72,,27,31,58
015 Kaltern a.d. Weinstr.,73,,25,35,60
015 Kaltern a.d. Weinstr.,74,,28,39,67
015 Kaltern a.d. Weinstr.,75,,23,31,54
015 Kaltern a.d. Weinstr.,76,,22,31,53
015 Kaltern a.d. Weinstr.,77,,17,37,54
015 Kaltern a.d. Weinstr.,78,,16,32,48
015 Kaltern a.d. Weinstr.,79,,21,35,56
015 Kaltern a.d. Weinstr.,80,,16,29,45
015 Kaltern a.d. Weinstr.,81,,9,29,38
015 Kaltern a.d. Weinstr.,82,,13,31,44
015 Kaltern a.d. Weinstr.,83,,8,30,38
015 Kaltern a.d. Weinstr.,84,,6,23,29
015 Kaltern a.d. Weinstr.,85,,4,16,20
015 Kaltern a.d. Weinstr.,86,,3,7,10
015 Kaltern a.d. Weinstr.,87,,3,9,12
015 Kaltern a.d. Weinstr.,88,,2,3,5
015 Kaltern a.d. Weinstr.,89,,3,8,11
015 Kaltern a.d. Weinstr.,90,,3,9,12
015 Kaltern a.d. Weinstr.,91,,6,10,16
015 Kaltern a.d. Weinstr.,92,,1,13,14
015 Kaltern a.d. Weinstr.,93,,2,4,6
015 Kaltern a.d. Weinstr.,94,,1,1,2
015 Kaltern a.d. Weinstr.,95,,-,2,2
015 Kaltern a.d. Weinstr.,96,,1,-,1
015 Kaltern a.d. Weinstr.,97,,-,3,3
016 Freienfeld,0,,16,12,28
016 Freienfeld,1,,18,17,35
016 Freienfeld,2,,16,21,37
016 Freienfeld,3,,16,19,35
016 Freienfeld,4,,15,16,31
016 Freienfeld,5,,16,19,35
016 Freienfeld,6,,13,16,29
016 Freienfeld,7,,22,18,40
016 Freienfeld,8,,23,13,36
016 Freienfeld,9,,14,17,31
016 Freienfeld,10,,15,9,24
016 Freienfeld,11,,15,11,26
016 Freienfeld,12,,19,22,41
016 Freienfeld,13,,10,12,22
016 Freienfeld,14,,19,19,38
016 Freienfeld,15,,26,20,46
016 Freienfeld,16,,20,14,34
016 Freienfeld,17,,15,19,34
016 Freienfeld,18,,15,12,27
016 Freienfeld,19,,17,14,31
016 Freienfeld,20,,24,15,39
016 Freienfeld,21,,24,20,44
016 Freienfeld,22,,13,17,30
016 Freienfeld,23,,23,24,47
016 Freienfeld,24,,18,15,33
016 Freienfeld,25,,19,19,38
016 Freienfeld,26,,14,14,28
016 Freienfeld,27,,17,18,35
016 Freienfeld,28,,17,9,26
016 Freienfeld,29,,19,18,37
016 Freienfeld,30,,23,19,42
016 Freienfeld,31,,22,19,41
016 Freienfeld,32,,21,24,45
016 Freienfeld,33,,26,25,51
016 Freienfeld,34,,24,15,39
016 Freienfeld,35,,25,25,50
016 Freienfeld,36,,25,19,44
016 Freienfeld,37,,19,30,49
016 Freienfeld,38,,25,21,46
016 Freienfeld,39,,23,16,39
016 Freienfeld,40,,25,20,45
016 Freienfeld,41,,22,17,39
016 Freienfeld,42,,27,28,55
016 Freienfeld,43,,25,19,44
016 Freienfeld,44,,27,22,49
016 Freienfeld,45,,27,13,40
016 Freienfeld,46,,15,19,34
016 Freienfeld,47,,14,19,33
016 Freienfeld,48,,24,18,42
016 Freienfeld,49,,21,9,30
016 Freienfeld,50,,19,17,36
016 Freienfeld,51,,17,10,27
016 Freienfeld,52,,14,18,32
016 Freienfeld,53,,14,11,25
016 Freienfeld,54,,20,10,30
016 Freienfeld,55,,16,13,29
016 Freienfeld,56,,20,13,33
016 Freienfeld,57,,5,12,17
016 Freienfeld,58,,11,16,27
016 Freienfeld,59,,12,2,14
016 Freienfeld,60,,10,5,15
016 Freienfeld,61,,12,10,22
016 Freienfeld,62,,11,9,20
016 Freienfeld,63,,13,11,24
016 Freienfeld,64,,11,4,15
016 Freienfeld,65,,10,9,19
016 Freienfeld,66,,14,11,25
016 Freienfeld,67,,6,10,16
016 Freienfeld,68,,8,11,19
016 Freienfeld,69,,7,12,19
016 Freienfeld,70,,5,6,11
016 Freienfeld,71,,8,8,16
016 Freienfeld,72,,11,10,21
016 Freienfeld,73,,9,9,18
016 Freienfeld,74,,8,7,15
016 Freienfeld,75,,4,7,11
016 Freienfeld,76,,5,5,10
016 Freienfeld,77,,5,8,13
016 Freienfeld,78,,8,13,21
016 Freienfeld,79,,7,9,16
016 Freienfeld,80,,2,3,5
016 Freienfeld,81,,2,14,16
016 Freienfeld,82,,2,9,11
016 Freienfeld,83,,1,3,4
016 Freienfeld,84,,4,3,7
016 Freienfeld,85,,3,3,6
016 Freienfeld,86,,-,2,2
016 Freienfeld,87,,-,1,1
016 Freienfeld,88,,1,1,2
016 Freienfeld,89,,-,2,2
016 Freienfeld,90,,1,4,5
016 Freienfeld,91,,1,1,2
016 Freienfeld,93,,1,1,2
016 Freienfeld,94,,2,1,3
017 Sand in Taufers,0,,35,21,56
017 Sand in Taufers,1,,34,27,61
017 Sand in Taufers,2,,28,33,61
017 Sand in Taufers,3,,35,40,75
017 Sand in Taufers,4,,43,22,65
017 Sand in Taufers,5,,37,33,70
017 Sand in Taufers,6,,28,33,61
017 Sand in Taufers,7,,33,36,69
017 Sand in Taufers,8,,27,31,58
017 Sand in Taufers,9,,27,27,54
017 Sand in Taufers,10,,39,34,73
017 Sand in Taufers,11,,25,33,58
017 Sand in Taufers,12,,32,35,67
017 Sand in Taufers,13,,28,32,60
017 Sand in Taufers,14,,25,30,55
017 Sand in Taufers,15,,29,28,57
017 Sand in Taufers,16,,28,28,56
017 Sand in Taufers,17,,21,22,43
017 Sand in Taufers,18,,23,20,43
017 Sand in Taufers,19,,23,25,48
017 Sand in Taufers,20,,31,27,58
017 Sand in Taufers,21,,34,32,66
017 Sand in Taufers,22,,22,35,57
017 Sand in Taufers,23,,33,34,67
017 Sand in Taufers,24,,34,33,67
017 Sand in Taufers,25,,29,40,69
017 Sand in Taufers,26,,38,32,70
017 Sand in Taufers,27,,30,36,66
017 Sand in Taufers,28,,39,36,75
017 Sand in Taufers,29,,43,39,82
017 Sand in Taufers,30,,60,44,104
017 Sand in Taufers,31,,59,48,107
017 Sand in Taufers,32,,50,49,99
017 Sand in Taufers,33,,44,48,92
017 Sand in Taufers,34,,43,52,95
017 Sand in Taufers,35,,54,42,96
017 Sand in Taufers,36,,52,42,94
017 Sand in Taufers,37,,31,45,76
017 Sand in Taufers,38,,50,34,84
017 Sand in Taufers,39,,50,37,87
017 Sand in Taufers,40,,48,42,90
017 Sand in Taufers,41,,49,43,92
017 Sand in Taufers,42,,35,39,74
017 Sand in Taufers,43,,45,43,88
017 Sand in Taufers,44,,41,31,72
017 Sand in Taufers,45,,36,32,68
017 Sand in Taufers,46,,33,21,54
017 Sand in Taufers,47,,23,36,59
017 Sand in Taufers,48,,28,36,64
017 Sand in Taufers,49,,23,21,44
017 Sand in Taufers,50,,30,29,59
017 Sand in Taufers,51,,31,23,54
017 Sand in Taufers,52,,18,28,46
017 Sand in Taufers,53,,26,22,48
017 Sand in Taufers,54,,32,34,66
017 Sand in Taufers,55,,30,21,51
017 Sand in Taufers,56,,21,25,46
017 Sand in Taufers,57,,25,29,54
017 Sand in Taufers,58,,26,24,50
017 Sand in Taufers,59,,27,9,36
017 Sand in Taufers,60,,17,30,47
017 Sand in Taufers,61,,29,29,58
017 Sand in Taufers,62,,28,33,61
017 Sand in Taufers,63,,27,32,59
017 Sand in Taufers,64,,23,18,41
017 Sand in Taufers,65,,27,30,57
017 Sand in Taufers,66,,18,26,44
017 Sand in Taufers,67,,27,12,39
017 Sand in Taufers,68,,15,25,40
017 Sand in Taufers,69,,29,16,45
017 Sand in Taufers,70,,15,13,28
017 Sand in Taufers,71,,14,17,31
017 Sand in Taufers,72,,10,17,27
017 Sand in Taufers,73,,12,12,24
017 Sand in Taufers,74,,14,18,32
017 Sand in Taufers,75,,13,12,25
017 Sand in Taufers,76,,11,15,26
017 Sand in Taufers,77,,13,11,24
017 Sand in Taufers,78,,9,18,27
017 Sand in Taufers,79,,8,12,20
017 Sand in Taufers,80,,6,15,21
017 Sand in Taufers,81,,11,9,20
017 Sand in Taufers,82,,7,15,22
017 Sand in Taufers,83,,8,15,23
017 Sand in Taufers,84,,6,8,14
017 Sand in Taufers,85,,7,9,16
017 Sand in Taufers,86,,3,4,7
017 Sand in Taufers,87,,1,5,6
017 Sand in Taufers,88,,-,2,2
017 Sand in Taufers,89,,4,5,9
017 Sand in Taufers,90,,1,5,6
017 Sand in Taufers,91,,-,4,4
017 Sand in Taufers,92,,-,2,2
017 Sand in Taufers,93,,-,5,5
017 Sand in Taufers,95,,1,2,3
017 Sand in Taufers,97,,-,2,2
018 Kastelbell-Tschars,0,,12,11,23
018 Kastelbell-Tschars,1,,14,9,23
018 Kastelbell-Tschars,2,,8,9,17
018 Kastelbell-Tschars,3,,16,12,28
018 Kastelbell-Tschars,4,,12,8,20
018 Kastelbell-Tschars,5,,23,11,34
018 Kastelbell-Tschars,6,,17,9,26
018 Kastelbell-Tschars,7,,9,10,19
018 Kastelbell-Tschars,8,,14,18,32
018 Kastelbell-Tschars,9,,15,10,25
018 Kastelbell-Tschars,10,,14,15,29
018 Kastelbell-Tschars,11,,13,15,28
018 Kastelbell-Tschars,12,,14,13,27
018 Kastelbell-Tschars,13,,18,13,31
018 Kastelbell-Tschars,14,,15,10,25
018 Kastelbell-Tschars,15,,16,10,26
018 Kastelbell-Tschars,16,,19,7,26
018 Kastelbell-Tschars,17,,18,16,34
018 Kastelbell-Tschars,18,,16,21,37
018 Kastelbell-Tschars,19,,21,16,37
018 Kastelbell-Tschars,20,,8,9,17
018 Kastelbell-Tschars,21,,14,23,37
018 Kastelbell-Tschars,22,,24,13,37
018 Kastelbell-Tschars,23,,16,18,34
018 Kastelbell-Tschars,24,,17,17,34
018 Kastelbell-Tschars,25,,15,13,28
018 Kastelbell-Tschars,26,,15,20,35
018 Kastelbell-Tschars,27,,12,14,26
018 Kastelbell-Tschars,28,,19,19,38
018 Kastelbell-Tschars,29,,15,15,30
018 Kastelbell-Tschars,30,,17,12,29
018 Kastelbell-Tschars,31,,19,21,40
018 Kastelbell-Tschars,32,,14,20,34
018 Kastelbell-Tschars,33,,16,14,30
018 Kastelbell-Tschars,34,,15,15,30
018 Kastelbell-Tschars,35,,24,20,44
018 Kastelbell-Tschars,36,,16,14,30
018 Kastelbell-Tschars,37,,11,21,32
018 Kastelbell-Tschars,38,,20,10,30
018 Kastelbell-Tschars,39,,20,16,36
018 Kastelbell-Tschars,40,,20,15,35
018 Kastelbell-Tschars,41,,26,22,48
018 Kastelbell-Tschars,42,,6,24,30
018 Kastelbell-Tschars,43,,22,20,42
018 Kastelbell-Tschars,44,,25,20,45
018 Kastelbell-Tschars,45,,24,19,43
018 Kastelbell-Tschars,46,,17,13,30
018 Kastelbell-Tschars,47,,17,12,29
018 Kastelbell-Tschars,48,,13,16,29
018 Kastelbell-Tschars,49,,19,18,37
018 Kastelbell-Tschars,50,,8,13,21
018 Kastelbell-Tschars,51,,9,16,25
018 Kastelbell-Tschars,52,,14,16,30
018 Kastelbell-Tschars,53,,16,12,28
018 Kastelbell-Tschars,54,,12,13,25
018 Kastelbell-Tschars,55,,13,8,21
018 Kastelbell-Tschars,56,,12,10,22
018 Kastelbell-Tschars,57,,10,8,18
018 Kastelbell-Tschars,58,,14,13,27
018 Kastelbell-Tschars,59,,9,4,13
018 Kastelbell-Tschars,60,,10,7,17
018 Kastelbell-Tschars,61,,7,7,14
018 Kastelbell-Tschars,62,,12,12,24
018 Kastelbell-Tschars,63,,10,8,18
018 Kastelbell-Tschars,64,,8,10,18
018 Kastelbell-Tschars,65,,12,12,24
018 Kastelbell-Tschars,66,,7,16,23
018 Kastelbell-Tschars,67,,11,10,21
018 Kastelbell-Tschars,68,,10,16,26
018 Kastelbell-Tschars,69,,11,9,20
018 Kastelbell-Tschars,70,,5,14,19
018 Kastelbell-Tschars,71,,16,13,29
018 Kastelbell-Tschars,72,,7,13,20
018 Kastelbell-Tschars,73,,10,14,24
018 Kastelbell-Tschars,74,,21,16,37
018 Kastelbell-Tschars,75,,10,13,23
018 Kastelbell-Tschars,76,,6,11,17
018 Kastelbell-Tschars,77,,8,9,17
018 Kastelbell-Tschars,78,,10,14,24
018 Kastelbell-Tschars,79,,11,11,22
018 Kastelbell-Tschars,80,,3,8,11
018 Kastelbell-Tschars,81,,6,10,16
018 Kastelbell-Tschars,82,,3,8,11
018 Kastelbell-Tschars,83,,3,6,9
018 Kastelbell-Tschars,84,,4,6,10
018 Kastelbell-Tschars,85,,1,4,5
018 Kastelbell-Tschars,86,,-,4,4
018 Kastelbell-Tschars,87,,1,2,3
018 Kastelbell-Tschars,88,,-,1,1
018 Kastelbell-Tschars,89,,2,3,5
018 Kastelbell-Tschars,90,,1,3,4
018 Kastelbell-Tschars,91,,1,1,2
018 Kastelbell-Tschars,92,,1,1,2
018 Kastelbell-Tschars,93,,-,4,4
018 Kastelbell-Tschars,94,,-,1,1
018 Kastelbell-Tschars,95,,1,-,1
018 Kastelbell-Tschars,96,,-,1,1
019 Kastelruth,0,,41,36,77
019 Kastelruth,1,,42,35,77
019 Kastelruth,2,,38,34,72
019 Kastelruth,3,,41,32,73
019 Kastelruth,4,,32,30,62
019 Kastelruth,5,,34,39,73
019 Kastelruth,6,,51,46,97
019 Kastelruth,7,,47,46,93
019 Kastelruth,8,,42,36,78
019 Kastelruth,9,,53,42,95
019 Kastelruth,10,,31,32,63
019 Kastelruth,11,,39,35,74
019 Kastelruth,12,,35,52,87
019 Kastelruth,13,,33,38,71
019 Kastelruth,14,,38,40,78
019 Kastelruth,15,,47,38,85
019 Kastelruth,16,,26,24,50
019 Kastelruth,17,,37,41,78
019 Kastelruth,18,,36,24,60
019 Kastelruth,19,,27,33,60
019 Kastelruth,20,,34,30,64
019 Kastelruth,21,,36,42,78
019 Kastelruth,22,,44,36,80
019 Kastelruth,23,,38,43,81
019 Kastelruth,24,,45,39,84
019 Kastelruth,25,,33,39,72
019 Kastelruth,26,,32,39,71
019 Kastelruth,27,,41,37,78
019 Kastelruth,28,,37,57,94
019 Kastelruth,29,,52,38,90
019 Kastelruth,30,,56,44,100
019 Kastelruth,31,,44,56,100
019 Kastelruth,32,,71,37,108
019 Kastelruth,33,,61,44,105
019 Kastelruth,34,,54,54,108
019 Kastelruth,35,,64,50,114
019 Kastelruth,36,,63,57,120
019 Kastelruth,37,,70,54,124
019 Kastelruth,38,,72,48,120
019 Kastelruth,39,,42,78,120
019 Kastelruth,40,,57,39,96
019 Kastelruth,41,,54,34,88
019 Kastelruth,42,,36,48,84
019 Kastelruth,43,,55,44,99
019 Kastelruth,44,,49,40,89
019 Kastelruth,45,,46,43,89
019 Kastelruth,46,,48,41,89
019 Kastelruth,47,,39,38,77
019 Kastelruth,48,,35,32,67
019 Kastelruth,49,,37,36,73
019 Kastelruth,50,,37,29,66
019 Kastelruth,51,,28,29,57
019 Kastelruth,52,,37,26,63
019 Kastelruth,53,,29,25,54
019 Kastelruth,54,,44,21,65
019 Kastelruth,55,,17,35,52
019 Kastelruth,56,,27,38,65
019 Kastelruth,57,,36,32,68
019 Kastelruth,58,,21,36,57
019 Kastelruth,59,,23,20,43
019 Kastelruth,60,,19,46,65
019 Kastelruth,61,,42,41,83
019 Kastelruth,62,,33,28,61
019 Kastelruth,63,,32,46,78
019 Kastelruth,64,,27,35,62
019 Kastelruth,65,,27,28,55
019 Kastelruth,66,,25,26,51
019 Kastelruth,67,,28,25,53
019 Kastelruth,68,,30,20,50
019 Kastelruth,69,,29,29,58
019 Kastelruth,70,,22,24,46
019 Kastelruth,71,,34,29,63
019 Kastelruth,72,,19,37,56
019 Kastelruth,73,,38,26,64
019 Kastelruth,74,,11,26,37
019 Kastelruth,75,,23,27,50
019 Kastelruth,76,,11,17,28
019 Kastelruth,77,,21,30,51
019 Kastelruth,78,,14,22,36
019 Kastelruth,79,,10,19,29
019 Kastelruth,80,,15,21,36
019 Kastelruth,81,,9,18,27
019 Kastelruth,82,,10,15,25
019 Kastelruth,83,,8,19,27
019 Kastelruth,84,,7,14,21
019 Kastelruth,85,,7,7,14
019 Kastelruth,86,,3,8,11
019 Kastelruth,87,,-,4,4
019 Kastelruth,88,,-,4,4
019 Kastelruth,89,,1,12,13
019 Kastelruth,90,,4,7,11
019 Kastelruth,91,,2,4,6
019 Kastelruth,92,,3,7,10
019 Kastelruth,93,,-,3,3
019 Kastelruth,94,,-,1,1
019 Kastelruth,95,,-,2,2
019 Kastelruth,96,,1,-,1
019 Kastelruth,97,,-,1,1
019 Kastelruth,98,,-,3,3
019 Kastelruth,99,,-,1,1
020 Tscherms,0,,8,4,12
020 Tscherms,1,,8,6,14
020 Tscherms,2,,9,9,18
020 Tscherms,3,,7,7,14
020 Tscherms,4,,9,5,14
020 Tscherms,5,,8,8,16
020 Tscherms,6,,4,7,11
020 Tscherms,7,,7,12,19
020 Tscherms,8,,5,4,9
020 Tscherms,9,,9,11,20
020 Tscherms,10,,10,16,26
020 Tscherms,11,,8,9,17
020 Tscherms,12,,12,8,20
020 Tscherms,13,,5,9,14
020 Tscherms,14,,9,7,16
020 Tscherms,15,,3,4,7
020 Tscherms,16,,5,15,20
020 Tscherms,17,,12,6,18
020 Tscherms,18,,10,7,17
020 Tscherms,19,,12,8,20
020 Tscherms,20,,13,6,19
020 Tscherms,21,,10,9,19
020 Tscherms,22,,6,9,15
020 Tscherms,23,,9,8,17
020 Tscherms,24,,8,6,14
020 Tscherms,25,,4,10,14
020 Tscherms,26,,4,13,17
020 Tscherms,27,,6,5,11
020 Tscherms,28,,7,7,14
020 Tscherms,29,,10,6,16
020 Tscherms,30,,9,5,14
020 Tscherms,31,,10,13,23
020 Tscherms,32,,12,10,22
020 Tscherms,33,,10,15,25
020 Tscherms,34,,13,6,19
020 Tscherms,35,,13,17,30
020 Tscherms,36,,16,8,24
020 Tscherms,37,,13,16,29
020 Tscherms,38,,14,5,19
020 Tscherms,39,,18,15,33
020 Tscherms,40,,12,14,26
020 Tscherms,41,,16,13,29
020 Tscherms,42,,16,10,26
020 Tscherms,43,,9,10,19
020 Tscherms,44,,11,14,25
020 Tscherms,45,,8,16,24
020 Tscherms,46,,8,9,17
020 Tscherms,47,,8,10,18
020 Tscherms,48,,8,6,14
020 Tscherms,49,,11,8,19
020 Tscherms,50,,9,8,17
020 Tscherms,51,,12,6,18
020 Tscherms,52,,12,6,18
020 Tscherms,53,,5,13,18
020 Tscherms,54,,8,7,15
020 Tscherms,55,,3,3,6
020 Tscherms,56,,6,5,11
020 Tscherms,57,,8,7,15
020 Tscherms,58,,5,8,13
020 Tscherms,59,,5,7,12
020 Tscherms,60,,5,9,14
020 Tscherms,61,,6,3,9
020 Tscherms,62,,8,3,11
020 Tscherms,63,,10,8,18
020 Tscherms,64,,5,5,10
020 Tscherms,65,,5,5,10
020 Tscherms,66,,7,2,9
020 Tscherms,67,,5,8,13
020 Tscherms,68,,5,7,12
020 Tscherms,69,,4,5,9
020 Tscherms,70,,2,9,11
020 Tscherms,71,,5,3,8
020 Tscherms,72,,5,5,10
020 Tscherms,73,,2,3,5
020 Tscherms,74,,3,5,8
020 Tscherms,75,,3,2,5
020 Tscherms,76,,5,5,10
020 Tscherms,77,,8,4,12
020 Tscherms,78,,3,2,5
020 Tscherms,79,,4,5,9
020 Tscherms,80,,3,5,8
020 Tscherms,81,,1,3,4
020 Tscherms,82,,1,4,5
020 Tscherms,83,,2,3,5
020 Tscherms,84,,4,3,7
020 Tscherms,85,,-,1,1
020 Tscherms,86,,2,2,4
020 Tscherms,87,,1,1,2
020 Tscherms,88,,-,1,1
020 Tscherms,89,,1,-,1
020 Tscherms,90,,-,1,1
020 Tscherms,91,,-,3,3
020 Tscherms,92,,2,-,2
020 Tscherms,93,,-,1,1
020 Tscherms,94,,1,1,2
021 Kiens,0,,14,14,28
021 Kiens,1,,16,19,35
021 Kiens,2,,8,12,20
021 Kiens,3,,22,19,41
021 Kiens,4,,10,22,32
021 Kiens,5,,15,17,32
021 Kiens,6,,23,7,30
021 Kiens,7,,16,13,29
021 Kiens,8,,16,19,35
021 Kiens,9,,14,20,34
021 Kiens,10,,17,17,34
021 Kiens,11,,18,16,34
021 Kiens,12,,26,16,42
021 Kiens,13,,12,24,36
021 Kiens,14,,15,21,36
021 Kiens,15,,12,19,31
021 Kiens,16,,13,14,27
021 Kiens,17,,11,14,25
021 Kiens,18,,19,10,29
021 Kiens,19,,19,14,33
021 Kiens,20,,17,11,28
021 Kiens,21,,14,19,33
021 Kiens,22,,21,16,37
021 Kiens,23,,13,18,31
021 Kiens,24,,16,25,41
021 Kiens,25,,15,17,32
021 Kiens,26,,28,19,47
021 Kiens,27,,17,16,33
021 Kiens,28,,30,21,51
021 Kiens,29,,19,22,41
021 Kiens,30,,17,21,38
021 Kiens,31,,32,25,57
021 Kiens,32,,22,20,42
021 Kiens,33,,29,22,51
021 Kiens,34,,25,27,52
021 Kiens,35,,31,23,54
021 Kiens,36,,39,18,57
021 Kiens,37,,22,24,46
021 Kiens,38,,28,27,55
021 Kiens,39,,24,21,45
021 Kiens,40,,33,23,56
021 Kiens,41,,18,22,40
021 Kiens,42,,29,20,49
021 Kiens,43,,20,24,44
021 Kiens,44,,22,19,41
021 Kiens,45,,25,15,40
021 Kiens,46,,14,13,27
021 Kiens,47,,12,16,28
021 Kiens,48,,18,13,31
021 Kiens,49,,15,8,23
021 Kiens,50,,11,16,27
021 Kiens,51,,14,23,37
021 Kiens,52,,10,8,18
021 Kiens,53,,12,12,24
021 Kiens,54,,16,10,26
021 Kiens,55,,10,13,23
021 Kiens,56,,15,18,33
021 Kiens,57,,16,14,30
021 Kiens,58,,19,13,32
021 Kiens,59,,8,12,20
021 Kiens,60,,11,13,24
021 Kiens,61,,20,12,32
021 Kiens,62,,16,11,27
021 Kiens,63,,17,11,28
021 Kiens,64,,11,16,27
021 Kiens,65,,11,8,19
021 Kiens,66,,13,14,27
021 Kiens,67,,10,12,22
021 Kiens,68,,10,11,21
021 Kiens,69,,4,17,21
021 Kiens,70,,9,13,22
021 Kiens,71,,12,8,20
021 Kiens,72,,13,13,26
021 Kiens,73,,15,9,24
021 Kiens,74,,9,11,20
021 Kiens,75,,7,9,16
021 Kiens,76,,3,5,8
021 Kiens,77,,5,5,10
021 Kiens,78,,3,5,8
021 Kiens,79,,5,3,8
021 Kiens,80,,3,6,9
021 Kiens,81,,5,6,11
021 Kiens,82,,4,4,8
021 Kiens,83,,-,6,6
021 Kiens,84,,5,3,8
021 Kiens,85,,1,3,4
021 Kiens,86,,-,2,2
021 Kiens,87,,-,1,1
021 Kiens,88,,-,2,2
021 Kiens,89,,1,2,3
021 Kiens,90,,1,1,2
021 Kiens,91,,3,2,5
021 Kiens,92,,1,3,4
022 Klausen,0,,33,35,68
022 Klausen,1,,29,30,59
022 Klausen,2,,38,26,64
022 Klausen,3,,34,33,67
022 Klausen,4,,31,34,65
022 Klausen,5,,31,29,60
022 Klausen,6,,20,28,48
022 Klausen,7,,42,35,77
022 Klausen,8,,28,30,58
022 Klausen,9,,34,24,58
022 Klausen,10,,16,31,47
022 Klausen,11,,29,25,54
022 Klausen,12,,43,26,69
022 Klausen,13,,32,33,65
022 Klausen,14,,39,25,64
022 Klausen,15,,30,30,60
022 Klausen,16,,30,33,63
022 Klausen,17,,22,32,54
022 Klausen,18,,38,31,69
022 Klausen,19,,38,38,76
022 Klausen,20,,30,27,57
022 Klausen,21,,22,39,61
022 Klausen,22,,40,36,76
022 Klausen,23,,33,32,65
022 Klausen,24,,28,34,62
022 Klausen,25,,30,42,72
022 Klausen,26,,37,44,81
022 Klausen,27,,38,36,74
022 Klausen,28,,43,25,68
022 Klausen,29,,35,36,71
022 Klausen,30,,40,27,67
022 Klausen,31,,47,31,78
022 Klausen,32,,35,40,75
022 Klausen,33,,46,43,89
022 Klausen,34,,42,47,89
022 Klausen,35,,47,55,102
022 Klausen,36,,47,46,93
022 Klausen,37,,48,43,91
022 Klausen,38,,60,42,102
022 Klausen,39,,40,43,83
022 Klausen,40,,37,47,84
022 Klausen,41,,36,39,75
022 Klausen,42,,32,41,73
022 Klausen,43,,50,43,93
022 Klausen,44,,39,26,65
022 Klausen,45,,31,37,68
022 Klausen,46,,28,29,57
022 Klausen,47,,33,25,58
022 Klausen,48,,30,23,53
022 Klausen,49,,30,34,64
022 Klausen,50,,31,41,72
022 Klausen,51,,20,31,51
022 Klausen,52,,26,15,41
022 Klausen,53,,33,26,59
022 Klausen,54,,29,25,54
022 Klausen,55,,29,26,55
022 Klausen,56,,29,27,56
022 Klausen,57,,28,20,48
022 Klausen,58,,30,20,50
022 Klausen,59,,14,16,30
022 Klausen,60,,24,18,42
022 Klausen,61,,21,31,52
022 Klausen,62,,21,26,47
022 Klausen,63,,28,20,48
022 Klausen,64,,24,22,46
022 Klausen,65,,26,19,45
022 Klausen,66,,17,20,37
022 Klausen,67,,18,17,35
022 Klausen,68,,19,22,41
022 Klausen,69,,12,18,30
022 Klausen,70,,18,15,33
022 Klausen,71,,22,16,38
022 Klausen,72,,11,20,31
022 Klausen,73,,12,14,26
022 Klausen,74,,12,18,30
022 Klausen,75,,18,19,37
022 Klausen,76,,6,17,23
022 Klausen,77,,5,15,20
022 Klausen,78,,10,11,21
022 Klausen,79,,12,9,21
022 Klausen,80,,7,14,21
022 Klausen,81,,3,14,17
022 Klausen,82,,5,13,18
022 Klausen,83,,1,11,12
022 Klausen,84,,4,11,15
022 Klausen,85,,1,9,10
022 Klausen,86,,2,9,11
022 Klausen,87,,3,7,10
022 Klausen,88,,1,1,2
022 Klausen,89,,1,-,1
022 Klausen,90,,3,6,9
022 Klausen,91,,-,8,8
022 Klausen,92,,2,2,4
022 Klausen,93,,1,1,2
022 Klausen,94,,-,3,3
022 Klausen,95,,-,2,2
023 Karneid,0,,22,23,45
023 Karneid,1,,22,16,38
023 Karneid,2,,13,14,27
023 Karneid,3,,22,23,45
023 Karneid,4,,19,19,38
023 Karneid,5,,25,28,53
023 Karneid,6,,18,20,38
023 Karneid,7,,30,20,50
023 Karneid,8,,19,21,40
023 Karneid,9,,24,20,44
023 Karneid,10,,22,22,44
023 Karneid,11,,21,18,39
023 Karneid,12,,23,18,41
023 Karneid,13,,16,21,37
023 Karneid,14,,27,15,42
023 Karneid,15,,15,19,34
023 Karneid,16,,19,19,38
023 Karneid,17,,13,20,33
023 Karneid,18,,20,20,40
023 Karneid,19,,22,12,34
023 Karneid,20,,26,14,40
023 Karneid,21,,19,10,29
023 Karneid,22,,24,16,40
023 Karneid,23,,28,27,55
023 Karneid,24,,27,18,45
023 Karneid,25,,29,25,54
023 Karneid,26,,29,13,42
023 Karneid,27,,21,16,37
023 Karneid,28,,28,27,55
023 Karneid,29,,24,19,43
023 Karneid,30,,24,25,49
023 Karneid,31,,32,28,60
023 Karneid,32,,30,27,57
023 Karneid,33,,35,34,69
023 Karneid,34,,37,19,56
023 Karneid,35,,19,28,47
023 Karneid,36,,37,33,70
023 Karneid,37,,32,34,66
023 Karneid,38,,39,35,74
023 Karneid,39,,29,23,52
023 Karneid,40,,30,24,54
023 Karneid,41,,40,24,64
023 Karneid,42,,28,35,63
023 Karneid,43,,28,21,49
023 Karneid,44,,28,28,56
023 Karneid,45,,28,19,47
023 Karneid,46,,19,19,38
023 Karneid,47,,18,16,34
023 Karneid,48,,22,18,40
023 Karneid,49,,16,10,26
023 Karneid,50,,16,16,32
023 Karneid,51,,22,15,37
023 Karneid,52,,11,20,31
023 Karneid,53,,20,12,32
023 Karneid,54,,23,18,41
023 Karneid,55,,12,15,27
023 Karneid,56,,16,24,40
023 Karneid,57,,10,15,25
023 Karneid,58,,12,21,33
023 Karneid,59,,13,15,28
023 Karneid,60,,12,14,26
023 Karneid,61,,20,14,34
023 Karneid,62,,17,24,41
023 Karneid,63,,23,15,38
023 Karneid,64,,14,15,29
023 Karneid,65,,17,17,34
023 Karneid,66,,21,11,32
023 Karneid,67,,9,9,18
023 Karneid,68,,12,12,24
023 Karneid,69,,9,13,22
023 Karneid,70,,13,15,28
023 Karneid,71,,8,15,23
023 Karneid,72,,13,5,18
023 Karneid,73,,18,10,28
023 Karneid,74,,7,8,15
023 Karneid,75,,12,10,22
023 Karneid,76,,10,8,18
023 Karneid,77,,4,9,13
023 Karneid,78,,8,10,18
023 Karneid,79,,3,7,10
023 Karneid,80,,8,9,17
023 Karneid,81,,4,2,6
023 Karneid,82,,1,7,8
023 Karneid,83,,1,5,6
023 Karneid,84,,3,8,11
023 Karneid,85,,5,2,7
023 Karneid,86,,-,4,4
023 Karneid,87,,1,2,3
023 Karneid,88,,-,2,2
023 Karneid,89,,-,1,1
023 Karneid,90,,1,-,1
023 Karneid,91,,-,3,3
023 Karneid,92,,-,5,5
023 Karneid,93,,-,1,1
023 Karneid,94,,1,-,1
023 Karneid,96,,-,1,1
023 Karneid,100,,-,1,1
024 Kurtatsch a.d.Weinstr.,0,,11,11,22
024 Kurtatsch a.d.Weinstr.,1,,11,12,23
024 Kurtatsch a.d.Weinstr.,2,,10,18,28
024 Kurtatsch a.d.Weinstr.,3,,20,13,33
024 Kurtatsch a.d.Weinstr.,4,,16,15,31
024 Kurtatsch a.d.Weinstr.,5,,18,10,28
024 Kurtatsch a.d.Weinstr.,6,,16,14,30
024 Kurtatsch a.d.Weinstr.,7,,14,14,28
024 Kurtatsch a.d.Weinstr.,8,,24,18,42
024 Kurtatsch a.d.Weinstr.,9,,19,13,32
024 Kurtatsch a.d.Weinstr.,10,,16,6,22
024 Kurtatsch a.d.Weinstr.,11,,24,20,44
024 Kurtatsch a.d.Weinstr.,12,,23,10,33
024 Kurtatsch a.d.Weinstr.,13,,16,17,33
024 Kurtatsch a.d.Weinstr.,14,,11,7,18
024 Kurtatsch a.d.Weinstr.,15,,10,18,28
024 Kurtatsch a.d.Weinstr.,16,,7,14,21
024 Kurtatsch a.d.Weinstr.,17,,11,12,23
024 Kurtatsch a.d.Weinstr.,18,,10,9,19
024 Kurtatsch a.d.Weinstr.,19,,13,11,24
024 Kurtatsch a.d.Weinstr.,20,,15,8,23
024 Kurtatsch a.d.Weinstr.,21,,15,8,23
024 Kurtatsch a.d.Weinstr.,22,,12,17,29
024 Kurtatsch a.d.Weinstr.,23,,10,12,22
024 Kurtatsch a.d.Weinstr.,24,,7,13,20
024 Kurtatsch a.d.Weinstr.,25,,10,10,20
024 Kurtatsch a.d.Weinstr.,26,,10,9,19
024 Kurtatsch a.d.Weinstr.,27,,9,15,24
024 Kurtatsch a.d.Weinstr.,28,,12,12,24
024 Kurtatsch a.d.Weinstr.,29,,12,12,24
024 Kurtatsch a.d.Weinstr.,30,,8,19,27
024 Kurtatsch a.d.Weinstr.,31,,17,16,33
024 Kurtatsch a.d.Weinstr.,32,,12,19,31
024 Kurtatsch a.d.Weinstr.,33,,12,20,32
024 Kurtatsch a.d.Weinstr.,34,,14,24,38
024 Kurtatsch a.d.Weinstr.,35,,27,22,49
024 Kurtatsch a.d.Weinstr.,36,,27,15,42
024 Kurtatsch a.d.Weinstr.,37,,18,19,37
024 Kurtatsch a.d.Weinstr.,38,,31,17,48
024 Kurtatsch a.d.Weinstr.,39,,26,27,53
024 Kurtatsch a.d.Weinstr.,40,,15,26,41
024 Kurtatsch a.d.Weinstr.,41,,21,20,41
024 Kurtatsch a.d.Weinstr.,42,,27,9,36
024 Kurtatsch a.d.Weinstr.,43,,17,15,32
024 Kurtatsch a.d.Weinstr.,44,,19,21,40
024 Kurtatsch a.d.Weinstr.,45,,19,10,29
024 Kurtatsch a.d.Weinstr.,46,,15,17,32
024 Kurtatsch a.d.Weinstr.,47,,10,10,20
024 Kurtatsch a.d.Weinstr.,48,,9,9,18
024 Kurtatsch a.d.Weinstr.,49,,16,16,32
024 Kurtatsch a.d.Weinstr.,50,,15,7,22
024 Kurtatsch a.d.Weinstr.,51,,17,17,34
024 Kurtatsch a.d.Weinstr.,52,,11,8,19
024 Kurtatsch a.d.Weinstr.,53,,10,14,24
024 Kurtatsch a.d.Weinstr.,54,,14,6,20
024 Kurtatsch a.d.Weinstr.,55,,13,9,22
024 Kurtatsch a.d.Weinstr.,56,,8,7,15
024 Kurtatsch a.d.Weinstr.,57,,11,8,19
024 Kurtatsch a.d.Weinstr.,58,,12,8,20
024 Kurtatsch a.d.Weinstr.,59,,7,8,15
024 Kurtatsch a.d.Weinstr.,60,,5,8,13
024 Kurtatsch a.d.Weinstr.,61,,10,7,17
024 Kurtatsch a.d.Weinstr.,62,,11,12,23
024 Kurtatsch a.d.Weinstr.,63,,8,11,19
024 Kurtatsch a.d.Weinstr.,64,,11,11,22
024 Kurtatsch a.d.Weinstr.,65,,4,15,19
024 Kurtatsch a.d.Weinstr.,66,,11,11,22
024 Kurtatsch a.d.Weinstr.,67,,5,10,15
024 Kurtatsch a.d.Weinstr.,68,,8,7,15
024 Kurtatsch a.d.Weinstr.,69,,5,7,12
024 Kurtatsch a.d.Weinstr.,70,,7,9,16
024 Kurtatsch a.d.Weinstr.,71,,8,6,14
024 Kurtatsch a.d.Weinstr.,72,,11,16,27
024 Kurtatsch a.d.Weinstr.,73,,7,11,18
024 Kurtatsch a.d.Weinstr.,74,,9,14,23
024 Kurtatsch a.d.Weinstr.,75,,8,11,19
024 Kurtatsch a.d.Weinstr.,76,,7,8,15
024 Kurtatsch a.d.Weinstr.,77,,9,6,15
024 Kurtatsch a.d.Weinstr.,78,,5,6,11
024 Kurtatsch a.d.Weinstr.,79,,4,8,12
024 Kurtatsch a.d.Weinstr.,80,,6,8,14
024 Kurtatsch a.d.Weinstr.,81,,6,18,24
024 Kurtatsch a.d.Weinstr.,82,,-,3,3
024 Kurtatsch a.d.Weinstr.,83,,3,7,10
024 Kurtatsch a.d.Weinstr.,84,,5,3,8
024 Kurtatsch a.d.Weinstr.,85,,2,1,3
024 Kurtatsch a.d.Weinstr.,86,,-,1,1
024 Kurtatsch a.d.Weinstr.,87,,-,4,4
024 Kurtatsch a.d.Weinstr.,88,,-,1,1
024 Kurtatsch a.d.Weinstr.,89,,-,1,1
024 Kurtatsch a.d.Weinstr.,90,,2,1,3
024 Kurtatsch a.d.Weinstr.,91,,-,2,2
024 Kurtatsch a.d.Weinstr.,92,,2,2,4
024 Kurtatsch a.d.Weinstr.,93,,-,2,2
024 Kurtatsch a.d.Weinstr.,96,,1,-,1
025 Kurtinig a.d. Weinstr.,0,,1,1,2
025 Kurtinig a.d. Weinstr.,1,,5,3,8
025 Kurtinig a.d. Weinstr.,2,,3,4,7
025 Kurtinig a.d. Weinstr.,3,,2,8,10
025 Kurtinig a.d. Weinstr.,4,,3,5,8
025 Kurtinig a.d. Weinstr.,5,,3,3,6
025 Kurtinig a.d. Weinstr.,6,,2,5,7
025 Kurtinig a.d. Weinstr.,7,,3,4,7
025 Kurtinig a.d. Weinstr.,8,,1,2,3
025 Kurtinig a.d. Weinstr.,9,,5,2,7
025 Kurtinig a.d. Weinstr.,10,,2,4,6
025 Kurtinig a.d. Weinstr.,11,,4,4,8
025 Kurtinig a.d. Weinstr.,12,,2,3,5
025 Kurtinig a.d. Weinstr.,13,,6,2,8
025 Kurtinig a.d. Weinstr.,14,,3,2,5
025 Kurtinig a.d. Weinstr.,15,,6,4,10
025 Kurtinig a.d. Weinstr.,16,,6,4,10
025 Kurtinig a.d. Weinstr.,17,,5,6,11
025 Kurtinig a.d. Weinstr.,18,,4,4,8
025 Kurtinig a.d. Weinstr.,19,,2,4,6
025 Kurtinig a.d. Weinstr.,20,,3,4,7
025 Kurtinig a.d. Weinstr.,21,,3,4,7
025 Kurtinig a.d. Weinstr.,22,,6,5,11
025 Kurtinig a.d. Weinstr.,23,,5,3,8
025 Kurtinig a.d. Weinstr.,24,,5,3,8
025 Kurtinig a.d. Weinstr.,25,,4,8,12
025 Kurtinig a.d. Weinstr.,26,,3,3,6
025 Kurtinig a.d. Weinstr.,27,,3,1,4
025 Kurtinig a.d. Weinstr.,28,,2,-,2
025 Kurtinig a.d. Weinstr.,29,,2,5,7
025 Kurtinig a.d. Weinstr.,30,,3,2,5
025 Kurtinig a.d. Weinstr.,31,,6,3,9
025 Kurtinig a.d. Weinstr.,32,,2,5,7
025 Kurtinig a.d. Weinstr.,33,,4,3,7
025 Kurtinig a.d. Weinstr.,34,,7,3,10
025 Kurtinig a.d. Weinstr.,35,,7,7,14
025 Kurtinig a.d. Weinstr.,36,,4,4,8
025 Kurtinig a.d. Weinstr.,37,,5,5,10
025 Kurtinig a.d. Weinstr.,38,,2,5,7
025 Kurtinig a.d. Weinstr.,39,,4,4,8
025 Kurtinig a.d. Weinstr.,40,,7,5,12
025 Kurtinig a.d. Weinstr.,41,,8,6,14
025 Kurtinig a.d. Weinstr.,42,,5,5,10
025 Kurtinig a.d. Weinstr.,43,,8,9,17
025 Kurtinig a.d. Weinstr.,44,,5,4,9
025 Kurtinig a.d. Weinstr.,45,,11,5,16
025 Kurtinig a.d. Weinstr.,46,,3,8,11
025 Kurtinig a.d. Weinstr.,47,,7,7,14
025 Kurtinig a.d. Weinstr.,48,,4,2,6
025 Kurtinig a.d. Weinstr.,49,,3,1,4
025 Kurtinig a.d. Weinstr.,50,,7,2,9
025 Kurtinig a.d. Weinstr.,51,,4,6,10
025 Kurtinig a.d. Weinstr.,52,,2,4,6
025 Kurtinig a.d. Weinstr.,53,,3,4,7
025 Kurtinig a.d. Weinstr.,54,,2,3,5
025 Kurtinig a.d. Weinstr.,55,,3,3,6
025 Kurtinig a.d. Weinstr.,56,,4,5,9
025 Kurtinig a.d. Weinstr.,57,,5,2,7
025 Kurtinig a.d. Weinstr.,58,,-,5,5
025 Kurtinig a.d. Weinstr.,59,,3,2,5
025 Kurtinig a.d. Weinstr.,60,,3,2,5
025 Kurtinig a.d. Weinstr.,61,,4,2,6
025 Kurtinig a.d. Weinstr.,62,,2,2,4
025 Kurtinig a.d. Weinstr.,63,,4,2,6
025 Kurtinig a.d. Weinstr.,64,,2,2,4
025 Kurtinig a.d. Weinstr.,65,,5,3,8
025 Kurtinig a.d. Weinstr.,66,,2,2,4
025 Kurtinig a.d. Weinstr.,67,,2,4,6
025 Kurtinig a.d. Weinstr.,68,,5,3,8
025 Kurtinig a.d. Weinstr.,69,,-,6,6
025 Kurtinig a.d. Weinstr.,70,,2,4,6
025 Kurtinig a.d. Weinstr.,71,,1,2,3
025 Kurtinig a.d. Weinstr.,72,,3,4,7
025 Kurtinig a.d. Weinstr.,73,,3,2,5
025 Kurtinig a.d. Weinstr.,74,,4,4,8
025 Kurtinig a.d. Weinstr.,75,,1,3,4
025 Kurtinig a.d. Weinstr.,76,,2,4,6
025 Kurtinig a.d. Weinstr.,77,,2,3,5
025 Kurtinig a.d. Weinstr.,78,,3,1,4
025 Kurtinig a.d. Weinstr.,79,,-,5,5
025 Kurtinig a.d. Weinstr.,80,,1,4,5
025 Kurtinig a.d. Weinstr.,81,,-,1,1
025 Kurtinig a.d. Weinstr.,82,,-,2,2
025 Kurtinig a.d. Weinstr.,83,,2,1,3
025 Kurtinig a.d. Weinstr.,84,,1,-,1
025 Kurtinig a.d. Weinstr.,85,,-,2,2
025 Kurtinig a.d. Weinstr.,86,,-,1,1
025 Kurtinig a.d. Weinstr.,89,,-,1,1
025 Kurtinig a.d. Weinstr.,90,,-,2,2
025 Kurtinig a.d. Weinstr.,92,,-,1,1
026 Corvara,0,,8,4,12
026 Corvara,1,,13,6,19
026 Corvara,2,,6,5,11
026 Corvara,3,,4,9,13
026 Corvara,4,,7,4,11
026 Corvara,5,,8,7,15
026 Corvara,6,,10,7,17
026 Corvara,7,,3,5,8
026 Corvara,8,,8,4,12
026 Corvara,9,,7,7,14
026 Corvara,10,,6,4,10
026 Corvara,11,,6,3,9
026 Corvara,12,,6,10,16
026 Corvara,13,,2,5,7
026 Corvara,14,,9,7,16
026 Corvara,15,,5,5,10
026 Corvara,16,,5,3,8
026 Corvara,17,,9,7,16
026 Corvara,18,,3,-,3
026 Corvara,19,,5,8,13
026 Corvara,20,,7,3,10
026 Corvara,21,,7,7,14
026 Corvara,22,,8,11,19
026 Corvara,23,,15,3,18
026 Corvara,24,,11,7,18
026 Corvara,25,,10,7,17
026 Corvara,26,,10,3,13
026 Corvara,27,,15,9,24
026 Corvara,28,,11,4,15
026 Corvara,29,,8,19,27
026 Corvara,30,,6,15,21
026 Corvara,31,,12,7,19
026 Corvara,32,,6,8,14
026 Corvara,33,,13,7,20
026 Corvara,34,,9,12,21
026 Corvara,35,,15,12,27
026 Corvara,36,,8,14,22
026 Corvara,37,,16,19,35
026 Corvara,38,,12,16,28
026 Corvara,39,,17,16,33
026 Corvara,40,,8,7,15
026 Corvara,41,,12,11,23
026 Corvara,42,,13,12,25
026 Corvara,43,,8,7,15
026 Corvara,44,,16,13,29
026 Corvara,45,,6,7,13
026 Corvara,46,,10,6,16
026 Corvara,47,,7,5,12
026 Corvara,48,,4,8,12
026 Corvara,49,,11,7,18
026 Corvara,50,,10,8,18
026 Corvara,51,,6,12,18
026 Corvara,52,,5,8,13
026 Corvara,53,,5,9,14
026 Corvara,54,,7,8,15
026 Corvara,55,,3,9,12
026 Corvara,56,,5,5,10
026 Corvara,57,,4,10,14
026 Corvara,58,,14,11,25
026 Corvara,59,,5,5,10
026 Corvara,60,,7,9,16
026 Corvara,61,,5,10,15
026 Corvara,62,,5,8,13
026 Corvara,63,,12,12,24
026 Corvara,64,,9,6,15
026 Corvara,65,,6,4,10
026 Corvara,66,,4,8,12
026 Corvara,67,,5,8,13
026 Corvara,68,,5,7,12
026 Corvara,69,,7,4,11
026 Corvara,70,,8,8,16
026 Corvara,71,,4,4,8
026 Corvara,72,,6,4,10
026 Corvara,73,,7,11,18
026 Corvara,74,,7,3,10
026 Corvara,75,,5,4,9
026 Corvara,76,,2,2,4
026 Corvara,77,,5,3,8
026 Corvara,78,,3,2,5
026 Corvara,79,,1,3,4
026 Corvara,80,,3,1,4
026 Corvara,81,,4,2,6
026 Corvara,82,,3,4,7
026 Corvara,83,,4,1,5
026 Corvara,84,,3,1,4
026 Corvara,85,,2,2,4
026 Corvara,86,,-,1,1
026 Corvara,87,,1,2,3
026 Corvara,90,,-,3,3
026 Corvara,91,,-,3,3
026 Corvara,92,,2,2,4
026 Corvara,93,,1,-,1
026 Corvara,94,,-,2,2
026 Corvara,95,,-,1,1
026 Corvara,96,,-,1,1
026 Corvara,101,,1,-,1
027 Graun im Vinschgau,0,,12,16,28
027 Graun im Vinschgau,1,,10,12,22
027 Graun im Vinschgau,2,,10,12,22
027 Graun im Vinschgau,3,,16,15,31
027 Graun im Vinschgau,4,,19,17,36
027 Graun im Vinschgau,5,,14,10,24
027 Graun im Vinschgau,6,,10,16,26
027 Graun im Vinschgau,7,,18,17,35
027 Graun im Vinschgau,8,,22,18,40
027 Graun im Vinschgau,9,,19,16,35
027 Graun im Vinschgau,10,,19,12,31
027 Graun im Vinschgau,11,,21,14,35
027 Graun im Vinschgau,12,,17,16,33
027 Graun im Vinschgau,13,,11,12,23
027 Graun im Vinschgau,14,,18,19,37
027 Graun im Vinschgau,15,,26,18,44
027 Graun im Vinschgau,16,,20,11,31
027 Graun im Vinschgau,17,,16,11,27
027 Graun im Vinschgau,18,,8,8,16
027 Graun im Vinschgau,19,,19,10,29
027 Graun im Vinschgau,20,,18,15,33
027 Graun im Vinschgau,21,,8,15,23
027 Graun im Vinschgau,22,,17,17,34
027 Graun im Vinschgau,23,,21,19,40
027 Graun im Vinschgau,24,,21,17,38
027 Graun im Vinschgau,25,,15,22,37
027 Graun im Vinschgau,26,,15,16,31
027 Graun im Vinschgau,27,,15,18,33
027 Graun im Vinschgau,28,,15,17,32
027 Graun im Vinschgau,29,,19,18,37
027 Graun im Vinschgau,30,,21,13,34
027 Graun im Vinschgau,31,,21,19,40
027 Graun im Vinschgau,32,,22,22,44
027 Graun im Vinschgau,33,,19,12,31
027 Graun im Vinschgau,34,,24,15,39
027 Graun im Vinschgau,35,,27,20,47
027 Graun im Vinschgau,36,,16,22,38
027 Graun im Vinschgau,37,,28,23,51
027 Graun im Vinschgau,38,,19,21,40
027 Graun im Vinschgau,39,,16,20,36
027 Graun im Vinschgau,40,,19,23,42
027 Graun im Vinschgau,41,,23,17,40
027 Graun im Vinschgau,42,,22,25,47
027 Graun im Vinschgau,43,,18,15,33
027 Graun im Vinschgau,44,,20,20,40
027 Graun im Vinschgau,45,,21,11,32
027 Graun im Vinschgau,46,,20,14,34
027 Graun im Vinschgau,47,,12,13,25
027 Graun im Vinschgau,48,,15,10,25
027 Graun im Vinschgau,49,,14,9,23
027 Graun im Vinschgau,50,,17,16,33
027 Graun im Vinschgau,51,,14,6,20
027 Graun im Vinschgau,52,,17,11,28
027 Graun im Vinschgau,53,,13,16,29
027 Graun im Vinschgau,54,,12,12,24
027 Graun im Vinschgau,55,,7,21,28
027 Graun im Vinschgau,56,,13,12,25
027 Graun im Vinschgau,57,,5,10,15
027 Graun im Vinschgau,58,,10,8,18
027 Graun im Vinschgau,59,,8,8,16
027 Graun im Vinschgau,60,,11,10,21
027 Graun im Vinschgau,61,,9,11,20
027 Graun im Vinschgau,62,,10,12,22
027 Graun im Vinschgau,63,,15,10,25
027 Graun im Vinschgau,64,,12,9,21
027 Graun im Vinschgau,65,,11,11,22
027 Graun im Vinschgau,66,,11,11,22
027 Graun im Vinschgau,67,,11,3,14
027 Graun im Vinschgau,68,,13,14,27
027 Graun im Vinschgau,69,,9,8,17
027 Graun im Vinschgau,70,,11,9,20
027 Graun im Vinschgau,71,,8,7,15
027 Graun im Vinschgau,72,,11,7,18
027 Graun im Vinschgau,73,,9,10,19
027 Graun im Vinschgau,74,,4,6,10
027 Graun im Vinschgau,75,,12,13,25
027 Graun im Vinschgau,76,,7,11,18
027 Graun im Vinschgau,77,,6,9,15
027 Graun im Vinschgau,78,,8,12,20
027 Graun im Vinschgau,79,,3,4,7
027 Graun im Vinschgau,80,,7,8,15
027 Graun im Vinschgau,81,,4,11,15
027 Graun im Vinschgau,82,,7,8,15
027 Graun im Vinschgau,83,,6,9,15
027 Graun im Vinschgau,84,,3,1,4
027 Graun im Vinschgau,85,,1,5,6
027 Graun im Vinschgau,86,,2,2,4
027 Graun im Vinschgau,87,,-,1,1
027 Graun im Vinschgau,88,,1,2,3
027 Graun im Vinschgau,89,,-,3,3
027 Graun im Vinschgau,90,,1,3,4
027 Graun im Vinschgau,91,,-,1,1
027 Graun im Vinschgau,92,,1,1,2
027 Graun im Vinschgau,93,,-,2,2
027 Graun im Vinschgau,96,,-,2,2
027 Graun im Vinschgau,97,,-,1,1
027 Graun im Vinschgau,101,,-,1,1
028 Toblach,0,,20,19,39
028 Toblach,1,,17,28,45
028 Toblach,2,,12,21,33
028 Toblach,3,,29,17,46
028 Toblach,4,,21,16,37
028 Toblach,5,,15,22,37
028 Toblach,6,,19,11,30
028 Toblach,7,,24,18,42
028 Toblach,8,,28,22,50
028 Toblach,9,,17,10,27
028 Toblach,10,,23,19,42
028 Toblach,11,,19,19,38
028 Toblach,12,,15,18,33
028 Toblach,13,,17,28,45
028 Toblach,14,,16,23,39
028 Toblach,15,,10,15,25
028 Toblach,16,,13,23,36
028 Toblach,17,,31,16,47
028 Toblach,18,,15,21,36
028 Toblach,19,,23,23,46
028 Toblach,20,,20,29,49
028 Toblach,21,,24,18,42
028 Toblach,22,,27,27,54
028 Toblach,23,,27,23,50
028 Toblach,24,,27,19,46
028 Toblach,25,,30,25,55
028 Toblach,26,,25,24,49
028 Toblach,27,,16,21,37
028 Toblach,28,,25,36,61
028 Toblach,29,,23,21,44
028 Toblach,30,,32,19,51
028 Toblach,31,,30,21,51
028 Toblach,32,,28,31,59
028 Toblach,33,,28,21,49
028 Toblach,34,,22,19,41
028 Toblach,35,,40,26,66
028 Toblach,36,,36,29,65
028 Toblach,37,,29,22,51
028 Toblach,38,,28,29,57
028 Toblach,39,,35,27,62
028 Toblach,40,,33,30,63
028 Toblach,41,,30,25,55
028 Toblach,42,,37,29,66
028 Toblach,43,,22,30,52
028 Toblach,44,,20,16,36
028 Toblach,45,,37,27,64
028 Toblach,46,,24,17,41
028 Toblach,47,,26,22,48
028 Toblach,48,,17,22,39
028 Toblach,49,,18,26,44
028 Toblach,50,,20,20,40
028 Toblach,51,,20,24,44
028 Toblach,52,,20,17,37
028 Toblach,53,,26,11,37
028 Toblach,54,,14,17,31
028 Toblach,55,,20,12,32
028 Toblach,56,,15,24,39
028 Toblach,57,,20,14,34
028 Toblach,58,,12,15,27
028 Toblach,59,,11,17,28
028 Toblach,60,,18,13,31
028 Toblach,61,,13,17,30
028 Toblach,62,,15,19,34
028 Toblach,63,,18,12,30
028 Toblach,64,,13,13,26
028 Toblach,65,,15,12,27
028 Toblach,66,,15,8,23
028 Toblach,67,,4,10,14
028 Toblach,68,,9,16,25
028 Toblach,69,,7,17,24
028 Toblach,70,,14,16,30
028 Toblach,71,,9,10,19
028 Toblach,72,,13,17,30
028 Toblach,73,,16,14,30
028 Toblach,74,,9,11,20
028 Toblach,75,,10,13,23
028 Toblach,76,,11,10,21
028 Toblach,77,,8,14,22
028 Toblach,78,,9,12,21
028 Toblach,79,,12,9,21
028 Toblach,80,,6,8,14
028 Toblach,81,,10,8,18
028 Toblach,82,,6,12,18
028 Toblach,83,,3,9,12
028 Toblach,84,,4,7,11
028 Toblach,85,,3,7,10
028 Toblach,86,,3,3,6
028 Toblach,87,,4,2,6
028 Toblach,88,,1,-,1
028 Toblach,89,,1,7,8
028 Toblach,90,,1,1,2
028 Toblach,91,,1,3,4
028 Toblach,92,,1,1,2
028 Toblach,93,,-,2,2
028 Toblach,94,,-,1,1
028 Toblach,95,,1,-,1
028 Toblach,97,,1,-,1
029 Neumarkt,0,,21,17,38
029 Neumarkt,1,,39,26,65
029 Neumarkt,2,,30,25,55
029 Neumarkt,3,,28,34,62
029 Neumarkt,4,,29,17,46
029 Neumarkt,5,,18,27,45
029 Neumarkt,6,,20,38,58
029 Neumarkt,7,,20,17,37
029 Neumarkt,8,,23,24,47
029 Neumarkt,9,,22,24,46
029 Neumarkt,10,,23,23,46
029 Neumarkt,11,,22,36,58
029 Neumarkt,12,,21,25,46
029 Neumarkt,13,,24,18,42
029 Neumarkt,14,,26,26,52
029 Neumarkt,15,,21,32,53
029 Neumarkt,16,,19,26,45
029 Neumarkt,17,,25,28,53
029 Neumarkt,18,,21,16,37
029 Neumarkt,19,,26,18,44
029 Neumarkt,20,,19,23,42
029 Neumarkt,21,,15,25,40
029 Neumarkt,22,,26,28,54
029 Neumarkt,23,,25,21,46
029 Neumarkt,24,,19,24,43
029 Neumarkt,25,,26,24,50
029 Neumarkt,26,,38,28,66
029 Neumarkt,27,,21,18,39
029 Neumarkt,28,,29,32,61
029 Neumarkt,29,,35,31,66
029 Neumarkt,30,,32,37,69
029 Neumarkt,31,,23,27,50
029 Neumarkt,32,,37,44,81
029 Neumarkt,33,,31,50,81
029 Neumarkt,34,,30,30,60
029 Neumarkt,35,,34,38,72
029 Neumarkt,36,,30,46,76
029 Neumarkt,37,,42,43,85
029 Neumarkt,38,,55,44,99
029 Neumarkt,39,,49,38,87
029 Neumarkt,40,,49,44,93
029 Neumarkt,41,,47,42,89
029 Neumarkt,42,,51,32,83
029 Neumarkt,43,,34,40,74
029 Neumarkt,44,,48,43,91
029 Neumarkt,45,,42,33,75
029 Neumarkt,46,,27,35,62
029 Neumarkt,47,,37,31,68
029 Neumarkt,48,,29,24,53
029 Neumarkt,49,,38,41,79
029 Neumarkt,50,,36,29,65
029 Neumarkt,51,,18,20,38
029 Neumarkt,52,,27,22,49
029 Neumarkt,53,,23,25,48
029 Neumarkt,54,,24,23,47
029 Neumarkt,55,,16,25,41
029 Neumarkt,56,,20,22,42
029 Neumarkt,57,,26,31,57
029 Neumarkt,58,,35,31,66
029 Neumarkt,59,,25,23,48
029 Neumarkt,60,,21,17,38
029 Neumarkt,61,,25,21,46
029 Neumarkt,62,,22,25,47
029 Neumarkt,63,,36,25,61
029 Neumarkt,64,,29,32,61
029 Neumarkt,65,,17,28,45
029 Neumarkt,66,,20,18,38
029 Neumarkt,67,,22,16,38
029 Neumarkt,68,,20,17,37
029 Neumarkt,69,,21,23,44
029 Neumarkt,70,,14,22,36
029 Neumarkt,71,,18,19,37
029 Neumarkt,72,,19,22,41
029 Neumarkt,73,,23,29,52
029 Neumarkt,74,,17,23,40
029 Neumarkt,75,,13,15,28
029 Neumarkt,76,,6,19,25
029 Neumarkt,77,,18,18,36
029 Neumarkt,78,,14,18,32
029 Neumarkt,79,,15,21,36
029 Neumarkt,80,,8,14,22
029 Neumarkt,81,,14,25,39
029 Neumarkt,82,,7,15,22
029 Neumarkt,83,,5,22,27
029 Neumarkt,84,,3,18,21
029 Neumarkt,85,,4,8,12
029 Neumarkt,86,,3,3,6
029 Neumarkt,87,,1,5,6
029 Neumarkt,88,,1,2,3
029 Neumarkt,89,,1,5,6
029 Neumarkt,90,,4,5,9
029 Neumarkt,91,,4,5,9
029 Neumarkt,92,,1,7,8
029 Neumarkt,93,,1,3,4
029 Neumarkt,94,,-,1,1
029 Neumarkt,95,,1,1,2
029 Neumarkt,98,,1,1,2
030 Pfalzen,0,,15,15,30
030 Pfalzen,1,,19,11,30
030 Pfalzen,2,,13,14,27
030 Pfalzen,3,,16,14,30
030 Pfalzen,4,,13,16,29
030 Pfalzen,5,,19,17,36
030 Pfalzen,6,,16,18,34
030 Pfalzen,7,,13,15,28
030 Pfalzen,8,,15,16,31
030 Pfalzen,9,,22,18,40
030 Pfalzen,10,,10,16,26
030 Pfalzen,11,,11,19,30
030 Pfalzen,12,,13,22,35
030 Pfalzen,13,,14,19,33
030 Pfalzen,14,,18,13,31
030 Pfalzen,15,,18,20,38
030 Pfalzen,16,,13,9,22
030 Pfalzen,17,,14,23,37
030 Pfalzen,18,,19,18,37
030 Pfalzen,19,,22,14,36
030 Pfalzen,20,,15,11,26
030 Pfalzen,21,,12,10,22
030 Pfalzen,22,,18,20,38
030 Pfalzen,23,,18,20,38
030 Pfalzen,24,,20,18,38
030 Pfalzen,25,,16,21,37
030 Pfalzen,26,,20,17,37
030 Pfalzen,27,,21,15,36
030 Pfalzen,28,,20,13,33
030 Pfalzen,29,,11,17,28
030 Pfalzen,30,,28,20,48
030 Pfalzen,31,,17,20,37
030 Pfalzen,32,,21,17,38
030 Pfalzen,33,,21,22,43
030 Pfalzen,34,,20,22,42
030 Pfalzen,35,,29,11,40
030 Pfalzen,36,,23,34,57
030 Pfalzen,37,,22,22,44
030 Pfalzen,38,,24,22,46
030 Pfalzen,39,,22,25,47
030 Pfalzen,40,,19,18,37
030 Pfalzen,41,,29,19,48
030 Pfalzen,42,,22,30,52
030 Pfalzen,43,,25,18,43
030 Pfalzen,44,,21,13,34
030 Pfalzen,45,,14,15,29
030 Pfalzen,46,,16,21,37
030 Pfalzen,47,,24,18,42
030 Pfalzen,48,,16,14,30
030 Pfalzen,49,,15,11,26
030 Pfalzen,50,,13,11,24
030 Pfalzen,51,,14,11,25
030 Pfalzen,52,,10,10,20
030 Pfalzen,53,,16,18,34
030 Pfalzen,54,,11,11,22
030 Pfalzen,55,,15,6,21
030 Pfalzen,56,,10,10,20
030 Pfalzen,57,,11,3,14
030 Pfalzen,58,,8,9,17
030 Pfalzen,59,,7,9,16
030 Pfalzen,60,,9,5,14
030 Pfalzen,61,,8,12,20
030 Pfalzen,62,,7,13,20
030 Pfalzen,63,,11,8,19
030 Pfalzen,64,,12,9,21
030 Pfalzen,65,,10,5,15
030 Pfalzen,66,,12,10,22
030 Pfalzen,67,,6,5,11
030 Pfalzen,68,,2,9,11
030 Pfalzen,69,,7,5,12
030 Pfalzen,70,,8,13,21
030 Pfalzen,71,,6,8,14
030 Pfalzen,72,,9,5,14
030 Pfalzen,73,,10,7,17
030 Pfalzen,74,,8,11,19
030 Pfalzen,75,,9,6,15
030 Pfalzen,76,,2,5,7
030 Pfalzen,77,,6,5,11
030 Pfalzen,78,,4,4,8
030 Pfalzen,79,,6,3,9
030 Pfalzen,80,,3,9,12
030 Pfalzen,81,,5,5,10
030 Pfalzen,82,,3,3,6
030 Pfalzen,83,,-,5,5
030 Pfalzen,84,,1,6,7
030 Pfalzen,85,,3,2,5
030 Pfalzen,86,,1,1,2
030 Pfalzen,87,,-,1,1
030 Pfalzen,88,,-,2,2
030 Pfalzen,90,,1,4,5
030 Pfalzen,91,,1,2,3
030 Pfalzen,94,,-,2,2
030 Pfalzen,95,,-,1,1
030 Pfalzen,96,,1,-,1
031 Völs am Schlern,0,,17,12,29
031 Völs am Schlern,1,,14,22,36
031 Völs am Schlern,2,,19,28,47
031 Völs am Schlern,3,,21,23,44
031 Völs am Schlern,4,,21,27,48
031 Völs am Schlern,5,,22,18,40
031 Völs am Schlern,6,,25,26,51
031 Völs am Schlern,7,,19,23,42
031 Völs am Schlern,8,,14,20,34
031 Völs am Schlern,9,,21,22,43
031 Völs am Schlern,10,,20,9,29
031 Völs am Schlern,11,,17,17,34
031 Völs am Schlern,12,,19,17,36
031 Völs am Schlern,13,,14,20,34
031 Völs am Schlern,14,,20,18,38
031 Völs am Schlern,15,,19,15,34
031 Völs am Schlern,16,,17,14,31
031 Völs am Schlern,17,,17,14,31
031 Völs am Schlern,18,,22,14,36
031 Völs am Schlern,19,,15,15,30
031 Völs am Schlern,20,,16,5,21
031 Völs am Schlern,21,,11,26,37
031 Völs am Schlern,22,,18,22,40
031 Völs am Schlern,23,,28,18,46
031 Völs am Schlern,24,,31,17,48
031 Völs am Schlern,25,,20,24,44
031 Völs am Schlern,26,,23,18,41
031 Völs am Schlern,27,,21,24,45
031 Völs am Schlern,28,,32,20,52
031 Völs am Schlern,29,,25,18,43
031 Völs am Schlern,30,,23,25,48
031 Völs am Schlern,31,,27,29,56
031 Völs am Schlern,32,,39,28,67
031 Völs am Schlern,33,,33,35,68
031 Völs am Schlern,34,,30,34,64
031 Völs am Schlern,35,,33,33,66
031 Völs am Schlern,36,,30,37,67
031 Völs am Schlern,37,,29,24,53
031 Völs am Schlern,38,,37,25,62
031 Völs am Schlern,39,,27,26,53
031 Völs am Schlern,40,,28,26,54
031 Völs am Schlern,41,,31,23,54
031 Völs am Schlern,42,,29,19,48
031 Völs am Schlern,43,,23,20,43
031 Völs am Schlern,44,,20,20,40
031 Völs am Schlern,45,,19,11,30
031 Völs am Schlern,46,,22,16,38
031 Völs am Schlern,47,,21,17,38
031 Völs am Schlern,48,,18,17,35
031 Völs am Schlern,49,,17,15,32
031 Völs am Schlern,50,,17,26,43
031 Völs am Schlern,51,,17,24,41
031 Völs am Schlern,52,,18,17,35
031 Völs am Schlern,53,,17,22,39
031 Völs am Schlern,54,,20,16,36
031 Völs am Schlern,55,,17,9,26
031 Völs am Schlern,56,,17,12,29
031 Völs am Schlern,57,,16,19,35
031 Völs am Schlern,58,,17,12,29
031 Völs am Schlern,59,,11,13,24
031 Völs am Schlern,60,,13,10,23
031 Völs am Schlern,61,,14,23,37
031 Völs am Schlern,62,,15,16,31
031 Völs am Schlern,63,,20,20,40
031 Völs am Schlern,64,,11,19,30
031 Völs am Schlern,65,,13,11,24
031 Völs am Schlern,66,,12,15,27
031 Völs am Schlern,67,,10,10,20
031 Völs am Schlern,68,,8,20,28
031 Völs am Schlern,69,,15,12,27
031 Völs am Schlern,70,,15,8,23
031 Völs am Schlern,71,,7,14,21
031 Völs am Schlern,72,,13,8,21
031 Völs am Schlern,73,,13,13,26
031 Völs am Schlern,74,,6,12,18
031 Völs am Schlern,75,,7,10,17
031 Völs am Schlern,76,,5,13,18
031 Völs am Schlern,77,,10,10,20
031 Völs am Schlern,78,,8,6,14
031 Völs am Schlern,79,,7,11,18
031 Völs am Schlern,80,,10,12,22
031 Völs am Schlern,81,,4,4,8
031 Völs am Schlern,82,,3,7,10
031 Völs am Schlern,83,,4,11,15
031 Völs am Schlern,84,,4,6,10
031 Völs am Schlern,85,,1,5,6
031 Völs am Schlern,86,,1,4,5
031 Völs am Schlern,87,,1,3,4
031 Völs am Schlern,88,,1,2,3
031 Völs am Schlern,89,,2,3,5
031 Völs am Schlern,90,,3,5,8
031 Völs am Schlern,91,,3,-,3
031 Völs am Schlern,93,,1,1,2
031 Völs am Schlern,94,,1,1,2
031 Völs am Schlern,95,,2,-,2
031 Völs am Schlern,96,,-,2,2
032 Franzensfeste,0,,5,4,9
032 Franzensfeste,1,,7,3,10
032 Franzensfeste,2,,8,5,13
032 Franzensfeste,3,,5,5,10
032 Franzensfeste,4,,3,3,6
032 Franzensfeste,5,,6,5,11
032 Franzensfeste,6,,4,5,9
032 Franzensfeste,7,,6,2,8
032 Franzensfeste,8,,5,4,9
032 Franzensfeste,9,,6,2,8
032 Franzensfeste,10,,5,6,11
032 Franzensfeste,11,,7,5,12
032 Franzensfeste,12,,5,7,12
032 Franzensfeste,13,,5,4,9
032 Franzensfeste,14,,2,4,6
032 Franzensfeste,15,,4,4,8
032 Franzensfeste,16,,3,3,6
032 Franzensfeste,17,,5,2,7
032 Franzensfeste,18,,6,5,11
032 Franzensfeste,19,,5,5,10
032 Franzensfeste,20,,6,6,12
032 Franzensfeste,21,,8,5,13
032 Franzensfeste,22,,5,7,12
032 Franzensfeste,23,,7,5,12
032 Franzensfeste,24,,6,9,15
032 Franzensfeste,25,,11,4,15
032 Franzensfeste,26,,5,3,8
032 Franzensfeste,27,,2,3,5
032 Franzensfeste,28,,3,3,6
032 Franzensfeste,29,,8,11,19
032 Franzensfeste,30,,10,7,17
032 Franzensfeste,31,,2,5,7
032 Franzensfeste,32,,6,10,16
032 Franzensfeste,33,,7,2,9
032 Franzensfeste,34,,11,7,18
032 Franzensfeste,35,,8,5,13
032 Franzensfeste,36,,10,13,23
032 Franzensfeste,37,,9,5,14
032 Franzensfeste,38,,10,4,14
032 Franzensfeste,39,,9,6,15
032 Franzensfeste,40,,14,8,22
032 Franzensfeste,41,,7,10,17
032 Franzensfeste,42,,11,3,14
032 Franzensfeste,43,,5,10,15
032 Franzensfeste,44,,5,7,12
032 Franzensfeste,45,,8,10,18
032 Franzensfeste,46,,13,3,16
032 Franzensfeste,47,,5,6,11
032 Franzensfeste,48,,4,7,11
032 Franzensfeste,49,,9,7,16
032 Franzensfeste,50,,5,10,15
032 Franzensfeste,51,,7,6,13
032 Franzensfeste,52,,5,4,9
032 Franzensfeste,53,,8,1,9
032 Franzensfeste,54,,11,3,14
032 Franzensfeste,55,,2,4,6
032 Franzensfeste,56,,5,4,9
032 Franzensfeste,57,,2,3,5
032 Franzensfeste,58,,8,6,14
032 Franzensfeste,59,,4,7,11
032 Franzensfeste,60,,4,9,13
032 Franzensfeste,61,,3,2,5
032 Franzensfeste,62,,5,1,6
032 Franzensfeste,63,,5,2,7
032 Franzensfeste,64,,3,4,7
032 Franzensfeste,65,,6,3,9
032 Franzensfeste,66,,1,3,4
032 Franzensfeste,67,,7,6,13
032 Franzensfeste,68,,4,2,6
032 Franzensfeste,69,,3,2,5
032 Franzensfeste,70,,3,3,6
032 Franzensfeste,71,,2,6,8
032 Franzensfeste,72,,3,6,9
032 Franzensfeste,73,,2,8,10
032 Franzensfeste,74,,6,4,10
032 Franzensfeste,75,,4,7,11
032 Franzensfeste,76,,2,2,4
032 Franzensfeste,77,,3,6,9
032 Franzensfeste,78,,4,10,14
032 Franzensfeste,79,,3,1,4
032 Franzensfeste,80,,6,5,11
032 Franzensfeste,81,,4,6,10
032 Franzensfeste,82,,3,4,7
032 Franzensfeste,83,,1,4,5
032 Franzensfeste,84,,-,1,1
032 Franzensfeste,85,,2,-,2
032 Franzensfeste,86,,-,2,2
032 Franzensfeste,89,,1,2,3
032 Franzensfeste,91,,1,-,1
032 Franzensfeste,92,,-,1,1
032 Franzensfeste,93,,-,1,1
032 Franzensfeste,95,,-,1,1
033 Villnöss,0,,13,15,28
033 Villnöss,1,,13,14,27
033 Villnöss,2,,20,15,35
033 Villnöss,3,,14,22,36
033 Villnöss,4,,19,15,34
033 Villnöss,5,,16,30,46
033 Villnöss,6,,22,19,41
033 Villnöss,7,,17,22,39
033 Villnöss,8,,22,17,39
033 Villnöss,9,,16,13,29
033 Villnöss,10,,15,12,27
033 Villnöss,11,,17,12,29
033 Villnöss,12,,12,14,26
033 Villnöss,13,,19,16,35
033 Villnöss,14,,15,11,26
033 Villnöss,15,,13,8,21
033 Villnöss,16,,15,23,38
033 Villnöss,17,,16,21,37
033 Villnöss,18,,10,16,26
033 Villnöss,19,,16,17,33
033 Villnöss,20,,15,14,29
033 Villnöss,21,,15,14,29
033 Villnöss,22,,12,16,28
033 Villnöss,23,,13,16,29
033 Villnöss,24,,20,12,32
033 Villnöss,25,,11,11,22
033 Villnöss,26,,15,15,30
033 Villnöss,27,,15,13,28
033 Villnöss,28,,14,11,25
033 Villnöss,29,,24,14,38
033 Villnöss,30,,21,19,40
033 Villnöss,31,,9,16,25
033 Villnöss,32,,20,24,44
033 Villnöss,33,,26,26,52
033 Villnöss,34,,18,25,43
033 Villnöss,35,,27,23,50
033 Villnöss,36,,29,19,48
033 Villnöss,37,,20,16,36
033 Villnöss,38,,26,20,46
033 Villnöss,39,,28,23,51
033 Villnöss,40,,32,26,58
033 Villnöss,41,,30,19,49
033 Villnöss,42,,26,20,46
033 Villnöss,43,,23,14,37
033 Villnöss,44,,20,12,32
033 Villnöss,45,,12,10,22
033 Villnöss,46,,9,15,24
033 Villnöss,47,,13,12,25
033 Villnöss,48,,14,16,30
033 Villnöss,49,,12,3,15
033 Villnöss,50,,17,13,30
033 Villnöss,51,,13,13,26
033 Villnöss,52,,13,11,24
033 Villnöss,53,,11,9,20
033 Villnöss,54,,7,9,16
033 Villnöss,55,,7,14,21
033 Villnöss,56,,10,10,20
033 Villnöss,57,,11,11,22
033 Villnöss,58,,11,5,16
033 Villnöss,59,,8,4,12
033 Villnöss,60,,9,14,23
033 Villnöss,61,,12,10,22
033 Villnöss,62,,11,18,29
033 Villnöss,63,,13,10,23
033 Villnöss,64,,8,17,25
033 Villnöss,65,,12,13,25
033 Villnöss,66,,12,9,21
033 Villnöss,67,,9,14,23
033 Villnöss,68,,4,16,20
033 Villnöss,69,,6,10,16
033 Villnöss,70,,11,9,20
033 Villnöss,71,,9,11,20
033 Villnöss,72,,14,13,27
033 Villnöss,73,,10,11,21
033 Villnöss,74,,10,10,20
033 Villnöss,75,,9,12,21
033 Villnöss,76,,14,6,20
033 Villnöss,77,,7,10,17
033 Villnöss,78,,3,8,11
033 Villnöss,79,,7,6,13
033 Villnöss,80,,4,9,13
033 Villnöss,81,,6,11,17
033 Villnöss,82,,3,8,11
033 Villnöss,83,,1,6,7
033 Villnöss,84,,1,6,7
033 Villnöss,85,,2,4,6
033 Villnöss,86,,-,1,1
033 Villnöss,87,,1,3,4
033 Villnöss,88,,-,1,1
033 Villnöss,89,,1,3,4
033 Villnöss,90,,2,3,5
033 Villnöss,91,,-,2,2
033 Villnöss,93,,1,1,2
033 Villnöss,94,,2,-,2
033 Villnöss,95,,1,3,4
034 Gais,0,,11,22,33
034 Gais,1,,18,15,33
034 Gais,2,,25,20,45
034 Gais,3,,22,13,35
034 Gais,4,,21,18,39
034 Gais,5,,21,30,51
034 Gais,6,,24,22,46
034 Gais,7,,28,12,40
034 Gais,8,,9,19,28
034 Gais,9,,26,18,44
034 Gais,10,,21,25,46
034 Gais,11,,11,19,30
034 Gais,12,,22,29,51
034 Gais,13,,24,30,54
034 Gais,14,,12,21,33
034 Gais,15,,16,13,29
034 Gais,16,,16,17,33
034 Gais,17,,17,23,40
034 Gais,18,,16,19,35
034 Gais,19,,21,16,37
034 Gais,20,,21,15,36
034 Gais,21,,22,20,42
034 Gais,22,,18,18,36
034 Gais,23,,23,18,41
034 Gais,24,,25,24,49
034 Gais,25,,24,14,38
034 Gais,26,,20,18,38
034 Gais,27,,19,22,41
034 Gais,28,,24,23,47
034 Gais,29,,22,19,41
034 Gais,30,,27,26,53
034 Gais,31,,25,25,50
034 Gais,32,,30,39,69
034 Gais,33,,35,29,64
034 Gais,34,,29,25,54
034 Gais,35,,37,33,70
034 Gais,36,,23,22,45
034 Gais,37,,26,28,54
034 Gais,38,,35,20,55
034 Gais,39,,26,24,50
034 Gais,40,,29,31,60
034 Gais,41,,16,17,33
034 Gais,42,,30,21,51
034 Gais,43,,24,30,54
034 Gais,44,,17,13,30
034 Gais,45,,16,21,37
034 Gais,46,,25,20,45
034 Gais,47,,12,17,29
034 Gais,48,,25,20,45
034 Gais,49,,19,13,32
034 Gais,50,,15,13,28
034 Gais,51,,14,14,28
034 Gais,52,,15,17,32
034 Gais,53,,17,20,37
034 Gais,54,,20,21,41
034 Gais,55,,15,12,27
034 Gais,56,,25,14,39
034 Gais,57,,20,11,31
034 Gais,58,,18,19,37
034 Gais,59,,13,9,22
034 Gais,60,,12,13,25
034 Gais,61,,12,16,28
034 Gais,62,,14,15,29
034 Gais,63,,20,12,32
034 Gais,64,,18,12,30
034 Gais,65,,13,15,28
034 Gais,66,,14,14,28
034 Gais,67,,17,17,34
034 Gais,68,,10,13,23
034 Gais,69,,12,12,24
034 Gais,70,,7,6,13
034 Gais,71,,4,10,14
034 Gais,72,,7,9,16
034 Gais,73,,11,8,19
034 Gais,74,,4,13,17
034 Gais,75,,4,5,9
034 Gais,76,,10,8,18
034 Gais,77,,7,8,15
034 Gais,78,,11,7,18
034 Gais,79,,4,5,9
034 Gais,80,,4,6,10
034 Gais,81,,4,9,13
034 Gais,82,,3,4,7
034 Gais,83,,3,4,7
034 Gais,84,,2,1,3
034 Gais,85,,1,2,3
034 Gais,86,,2,4,6
034 Gais,87,,1,-,1
034 Gais,88,,-,2,2
034 Gais,89,,-,2,2
034 Gais,90,,1,1,2
034 Gais,91,,2,2,4
034 Gais,92,,-,2,2
034 Gais,93,,1,1,2
034 Gais,94,,1,-,1
035 Gargazon,0,,10,7,17
035 Gargazon,1,,7,14,21
035 Gargazon,2,,6,15,21
035 Gargazon,3,,4,8,12
035 Gargazon,4,,11,4,15
035 Gargazon,5,,12,7,19
035 Gargazon,6,,14,9,23
035 Gargazon,7,,5,14,19
035 Gargazon,8,,10,5,15
035 Gargazon,9,,11,5,16
035 Gargazon,10,,3,7,10
035 Gargazon,11,,9,8,17
035 Gargazon,12,,13,8,21
035 Gargazon,13,,16,9,25
035 Gargazon,14,,7,10,17
035 Gargazon,15,,8,7,15
035 Gargazon,16,,9,5,14
035 Gargazon,17,,6,10,16
035 Gargazon,18,,5,10,15
035 Gargazon,19,,10,4,14
035 Gargazon,20,,10,3,13
035 Gargazon,21,,4,9,13
035 Gargazon,22,,5,8,13
035 Gargazon,23,,10,5,15
035 Gargazon,24,,9,12,21
035 Gargazon,25,,6,8,14
035 Gargazon,26,,4,14,18
035 Gargazon,27,,5,7,12
035 Gargazon,28,,4,8,12
035 Gargazon,29,,8,7,15
035 Gargazon,30,,10,9,19
035 Gargazon,31,,15,10,25
035 Gargazon,32,,9,22,31
035 Gargazon,33,,13,14,27
035 Gargazon,34,,11,12,23
035 Gargazon,35,,15,14,29
035 Gargazon,36,,16,20,36
035 Gargazon,37,,17,14,31
035 Gargazon,38,,14,15,29
035 Gargazon,39,,14,10,24
035 Gargazon,40,,16,15,31
035 Gargazon,41,,20,16,36
035 Gargazon,42,,13,14,27
035 Gargazon,43,,11,12,23
035 Gargazon,44,,10,11,21
035 Gargazon,45,,17,13,30
035 Gargazon,46,,6,8,14
035 Gargazon,47,,15,11,26
035 Gargazon,48,,12,6,18
035 Gargazon,49,,7,3,10
035 Gargazon,50,,10,10,20
035 Gargazon,51,,14,9,23
035 Gargazon,52,,4,6,10
035 Gargazon,53,,10,9,19
035 Gargazon,54,,8,6,14
035 Gargazon,55,,6,10,16
035 Gargazon,56,,7,8,15
035 Gargazon,57,,5,6,11
035 Gargazon,58,,7,14,21
035 Gargazon,59,,8,5,13
035 Gargazon,60,,3,4,7
035 Gargazon,61,,4,7,11
035 Gargazon,62,,6,12,18
035 Gargazon,63,,10,8,18
035 Gargazon,64,,5,17,22
035 Gargazon,65,,8,6,14
035 Gargazon,66,,9,7,16
035 Gargazon,67,,8,14,22
035 Gargazon,68,,5,4,9
035 Gargazon,69,,12,2,14
035 Gargazon,70,,8,5,13
035 Gargazon,71,,3,10,13
035 Gargazon,72,,7,2,9
035 Gargazon,73,,4,7,11
035 Gargazon,74,,3,5,8
035 Gargazon,75,,2,10,12
035 Gargazon,76,,2,5,7
035 Gargazon,77,,3,5,8
035 Gargazon,78,,5,3,8
035 Gargazon,79,,2,6,8
035 Gargazon,80,,1,3,4
035 Gargazon,81,,5,5,10
035 Gargazon,82,,3,7,10
035 Gargazon,83,,4,4,8
035 Gargazon,84,,1,1,2
035 Gargazon,85,,2,1,3
035 Gargazon,86,,-,2,2
035 Gargazon,87,,-,1,1
035 Gargazon,88,,-,1,1
035 Gargazon,89,,2,3,5
035 Gargazon,90,,2,-,2
035 Gargazon,91,,1,4,5
035 Gargazon,92,,1,3,4
035 Gargazon,95,,-,1,1
035 Gargazon,98,,-,1,1
036 Glurns,0,,3,5,8
036 Glurns,1,,7,5,12
036 Glurns,2,,3,6,9
036 Glurns,3,,5,-,5
036 Glurns,4,,4,4,8
036 Glurns,5,,4,4,8
036 Glurns,6,,10,5,15
036 Glurns,7,,4,7,11
036 Glurns,8,,8,4,12
036 Glurns,9,,7,4,11
036 Glurns,10,,2,3,5
036 Glurns,11,,7,7,14
036 Glurns,12,,5,9,14
036 Glurns,13,,6,4,10
036 Glurns,14,,8,6,14
036 Glurns,15,,4,3,7
036 Glurns,16,,7,9,16
036 Glurns,17,,6,6,12
036 Glurns,18,,6,7,13
036 Glurns,19,,3,3,6
036 Glurns,20,,7,6,13
036 Glurns,21,,8,6,14
036 Glurns,22,,10,8,18
036 Glurns,23,,7,6,13
036 Glurns,24,,13,5,18
036 Glurns,25,,6,9,15
036 Glurns,26,,5,6,11
036 Glurns,27,,5,3,8
036 Glurns,28,,10,6,16
036 Glurns,29,,7,9,16
036 Glurns,30,,8,11,19
036 Glurns,31,,3,5,8
036 Glurns,32,,4,6,10
036 Glurns,33,,6,5,11
036 Glurns,34,,5,-,5
036 Glurns,35,,3,6,9
036 Glurns,36,,6,5,11
036 Glurns,37,,7,9,16
036 Glurns,38,,5,8,13
036 Glurns,39,,1,5,6
036 Glurns,40,,9,4,13
036 Glurns,41,,6,9,15
036 Glurns,42,,4,6,10
036 Glurns,43,,4,5,9
036 Glurns,44,,7,9,16
036 Glurns,45,,12,9,21
036 Glurns,46,,4,10,14
036 Glurns,47,,6,12,18
036 Glurns,48,,8,5,13
036 Glurns,49,,9,7,16
036 Glurns,50,,12,4,16
036 Glurns,51,,8,9,17
036 Glurns,52,,5,10,15
036 Glurns,53,,8,10,18
036 Glurns,54,,6,5,11
036 Glurns,55,,6,3,9
036 Glurns,56,,8,5,13
036 Glurns,57,,11,7,18
036 Glurns,58,,8,2,10
036 Glurns,59,,6,1,7
036 Glurns,60,,4,4,8
036 Glurns,61,,1,4,5
036 Glurns,62,,5,6,11
036 Glurns,63,,4,2,6
036 Glurns,64,,6,1,7
036 Glurns,65,,1,3,4
036 Glurns,66,,4,4,8
036 Glurns,67,,5,5,10
036 Glurns,68,,-,1,1
036 Glurns,69,,2,4,6
036 Glurns,70,,1,5,6
036 Glurns,71,,1,1,2
036 Glurns,72,,7,3,10
036 Glurns,73,,4,1,5
036 Glurns,74,,3,2,5
036 Glurns,75,,2,7,9
036 Glurns,76,,-,3,3
036 Glurns,77,,1,3,4
036 Glurns,78,,-,2,2
036 Glurns,79,,1,6,7
036 Glurns,80,,2,2,4
036 Glurns,81,,-,1,1
036 Glurns,82,,1,-,1
036 Glurns,83,,1,-,1
036 Glurns,84,,1,-,1
036 Glurns,85,,1,2,3
036 Glurns,87,,1,2,3
036 Glurns,89,,-,1,1
036 Glurns,90,,-,1,1
036 Glurns,91,,-,2,2
036 Glurns,92,,-,2,2
036 Glurns,93,,1,-,1
037 Latsch,0,,30,22,52
037 Latsch,1,,25,20,45
037 Latsch,2,,27,28,55
037 Latsch,3,,34,26,60
037 Latsch,4,,34,32,66
037 Latsch,5,,29,21,50
037 Latsch,6,,26,19,45
037 Latsch,7,,35,40,75
037 Latsch,8,,36,36,72
037 Latsch,9,,46,36,82
037 Latsch,10,,38,22,60
037 Latsch,11,,34,33,67
037 Latsch,12,,36,35,71
037 Latsch,13,,29,36,65
037 Latsch,14,,32,51,83
037 Latsch,15,,34,32,66
037 Latsch,16,,39,33,72
037 Latsch,17,,32,39,71
037 Latsch,18,,36,25,61
037 Latsch,19,,32,33,65
037 Latsch,20,,33,36,69
037 Latsch,21,,29,36,65
037 Latsch,22,,32,50,82
037 Latsch,23,,30,43,73
037 Latsch,24,,34,38,72
037 Latsch,25,,38,29,67
037 Latsch,26,,31,22,53
037 Latsch,27,,24,32,56
037 Latsch,28,,24,19,43
037 Latsch,29,,33,29,62
037 Latsch,30,,25,30,55
037 Latsch,31,,31,32,63
037 Latsch,32,,33,36,69
037 Latsch,33,,46,41,87
037 Latsch,34,,38,35,73
037 Latsch,35,,40,44,84
037 Latsch,36,,43,51,94
037 Latsch,37,,55,49,104
037 Latsch,38,,33,49,82
037 Latsch,39,,57,47,104
037 Latsch,40,,58,44,102
037 Latsch,41,,53,45,98
037 Latsch,42,,45,43,88
037 Latsch,43,,49,39,88
037 Latsch,44,,38,55,93
037 Latsch,45,,42,46,88
037 Latsch,46,,40,30,70
037 Latsch,47,,29,33,62
037 Latsch,48,,31,33,64
037 Latsch,49,,37,28,65
037 Latsch,50,,32,23,55
037 Latsch,51,,26,22,48
037 Latsch,52,,41,20,61
037 Latsch,53,,20,32,52
037 Latsch,54,,31,15,46
037 Latsch,55,,16,21,37
037 Latsch,56,,17,22,39
037 Latsch,57,,18,15,33
037 Latsch,58,,20,21,41
037 Latsch,59,,20,18,38
037 Latsch,60,,24,13,37
037 Latsch,61,,25,22,47
037 Latsch,62,,25,24,49
037 Latsch,63,,18,26,44
037 Latsch,64,,19,24,43
037 Latsch,65,,18,18,36
037 Latsch,66,,16,30,46
037 Latsch,67,,13,26,39
037 Latsch,68,,17,14,31
037 Latsch,69,,29,14,43
037 Latsch,70,,17,25,42
037 Latsch,71,,17,22,39
037 Latsch,72,,23,21,44
037 Latsch,73,,17,19,36
037 Latsch,74,,18,19,37
037 Latsch,75,,17,16,33
037 Latsch,76,,17,19,36
037 Latsch,77,,14,29,43
037 Latsch,78,,20,17,37
037 Latsch,79,,15,19,34
037 Latsch,80,,7,18,25
037 Latsch,81,,10,17,27
037 Latsch,82,,9,17,26
037 Latsch,83,,13,10,23
037 Latsch,84,,5,9,14
037 Latsch,85,,5,10,15
037 Latsch,86,,3,3,6
037 Latsch,87,,1,2,3
037 Latsch,88,,1,3,4
037 Latsch,89,,-,4,4
037 Latsch,90,,3,5,8
037 Latsch,91,,2,4,6
037 Latsch,92,,3,3,6
037 Latsch,93,,1,2,3
037 Latsch,94,,-,1,1
037 Latsch,95,,1,1,2
037 Latsch,96,,1,2,3
038 Algund,0,,19,21,40
038 Algund,1,,27,20,47
038 Algund,2,,20,25,45
038 Algund,3,,28,25,53
038 Algund,4,,20,24,44
038 Algund,5,,35,24,59
038 Algund,6,,21,23,44
038 Algund,7,,19,18,37
038 Algund,8,,14,20,34
038 Algund,9,,31,21,52
038 Algund,10,,26,13,39
038 Algund,11,,23,16,39
038 Algund,12,,29,19,48
038 Algund,13,,24,22,46
038 Algund,14,,28,19,47
038 Algund,15,,19,25,44
038 Algund,16,,18,24,42
038 Algund,17,,30,21,51
038 Algund,18,,23,31,54
038 Algund,19,,24,20,44
038 Algund,20,,21,22,43
038 Algund,21,,27,31,58
038 Algund,22,,26,21,47
038 Algund,23,,25,26,51
038 Algund,24,,27,28,55
038 Algund,25,,19,22,41
038 Algund,26,,18,31,49
038 Algund,27,,19,38,57
038 Algund,28,,21,27,48
038 Algund,29,,30,21,51
038 Algund,30,,19,30,49
038 Algund,31,,35,17,52
038 Algund,32,,32,31,63
038 Algund,33,,30,34,64
038 Algund,34,,48,27,75
038 Algund,35,,37,41,78
038 Algund,36,,41,31,72
038 Algund,37,,38,39,77
038 Algund,38,,34,37,71
038 Algund,39,,32,36,68
038 Algund,40,,41,26,67
038 Algund,41,,27,34,61
038 Algund,42,,34,43,77
038 Algund,43,,26,47,73
038 Algund,44,,31,39,70
038 Algund,45,,37,30,67
038 Algund,46,,41,30,71
038 Algund,47,,24,33,57
038 Algund,48,,32,26,58
038 Algund,49,,23,26,49
038 Algund,50,,30,23,53
038 Algund,51,,18,33,51
038 Algund,52,,25,24,49
038 Algund,53,,25,29,54
038 Algund,54,,23,25,48
038 Algund,55,,24,25,49
038 Algund,56,,29,23,52
038 Algund,57,,21,20,41
038 Algund,58,,30,27,57
038 Algund,59,,24,24,48
038 Algund,60,,26,25,51
038 Algund,61,,19,21,40
038 Algund,62,,17,35,52
038 Algund,63,,20,21,41
038 Algund,64,,19,26,45
038 Algund,65,,22,30,52
038 Algund,66,,21,22,43
038 Algund,67,,16,15,31
038 Algund,68,,15,28,43
038 Algund,69,,15,19,34
038 Algund,70,,22,24,46
038 Algund,71,,24,23,47
038 Algund,72,,16,22,38
038 Algund,73,,13,23,36
038 Algund,74,,15,21,36
038 Algund,75,,13,22,35
038 Algund,76,,11,20,31
038 Algund,77,,11,17,28
038 Algund,78,,14,17,31
038 Algund,79,,10,13,23
038 Algund,80,,6,18,24
038 Algund,81,,5,11,16
038 Algund,82,,8,17,25
038 Algund,83,,9,10,19
038 Algund,84,,8,10,18
038 Algund,85,,2,11,13
038 Algund,86,,3,5,8
038 Algund,87,,-,5,5
038 Algund,88,,2,3,5
038 Algund,89,,1,4,5
038 Algund,90,,1,4,5
038 Algund,91,,1,3,4
038 Algund,92,,3,7,10
038 Algund,93,,1,7,8
038 Algund,94,,2,3,5
038 Algund,95,,1,-,1
038 Algund,96,,-,3,3
038 Algund,97,,-,2,2
038 Algund,98,,-,1,1
038 Algund,99,,-,1,1
039 Lajen,0,,12,24,36
039 Lajen,1,,23,22,45
039 Lajen,2,,23,7,30
039 Lajen,3,,22,20,42
039 Lajen,4,,26,16,42
039 Lajen,5,,17,16,33
039 Lajen,6,,18,16,34
039 Lajen,7,,14,23,37
039 Lajen,8,,16,12,28
039 Lajen,9,,8,12,20
039 Lajen,10,,11,16,27
039 Lajen,11,,13,14,27
039 Lajen,12,,15,10,25
039 Lajen,13,,19,18,37
039 Lajen,14,,8,8,16
039 Lajen,15,,16,15,31
039 Lajen,16,,12,10,22
039 Lajen,17,,13,6,19
039 Lajen,18,,17,15,32
039 Lajen,19,,19,11,30
039 Lajen,20,,11,15,26
039 Lajen,21,,9,20,29
039 Lajen,22,,17,17,34
039 Lajen,23,,9,21,30
039 Lajen,24,,21,19,40
039 Lajen,25,,21,18,39
039 Lajen,26,,23,22,45
039 Lajen,27,,22,14,36
039 Lajen,28,,23,18,41
039 Lajen,29,,20,23,43
039 Lajen,30,,29,19,48
039 Lajen,31,,21,24,45
039 Lajen,32,,21,25,46
039 Lajen,33,,19,27,46
039 Lajen,34,,22,27,49
039 Lajen,35,,34,17,51
039 Lajen,36,,23,20,43
039 Lajen,37,,24,22,46
039 Lajen,38,,22,17,39
039 Lajen,39,,30,18,48
039 Lajen,40,,21,18,39
039 Lajen,41,,15,13,28
039 Lajen,42,,26,17,43
039 Lajen,43,,11,17,28
039 Lajen,44,,13,9,22
039 Lajen,45,,17,25,42
039 Lajen,46,,23,11,34
039 Lajen,47,,14,11,25
039 Lajen,48,,12,15,27
039 Lajen,49,,14,12,26
039 Lajen,50,,5,14,19
039 Lajen,51,,10,9,19
039 Lajen,52,,7,10,17
039 Lajen,53,,9,12,21
039 Lajen,54,,12,13,25
039 Lajen,55,,5,13,18
039 Lajen,56,,9,15,24
039 Lajen,57,,16,8,24
039 Lajen,58,,13,13,26
039 Lajen,59,,10,9,19
039 Lajen,60,,13,8,21
039 Lajen,61,,11,12,23
039 Lajen,62,,18,14,32
039 Lajen,63,,17,17,34
039 Lajen,64,,15,10,25
039 Lajen,65,,15,10,25
039 Lajen,66,,6,16,22
039 Lajen,67,,7,9,16
039 Lajen,68,,7,9,16
039 Lajen,69,,6,8,14
039 Lajen,70,,8,6,14
039 Lajen,71,,5,12,17
039 Lajen,72,,10,3,13
039 Lajen,73,,1,9,10
039 Lajen,74,,7,4,11
039 Lajen,75,,6,5,11
039 Lajen,76,,8,7,15
039 Lajen,77,,7,9,16
039 Lajen,78,,9,6,15
039 Lajen,79,,4,8,12
039 Lajen,80,,2,8,10
039 Lajen,81,,1,10,11
039 Lajen,82,,4,5,9
039 Lajen,83,,4,4,8
039 Lajen,84,,2,3,5
039 Lajen,85,,1,2,3
039 Lajen,86,,-,2,2
039 Lajen,87,,-,2,2
039 Lajen,88,,-,1,1
039 Lajen,89,,1,2,3
039 Lajen,90,,-,3,3
039 Lajen,91,,1,2,3
039 Lajen,92,,1,1,2
039 Lajen,94,,-,1,1
039 Lajen,96,,-,1,1
039 Lajen,97,,-,2,2
039 Lajen,98,,1,-,1
040 Leifers,0,,83,74,157
040 Leifers,1,,98,73,171
040 Leifers,2,,92,83,175
040 Leifers,3,,84,79,163
040 Leifers,4,,92,91,183
040 Leifers,5,,90,87,177
040 Leifers,6,,74,105,179
040 Leifers,7,,105,81,186
040 Leifers,8,,100,84,184
040 Leifers,9,,93,90,183
040 Leifers,10,,87,91,178
040 Leifers,11,,80,69,149
040 Leifers,12,,85,73,158
040 Leifers,13,,86,80,166
040 Leifers,14,,97,78,175
040 Leifers,15,,67,78,145
040 Leifers,16,,72,80,152
040 Leifers,17,,67,70,137
040 Leifers,18,,81,81,162
040 Leifers,19,,81,65,146
040 Leifers,20,,73,66,139
040 Leifers,21,,82,92,174
040 Leifers,22,,67,71,138
040 Leifers,23,,73,66,139
040 Leifers,24,,71,78,149
040 Leifers,25,,84,94,178
040 Leifers,26,,106,81,187
040 Leifers,27,,102,95,197
040 Leifers,28,,126,105,231
040 Leifers,29,,122,121,243
040 Leifers,30,,157,132,289
040 Leifers,31,,127,134,261
040 Leifers,32,,130,138,268
040 Leifers,33,,122,128,250
040 Leifers,34,,148,135,283
040 Leifers,35,,149,134,283
040 Leifers,36,,149,155,304
040 Leifers,37,,149,132,281
040 Leifers,38,,147,135,282
040 Leifers,39,,156,131,287
040 Leifers,40,,172,155,327
040 Leifers,41,,151,139,290
040 Leifers,42,,134,125,259
040 Leifers,43,,130,139,269
040 Leifers,44,,144,117,261
040 Leifers,45,,119,102,221
040 Leifers,46,,92,106,198
040 Leifers,47,,102,110,212
040 Leifers,48,,135,134,269
040 Leifers,49,,104,120,224
040 Leifers,50,,92,107,199
040 Leifers,51,,104,114,218
040 Leifers,52,,104,95,199
040 Leifers,53,,105,95,200
040 Leifers,54,,97,86,183
040 Leifers,55,,91,98,189
040 Leifers,56,,108,100,208
040 Leifers,57,,106,97,203
040 Leifers,58,,116,151,267
040 Leifers,59,,82,80,162
040 Leifers,60,,93,93,186
040 Leifers,61,,91,91,182
040 Leifers,62,,93,97,190
040 Leifers,63,,88,81,169
040 Leifers,64,,95,92,187
040 Leifers,65,,94,90,184
040 Leifers,66,,91,75,166
040 Leifers,67,,55,80,135
040 Leifers,68,,57,66,123
040 Leifers,69,,56,64,120
040 Leifers,70,,58,64,122
040 Leifers,71,,50,64,114
040 Leifers,72,,65,73,138
040 Leifers,73,,54,60,114
040 Leifers,74,,54,62,116
040 Leifers,75,,42,53,95
040 Leifers,76,,40,41,81
040 Leifers,77,,27,55,82
040 Leifers,78,,30,50,80
040 Leifers,79,,25,47,72
040 Leifers,80,,21,44,65
040 Leifers,81,,23,36,59
040 Leifers,82,,19,40,59
040 Leifers,83,,17,26,43
040 Leifers,84,,13,22,35
040 Leifers,85,,8,34,42
040 Leifers,86,,2,14,16
040 Leifers,87,,1,10,11
040 Leifers,88,,4,13,17
040 Leifers,89,,2,16,18
040 Leifers,90,,2,16,18
040 Leifers,91,,8,10,18
040 Leifers,92,,1,12,13
040 Leifers,93,,2,4,6
040 Leifers,94,,1,10,11
040 Leifers,95,,2,3,5
040 Leifers,96,,1,-,1
040 Leifers,97,,2,1,3
040 Leifers,98,,-,1,1
040 Leifers,99,,-,2,2
040 Leifers,100,,-,1,1
040 Leifers,101,,-,1,1
041 Lana,0,,69,47,116
041 Lana,1,,58,58,116
041 Lana,2,,59,45,104
041 Lana,3,,68,51,119
041 Lana,4,,70,74,144
041 Lana,5,,71,51,122
041 Lana,6,,62,62,124
041 Lana,7,,59,63,122
041 Lana,8,,69,75,144
041 Lana,9,,61,57,118
041 Lana,10,,64,72,136
041 Lana,11,,58,57,115
041 Lana,12,,61,54,115
041 Lana,13,,52,58,110
041 Lana,14,,52,62,114
041 Lana,15,,50,76,126
041 Lana,16,,59,46,105
041 Lana,17,,73,48,121
041 Lana,18,,56,51,107
041 Lana,19,,65,60,125
041 Lana,20,,58,51,109
041 Lana,21,,67,62,129
041 Lana,22,,69,54,123
041 Lana,23,,48,71,119
041 Lana,24,,53,53,106
041 Lana,25,,62,76,138
041 Lana,26,,74,57,131
041 Lana,27,,66,54,120
041 Lana,28,,63,74,137
041 Lana,29,,53,74,127
041 Lana,30,,84,70,154
041 Lana,31,,67,93,160
041 Lana,32,,103,92,195
041 Lana,33,,87,88,175
041 Lana,34,,92,109,201
041 Lana,35,,117,78,195
041 Lana,36,,87,89,176
041 Lana,37,,90,94,184
041 Lana,38,,98,101,199
041 Lana,39,,96,88,184
041 Lana,40,,100,98,198
041 Lana,41,,100,83,183
041 Lana,42,,88,75,163
041 Lana,43,,81,85,166
041 Lana,44,,76,78,154
041 Lana,45,,83,77,160
041 Lana,46,,81,85,166
041 Lana,47,,73,71,144
041 Lana,48,,58,65,123
041 Lana,49,,63,70,133
041 Lana,50,,61,64,125
041 Lana,51,,55,62,117
041 Lana,52,,51,58,109
041 Lana,53,,57,62,119
041 Lana,54,,52,53,105
041 Lana,55,,54,53,107
041 Lana,56,,56,65,121
041 Lana,57,,59,46,105
041 Lana,58,,63,60,123
041 Lana,59,,44,50,94
041 Lana,60,,48,56,104
041 Lana,61,,60,57,117
041 Lana,62,,54,66,120
041 Lana,63,,50,46,96
041 Lana,64,,41,48,89
041 Lana,65,,54,51,105
041 Lana,66,,44,55,99
041 Lana,67,,37,39,76
041 Lana,68,,42,50,92
041 Lana,69,,36,39,75
041 Lana,70,,35,46,81
041 Lana,71,,32,43,75
041 Lana,72,,30,34,64
041 Lana,73,,27,44,71
041 Lana,74,,28,38,66
041 Lana,75,,22,36,58
041 Lana,76,,36,28,64
041 Lana,77,,28,36,64
041 Lana,78,,19,38,57
041 Lana,79,,26,40,66
041 Lana,80,,8,22,30
041 Lana,81,,20,23,43
041 Lana,82,,20,35,55
041 Lana,83,,11,30,41
041 Lana,84,,13,28,41
041 Lana,85,,7,22,29
041 Lana,86,,3,10,13
041 Lana,87,,3,14,17
041 Lana,88,,3,5,8
041 Lana,89,,9,11,20
041 Lana,90,,7,11,18
041 Lana,91,,4,12,16
041 Lana,92,,3,8,11
041 Lana,93,,1,9,10
041 Lana,94,,1,7,8
041 Lana,95,,-,5,5
041 Lana,97,,-,5,5
041 Lana,98,,-,2,2
041 Lana,100,,-,2,2
041 Lana,101,,-,1,1
042 Laas,0,,24,18,42
042 Laas,1,,18,18,36
042 Laas,2,,29,19,48
042 Laas,3,,15,18,33
042 Laas,4,,22,26,48
042 Laas,5,,19,12,31
042 Laas,6,,25,31,56
042 Laas,7,,27,26,53
042 Laas,8,,30,33,63
042 Laas,9,,31,23,54
042 Laas,10,,25,25,50
042 Laas,11,,22,20,42
042 Laas,12,,16,28,44
042 Laas,13,,22,21,43
042 Laas,14,,20,26,46
042 Laas,15,,21,24,45
042 Laas,16,,24,19,43
042 Laas,17,,30,23,53
042 Laas,18,,32,20,52
042 Laas,19,,29,29,58
042 Laas,20,,26,27,53
042 Laas,21,,22,35,57
042 Laas,22,,34,24,58
042 Laas,23,,27,31,58
042 Laas,24,,22,27,49
042 Laas,25,,28,31,59
042 Laas,26,,29,28,57
042 Laas,27,,27,19,46
042 Laas,28,,24,29,53
042 Laas,29,,31,24,55
042 Laas,30,,44,28,72
042 Laas,31,,34,33,67
042 Laas,32,,27,26,53
042 Laas,33,,26,24,50
042 Laas,34,,35,22,57
042 Laas,35,,33,40,73
042 Laas,36,,40,23,63
042 Laas,37,,32,24,56
042 Laas,38,,33,25,58
042 Laas,39,,39,35,74
042 Laas,40,,25,29,54
042 Laas,41,,27,29,56
042 Laas,42,,34,26,60
042 Laas,43,,27,28,55
042 Laas,44,,38,24,62
042 Laas,45,,34,27,61
042 Laas,46,,27,25,52
042 Laas,47,,20,28,48
042 Laas,48,,23,16,39
042 Laas,49,,15,14,29
042 Laas,50,,16,24,40
042 Laas,51,,24,12,36
042 Laas,52,,29,25,54
042 Laas,53,,13,17,30
042 Laas,54,,21,25,46
042 Laas,55,,18,19,37
042 Laas,56,,16,21,37
042 Laas,57,,27,12,39
042 Laas,58,,13,15,28
042 Laas,59,,14,12,26
042 Laas,60,,12,15,27
042 Laas,61,,14,15,29
042 Laas,62,,17,19,36
042 Laas,63,,16,21,37
042 Laas,64,,18,25,43
042 Laas,65,,14,24,38
042 Laas,66,,19,12,31
042 Laas,67,,15,14,29
042 Laas,68,,20,12,32
042 Laas,69,,18,23,41
042 Laas,70,,13,19,32
042 Laas,71,,18,12,30
042 Laas,72,,17,15,32
042 Laas,73,,19,22,41
042 Laas,74,,13,16,29
042 Laas,75,,15,10,25
042 Laas,76,,12,11,23
042 Laas,77,,13,17,30
042 Laas,78,,15,11,26
042 Laas,79,,7,11,18
042 Laas,80,,6,18,24
042 Laas,81,,10,10,20
042 Laas,82,,4,19,23
042 Laas,83,,3,6,9
042 Laas,84,,5,10,15
042 Laas,85,,2,8,10
042 Laas,86,,4,2,6
042 Laas,87,,2,2,4
042 Laas,88,,1,4,5
042 Laas,89,,-,1,1
042 Laas,90,,1,3,4
042 Laas,91,,-,5,5
042 Laas,92,,-,3,3
042 Laas,93,,-,3,3
042 Laas,94,,2,1,3
042 Laas,95,,-,2,2
043 Laurein,0,,2,1,3
043 Laurein,1,,3,3,6
043 Laurein,2,,2,3,5
043 Laurein,3,,7,-,7
043 Laurein,4,,3,7,10
043 Laurein,5,,3,2,5
043 Laurein,6,,4,3,7
043 Laurein,7,,3,5,8
043 Laurein,8,,1,2,3
043 Laurein,9,,2,2,4
043 Laurein,10,,2,4,6
043 Laurein,11,,1,5,6
043 Laurein,12,,1,1,2
043 Laurein,13,,1,1,2
043 Laurein,14,,4,-,4
043 Laurein,15,,3,2,5
043 Laurein,16,,1,-,1
043 Laurein,17,,2,2,4
043 Laurein,18,,4,2,6
043 Laurein,19,,2,2,4
043 Laurein,20,,1,2,3
043 Laurein,22,,2,2,4
043 Laurein,23,,3,1,4
043 Laurein,24,,2,-,2
043 Laurein,25,,2,-,2
043 Laurein,26,,3,5,8
043 Laurein,27,,1,3,4
043 Laurein,28,,5,2,7
043 Laurein,29,,-,5,5
043 Laurein,30,,1,3,4
043 Laurein,31,,5,1,6
043 Laurein,32,,1,2,3
043 Laurein,33,,5,6,11
043 Laurein,34,,4,2,6
043 Laurein,35,,5,4,9
043 Laurein,36,,-,3,3
043 Laurein,37,,4,7,11
043 Laurein,38,,6,3,9
043 Laurein,39,,5,1,6
043 Laurein,40,,4,2,6
043 Laurein,41,,-,2,2
043 Laurein,42,,1,2,3
043 Laurein,43,,5,4,9
043 Laurein,44,,1,1,2
043 Laurein,45,,3,4,7
043 Laurein,46,,3,2,5
043 Laurein,47,,7,-,7
043 Laurein,49,,2,-,2
043 Laurein,50,,3,1,4
043 Laurein,51,,2,1,3
043 Laurein,52,,2,1,3
043 Laurein,54,,2,1,3
043 Laurein,55,,3,2,5
043 Laurein,56,,2,-,2
043 Laurein,57,,2,3,5
043 Laurein,58,,-,1,1
043 Laurein,59,,-,1,1
043 Laurein,60,,-,1,1
043 Laurein,61,,1,-,1
043 Laurein,62,,1,-,1
043 Laurein,64,,3,2,5
043 Laurein,65,,1,3,4
043 Laurein,66,,1,1,2
043 Laurein,67,,2,1,3
043 Laurein,68,,1,2,3
043 Laurein,69,,1,3,4
043 Laurein,70,,1,5,6
043 Laurein,71,,1,2,3
043 Laurein,72,,3,2,5
043 Laurein,73,,-,3,3
043 Laurein,74,,1,5,6
043 Laurein,75,,3,-,3
043 Laurein,76,,4,1,5
043 Laurein,77,,5,1,6
043 Laurein,78,,2,2,4
043 Laurein,79,,1,2,3
043 Laurein,80,,-,1,1
043 Laurein,82,,-,2,2
043 Laurein,83,,1,-,1
043 Laurein,84,,2,2,4
043 Laurein,85,,-,1,1
043 Laurein,88,,1,-,1
043 Laurein,91,,-,1,1
043 Laurein,93,,-,1,1
043 Laurein,94,,1,-,1
044 Lüsen,0,,8,11,19
044 Lüsen,1,,9,7,16
044 Lüsen,2,,11,9,20
044 Lüsen,3,,11,11,22
044 Lüsen,4,,16,9,25
044 Lüsen,5,,6,10,16
044 Lüsen,6,,11,10,21
044 Lüsen,7,,16,6,22
044 Lüsen,8,,8,13,21
044 Lüsen,9,,10,12,22
044 Lüsen,10,,14,14,28
044 Lüsen,11,,9,8,17
044 Lüsen,12,,12,11,23
044 Lüsen,13,,8,9,17
044 Lüsen,14,,7,12,19
044 Lüsen,15,,16,8,24
044 Lüsen,16,,9,9,18
044 Lüsen,17,,7,8,15
044 Lüsen,18,,12,12,24
044 Lüsen,19,,3,2,5
044 Lüsen,20,,9,16,25
044 Lüsen,21,,6,7,13
044 Lüsen,22,,15,10,25
044 Lüsen,23,,11,14,25
044 Lüsen,24,,14,13,27
044 Lüsen,25,,7,10,17
044 Lüsen,26,,14,18,32
044 Lüsen,27,,7,8,15
044 Lüsen,28,,15,10,25
044 Lüsen,29,,15,13,28
044 Lüsen,30,,16,14,30
044 Lüsen,31,,10,8,18
044 Lüsen,32,,9,8,17
044 Lüsen,33,,15,8,23
044 Lüsen,34,,15,14,29
044 Lüsen,35,,7,9,16
044 Lüsen,36,,13,16,29
044 Lüsen,37,,12,21,33
044 Lüsen,38,,13,13,26
044 Lüsen,39,,18,13,31
044 Lüsen,40,,13,10,23
044 Lüsen,41,,15,10,25
044 Lüsen,42,,8,12,20
044 Lüsen,43,,12,10,22
044 Lüsen,44,,9,12,21
044 Lüsen,45,,7,5,12
044 Lüsen,46,,11,11,22
044 Lüsen,47,,9,11,20
044 Lüsen,48,,9,10,19
044 Lüsen,49,,6,6,12
044 Lüsen,50,,14,5,19
044 Lüsen,51,,6,10,16
044 Lüsen,52,,11,4,15
044 Lüsen,53,,5,7,12
044 Lüsen,54,,6,7,13
044 Lüsen,55,,8,11,19
044 Lüsen,56,,7,1,8
044 Lüsen,57,,6,4,10
044 Lüsen,58,,10,6,16
044 Lüsen,59,,4,9,13
044 Lüsen,60,,4,5,9
044 Lüsen,61,,7,7,14
044 Lüsen,62,,2,6,8
044 Lüsen,63,,7,4,11
044 Lüsen,64,,5,9,14
044 Lüsen,65,,9,7,16
044 Lüsen,66,,8,5,13
044 Lüsen,67,,7,5,12
044 Lüsen,68,,6,9,15
044 Lüsen,69,,6,4,10
044 Lüsen,70,,3,5,8
044 Lüsen,71,,7,3,10
044 Lüsen,72,,2,11,13
044 Lüsen,73,,6,5,11
044 Lüsen,74,,3,5,8
044 Lüsen,75,,4,8,12
044 Lüsen,76,,6,7,13
044 Lüsen,77,,4,4,8
044 Lüsen,78,,2,6,8
044 Lüsen,79,,3,4,7
044 Lüsen,80,,2,3,5
044 Lüsen,81,,2,4,6
044 Lüsen,82,,1,2,3
044 Lüsen,83,,2,7,9
044 Lüsen,84,,1,2,3
044 Lüsen,85,,1,1,2
044 Lüsen,86,,-,2,2
044 Lüsen,87,,1,2,3
044 Lüsen,88,,-,2,2
044 Lüsen,89,,-,1,1
044 Lüsen,90,,1,1,2
044 Lüsen,91,,1,3,4
045 Margreid a.d. Weinstr.,0,,10,8,18
045 Margreid a.d. Weinstr.,1,,4,5,9
045 Margreid a.d. Weinstr.,2,,11,8,19
045 Margreid a.d. Weinstr.,3,,11,8,19
045 Margreid a.d. Weinstr.,4,,7,7,14
045 Margreid a.d. Weinstr.,5,,7,8,15
045 Margreid a.d. Weinstr.,6,,3,12,15
045 Margreid a.d. Weinstr.,7,,10,12,22
045 Margreid a.d. Weinstr.,8,,4,3,7
045 Margreid a.d. Weinstr.,9,,1,7,8
045 Margreid a.d. Weinstr.,10,,5,7,12
045 Margreid a.d. Weinstr.,11,,4,12,16
045 Margreid a.d. Weinstr.,12,,4,2,6
045 Margreid a.d. Weinstr.,13,,6,6,12
045 Margreid a.d. Weinstr.,14,,6,10,16
045 Margreid a.d. Weinstr.,15,,6,5,11
045 Margreid a.d. Weinstr.,16,,8,6,14
045 Margreid a.d. Weinstr.,17,,9,4,13
045 Margreid a.d. Weinstr.,18,,6,11,17
045 Margreid a.d. Weinstr.,19,,11,-,11
045 Margreid a.d. Weinstr.,20,,4,13,17
045 Margreid a.d. Weinstr.,21,,6,9,15
045 Margreid a.d. Weinstr.,22,,8,8,16
045 Margreid a.d. Weinstr.,23,,15,2,17
045 Margreid a.d. Weinstr.,24,,2,2,4
045 Margreid a.d. Weinstr.,25,,9,6,15
045 Margreid a.d. Weinstr.,26,,8,5,13
045 Margreid a.d. Weinstr.,27,,10,6,16
045 Margreid a.d. Weinstr.,28,,10,13,23
045 Margreid a.d. Weinstr.,29,,6,5,11
045 Margreid a.d. Weinstr.,30,,4,6,10
045 Margreid a.d. Weinstr.,31,,10,12,22
045 Margreid a.d. Weinstr.,32,,10,4,14
045 Margreid a.d. Weinstr.,33,,10,11,21
045 Margreid a.d. Weinstr.,34,,8,10,18
045 Margreid a.d. Weinstr.,35,,6,8,14
045 Margreid a.d. Weinstr.,36,,22,17,39
045 Margreid a.d. Weinstr.,37,,12,16,28
045 Margreid a.d. Weinstr.,38,,21,15,36
045 Margreid a.d. Weinstr.,39,,11,6,17
045 Margreid a.d. Weinstr.,40,,7,5,12
045 Margreid a.d. Weinstr.,41,,14,15,29
045 Margreid a.d. Weinstr.,42,,9,13,22
045 Margreid a.d. Weinstr.,43,,15,12,27
045 Margreid a.d. Weinstr.,44,,15,9,24
045 Margreid a.d. Weinstr.,45,,10,12,22
045 Margreid a.d. Weinstr.,46,,6,6,12
045 Margreid a.d. Weinstr.,47,,8,5,13
045 Margreid a.d. Weinstr.,48,,15,5,20
045 Margreid a.d. Weinstr.,49,,7,7,14
045 Margreid a.d. Weinstr.,50,,4,5,9
045 Margreid a.d. Weinstr.,51,,8,7,15
045 Margreid a.d. Weinstr.,52,,6,9,15
045 Margreid a.d. Weinstr.,53,,3,8,11
045 Margreid a.d. Weinstr.,54,,6,6,12
045 Margreid a.d. Weinstr.,55,,7,4,11
045 Margreid a.d. Weinstr.,56,,6,8,14
045 Margreid a.d. Weinstr.,57,,6,7,13
045 Margreid a.d. Weinstr.,58,,2,4,6
045 Margreid a.d. Weinstr.,59,,6,7,13
045 Margreid a.d. Weinstr.,60,,3,6,9
045 Margreid a.d. Weinstr.,61,,6,4,10
045 Margreid a.d. Weinstr.,62,,11,4,15
045 Margreid a.d. Weinstr.,63,,7,7,14
045 Margreid a.d. Weinstr.,64,,5,3,8
045 Margreid a.d. Weinstr.,65,,3,6,9
045 Margreid a.d. Weinstr.,66,,4,8,12
045 Margreid a.d. Weinstr.,67,,4,3,7
045 Margreid a.d. Weinstr.,68,,7,4,11
045 Margreid a.d. Weinstr.,69,,2,7,9
045 Margreid a.d. Weinstr.,70,,6,3,9
045 Margreid a.d. Weinstr.,71,,5,4,9
045 Margreid a.d. Weinstr.,72,,4,7,11
045 Margreid a.d. Weinstr.,73,,4,6,10
045 Margreid a.d. Weinstr.,74,,6,3,9
045 Margreid a.d. Weinstr.,75,,1,4,5
045 Margreid a.d. Weinstr.,76,,6,3,9
045 Margreid a.d. Weinstr.,77,,2,5,7
045 Margreid a.d. Weinstr.,78,,3,8,11
045 Margreid a.d. Weinstr.,79,,3,2,5
045 Margreid a.d. Weinstr.,80,,1,4,5
045 Margreid a.d. Weinstr.,81,,1,4,5
045 Margreid a.d. Weinstr.,82,,1,3,4
045 Margreid a.d. Weinstr.,83,,-,4,4
045 Margreid a.d. Weinstr.,84,,-,1,1
045 Margreid a.d. Weinstr.,85,,1,5,6
045 Margreid a.d. Weinstr.,86,,1,1,2
045 Margreid a.d. Weinstr.,88,,2,2,4
045 Margreid a.d. Weinstr.,90,,-,1,1
045 Margreid a.d. Weinstr.,91,,2,-,2
045 Margreid a.d. Weinstr.,92,,-,2,2
045 Margreid a.d. Weinstr.,93,,-,1,1
045 Margreid a.d. Weinstr.,98,,-,1,1
046 Mals,0,,28,22,50
046 Mals,1,,32,21,53
046 Mals,2,,20,26,46
046 Mals,3,,32,28,60
046 Mals,4,,32,35,67
046 Mals,5,,40,29,69
046 Mals,6,,35,33,68
046 Mals,7,,34,33,67
046 Mals,8,,33,26,59
046 Mals,9,,34,42,76
046 Mals,10,,38,31,69
046 Mals,11,,35,32,67
046 Mals,12,,31,31,62
046 Mals,13,,35,33,68
046 Mals,14,,38,27,65
046 Mals,15,,40,34,74
046 Mals,16,,31,25,56
046 Mals,17,,31,30,61
046 Mals,18,,28,37,65
046 Mals,19,,35,35,70
046 Mals,20,,35,34,69
046 Mals,21,,33,28,61
046 Mals,22,,38,27,65
046 Mals,23,,36,40,76
046 Mals,24,,34,33,67
046 Mals,25,,29,28,57
046 Mals,26,,45,34,79
046 Mals,27,,32,30,62
046 Mals,28,,35,27,62
046 Mals,29,,38,32,70
046 Mals,30,,44,31,75
046 Mals,31,,28,34,62
046 Mals,32,,32,42,74
046 Mals,33,,40,47,87
046 Mals,34,,49,50,99
046 Mals,35,,52,45,97
046 Mals,36,,55,41,96
046 Mals,37,,48,29,77
046 Mals,38,,51,52,103
046 Mals,39,,48,37,85
046 Mals,40,,51,44,95
046 Mals,41,,51,53,104
046 Mals,42,,38,25,63
046 Mals,43,,51,37,88
046 Mals,44,,30,40,70
046 Mals,45,,32,33,65
046 Mals,46,,35,25,60
046 Mals,47,,37,34,71
046 Mals,48,,32,27,59
046 Mals,49,,32,24,56
046 Mals,50,,22,20,42
046 Mals,51,,34,31,65
046 Mals,52,,29,21,50
046 Mals,53,,30,22,52
046 Mals,54,,33,22,55
046 Mals,55,,19,26,45
046 Mals,56,,27,17,44
046 Mals,57,,22,20,42
046 Mals,58,,22,29,51
046 Mals,59,,11,19,30
046 Mals,60,,31,14,45
046 Mals,61,,24,20,44
046 Mals,62,,25,23,48
046 Mals,63,,20,18,38
046 Mals,64,,21,28,49
046 Mals,65,,25,26,51
046 Mals,66,,21,20,41
046 Mals,67,,13,29,42
046 Mals,68,,22,19,41
046 Mals,69,,16,18,34
046 Mals,70,,15,19,34
046 Mals,71,,16,21,37
046 Mals,72,,18,11,29
046 Mals,73,,12,17,29
046 Mals,74,,22,17,39
046 Mals,75,,21,16,37
046 Mals,76,,23,14,37
046 Mals,77,,13,15,28
046 Mals,78,,9,20,29
046 Mals,79,,10,17,27
046 Mals,80,,7,16,23
046 Mals,81,,3,10,13
046 Mals,82,,13,16,29
046 Mals,83,,9,13,22
046 Mals,84,,3,17,20
046 Mals,85,,4,17,21
046 Mals,86,,1,4,5
046 Mals,87,,3,2,5
046 Mals,88,,1,3,4
046 Mals,89,,3,4,7
046 Mals,90,,1,4,5
046 Mals,91,,5,9,14
046 Mals,92,,1,2,3
046 Mals,93,,-,2,2
046 Mals,94,,2,2,4
046 Mals,95,,1,1,2
046 Mals,96,,-,1,1
046 Mals,100,,-,1,1
047 Enneberg,0,,13,16,29
047 Enneberg,1,,23,27,50
047 Enneberg,2,,16,13,29
047 Enneberg,3,,23,17,40
047 Enneberg,4,,17,20,37
047 Enneberg,5,,28,16,44
047 Enneberg,6,,19,9,28
047 Enneberg,7,,23,15,38
047 Enneberg,8,,17,13,30
047 Enneberg,9,,20,8,28
047 Enneberg,10,,21,14,35
047 Enneberg,11,,20,17,37
047 Enneberg,12,,14,15,29
047 Enneberg,13,,17,22,39
047 Enneberg,14,,15,17,32
047 Enneberg,15,,19,18,37
047 Enneberg,16,,21,16,37
047 Enneberg,17,,18,13,31
047 Enneberg,18,,19,10,29
047 Enneberg,19,,25,15,40
047 Enneberg,20,,20,20,40
047 Enneberg,21,,14,17,31
047 Enneberg,22,,24,20,44
047 Enneberg,23,,22,20,42
047 Enneberg,24,,24,17,41
047 Enneberg,25,,12,18,30
047 Enneberg,26,,13,23,36
047 Enneberg,27,,22,20,42
047 Enneberg,28,,12,16,28
047 Enneberg,29,,11,31,42
047 Enneberg,30,,24,31,55
047 Enneberg,31,,22,24,46
047 Enneberg,32,,23,26,49
047 Enneberg,33,,29,33,62
047 Enneberg,34,,26,21,47
047 Enneberg,35,,28,18,46
047 Enneberg,36,,23,20,43
047 Enneberg,37,,25,19,44
047 Enneberg,38,,22,20,42
047 Enneberg,39,,28,21,49
047 Enneberg,40,,23,22,45
047 Enneberg,41,,23,18,41
047 Enneberg,42,,15,16,31
047 Enneberg,43,,21,16,37
047 Enneberg,44,,15,18,33
047 Enneberg,45,,23,13,36
047 Enneberg,46,,21,8,29
047 Enneberg,47,,16,14,30
047 Enneberg,48,,16,18,34
047 Enneberg,49,,15,13,28
047 Enneberg,50,,14,12,26
047 Enneberg,51,,17,20,37
047 Enneberg,52,,14,16,30
047 Enneberg,53,,17,10,27
047 Enneberg,54,,10,15,25
047 Enneberg,55,,18,8,26
047 Enneberg,56,,16,13,29
047 Enneberg,57,,8,11,19
047 Enneberg,58,,14,17,31
047 Enneberg,59,,5,14,19
047 Enneberg,60,,20,16,36
047 Enneberg,61,,16,11,27
047 Enneberg,62,,12,19,31
047 Enneberg,63,,13,11,24
047 Enneberg,64,,12,7,19
047 Enneberg,65,,17,10,27
047 Enneberg,66,,14,17,31
047 Enneberg,67,,14,13,27
047 Enneberg,68,,12,12,24
047 Enneberg,69,,12,16,28
047 Enneberg,70,,9,10,19
047 Enneberg,71,,12,9,21
047 Enneberg,72,,8,18,26
047 Enneberg,73,,12,10,22
047 Enneberg,74,,13,14,27
047 Enneberg,75,,8,7,15
047 Enneberg,76,,10,12,22
047 Enneberg,77,,8,7,15
047 Enneberg,78,,6,9,15
047 Enneberg,79,,11,8,19
047 Enneberg,80,,4,8,12
047 Enneberg,81,,5,12,17
047 Enneberg,82,,7,7,14
047 Enneberg,83,,2,7,9
047 Enneberg,84,,5,4,9
047 Enneberg,85,,2,3,5
047 Enneberg,86,,4,3,7
047 Enneberg,87,,-,5,5
047 Enneberg,88,,1,6,7
047 Enneberg,89,,-,3,3
047 Enneberg,90,,2,5,7
047 Enneberg,91,,1,-,1
047 Enneberg,92,,-,3,3
047 Enneberg,93,,2,-,2
047 Enneberg,94,,1,-,1
047 Enneberg,97,,-,1,1
047 Enneberg,99,,-,1,1
048 Marling,0,,15,15,30
048 Marling,1,,10,10,20
048 Marling,2,,17,15,32
048 Marling,3,,9,15,24
048 Marling,4,,17,17,34
048 Marling,5,,13,7,20
048 Marling,6,,10,11,21
048 Marling,7,,12,10,22
048 Marling,8,,11,12,23
048 Marling,9,,18,11,29
048 Marling,10,,10,7,17
048 Marling,11,,16,8,24
048 Marling,12,,15,14,29
048 Marling,13,,12,11,23
048 Marling,14,,10,15,25
048 Marling,15,,9,16,25
048 Marling,16,,10,14,24
048 Marling,17,,6,10,16
048 Marling,18,,12,9,21
048 Marling,19,,7,16,23
048 Marling,20,,11,7,18
048 Marling,21,,12,11,23
048 Marling,22,,11,9,20
048 Marling,23,,16,9,25
048 Marling,24,,14,10,24
048 Marling,25,,15,19,34
048 Marling,26,,16,14,30
048 Marling,27,,10,18,28
048 Marling,28,,15,23,38
048 Marling,29,,15,13,28
048 Marling,30,,10,10,20
048 Marling,31,,13,21,34
048 Marling,32,,17,19,36
048 Marling,33,,25,16,41
048 Marling,34,,12,18,30
048 Marling,35,,21,21,42
048 Marling,36,,28,20,48
048 Marling,37,,19,13,32
048 Marling,38,,23,26,49
048 Marling,39,,27,20,47
048 Marling,40,,26,16,42
048 Marling,41,,27,29,56
048 Marling,42,,21,17,38
048 Marling,43,,24,12,36
048 Marling,44,,18,21,39
048 Marling,45,,16,14,30
048 Marling,46,,17,13,30
048 Marling,47,,11,10,21
048 Marling,48,,8,11,19
048 Marling,49,,10,8,18
048 Marling,50,,17,11,28
048 Marling,51,,11,18,29
048 Marling,52,,13,13,26
048 Marling,53,,6,12,18
048 Marling,54,,16,14,30
048 Marling,55,,18,19,37
048 Marling,56,,6,14,20
048 Marling,57,,17,13,30
048 Marling,58,,12,16,28
048 Marling,59,,20,15,35
048 Marling,60,,15,14,29
048 Marling,61,,11,17,28
048 Marling,62,,10,13,23
048 Marling,63,,22,18,40
048 Marling,64,,12,13,25
048 Marling,65,,15,15,30
048 Marling,66,,13,12,25
048 Marling,67,,11,17,28
048 Marling,68,,14,8,22
048 Marling,69,,6,16,22
048 Marling,70,,12,9,21
048 Marling,71,,9,13,22
048 Marling,72,,10,10,20
048 Marling,73,,10,9,19
048 Marling,74,,4,10,14
048 Marling,75,,7,7,14
048 Marling,76,,8,4,12
048 Marling,77,,10,8,18
048 Marling,78,,5,11,16
048 Marling,79,,3,14,17
048 Marling,80,,1,5,6
048 Marling,81,,5,5,10
048 Marling,82,,2,5,7
048 Marling,83,,4,7,11
048 Marling,84,,-,3,3
048 Marling,85,,3,4,7
048 Marling,86,,1,3,4
048 Marling,87,,1,-,1
048 Marling,88,,1,3,4
048 Marling,89,,2,3,5
048 Marling,90,,2,3,5
048 Marling,91,,1,2,3
048 Marling,92,,2,1,3
048 Marling,94,,-,1,1
048 Marling,95,,2,-,2
048 Marling,97,,-,1,1
048 Marling,99,,-,1,1
049 Martell,0,,7,2,9
049 Martell,1,,5,5,10
049 Martell,2,,3,5,8
049 Martell,3,,4,8,12
049 Martell,4,,7,4,11
049 Martell,5,,2,7,9
049 Martell,6,,6,7,13
049 Martell,7,,5,7,12
049 Martell,8,,4,6,10
049 Martell,9,,7,7,14
049 Martell,10,,6,8,14
049 Martell,11,,6,6,12
049 Martell,12,,5,5,10
049 Martell,13,,8,5,13
049 Martell,14,,6,5,11
049 Martell,15,,9,4,13
049 Martell,16,,4,1,5
049 Martell,17,,7,3,10
049 Martell,18,,-,4,4
049 Martell,19,,4,6,10
049 Martell,20,,6,2,8
049 Martell,21,,8,3,11
049 Martell,22,,5,7,12
049 Martell,23,,7,4,11
049 Martell,24,,9,5,14
049 Martell,25,,9,8,17
049 Martell,26,,4,5,9
049 Martell,27,,6,4,10
049 Martell,28,,5,6,11
049 Martell,29,,1,6,7
049 Martell,30,,6,9,15
049 Martell,31,,9,5,14
049 Martell,32,,4,9,13
049 Martell,33,,11,4,15
049 Martell,34,,8,4,12
049 Martell,35,,6,13,19
049 Martell,36,,8,6,14
049 Martell,37,,5,7,12
049 Martell,38,,15,6,21
049 Martell,39,,18,9,27
049 Martell,40,,10,9,19
049 Martell,41,,13,1,14
049 Martell,42,,10,8,18
049 Martell,43,,7,5,12
049 Martell,44,,9,3,12
049 Martell,45,,8,6,14
049 Martell,46,,8,6,14
049 Martell,47,,7,3,10
049 Martell,48,,5,4,9
049 Martell,49,,7,2,9
049 Martell,50,,7,6,13
049 Martell,51,,4,4,8
049 Martell,52,,4,3,7
049 Martell,53,,6,8,14
049 Martell,54,,3,4,7
049 Martell,55,,4,1,5
049 Martell,56,,5,4,9
049 Martell,57,,5,3,8
049 Martell,58,,3,-,3
049 Martell,59,,4,1,5
049 Martell,60,,1,3,4
049 Martell,61,,2,4,6
049 Martell,62,,6,5,11
049 Martell,63,,4,4,8
049 Martell,64,,6,2,8
049 Martell,65,,2,4,6
049 Martell,66,,2,6,8
049 Martell,67,,3,4,7
049 Martell,68,,3,4,7
049 Martell,69,,4,9,13
049 Martell,70,,7,1,8
049 Martell,71,,5,6,11
049 Martell,72,,2,4,6
049 Martell,73,,5,1,6
049 Martell,74,,7,4,11
049 Martell,75,,4,3,7
049 Martell,76,,3,4,7
049 Martell,77,,2,3,5
049 Martell,78,,2,8,10
049 Martell,79,,2,2,4
049 Martell,80,,3,5,8
049 Martell,81,,-,6,6
049 Martell,82,,1,1,2
049 Martell,83,,-,1,1
049 Martell,85,,1,1,2
049 Martell,86,,1,1,2
049 Martell,89,,2,1,3
049 Martell,90,,-,1,1
049 Martell,91,,1,-,1
049 Martell,93,,3,1,4
049 Martell,97,,-,1,1
050 Mölten,0,,12,8,20
050 Mölten,1,,10,8,18
050 Mölten,2,,14,12,26
050 Mölten,3,,16,17,33
050 Mölten,4,,14,13,27
050 Mölten,5,,11,19,30
050 Mölten,6,,8,16,24
050 Mölten,7,,10,7,17
050 Mölten,8,,16,13,29
050 Mölten,9,,11,10,21
050 Mölten,10,,13,5,18
050 Mölten,11,,12,11,23
050 Mölten,12,,6,12,18
050 Mölten,13,,10,6,16
050 Mölten,14,,12,6,18
050 Mölten,15,,13,5,18
050 Mölten,16,,7,9,16
050 Mölten,17,,9,8,17
050 Mölten,18,,10,6,16
050 Mölten,19,,7,13,20
050 Mölten,20,,7,5,12
050 Mölten,21,,6,14,20
050 Mölten,22,,9,7,16
050 Mölten,23,,13,9,22
050 Mölten,24,,13,10,23
050 Mölten,25,,13,12,25
050 Mölten,26,,11,7,18
050 Mölten,27,,7,8,15
050 Mölten,28,,11,16,27
050 Mölten,29,,18,10,28
050 Mölten,30,,15,11,26
050 Mölten,31,,14,16,30
050 Mölten,32,,10,10,20
050 Mölten,33,,19,12,31
050 Mölten,34,,18,13,31
050 Mölten,35,,14,15,29
050 Mölten,36,,17,17,34
050 Mölten,37,,19,14,33
050 Mölten,38,,14,13,27
050 Mölten,39,,10,15,25
050 Mölten,40,,21,12,33
050 Mölten,41,,19,6,25
050 Mölten,42,,10,9,19
050 Mölten,43,,18,9,27
050 Mölten,44,,8,8,16
050 Mölten,45,,13,5,18
050 Mölten,46,,2,11,13
050 Mölten,47,,7,3,10
050 Mölten,48,,5,7,12
050 Mölten,49,,12,8,20
050 Mölten,50,,7,6,13
050 Mölten,51,,6,6,12
050 Mölten,52,,8,6,14
050 Mölten,53,,5,5,10
050 Mölten,54,,9,10,19
050 Mölten,55,,6,6,12
050 Mölten,56,,6,4,10
050 Mölten,57,,3,8,11
050 Mölten,58,,9,3,12
050 Mölten,59,,6,5,11
050 Mölten,60,,2,7,9
050 Mölten,61,,13,8,21
050 Mölten,62,,7,11,18
050 Mölten,63,,9,3,12
050 Mölten,64,,6,7,13
050 Mölten,65,,6,7,13
050 Mölten,66,,2,3,5
050 Mölten,67,,5,6,11
050 Mölten,68,,4,6,10
050 Mölten,69,,10,6,16
050 Mölten,70,,9,5,14
050 Mölten,71,,9,9,18
050 Mölten,72,,3,5,8
050 Mölten,73,,8,3,11
050 Mölten,74,,7,4,11
050 Mölten,75,,3,7,10
050 Mölten,76,,1,5,6
050 Mölten,77,,3,4,7
050 Mölten,78,,3,5,8
050 Mölten,79,,2,4,6
050 Mölten,80,,1,2,3
050 Mölten,81,,6,6,12
050 Mölten,82,,3,1,4
050 Mölten,83,,1,4,5
050 Mölten,84,,1,7,8
050 Mölten,85,,1,5,6
050 Mölten,86,,-,1,1
050 Mölten,87,,-,1,1
050 Mölten,88,,2,1,3
050 Mölten,89,,-,2,2
050 Mölten,90,,-,4,4
050 Mölten,91,,1,-,1
050 Mölten,93,,-,1,1
050 Mölten,94,,-,1,1
050 Mölten,95,,-,1,1
050 Mölten,96,,-,1,1
050 Mölten,98,,-,1,1
051 Meran,0,,189,162,351
051 Meran,1,,182,162,344
051 Meran,2,,170,155,325
051 Meran,3,,166,164,330
051 Meran,4,,172,147,319
051 Meran,5,,168,173,341
051 Meran,6,,148,141,289
051 Meran,7,,182,158,340
051 Meran,8,,188,154,342
051 Meran,9,,167,140,307
051 Meran,10,,155,174,329
051 Meran,11,,131,145,276
051 Meran,12,,173,139,312
051 Meran,13,,154,173,327
051 Meran,14,,155,152,307
051 Meran,15,,174,158,332
051 Meran,16,,161,124,285
051 Meran,17,,162,147,309
051 Meran,18,,157,120,277
051 Meran,19,,137,180,317
051 Meran,20,,171,151,322
051 Meran,21,,154,151,305
051 Meran,22,,157,175,332
051 Meran,23,,179,165,344
051 Meran,24,,173,152,325
051 Meran,25,,163,178,341
051 Meran,26,,186,178,364
051 Meran,27,,186,221,407
051 Meran,28,,208,228,436
051 Meran,29,,252,251,503
051 Meran,30,,272,276,548
051 Meran,31,,255,250,505
051 Meran,32,,274,260,534
051 Meran,33,,288,263,551
051 Meran,34,,291,292,583
051 Meran,35,,316,295,611
051 Meran,36,,323,314,637
051 Meran,37,,332,321,653
051 Meran,38,,327,287,614
051 Meran,39,,336,314,650
051 Meran,40,,348,301,649
051 Meran,41,,335,270,605
051 Meran,42,,264,277,541
051 Meran,43,,297,291,588
051 Meran,44,,292,261,553
051 Meran,45,,271,245,516
051 Meran,46,,243,237,480
051 Meran,47,,228,247,475
051 Meran,48,,224,217,441
051 Meran,49,,196,216,412
051 Meran,50,,184,220,404
051 Meran,51,,184,219,403
051 Meran,52,,212,221,433
051 Meran,53,,209,205,414
051 Meran,54,,194,221,415
051 Meran,55,,227,245,472
051 Meran,56,,216,256,472
051 Meran,57,,214,280,494
051 Meran,58,,238,295,533
051 Meran,59,,212,217,429
051 Meran,60,,203,235,438
051 Meran,61,,254,239,493
051 Meran,62,,259,297,556
051 Meran,63,,230,283,513
051 Meran,64,,196,225,421
051 Meran,65,,204,248,452
051 Meran,66,,181,225,406
051 Meran,67,,189,223,412
051 Meran,68,,169,205,374
051 Meran,69,,166,201,367
051 Meran,70,,163,184,347
051 Meran,71,,151,169,320
051 Meran,72,,135,197,332
051 Meran,73,,123,176,299
051 Meran,74,,126,188,314
051 Meran,75,,107,143,250
051 Meran,76,,108,182,290
051 Meran,77,,102,154,256
051 Meran,78,,98,171,269
051 Meran,79,,76,163,239
051 Meran,80,,88,158,246
051 Meran,81,,63,153,216
051 Meran,82,,75,170,245
051 Meran,83,,44,160,204
051 Meran,84,,51,143,194
051 Meran,85,,43,96,139
051 Meran,86,,27,70,97
051 Meran,87,,25,65,90
051 Meran,88,,18,41,59
051 Meran,89,,27,67,94
051 Meran,90,,26,67,93
051 Meran,91,,19,54,73
051 Meran,92,,14,50,64
051 Meran,93,,10,34,44
051 Meran,94,,4,31,35
051 Meran,95,,8,27,35
051 Meran,96,,6,13,19
051 Meran,97,,1,11,12
051 Meran,98,,1,13,14
051 Meran,99,,1,5,6
051 Meran,100,,-,4,4
051 Meran,101,,-,2,2
051 Meran,102,,-,2,2
051 Meran,103,,-,1,1
052 Welsberg-Taisten,0,,12,18,30
052 Welsberg-Taisten,1,,15,16,31
052 Welsberg-Taisten,2,,21,19,40
052 Welsberg-Taisten,3,,31,18,49
052 Welsberg-Taisten,4,,15,14,29
052 Welsberg-Taisten,5,,23,19,42
052 Welsberg-Taisten,6,,19,13,32
052 Welsberg-Taisten,7,,21,19,40
052 Welsberg-Taisten,8,,16,16,32
052 Welsberg-Taisten,9,,17,14,31
052 Welsberg-Taisten,10,,12,15,27
052 Welsberg-Taisten,11,,14,19,33
052 Welsberg-Taisten,12,,10,10,20
052 Welsberg-Taisten,13,,20,17,37
052 Welsberg-Taisten,14,,10,19,29
052 Welsberg-Taisten,15,,4,18,22
052 Welsberg-Taisten,16,,12,17,29
052 Welsberg-Taisten,17,,13,14,27
052 Welsberg-Taisten,18,,9,10,19
052 Welsberg-Taisten,19,,8,13,21
052 Welsberg-Taisten,20,,25,14,39
052 Welsberg-Taisten,21,,18,18,36
052 Welsberg-Taisten,22,,18,14,32
052 Welsberg-Taisten,23,,9,12,21
052 Welsberg-Taisten,24,,14,15,29
052 Welsberg-Taisten,25,,23,17,40
052 Welsberg-Taisten,26,,21,19,40
052 Welsberg-Taisten,27,,14,22,36
052 Welsberg-Taisten,28,,17,12,29
052 Welsberg-Taisten,29,,13,26,39
052 Welsberg-Taisten,30,,28,19,47
052 Welsberg-Taisten,31,,30,10,40
052 Welsberg-Taisten,32,,16,27,43
052 Welsberg-Taisten,33,,31,24,55
052 Welsberg-Taisten,34,,25,20,45
052 Welsberg-Taisten,35,,21,21,42
052 Welsberg-Taisten,36,,23,16,39
052 Welsberg-Taisten,37,,31,19,50
052 Welsberg-Taisten,38,,27,22,49
052 Welsberg-Taisten,39,,21,17,38
052 Welsberg-Taisten,40,,36,21,57
052 Welsberg-Taisten,41,,27,22,49
052 Welsberg-Taisten,42,,19,23,42
052 Welsberg-Taisten,43,,16,16,32
052 Welsberg-Taisten,44,,12,14,26
052 Welsberg-Taisten,45,,20,21,41
052 Welsberg-Taisten,46,,25,18,43
052 Welsberg-Taisten,47,,11,19,30
052 Welsberg-Taisten,48,,19,19,38
052 Welsberg-Taisten,49,,17,11,28
052 Welsberg-Taisten,50,,14,14,28
052 Welsberg-Taisten,51,,19,12,31
052 Welsberg-Taisten,52,,18,11,29
052 Welsberg-Taisten,53,,19,10,29
052 Welsberg-Taisten,54,,15,13,28
052 Welsberg-Taisten,55,,14,11,25
052 Welsberg-Taisten,56,,16,16,32
052 Welsberg-Taisten,57,,10,9,19
052 Welsberg-Taisten,58,,12,14,26
052 Welsberg-Taisten,59,,10,14,24
052 Welsberg-Taisten,60,,13,10,23
052 Welsberg-Taisten,61,,11,15,26
052 Welsberg-Taisten,62,,10,13,23
052 Welsberg-Taisten,63,,19,17,36
052 Welsberg-Taisten,64,,6,13,19
052 Welsberg-Taisten,65,,13,14,27
052 Welsberg-Taisten,66,,13,11,24
052 Welsberg-Taisten,67,,11,8,19
052 Welsberg-Taisten,68,,10,10,20
052 Welsberg-Taisten,69,,3,16,19
052 Welsberg-Taisten,70,,17,15,32
052 Welsberg-Taisten,71,,10,11,21
052 Welsberg-Taisten,72,,11,12,23
052 Welsberg-Taisten,73,,6,12,18
052 Welsberg-Taisten,74,,9,7,16
052 Welsberg-Taisten,75,,9,12,21
052 Welsberg-Taisten,76,,5,19,24
052 Welsberg-Taisten,77,,7,12,19
052 Welsberg-Taisten,78,,7,7,14
052 Welsberg-Taisten,79,,-,8,8
052 Welsberg-Taisten,80,,4,8,12
052 Welsberg-Taisten,81,,5,9,14
052 Welsberg-Taisten,82,,4,5,9
052 Welsberg-Taisten,83,,3,9,12
052 Welsberg-Taisten,84,,2,7,9
052 Welsberg-Taisten,85,,1,7,8
052 Welsberg-Taisten,86,,2,1,3
052 Welsberg-Taisten,87,,1,2,3
052 Welsberg-Taisten,88,,2,-,2
052 Welsberg-Taisten,89,,2,4,6
052 Welsberg-Taisten,90,,1,1,2
052 Welsberg-Taisten,91,,-,4,4
052 Welsberg-Taisten,92,,1,2,3
052 Welsberg-Taisten,93,,-,2,2
052 Welsberg-Taisten,94,,1,2,3
052 Welsberg-Taisten,95,,-,1,1
052 Welsberg-Taisten,96,,-,2,2
052 Welsberg-Taisten,97,,1,1,2
052 Welsberg-Taisten,104,,1,-,1
052 Welsberg-Taisten,-,,-,1,1
053 Montan,0,,7,8,15
053 Montan,1,,9,6,15
053 Montan,2,,6,5,11
053 Montan,3,,10,6,16
053 Montan,4,,9,6,15
053 Montan,5,,7,10,17
053 Montan,6,,9,12,21
053 Montan,7,,7,8,15
053 Montan,8,,14,11,25
053 Montan,9,,16,15,31
053 Montan,10,,13,6,19
053 Montan,11,,5,8,13
053 Montan,12,,8,10,18
053 Montan,13,,14,9,23
053 Montan,14,,11,8,19
053 Montan,15,,10,11,21
053 Montan,16,,12,14,26
053 Montan,17,,10,17,27
053 Montan,18,,14,5,19
053 Montan,19,,11,9,20
053 Montan,20,,7,3,10
053 Montan,21,,10,6,16
053 Montan,22,,11,9,20
053 Montan,23,,11,10,21
053 Montan,24,,5,4,9
053 Montan,25,,10,5,15
053 Montan,26,,11,7,18
053 Montan,27,,8,4,12
053 Montan,28,,13,6,19
053 Montan,29,,12,14,26
053 Montan,30,,11,15,26
053 Montan,31,,16,4,20
053 Montan,32,,10,8,18
053 Montan,33,,13,9,22
053 Montan,34,,18,12,30
053 Montan,35,,16,18,34
053 Montan,36,,13,19,32
053 Montan,37,,14,11,25
053 Montan,38,,12,17,29
053 Montan,39,,31,14,45
053 Montan,40,,19,11,30
053 Montan,41,,13,17,30
053 Montan,42,,17,16,33
053 Montan,43,,19,11,30
053 Montan,44,,14,12,26
053 Montan,45,,14,10,24
053 Montan,46,,14,11,25
053 Montan,47,,16,11,27
053 Montan,48,,7,14,21
053 Montan,49,,7,11,18
053 Montan,50,,14,11,25
053 Montan,51,,12,8,20
053 Montan,52,,12,3,15
053 Montan,53,,7,6,13
053 Montan,54,,4,5,9
053 Montan,55,,8,3,11
053 Montan,56,,5,7,12
053 Montan,57,,7,10,17
053 Montan,58,,5,2,7
053 Montan,59,,4,3,7
053 Montan,60,,2,5,7
053 Montan,61,,5,7,12
053 Montan,62,,8,6,14
053 Montan,63,,6,5,11
053 Montan,64,,9,7,16
053 Montan,65,,5,10,15
053 Montan,66,,8,9,17
053 Montan,67,,2,7,9
053 Montan,68,,8,10,18
053 Montan,69,,1,8,9
053 Montan,70,,3,6,9
053 Montan,71,,15,5,20
053 Montan,72,,5,7,12
053 Montan,73,,7,11,18
053 Montan,74,,10,13,23
053 Montan,75,,6,9,15
053 Montan,76,,7,3,10
053 Montan,77,,5,5,10
053 Montan,78,,6,8,14
053 Montan,79,,3,9,12
053 Montan,80,,2,6,8
053 Montan,81,,5,10,15
053 Montan,82,,3,7,10
053 Montan,83,,1,3,4
053 Montan,84,,1,7,8
053 Montan,85,,2,4,6
053 Montan,86,,-,4,4
053 Montan,87,,2,4,6
053 Montan,88,,-,2,2
053 Montan,89,,-,5,5
053 Montan,90,,-,2,2
053 Montan,91,,1,4,5
053 Montan,92,,1,-,1
053 Montan,93,,-,2,2
053 Montan,94,,1,-,1
053 Montan,95,,-,1,1
053 Montan,96,,-,2,2
053 Montan,103,,-,1,1
054 Moos in Passeier,0,,15,17,32
054 Moos in Passeier,1,,14,11,25
054 Moos in Passeier,2,,20,18,38
054 Moos in Passeier,3,,14,12,26
054 Moos in Passeier,4,,12,18,30
054 Moos in Passeier,5,,28,10,38
054 Moos in Passeier,6,,14,17,31
054 Moos in Passeier,7,,13,17,30
054 Moos in Passeier,8,,18,20,38
054 Moos in Passeier,9,,8,15,23
054 Moos in Passeier,10,,17,21,38
054 Moos in Passeier,11,,20,12,32
054 Moos in Passeier,12,,18,18,36
054 Moos in Passeier,13,,18,21,39
054 Moos in Passeier,14,,15,13,28
054 Moos in Passeier,15,,17,19,36
054 Moos in Passeier,16,,16,16,32
054 Moos in Passeier,17,,15,14,29
054 Moos in Passeier,18,,17,15,32
054 Moos in Passeier,19,,19,12,31
054 Moos in Passeier,20,,22,21,43
054 Moos in Passeier,21,,15,13,28
054 Moos in Passeier,22,,17,21,38
054 Moos in Passeier,23,,17,19,36
054 Moos in Passeier,24,,17,16,33
054 Moos in Passeier,25,,20,17,37
054 Moos in Passeier,26,,24,13,37
054 Moos in Passeier,27,,20,17,37
054 Moos in Passeier,28,,14,9,23
054 Moos in Passeier,29,,19,16,35
054 Moos in Passeier,30,,25,13,38
054 Moos in Passeier,31,,9,25,34
054 Moos in Passeier,32,,21,15,36
054 Moos in Passeier,33,,19,17,36
054 Moos in Passeier,34,,20,11,31
054 Moos in Passeier,35,,18,19,37
054 Moos in Passeier,36,,21,21,42
054 Moos in Passeier,37,,23,19,42
054 Moos in Passeier,38,,26,20,46
054 Moos in Passeier,39,,22,8,30
054 Moos in Passeier,40,,26,10,36
054 Moos in Passeier,41,,17,18,35
054 Moos in Passeier,42,,11,20,31
054 Moos in Passeier,43,,9,7,16
054 Moos in Passeier,44,,18,16,34
054 Moos in Passeier,45,,16,13,29
054 Moos in Passeier,46,,14,16,30
054 Moos in Passeier,47,,20,7,27
054 Moos in Passeier,48,,9,8,17
054 Moos in Passeier,49,,9,9,18
054 Moos in Passeier,50,,16,9,25
054 Moos in Passeier,51,,6,9,15
054 Moos in Passeier,52,,8,5,13
054 Moos in Passeier,53,,9,10,19
054 Moos in Passeier,54,,8,10,18
054 Moos in Passeier,55,,16,9,25
054 Moos in Passeier,56,,6,6,12
054 Moos in Passeier,57,,19,10,29
054 Moos in Passeier,58,,8,8,16
054 Moos in Passeier,59,,9,7,16
054 Moos in Passeier,60,,9,9,18
054 Moos in Passeier,61,,14,12,26
054 Moos in Passeier,62,,5,12,17
054 Moos in Passeier,63,,10,15,25
054 Moos in Passeier,64,,9,10,19
054 Moos in Passeier,65,,5,6,11
054 Moos in Passeier,66,,11,7,18
054 Moos in Passeier,67,,5,6,11
054 Moos in Passeier,68,,8,7,15
054 Moos in Passeier,69,,8,7,15
054 Moos in Passeier,70,,11,14,25
054 Moos in Passeier,71,,7,10,17
054 Moos in Passeier,72,,8,4,12
054 Moos in Passeier,73,,9,7,16
054 Moos in Passeier,74,,9,7,16
054 Moos in Passeier,75,,7,12,19
054 Moos in Passeier,76,,4,10,14
054 Moos in Passeier,77,,7,5,12
054 Moos in Passeier,78,,9,2,11
054 Moos in Passeier,79,,7,7,14
054 Moos in Passeier,80,,3,4,7
054 Moos in Passeier,81,,4,3,7
054 Moos in Passeier,82,,1,6,7
054 Moos in Passeier,83,,1,2,3
054 Moos in Passeier,84,,2,2,4
054 Moos in Passeier,85,,1,4,5
054 Moos in Passeier,86,,1,-,1
054 Moos in Passeier,87,,1,2,3
054 Moos in Passeier,88,,-,3,3
054 Moos in Passeier,89,,1,1,2
054 Moos in Passeier,90,,1,3,4
054 Moos in Passeier,91,,-,1,1
054 Moos in Passeier,92,,1,1,2
054 Moos in Passeier,94,,-,1,1
054 Moos in Passeier,96,,1,-,1
055 Nals,0,,7,8,15
055 Nals,1,,6,9,15
055 Nals,2,,12,11,23
055 Nals,3,,8,9,17
055 Nals,4,,6,13,19
055 Nals,5,,14,8,22
055 Nals,6,,13,8,21
055 Nals,7,,12,6,18
055 Nals,8,,11,10,21
055 Nals,9,,9,6,15
055 Nals,10,,9,8,17
055 Nals,11,,7,12,19
055 Nals,12,,13,10,23
055 Nals,13,,8,11,19
055 Nals,14,,9,7,16
055 Nals,15,,12,8,20
055 Nals,16,,9,12,21
055 Nals,17,,12,10,22
055 Nals,18,,5,2,7
055 Nals,19,,12,5,17
055 Nals,20,,8,11,19
055 Nals,21,,5,9,14
055 Nals,22,,8,9,17
055 Nals,23,,11,10,21
055 Nals,24,,14,9,23
055 Nals,25,,8,9,17
055 Nals,26,,10,10,20
055 Nals,27,,6,6,12
055 Nals,28,,11,13,24
055 Nals,29,,7,11,18
055 Nals,30,,20,12,32
055 Nals,31,,11,7,18
055 Nals,32,,9,15,24
055 Nals,33,,15,15,30
055 Nals,34,,22,12,34
055 Nals,35,,16,15,31
055 Nals,36,,23,17,40
055 Nals,37,,20,14,34
055 Nals,38,,13,11,24
055 Nals,39,,19,13,32
055 Nals,40,,19,18,37
055 Nals,41,,11,19,30
055 Nals,42,,10,14,24
055 Nals,43,,17,15,32
055 Nals,44,,13,8,21
055 Nals,45,,16,14,30
055 Nals,46,,17,17,34
055 Nals,47,,8,9,17
055 Nals,48,,8,8,16
055 Nals,49,,19,15,34
055 Nals,50,,6,7,13
055 Nals,51,,6,7,13
055 Nals,52,,7,7,14
055 Nals,53,,3,10,13
055 Nals,54,,7,10,17
055 Nals,55,,10,9,19
055 Nals,56,,11,11,22
055 Nals,57,,12,6,18
055 Nals,58,,8,13,21
055 Nals,59,,7,11,18
055 Nals,60,,6,12,18
055 Nals,61,,10,6,16
055 Nals,62,,5,8,13
055 Nals,63,,11,6,17
055 Nals,64,,7,12,19
055 Nals,65,,10,10,20
055 Nals,66,,7,9,16
055 Nals,67,,3,14,17
055 Nals,68,,6,3,9
055 Nals,69,,7,6,13
055 Nals,70,,6,6,12
055 Nals,71,,9,10,19
055 Nals,72,,6,4,10
055 Nals,73,,3,6,9
055 Nals,74,,4,5,9
055 Nals,75,,9,7,16
055 Nals,76,,7,7,14
055 Nals,77,,6,6,12
055 Nals,78,,7,6,13
055 Nals,79,,4,4,8
055 Nals,80,,3,1,4
055 Nals,81,,1,6,7
055 Nals,82,,1,6,7
055 Nals,83,,2,7,9
055 Nals,84,,-,1,1
055 Nals,85,,1,3,4
055 Nals,87,,1,-,1
055 Nals,88,,-,1,1
055 Nals,89,,2,2,4
055 Nals,90,,-,3,3
055 Nals,91,,-,1,1
055 Nals,92,,2,-,2
055 Nals,93,,-,1,1
055 Nals,94,,1,1,2
056 Naturns,0,,29,28,57
056 Naturns,1,,37,25,62
056 Naturns,2,,23,26,49
056 Naturns,3,,31,30,61
056 Naturns,4,,28,25,53
056 Naturns,5,,30,29,59
056 Naturns,6,,31,32,63
056 Naturns,7,,22,18,40
056 Naturns,8,,31,35,66
056 Naturns,9,,46,34,80
056 Naturns,10,,37,38,75
056 Naturns,11,,31,38,69
056 Naturns,12,,30,39,69
056 Naturns,13,,43,36,79
056 Naturns,14,,35,31,66
056 Naturns,15,,37,24,61
056 Naturns,16,,42,35,77
056 Naturns,17,,35,18,53
056 Naturns,18,,29,26,55
056 Naturns,19,,34,23,57
056 Naturns,20,,39,19,58
056 Naturns,21,,29,32,61
056 Naturns,22,,35,29,64
056 Naturns,23,,39,47,86
056 Naturns,24,,32,29,61
056 Naturns,25,,40,36,76
056 Naturns,26,,37,39,76
056 Naturns,27,,36,33,69
056 Naturns,28,,35,34,69
056 Naturns,29,,42,34,76
056 Naturns,30,,40,42,82
056 Naturns,31,,43,45,88
056 Naturns,32,,40,43,83
056 Naturns,33,,41,40,81
056 Naturns,34,,45,44,89
056 Naturns,35,,37,46,83
056 Naturns,36,,46,43,89
056 Naturns,37,,47,40,87
056 Naturns,38,,52,45,97
056 Naturns,39,,39,49,88
056 Naturns,40,,48,39,87
056 Naturns,41,,42,47,89
056 Naturns,42,,41,47,88
056 Naturns,43,,37,47,84
056 Naturns,44,,53,37,90
056 Naturns,45,,44,40,84
056 Naturns,46,,31,34,65
056 Naturns,47,,36,33,69
056 Naturns,48,,40,35,75
056 Naturns,49,,31,32,63
056 Naturns,50,,38,30,68
056 Naturns,51,,33,25,58
056 Naturns,52,,35,35,70
056 Naturns,53,,37,36,73
056 Naturns,54,,27,32,59
056 Naturns,55,,26,20,46
056 Naturns,56,,30,25,55
056 Naturns,57,,13,20,33
056 Naturns,58,,24,31,55
056 Naturns,59,,25,19,44
056 Naturns,60,,20,20,40
056 Naturns,61,,26,35,61
056 Naturns,62,,32,34,66
056 Naturns,63,,41,29,70
056 Naturns,64,,21,20,41
056 Naturns,65,,20,21,41
056 Naturns,66,,23,18,41
056 Naturns,67,,23,23,46
056 Naturns,68,,20,21,41
056 Naturns,69,,22,10,32
056 Naturns,70,,17,20,37
056 Naturns,71,,15,13,28
056 Naturns,72,,12,19,31
056 Naturns,73,,12,22,34
056 Naturns,74,,17,24,41
056 Naturns,75,,14,17,31
056 Naturns,76,,17,16,33
056 Naturns,77,,12,17,29
056 Naturns,78,,13,14,27
056 Naturns,79,,15,17,32
056 Naturns,80,,13,15,28
056 Naturns,81,,8,10,18
056 Naturns,82,,5,10,15
056 Naturns,83,,4,12,16
056 Naturns,84,,3,8,11
056 Naturns,85,,1,8,9
056 Naturns,86,,2,3,5
056 Naturns,87,,3,1,4
056 Naturns,88,,2,1,3
056 Naturns,89,,1,4,5
056 Naturns,90,,2,7,9
056 Naturns,91,,3,10,13
056 Naturns,92,,1,3,4
056 Naturns,93,,1,2,3
056 Naturns,94,,2,-,2
056 Naturns,95,,-,5,5
056 Naturns,96,,-,1,1
056 Naturns,99,,1,-,1
057 Natz-Schabs,0,,12,16,28
057 Natz-Schabs,1,,22,15,37
057 Natz-Schabs,2,,21,15,36
057 Natz-Schabs,3,,9,20,29
057 Natz-Schabs,4,,19,18,37
057 Natz-Schabs,5,,14,21,35
057 Natz-Schabs,6,,22,15,37
057 Natz-Schabs,7,,18,18,36
057 Natz-Schabs,8,,23,16,39
057 Natz-Schabs,9,,13,13,26
057 Natz-Schabs,10,,23,16,39
057 Natz-Schabs,11,,15,18,33
057 Natz-Schabs,12,,18,13,31
057 Natz-Schabs,13,,21,21,42
057 Natz-Schabs,14,,14,25,39
057 Natz-Schabs,15,,17,24,41
057 Natz-Schabs,16,,24,15,39
057 Natz-Schabs,17,,19,20,39
057 Natz-Schabs,18,,17,20,37
057 Natz-Schabs,19,,21,23,44
057 Natz-Schabs,20,,17,14,31
057 Natz-Schabs,21,,20,16,36
057 Natz-Schabs,22,,11,20,31
057 Natz-Schabs,23,,17,19,36
057 Natz-Schabs,24,,23,15,38
057 Natz-Schabs,25,,15,15,30
057 Natz-Schabs,26,,19,16,35
057 Natz-Schabs,27,,17,15,32
057 Natz-Schabs,28,,9,21,30
057 Natz-Schabs,29,,16,25,41
057 Natz-Schabs,30,,16,21,37
057 Natz-Schabs,31,,27,18,45
057 Natz-Schabs,32,,25,23,48
057 Natz-Schabs,33,,26,27,53
057 Natz-Schabs,34,,31,25,56
057 Natz-Schabs,35,,28,22,50
057 Natz-Schabs,36,,29,18,47
057 Natz-Schabs,37,,29,26,55
057 Natz-Schabs,38,,29,18,47
057 Natz-Schabs,39,,32,28,60
057 Natz-Schabs,40,,25,26,51
057 Natz-Schabs,41,,25,27,52
057 Natz-Schabs,42,,18,22,40
057 Natz-Schabs,43,,22,19,41
057 Natz-Schabs,44,,32,21,53
057 Natz-Schabs,45,,24,21,45
057 Natz-Schabs,46,,23,18,41
057 Natz-Schabs,47,,20,19,39
057 Natz-Schabs,48,,18,22,40
057 Natz-Schabs,49,,20,16,36
057 Natz-Schabs,50,,10,14,24
057 Natz-Schabs,51,,20,15,35
057 Natz-Schabs,52,,14,10,24
057 Natz-Schabs,53,,16,10,26
057 Natz-Schabs,54,,16,15,31
057 Natz-Schabs,55,,18,15,33
057 Natz-Schabs,56,,13,12,25
057 Natz-Schabs,57,,12,11,23
057 Natz-Schabs,58,,14,11,25
057 Natz-Schabs,59,,10,6,16
057 Natz-Schabs,60,,14,12,26
057 Natz-Schabs,61,,11,7,18
057 Natz-Schabs,62,,11,6,17
057 Natz-Schabs,63,,14,9,23
057 Natz-Schabs,64,,4,7,11
057 Natz-Schabs,65,,2,6,8
057 Natz-Schabs,66,,6,6,12
057 Natz-Schabs,67,,12,6,18
057 Natz-Schabs,68,,9,4,13
057 Natz-Schabs,69,,8,7,15
057 Natz-Schabs,70,,5,5,10
057 Natz-Schabs,71,,6,10,16
057 Natz-Schabs,72,,5,7,12
057 Natz-Schabs,73,,5,4,9
057 Natz-Schabs,74,,5,7,12
057 Natz-Schabs,75,,10,2,12
057 Natz-Schabs,76,,4,7,11
057 Natz-Schabs,77,,1,4,5
057 Natz-Schabs,78,,4,7,11
057 Natz-Schabs,79,,3,5,8
057 Natz-Schabs,80,,2,7,9
057 Natz-Schabs,81,,-,10,10
057 Natz-Schabs,82,,5,3,8
057 Natz-Schabs,83,,5,3,8
057 Natz-Schabs,84,,1,7,8
057 Natz-Schabs,85,,-,2,2
057 Natz-Schabs,86,,1,4,5
057 Natz-Schabs,87,,-,1,1
057 Natz-Schabs,89,,1,-,1
057 Natz-Schabs,91,,2,-,2
057 Natz-Schabs,92,,-,1,1
057 Natz-Schabs,93,,-,2,2
057 Natz-Schabs,96,,-,1,1
058 Welschnofen,0,,18,7,25
058 Welschnofen,1,,9,9,18
058 Welschnofen,2,,20,6,26
058 Welschnofen,3,,6,12,18
058 Welschnofen,4,,9,8,17
058 Welschnofen,5,,10,12,22
058 Welschnofen,6,,14,10,24
058 Welschnofen,7,,11,12,23
058 Welschnofen,8,,10,11,21
058 Welschnofen,9,,14,13,27
058 Welschnofen,10,,11,11,22
058 Welschnofen,11,,14,10,24
058 Welschnofen,12,,14,10,24
058 Welschnofen,13,,15,11,26
058 Welschnofen,14,,12,14,26
058 Welschnofen,15,,14,9,23
058 Welschnofen,16,,11,17,28
058 Welschnofen,17,,10,9,19
058 Welschnofen,18,,7,10,17
058 Welschnofen,19,,11,8,19
058 Welschnofen,20,,6,8,14
058 Welschnofen,21,,10,11,21
058 Welschnofen,22,,10,15,25
058 Welschnofen,23,,13,11,24
058 Welschnofen,24,,15,9,24
058 Welschnofen,25,,9,4,13
058 Welschnofen,26,,12,12,24
058 Welschnofen,27,,11,18,29
058 Welschnofen,28,,19,10,29
058 Welschnofen,29,,17,11,28
058 Welschnofen,30,,13,15,28
058 Welschnofen,31,,13,16,29
058 Welschnofen,32,,12,14,26
058 Welschnofen,33,,14,15,29
058 Welschnofen,34,,19,12,31
058 Welschnofen,35,,13,14,27
058 Welschnofen,36,,16,17,33
058 Welschnofen,37,,17,16,33
058 Welschnofen,38,,16,12,28
058 Welschnofen,39,,21,16,37
058 Welschnofen,40,,14,7,21
058 Welschnofen,41,,16,16,32
058 Welschnofen,42,,13,16,29
058 Welschnofen,43,,16,18,34
058 Welschnofen,44,,20,9,29
058 Welschnofen,45,,14,12,26
058 Welschnofen,46,,16,11,27
058 Welschnofen,47,,11,13,24
058 Welschnofen,48,,9,12,21
058 Welschnofen,49,,15,14,29
058 Welschnofen,50,,15,11,26
058 Welschnofen,51,,11,13,24
058 Welschnofen,52,,11,8,19
058 Welschnofen,53,,16,7,23
058 Welschnofen,54,,9,9,18
058 Welschnofen,55,,12,13,25
058 Welschnofen,56,,9,9,18
058 Welschnofen,57,,9,8,17
058 Welschnofen,58,,10,10,20
058 Welschnofen,59,,11,6,17
058 Welschnofen,60,,7,10,17
058 Welschnofen,61,,13,9,22
058 Welschnofen,62,,11,13,24
058 Welschnofen,63,,10,7,17
058 Welschnofen,64,,7,7,14
058 Welschnofen,65,,10,7,17
058 Welschnofen,66,,7,6,13
058 Welschnofen,67,,9,4,13
058 Welschnofen,68,,4,12,16
058 Welschnofen,69,,8,6,14
058 Welschnofen,70,,10,10,20
058 Welschnofen,71,,10,14,24
058 Welschnofen,72,,7,7,14
058 Welschnofen,73,,5,8,13
058 Welschnofen,74,,6,8,14
058 Welschnofen,75,,7,12,19
058 Welschnofen,76,,7,5,12
058 Welschnofen,77,,2,3,5
058 Welschnofen,78,,4,8,12
058 Welschnofen,79,,5,6,11
058 Welschnofen,80,,3,13,16
058 Welschnofen,81,,7,7,14
058 Welschnofen,82,,6,6,12
058 Welschnofen,83,,1,9,10
058 Welschnofen,84,,3,4,7
058 Welschnofen,85,,1,5,6
058 Welschnofen,86,,1,1,2
058 Welschnofen,87,,1,-,1
058 Welschnofen,88,,1,4,5
058 Welschnofen,89,,-,3,3
058 Welschnofen,90,,-,2,2
058 Welschnofen,91,,-,3,3
058 Welschnofen,92,,2,5,7
058 Welschnofen,93,,1,-,1
058 Welschnofen,94,,1,1,2
058 Welschnofen,95,,-,2,2
058 Welschnofen,96,,1,-,1
058 Welschnofen,98,,-,1,1
059 Deutschnofen,0,,21,29,50
059 Deutschnofen,1,,19,30,49
059 Deutschnofen,2,,31,10,41
059 Deutschnofen,3,,22,29,51
059 Deutschnofen,4,,21,26,47
059 Deutschnofen,5,,29,23,52
059 Deutschnofen,6,,31,14,45
059 Deutschnofen,7,,22,28,50
059 Deutschnofen,8,,19,27,46
059 Deutschnofen,9,,25,25,50
059 Deutschnofen,10,,28,14,42
059 Deutschnofen,11,,22,26,48
059 Deutschnofen,12,,34,28,62
059 Deutschnofen,13,,20,21,41
059 Deutschnofen,14,,34,28,62
059 Deutschnofen,15,,23,22,45
059 Deutschnofen,16,,22,34,56
059 Deutschnofen,17,,21,24,45
059 Deutschnofen,18,,30,17,47
059 Deutschnofen,19,,25,19,44
059 Deutschnofen,20,,31,27,58
059 Deutschnofen,21,,22,22,44
059 Deutschnofen,22,,22,37,59
059 Deutschnofen,23,,21,16,37
059 Deutschnofen,24,,26,21,47
059 Deutschnofen,25,,23,20,43
059 Deutschnofen,26,,24,17,41
059 Deutschnofen,27,,31,25,56
059 Deutschnofen,28,,20,21,41
059 Deutschnofen,29,,25,24,49
059 Deutschnofen,30,,27,34,61
059 Deutschnofen,31,,17,28,45
059 Deutschnofen,32,,25,36,61
059 Deutschnofen,33,,25,23,48
059 Deutschnofen,34,,29,28,57
059 Deutschnofen,35,,42,28,70
059 Deutschnofen,36,,24,26,50
059 Deutschnofen,37,,30,28,58
059 Deutschnofen,38,,34,34,68
059 Deutschnofen,39,,37,20,57
059 Deutschnofen,40,,30,28,58
059 Deutschnofen,41,,33,27,60
059 Deutschnofen,42,,28,28,56
059 Deutschnofen,43,,35,21,56
059 Deutschnofen,44,,41,26,67
059 Deutschnofen,45,,26,17,43
059 Deutschnofen,46,,23,32,55
059 Deutschnofen,47,,23,25,48
059 Deutschnofen,48,,35,27,62
059 Deutschnofen,49,,28,22,50
059 Deutschnofen,50,,27,20,47
059 Deutschnofen,51,,23,20,43
059 Deutschnofen,52,,23,21,44
059 Deutschnofen,53,,20,14,34
059 Deutschnofen,54,,16,20,36
059 Deutschnofen,55,,21,13,34
059 Deutschnofen,56,,22,15,37
059 Deutschnofen,57,,12,15,27
059 Deutschnofen,58,,18,22,40
059 Deutschnofen,59,,17,15,32
059 Deutschnofen,60,,16,16,32
059 Deutschnofen,61,,24,21,45
059 Deutschnofen,62,,18,17,35
059 Deutschnofen,63,,16,25,41
059 Deutschnofen,64,,14,19,33
059 Deutschnofen,65,,27,14,41
059 Deutschnofen,66,,15,21,36
059 Deutschnofen,67,,13,7,20
059 Deutschnofen,68,,14,10,24
059 Deutschnofen,69,,8,13,21
059 Deutschnofen,70,,16,10,26
059 Deutschnofen,71,,8,13,21
059 Deutschnofen,72,,14,14,28
059 Deutschnofen,73,,12,8,20
059 Deutschnofen,74,,10,10,20
059 Deutschnofen,75,,7,10,17
059 Deutschnofen,76,,9,21,30
059 Deutschnofen,77,,8,14,22
059 Deutschnofen,78,,15,10,25
059 Deutschnofen,79,,8,19,27
059 Deutschnofen,80,,5,10,15
059 Deutschnofen,81,,4,10,14
059 Deutschnofen,82,,8,15,23
059 Deutschnofen,83,,6,14,20
059 Deutschnofen,84,,2,10,12
059 Deutschnofen,85,,1,6,7
059 Deutschnofen,86,,2,5,7
059 Deutschnofen,87,,-,3,3
059 Deutschnofen,88,,3,2,5
059 Deutschnofen,89,,3,5,8
059 Deutschnofen,90,,2,5,7
059 Deutschnofen,91,,-,6,6
059 Deutschnofen,92,,-,4,4
059 Deutschnofen,93,,1,6,7
059 Deutschnofen,94,,1,2,3
059 Deutschnofen,96,,1,-,1
059 Deutschnofen,97,,1,-,1
060 Auer,0,,23,15,38
060 Auer,1,,22,18,40
060 Auer,2,,32,17,49
060 Auer,3,,17,20,37
060 Auer,4,,20,22,42
060 Auer,5,,21,24,45
060 Auer,6,,22,22,44
060 Auer,7,,19,18,37
060 Auer,8,,19,21,40
060 Auer,9,,18,15,33
060 Auer,10,,23,23,46
060 Auer,11,,11,24,35
060 Auer,12,,19,20,39
060 Auer,13,,26,16,42
060 Auer,14,,17,19,36
060 Auer,15,,23,19,42
060 Auer,16,,17,25,42
060 Auer,17,,22,19,41
060 Auer,18,,17,14,31
060 Auer,19,,24,17,41
060 Auer,20,,17,14,31
060 Auer,21,,16,18,34
060 Auer,22,,18,27,45
060 Auer,23,,15,16,31
060 Auer,24,,15,19,34
060 Auer,25,,19,19,38
060 Auer,26,,14,13,27
060 Auer,27,,16,28,44
060 Auer,28,,19,34,53
060 Auer,29,,20,18,38
060 Auer,30,,33,24,57
060 Auer,31,,32,20,52
060 Auer,32,,19,22,41
060 Auer,33,,36,24,60
060 Auer,34,,28,31,59
060 Auer,35,,22,30,52
060 Auer,36,,37,38,75
060 Auer,37,,25,27,52
060 Auer,38,,34,38,72
060 Auer,39,,33,26,59
060 Auer,40,,33,24,57
060 Auer,41,,34,39,73
060 Auer,42,,25,24,49
060 Auer,43,,39,35,74
060 Auer,44,,27,35,62
060 Auer,45,,36,28,64
060 Auer,46,,34,19,53
060 Auer,47,,24,26,50
060 Auer,48,,31,29,60
060 Auer,49,,16,23,39
060 Auer,50,,20,13,33
060 Auer,51,,16,22,38
060 Auer,52,,18,21,39
060 Auer,53,,15,21,36
060 Auer,54,,14,21,35
060 Auer,55,,13,14,27
060 Auer,56,,29,14,43
060 Auer,57,,17,23,40
060 Auer,58,,17,24,41
060 Auer,59,,12,12,24
060 Auer,60,,22,15,37
060 Auer,61,,16,18,34
060 Auer,62,,17,18,35
060 Auer,63,,21,14,35
060 Auer,64,,13,9,22
060 Auer,65,,13,20,33
060 Auer,66,,17,18,35
060 Auer,67,,12,12,24
060 Auer,68,,11,10,21
060 Auer,69,,9,16,25
060 Auer,70,,17,14,31
060 Auer,71,,5,8,13
060 Auer,72,,3,16,19
060 Auer,73,,12,12,24
060 Auer,74,,8,8,16
060 Auer,75,,8,14,22
060 Auer,76,,10,8,18
060 Auer,77,,8,13,21
060 Auer,78,,4,18,22
060 Auer,79,,11,11,22
060 Auer,80,,9,10,19
060 Auer,81,,8,14,22
060 Auer,82,,2,15,17
060 Auer,83,,2,11,13
060 Auer,84,,6,10,16
060 Auer,85,,2,4,6
060 Auer,86,,-,8,8
060 Auer,87,,2,3,5
060 Auer,88,,-,2,2
060 Auer,89,,-,2,2
060 Auer,90,,-,3,3
060 Auer,91,,1,7,8
060 Auer,92,,-,2,2
060 Auer,93,,-,1,1
060 Auer,94,,2,1,3
060 Auer,95,,-,1,1
061 St.Ulrich,0,,23,30,53
061 St.Ulrich,1,,25,36,61
061 St.Ulrich,2,,28,39,67
061 St.Ulrich,3,,20,26,46
061 St.Ulrich,4,,32,32,64
061 St.Ulrich,5,,45,30,75
061 St.Ulrich,6,,42,35,77
061 St.Ulrich,7,,32,29,61
061 St.Ulrich,8,,32,25,57
061 St.Ulrich,9,,31,33,64
061 St.Ulrich,10,,29,32,61
061 St.Ulrich,11,,21,28,49
061 St.Ulrich,12,,35,31,66
061 St.Ulrich,13,,31,33,64
061 St.Ulrich,14,,29,21,50
061 St.Ulrich,15,,17,22,39
061 St.Ulrich,16,,17,22,39
061 St.Ulrich,17,,25,19,44
061 St.Ulrich,18,,20,17,37
061 St.Ulrich,19,,23,21,44
061 St.Ulrich,20,,22,18,40
061 St.Ulrich,21,,21,17,38
061 St.Ulrich,22,,25,28,53
061 St.Ulrich,23,,22,27,49
061 St.Ulrich,24,,25,34,59
061 St.Ulrich,25,,29,28,57
061 St.Ulrich,26,,23,29,52
061 St.Ulrich,27,,23,26,49
061 St.Ulrich,28,,33,36,69
061 St.Ulrich,29,,40,30,70
061 St.Ulrich,30,,38,35,73
061 St.Ulrich,31,,38,31,69
061 St.Ulrich,32,,39,36,75
061 St.Ulrich,33,,40,37,77
061 St.Ulrich,34,,44,32,76
061 St.Ulrich,35,,47,44,91
061 St.Ulrich,36,,41,45,86
061 St.Ulrich,37,,45,39,84
061 St.Ulrich,38,,37,38,75
061 St.Ulrich,39,,37,35,72
061 St.Ulrich,40,,40,42,82
061 St.Ulrich,41,,36,34,70
061 St.Ulrich,42,,33,35,68
061 St.Ulrich,43,,27,23,50
061 St.Ulrich,44,,34,26,60
061 St.Ulrich,45,,41,27,68
061 St.Ulrich,46,,22,18,40
061 St.Ulrich,47,,25,32,57
061 St.Ulrich,48,,16,27,43
061 St.Ulrich,49,,26,39,65
061 St.Ulrich,50,,27,34,61
061 St.Ulrich,51,,28,17,45
061 St.Ulrich,52,,14,24,38
061 St.Ulrich,53,,25,25,50
061 St.Ulrich,54,,20,26,46
061 St.Ulrich,55,,19,27,46
061 St.Ulrich,56,,30,30,60
061 St.Ulrich,57,,23,24,47
061 St.Ulrich,58,,32,27,59
061 St.Ulrich,59,,18,19,37
061 St.Ulrich,60,,29,32,61
061 St.Ulrich,61,,40,38,78
061 St.Ulrich,62,,31,36,67
061 St.Ulrich,63,,37,45,82
061 St.Ulrich,64,,32,28,60
061 St.Ulrich,65,,19,20,39
061 St.Ulrich,66,,24,26,50
061 St.Ulrich,67,,23,26,49
061 St.Ulrich,68,,24,17,41
061 St.Ulrich,69,,13,25,38
061 St.Ulrich,70,,18,13,31
061 St.Ulrich,71,,19,13,32
061 St.Ulrich,72,,15,23,38
061 St.Ulrich,73,,19,15,34
061 St.Ulrich,74,,20,9,29
061 St.Ulrich,75,,16,4,20
061 St.Ulrich,76,,16,13,29
061 St.Ulrich,77,,16,13,29
061 St.Ulrich,78,,8,15,23
061 St.Ulrich,79,,10,10,20
061 St.Ulrich,80,,9,20,29
061 St.Ulrich,81,,10,23,33
061 St.Ulrich,82,,6,17,23
061 St.Ulrich,83,,7,14,21
061 St.Ulrich,84,,3,18,21
061 St.Ulrich,85,,6,9,15
061 St.Ulrich,86,,5,7,12
061 St.Ulrich,87,,2,6,8
061 St.Ulrich,88,,3,6,9
061 St.Ulrich,89,,1,7,8
061 St.Ulrich,90,,6,6,12
061 St.Ulrich,91,,3,7,10
061 St.Ulrich,92,,3,4,7
061 St.Ulrich,93,,-,4,4
061 St.Ulrich,94,,2,1,3
061 St.Ulrich,95,,2,-,2
061 St.Ulrich,96,,1,1,2
061 St.Ulrich,97,,-,1,1
062 Partschins,0,,12,22,34
062 Partschins,1,,23,18,41
062 Partschins,2,,24,20,44
062 Partschins,3,,16,18,34
062 Partschins,4,,20,15,35
062 Partschins,5,,14,17,31
062 Partschins,6,,17,12,29
062 Partschins,7,,24,22,46
062 Partschins,8,,13,18,31
062 Partschins,9,,22,16,38
062 Partschins,10,,22,19,41
062 Partschins,11,,22,18,40
062 Partschins,12,,21,16,37
062 Partschins,13,,26,26,52
062 Partschins,14,,24,23,47
062 Partschins,15,,10,23,33
062 Partschins,16,,17,29,46
062 Partschins,17,,16,15,31
062 Partschins,18,,22,21,43
062 Partschins,19,,11,14,25
062 Partschins,20,,18,21,39
062 Partschins,21,,17,21,38
062 Partschins,22,,17,20,37
062 Partschins,23,,20,24,44
062 Partschins,24,,25,22,47
062 Partschins,25,,20,20,40
062 Partschins,26,,17,17,34
062 Partschins,27,,25,17,42
062 Partschins,28,,23,24,47
062 Partschins,29,,27,22,49
062 Partschins,30,,25,19,44
062 Partschins,31,,29,27,56
062 Partschins,32,,28,32,60
062 Partschins,33,,25,32,57
062 Partschins,34,,22,33,55
062 Partschins,35,,35,24,59
062 Partschins,36,,23,27,50
062 Partschins,37,,36,22,58
062 Partschins,38,,36,36,72
062 Partschins,39,,28,31,59
062 Partschins,40,,30,37,67
062 Partschins,41,,37,25,62
062 Partschins,42,,33,26,59
062 Partschins,43,,22,22,44
062 Partschins,44,,25,38,63
062 Partschins,45,,28,17,45
062 Partschins,46,,20,19,39
062 Partschins,47,,25,24,49
062 Partschins,48,,23,20,43
062 Partschins,49,,24,24,48
062 Partschins,50,,12,27,39
062 Partschins,51,,22,15,37
062 Partschins,52,,17,15,32
062 Partschins,53,,20,16,36
062 Partschins,54,,19,20,39
062 Partschins,55,,8,13,21
062 Partschins,56,,19,19,38
062 Partschins,57,,15,17,32
062 Partschins,58,,28,27,55
062 Partschins,59,,13,18,31
062 Partschins,60,,18,16,34
062 Partschins,61,,23,25,48
062 Partschins,62,,15,16,31
062 Partschins,63,,21,30,51
062 Partschins,64,,13,14,27
062 Partschins,65,,11,16,27
062 Partschins,66,,18,13,31
062 Partschins,67,,14,17,31
062 Partschins,68,,14,17,31
062 Partschins,69,,11,11,22
062 Partschins,70,,9,17,26
062 Partschins,71,,12,16,28
062 Partschins,72,,14,11,25
062 Partschins,73,,13,21,34
062 Partschins,74,,11,10,21
062 Partschins,75,,12,8,20
062 Partschins,76,,10,12,22
062 Partschins,77,,11,12,23
062 Partschins,78,,8,8,16
062 Partschins,79,,6,11,17
062 Partschins,80,,4,13,17
062 Partschins,81,,6,9,15
062 Partschins,82,,4,8,12
062 Partschins,83,,14,7,21
062 Partschins,84,,3,6,9
062 Partschins,85,,3,5,8
062 Partschins,86,,2,2,4
062 Partschins,87,,1,4,5
062 Partschins,88,,1,4,5
062 Partschins,89,,1,1,2
062 Partschins,90,,2,5,7
062 Partschins,91,,1,3,4
062 Partschins,92,,-,3,3
062 Partschins,93,,-,1,1
062 Partschins,94,,-,1,1
062 Partschins,97,,-,1,1
062 Partschins,99,,-,1,1
063 Percha,0,,10,14,24
063 Percha,1,,9,4,13
063 Percha,2,,12,6,18
063 Percha,3,,4,4,8
063 Percha,4,,12,11,23
063 Percha,5,,5,7,12
063 Percha,6,,8,8,16
063 Percha,7,,10,16,26
063 Percha,8,,9,4,13
063 Percha,9,,8,9,17
063 Percha,10,,9,12,21
063 Percha,11,,7,9,16
063 Percha,12,,12,6,18
063 Percha,13,,10,9,19
063 Percha,14,,8,6,14
063 Percha,15,,6,8,14
063 Percha,16,,6,4,10
063 Percha,17,,9,18,27
063 Percha,18,,6,7,13
063 Percha,19,,8,13,21
063 Percha,20,,17,9,26
063 Percha,21,,14,9,23
063 Percha,22,,6,10,16
063 Percha,23,,9,6,15
063 Percha,24,,11,5,16
063 Percha,25,,4,13,17
063 Percha,26,,9,12,21
063 Percha,27,,8,10,18
063 Percha,28,,13,11,24
063 Percha,29,,9,9,18
063 Percha,30,,8,13,21
063 Percha,31,,11,9,20
063 Percha,32,,14,9,23
063 Percha,33,,19,13,32
063 Percha,34,,7,11,18
063 Percha,35,,17,16,33
063 Percha,36,,16,12,28
063 Percha,37,,7,11,18
063 Percha,38,,17,6,23
063 Percha,39,,15,24,39
063 Percha,40,,15,7,22
063 Percha,41,,11,17,28
063 Percha,42,,14,10,24
063 Percha,43,,11,11,22
063 Percha,44,,10,6,16
063 Percha,45,,7,9,16
063 Percha,46,,9,8,17
063 Percha,47,,10,5,15
063 Percha,48,,7,12,19
063 Percha,49,,11,11,22
063 Percha,50,,4,4,8
063 Percha,51,,8,6,14
063 Percha,52,,4,8,12
063 Percha,53,,7,7,14
063 Percha,54,,6,8,14
063 Percha,55,,10,6,16
063 Percha,56,,4,4,8
063 Percha,57,,6,6,12
063 Percha,58,,6,8,14
063 Percha,59,,8,5,13
063 Percha,60,,13,4,17
063 Percha,61,,8,7,15
063 Percha,62,,8,7,15
063 Percha,63,,7,6,13
063 Percha,64,,5,5,10
063 Percha,65,,6,5,11
063 Percha,66,,5,9,14
063 Percha,67,,1,5,6
063 Percha,68,,3,3,6
063 Percha,69,,4,4,8
063 Percha,70,,8,6,14
063 Percha,71,,4,5,9
063 Percha,72,,5,3,8
063 Percha,73,,6,1,7
063 Percha,74,,9,3,12
063 Percha,75,,3,5,8
063 Percha,76,,2,4,6
063 Percha,77,,4,3,7
063 Percha,78,,2,6,8
063 Percha,79,,3,5,8
063 Percha,80,,1,3,4
063 Percha,81,,1,4,5
063 Percha,82,,2,1,3
063 Percha,83,,-,2,2
063 Percha,84,,-,1,1
063 Percha,86,,-,1,1
063 Percha,90,,-,3,3
063 Percha,92,,-,1,1
064 Plaus,0,,6,1,7
064 Plaus,1,,4,1,5
064 Plaus,2,,5,5,10
064 Plaus,3,,8,3,11
064 Plaus,4,,10,3,13
064 Plaus,5,,11,5,16
064 Plaus,6,,4,7,11
064 Plaus,7,,6,5,11
064 Plaus,8,,4,2,6
064 Plaus,9,,2,2,4
064 Plaus,10,,4,1,5
064 Plaus,11,,9,3,12
064 Plaus,12,,7,7,14
064 Plaus,13,,3,10,13
064 Plaus,14,,4,3,7
064 Plaus,15,,5,7,12
064 Plaus,16,,4,2,6
064 Plaus,17,,4,2,6
064 Plaus,18,,-,4,4
064 Plaus,19,,2,5,7
064 Plaus,20,,5,1,6
064 Plaus,21,,1,2,3
064 Plaus,22,,-,3,3
064 Plaus,23,,2,7,9
064 Plaus,24,,1,3,4
064 Plaus,25,,3,6,9
064 Plaus,26,,4,4,8
064 Plaus,27,,2,5,7
064 Plaus,28,,4,3,7
064 Plaus,29,,10,3,13
064 Plaus,30,,5,7,12
064 Plaus,31,,9,6,15
064 Plaus,32,,5,3,8
064 Plaus,33,,4,5,9
064 Plaus,34,,9,4,13
064 Plaus,35,,7,9,16
064 Plaus,36,,3,7,10
064 Plaus,37,,8,10,18
064 Plaus,38,,5,6,11
064 Plaus,39,,15,2,17
064 Plaus,40,,6,8,14
064 Plaus,41,,2,5,7
064 Plaus,42,,6,5,11
064 Plaus,43,,7,3,10
064 Plaus,44,,3,6,9
064 Plaus,45,,7,2,9
064 Plaus,46,,3,3,6
064 Plaus,47,,2,2,4
064 Plaus,48,,2,1,3
064 Plaus,49,,4,4,8
064 Plaus,50,,2,1,3
064 Plaus,51,,2,4,6
064 Plaus,52,,5,2,7
064 Plaus,53,,5,3,8
064 Plaus,54,,1,2,3
064 Plaus,55,,4,2,6
064 Plaus,56,,1,3,4
064 Plaus,57,,2,5,7
064 Plaus,58,,5,2,7
064 Plaus,59,,4,1,5
064 Plaus,60,,2,3,5
064 Plaus,61,,4,1,5
064 Plaus,62,,-,4,4
064 Plaus,63,,3,4,7
064 Plaus,64,,3,1,4
064 Plaus,65,,3,2,5
064 Plaus,66,,1,1,2
064 Plaus,67,,2,3,5
064 Plaus,69,,2,2,4
064 Plaus,70,,4,2,6
064 Plaus,71,,1,3,4
064 Plaus,72,,1,3,4
064 Plaus,73,,1,1,2
064 Plaus,74,,-,1,1
064 Plaus,75,,1,1,2
064 Plaus,77,,1,1,2
064 Plaus,78,,1,1,2
064 Plaus,79,,1,-,1
064 Plaus,80,,-,4,4
064 Plaus,81,,-,2,2
064 Plaus,82,,1,1,2
064 Plaus,83,,-,1,1
064 Plaus,85,,-,2,2
064 Plaus,86,,-,1,1
064 Plaus,89,,-,1,1
064 Plaus,92,,1,-,1
065 Waidbruck,0,,1,-,1
065 Waidbruck,1,,-,1,1
065 Waidbruck,2,,-,1,1
065 Waidbruck,3,,1,1,2
065 Waidbruck,4,,1,2,3
065 Waidbruck,5,,2,2,4
065 Waidbruck,7,,3,3,6
065 Waidbruck,8,,2,-,2
065 Waidbruck,9,,1,3,4
065 Waidbruck,10,,3,1,4
065 Waidbruck,11,,1,1,2
065 Waidbruck,12,,-,2,2
065 Waidbruck,13,,1,-,1
065 Waidbruck,14,,1,1,2
065 Waidbruck,15,,1,-,1
065 Waidbruck,16,,-,1,1
065 Waidbruck,17,,1,1,2
065 Waidbruck,19,,-,1,1
065 Waidbruck,20,,3,1,4
065 Waidbruck,21,,1,-,1
065 Waidbruck,23,,-,2,2
065 Waidbruck,24,,1,-,1
065 Waidbruck,25,,1,-,1
065 Waidbruck,26,,4,1,5
065 Waidbruck,27,,1,2,3
065 Waidbruck,28,,-,1,1
065 Waidbruck,29,,4,-,4
065 Waidbruck,30,,6,1,7
065 Waidbruck,31,,-,1,1
065 Waidbruck,32,,3,1,4
065 Waidbruck,33,,3,-,3
065 Waidbruck,34,,1,1,2
065 Waidbruck,35,,1,3,4
065 Waidbruck,36,,3,1,4
065 Waidbruck,37,,2,4,6
065 Waidbruck,38,,3,2,5
065 Waidbruck,39,,2,1,3
065 Waidbruck,40,,3,-,3
065 Waidbruck,41,,3,1,4
065 Waidbruck,42,,3,-,3
065 Waidbruck,43,,-,1,1
065 Waidbruck,44,,3,1,4
065 Waidbruck,45,,4,1,5
065 Waidbruck,46,,-,1,1
065 Waidbruck,47,,2,1,3
065 Waidbruck,48,,2,-,2
065 Waidbruck,49,,2,-,2
065 Waidbruck,52,,1,1,2
065 Waidbruck,53,,1,2,3
065 Waidbruck,55,,1,-,1
065 Waidbruck,58,,-,3,3
065 Waidbruck,59,,1,1,2
065 Waidbruck,60,,2,1,3
065 Waidbruck,62,,1,-,1
065 Waidbruck,63,,1,2,3
065 Waidbruck,64,,-,3,3
065 Waidbruck,65,,1,-,1
065 Waidbruck,66,,-,2,2
065 Waidbruck,67,,1,1,2
065 Waidbruck,68,,2,2,4
065 Waidbruck,69,,-,3,3
065 Waidbruck,70,,3,1,4
065 Waidbruck,71,,2,-,2
065 Waidbruck,72,,-,4,4
065 Waidbruck,73,,1,-,1
065 Waidbruck,74,,1,-,1
065 Waidbruck,75,,-,3,3
065 Waidbruck,76,,1,1,2
065 Waidbruck,77,,2,1,3
065 Waidbruck,78,,-,1,1
065 Waidbruck,79,,1,1,2
065 Waidbruck,81,,-,2,2
065 Waidbruck,82,,-,1,1
065 Waidbruck,84,,-,1,1
065 Waidbruck,85,,-,2,2
065 Waidbruck,90,,-,1,1
065 Waidbruck,94,,-,1,1
066 Burgstall,0,,13,4,17
066 Burgstall,1,,10,12,22
066 Burgstall,2,,9,9,18
066 Burgstall,3,,9,7,16
066 Burgstall,4,,10,11,21
066 Burgstall,5,,10,9,19
066 Burgstall,6,,9,10,19
066 Burgstall,7,,8,6,14
066 Burgstall,8,,5,9,14
066 Burgstall,9,,10,10,20
066 Burgstall,10,,6,5,11
066 Burgstall,11,,7,10,17
066 Burgstall,12,,4,6,10
066 Burgstall,13,,8,11,19
066 Burgstall,14,,14,8,22
066 Burgstall,15,,10,3,13
066 Burgstall,16,,7,7,14
066 Burgstall,17,,10,9,19
066 Burgstall,18,,10,4,14
066 Burgstall,19,,6,11,17
066 Burgstall,20,,10,12,22
066 Burgstall,21,,6,10,16
066 Burgstall,22,,13,8,21
066 Burgstall,23,,5,7,12
066 Burgstall,24,,10,11,21
066 Burgstall,25,,5,6,11
066 Burgstall,26,,9,9,18
066 Burgstall,27,,8,17,25
066 Burgstall,28,,9,7,16
066 Burgstall,29,,15,13,28
066 Burgstall,30,,9,11,20
066 Burgstall,31,,14,15,29
066 Burgstall,32,,7,20,27
066 Burgstall,33,,16,11,27
066 Burgstall,34,,16,9,25
066 Burgstall,35,,16,9,25
066 Burgstall,36,,15,19,34
066 Burgstall,37,,11,15,26
066 Burgstall,38,,13,19,32
066 Burgstall,39,,20,19,39
066 Burgstall,40,,16,12,28
066 Burgstall,41,,16,15,31
066 Burgstall,42,,18,14,32
066 Burgstall,43,,9,15,24
066 Burgstall,44,,15,10,25
066 Burgstall,45,,10,9,19
066 Burgstall,46,,16,8,24
066 Burgstall,47,,10,9,19
066 Burgstall,48,,14,11,25
066 Burgstall,49,,7,12,19
066 Burgstall,50,,10,16,26
066 Burgstall,51,,8,10,18
066 Burgstall,52,,12,16,28
066 Burgstall,53,,14,7,21
066 Burgstall,54,,10,12,22
066 Burgstall,55,,8,6,14
066 Burgstall,56,,7,13,20
066 Burgstall,57,,7,9,16
066 Burgstall,58,,13,8,21
066 Burgstall,59,,8,9,17
066 Burgstall,60,,12,10,22
066 Burgstall,61,,11,9,20
066 Burgstall,62,,5,6,11
066 Burgstall,63,,8,4,12
066 Burgstall,64,,5,12,17
066 Burgstall,65,,7,9,16
066 Burgstall,66,,10,14,24
066 Burgstall,67,,4,9,13
066 Burgstall,68,,5,5,10
066 Burgstall,69,,7,4,11
066 Burgstall,70,,9,8,17
066 Burgstall,71,,8,4,12
066 Burgstall,72,,2,8,10
066 Burgstall,73,,6,3,9
066 Burgstall,74,,5,7,12
066 Burgstall,75,,1,4,5
066 Burgstall,76,,5,7,12
066 Burgstall,77,,2,12,14
066 Burgstall,78,,4,9,13
066 Burgstall,79,,6,5,11
066 Burgstall,80,,1,6,7
066 Burgstall,81,,5,3,8
066 Burgstall,82,,4,6,10
066 Burgstall,83,,1,-,1
066 Burgstall,84,,1,3,4
066 Burgstall,85,,1,3,4
066 Burgstall,86,,-,1,1
066 Burgstall,87,,1,-,1
066 Burgstall,88,,-,2,2
066 Burgstall,89,,1,4,5
066 Burgstall,90,,-,3,3
066 Burgstall,91,,-,1,1
066 Burgstall,92,,-,1,1
066 Burgstall,93,,-,1,1
066 Burgstall,94,,-,1,1
066 Burgstall,95,,-,1,1
066 Burgstall,97,,1,-,1
067 Prad am Stilfser Joch,0,,19,21,40
067 Prad am Stilfser Joch,1,,15,10,25
067 Prad am Stilfser Joch,2,,12,14,26
067 Prad am Stilfser Joch,3,,23,15,38
067 Prad am Stilfser Joch,4,,18,15,33
067 Prad am Stilfser Joch,5,,16,17,33
067 Prad am Stilfser Joch,6,,20,21,41
067 Prad am Stilfser Joch,7,,23,16,39
067 Prad am Stilfser Joch,8,,22,19,41
067 Prad am Stilfser Joch,9,,20,12,32
067 Prad am Stilfser Joch,10,,20,26,46
067 Prad am Stilfser Joch,11,,22,29,51
067 Prad am Stilfser Joch,12,,17,20,37
067 Prad am Stilfser Joch,13,,20,11,31
067 Prad am Stilfser Joch,14,,19,22,41
067 Prad am Stilfser Joch,15,,20,23,43
067 Prad am Stilfser Joch,16,,32,17,49
067 Prad am Stilfser Joch,17,,13,18,31
067 Prad am Stilfser Joch,18,,29,29,58
067 Prad am Stilfser Joch,19,,29,21,50
067 Prad am Stilfser Joch,20,,29,28,57
067 Prad am Stilfser Joch,21,,29,25,54
067 Prad am Stilfser Joch,22,,28,25,53
067 Prad am Stilfser Joch,23,,22,22,44
067 Prad am Stilfser Joch,24,,28,19,47
067 Prad am Stilfser Joch,25,,20,13,33
067 Prad am Stilfser Joch,26,,24,17,41
067 Prad am Stilfser Joch,27,,16,37,53
067 Prad am Stilfser Joch,28,,22,23,45
067 Prad am Stilfser Joch,29,,20,18,38
067 Prad am Stilfser Joch,30,,30,14,44
067 Prad am Stilfser Joch,31,,25,37,62
067 Prad am Stilfser Joch,32,,27,24,51
067 Prad am Stilfser Joch,33,,27,19,46
067 Prad am Stilfser Joch,34,,27,22,49
067 Prad am Stilfser Joch,35,,25,26,51
067 Prad am Stilfser Joch,36,,34,33,67
067 Prad am Stilfser Joch,37,,20,25,45
067 Prad am Stilfser Joch,38,,38,29,67
067 Prad am Stilfser Joch,39,,31,23,54
067 Prad am Stilfser Joch,40,,26,27,53
067 Prad am Stilfser Joch,41,,25,10,35
067 Prad am Stilfser Joch,42,,27,29,56
067 Prad am Stilfser Joch,43,,20,28,48
067 Prad am Stilfser Joch,44,,18,23,41
067 Prad am Stilfser Joch,45,,33,13,46
067 Prad am Stilfser Joch,46,,22,29,51
067 Prad am Stilfser Joch,47,,27,26,53
067 Prad am Stilfser Joch,48,,24,24,48
067 Prad am Stilfser Joch,49,,27,17,44
067 Prad am Stilfser Joch,50,,28,17,45
067 Prad am Stilfser Joch,51,,26,18,44
067 Prad am Stilfser Joch,52,,15,19,34
067 Prad am Stilfser Joch,53,,20,21,41
067 Prad am Stilfser Joch,54,,21,17,38
067 Prad am Stilfser Joch,55,,21,19,40
067 Prad am Stilfser Joch,56,,19,10,29
067 Prad am Stilfser Joch,57,,16,12,28
067 Prad am Stilfser Joch,58,,17,14,31
067 Prad am Stilfser Joch,59,,16,10,26
067 Prad am Stilfser Joch,60,,10,16,26
067 Prad am Stilfser Joch,61,,25,17,42
067 Prad am Stilfser Joch,62,,16,16,32
067 Prad am Stilfser Joch,63,,23,9,32
067 Prad am Stilfser Joch,64,,11,16,27
067 Prad am Stilfser Joch,65,,13,14,27
067 Prad am Stilfser Joch,66,,17,13,30
067 Prad am Stilfser Joch,67,,9,12,21
067 Prad am Stilfser Joch,68,,12,10,22
067 Prad am Stilfser Joch,69,,16,13,29
067 Prad am Stilfser Joch,70,,8,21,29
067 Prad am Stilfser Joch,71,,12,11,23
067 Prad am Stilfser Joch,72,,11,18,29
067 Prad am Stilfser Joch,73,,7,14,21
067 Prad am Stilfser Joch,74,,12,13,25
067 Prad am Stilfser Joch,75,,9,13,22
067 Prad am Stilfser Joch,76,,6,9,15
067 Prad am Stilfser Joch,77,,6,11,17
067 Prad am Stilfser Joch,78,,9,12,21
067 Prad am Stilfser Joch,79,,9,7,16
067 Prad am Stilfser Joch,80,,2,10,12
067 Prad am Stilfser Joch,81,,2,10,12
067 Prad am Stilfser Joch,82,,5,13,18
067 Prad am Stilfser Joch,83,,5,7,12
067 Prad am Stilfser Joch,84,,4,5,9
067 Prad am Stilfser Joch,85,,5,5,10
067 Prad am Stilfser Joch,86,,1,3,4
067 Prad am Stilfser Joch,87,,-,4,4
067 Prad am Stilfser Joch,88,,-,4,4
067 Prad am Stilfser Joch,89,,2,-,2
067 Prad am Stilfser Joch,90,,1,4,5
067 Prad am Stilfser Joch,91,,-,1,1
067 Prad am Stilfser Joch,92,,3,3,6
067 Prad am Stilfser Joch,93,,-,2,2
067 Prad am Stilfser Joch,94,,-,4,4
067 Prad am Stilfser Joch,96,,-,1,1
068 Prettau,0,,5,5,10
068 Prettau,1,,2,4,6
068 Prettau,2,,1,3,4
068 Prettau,3,,3,4,7
068 Prettau,4,,2,4,6
068 Prettau,5,,6,6,12
068 Prettau,6,,6,4,10
068 Prettau,7,,3,5,8
068 Prettau,8,,1,2,3
068 Prettau,9,,6,4,10
068 Prettau,10,,5,7,12
068 Prettau,11,,4,7,11
068 Prettau,12,,3,3,6
068 Prettau,13,,1,4,5
068 Prettau,14,,1,7,8
068 Prettau,15,,-,3,3
068 Prettau,16,,5,3,8
068 Prettau,17,,5,1,6
068 Prettau,18,,2,2,4
068 Prettau,19,,2,1,3
068 Prettau,20,,3,6,9
068 Prettau,21,,4,2,6
068 Prettau,22,,2,1,3
068 Prettau,23,,2,1,3
068 Prettau,24,,4,4,8
068 Prettau,25,,5,3,8
068 Prettau,26,,1,1,2
068 Prettau,27,,4,3,7
068 Prettau,28,,2,1,3
068 Prettau,29,,4,2,6
068 Prettau,30,,5,1,6
068 Prettau,31,,5,6,11
068 Prettau,32,,9,4,13
068 Prettau,33,,4,6,10
068 Prettau,34,,3,6,9
068 Prettau,35,,7,7,14
068 Prettau,36,,4,3,7
068 Prettau,37,,10,4,14
068 Prettau,38,,6,1,7
068 Prettau,39,,5,11,16
068 Prettau,40,,8,6,14
068 Prettau,41,,5,5,10
068 Prettau,42,,2,5,7
068 Prettau,43,,5,5,10
068 Prettau,44,,8,4,12
068 Prettau,45,,5,2,7
068 Prettau,46,,7,-,7
068 Prettau,47,,4,1,5
068 Prettau,48,,6,5,11
068 Prettau,49,,6,5,11
068 Prettau,50,,5,2,7
068 Prettau,51,,3,3,6
068 Prettau,52,,4,3,7
068 Prettau,53,,3,2,5
068 Prettau,54,,2,2,4
068 Prettau,55,,2,3,5
068 Prettau,56,,2,2,4
068 Prettau,57,,4,5,9
068 Prettau,58,,8,4,12
068 Prettau,59,,1,3,4
068 Prettau,60,,6,5,11
068 Prettau,61,,3,2,5
068 Prettau,62,,3,2,5
068 Prettau,63,,3,3,6
068 Prettau,64,,4,5,9
068 Prettau,65,,4,3,7
068 Prettau,66,,5,7,12
068 Prettau,67,,2,6,8
068 Prettau,68,,3,3,6
068 Prettau,69,,6,3,9
068 Prettau,70,,1,3,4
068 Prettau,71,,3,3,6
068 Prettau,72,,3,-,3
068 Prettau,73,,2,1,3
068 Prettau,74,,5,4,9
068 Prettau,75,,4,5,9
068 Prettau,76,,-,2,2
068 Prettau,77,,3,1,4
068 Prettau,78,,1,7,8
068 Prettau,79,,1,2,3
068 Prettau,80,,1,1,2
068 Prettau,81,,-,4,4
068 Prettau,82,,2,-,2
068 Prettau,83,,1,2,3
068 Prettau,84,,1,2,3
068 Prettau,85,,2,-,2
068 Prettau,86,,1,1,2
068 Prettau,87,,1,-,1
068 Prettau,88,,2,2,4
068 Prettau,90,,-,1,1
068 Prettau,91,,-,2,2
068 Prettau,92,,-,2,2
068 Prettau,98,,-,1,1
068 Prettau,99,,-,1,1
069 Proveis,0,,1,2,3
069 Proveis,1,,1,1,2
069 Proveis,2,,4,-,4
069 Proveis,3,,3,1,4
069 Proveis,4,,-,1,1
069 Proveis,5,,4,-,4
069 Proveis,6,,2,2,4
069 Proveis,7,,1,2,3
069 Proveis,8,,1,1,2
069 Proveis,9,,-,5,5
069 Proveis,10,,2,-,2
069 Proveis,11,,2,1,3
069 Proveis,12,,3,1,4
069 Proveis,13,,3,2,5
069 Proveis,14,,-,1,1
069 Proveis,15,,1,1,2
069 Proveis,16,,2,3,5
069 Proveis,17,,2,2,4
069 Proveis,18,,3,1,4
069 Proveis,19,,5,-,5
069 Proveis,20,,3,3,6
069 Proveis,21,,3,3,6
069 Proveis,22,,2,-,2
069 Proveis,23,,2,3,5
069 Proveis,25,,3,1,4
069 Proveis,26,,2,2,4
069 Proveis,27,,2,2,4
069 Proveis,28,,2,2,4
069 Proveis,29,,2,1,3
069 Proveis,30,,5,2,7
069 Proveis,31,,2,-,2
069 Proveis,32,,1,2,3
069 Proveis,33,,-,1,1
069 Proveis,34,,3,3,6
069 Proveis,35,,3,4,7
069 Proveis,36,,5,1,6
069 Proveis,37,,2,1,3
069 Proveis,38,,2,2,4
069 Proveis,39,,1,1,2
069 Proveis,40,,3,-,3
069 Proveis,41,,4,2,6
069 Proveis,42,,4,2,6
069 Proveis,43,,3,1,4
069 Proveis,44,,-,4,4
069 Proveis,45,,4,-,4
069 Proveis,46,,1,3,4
069 Proveis,47,,2,2,4
069 Proveis,48,,4,1,5
069 Proveis,49,,4,4,8
069 Proveis,50,,3,2,5
069 Proveis,51,,1,1,2
069 Proveis,52,,2,3,5
069 Proveis,53,,2,-,2
069 Proveis,54,,1,1,2
069 Proveis,55,,1,-,1
069 Proveis,56,,2,1,3
069 Proveis,57,,2,2,4
069 Proveis,58,,3,-,3
069 Proveis,59,,1,1,2
069 Proveis,60,,2,-,2
069 Proveis,61,,2,1,3
069 Proveis,62,,1,1,2
069 Proveis,63,,1,1,2
069 Proveis,64,,3,-,3
069 Proveis,65,,1,3,4
069 Proveis,66,,-,2,2
069 Proveis,67,,2,1,3
069 Proveis,68,,2,1,3
069 Proveis,69,,1,1,2
069 Proveis,70,,-,1,1
069 Proveis,71,,-,2,2
069 Proveis,72,,1,1,2
069 Proveis,73,,2,1,3
069 Proveis,75,,3,3,6
069 Proveis,76,,3,1,4
069 Proveis,77,,-,1,1
069 Proveis,79,,-,1,1
069 Proveis,80,,2,-,2
069 Proveis,82,,-,2,2
069 Proveis,83,,-,4,4
069 Proveis,84,,-,1,1
070 Ratschings,0,,33,21,54
070 Ratschings,1,,29,21,50
070 Ratschings,2,,15,27,42
070 Ratschings,3,,26,31,57
070 Ratschings,4,,35,23,58
070 Ratschings,5,,26,20,46
070 Ratschings,6,,33,22,55
070 Ratschings,7,,37,37,74
070 Ratschings,8,,30,34,64
070 Ratschings,9,,30,25,55
070 Ratschings,10,,22,28,50
070 Ratschings,11,,25,21,46
070 Ratschings,12,,39,31,70
070 Ratschings,13,,24,21,45
070 Ratschings,14,,32,27,59
070 Ratschings,15,,26,18,44
070 Ratschings,16,,35,30,65
070 Ratschings,17,,29,31,60
070 Ratschings,18,,29,27,56
070 Ratschings,19,,28,34,62
070 Ratschings,20,,24,19,43
070 Ratschings,21,,29,19,48
070 Ratschings,22,,35,24,59
070 Ratschings,23,,27,30,57
070 Ratschings,24,,23,20,43
070 Ratschings,25,,34,23,57
070 Ratschings,26,,33,20,53
070 Ratschings,27,,35,17,52
070 Ratschings,28,,22,27,49
070 Ratschings,29,,32,29,61
070 Ratschings,30,,38,27,65
070 Ratschings,31,,29,35,64
070 Ratschings,32,,36,35,71
070 Ratschings,33,,39,39,78
070 Ratschings,34,,30,39,69
070 Ratschings,35,,36,43,79
070 Ratschings,36,,48,38,86
070 Ratschings,37,,38,40,78
070 Ratschings,38,,44,45,89
070 Ratschings,39,,36,47,83
070 Ratschings,40,,49,36,85
070 Ratschings,41,,45,28,73
070 Ratschings,42,,36,40,76
070 Ratschings,43,,33,28,61
070 Ratschings,44,,40,24,64
070 Ratschings,45,,41,25,66
070 Ratschings,46,,30,23,53
070 Ratschings,47,,34,17,51
070 Ratschings,48,,35,19,54
070 Ratschings,49,,14,32,46
070 Ratschings,50,,27,15,42
070 Ratschings,51,,21,25,46
070 Ratschings,52,,22,19,41
070 Ratschings,53,,16,15,31
070 Ratschings,54,,25,20,45
070 Ratschings,55,,24,23,47
070 Ratschings,56,,30,19,49
070 Ratschings,57,,18,15,33
070 Ratschings,58,,23,7,30
070 Ratschings,59,,18,19,37
070 Ratschings,60,,16,11,27
070 Ratschings,61,,16,12,28
070 Ratschings,62,,19,18,37
070 Ratschings,63,,24,20,44
070 Ratschings,64,,17,16,33
070 Ratschings,65,,18,17,35
070 Ratschings,66,,14,20,34
070 Ratschings,67,,19,9,28
070 Ratschings,68,,14,12,26
070 Ratschings,69,,13,18,31
070 Ratschings,70,,12,9,21
070 Ratschings,71,,16,19,35
070 Ratschings,72,,15,13,28
070 Ratschings,73,,11,11,22
070 Ratschings,74,,12,16,28
070 Ratschings,75,,7,21,28
070 Ratschings,76,,9,12,21
070 Ratschings,77,,13,12,25
070 Ratschings,78,,10,13,23
070 Ratschings,79,,11,9,20
070 Ratschings,80,,9,12,21
070 Ratschings,81,,6,10,16
070 Ratschings,82,,3,9,12
070 Ratschings,83,,4,10,14
070 Ratschings,84,,2,11,13
070 Ratschings,85,,1,2,3
070 Ratschings,86,,-,6,6
070 Ratschings,88,,2,1,3
070 Ratschings,89,,2,3,5
070 Ratschings,90,,-,4,4
070 Ratschings,91,,2,-,2
070 Ratschings,92,,1,-,1
070 Ratschings,96,,-,1,1
071 Rasen-Antholz,0,,12,16,28
071 Rasen-Antholz,1,,10,24,34
071 Rasen-Antholz,2,,15,24,39
071 Rasen-Antholz,3,,17,21,38
071 Rasen-Antholz,4,,25,22,47
071 Rasen-Antholz,5,,14,18,32
071 Rasen-Antholz,6,,19,13,32
071 Rasen-Antholz,7,,27,19,46
071 Rasen-Antholz,8,,26,16,42
071 Rasen-Antholz,9,,10,14,24
071 Rasen-Antholz,10,,21,11,32
071 Rasen-Antholz,11,,19,14,33
071 Rasen-Antholz,12,,26,19,45
071 Rasen-Antholz,13,,14,14,28
071 Rasen-Antholz,14,,14,27,41
071 Rasen-Antholz,15,,18,17,35
071 Rasen-Antholz,16,,20,18,38
071 Rasen-Antholz,17,,26,9,35
071 Rasen-Antholz,18,,17,20,37
071 Rasen-Antholz,19,,24,13,37
071 Rasen-Antholz,20,,18,18,36
071 Rasen-Antholz,21,,14,20,34
071 Rasen-Antholz,22,,22,24,46
071 Rasen-Antholz,23,,16,16,32
071 Rasen-Antholz,24,,18,13,31
071 Rasen-Antholz,25,,17,19,36
071 Rasen-Antholz,26,,17,18,35
071 Rasen-Antholz,27,,16,16,32
071 Rasen-Antholz,28,,21,19,40
071 Rasen-Antholz,29,,23,27,50
071 Rasen-Antholz,30,,26,21,47
071 Rasen-Antholz,31,,31,22,53
071 Rasen-Antholz,32,,26,20,46
071 Rasen-Antholz,33,,25,25,50
071 Rasen-Antholz,34,,23,25,48
071 Rasen-Antholz,35,,28,26,54
071 Rasen-Antholz,36,,26,26,52
071 Rasen-Antholz,37,,27,28,55
071 Rasen-Antholz,38,,29,18,47
071 Rasen-Antholz,39,,34,25,59
071 Rasen-Antholz,40,,28,24,52
071 Rasen-Antholz,41,,21,22,43
071 Rasen-Antholz,42,,27,21,48
071 Rasen-Antholz,43,,18,25,43
071 Rasen-Antholz,44,,21,23,44
071 Rasen-Antholz,45,,25,19,44
071 Rasen-Antholz,46,,22,16,38
071 Rasen-Antholz,47,,22,11,33
071 Rasen-Antholz,48,,18,14,32
071 Rasen-Antholz,49,,18,14,32
071 Rasen-Antholz,50,,14,13,27
071 Rasen-Antholz,51,,17,10,27
071 Rasen-Antholz,52,,12,15,27
071 Rasen-Antholz,53,,12,12,24
071 Rasen-Antholz,54,,15,8,23
071 Rasen-Antholz,55,,14,8,22
071 Rasen-Antholz,56,,14,9,23
071 Rasen-Antholz,57,,9,14,23
071 Rasen-Antholz,58,,10,14,24
071 Rasen-Antholz,59,,11,10,21
071 Rasen-Antholz,60,,10,8,18
071 Rasen-Antholz,61,,13,13,26
071 Rasen-Antholz,62,,11,15,26
071 Rasen-Antholz,63,,15,12,27
071 Rasen-Antholz,64,,10,17,27
071 Rasen-Antholz,65,,17,13,30
071 Rasen-Antholz,66,,13,8,21
071 Rasen-Antholz,67,,10,11,21
071 Rasen-Antholz,68,,9,12,21
071 Rasen-Antholz,69,,10,8,18
071 Rasen-Antholz,70,,12,10,22
071 Rasen-Antholz,71,,10,15,25
071 Rasen-Antholz,72,,15,11,26
071 Rasen-Antholz,73,,14,15,29
071 Rasen-Antholz,74,,4,11,15
071 Rasen-Antholz,75,,11,4,15
071 Rasen-Antholz,76,,4,3,7
071 Rasen-Antholz,77,,9,9,18
071 Rasen-Antholz,78,,6,6,12
071 Rasen-Antholz,79,,7,12,19
071 Rasen-Antholz,80,,6,11,17
071 Rasen-Antholz,81,,1,10,11
071 Rasen-Antholz,82,,4,6,10
071 Rasen-Antholz,83,,5,5,10
071 Rasen-Antholz,84,,2,6,8
071 Rasen-Antholz,85,,1,4,5
071 Rasen-Antholz,86,,-,3,3
071 Rasen-Antholz,87,,2,3,5
071 Rasen-Antholz,88,,-,2,2
071 Rasen-Antholz,89,,3,2,5
071 Rasen-Antholz,90,,1,1,2
071 Rasen-Antholz,91,,-,2,2
071 Rasen-Antholz,92,,1,1,2
071 Rasen-Antholz,93,,-,1,1
071 Rasen-Antholz,94,,-,1,1
071 Rasen-Antholz,95,,-,1,1
071 Rasen-Antholz,99,,-,1,1
072 Ritten,0,,49,46,95
072 Ritten,1,,45,37,82
072 Ritten,2,,34,48,82
072 Ritten,3,,53,44,97
072 Ritten,4,,43,44,87
072 Ritten,5,,53,53,106
072 Ritten,6,,39,45,84
072 Ritten,7,,57,54,111
072 Ritten,8,,38,50,88
072 Ritten,9,,55,43,98
072 Ritten,10,,60,47,107
072 Ritten,11,,56,50,106
072 Ritten,12,,46,72,118
072 Ritten,13,,61,50,111
072 Ritten,14,,60,45,105
072 Ritten,15,,51,43,94
072 Ritten,16,,58,54,112
072 Ritten,17,,49,40,89
072 Ritten,18,,49,42,91
072 Ritten,19,,44,47,91
072 Ritten,20,,46,26,72
072 Ritten,21,,51,44,95
072 Ritten,22,,40,49,89
072 Ritten,23,,47,51,98
072 Ritten,24,,44,38,82
072 Ritten,25,,51,42,93
072 Ritten,26,,46,36,82
072 Ritten,27,,59,40,99
072 Ritten,28,,45,46,91
072 Ritten,29,,61,41,102
072 Ritten,30,,64,60,124
072 Ritten,31,,65,45,110
072 Ritten,32,,53,58,111
072 Ritten,33,,50,70,120
072 Ritten,34,,55,70,125
072 Ritten,35,,47,69,116
072 Ritten,36,,70,62,132
072 Ritten,37,,71,54,125
072 Ritten,38,,63,51,114
072 Ritten,39,,79,43,122
072 Ritten,40,,64,57,121
072 Ritten,41,,61,54,115
072 Ritten,42,,57,59,116
072 Ritten,43,,48,58,106
072 Ritten,44,,65,58,123
072 Ritten,45,,67,49,116
072 Ritten,46,,37,44,81
072 Ritten,47,,40,40,80
072 Ritten,48,,46,42,88
072 Ritten,49,,49,37,86
072 Ritten,50,,37,32,69
072 Ritten,51,,51,32,83
072 Ritten,52,,39,44,83
072 Ritten,53,,43,35,78
072 Ritten,54,,35,43,78
072 Ritten,55,,37,43,80
072 Ritten,56,,51,32,83
072 Ritten,57,,34,29,63
072 Ritten,58,,28,38,66
072 Ritten,59,,21,25,46
072 Ritten,60,,33,39,72
072 Ritten,61,,35,37,72
072 Ritten,62,,45,34,79
072 Ritten,63,,37,38,75
072 Ritten,64,,34,24,58
072 Ritten,65,,37,32,69
072 Ritten,66,,34,33,67
072 Ritten,67,,26,26,52
072 Ritten,68,,21,24,45
072 Ritten,69,,23,30,53
072 Ritten,70,,26,28,54
072 Ritten,71,,19,26,45
072 Ritten,72,,22,24,46
072 Ritten,73,,15,32,47
072 Ritten,74,,14,21,35
072 Ritten,75,,21,20,41
072 Ritten,76,,17,12,29
072 Ritten,77,,17,19,36
072 Ritten,78,,12,19,31
072 Ritten,79,,12,33,45
072 Ritten,80,,15,28,43
072 Ritten,81,,17,26,43
072 Ritten,82,,5,21,26
072 Ritten,83,,7,18,25
072 Ritten,84,,7,18,25
072 Ritten,85,,6,13,19
072 Ritten,86,,1,6,7
072 Ritten,87,,2,8,10
072 Ritten,88,,-,2,2
072 Ritten,89,,4,5,9
072 Ritten,90,,2,6,8
072 Ritten,91,,3,7,10
072 Ritten,92,,1,2,3
072 Ritten,93,,2,1,3
072 Ritten,94,,1,2,3
072 Ritten,95,,1,-,1
072 Ritten,97,,1,1,2
072 Ritten,99,,-,1,1
073 Riffian,0,,6,4,10
073 Riffian,1,,8,2,10
073 Riffian,2,,6,5,11
073 Riffian,3,,11,8,19
073 Riffian,4,,10,8,18
073 Riffian,5,,7,11,18
073 Riffian,6,,11,9,20
073 Riffian,7,,10,8,18
073 Riffian,8,,5,6,11
073 Riffian,9,,7,10,17
073 Riffian,10,,5,8,13
073 Riffian,11,,6,6,12
073 Riffian,12,,9,9,18
073 Riffian,13,,9,13,22
073 Riffian,14,,6,7,13
073 Riffian,15,,12,5,17
073 Riffian,16,,6,11,17
073 Riffian,17,,5,8,13
073 Riffian,18,,8,6,14
073 Riffian,19,,8,3,11
073 Riffian,20,,8,7,15
073 Riffian,21,,7,8,15
073 Riffian,22,,8,11,19
073 Riffian,23,,9,8,17
073 Riffian,24,,6,5,11
073 Riffian,25,,5,8,13
073 Riffian,26,,11,6,17
073 Riffian,27,,13,12,25
073 Riffian,28,,10,2,12
073 Riffian,29,,8,10,18
073 Riffian,30,,9,5,14
073 Riffian,31,,8,8,16
073 Riffian,32,,9,21,30
073 Riffian,33,,13,15,28
073 Riffian,34,,7,8,15
073 Riffian,35,,10,13,23
073 Riffian,36,,8,14,22
073 Riffian,37,,12,14,26
073 Riffian,38,,12,6,18
073 Riffian,39,,10,6,16
073 Riffian,40,,10,7,17
073 Riffian,41,,15,11,26
073 Riffian,42,,10,9,19
073 Riffian,43,,9,8,17
073 Riffian,44,,14,5,19
073 Riffian,45,,7,13,20
073 Riffian,46,,7,6,13
073 Riffian,47,,7,11,18
073 Riffian,48,,10,4,14
073 Riffian,49,,4,8,12
073 Riffian,50,,11,6,17
073 Riffian,51,,9,5,14
073 Riffian,52,,7,3,10
073 Riffian,53,,5,10,15
073 Riffian,54,,3,3,6
073 Riffian,55,,6,6,12
073 Riffian,56,,7,3,10
073 Riffian,57,,3,4,7
073 Riffian,58,,2,6,8
073 Riffian,59,,6,3,9
073 Riffian,60,,7,10,17
073 Riffian,61,,7,7,14
073 Riffian,62,,12,7,19
073 Riffian,63,,7,3,10
073 Riffian,64,,4,3,7
073 Riffian,65,,4,9,13
073 Riffian,66,,10,4,14
073 Riffian,67,,4,5,9
073 Riffian,68,,3,5,8
073 Riffian,69,,-,3,3
073 Riffian,70,,1,3,4
073 Riffian,71,,5,5,10
073 Riffian,72,,2,4,6
073 Riffian,73,,5,9,14
073 Riffian,74,,4,3,7
073 Riffian,75,,2,7,9
073 Riffian,76,,3,4,7
073 Riffian,77,,4,6,10
073 Riffian,78,,4,3,7
073 Riffian,79,,4,3,7
073 Riffian,80,,4,3,7
073 Riffian,81,,3,6,9
073 Riffian,82,,1,-,1
073 Riffian,83,,1,3,4
073 Riffian,84,,-,3,3
073 Riffian,86,,1,-,1
073 Riffian,87,,-,3,3
073 Riffian,89,,1,-,1
073 Riffian,90,,1,2,3
073 Riffian,91,,-,1,1
073 Riffian,92,,-,1,1
073 Riffian,94,,1,-,1
073 Riffian,95,,-,1,1
073 Riffian,96,,-,2,2
074 Mühlbach,0,,21,16,37
074 Mühlbach,1,,24,11,35
074 Mühlbach,2,,19,18,37
074 Mühlbach,3,,12,20,32
074 Mühlbach,4,,20,17,37
074 Mühlbach,5,,19,12,31
074 Mühlbach,6,,18,15,33
074 Mühlbach,7,,16,16,32
074 Mühlbach,8,,16,18,34
074 Mühlbach,9,,14,15,29
074 Mühlbach,10,,19,14,33
074 Mühlbach,11,,17,20,37
074 Mühlbach,12,,15,23,38
074 Mühlbach,13,,14,19,33
074 Mühlbach,14,,14,14,28
074 Mühlbach,15,,15,21,36
074 Mühlbach,16,,20,17,37
074 Mühlbach,17,,22,13,35
074 Mühlbach,18,,15,9,24
074 Mühlbach,19,,17,17,34
074 Mühlbach,20,,18,23,41
074 Mühlbach,21,,19,17,36
074 Mühlbach,22,,24,25,49
074 Mühlbach,23,,22,16,38
074 Mühlbach,24,,16,15,31
074 Mühlbach,25,,18,15,33
074 Mühlbach,26,,28,23,51
074 Mühlbach,27,,22,19,41
074 Mühlbach,28,,17,23,40
074 Mühlbach,29,,17,20,37
074 Mühlbach,30,,19,18,37
074 Mühlbach,31,,20,16,36
074 Mühlbach,32,,20,20,40
074 Mühlbach,33,,26,22,48
074 Mühlbach,34,,26,14,40
074 Mühlbach,35,,26,31,57
074 Mühlbach,36,,37,19,56
074 Mühlbach,37,,22,20,42
074 Mühlbach,38,,29,17,46
074 Mühlbach,39,,19,24,43
074 Mühlbach,40,,13,21,34
074 Mühlbach,41,,23,21,44
074 Mühlbach,42,,22,16,38
074 Mühlbach,43,,25,21,46
074 Mühlbach,44,,22,14,36
074 Mühlbach,45,,21,18,39
074 Mühlbach,46,,20,12,32
074 Mühlbach,47,,16,22,38
074 Mühlbach,48,,18,22,40
074 Mühlbach,49,,21,16,37
074 Mühlbach,50,,13,21,34
074 Mühlbach,51,,19,17,36
074 Mühlbach,52,,15,20,35
074 Mühlbach,53,,12,21,33
074 Mühlbach,54,,21,17,38
074 Mühlbach,55,,15,13,28
074 Mühlbach,56,,18,13,31
074 Mühlbach,57,,10,20,30
074 Mühlbach,58,,23,11,34
074 Mühlbach,59,,10,9,19
074 Mühlbach,60,,14,12,26
074 Mühlbach,61,,12,10,22
074 Mühlbach,62,,17,14,31
074 Mühlbach,63,,19,15,34
074 Mühlbach,64,,14,10,24
074 Mühlbach,65,,13,17,30
074 Mühlbach,66,,14,8,22
074 Mühlbach,67,,5,12,17
074 Mühlbach,68,,7,7,14
074 Mühlbach,69,,8,11,19
074 Mühlbach,70,,12,13,25
074 Mühlbach,71,,9,10,19
074 Mühlbach,72,,6,10,16
074 Mühlbach,73,,6,11,17
074 Mühlbach,74,,12,7,19
074 Mühlbach,75,,7,1,8
074 Mühlbach,76,,11,18,29
074 Mühlbach,77,,5,8,13
074 Mühlbach,78,,7,8,15
074 Mühlbach,79,,5,6,11
074 Mühlbach,80,,5,7,12
074 Mühlbach,81,,5,9,14
074 Mühlbach,82,,3,11,14
074 Mühlbach,83,,3,3,6
074 Mühlbach,84,,2,7,9
074 Mühlbach,85,,2,7,9
074 Mühlbach,86,,-,3,3
074 Mühlbach,87,,1,2,3
074 Mühlbach,88,,-,1,1
074 Mühlbach,89,,-,1,1
074 Mühlbach,90,,-,3,3
074 Mühlbach,91,,1,2,3
074 Mühlbach,92,,-,1,1
074 Mühlbach,93,,-,1,1
074 Mühlbach,94,,1,1,2
074 Mühlbach,97,,-,1,1
074 Mühlbach,98,,-,1,1
074 Mühlbach,99,,-,1,1
075 Rodeneck,0,,5,3,8
075 Rodeneck,1,,8,6,14
075 Rodeneck,2,,7,2,9
075 Rodeneck,3,,9,4,13
075 Rodeneck,4,,6,15,21
075 Rodeneck,5,,8,9,17
075 Rodeneck,6,,12,6,18
075 Rodeneck,7,,10,7,17
075 Rodeneck,8,,13,9,22
075 Rodeneck,9,,4,9,13
075 Rodeneck,10,,8,10,18
075 Rodeneck,11,,7,7,14
075 Rodeneck,12,,9,10,19
075 Rodeneck,13,,6,9,15
075 Rodeneck,14,,12,8,20
075 Rodeneck,15,,7,6,13
075 Rodeneck,16,,13,8,21
075 Rodeneck,17,,6,5,11
075 Rodeneck,18,,9,11,20
075 Rodeneck,19,,12,9,21
075 Rodeneck,20,,15,10,25
075 Rodeneck,21,,11,8,19
075 Rodeneck,22,,7,5,12
075 Rodeneck,23,,10,5,15
075 Rodeneck,24,,7,12,19
075 Rodeneck,25,,8,3,11
075 Rodeneck,26,,6,8,14
075 Rodeneck,27,,7,8,15
075 Rodeneck,28,,8,7,15
075 Rodeneck,29,,9,7,16
075 Rodeneck,30,,8,4,12
075 Rodeneck,31,,14,10,24
075 Rodeneck,32,,10,9,19
075 Rodeneck,33,,14,5,19
075 Rodeneck,34,,10,11,21
075 Rodeneck,35,,15,11,26
075 Rodeneck,36,,8,11,19
075 Rodeneck,37,,11,10,21
075 Rodeneck,38,,12,9,21
075 Rodeneck,39,,9,7,16
075 Rodeneck,40,,11,11,22
075 Rodeneck,41,,9,9,18
075 Rodeneck,42,,9,12,21
075 Rodeneck,43,,10,11,21
075 Rodeneck,44,,5,10,15
075 Rodeneck,45,,11,6,17
075 Rodeneck,46,,8,5,13
075 Rodeneck,47,,6,6,12
075 Rodeneck,48,,9,4,13
075 Rodeneck,49,,7,6,13
075 Rodeneck,50,,11,3,14
075 Rodeneck,51,,4,1,5
075 Rodeneck,52,,8,5,13
075 Rodeneck,53,,4,3,7
075 Rodeneck,54,,2,7,9
075 Rodeneck,55,,3,6,9
075 Rodeneck,56,,4,7,11
075 Rodeneck,57,,6,4,10
075 Rodeneck,58,,10,7,17
075 Rodeneck,59,,-,5,5
075 Rodeneck,60,,5,5,10
075 Rodeneck,61,,3,2,5
075 Rodeneck,62,,2,7,9
075 Rodeneck,63,,10,3,13
075 Rodeneck,64,,5,4,9
075 Rodeneck,65,,3,9,12
075 Rodeneck,66,,4,3,7
075 Rodeneck,67,,2,4,6
075 Rodeneck,68,,4,5,9
075 Rodeneck,69,,5,2,7
075 Rodeneck,70,,1,11,12
075 Rodeneck,71,,3,1,4
075 Rodeneck,72,,6,5,11
075 Rodeneck,73,,4,4,8
075 Rodeneck,74,,4,5,9
075 Rodeneck,75,,7,2,9
075 Rodeneck,76,,4,4,8
075 Rodeneck,77,,3,5,8
075 Rodeneck,78,,3,4,7
075 Rodeneck,79,,2,7,9
075 Rodeneck,80,,3,5,8
075 Rodeneck,81,,2,1,3
075 Rodeneck,82,,1,3,4
075 Rodeneck,83,,2,1,3
075 Rodeneck,84,,2,2,4
075 Rodeneck,85,,4,2,6
075 Rodeneck,86,,-,3,3
075 Rodeneck,89,,1,-,1
075 Rodeneck,90,,1,-,1
075 Rodeneck,92,,1,-,1
075 Rodeneck,94,,2,-,2
076 Salurn,0,,18,15,33
076 Salurn,1,,25,19,44
076 Salurn,2,,16,14,30
076 Salurn,3,,14,12,26
076 Salurn,4,,18,16,34
076 Salurn,5,,20,12,32
076 Salurn,6,,18,23,41
076 Salurn,7,,17,13,30
076 Salurn,8,,21,23,44
076 Salurn,9,,18,9,27
076 Salurn,10,,20,20,40
076 Salurn,11,,17,14,31
076 Salurn,12,,20,17,37
076 Salurn,13,,14,15,29
076 Salurn,14,,12,14,26
076 Salurn,15,,18,19,37
076 Salurn,16,,18,21,39
076 Salurn,17,,22,15,37
076 Salurn,18,,14,19,33
076 Salurn,19,,17,16,33
076 Salurn,20,,10,14,24
076 Salurn,21,,12,19,31
076 Salurn,22,,21,20,41
076 Salurn,23,,17,21,38
076 Salurn,24,,19,22,41
076 Salurn,25,,14,16,30
076 Salurn,26,,17,18,35
076 Salurn,27,,27,21,48
076 Salurn,28,,22,21,43
076 Salurn,29,,17,24,41
076 Salurn,30,,14,18,32
076 Salurn,31,,21,27,48
076 Salurn,32,,25,25,50
076 Salurn,33,,41,23,64
076 Salurn,34,,29,26,55
076 Salurn,35,,27,26,53
076 Salurn,36,,29,21,50
076 Salurn,37,,25,24,49
076 Salurn,38,,28,25,53
076 Salurn,39,,29,29,58
076 Salurn,40,,36,28,64
076 Salurn,41,,39,25,64
076 Salurn,42,,30,26,56
076 Salurn,43,,33,34,67
076 Salurn,44,,19,29,48
076 Salurn,45,,29,31,60
076 Salurn,46,,27,19,46
076 Salurn,47,,19,23,42
076 Salurn,48,,19,12,31
076 Salurn,49,,18,20,38
076 Salurn,50,,23,18,41
076 Salurn,51,,14,14,28
076 Salurn,52,,27,20,47
076 Salurn,53,,28,20,48
076 Salurn,54,,23,16,39
076 Salurn,55,,25,13,38
076 Salurn,56,,16,21,37
076 Salurn,57,,17,19,36
076 Salurn,58,,22,16,38
076 Salurn,59,,14,10,24
076 Salurn,60,,19,19,38
076 Salurn,61,,19,17,36
076 Salurn,62,,18,18,36
076 Salurn,63,,19,16,35
076 Salurn,64,,13,10,23
076 Salurn,65,,9,11,20
076 Salurn,66,,6,10,16
076 Salurn,67,,10,12,22
076 Salurn,68,,13,21,34
076 Salurn,69,,17,17,34
076 Salurn,70,,10,7,17
076 Salurn,71,,11,7,18
076 Salurn,72,,10,18,28
076 Salurn,73,,6,11,17
076 Salurn,74,,11,12,23
076 Salurn,75,,18,12,30
076 Salurn,76,,9,22,31
076 Salurn,77,,5,19,24
076 Salurn,78,,7,15,22
076 Salurn,79,,6,21,27
076 Salurn,80,,6,15,21
076 Salurn,81,,5,10,15
076 Salurn,82,,6,18,24
076 Salurn,83,,3,12,15
076 Salurn,84,,8,12,20
076 Salurn,85,,6,11,17
076 Salurn,86,,4,5,9
076 Salurn,87,,-,4,4
076 Salurn,88,,2,6,8
076 Salurn,89,,4,5,9
076 Salurn,90,,3,3,6
076 Salurn,91,,-,5,5
076 Salurn,92,,3,4,7
076 Salurn,93,,-,2,2
076 Salurn,94,,1,2,3
076 Salurn,95,,-,1,1
076 Salurn,96,,-,2,2
077 Innichen,0,,13,13,26
077 Innichen,1,,19,18,37
077 Innichen,2,,14,18,32
077 Innichen,3,,24,21,45
077 Innichen,4,,17,14,31
077 Innichen,5,,13,15,28
077 Innichen,6,,21,13,34
077 Innichen,7,,21,16,37
077 Innichen,8,,17,17,34
077 Innichen,9,,22,12,34
077 Innichen,10,,20,17,37
077 Innichen,11,,24,21,45
077 Innichen,12,,22,16,38
077 Innichen,13,,21,27,48
077 Innichen,14,,19,14,33
077 Innichen,15,,18,22,40
077 Innichen,16,,29,19,48
077 Innichen,17,,23,20,43
077 Innichen,18,,20,17,37
077 Innichen,19,,21,21,42
077 Innichen,20,,22,20,42
077 Innichen,21,,21,16,37
077 Innichen,22,,19,24,43
077 Innichen,23,,13,22,35
077 Innichen,24,,22,15,37
077 Innichen,25,,28,27,55
077 Innichen,26,,12,17,29
077 Innichen,27,,17,22,39
077 Innichen,28,,18,23,41
077 Innichen,29,,22,10,32
077 Innichen,30,,29,20,49
077 Innichen,31,,23,27,50
077 Innichen,32,,27,24,51
077 Innichen,33,,24,16,40
077 Innichen,34,,21,30,51
077 Innichen,35,,24,25,49
077 Innichen,36,,25,29,54
077 Innichen,37,,25,27,52
077 Innichen,38,,25,30,55
077 Innichen,39,,34,29,63
077 Innichen,40,,33,31,64
077 Innichen,41,,27,28,55
077 Innichen,42,,29,24,53
077 Innichen,43,,22,26,48
077 Innichen,44,,31,18,49
077 Innichen,45,,27,26,53
077 Innichen,46,,21,25,46
077 Innichen,47,,19,25,44
077 Innichen,48,,27,15,42
077 Innichen,49,,25,19,44
077 Innichen,50,,23,12,35
077 Innichen,51,,24,16,40
077 Innichen,52,,13,26,39
077 Innichen,53,,12,17,29
077 Innichen,54,,18,21,39
077 Innichen,55,,20,16,36
077 Innichen,56,,18,11,29
077 Innichen,57,,10,14,24
077 Innichen,58,,15,15,30
077 Innichen,59,,11,8,19
077 Innichen,60,,9,13,22
077 Innichen,61,,24,8,32
077 Innichen,62,,16,18,34
077 Innichen,63,,12,19,31
077 Innichen,64,,10,24,34
077 Innichen,65,,13,12,25
077 Innichen,66,,9,10,19
077 Innichen,67,,12,11,23
077 Innichen,68,,9,18,27
077 Innichen,69,,7,19,26
077 Innichen,70,,12,12,24
077 Innichen,71,,11,10,21
077 Innichen,72,,10,16,26
077 Innichen,73,,14,20,34
077 Innichen,74,,14,11,25
077 Innichen,75,,12,15,27
077 Innichen,76,,11,18,29
077 Innichen,77,,6,12,18
077 Innichen,78,,14,12,26
077 Innichen,79,,5,22,27
077 Innichen,80,,8,5,13
077 Innichen,81,,4,12,16
077 Innichen,82,,4,12,16
077 Innichen,83,,5,12,17
077 Innichen,84,,6,12,18
077 Innichen,85,,1,4,5
077 Innichen,86,,-,3,3
077 Innichen,87,,1,3,4
077 Innichen,88,,3,4,7
077 Innichen,89,,4,4,8
077 Innichen,90,,2,2,4
077 Innichen,91,,2,3,5
077 Innichen,92,,1,5,6
077 Innichen,95,,-,1,1
077 Innichen,96,,-,2,2
077 Innichen,102,,-,1,1
079 Jenesien,0,,18,16,34
079 Jenesien,1,,15,22,37
079 Jenesien,2,,13,15,28
079 Jenesien,3,,18,23,41
079 Jenesien,4,,17,16,33
079 Jenesien,5,,25,22,47
079 Jenesien,6,,16,26,42
079 Jenesien,7,,20,19,39
079 Jenesien,8,,24,11,35
079 Jenesien,9,,27,15,42
079 Jenesien,10,,21,21,42
079 Jenesien,11,,16,19,35
079 Jenesien,12,,28,23,51
079 Jenesien,13,,19,22,41
079 Jenesien,14,,18,15,33
079 Jenesien,15,,18,13,31
079 Jenesien,16,,23,16,39
079 Jenesien,17,,15,21,36
079 Jenesien,18,,17,16,33
079 Jenesien,19,,15,6,21
079 Jenesien,20,,20,13,33
079 Jenesien,21,,18,20,38
079 Jenesien,22,,14,22,36
079 Jenesien,23,,7,19,26
079 Jenesien,24,,15,23,38
079 Jenesien,25,,20,17,37
079 Jenesien,26,,12,14,26
079 Jenesien,27,,20,21,41
079 Jenesien,28,,16,17,33
079 Jenesien,29,,13,17,30
079 Jenesien,30,,20,21,41
079 Jenesien,31,,21,27,48
079 Jenesien,32,,25,26,51
079 Jenesien,33,,29,24,53
079 Jenesien,34,,29,31,60
079 Jenesien,35,,30,19,49
079 Jenesien,36,,19,30,49
079 Jenesien,37,,16,22,38
079 Jenesien,38,,32,28,60
079 Jenesien,39,,35,29,64
079 Jenesien,40,,34,32,66
079 Jenesien,41,,26,25,51
079 Jenesien,42,,28,22,50
079 Jenesien,43,,31,21,52
079 Jenesien,44,,26,13,39
079 Jenesien,45,,24,17,41
079 Jenesien,46,,22,10,32
079 Jenesien,47,,16,18,34
079 Jenesien,48,,17,13,30
079 Jenesien,49,,10,11,21
079 Jenesien,50,,17,14,31
079 Jenesien,51,,15,11,26
079 Jenesien,52,,12,20,32
079 Jenesien,53,,11,11,22
079 Jenesien,54,,14,21,35
079 Jenesien,55,,11,12,23
079 Jenesien,56,,12,7,19
079 Jenesien,57,,14,11,25
079 Jenesien,58,,10,11,21
079 Jenesien,59,,8,13,21
079 Jenesien,60,,14,13,27
079 Jenesien,61,,18,10,28
079 Jenesien,62,,15,10,25
079 Jenesien,63,,15,20,35
079 Jenesien,64,,17,11,28
079 Jenesien,65,,15,17,32
079 Jenesien,66,,20,9,29
079 Jenesien,67,,10,16,26
079 Jenesien,68,,6,18,24
079 Jenesien,69,,6,7,13
079 Jenesien,70,,8,7,15
079 Jenesien,71,,17,13,30
079 Jenesien,72,,7,10,17
079 Jenesien,73,,9,9,18
079 Jenesien,74,,7,15,22
079 Jenesien,75,,6,15,21
079 Jenesien,76,,10,10,20
079 Jenesien,77,,7,10,17
079 Jenesien,78,,9,12,21
079 Jenesien,79,,4,13,17
079 Jenesien,80,,8,9,17
079 Jenesien,81,,6,7,13
079 Jenesien,82,,7,7,14
079 Jenesien,83,,1,5,6
079 Jenesien,84,,3,6,9
079 Jenesien,85,,1,4,5
079 Jenesien,86,,-,1,1
079 Jenesien,87,,-,1,1
079 Jenesien,88,,1,1,2
079 Jenesien,89,,-,3,3
079 Jenesien,90,,1,1,2
079 Jenesien,91,,-,3,3
079 Jenesien,92,,1,1,2
079 Jenesien,93,,-,2,2
079 Jenesien,94,,-,1,1
079 Jenesien,96,,-,1,1
080 St.Leonhard in Pass.,0,,16,21,37
080 St.Leonhard in Pass.,1,,23,14,37
080 St.Leonhard in Pass.,2,,20,21,41
080 St.Leonhard in Pass.,3,,29,12,41
080 St.Leonhard in Pass.,4,,22,19,41
080 St.Leonhard in Pass.,5,,20,21,41
080 St.Leonhard in Pass.,6,,23,19,42
080 St.Leonhard in Pass.,7,,23,18,41
080 St.Leonhard in Pass.,8,,25,20,45
080 St.Leonhard in Pass.,9,,22,11,33
080 St.Leonhard in Pass.,10,,22,19,41
080 St.Leonhard in Pass.,11,,23,22,45
080 St.Leonhard in Pass.,12,,21,19,40
080 St.Leonhard in Pass.,13,,21,18,39
080 St.Leonhard in Pass.,14,,24,21,45
080 St.Leonhard in Pass.,15,,35,30,65
080 St.Leonhard in Pass.,16,,21,29,50
080 St.Leonhard in Pass.,17,,30,24,54
080 St.Leonhard in Pass.,18,,36,32,68
080 St.Leonhard in Pass.,19,,23,26,49
080 St.Leonhard in Pass.,20,,29,21,50
080 St.Leonhard in Pass.,21,,28,24,52
080 St.Leonhard in Pass.,22,,30,22,52
080 St.Leonhard in Pass.,23,,23,28,51
080 St.Leonhard in Pass.,24,,24,35,59
080 St.Leonhard in Pass.,25,,26,24,50
080 St.Leonhard in Pass.,26,,28,25,53
080 St.Leonhard in Pass.,27,,35,21,56
080 St.Leonhard in Pass.,28,,20,18,38
080 St.Leonhard in Pass.,29,,27,11,38
080 St.Leonhard in Pass.,30,,31,32,63
080 St.Leonhard in Pass.,31,,32,29,61
080 St.Leonhard in Pass.,32,,28,24,52
080 St.Leonhard in Pass.,33,,35,22,57
080 St.Leonhard in Pass.,34,,26,25,51
080 St.Leonhard in Pass.,35,,24,24,48
080 St.Leonhard in Pass.,36,,31,21,52
080 St.Leonhard in Pass.,37,,26,27,53
080 St.Leonhard in Pass.,38,,31,32,63
080 St.Leonhard in Pass.,39,,30,30,60
080 St.Leonhard in Pass.,40,,24,30,54
080 St.Leonhard in Pass.,41,,21,26,47
080 St.Leonhard in Pass.,42,,24,29,53
080 St.Leonhard in Pass.,43,,30,21,51
080 St.Leonhard in Pass.,44,,29,18,47
080 St.Leonhard in Pass.,45,,26,28,54
080 St.Leonhard in Pass.,46,,24,20,44
080 St.Leonhard in Pass.,47,,21,27,48
080 St.Leonhard in Pass.,48,,25,18,43
080 St.Leonhard in Pass.,49,,24,18,42
080 St.Leonhard in Pass.,50,,20,15,35
080 St.Leonhard in Pass.,51,,29,25,54
080 St.Leonhard in Pass.,52,,21,26,47
080 St.Leonhard in Pass.,53,,25,16,41
080 St.Leonhard in Pass.,54,,19,15,34
080 St.Leonhard in Pass.,55,,22,11,33
080 St.Leonhard in Pass.,56,,22,13,35
080 St.Leonhard in Pass.,57,,17,16,33
080 St.Leonhard in Pass.,58,,15,19,34
080 St.Leonhard in Pass.,59,,11,11,22
080 St.Leonhard in Pass.,60,,15,13,28
080 St.Leonhard in Pass.,61,,10,24,34
080 St.Leonhard in Pass.,62,,8,15,23
080 St.Leonhard in Pass.,63,,14,15,29
080 St.Leonhard in Pass.,64,,19,13,32
080 St.Leonhard in Pass.,65,,19,18,37
080 St.Leonhard in Pass.,66,,12,13,25
080 St.Leonhard in Pass.,67,,19,9,28
080 St.Leonhard in Pass.,68,,19,11,30
080 St.Leonhard in Pass.,69,,11,14,25
080 St.Leonhard in Pass.,70,,11,15,26
080 St.Leonhard in Pass.,71,,10,14,24
080 St.Leonhard in Pass.,72,,8,12,20
080 St.Leonhard in Pass.,73,,6,14,20
080 St.Leonhard in Pass.,74,,8,11,19
080 St.Leonhard in Pass.,75,,9,8,17
080 St.Leonhard in Pass.,76,,6,14,20
080 St.Leonhard in Pass.,77,,5,15,20
080 St.Leonhard in Pass.,78,,6,13,19
080 St.Leonhard in Pass.,79,,8,9,17
080 St.Leonhard in Pass.,80,,5,11,16
080 St.Leonhard in Pass.,81,,6,13,19
080 St.Leonhard in Pass.,82,,3,7,10
080 St.Leonhard in Pass.,83,,1,7,8
080 St.Leonhard in Pass.,84,,2,9,11
080 St.Leonhard in Pass.,85,,2,3,5
080 St.Leonhard in Pass.,86,,1,3,4
080 St.Leonhard in Pass.,87,,-,5,5
080 St.Leonhard in Pass.,88,,1,-,1
080 St.Leonhard in Pass.,89,,2,4,6
080 St.Leonhard in Pass.,90,,1,6,7
080 St.Leonhard in Pass.,91,,1,2,3
080 St.Leonhard in Pass.,92,,1,4,5
080 St.Leonhard in Pass.,93,,-,2,2
080 St.Leonhard in Pass.,96,,2,-,2
080 St.Leonhard in Pass.,97,,-,1,1
081 St.Lorenzen,0,,26,18,44
081 St.Lorenzen,1,,24,16,40
081 St.Lorenzen,2,,19,21,40
081 St.Lorenzen,3,,27,18,45
081 St.Lorenzen,4,,21,28,49
081 St.Lorenzen,5,,28,26,54
081 St.Lorenzen,6,,29,29,58
081 St.Lorenzen,7,,14,30,44
081 St.Lorenzen,8,,32,28,60
081 St.Lorenzen,9,,25,14,39
081 St.Lorenzen,10,,33,20,53
081 St.Lorenzen,11,,25,31,56
081 St.Lorenzen,12,,26,22,48
081 St.Lorenzen,13,,21,14,35
081 St.Lorenzen,14,,25,20,45
081 St.Lorenzen,15,,18,17,35
081 St.Lorenzen,16,,18,26,44
081 St.Lorenzen,17,,21,23,44
081 St.Lorenzen,18,,25,20,45
081 St.Lorenzen,19,,25,21,46
081 St.Lorenzen,20,,27,25,52
081 St.Lorenzen,21,,21,19,40
081 St.Lorenzen,22,,32,20,52
081 St.Lorenzen,23,,22,20,42
081 St.Lorenzen,24,,14,20,34
081 St.Lorenzen,25,,25,26,51
081 St.Lorenzen,26,,24,23,47
081 St.Lorenzen,27,,23,21,44
081 St.Lorenzen,28,,27,18,45
081 St.Lorenzen,29,,24,26,50
081 St.Lorenzen,30,,23,31,54
081 St.Lorenzen,31,,36,28,64
081 St.Lorenzen,32,,34,33,67
081 St.Lorenzen,33,,36,26,62
081 St.Lorenzen,34,,27,26,53
081 St.Lorenzen,35,,28,32,60
081 St.Lorenzen,36,,41,38,79
081 St.Lorenzen,37,,32,40,72
081 St.Lorenzen,38,,37,33,70
081 St.Lorenzen,39,,38,22,60
081 St.Lorenzen,40,,30,24,54
081 St.Lorenzen,41,,34,31,65
081 St.Lorenzen,42,,27,34,61
081 St.Lorenzen,43,,23,38,61
081 St.Lorenzen,44,,30,19,49
081 St.Lorenzen,45,,32,27,59
081 St.Lorenzen,46,,31,34,65
081 St.Lorenzen,47,,24,26,50
081 St.Lorenzen,48,,27,28,55
081 St.Lorenzen,49,,17,18,35
081 St.Lorenzen,50,,18,19,37
081 St.Lorenzen,51,,23,16,39
081 St.Lorenzen,52,,17,10,27
081 St.Lorenzen,53,,18,17,35
081 St.Lorenzen,54,,15,18,33
081 St.Lorenzen,55,,12,22,34
081 St.Lorenzen,56,,14,14,28
081 St.Lorenzen,57,,20,10,30
081 St.Lorenzen,58,,19,11,30
081 St.Lorenzen,59,,13,18,31
081 St.Lorenzen,60,,16,15,31
081 St.Lorenzen,61,,14,16,30
081 St.Lorenzen,62,,17,24,41
081 St.Lorenzen,63,,19,17,36
081 St.Lorenzen,64,,15,12,27
081 St.Lorenzen,65,,15,18,33
081 St.Lorenzen,66,,15,15,30
081 St.Lorenzen,67,,18,16,34
081 St.Lorenzen,68,,13,15,28
081 St.Lorenzen,69,,9,14,23
081 St.Lorenzen,70,,15,13,28
081 St.Lorenzen,71,,11,12,23
081 St.Lorenzen,72,,13,12,25
081 St.Lorenzen,73,,11,15,26
081 St.Lorenzen,74,,10,9,19
081 St.Lorenzen,75,,10,17,27
081 St.Lorenzen,76,,11,17,28
081 St.Lorenzen,77,,9,8,17
081 St.Lorenzen,78,,8,10,18
081 St.Lorenzen,79,,6,15,21
081 St.Lorenzen,80,,3,10,13
081 St.Lorenzen,81,,7,12,19
081 St.Lorenzen,82,,3,4,7
081 St.Lorenzen,83,,5,5,10
081 St.Lorenzen,84,,1,5,6
081 St.Lorenzen,85,,4,6,10
081 St.Lorenzen,86,,2,5,7
081 St.Lorenzen,87,,-,3,3
081 St.Lorenzen,88,,1,-,1
081 St.Lorenzen,89,,-,2,2
081 St.Lorenzen,90,,3,2,5
081 St.Lorenzen,91,,1,1,2
081 St.Lorenzen,92,,1,-,1
081 St.Lorenzen,93,,-,1,1
082 St.Martin in Thurn,0,,21,13,34
082 St.Martin in Thurn,1,,5,6,11
082 St.Martin in Thurn,2,,17,9,26
082 St.Martin in Thurn,3,,8,13,21
082 St.Martin in Thurn,4,,8,9,17
082 St.Martin in Thurn,5,,8,20,28
082 St.Martin in Thurn,6,,11,12,23
082 St.Martin in Thurn,7,,17,12,29
082 St.Martin in Thurn,8,,24,14,38
082 St.Martin in Thurn,9,,15,11,26
082 St.Martin in Thurn,10,,15,9,24
082 St.Martin in Thurn,11,,9,9,18
082 St.Martin in Thurn,12,,18,14,32
082 St.Martin in Thurn,13,,11,11,22
082 St.Martin in Thurn,14,,6,17,23
082 St.Martin in Thurn,15,,16,15,31
082 St.Martin in Thurn,16,,8,6,14
082 St.Martin in Thurn,17,,14,12,26
082 St.Martin in Thurn,18,,13,10,23
082 St.Martin in Thurn,19,,12,14,26
082 St.Martin in Thurn,20,,8,6,14
082 St.Martin in Thurn,21,,15,10,25
082 St.Martin in Thurn,22,,15,14,29
082 St.Martin in Thurn,23,,16,8,24
082 St.Martin in Thurn,24,,9,15,24
082 St.Martin in Thurn,25,,9,13,22
082 St.Martin in Thurn,26,,17,11,28
082 St.Martin in Thurn,27,,14,10,24
082 St.Martin in Thurn,28,,12,11,23
082 St.Martin in Thurn,29,,7,11,18
082 St.Martin in Thurn,30,,6,12,18
082 St.Martin in Thurn,31,,11,11,22
082 St.Martin in Thurn,32,,13,9,22
082 St.Martin in Thurn,33,,16,14,30
082 St.Martin in Thurn,34,,14,14,28
082 St.Martin in Thurn,35,,15,15,30
082 St.Martin in Thurn,36,,14,15,29
082 St.Martin in Thurn,37,,10,10,20
082 St.Martin in Thurn,38,,15,24,39
082 St.Martin in Thurn,39,,16,20,36
082 St.Martin in Thurn,40,,11,16,27
082 St.Martin in Thurn,41,,15,13,28
082 St.Martin in Thurn,42,,16,15,31
082 St.Martin in Thurn,43,,15,21,36
082 St.Martin in Thurn,44,,14,5,19
082 St.Martin in Thurn,45,,12,10,22
082 St.Martin in Thurn,46,,12,8,20
082 St.Martin in Thurn,47,,12,9,21
082 St.Martin in Thurn,48,,7,7,14
082 St.Martin in Thurn,49,,13,9,22
082 St.Martin in Thurn,50,,8,8,16
082 St.Martin in Thurn,51,,5,12,17
082 St.Martin in Thurn,52,,3,4,7
082 St.Martin in Thurn,53,,8,8,16
082 St.Martin in Thurn,54,,11,6,17
082 St.Martin in Thurn,55,,4,7,11
082 St.Martin in Thurn,56,,10,6,16
082 St.Martin in Thurn,57,,9,6,15
082 St.Martin in Thurn,58,,9,7,16
082 St.Martin in Thurn,59,,6,4,10
082 St.Martin in Thurn,60,,11,8,19
082 St.Martin in Thurn,61,,4,8,12
082 St.Martin in Thurn,62,,7,6,13
082 St.Martin in Thurn,63,,7,7,14
082 St.Martin in Thurn,64,,5,5,10
082 St.Martin in Thurn,65,,5,8,13
082 St.Martin in Thurn,66,,9,8,17
082 St.Martin in Thurn,67,,7,13,20
082 St.Martin in Thurn,68,,4,5,9
082 St.Martin in Thurn,69,,6,5,11
082 St.Martin in Thurn,70,,5,4,9
082 St.Martin in Thurn,71,,3,9,12
082 St.Martin in Thurn,72,,8,7,15
082 St.Martin in Thurn,73,,9,8,17
082 St.Martin in Thurn,74,,7,6,13
082 St.Martin in Thurn,75,,6,7,13
082 St.Martin in Thurn,76,,3,4,7
082 St.Martin in Thurn,77,,5,5,10
082 St.Martin in Thurn,78,,7,3,10
082 St.Martin in Thurn,79,,8,4,12
082 St.Martin in Thurn,80,,7,8,15
082 St.Martin in Thurn,81,,4,9,13
082 St.Martin in Thurn,82,,7,4,11
082 St.Martin in Thurn,83,,5,3,8
082 St.Martin in Thurn,84,,5,7,12
082 St.Martin in Thurn,85,,2,4,6
082 St.Martin in Thurn,86,,2,-,2
082 St.Martin in Thurn,87,,1,2,3
082 St.Martin in Thurn,88,,1,1,2
082 St.Martin in Thurn,89,,1,1,2
082 St.Martin in Thurn,90,,-,2,2
082 St.Martin in Thurn,91,,-,1,1
082 St.Martin in Thurn,92,,1,-,1
082 St.Martin in Thurn,93,,1,-,1
082 St.Martin in Thurn,96,,1,-,1
082 St.Martin in Thurn,100,,1,-,1
083 St.Martin in Passeier,0,,23,20,43
083 St.Martin in Passeier,1,,20,18,38
083 St.Martin in Passeier,2,,18,12,30
083 St.Martin in Passeier,3,,18,17,35
083 St.Martin in Passeier,4,,14,20,34
083 St.Martin in Passeier,5,,8,20,28
083 St.Martin in Passeier,6,,19,19,38
083 St.Martin in Passeier,7,,28,25,53
083 St.Martin in Passeier,8,,21,21,42
083 St.Martin in Passeier,9,,19,17,36
083 St.Martin in Passeier,10,,20,23,43
083 St.Martin in Passeier,11,,20,23,43
083 St.Martin in Passeier,12,,21,20,41
083 St.Martin in Passeier,13,,21,25,46
083 St.Martin in Passeier,14,,19,25,44
083 St.Martin in Passeier,15,,19,21,40
083 St.Martin in Passeier,16,,15,15,30
083 St.Martin in Passeier,17,,18,23,41
083 St.Martin in Passeier,18,,20,25,45
083 St.Martin in Passeier,19,,16,18,34
083 St.Martin in Passeier,20,,16,25,41
083 St.Martin in Passeier,21,,19,10,29
083 St.Martin in Passeier,22,,20,21,41
083 St.Martin in Passeier,23,,22,22,44
083 St.Martin in Passeier,24,,19,23,42
083 St.Martin in Passeier,25,,23,10,33
083 St.Martin in Passeier,26,,29,16,45
083 St.Martin in Passeier,27,,22,26,48
083 St.Martin in Passeier,28,,19,23,42
083 St.Martin in Passeier,29,,26,22,48
083 St.Martin in Passeier,30,,20,19,39
083 St.Martin in Passeier,31,,27,29,56
083 St.Martin in Passeier,32,,26,27,53
083 St.Martin in Passeier,33,,28,24,52
083 St.Martin in Passeier,34,,29,24,53
083 St.Martin in Passeier,35,,30,26,56
083 St.Martin in Passeier,36,,25,23,48
083 St.Martin in Passeier,37,,22,24,46
083 St.Martin in Passeier,38,,27,31,58
083 St.Martin in Passeier,39,,32,25,57
083 St.Martin in Passeier,40,,20,20,40
083 St.Martin in Passeier,41,,34,20,54
083 St.Martin in Passeier,42,,22,29,51
083 St.Martin in Passeier,43,,34,22,56
083 St.Martin in Passeier,44,,21,23,44
083 St.Martin in Passeier,45,,25,21,46
083 St.Martin in Passeier,46,,23,20,43
083 St.Martin in Passeier,47,,25,11,36
083 St.Martin in Passeier,48,,21,14,35
083 St.Martin in Passeier,49,,32,16,48
083 St.Martin in Passeier,50,,15,10,25
083 St.Martin in Passeier,51,,22,15,37
083 St.Martin in Passeier,52,,5,19,24
083 St.Martin in Passeier,53,,20,14,34
083 St.Martin in Passeier,54,,10,15,25
083 St.Martin in Passeier,55,,14,9,23
083 St.Martin in Passeier,56,,11,10,21
083 St.Martin in Passeier,57,,14,13,27
083 St.Martin in Passeier,58,,14,11,25
083 St.Martin in Passeier,59,,13,12,25
083 St.Martin in Passeier,60,,18,13,31
083 St.Martin in Passeier,61,,14,11,25
083 St.Martin in Passeier,62,,15,14,29
083 St.Martin in Passeier,63,,10,15,25
083 St.Martin in Passeier,64,,4,13,17
083 St.Martin in Passeier,65,,6,13,19
083 St.Martin in Passeier,66,,12,8,20
083 St.Martin in Passeier,67,,15,19,34
083 St.Martin in Passeier,68,,13,14,27
083 St.Martin in Passeier,69,,7,13,20
083 St.Martin in Passeier,70,,16,9,25
083 St.Martin in Passeier,71,,13,9,22
083 St.Martin in Passeier,72,,8,9,17
083 St.Martin in Passeier,73,,7,12,19
083 St.Martin in Passeier,74,,5,12,17
083 St.Martin in Passeier,75,,11,9,20
083 St.Martin in Passeier,76,,7,7,14
083 St.Martin in Passeier,77,,11,6,17
083 St.Martin in Passeier,78,,4,12,16
083 St.Martin in Passeier,79,,5,8,13
083 St.Martin in Passeier,80,,3,12,15
083 St.Martin in Passeier,81,,1,7,8
083 St.Martin in Passeier,82,,5,5,10
083 St.Martin in Passeier,83,,4,10,14
083 St.Martin in Passeier,84,,1,4,5
083 St.Martin in Passeier,85,,1,3,4
083 St.Martin in Passeier,86,,-,2,2
083 St.Martin in Passeier,87,,1,4,5
083 St.Martin in Passeier,88,,-,1,1
083 St.Martin in Passeier,89,,1,1,2
083 St.Martin in Passeier,90,,1,4,5
083 St.Martin in Passeier,91,,-,1,1
083 St.Martin in Passeier,92,,-,3,3
083 St.Martin in Passeier,93,,1,-,1
084 St.Pankraz,0,,13,9,22
084 St.Pankraz,1,,13,6,19
084 St.Pankraz,2,,8,4,12
084 St.Pankraz,3,,13,15,28
084 St.Pankraz,4,,12,15,27
084 St.Pankraz,5,,9,5,14
084 St.Pankraz,6,,13,6,19
084 St.Pankraz,7,,9,11,20
084 St.Pankraz,8,,12,9,21
084 St.Pankraz,9,,11,5,16
084 St.Pankraz,10,,8,9,17
084 St.Pankraz,11,,5,13,18
084 St.Pankraz,12,,6,8,14
084 St.Pankraz,13,,13,12,25
084 St.Pankraz,14,,9,3,12
084 St.Pankraz,15,,11,14,25
084 St.Pankraz,16,,14,8,22
084 St.Pankraz,17,,10,8,18
084 St.Pankraz,18,,9,6,15
084 St.Pankraz,19,,9,6,15
084 St.Pankraz,20,,9,5,14
084 St.Pankraz,21,,11,6,17
084 St.Pankraz,22,,12,9,21
084 St.Pankraz,23,,11,14,25
084 St.Pankraz,24,,13,9,22
084 St.Pankraz,25,,5,5,10
084 St.Pankraz,26,,14,9,23
084 St.Pankraz,27,,8,10,18
084 St.Pankraz,28,,5,10,15
084 St.Pankraz,29,,10,8,18
084 St.Pankraz,30,,13,12,25
084 St.Pankraz,31,,11,9,20
084 St.Pankraz,32,,10,16,26
084 St.Pankraz,33,,17,10,27
084 St.Pankraz,34,,12,11,23
084 St.Pankraz,35,,18,11,29
084 St.Pankraz,36,,18,20,38
084 St.Pankraz,37,,12,15,27
084 St.Pankraz,38,,14,6,20
084 St.Pankraz,39,,23,14,37
084 St.Pankraz,40,,14,15,29
084 St.Pankraz,41,,9,10,19
084 St.Pankraz,42,,17,7,24
084 St.Pankraz,43,,14,13,27
084 St.Pankraz,44,,13,6,19
084 St.Pankraz,45,,15,11,26
084 St.Pankraz,46,,6,9,15
084 St.Pankraz,47,,12,9,21
084 St.Pankraz,48,,10,15,25
084 St.Pankraz,49,,6,4,10
084 St.Pankraz,50,,10,8,18
084 St.Pankraz,51,,11,9,20
084 St.Pankraz,52,,16,10,26
084 St.Pankraz,53,,5,3,8
084 St.Pankraz,54,,11,6,17
084 St.Pankraz,55,,7,6,13
084 St.Pankraz,56,,8,3,11
084 St.Pankraz,57,,7,8,15
084 St.Pankraz,58,,4,7,11
084 St.Pankraz,59,,3,6,9
084 St.Pankraz,60,,5,7,12
084 St.Pankraz,61,,10,15,25
084 St.Pankraz,62,,9,14,23
084 St.Pankraz,63,,8,12,20
084 St.Pankraz,64,,8,6,14
084 St.Pankraz,65,,9,7,16
084 St.Pankraz,66,,5,11,16
084 St.Pankraz,67,,9,10,19
084 St.Pankraz,68,,5,5,10
084 St.Pankraz,69,,4,4,8
084 St.Pankraz,70,,6,7,13
084 St.Pankraz,71,,8,3,11
084 St.Pankraz,72,,7,10,17
084 St.Pankraz,73,,9,4,13
084 St.Pankraz,74,,7,7,14
084 St.Pankraz,75,,7,10,17
084 St.Pankraz,76,,7,9,16
084 St.Pankraz,77,,7,4,11
084 St.Pankraz,78,,6,6,12
084 St.Pankraz,79,,7,8,15
084 St.Pankraz,80,,5,8,13
084 St.Pankraz,81,,10,3,13
084 St.Pankraz,82,,8,7,15
084 St.Pankraz,83,,2,7,9
084 St.Pankraz,84,,2,9,11
084 St.Pankraz,85,,2,1,3
084 St.Pankraz,86,,2,2,4
084 St.Pankraz,87,,-,1,1
084 St.Pankraz,88,,1,-,1
084 St.Pankraz,89,,1,2,3
084 St.Pankraz,90,,1,2,3
084 St.Pankraz,91,,1,1,2
084 St.Pankraz,92,,1,1,2
084 St.Pankraz,94,,-,1,1
084 St.Pankraz,95,,-,2,2
085 St.Christina in Gröden,0,,13,16,29
085 St.Christina in Gröden,1,,11,6,17
085 St.Christina in Gröden,2,,12,14,26
085 St.Christina in Gröden,3,,10,13,23
085 St.Christina in Gröden,4,,21,13,34
085 St.Christina in Gröden,5,,18,11,29
085 St.Christina in Gröden,6,,12,15,27
085 St.Christina in Gröden,7,,11,10,21
085 St.Christina in Gröden,8,,12,5,17
085 St.Christina in Gröden,9,,15,9,24
085 St.Christina in Gröden,10,,7,14,21
085 St.Christina in Gröden,11,,13,14,27
085 St.Christina in Gröden,12,,13,13,26
085 St.Christina in Gröden,13,,12,16,28
085 St.Christina in Gröden,14,,7,13,20
085 St.Christina in Gröden,15,,6,7,13
085 St.Christina in Gröden,16,,9,11,20
085 St.Christina in Gröden,17,,12,6,18
085 St.Christina in Gröden,18,,11,9,20
085 St.Christina in Gröden,19,,5,11,16
085 St.Christina in Gröden,20,,11,6,17
085 St.Christina in Gröden,21,,17,14,31
085 St.Christina in Gröden,22,,12,3,15
085 St.Christina in Gröden,23,,8,14,22
085 St.Christina in Gröden,24,,10,14,24
085 St.Christina in Gröden,25,,13,8,21
085 St.Christina in Gröden,26,,4,11,15
085 St.Christina in Gröden,27,,5,10,15
085 St.Christina in Gröden,28,,14,7,21
085 St.Christina in Gröden,29,,14,13,27
085 St.Christina in Gröden,30,,8,18,26
085 St.Christina in Gröden,31,,10,14,24
085 St.Christina in Gröden,32,,16,12,28
085 St.Christina in Gröden,33,,11,16,27
085 St.Christina in Gröden,34,,19,19,38
085 St.Christina in Gröden,35,,19,10,29
085 St.Christina in Gröden,36,,22,22,44
085 St.Christina in Gröden,37,,15,16,31
085 St.Christina in Gröden,38,,19,9,28
085 St.Christina in Gröden,39,,14,16,30
085 St.Christina in Gröden,40,,11,21,32
085 St.Christina in Gröden,41,,15,17,32
085 St.Christina in Gröden,42,,22,15,37
085 St.Christina in Gröden,43,,22,15,37
085 St.Christina in Gröden,44,,21,18,39
085 St.Christina in Gröden,45,,10,7,17
085 St.Christina in Gröden,46,,7,11,18
085 St.Christina in Gröden,47,,16,11,27
085 St.Christina in Gröden,48,,11,10,21
085 St.Christina in Gröden,49,,9,9,18
085 St.Christina in Gröden,50,,15,14,29
085 St.Christina in Gröden,51,,9,9,18
085 St.Christina in Gröden,52,,4,7,11
085 St.Christina in Gröden,53,,11,5,16
085 St.Christina in Gröden,54,,6,5,11
085 St.Christina in Gröden,55,,7,12,19
085 St.Christina in Gröden,56,,8,5,13
085 St.Christina in Gröden,57,,6,8,14
085 St.Christina in Gröden,58,,9,10,19
085 St.Christina in Gröden,59,,6,6,12
085 St.Christina in Gröden,60,,6,11,17
085 St.Christina in Gröden,61,,11,15,26
085 St.Christina in Gröden,62,,11,6,17
085 St.Christina in Gröden,63,,12,8,20
085 St.Christina in Gröden,64,,9,11,20
085 St.Christina in Gröden,65,,10,11,21
085 St.Christina in Gröden,66,,7,8,15
085 St.Christina in Gröden,67,,9,5,14
085 St.Christina in Gröden,68,,12,10,22
085 St.Christina in Gröden,69,,13,5,18
085 St.Christina in Gröden,70,,7,12,19
085 St.Christina in Gröden,71,,6,13,19
085 St.Christina in Gröden,72,,8,8,16
085 St.Christina in Gröden,73,,4,7,11
085 St.Christina in Gröden,74,,14,5,19
085 St.Christina in Gröden,75,,2,10,12
085 St.Christina in Gröden,76,,5,5,10
085 St.Christina in Gröden,77,,5,6,11
085 St.Christina in Gröden,78,,8,6,14
085 St.Christina in Gröden,79,,5,8,13
085 St.Christina in Gröden,80,,2,2,4
085 St.Christina in Gröden,81,,5,4,9
085 St.Christina in Gröden,82,,-,10,10
085 St.Christina in Gröden,83,,1,4,5
085 St.Christina in Gröden,84,,1,3,4
085 St.Christina in Gröden,85,,3,1,4
085 St.Christina in Gröden,88,,-,2,2
085 St.Christina in Gröden,89,,2,1,3
085 St.Christina in Gröden,90,,-,1,1
085 St.Christina in Gröden,91,,2,-,2
085 St.Christina in Gröden,92,,-,1,1
085 St.Christina in Gröden,94,,-,1,1
086 Sarntal,0,,42,36,78
086 Sarntal,1,,46,36,82
086 Sarntal,2,,28,43,71
086 Sarntal,3,,48,28,76
086 Sarntal,4,,36,41,77
086 Sarntal,5,,34,35,69
086 Sarntal,6,,51,43,94
086 Sarntal,7,,43,46,89
086 Sarntal,8,,48,41,89
086 Sarntal,9,,44,42,86
086 Sarntal,10,,33,41,74
086 Sarntal,11,,33,40,73
086 Sarntal,12,,46,36,82
086 Sarntal,13,,42,41,83
086 Sarntal,14,,45,33,78
086 Sarntal,15,,55,36,91
086 Sarntal,16,,44,42,86
086 Sarntal,17,,36,31,67
086 Sarntal,18,,37,42,79
086 Sarntal,19,,43,38,81
086 Sarntal,20,,38,41,79
086 Sarntal,21,,55,42,97
086 Sarntal,22,,59,46,105
086 Sarntal,23,,42,55,97
086 Sarntal,24,,59,45,104
086 Sarntal,25,,59,50,109
086 Sarntal,26,,57,56,113
086 Sarntal,27,,60,39,99
086 Sarntal,28,,50,40,90
086 Sarntal,29,,61,48,109
086 Sarntal,30,,49,63,112
086 Sarntal,31,,63,62,125
086 Sarntal,32,,68,38,106
086 Sarntal,33,,46,49,95
086 Sarntal,34,,68,58,126
086 Sarntal,35,,63,57,120
086 Sarntal,36,,54,43,97
086 Sarntal,37,,54,49,103
086 Sarntal,38,,53,52,105
086 Sarntal,39,,68,53,121
086 Sarntal,40,,57,61,118
086 Sarntal,41,,44,41,85
086 Sarntal,42,,61,34,95
086 Sarntal,43,,40,45,85
086 Sarntal,44,,65,46,111
086 Sarntal,45,,44,41,85
086 Sarntal,46,,52,43,95
086 Sarntal,47,,38,42,80
086 Sarntal,48,,41,31,72
086 Sarntal,49,,40,40,80
086 Sarntal,50,,36,29,65
086 Sarntal,51,,40,30,70
086 Sarntal,52,,35,41,76
086 Sarntal,53,,46,34,80
086 Sarntal,54,,37,35,72
086 Sarntal,55,,51,25,76
086 Sarntal,56,,32,38,70
086 Sarntal,57,,39,27,66
086 Sarntal,58,,36,36,72
086 Sarntal,59,,29,33,62
086 Sarntal,60,,29,31,60
086 Sarntal,61,,40,41,81
086 Sarntal,62,,39,38,77
086 Sarntal,63,,34,31,65
086 Sarntal,64,,29,44,73
086 Sarntal,65,,39,32,71
086 Sarntal,66,,34,28,62
086 Sarntal,67,,24,33,57
086 Sarntal,68,,20,24,44
086 Sarntal,69,,23,25,48
086 Sarntal,70,,26,19,45
086 Sarntal,71,,22,24,46
086 Sarntal,72,,25,24,49
086 Sarntal,73,,18,25,43
086 Sarntal,74,,17,25,42
086 Sarntal,75,,20,29,49
086 Sarntal,76,,20,26,46
086 Sarntal,77,,16,32,48
086 Sarntal,78,,18,14,32
086 Sarntal,79,,19,19,38
086 Sarntal,80,,12,23,35
086 Sarntal,81,,8,21,29
086 Sarntal,82,,11,32,43
086 Sarntal,83,,6,12,18
086 Sarntal,84,,10,15,25
086 Sarntal,85,,3,17,20
086 Sarntal,86,,1,9,10
086 Sarntal,87,,3,7,10
086 Sarntal,88,,-,4,4
086 Sarntal,89,,1,3,4
086 Sarntal,90,,3,3,6
086 Sarntal,91,,6,5,11
086 Sarntal,92,,2,6,8
086 Sarntal,93,,2,2,4
086 Sarntal,94,,-,3,3
086 Sarntal,95,,-,2,2
086 Sarntal,96,,-,1,1
086 Sarntal,97,,1,2,3
087 Schenna,0,,18,18,36
087 Schenna,1,,13,12,25
087 Schenna,2,,14,18,32
087 Schenna,3,,20,14,34
087 Schenna,4,,20,19,39
087 Schenna,5,,22,17,39
087 Schenna,6,,16,12,28
087 Schenna,7,,12,17,29
087 Schenna,8,,16,16,32
087 Schenna,9,,17,18,35
087 Schenna,10,,20,16,36
087 Schenna,11,,13,8,21
087 Schenna,12,,17,16,33
087 Schenna,13,,12,20,32
087 Schenna,14,,19,16,35
087 Schenna,15,,20,10,30
087 Schenna,16,,21,19,40
087 Schenna,17,,22,17,39
087 Schenna,18,,19,13,32
087 Schenna,19,,16,17,33
087 Schenna,20,,14,14,28
087 Schenna,21,,16,13,29
087 Schenna,22,,12,14,26
087 Schenna,23,,23,8,31
087 Schenna,24,,19,18,37
087 Schenna,25,,23,19,42
087 Schenna,26,,15,16,31
087 Schenna,27,,17,20,37
087 Schenna,28,,22,16,38
087 Schenna,29,,18,29,47
087 Schenna,30,,35,18,53
087 Schenna,31,,28,22,50
087 Schenna,32,,28,16,44
087 Schenna,33,,28,25,53
087 Schenna,34,,24,25,49
087 Schenna,35,,25,19,44
087 Schenna,36,,23,20,43
087 Schenna,37,,31,21,52
087 Schenna,38,,17,18,35
087 Schenna,39,,24,27,51
087 Schenna,40,,20,24,44
087 Schenna,41,,26,19,45
087 Schenna,42,,19,13,32
087 Schenna,43,,29,22,51
087 Schenna,44,,32,24,56
087 Schenna,45,,14,13,27
087 Schenna,46,,20,19,39
087 Schenna,47,,14,18,32
087 Schenna,48,,17,16,33
087 Schenna,49,,12,15,27
087 Schenna,50,,14,18,32
087 Schenna,51,,15,15,30
087 Schenna,52,,13,16,29
087 Schenna,53,,14,13,27
087 Schenna,54,,19,14,33
087 Schenna,55,,21,18,39
087 Schenna,56,,15,15,30
087 Schenna,57,,16,18,34
087 Schenna,58,,18,23,41
087 Schenna,59,,15,13,28
087 Schenna,60,,16,9,25
087 Schenna,61,,20,12,32
087 Schenna,62,,10,19,29
087 Schenna,63,,12,13,25
087 Schenna,64,,11,9,20
087 Schenna,65,,11,14,25
087 Schenna,66,,16,19,35
087 Schenna,67,,7,10,17
087 Schenna,68,,8,11,19
087 Schenna,69,,13,10,23
087 Schenna,70,,12,15,27
087 Schenna,71,,7,8,15
087 Schenna,72,,10,11,21
087 Schenna,73,,11,11,22
087 Schenna,74,,12,7,19
087 Schenna,75,,6,10,16
087 Schenna,76,,7,10,17
087 Schenna,77,,5,13,18
087 Schenna,78,,5,7,12
087 Schenna,79,,1,9,10
087 Schenna,80,,9,7,16
087 Schenna,81,,4,4,8
087 Schenna,82,,8,5,13
087 Schenna,83,,6,9,15
087 Schenna,84,,4,4,8
087 Schenna,85,,2,6,8
087 Schenna,86,,-,2,2
087 Schenna,87,,1,1,2
087 Schenna,88,,1,1,2
087 Schenna,89,,1,2,3
087 Schenna,90,,2,2,4
087 Schenna,91,,-,2,2
087 Schenna,92,,3,2,5
087 Schenna,94,,1,1,2
087 Schenna,95,,1,1,2
087 Schenna,100,,-,1,1
088 Mühlwald,0,,9,9,18
088 Mühlwald,1,,17,10,27
088 Mühlwald,2,,8,13,21
088 Mühlwald,3,,10,13,23
088 Mühlwald,4,,8,11,19
088 Mühlwald,5,,12,8,20
088 Mühlwald,6,,12,14,26
088 Mühlwald,7,,11,8,19
088 Mühlwald,8,,14,13,27
088 Mühlwald,9,,13,4,17
088 Mühlwald,10,,9,6,15
088 Mühlwald,11,,13,12,25
088 Mühlwald,12,,5,7,12
088 Mühlwald,13,,11,6,17
088 Mühlwald,14,,9,6,15
088 Mühlwald,15,,16,8,24
088 Mühlwald,16,,7,3,10
088 Mühlwald,17,,9,14,23
088 Mühlwald,18,,6,7,13
088 Mühlwald,19,,11,18,29
088 Mühlwald,20,,11,18,29
088 Mühlwald,21,,11,9,20
088 Mühlwald,22,,8,15,23
088 Mühlwald,23,,16,15,31
088 Mühlwald,24,,20,4,24
088 Mühlwald,25,,7,19,26
088 Mühlwald,26,,12,8,20
088 Mühlwald,27,,8,8,16
088 Mühlwald,28,,13,9,22
088 Mühlwald,29,,11,9,20
088 Mühlwald,30,,10,5,15
088 Mühlwald,31,,16,7,23
088 Mühlwald,32,,10,10,20
088 Mühlwald,33,,16,15,31
088 Mühlwald,34,,9,10,19
088 Mühlwald,35,,14,16,30
088 Mühlwald,36,,17,10,27
088 Mühlwald,37,,18,14,32
088 Mühlwald,38,,13,8,21
088 Mühlwald,39,,18,14,32
088 Mühlwald,40,,17,10,27
088 Mühlwald,41,,11,11,22
088 Mühlwald,42,,8,11,19
088 Mühlwald,43,,6,10,16
088 Mühlwald,44,,15,9,24
088 Mühlwald,45,,14,5,19
088 Mühlwald,46,,9,6,15
088 Mühlwald,47,,13,12,25
088 Mühlwald,48,,8,8,16
088 Mühlwald,49,,7,8,15
088 Mühlwald,50,,10,4,14
088 Mühlwald,51,,10,9,19
088 Mühlwald,52,,10,7,17
088 Mühlwald,53,,9,4,13
088 Mühlwald,54,,5,9,14
088 Mühlwald,55,,9,3,12
088 Mühlwald,56,,12,4,16
088 Mühlwald,57,,10,7,17
088 Mühlwald,58,,8,3,11
088 Mühlwald,59,,4,4,8
088 Mühlwald,60,,8,4,12
088 Mühlwald,61,,10,2,12
088 Mühlwald,62,,6,7,13
088 Mühlwald,63,,4,7,11
088 Mühlwald,64,,3,9,12
088 Mühlwald,65,,6,11,17
088 Mühlwald,66,,9,4,13
088 Mühlwald,67,,11,3,14
088 Mühlwald,68,,4,3,7
088 Mühlwald,69,,6,3,9
088 Mühlwald,70,,3,7,10
088 Mühlwald,71,,4,10,14
088 Mühlwald,72,,1,2,3
088 Mühlwald,73,,5,5,10
088 Mühlwald,74,,3,5,8
088 Mühlwald,75,,7,8,15
088 Mühlwald,76,,4,4,8
088 Mühlwald,77,,8,2,10
088 Mühlwald,78,,3,5,8
088 Mühlwald,79,,3,3,6
088 Mühlwald,80,,6,4,10
088 Mühlwald,81,,1,4,5
088 Mühlwald,82,,-,4,4
088 Mühlwald,83,,-,5,5
088 Mühlwald,84,,1,1,2
088 Mühlwald,85,,-,2,2
088 Mühlwald,86,,1,2,3
088 Mühlwald,87,,3,2,5
088 Mühlwald,88,,-,1,1
088 Mühlwald,89,,-,2,2
088 Mühlwald,90,,1,1,2
088 Mühlwald,91,,-,2,2
088 Mühlwald,93,,-,2,2
088 Mühlwald,96,,1,-,1
089 Wolkenstein in Gröden,0,,13,9,22
089 Wolkenstein in Gröden,1,,13,18,31
089 Wolkenstein in Gröden,2,,23,16,39
089 Wolkenstein in Gröden,3,,22,18,40
089 Wolkenstein in Gröden,4,,19,20,39
089 Wolkenstein in Gröden,5,,12,19,31
089 Wolkenstein in Gröden,6,,15,23,38
089 Wolkenstein in Gröden,7,,22,31,53
089 Wolkenstein in Gröden,8,,15,12,27
089 Wolkenstein in Gröden,9,,17,12,29
089 Wolkenstein in Gröden,10,,16,18,34
089 Wolkenstein in Gröden,11,,12,14,26
089 Wolkenstein in Gröden,12,,24,15,39
089 Wolkenstein in Gröden,13,,19,18,37
089 Wolkenstein in Gröden,14,,13,12,25
089 Wolkenstein in Gröden,15,,16,13,29
089 Wolkenstein in Gröden,16,,18,18,36
089 Wolkenstein in Gröden,17,,11,20,31
089 Wolkenstein in Gröden,18,,16,13,29
089 Wolkenstein in Gröden,19,,16,11,27
089 Wolkenstein in Gröden,20,,13,11,24
089 Wolkenstein in Gröden,21,,15,10,25
089 Wolkenstein in Gröden,22,,11,16,27
089 Wolkenstein in Gröden,23,,17,11,28
089 Wolkenstein in Gröden,24,,15,13,28
089 Wolkenstein in Gröden,25,,7,14,21
089 Wolkenstein in Gröden,26,,8,8,16
089 Wolkenstein in Gröden,27,,9,11,20
089 Wolkenstein in Gröden,28,,14,12,26
089 Wolkenstein in Gröden,29,,21,19,40
089 Wolkenstein in Gröden,30,,9,20,29
089 Wolkenstein in Gröden,31,,26,20,46
089 Wolkenstein in Gröden,32,,18,18,36
089 Wolkenstein in Gröden,33,,20,25,45
089 Wolkenstein in Gröden,34,,22,28,50
089 Wolkenstein in Gröden,35,,27,19,46
089 Wolkenstein in Gröden,36,,28,29,57
089 Wolkenstein in Gröden,37,,32,26,58
089 Wolkenstein in Gröden,38,,29,22,51
089 Wolkenstein in Gröden,39,,25,32,57
089 Wolkenstein in Gröden,40,,30,22,52
089 Wolkenstein in Gröden,41,,23,20,43
089 Wolkenstein in Gröden,42,,19,24,43
089 Wolkenstein in Gröden,43,,25,27,52
089 Wolkenstein in Gröden,44,,23,22,45
089 Wolkenstein in Gröden,45,,16,16,32
089 Wolkenstein in Gröden,46,,19,16,35
089 Wolkenstein in Gröden,47,,21,17,38
089 Wolkenstein in Gröden,48,,12,12,24
089 Wolkenstein in Gröden,49,,15,9,24
089 Wolkenstein in Gröden,50,,15,9,24
089 Wolkenstein in Gröden,51,,8,14,22
089 Wolkenstein in Gröden,52,,11,7,18
089 Wolkenstein in Gröden,53,,14,12,26
089 Wolkenstein in Gröden,54,,6,17,23
089 Wolkenstein in Gröden,55,,17,12,29
089 Wolkenstein in Gröden,56,,13,14,27
089 Wolkenstein in Gröden,57,,11,18,29
089 Wolkenstein in Gröden,58,,16,20,36
089 Wolkenstein in Gröden,59,,5,14,19
089 Wolkenstein in Gröden,60,,14,10,24
089 Wolkenstein in Gröden,61,,21,16,37
089 Wolkenstein in Gröden,62,,12,12,24
089 Wolkenstein in Gröden,63,,16,18,34
089 Wolkenstein in Gröden,64,,16,18,34
089 Wolkenstein in Gröden,65,,17,15,32
089 Wolkenstein in Gröden,66,,19,7,26
089 Wolkenstein in Gröden,67,,11,19,30
089 Wolkenstein in Gröden,68,,11,15,26
089 Wolkenstein in Gröden,69,,14,8,22
089 Wolkenstein in Gröden,70,,17,10,27
089 Wolkenstein in Gröden,71,,7,11,18
089 Wolkenstein in Gröden,72,,5,9,14
089 Wolkenstein in Gröden,73,,8,10,18
089 Wolkenstein in Gröden,74,,9,10,19
089 Wolkenstein in Gröden,75,,8,7,15
089 Wolkenstein in Gröden,76,,6,9,15
089 Wolkenstein in Gröden,77,,10,6,16
089 Wolkenstein in Gröden,78,,8,6,14
089 Wolkenstein in Gröden,79,,6,7,13
089 Wolkenstein in Gröden,80,,3,10,13
089 Wolkenstein in Gröden,81,,4,6,10
089 Wolkenstein in Gröden,82,,5,9,14
089 Wolkenstein in Gröden,83,,1,5,6
089 Wolkenstein in Gröden,84,,3,4,7
089 Wolkenstein in Gröden,85,,1,2,3
089 Wolkenstein in Gröden,87,,1,3,4
089 Wolkenstein in Gröden,89,,-,4,4
089 Wolkenstein in Gröden,90,,1,2,3
089 Wolkenstein in Gröden,92,,-,4,4
089 Wolkenstein in Gröden,93,,-,3,3
089 Wolkenstein in Gröden,95,,-,1,1
089 Wolkenstein in Gröden,97,,-,1,1
091 Schnals,0,,7,6,13
091 Schnals,1,,3,5,8
091 Schnals,2,,12,-,12
091 Schnals,3,,4,5,9
091 Schnals,4,,4,5,9
091 Schnals,5,,6,9,15
091 Schnals,6,,7,16,23
091 Schnals,7,,13,11,24
091 Schnals,8,,7,13,20
091 Schnals,9,,4,9,13
091 Schnals,10,,5,7,12
091 Schnals,11,,11,5,16
091 Schnals,12,,13,10,23
091 Schnals,13,,12,9,21
091 Schnals,14,,5,7,12
091 Schnals,15,,19,9,28
091 Schnals,16,,10,5,15
091 Schnals,17,,12,10,22
091 Schnals,18,,9,10,19
091 Schnals,19,,7,9,16
091 Schnals,20,,13,16,29
091 Schnals,21,,9,9,18
091 Schnals,22,,11,5,16
091 Schnals,23,,16,9,25
091 Schnals,24,,13,11,24
091 Schnals,25,,11,9,20
091 Schnals,26,,11,10,21
091 Schnals,27,,9,9,18
091 Schnals,28,,11,2,13
091 Schnals,29,,6,6,12
091 Schnals,30,,15,6,21
091 Schnals,31,,7,9,16
091 Schnals,32,,10,9,19
091 Schnals,33,,12,11,23
091 Schnals,34,,12,12,24
091 Schnals,35,,13,10,23
091 Schnals,36,,11,10,21
091 Schnals,37,,16,11,27
091 Schnals,38,,14,15,29
091 Schnals,39,,18,8,26
091 Schnals,40,,7,10,17
091 Schnals,41,,10,15,25
091 Schnals,42,,15,13,28
091 Schnals,43,,12,14,26
091 Schnals,44,,11,8,19
091 Schnals,45,,17,13,30
091 Schnals,46,,14,11,25
091 Schnals,47,,13,5,18
091 Schnals,48,,14,5,19
091 Schnals,49,,10,6,16
091 Schnals,50,,10,10,20
091 Schnals,51,,13,9,22
091 Schnals,52,,13,7,20
091 Schnals,53,,11,8,19
091 Schnals,54,,10,7,17
091 Schnals,55,,10,9,19
091 Schnals,56,,3,3,6
091 Schnals,57,,10,8,18
091 Schnals,58,,5,6,11
091 Schnals,59,,7,4,11
091 Schnals,60,,4,7,11
091 Schnals,61,,6,9,15
091 Schnals,62,,4,4,8
091 Schnals,63,,4,5,9
091 Schnals,64,,7,7,14
091 Schnals,65,,7,7,14
091 Schnals,66,,2,11,13
091 Schnals,67,,7,5,12
091 Schnals,68,,6,5,11
091 Schnals,69,,3,5,8
091 Schnals,70,,2,4,6
091 Schnals,71,,6,4,10
091 Schnals,72,,3,10,13
091 Schnals,73,,2,4,6
091 Schnals,74,,-,5,5
091 Schnals,75,,5,6,11
091 Schnals,76,,2,6,8
091 Schnals,77,,3,6,9
091 Schnals,78,,9,3,12
091 Schnals,79,,7,11,18
091 Schnals,80,,-,6,6
091 Schnals,81,,-,1,1
091 Schnals,82,,7,3,10
091 Schnals,83,,-,5,5
091 Schnals,84,,1,3,4
091 Schnals,85,,-,1,1
091 Schnals,86,,3,2,5
091 Schnals,87,,-,3,3
091 Schnals,88,,-,2,2
091 Schnals,89,,1,3,4
091 Schnals,90,,-,2,2
091 Schnals,91,,-,1,1
091 Schnals,92,,1,2,3
091 Schnals,93,,-,2,2
091 Schnals,95,,-,1,1
092 Sexten,0,,11,6,17
092 Sexten,1,,11,11,22
092 Sexten,2,,16,19,35
092 Sexten,3,,17,12,29
092 Sexten,4,,8,15,23
092 Sexten,5,,8,16,24
092 Sexten,6,,11,7,18
092 Sexten,7,,12,9,21
092 Sexten,8,,12,12,24
092 Sexten,9,,15,14,29
092 Sexten,10,,16,11,27
092 Sexten,11,,8,5,13
092 Sexten,12,,13,10,23
092 Sexten,13,,11,12,23
092 Sexten,14,,10,19,29
092 Sexten,15,,9,9,18
092 Sexten,16,,10,5,15
092 Sexten,17,,12,9,21
092 Sexten,18,,6,9,15
092 Sexten,19,,12,11,23
092 Sexten,20,,6,10,16
092 Sexten,21,,11,9,20
092 Sexten,22,,10,19,29
092 Sexten,23,,15,12,27
092 Sexten,24,,16,6,22
092 Sexten,25,,11,20,31
092 Sexten,26,,9,11,20
092 Sexten,27,,9,4,13
092 Sexten,28,,17,10,27
092 Sexten,29,,8,7,15
092 Sexten,30,,8,6,14
092 Sexten,31,,9,10,19
092 Sexten,32,,14,15,29
092 Sexten,33,,12,15,27
092 Sexten,34,,11,19,30
092 Sexten,35,,24,19,43
092 Sexten,36,,17,17,34
092 Sexten,37,,20,17,37
092 Sexten,38,,15,15,30
092 Sexten,39,,19,18,37
092 Sexten,40,,19,19,38
092 Sexten,41,,29,18,47
092 Sexten,42,,14,15,29
092 Sexten,43,,18,14,32
092 Sexten,44,,19,9,28
092 Sexten,45,,15,15,30
092 Sexten,46,,22,15,37
092 Sexten,47,,17,13,30
092 Sexten,48,,13,14,27
092 Sexten,49,,10,13,23
092 Sexten,50,,12,11,23
092 Sexten,51,,5,12,17
092 Sexten,52,,6,11,17
092 Sexten,53,,7,9,16
092 Sexten,54,,13,7,20
092 Sexten,55,,6,7,13
092 Sexten,56,,10,7,17
092 Sexten,57,,11,4,15
092 Sexten,58,,6,9,15
092 Sexten,59,,9,4,13
092 Sexten,60,,6,12,18
092 Sexten,61,,8,6,14
092 Sexten,62,,5,7,12
092 Sexten,63,,10,16,26
092 Sexten,64,,10,14,24
092 Sexten,65,,7,10,17
092 Sexten,66,,14,12,26
092 Sexten,67,,11,8,19
092 Sexten,68,,7,10,17
092 Sexten,69,,11,16,27
092 Sexten,70,,12,7,19
092 Sexten,71,,5,10,15
092 Sexten,72,,6,7,13
092 Sexten,73,,9,13,22
092 Sexten,74,,9,12,21
092 Sexten,75,,8,13,21
092 Sexten,76,,9,11,20
092 Sexten,77,,9,15,24
092 Sexten,78,,7,3,10
092 Sexten,79,,5,11,16
092 Sexten,80,,6,7,13
092 Sexten,81,,6,10,16
092 Sexten,82,,7,7,14
092 Sexten,83,,4,8,12
092 Sexten,84,,2,4,6
092 Sexten,85,,2,3,5
092 Sexten,86,,-,1,1
092 Sexten,87,,1,1,2
092 Sexten,88,,-,1,1
092 Sexten,89,,1,-,1
092 Sexten,90,,1,-,1
092 Sexten,91,,-,3,3
092 Sexten,92,,-,4,4
092 Sexten,99,,-,1,1
092 Sexten,101,,-,1,1
093 Schlanders,0,,27,36,63
093 Schlanders,1,,29,24,53
093 Schlanders,2,,28,29,57
093 Schlanders,3,,32,34,66
093 Schlanders,4,,38,39,77
093 Schlanders,5,,28,42,70
093 Schlanders,6,,42,38,80
093 Schlanders,7,,56,48,104
093 Schlanders,8,,47,38,85
093 Schlanders,9,,37,29,66
093 Schlanders,10,,43,39,82
093 Schlanders,11,,46,43,89
093 Schlanders,12,,34,42,76
093 Schlanders,13,,39,39,78
093 Schlanders,14,,51,41,92
093 Schlanders,15,,36,34,70
093 Schlanders,16,,38,43,81
093 Schlanders,17,,38,29,67
093 Schlanders,18,,35,35,70
093 Schlanders,19,,41,38,79
093 Schlanders,20,,39,39,78
093 Schlanders,21,,31,36,67
093 Schlanders,22,,50,37,87
093 Schlanders,23,,42,34,76
093 Schlanders,24,,32,33,65
093 Schlanders,25,,37,43,80
093 Schlanders,26,,51,33,84
093 Schlanders,27,,37,44,81
093 Schlanders,28,,43,32,75
093 Schlanders,29,,37,37,74
093 Schlanders,30,,53,38,91
093 Schlanders,31,,40,47,87
093 Schlanders,32,,56,39,95
093 Schlanders,33,,46,48,94
093 Schlanders,34,,49,54,103
093 Schlanders,35,,63,41,104
093 Schlanders,36,,56,44,100
093 Schlanders,37,,50,54,104
093 Schlanders,38,,53,55,108
093 Schlanders,39,,58,48,106
093 Schlanders,40,,39,43,82
093 Schlanders,41,,56,61,117
093 Schlanders,42,,55,44,99
093 Schlanders,43,,42,57,99
093 Schlanders,44,,47,45,92
093 Schlanders,45,,41,39,80
093 Schlanders,46,,46,54,100
093 Schlanders,47,,44,34,78
093 Schlanders,48,,27,33,60
093 Schlanders,49,,27,37,64
093 Schlanders,50,,31,31,62
093 Schlanders,51,,34,37,71
093 Schlanders,52,,32,23,55
093 Schlanders,53,,30,31,61
093 Schlanders,54,,23,32,55
093 Schlanders,55,,29,36,65
093 Schlanders,56,,37,26,63
093 Schlanders,57,,23,24,47
093 Schlanders,58,,31,20,51
093 Schlanders,59,,30,13,43
093 Schlanders,60,,28,31,59
093 Schlanders,61,,29,32,61
093 Schlanders,62,,36,37,73
093 Schlanders,63,,35,38,73
093 Schlanders,64,,29,28,57
093 Schlanders,65,,29,35,64
093 Schlanders,66,,15,20,35
093 Schlanders,67,,26,26,52
093 Schlanders,68,,20,26,46
093 Schlanders,69,,16,25,41
093 Schlanders,70,,19,22,41
093 Schlanders,71,,19,30,49
093 Schlanders,72,,22,17,39
093 Schlanders,73,,23,18,41
093 Schlanders,74,,17,26,43
093 Schlanders,75,,13,16,29
093 Schlanders,76,,17,22,39
093 Schlanders,77,,17,24,41
093 Schlanders,78,,15,24,39
093 Schlanders,79,,10,18,28
093 Schlanders,80,,12,17,29
093 Schlanders,81,,8,17,25
093 Schlanders,82,,6,14,20
093 Schlanders,83,,6,9,15
093 Schlanders,84,,3,17,20
093 Schlanders,85,,3,11,14
093 Schlanders,86,,5,11,16
093 Schlanders,87,,3,2,5
093 Schlanders,88,,2,4,6
093 Schlanders,89,,3,2,5
093 Schlanders,90,,3,8,11
093 Schlanders,91,,3,6,9
093 Schlanders,92,,1,6,7
093 Schlanders,93,,2,5,7
093 Schlanders,94,,1,3,4
093 Schlanders,95,,-,1,1
093 Schlanders,98,,-,1,1
093 Schlanders,100,,-,1,1
093 Schlanders,101,,-,2,2
094 Schluderns,0,,5,15,20
094 Schluderns,1,,16,13,29
094 Schluderns,2,,14,9,23
094 Schluderns,3,,13,7,20
094 Schluderns,4,,17,8,25
094 Schluderns,5,,9,15,24
094 Schluderns,6,,7,10,17
094 Schluderns,7,,14,11,25
094 Schluderns,8,,12,16,28
094 Schluderns,9,,9,12,21
094 Schluderns,10,,14,19,33
094 Schluderns,11,,17,7,24
094 Schluderns,12,,8,9,17
094 Schluderns,13,,9,11,20
094 Schluderns,14,,22,7,29
094 Schluderns,15,,15,13,28
094 Schluderns,16,,11,13,24
094 Schluderns,17,,6,10,16
094 Schluderns,18,,13,20,33
094 Schluderns,19,,19,11,30
094 Schluderns,20,,16,11,27
094 Schluderns,21,,13,11,24
094 Schluderns,22,,8,15,23
094 Schluderns,23,,21,14,35
094 Schluderns,24,,8,6,14
094 Schluderns,25,,7,16,23
094 Schluderns,26,,14,12,26
094 Schluderns,27,,13,12,25
094 Schluderns,28,,9,15,24
094 Schluderns,29,,16,10,26
094 Schluderns,30,,18,14,32
094 Schluderns,31,,22,14,36
094 Schluderns,32,,13,14,27
094 Schluderns,33,,12,15,27
094 Schluderns,34,,12,15,27
094 Schluderns,35,,21,9,30
094 Schluderns,36,,17,15,32
094 Schluderns,37,,14,16,30
094 Schluderns,38,,16,17,33
094 Schluderns,39,,25,10,35
094 Schluderns,40,,26,12,38
094 Schluderns,41,,14,20,34
094 Schluderns,42,,12,21,33
094 Schluderns,43,,16,16,32
094 Schluderns,44,,10,7,17
094 Schluderns,45,,14,20,34
094 Schluderns,46,,10,12,22
094 Schluderns,47,,17,7,24
094 Schluderns,48,,10,17,27
094 Schluderns,49,,17,11,28
094 Schluderns,50,,13,7,20
094 Schluderns,51,,11,7,18
094 Schluderns,52,,7,6,13
094 Schluderns,53,,11,3,14
094 Schluderns,54,,9,14,23
094 Schluderns,55,,14,11,25
094 Schluderns,56,,10,9,19
094 Schluderns,57,,6,5,11
094 Schluderns,58,,8,9,17
094 Schluderns,59,,7,3,10
094 Schluderns,60,,4,12,16
094 Schluderns,61,,3,8,11
094 Schluderns,62,,8,8,16
094 Schluderns,63,,11,14,25
094 Schluderns,64,,8,5,13
094 Schluderns,65,,12,8,20
094 Schluderns,66,,9,10,19
094 Schluderns,67,,7,10,17
094 Schluderns,68,,5,7,12
094 Schluderns,69,,5,10,15
094 Schluderns,70,,10,11,21
094 Schluderns,71,,5,9,14
094 Schluderns,72,,12,9,21
094 Schluderns,73,,4,8,12
094 Schluderns,74,,7,9,16
094 Schluderns,75,,8,7,15
094 Schluderns,76,,6,9,15
094 Schluderns,77,,5,1,6
094 Schluderns,78,,4,12,16
094 Schluderns,79,,2,7,9
094 Schluderns,80,,2,3,5
094 Schluderns,81,,1,5,6
094 Schluderns,82,,6,5,11
094 Schluderns,83,,2,7,9
094 Schluderns,84,,1,4,5
094 Schluderns,85,,3,3,6
094 Schluderns,86,,3,2,5
094 Schluderns,87,,1,2,3
094 Schluderns,88,,1,3,4
094 Schluderns,89,,1,3,4
094 Schluderns,90,,1,1,2
094 Schluderns,91,,1,-,1
094 Schluderns,92,,-,1,1
094 Schluderns,94,,-,1,1
094 Schluderns,95,,-,2,2
095 Stilfs,0,,8,5,13
095 Stilfs,1,,8,7,15
095 Stilfs,2,,7,4,11
095 Stilfs,3,,5,11,16
095 Stilfs,4,,11,4,15
095 Stilfs,5,,2,7,9
095 Stilfs,6,,8,3,11
095 Stilfs,7,,9,11,20
095 Stilfs,8,,12,2,14
095 Stilfs,9,,7,6,13
095 Stilfs,10,,8,6,14
095 Stilfs,11,,5,15,20
095 Stilfs,12,,3,9,12
095 Stilfs,13,,11,5,16
095 Stilfs,14,,17,7,24
095 Stilfs,15,,10,6,16
095 Stilfs,16,,6,4,10
095 Stilfs,17,,6,7,13
095 Stilfs,18,,8,8,16
095 Stilfs,19,,12,5,17
095 Stilfs,20,,15,6,21
095 Stilfs,21,,8,6,14
095 Stilfs,22,,11,4,15
095 Stilfs,23,,10,4,14
095 Stilfs,24,,8,4,12
095 Stilfs,25,,5,8,13
095 Stilfs,26,,10,7,17
095 Stilfs,27,,9,8,17
095 Stilfs,28,,14,4,18
095 Stilfs,29,,11,9,20
095 Stilfs,30,,7,9,16
095 Stilfs,31,,5,20,25
095 Stilfs,32,,14,11,25
095 Stilfs,33,,13,14,27
095 Stilfs,34,,11,14,25
095 Stilfs,35,,12,14,26
095 Stilfs,36,,9,11,20
095 Stilfs,37,,9,9,18
095 Stilfs,38,,16,8,24
095 Stilfs,39,,11,10,21
095 Stilfs,40,,11,5,16
095 Stilfs,41,,9,5,14
095 Stilfs,42,,11,16,27
095 Stilfs,43,,9,2,11
095 Stilfs,44,,8,6,14
095 Stilfs,45,,10,8,18
095 Stilfs,46,,6,12,18
095 Stilfs,47,,9,6,15
095 Stilfs,48,,6,12,18
095 Stilfs,49,,4,3,7
095 Stilfs,50,,15,8,23
095 Stilfs,51,,10,5,15
095 Stilfs,52,,11,5,16
095 Stilfs,53,,13,10,23
095 Stilfs,54,,1,7,8
095 Stilfs,55,,7,3,10
095 Stilfs,56,,9,10,19
095 Stilfs,57,,6,5,11
095 Stilfs,58,,9,10,19
095 Stilfs,59,,2,4,6
095 Stilfs,60,,13,9,22
095 Stilfs,61,,9,8,17
095 Stilfs,62,,5,12,17
095 Stilfs,63,,7,4,11
095 Stilfs,64,,7,11,18
095 Stilfs,65,,5,9,14
095 Stilfs,66,,4,5,9
095 Stilfs,67,,7,6,13
095 Stilfs,68,,3,10,13
095 Stilfs,69,,3,7,10
095 Stilfs,70,,6,4,10
095 Stilfs,71,,4,6,10
095 Stilfs,72,,4,6,10
095 Stilfs,73,,3,4,7
095 Stilfs,74,,5,7,12
095 Stilfs,75,,5,1,6
095 Stilfs,76,,4,8,12
095 Stilfs,77,,5,7,12
095 Stilfs,78,,4,5,9
095 Stilfs,79,,6,3,9
095 Stilfs,80,,1,7,8
095 Stilfs,81,,4,5,9
095 Stilfs,82,,1,5,6
095 Stilfs,83,,1,4,5
095 Stilfs,84,,1,8,9
095 Stilfs,85,,1,1,2
095 Stilfs,86,,1,2,3
095 Stilfs,87,,-,2,2
095 Stilfs,88,,-,3,3
095 Stilfs,90,,2,2,4
095 Stilfs,91,,-,1,1
095 Stilfs,92,,-,2,2
095 Stilfs,93,,-,1,1
095 Stilfs,94,,-,2,2
095 Stilfs,95,,-,2,2
096 Terenten,0,,13,21,34
096 Terenten,1,,8,10,18
096 Terenten,2,,8,8,16
096 Terenten,3,,10,13,23
096 Terenten,4,,9,9,18
096 Terenten,5,,10,18,28
096 Terenten,6,,21,19,40
096 Terenten,7,,9,7,16
096 Terenten,8,,12,11,23
096 Terenten,9,,13,8,21
096 Terenten,10,,14,14,28
096 Terenten,11,,7,13,20
096 Terenten,12,,9,8,17
096 Terenten,13,,6,15,21
096 Terenten,14,,13,16,29
096 Terenten,15,,14,7,21
096 Terenten,16,,10,8,18
096 Terenten,17,,16,6,22
096 Terenten,18,,10,9,19
096 Terenten,19,,11,15,26
096 Terenten,20,,12,12,24
096 Terenten,21,,14,15,29
096 Terenten,22,,12,11,23
096 Terenten,23,,13,6,19
096 Terenten,24,,10,13,23
096 Terenten,25,,11,9,20
096 Terenten,26,,17,18,35
096 Terenten,27,,10,6,16
096 Terenten,28,,16,10,26
096 Terenten,29,,16,10,26
096 Terenten,30,,16,16,32
096 Terenten,31,,9,18,27
096 Terenten,32,,19,9,28
096 Terenten,33,,15,16,31
096 Terenten,34,,21,11,32
096 Terenten,35,,16,13,29
096 Terenten,36,,12,13,25
096 Terenten,37,,16,17,33
096 Terenten,38,,13,18,31
096 Terenten,39,,17,9,26
096 Terenten,40,,16,15,31
096 Terenten,41,,24,13,37
096 Terenten,42,,21,10,31
096 Terenten,43,,10,16,26
096 Terenten,44,,12,9,21
096 Terenten,45,,15,11,26
096 Terenten,46,,12,8,20
096 Terenten,47,,12,9,21
096 Terenten,48,,10,12,22
096 Terenten,49,,12,10,22
096 Terenten,50,,16,11,27
096 Terenten,51,,9,6,15
096 Terenten,52,,6,7,13
096 Terenten,53,,5,6,11
096 Terenten,54,,8,7,15
096 Terenten,55,,9,6,15
096 Terenten,56,,10,8,18
096 Terenten,57,,7,3,10
096 Terenten,58,,8,3,11
096 Terenten,59,,6,3,9
096 Terenten,60,,3,6,9
096 Terenten,61,,8,4,12
096 Terenten,62,,5,5,10
096 Terenten,63,,6,4,10
096 Terenten,64,,8,5,13
096 Terenten,65,,2,6,8
096 Terenten,66,,4,9,13
096 Terenten,67,,6,5,11
096 Terenten,68,,4,9,13
096 Terenten,69,,7,5,12
096 Terenten,70,,2,4,6
096 Terenten,71,,5,3,8
096 Terenten,72,,4,4,8
096 Terenten,73,,6,11,17
096 Terenten,74,,5,6,11
096 Terenten,75,,5,4,9
096 Terenten,76,,5,6,11
096 Terenten,77,,2,3,5
096 Terenten,78,,3,9,12
096 Terenten,79,,6,2,8
096 Terenten,80,,1,7,8
096 Terenten,81,,4,3,7
096 Terenten,82,,3,1,4
096 Terenten,83,,-,2,2
096 Terenten,84,,4,3,7
096 Terenten,85,,1,1,2
096 Terenten,86,,-,3,3
096 Terenten,87,,1,-,1
096 Terenten,88,,-,1,1
096 Terenten,89,,-,1,1
096 Terenten,90,,2,1,3
096 Terenten,91,,1,-,1
096 Terenten,92,,-,1,1
096 Terenten,94,,-,1,1
096 Terenten,95,,-,1,1
097 Terlan,0,,23,19,42
097 Terlan,1,,21,25,46
097 Terlan,2,,16,21,37
097 Terlan,3,,21,26,47
097 Terlan,4,,34,26,60
097 Terlan,5,,29,19,48
097 Terlan,6,,18,21,39
097 Terlan,7,,32,27,59
097 Terlan,8,,16,25,41
097 Terlan,9,,25,24,49
097 Terlan,10,,19,18,37
097 Terlan,11,,26,23,49
097 Terlan,12,,23,28,51
097 Terlan,13,,24,20,44
097 Terlan,14,,14,22,36
097 Terlan,15,,21,30,51
097 Terlan,16,,21,17,38
097 Terlan,17,,25,17,42
097 Terlan,18,,15,21,36
097 Terlan,19,,25,19,44
097 Terlan,20,,13,14,27
097 Terlan,21,,24,15,39
097 Terlan,22,,21,16,37
097 Terlan,23,,15,16,31
097 Terlan,24,,25,21,46
097 Terlan,25,,19,25,44
097 Terlan,26,,17,20,37
097 Terlan,27,,28,20,48
097 Terlan,28,,32,31,63
097 Terlan,29,,29,21,50
097 Terlan,30,,25,41,66
097 Terlan,31,,23,31,54
097 Terlan,32,,43,23,66
097 Terlan,33,,30,25,55
097 Terlan,34,,37,42,79
097 Terlan,35,,32,33,65
097 Terlan,36,,37,26,63
097 Terlan,37,,25,36,61
097 Terlan,38,,34,21,55
097 Terlan,39,,35,29,64
097 Terlan,40,,32,32,64
097 Terlan,41,,36,37,73
097 Terlan,42,,34,36,70
097 Terlan,43,,46,25,71
097 Terlan,44,,25,35,60
097 Terlan,45,,18,24,42
097 Terlan,46,,32,23,55
097 Terlan,47,,23,24,47
097 Terlan,48,,32,31,63
097 Terlan,49,,19,21,40
097 Terlan,50,,23,21,44
097 Terlan,51,,18,23,41
097 Terlan,52,,18,26,44
097 Terlan,53,,21,18,39
097 Terlan,54,,21,23,44
097 Terlan,55,,20,16,36
097 Terlan,56,,21,24,45
097 Terlan,57,,14,19,33
097 Terlan,58,,13,24,37
097 Terlan,59,,21,21,42
097 Terlan,60,,21,25,46
097 Terlan,61,,16,29,45
097 Terlan,62,,32,19,51
097 Terlan,63,,22,24,46
097 Terlan,64,,21,15,36
097 Terlan,65,,17,20,37
097 Terlan,66,,22,18,40
097 Terlan,67,,14,17,31
097 Terlan,68,,7,12,19
097 Terlan,69,,15,23,38
097 Terlan,70,,7,23,30
097 Terlan,71,,15,15,30
097 Terlan,72,,14,11,25
097 Terlan,73,,19,15,34
097 Terlan,74,,15,16,31
097 Terlan,75,,11,14,25
097 Terlan,76,,12,11,23
097 Terlan,77,,10,12,22
097 Terlan,78,,12,18,30
097 Terlan,79,,10,11,21
097 Terlan,80,,6,13,19
097 Terlan,81,,7,23,30
097 Terlan,82,,8,10,18
097 Terlan,83,,8,13,21
097 Terlan,84,,2,8,10
097 Terlan,85,,-,6,6
097 Terlan,86,,3,3,6
097 Terlan,87,,-,4,4
097 Terlan,88,,-,5,5
097 Terlan,89,,1,3,4
097 Terlan,90,,-,6,6
097 Terlan,91,,1,5,6
097 Terlan,92,,-,5,5
097 Terlan,93,,-,4,4
097 Terlan,94,,1,1,2
097 Terlan,95,,2,-,2
097 Terlan,96,,-,1,1
097 Terlan,97,,-,1,1
097 Terlan,99,,-,1,1
098 Tramin a.d. Weinstr.,0,,14,16,30
098 Tramin a.d. Weinstr.,1,,23,15,38
098 Tramin a.d. Weinstr.,2,,13,18,31
098 Tramin a.d. Weinstr.,3,,16,21,37
098 Tramin a.d. Weinstr.,4,,24,14,38
098 Tramin a.d. Weinstr.,5,,19,19,38
098 Tramin a.d. Weinstr.,6,,15,18,33
098 Tramin a.d. Weinstr.,7,,29,15,44
098 Tramin a.d. Weinstr.,8,,19,26,45
098 Tramin a.d. Weinstr.,9,,18,21,39
098 Tramin a.d. Weinstr.,10,,20,22,42
098 Tramin a.d. Weinstr.,11,,16,17,33
098 Tramin a.d. Weinstr.,12,,20,25,45
098 Tramin a.d. Weinstr.,13,,18,10,28
098 Tramin a.d. Weinstr.,14,,23,20,43
098 Tramin a.d. Weinstr.,15,,11,30,41
098 Tramin a.d. Weinstr.,16,,12,26,38
098 Tramin a.d. Weinstr.,17,,18,26,44
098 Tramin a.d. Weinstr.,18,,11,16,27
098 Tramin a.d. Weinstr.,19,,21,20,41
098 Tramin a.d. Weinstr.,20,,21,16,37
098 Tramin a.d. Weinstr.,21,,16,14,30
098 Tramin a.d. Weinstr.,22,,25,18,43
098 Tramin a.d. Weinstr.,23,,30,17,47
098 Tramin a.d. Weinstr.,24,,19,18,37
098 Tramin a.d. Weinstr.,25,,15,13,28
098 Tramin a.d. Weinstr.,26,,10,20,30
098 Tramin a.d. Weinstr.,27,,17,20,37
098 Tramin a.d. Weinstr.,28,,20,12,32
098 Tramin a.d. Weinstr.,29,,20,20,40
098 Tramin a.d. Weinstr.,30,,18,16,34
098 Tramin a.d. Weinstr.,31,,22,13,35
098 Tramin a.d. Weinstr.,32,,22,28,50
098 Tramin a.d. Weinstr.,33,,26,34,60
098 Tramin a.d. Weinstr.,34,,31,19,50
098 Tramin a.d. Weinstr.,35,,30,22,52
098 Tramin a.d. Weinstr.,36,,23,26,49
098 Tramin a.d. Weinstr.,37,,28,27,55
098 Tramin a.d. Weinstr.,38,,29,30,59
098 Tramin a.d. Weinstr.,39,,34,30,64
098 Tramin a.d. Weinstr.,40,,29,29,58
098 Tramin a.d. Weinstr.,41,,22,25,47
098 Tramin a.d. Weinstr.,42,,20,14,34
098 Tramin a.d. Weinstr.,43,,31,26,57
098 Tramin a.d. Weinstr.,44,,29,33,62
098 Tramin a.d. Weinstr.,45,,19,31,50
098 Tramin a.d. Weinstr.,46,,25,22,47
098 Tramin a.d. Weinstr.,47,,20,18,38
098 Tramin a.d. Weinstr.,48,,23,19,42
098 Tramin a.d. Weinstr.,49,,17,19,36
098 Tramin a.d. Weinstr.,50,,20,18,38
098 Tramin a.d. Weinstr.,51,,17,17,34
098 Tramin a.d. Weinstr.,52,,19,17,36
098 Tramin a.d. Weinstr.,53,,10,12,22
098 Tramin a.d. Weinstr.,54,,15,20,35
098 Tramin a.d. Weinstr.,55,,15,15,30
098 Tramin a.d. Weinstr.,56,,17,18,35
098 Tramin a.d. Weinstr.,57,,14,22,36
098 Tramin a.d. Weinstr.,58,,24,17,41
098 Tramin a.d. Weinstr.,59,,7,9,16
098 Tramin a.d. Weinstr.,60,,23,25,48
098 Tramin a.d. Weinstr.,61,,19,22,41
098 Tramin a.d. Weinstr.,62,,21,20,41
098 Tramin a.d. Weinstr.,63,,15,24,39
098 Tramin a.d. Weinstr.,64,,21,15,36
098 Tramin a.d. Weinstr.,65,,14,12,26
098 Tramin a.d. Weinstr.,66,,8,20,28
098 Tramin a.d. Weinstr.,67,,15,13,28
098 Tramin a.d. Weinstr.,68,,12,13,25
098 Tramin a.d. Weinstr.,69,,15,14,29
098 Tramin a.d. Weinstr.,70,,11,12,23
098 Tramin a.d. Weinstr.,71,,9,14,23
098 Tramin a.d. Weinstr.,72,,11,18,29
098 Tramin a.d. Weinstr.,73,,7,18,25
098 Tramin a.d. Weinstr.,74,,19,14,33
098 Tramin a.d. Weinstr.,75,,9,14,23
098 Tramin a.d. Weinstr.,76,,15,17,32
098 Tramin a.d. Weinstr.,77,,17,13,30
098 Tramin a.d. Weinstr.,78,,13,18,31
098 Tramin a.d. Weinstr.,79,,10,18,28
098 Tramin a.d. Weinstr.,80,,6,15,21
098 Tramin a.d. Weinstr.,81,,8,18,26
098 Tramin a.d. Weinstr.,82,,5,9,14
098 Tramin a.d. Weinstr.,83,,9,10,19
098 Tramin a.d. Weinstr.,84,,6,11,17
098 Tramin a.d. Weinstr.,85,,2,10,12
098 Tramin a.d. Weinstr.,86,,2,2,4
098 Tramin a.d. Weinstr.,87,,1,4,5
098 Tramin a.d. Weinstr.,88,,1,-,1
098 Tramin a.d. Weinstr.,89,,1,5,6
098 Tramin a.d. Weinstr.,90,,2,6,8
098 Tramin a.d. Weinstr.,91,,1,-,1
098 Tramin a.d. Weinstr.,92,,1,2,3
098 Tramin a.d. Weinstr.,93,,-,2,2
098 Tramin a.d. Weinstr.,94,,1,1,2
098 Tramin a.d. Weinstr.,96,,1,1,2
098 Tramin a.d. Weinstr.,97,,-,1,1
098 Tramin a.d. Weinstr.,98,,-,1,1
098 Tramin a.d. Weinstr.,104,,-,1,1
099 Tisens,0,,14,12,26
099 Tisens,1,,9,9,18
099 Tisens,2,,11,9,20
099 Tisens,3,,10,15,25
099 Tisens,4,,9,10,19
099 Tisens,5,,11,9,20
099 Tisens,6,,11,13,24
099 Tisens,7,,5,6,11
099 Tisens,8,,11,8,19
099 Tisens,9,,10,9,19
099 Tisens,10,,11,12,23
099 Tisens,11,,6,8,14
099 Tisens,12,,6,16,22
099 Tisens,13,,16,8,24
099 Tisens,14,,10,15,25
099 Tisens,15,,11,10,21
099 Tisens,16,,7,13,20
099 Tisens,17,,13,9,22
099 Tisens,18,,15,8,23
099 Tisens,19,,9,4,13
099 Tisens,20,,11,12,23
099 Tisens,21,,19,7,26
099 Tisens,22,,11,15,26
099 Tisens,23,,5,21,26
099 Tisens,24,,16,10,26
099 Tisens,25,,10,10,20
099 Tisens,26,,10,14,24
099 Tisens,27,,12,10,22
099 Tisens,28,,9,5,14
099 Tisens,29,,15,13,28
099 Tisens,30,,11,9,20
099 Tisens,31,,11,10,21
099 Tisens,32,,8,11,19
099 Tisens,33,,20,17,37
099 Tisens,34,,14,21,35
099 Tisens,35,,16,14,30
099 Tisens,36,,18,19,37
099 Tisens,37,,20,23,43
099 Tisens,38,,20,11,31
099 Tisens,39,,17,29,46
099 Tisens,40,,15,4,19
099 Tisens,41,,18,14,32
099 Tisens,42,,24,7,31
099 Tisens,43,,14,15,29
099 Tisens,44,,17,7,24
099 Tisens,45,,14,11,25
099 Tisens,46,,10,11,21
099 Tisens,47,,16,20,36
099 Tisens,48,,9,12,21
099 Tisens,49,,21,12,33
099 Tisens,50,,9,8,17
099 Tisens,51,,12,11,23
099 Tisens,52,,7,12,19
099 Tisens,53,,10,11,21
099 Tisens,54,,9,7,16
099 Tisens,55,,5,8,13
099 Tisens,56,,15,9,24
099 Tisens,57,,9,8,17
099 Tisens,58,,8,6,14
099 Tisens,59,,3,7,10
099 Tisens,60,,10,10,20
099 Tisens,61,,11,10,21
099 Tisens,62,,9,9,18
099 Tisens,63,,8,14,22
099 Tisens,64,,8,8,16
099 Tisens,65,,13,9,22
099 Tisens,66,,7,12,19
099 Tisens,67,,6,4,10
099 Tisens,68,,7,8,15
099 Tisens,69,,4,12,16
099 Tisens,70,,7,7,14
099 Tisens,71,,2,10,12
099 Tisens,72,,8,10,18
099 Tisens,73,,7,9,16
099 Tisens,74,,4,15,19
099 Tisens,75,,10,11,21
099 Tisens,76,,8,12,20
099 Tisens,77,,11,9,20
099 Tisens,78,,5,9,14
099 Tisens,79,,4,7,11
099 Tisens,80,,2,3,5
099 Tisens,81,,4,9,13
099 Tisens,82,,4,4,8
099 Tisens,83,,4,6,10
099 Tisens,84,,2,5,7
099 Tisens,85,,2,6,8
099 Tisens,86,,1,3,4
099 Tisens,87,,1,3,4
099 Tisens,88,,1,2,3
099 Tisens,89,,2,3,5
099 Tisens,90,,1,1,2
099 Tisens,91,,-,2,2
099 Tisens,92,,-,2,2
099 Tisens,93,,1,1,2
099 Tisens,94,,-,2,2
099 Tisens,96,,-,2,2
099 Tisens,97,,-,1,1
099 Tisens,101,,-,1,1
100 Tiers,0,,5,3,8
100 Tiers,1,,4,8,12
100 Tiers,2,,7,4,11
100 Tiers,3,,3,9,12
100 Tiers,4,,2,8,10
100 Tiers,5,,4,9,13
100 Tiers,6,,5,10,15
100 Tiers,7,,7,5,12
100 Tiers,8,,8,4,12
100 Tiers,9,,6,10,16
100 Tiers,10,,5,7,12
100 Tiers,11,,4,2,6
100 Tiers,12,,6,3,9
100 Tiers,13,,4,3,7
100 Tiers,14,,6,5,11
100 Tiers,15,,5,6,11
100 Tiers,16,,6,8,14
100 Tiers,17,,5,4,9
100 Tiers,18,,8,6,14
100 Tiers,19,,5,6,11
100 Tiers,20,,4,10,14
100 Tiers,21,,6,7,13
100 Tiers,22,,6,6,12
100 Tiers,23,,5,5,10
100 Tiers,24,,2,5,7
100 Tiers,25,,1,9,10
100 Tiers,26,,9,9,18
100 Tiers,27,,6,2,8
100 Tiers,28,,1,3,4
100 Tiers,29,,9,4,13
100 Tiers,30,,4,9,13
100 Tiers,31,,9,9,18
100 Tiers,32,,10,8,18
100 Tiers,33,,6,7,13
100 Tiers,34,,8,8,16
100 Tiers,35,,14,10,24
100 Tiers,36,,6,5,11
100 Tiers,37,,10,11,21
100 Tiers,38,,9,6,15
100 Tiers,39,,7,6,13
100 Tiers,40,,8,3,11
100 Tiers,41,,6,10,16
100 Tiers,42,,5,7,12
100 Tiers,43,,6,4,10
100 Tiers,44,,5,7,12
100 Tiers,45,,12,5,17
100 Tiers,46,,7,4,11
100 Tiers,47,,5,9,14
100 Tiers,48,,10,8,18
100 Tiers,49,,5,3,8
100 Tiers,50,,9,5,14
100 Tiers,51,,6,5,11
100 Tiers,52,,3,2,5
100 Tiers,53,,1,3,4
100 Tiers,54,,8,4,12
100 Tiers,55,,3,5,8
100 Tiers,56,,3,5,8
100 Tiers,57,,3,3,6
100 Tiers,58,,6,5,11
100 Tiers,59,,9,3,12
100 Tiers,60,,1,5,6
100 Tiers,61,,9,10,19
100 Tiers,62,,2,5,7
100 Tiers,63,,4,6,10
100 Tiers,64,,2,3,5
100 Tiers,65,,5,6,11
100 Tiers,66,,6,5,11
100 Tiers,67,,6,5,11
100 Tiers,68,,4,6,10
100 Tiers,69,,7,2,9
100 Tiers,70,,2,5,7
100 Tiers,71,,7,3,10
100 Tiers,72,,2,5,7
100 Tiers,73,,7,2,9
100 Tiers,74,,3,-,3
100 Tiers,75,,2,3,5
100 Tiers,76,,3,3,6
100 Tiers,77,,4,4,8
100 Tiers,78,,4,2,6
100 Tiers,79,,6,4,10
100 Tiers,80,,2,5,7
100 Tiers,81,,2,2,4
100 Tiers,82,,3,1,4
100 Tiers,83,,1,8,9
100 Tiers,84,,2,2,4
100 Tiers,85,,2,-,2
100 Tiers,86,,-,1,1
100 Tiers,87,,1,1,2
100 Tiers,89,,1,1,2
100 Tiers,90,,1,-,1
100 Tiers,91,,-,1,1
100 Tiers,92,,-,1,1
100 Tiers,94,,-,1,1
101 Tirol,0,,15,16,31
101 Tirol,1,,11,13,24
101 Tirol,2,,13,10,23
101 Tirol,3,,18,10,28
101 Tirol,4,,19,10,29
101 Tirol,5,,13,16,29
101 Tirol,6,,18,13,31
101 Tirol,7,,19,22,41
101 Tirol,8,,20,16,36
101 Tirol,9,,8,16,24
101 Tirol,10,,15,14,29
101 Tirol,11,,20,9,29
101 Tirol,12,,12,14,26
101 Tirol,13,,8,8,16
101 Tirol,14,,16,11,27
101 Tirol,15,,11,18,29
101 Tirol,16,,11,15,26
101 Tirol,17,,16,9,25
101 Tirol,18,,11,13,24
101 Tirol,19,,10,16,26
101 Tirol,20,,17,10,27
101 Tirol,21,,19,15,34
101 Tirol,22,,12,12,24
101 Tirol,23,,17,21,38
101 Tirol,24,,18,10,28
101 Tirol,25,,18,4,22
101 Tirol,26,,10,12,22
101 Tirol,27,,14,20,34
101 Tirol,28,,16,10,26
101 Tirol,29,,16,16,32
101 Tirol,30,,16,20,36
101 Tirol,31,,22,13,35
101 Tirol,32,,22,18,40
101 Tirol,33,,22,15,37
101 Tirol,34,,18,14,32
101 Tirol,35,,20,21,41
101 Tirol,36,,25,21,46
101 Tirol,37,,22,20,42
101 Tirol,38,,18,17,35
101 Tirol,39,,21,18,39
101 Tirol,40,,29,23,52
101 Tirol,41,,22,13,35
101 Tirol,42,,16,14,30
101 Tirol,43,,17,23,40
101 Tirol,44,,24,14,38
101 Tirol,45,,16,12,28
101 Tirol,46,,13,18,31
101 Tirol,47,,16,18,34
101 Tirol,48,,8,15,23
101 Tirol,49,,13,15,28
101 Tirol,50,,15,17,32
101 Tirol,51,,17,17,34
101 Tirol,52,,12,11,23
101 Tirol,53,,15,19,34
101 Tirol,54,,14,12,26
101 Tirol,55,,20,15,35
101 Tirol,56,,20,15,35
101 Tirol,57,,9,15,24
101 Tirol,58,,13,6,19
101 Tirol,59,,12,14,26
101 Tirol,60,,16,17,33
101 Tirol,61,,13,12,25
101 Tirol,62,,13,19,32
101 Tirol,63,,12,17,29
101 Tirol,64,,10,13,23
101 Tirol,65,,13,11,24
101 Tirol,66,,7,10,17
101 Tirol,67,,11,14,25
101 Tirol,68,,6,11,17
101 Tirol,69,,10,10,20
101 Tirol,70,,15,7,22
101 Tirol,71,,7,11,18
101 Tirol,72,,8,7,15
101 Tirol,73,,7,5,12
101 Tirol,74,,4,7,11
101 Tirol,75,,7,14,21
101 Tirol,76,,7,9,16
101 Tirol,77,,10,7,17
101 Tirol,78,,5,8,13
101 Tirol,79,,6,9,15
101 Tirol,80,,8,10,18
101 Tirol,81,,4,5,9
101 Tirol,82,,4,6,10
101 Tirol,83,,6,4,10
101 Tirol,84,,2,5,7
101 Tirol,85,,2,4,6
101 Tirol,86,,1,3,4
101 Tirol,88,,1,-,1
101 Tirol,89,,1,2,3
101 Tirol,90,,1,3,4
101 Tirol,91,,1,2,3
101 Tirol,92,,2,1,3
101 Tirol,93,,-,3,3
101 Tirol,97,,1,-,1
101 Tirol,100,,-,1,1
102 Truden im Naturpark,0,,3,7,10
102 Truden im Naturpark,1,,8,4,12
102 Truden im Naturpark,2,,1,3,4
102 Truden im Naturpark,3,,6,5,11
102 Truden im Naturpark,4,,6,8,14
102 Truden im Naturpark,5,,-,4,4
102 Truden im Naturpark,6,,3,8,11
102 Truden im Naturpark,7,,6,6,12
102 Truden im Naturpark,8,,7,6,13
102 Truden im Naturpark,9,,5,6,11
102 Truden im Naturpark,10,,6,5,11
102 Truden im Naturpark,11,,10,4,14
102 Truden im Naturpark,12,,7,4,11
102 Truden im Naturpark,13,,7,7,14
102 Truden im Naturpark,14,,4,6,10
102 Truden im Naturpark,15,,9,8,17
102 Truden im Naturpark,16,,9,10,19
102 Truden im Naturpark,17,,7,5,12
102 Truden im Naturpark,18,,1,8,9
102 Truden im Naturpark,19,,8,6,14
102 Truden im Naturpark,20,,11,4,15
102 Truden im Naturpark,21,,6,5,11
102 Truden im Naturpark,22,,12,3,15
102 Truden im Naturpark,23,,3,9,12
102 Truden im Naturpark,24,,4,4,8
102 Truden im Naturpark,25,,9,8,17
102 Truden im Naturpark,26,,7,6,13
102 Truden im Naturpark,27,,3,4,7
102 Truden im Naturpark,28,,10,7,17
102 Truden im Naturpark,29,,7,1,8
102 Truden im Naturpark,30,,4,7,11
102 Truden im Naturpark,31,,10,8,18
102 Truden im Naturpark,32,,9,9,18
102 Truden im Naturpark,33,,4,3,7
102 Truden im Naturpark,34,,2,7,9
102 Truden im Naturpark,35,,7,9,16
102 Truden im Naturpark,36,,6,12,18
102 Truden im Naturpark,37,,11,10,21
102 Truden im Naturpark,38,,6,7,13
102 Truden im Naturpark,39,,8,8,16
102 Truden im Naturpark,40,,9,7,16
102 Truden im Naturpark,41,,11,7,18
102 Truden im Naturpark,42,,7,5,12
102 Truden im Naturpark,43,,8,5,13
102 Truden im Naturpark,44,,12,12,24
102 Truden im Naturpark,45,,7,9,16
102 Truden im Naturpark,46,,5,8,13
102 Truden im Naturpark,47,,6,10,16
102 Truden im Naturpark,48,,8,5,13
102 Truden im Naturpark,49,,8,10,18
102 Truden im Naturpark,50,,5,6,11
102 Truden im Naturpark,51,,8,5,13
102 Truden im Naturpark,52,,6,6,12
102 Truden im Naturpark,53,,8,5,13
102 Truden im Naturpark,54,,3,2,5
102 Truden im Naturpark,55,,5,3,8
102 Truden im Naturpark,56,,2,6,8
102 Truden im Naturpark,57,,6,2,8
102 Truden im Naturpark,58,,7,6,13
102 Truden im Naturpark,59,,4,2,6
102 Truden im Naturpark,60,,4,5,9
102 Truden im Naturpark,61,,4,5,9
102 Truden im Naturpark,62,,4,4,8
102 Truden im Naturpark,63,,5,5,10
102 Truden im Naturpark,64,,2,4,6
102 Truden im Naturpark,65,,8,2,10
102 Truden im Naturpark,66,,7,7,14
102 Truden im Naturpark,67,,3,4,7
102 Truden im Naturpark,68,,4,3,7
102 Truden im Naturpark,69,,3,3,6
102 Truden im Naturpark,70,,5,-,5
102 Truden im Naturpark,71,,6,7,13
102 Truden im Naturpark,72,,4,4,8
102 Truden im Naturpark,73,,5,4,9
102 Truden im Naturpark,74,,3,9,12
102 Truden im Naturpark,75,,-,7,7
102 Truden im Naturpark,76,,1,6,7
102 Truden im Naturpark,77,,4,6,10
102 Truden im Naturpark,78,,2,8,10
102 Truden im Naturpark,79,,-,5,5
102 Truden im Naturpark,80,,-,7,7
102 Truden im Naturpark,81,,3,6,9
102 Truden im Naturpark,82,,2,5,7
102 Truden im Naturpark,83,,1,4,5
102 Truden im Naturpark,84,,-,5,5
102 Truden im Naturpark,85,,1,4,5
102 Truden im Naturpark,86,,1,1,2
102 Truden im Naturpark,89,,1,1,2
102 Truden im Naturpark,90,,-,1,1
102 Truden im Naturpark,93,,-,1,1
102 Truden im Naturpark,95,,-,1,1
103 Taufers im Münstertal,0,,6,4,10
103 Taufers im Münstertal,1,,4,4,8
103 Taufers im Münstertal,2,,4,5,9
103 Taufers im Münstertal,3,,5,6,11
103 Taufers im Münstertal,4,,5,4,9
103 Taufers im Münstertal,5,,3,3,6
103 Taufers im Münstertal,6,,8,8,16
103 Taufers im Münstertal,7,,4,4,8
103 Taufers im Münstertal,8,,6,4,10
103 Taufers im Münstertal,9,,9,9,18
103 Taufers im Münstertal,10,,6,8,14
103 Taufers im Münstertal,11,,3,5,8
103 Taufers im Münstertal,12,,9,8,17
103 Taufers im Münstertal,13,,7,10,17
103 Taufers im Münstertal,14,,9,7,16
103 Taufers im Münstertal,15,,8,2,10
103 Taufers im Münstertal,16,,6,8,14
103 Taufers im Münstertal,17,,4,6,10
103 Taufers im Münstertal,18,,6,3,9
103 Taufers im Münstertal,19,,4,3,7
103 Taufers im Münstertal,20,,5,7,12
103 Taufers im Münstertal,21,,5,5,10
103 Taufers im Münstertal,22,,5,11,16
103 Taufers im Münstertal,23,,10,2,12
103 Taufers im Münstertal,24,,9,6,15
103 Taufers im Münstertal,25,,8,5,13
103 Taufers im Münstertal,26,,9,3,12
103 Taufers im Münstertal,27,,8,5,13
103 Taufers im Münstertal,28,,6,2,8
103 Taufers im Münstertal,29,,9,5,14
103 Taufers im Münstertal,30,,5,6,11
103 Taufers im Münstertal,31,,2,4,6
103 Taufers im Münstertal,32,,4,8,12
103 Taufers im Münstertal,33,,7,14,21
103 Taufers im Münstertal,34,,6,8,14
103 Taufers im Münstertal,35,,10,6,16
103 Taufers im Münstertal,36,,9,10,19
103 Taufers im Münstertal,37,,4,5,9
103 Taufers im Münstertal,38,,8,8,16
103 Taufers im Münstertal,39,,12,7,19
103 Taufers im Münstertal,40,,7,12,19
103 Taufers im Münstertal,41,,10,10,20
103 Taufers im Münstertal,42,,11,9,20
103 Taufers im Münstertal,43,,9,8,17
103 Taufers im Münstertal,44,,14,6,20
103 Taufers im Münstertal,45,,6,9,15
103 Taufers im Münstertal,46,,5,6,11
103 Taufers im Münstertal,47,,9,7,16
103 Taufers im Münstertal,48,,10,10,20
103 Taufers im Münstertal,49,,4,3,7
103 Taufers im Münstertal,50,,3,6,9
103 Taufers im Münstertal,51,,7,3,10
103 Taufers im Münstertal,52,,6,2,8
103 Taufers im Münstertal,53,,5,4,9
103 Taufers im Münstertal,54,,7,1,8
103 Taufers im Münstertal,55,,5,1,6
103 Taufers im Münstertal,56,,5,1,6
103 Taufers im Münstertal,57,,3,7,10
103 Taufers im Münstertal,58,,3,3,6
103 Taufers im Münstertal,59,,2,3,5
103 Taufers im Münstertal,60,,1,-,1
103 Taufers im Münstertal,61,,6,5,11
103 Taufers im Münstertal,62,,5,5,10
103 Taufers im Münstertal,63,,4,6,10
103 Taufers im Münstertal,64,,3,3,6
103 Taufers im Münstertal,65,,4,4,8
103 Taufers im Münstertal,66,,8,9,17
103 Taufers im Münstertal,67,,3,4,7
103 Taufers im Münstertal,68,,2,9,11
103 Taufers im Münstertal,69,,6,2,8
103 Taufers im Münstertal,70,,3,8,11
103 Taufers im Münstertal,71,,6,5,11
103 Taufers im Münstertal,72,,5,1,6
103 Taufers im Münstertal,73,,8,3,11
103 Taufers im Münstertal,74,,3,3,6
103 Taufers im Münstertal,75,,4,6,10
103 Taufers im Münstertal,76,,3,3,6
103 Taufers im Münstertal,77,,3,4,7
103 Taufers im Münstertal,78,,2,4,6
103 Taufers im Münstertal,79,,1,5,6
103 Taufers im Münstertal,80,,-,7,7
103 Taufers im Münstertal,81,,3,5,8
103 Taufers im Münstertal,82,,2,2,4
103 Taufers im Münstertal,83,,2,-,2
103 Taufers im Münstertal,84,,3,2,5
103 Taufers im Münstertal,85,,1,2,3
103 Taufers im Münstertal,86,,-,2,2
103 Taufers im Münstertal,87,,2,3,5
103 Taufers im Münstertal,88,,1,-,1
103 Taufers im Münstertal,89,,1,1,2
103 Taufers im Münstertal,90,,1,-,1
103 Taufers im Münstertal,91,,-,1,1
103 Taufers im Münstertal,92,,-,2,2
103 Taufers im Münstertal,95,,-,1,1
103 Taufers im Münstertal,96,,-,1,1
103 Taufers im Münstertal,100,,-,1,1
104 Ulten,0,,20,12,32
104 Ulten,1,,22,20,42
104 Ulten,2,,13,21,34
104 Ulten,3,,19,16,35
104 Ulten,4,,17,17,34
104 Ulten,5,,14,15,29
104 Ulten,6,,18,18,36
104 Ulten,7,,14,20,34
104 Ulten,8,,11,13,24
104 Ulten,9,,11,17,28
104 Ulten,10,,19,15,34
104 Ulten,11,,23,14,37
104 Ulten,12,,17,17,34
104 Ulten,13,,23,31,54
104 Ulten,14,,16,18,34
104 Ulten,15,,18,29,47
104 Ulten,16,,16,20,36
104 Ulten,17,,20,17,37
104 Ulten,18,,22,11,33
104 Ulten,19,,14,16,30
104 Ulten,20,,20,22,42
104 Ulten,21,,22,18,40
104 Ulten,22,,16,22,38
104 Ulten,23,,18,17,35
104 Ulten,24,,19,21,40
104 Ulten,25,,17,17,34
104 Ulten,26,,22,16,38
104 Ulten,27,,22,11,33
104 Ulten,28,,17,21,38
104 Ulten,29,,24,22,46
104 Ulten,30,,22,27,49
104 Ulten,31,,27,15,42
104 Ulten,32,,24,21,45
104 Ulten,33,,26,20,46
104 Ulten,34,,22,25,47
104 Ulten,35,,29,21,50
104 Ulten,36,,28,26,54
104 Ulten,37,,14,22,36
104 Ulten,38,,21,19,40
104 Ulten,39,,26,26,52
104 Ulten,40,,24,21,45
104 Ulten,41,,30,26,56
104 Ulten,42,,30,22,52
104 Ulten,43,,29,17,46
104 Ulten,44,,25,20,45
104 Ulten,45,,23,23,46
104 Ulten,46,,25,16,41
104 Ulten,47,,34,22,56
104 Ulten,48,,18,16,34
104 Ulten,49,,12,12,24
104 Ulten,50,,19,16,35
104 Ulten,51,,24,13,37
104 Ulten,52,,18,13,31
104 Ulten,53,,19,19,38
104 Ulten,54,,21,14,35
104 Ulten,55,,17,10,27
104 Ulten,56,,13,12,25
104 Ulten,57,,16,9,25
104 Ulten,58,,15,15,30
104 Ulten,59,,8,13,21
104 Ulten,60,,14,20,34
104 Ulten,61,,17,16,33
104 Ulten,62,,9,18,27
104 Ulten,63,,13,11,24
104 Ulten,64,,16,9,25
104 Ulten,65,,20,16,36
104 Ulten,66,,7,10,17
104 Ulten,67,,10,10,20
104 Ulten,68,,9,9,18
104 Ulten,69,,10,14,24
104 Ulten,70,,12,14,26
104 Ulten,71,,5,14,19
104 Ulten,72,,12,8,20
104 Ulten,73,,10,8,18
104 Ulten,74,,15,17,32
104 Ulten,75,,5,13,18
104 Ulten,76,,9,16,25
104 Ulten,77,,7,18,25
104 Ulten,78,,5,14,19
104 Ulten,79,,16,13,29
104 Ulten,80,,9,11,20
104 Ulten,81,,10,25,35
104 Ulten,82,,7,10,17
104 Ulten,83,,9,14,23
104 Ulten,84,,9,11,20
104 Ulten,85,,2,13,15
104 Ulten,86,,3,2,5
104 Ulten,87,,1,2,3
104 Ulten,88,,-,3,3
104 Ulten,89,,3,1,4
104 Ulten,90,,1,7,8
104 Ulten,91,,2,4,6
104 Ulten,92,,1,2,3
104 Ulten,93,,2,4,6
104 Ulten,94,,1,3,4
104 Ulten,95,,1,-,1
104 Ulten,106,,-,1,1
105 Pfatten,0,,-,5,5
105 Pfatten,1,,10,5,15
105 Pfatten,2,,2,4,6
105 Pfatten,3,,4,-,4
105 Pfatten,4,,5,5,10
105 Pfatten,5,,5,5,10
105 Pfatten,6,,11,3,14
105 Pfatten,7,,3,1,4
105 Pfatten,8,,4,8,12
105 Pfatten,9,,4,5,9
105 Pfatten,10,,9,10,19
105 Pfatten,11,,4,5,9
105 Pfatten,12,,6,6,12
105 Pfatten,13,,7,4,11
105 Pfatten,14,,9,7,16
105 Pfatten,15,,6,5,11
105 Pfatten,16,,2,7,9
105 Pfatten,17,,6,4,10
105 Pfatten,18,,4,9,13
105 Pfatten,19,,4,5,9
105 Pfatten,20,,3,5,8
105 Pfatten,21,,2,3,5
105 Pfatten,22,,5,3,8
105 Pfatten,23,,7,2,9
105 Pfatten,24,,3,4,7
105 Pfatten,25,,3,10,13
105 Pfatten,26,,3,3,6
105 Pfatten,27,,6,1,7
105 Pfatten,28,,6,3,9
105 Pfatten,29,,-,7,7
105 Pfatten,30,,6,8,14
105 Pfatten,31,,7,6,13
105 Pfatten,32,,8,9,17
105 Pfatten,33,,11,6,17
105 Pfatten,34,,7,5,12
105 Pfatten,35,,7,5,12
105 Pfatten,36,,5,8,13
105 Pfatten,37,,14,5,19
105 Pfatten,38,,9,8,17
105 Pfatten,39,,8,11,19
105 Pfatten,40,,8,5,13
105 Pfatten,41,,7,10,17
105 Pfatten,42,,7,12,19
105 Pfatten,43,,10,14,24
105 Pfatten,44,,6,9,15
105 Pfatten,45,,4,14,18
105 Pfatten,46,,7,7,14
105 Pfatten,47,,16,5,21
105 Pfatten,48,,9,7,16
105 Pfatten,49,,9,4,13
105 Pfatten,50,,11,2,13
105 Pfatten,51,,7,7,14
105 Pfatten,52,,2,6,8
105 Pfatten,53,,3,2,5
105 Pfatten,54,,4,6,10
105 Pfatten,55,,6,2,8
105 Pfatten,56,,3,2,5
105 Pfatten,57,,6,8,14
105 Pfatten,58,,5,4,9
105 Pfatten,59,,5,3,8
105 Pfatten,60,,6,2,8
105 Pfatten,61,,2,2,4
105 Pfatten,62,,4,2,6
105 Pfatten,63,,4,6,10
105 Pfatten,64,,2,4,6
105 Pfatten,65,,4,2,6
105 Pfatten,66,,2,3,5
105 Pfatten,67,,4,1,5
105 Pfatten,68,,3,4,7
105 Pfatten,69,,6,2,8
105 Pfatten,70,,2,6,8
105 Pfatten,71,,2,3,5
105 Pfatten,72,,-,4,4
105 Pfatten,73,,2,4,6
105 Pfatten,74,,2,3,5
105 Pfatten,75,,-,6,6
105 Pfatten,76,,-,1,1
105 Pfatten,77,,1,-,1
105 Pfatten,78,,3,3,6
105 Pfatten,79,,1,4,5
105 Pfatten,80,,2,4,6
105 Pfatten,81,,3,1,4
105 Pfatten,82,,2,1,3
105 Pfatten,83,,-,1,1
105 Pfatten,84,,1,1,2
105 Pfatten,85,,1,-,1
105 Pfatten,86,,-,1,1
105 Pfatten,87,,1,1,2
105 Pfatten,88,,-,2,2
105 Pfatten,91,,1,-,1
105 Pfatten,92,,-,1,1
105 Pfatten,97,,-,2,2
106 Olang,0,,16,13,29
106 Olang,1,,18,15,33
106 Olang,2,,15,13,28
106 Olang,3,,17,21,38
106 Olang,4,,19,19,38
106 Olang,5,,16,16,32
106 Olang,6,,17,23,40
106 Olang,7,,22,19,41
106 Olang,8,,26,22,48
106 Olang,9,,20,9,29
106 Olang,10,,20,11,31
106 Olang,11,,20,23,43
106 Olang,12,,14,16,30
106 Olang,13,,26,19,45
106 Olang,14,,22,22,44
106 Olang,15,,20,20,40
106 Olang,16,,15,18,33
106 Olang,17,,26,19,45
106 Olang,18,,17,17,34
106 Olang,19,,13,23,36
106 Olang,20,,20,14,34
106 Olang,21,,16,22,38
106 Olang,22,,22,24,46
106 Olang,23,,15,21,36
106 Olang,24,,18,27,45
106 Olang,25,,18,19,37
106 Olang,26,,18,15,33
106 Olang,27,,29,27,56
106 Olang,28,,20,22,42
106 Olang,29,,24,29,53
106 Olang,30,,17,25,42
106 Olang,31,,29,25,54
106 Olang,32,,26,19,45
106 Olang,33,,31,19,50
106 Olang,34,,24,19,43
106 Olang,35,,20,31,51
106 Olang,36,,28,24,52
106 Olang,37,,31,24,55
106 Olang,38,,28,21,49
106 Olang,39,,17,25,42
106 Olang,40,,19,30,49
106 Olang,41,,23,23,46
106 Olang,42,,25,11,36
106 Olang,43,,16,27,43
106 Olang,44,,22,25,47
106 Olang,45,,25,16,41
106 Olang,46,,22,13,35
106 Olang,47,,26,14,40
106 Olang,48,,14,28,42
106 Olang,49,,17,18,35
106 Olang,50,,16,18,34
106 Olang,51,,15,19,34
106 Olang,52,,18,13,31
106 Olang,53,,9,12,21
106 Olang,54,,34,16,50
106 Olang,55,,24,11,35
106 Olang,56,,19,21,40
106 Olang,57,,15,23,38
106 Olang,58,,16,13,29
106 Olang,59,,18,10,28
106 Olang,60,,14,6,20
106 Olang,61,,11,16,27
106 Olang,62,,14,15,29
106 Olang,63,,15,13,28
106 Olang,64,,17,10,27
106 Olang,65,,12,8,20
106 Olang,66,,7,14,21
106 Olang,67,,9,8,17
106 Olang,68,,9,8,17
106 Olang,69,,8,15,23
106 Olang,70,,11,9,20
106 Olang,71,,11,15,26
106 Olang,72,,10,12,22
106 Olang,73,,4,6,10
106 Olang,74,,13,8,21
106 Olang,75,,11,13,24
106 Olang,76,,5,9,14
106 Olang,77,,6,8,14
106 Olang,78,,5,12,17
106 Olang,79,,4,5,9
106 Olang,80,,3,7,10
106 Olang,81,,5,4,9
106 Olang,82,,3,6,9
106 Olang,83,,5,4,9
106 Olang,84,,2,5,7
106 Olang,85,,1,3,4
106 Olang,86,,-,1,1
106 Olang,87,,1,2,3
106 Olang,88,,1,1,2
106 Olang,89,,1,4,5
106 Olang,90,,1,3,4
106 Olang,91,,-,1,1
106 Olang,93,,1,3,4
106 Olang,94,,-,1,1
106 Olang,98,,1,-,1
107 Pfitsch,0,,16,11,27
107 Pfitsch,1,,17,13,30
107 Pfitsch,2,,20,20,40
107 Pfitsch,3,,10,11,21
107 Pfitsch,4,,24,22,46
107 Pfitsch,5,,17,16,33
107 Pfitsch,6,,11,17,28
107 Pfitsch,7,,15,11,26
107 Pfitsch,8,,11,14,25
107 Pfitsch,9,,17,10,27
107 Pfitsch,10,,14,20,34
107 Pfitsch,11,,15,14,29
107 Pfitsch,12,,14,15,29
107 Pfitsch,13,,20,14,34
107 Pfitsch,14,,19,14,33
107 Pfitsch,15,,8,21,29
107 Pfitsch,16,,15,14,29
107 Pfitsch,17,,11,18,29
107 Pfitsch,18,,14,9,23
107 Pfitsch,19,,16,10,26
107 Pfitsch,20,,25,13,38
107 Pfitsch,21,,22,20,42
107 Pfitsch,22,,28,14,42
107 Pfitsch,23,,20,17,37
107 Pfitsch,24,,21,25,46
107 Pfitsch,25,,27,15,42
107 Pfitsch,26,,27,17,44
107 Pfitsch,27,,13,17,30
107 Pfitsch,28,,21,21,42
107 Pfitsch,29,,19,19,38
107 Pfitsch,30,,16,21,37
107 Pfitsch,31,,18,15,33
107 Pfitsch,32,,16,18,34
107 Pfitsch,33,,25,18,43
107 Pfitsch,34,,26,20,46
107 Pfitsch,35,,26,25,51
107 Pfitsch,36,,23,21,44
107 Pfitsch,37,,19,16,35
107 Pfitsch,38,,28,16,44
107 Pfitsch,39,,22,20,42
107 Pfitsch,40,,14,25,39
107 Pfitsch,41,,19,19,38
107 Pfitsch,42,,24,22,46
107 Pfitsch,43,,22,22,44
107 Pfitsch,44,,14,26,40
107 Pfitsch,45,,14,18,32
107 Pfitsch,46,,23,16,39
107 Pfitsch,47,,24,22,46
107 Pfitsch,48,,17,12,29
107 Pfitsch,49,,15,14,29
107 Pfitsch,50,,21,20,41
107 Pfitsch,51,,22,15,37
107 Pfitsch,52,,19,23,42
107 Pfitsch,53,,24,13,37
107 Pfitsch,54,,22,17,39
107 Pfitsch,55,,15,20,35
107 Pfitsch,56,,8,10,18
107 Pfitsch,57,,10,13,23
107 Pfitsch,58,,14,13,27
107 Pfitsch,59,,12,12,24
107 Pfitsch,60,,11,14,25
107 Pfitsch,61,,22,12,34
107 Pfitsch,62,,23,13,36
107 Pfitsch,63,,17,16,33
107 Pfitsch,64,,13,14,27
107 Pfitsch,65,,15,8,23
107 Pfitsch,66,,4,12,16
107 Pfitsch,67,,9,11,20
107 Pfitsch,68,,8,12,20
107 Pfitsch,69,,8,8,16
107 Pfitsch,70,,11,5,16
107 Pfitsch,71,,13,12,25
107 Pfitsch,72,,3,14,17
107 Pfitsch,73,,8,12,20
107 Pfitsch,74,,6,13,19
107 Pfitsch,75,,16,11,27
107 Pfitsch,76,,5,12,17
107 Pfitsch,77,,9,12,21
107 Pfitsch,78,,4,12,16
107 Pfitsch,79,,10,9,19
107 Pfitsch,80,,-,17,17
107 Pfitsch,81,,6,12,18
107 Pfitsch,82,,5,4,9
107 Pfitsch,83,,6,7,13
107 Pfitsch,84,,-,5,5
107 Pfitsch,85,,2,6,8
107 Pfitsch,86,,-,3,3
107 Pfitsch,87,,2,2,4
107 Pfitsch,88,,1,1,2
107 Pfitsch,89,,2,3,5
107 Pfitsch,90,,-,1,1
107 Pfitsch,91,,-,2,2
107 Pfitsch,92,,-,2,2
107 Pfitsch,93,,-,1,1
107 Pfitsch,94,,1,1,2
107 Pfitsch,95,,-,1,1
107 Pfitsch,96,,-,2,2
108 Ahrntal,0,,33,39,72
108 Ahrntal,1,,37,42,79
108 Ahrntal,2,,30,33,63
108 Ahrntal,3,,30,29,59
108 Ahrntal,4,,49,39,88
108 Ahrntal,5,,32,39,71
108 Ahrntal,6,,35,36,71
108 Ahrntal,7,,41,43,84
108 Ahrntal,8,,38,49,87
108 Ahrntal,9,,36,31,67
108 Ahrntal,10,,26,26,52
108 Ahrntal,11,,39,41,80
108 Ahrntal,12,,41,32,73
108 Ahrntal,13,,26,35,61
108 Ahrntal,14,,41,31,72
108 Ahrntal,15,,38,33,71
108 Ahrntal,16,,28,33,61
108 Ahrntal,17,,36,37,73
108 Ahrntal,18,,39,49,88
108 Ahrntal,19,,34,45,79
108 Ahrntal,20,,41,31,72
108 Ahrntal,21,,44,48,92
108 Ahrntal,22,,40,45,85
108 Ahrntal,23,,50,41,91
108 Ahrntal,24,,38,35,73
108 Ahrntal,25,,45,38,83
108 Ahrntal,26,,35,48,83
108 Ahrntal,27,,53,45,98
108 Ahrntal,28,,44,47,91
108 Ahrntal,29,,46,46,92
108 Ahrntal,30,,48,41,89
108 Ahrntal,31,,45,43,88
108 Ahrntal,32,,53,52,105
108 Ahrntal,33,,70,41,111
108 Ahrntal,34,,50,44,94
108 Ahrntal,35,,53,45,98
108 Ahrntal,36,,52,49,101
108 Ahrntal,37,,45,50,95
108 Ahrntal,38,,61,40,101
108 Ahrntal,39,,56,42,98
108 Ahrntal,40,,55,44,99
108 Ahrntal,41,,50,44,94
108 Ahrntal,42,,37,48,85
108 Ahrntal,43,,36,34,70
108 Ahrntal,44,,41,30,71
108 Ahrntal,45,,43,38,81
108 Ahrntal,46,,48,26,74
108 Ahrntal,47,,27,39,66
108 Ahrntal,48,,36,18,54
108 Ahrntal,49,,36,27,63
108 Ahrntal,50,,33,21,54
108 Ahrntal,51,,26,29,55
108 Ahrntal,52,,27,33,60
108 Ahrntal,53,,33,26,59
108 Ahrntal,54,,34,21,55
108 Ahrntal,55,,32,30,62
108 Ahrntal,56,,28,27,55
108 Ahrntal,57,,26,18,44
108 Ahrntal,58,,17,22,39
108 Ahrntal,59,,20,14,34
108 Ahrntal,60,,20,18,38
108 Ahrntal,61,,22,32,54
108 Ahrntal,62,,31,30,61
108 Ahrntal,63,,31,33,64
108 Ahrntal,64,,31,25,56
108 Ahrntal,65,,26,23,49
108 Ahrntal,66,,37,29,66
108 Ahrntal,67,,26,22,48
108 Ahrntal,68,,21,15,36
108 Ahrntal,69,,21,36,57
108 Ahrntal,70,,21,20,41
108 Ahrntal,71,,18,17,35
108 Ahrntal,72,,21,26,47
108 Ahrntal,73,,31,20,51
108 Ahrntal,74,,19,19,38
108 Ahrntal,75,,18,15,33
108 Ahrntal,76,,12,25,37
108 Ahrntal,77,,16,18,34
108 Ahrntal,78,,15,15,30
108 Ahrntal,79,,10,16,26
108 Ahrntal,80,,11,14,25
108 Ahrntal,81,,8,12,20
108 Ahrntal,82,,8,15,23
108 Ahrntal,83,,5,7,12
108 Ahrntal,84,,2,7,9
108 Ahrntal,85,,7,4,11
108 Ahrntal,86,,-,4,4
108 Ahrntal,87,,2,6,8
108 Ahrntal,88,,-,4,4
108 Ahrntal,89,,1,9,10
108 Ahrntal,90,,3,5,8
108 Ahrntal,91,,2,2,4
108 Ahrntal,92,,1,4,5
108 Ahrntal,94,,2,1,3
108 Ahrntal,95,,-,2,2
108 Ahrntal,97,,-,1,1
108 Ahrntal,99,,1,-,1
109 Gsies,0,,9,12,21
109 Gsies,1,,20,17,37
109 Gsies,2,,12,10,22
109 Gsies,3,,14,15,29
109 Gsies,4,,10,10,20
109 Gsies,5,,25,14,39
109 Gsies,6,,18,6,24
109 Gsies,7,,12,16,28
109 Gsies,8,,10,18,28
109 Gsies,9,,15,16,31
109 Gsies,10,,10,19,29
109 Gsies,11,,17,19,36
109 Gsies,12,,16,10,26
109 Gsies,13,,16,25,41
109 Gsies,14,,16,13,29
109 Gsies,15,,9,12,21
109 Gsies,16,,7,15,22
109 Gsies,17,,19,17,36
109 Gsies,18,,12,17,29
109 Gsies,19,,17,13,30
109 Gsies,20,,13,8,21
109 Gsies,21,,18,10,28
109 Gsies,22,,18,19,37
109 Gsies,23,,15,17,32
109 Gsies,24,,23,23,46
109 Gsies,25,,10,16,26
109 Gsies,26,,14,13,27
109 Gsies,27,,18,18,36
109 Gsies,28,,14,18,32
109 Gsies,29,,19,23,42
109 Gsies,30,,20,19,39
109 Gsies,31,,14,13,27
109 Gsies,32,,10,20,30
109 Gsies,33,,22,17,39
109 Gsies,34,,26,14,40
109 Gsies,35,,25,12,37
109 Gsies,36,,16,15,31
109 Gsies,37,,16,12,28
109 Gsies,38,,15,19,34
109 Gsies,39,,21,5,26
109 Gsies,40,,14,17,31
109 Gsies,41,,13,15,28
109 Gsies,42,,17,8,25
109 Gsies,43,,9,14,23
109 Gsies,44,,17,18,35
109 Gsies,45,,12,14,26
109 Gsies,46,,16,16,32
109 Gsies,47,,12,14,26
109 Gsies,48,,17,7,24
109 Gsies,49,,15,10,25
109 Gsies,50,,16,6,22
109 Gsies,51,,18,6,24
109 Gsies,52,,17,13,30
109 Gsies,53,,15,13,28
109 Gsies,54,,8,8,16
109 Gsies,55,,15,15,30
109 Gsies,56,,7,10,17
109 Gsies,57,,22,7,29
109 Gsies,58,,15,10,25
109 Gsies,59,,4,12,16
109 Gsies,60,,8,13,21
109 Gsies,61,,10,9,19
109 Gsies,62,,5,13,18
109 Gsies,63,,6,11,17
109 Gsies,64,,9,11,20
109 Gsies,65,,6,9,15
109 Gsies,66,,7,9,16
109 Gsies,67,,11,7,18
109 Gsies,68,,4,10,14
109 Gsies,69,,4,9,13
109 Gsies,70,,5,9,14
109 Gsies,71,,6,5,11
109 Gsies,72,,9,5,14
109 Gsies,73,,6,10,16
109 Gsies,74,,12,6,18
109 Gsies,75,,3,6,9
109 Gsies,76,,8,9,17
109 Gsies,77,,2,11,13
109 Gsies,78,,4,4,8
109 Gsies,79,,6,5,11
109 Gsies,80,,5,6,11
109 Gsies,81,,5,6,11
109 Gsies,82,,7,7,14
109 Gsies,83,,2,10,12
109 Gsies,84,,3,4,7
109 Gsies,85,,2,1,3
109 Gsies,86,,1,1,2
109 Gsies,87,,1,2,3
109 Gsies,89,,1,1,2
109 Gsies,91,,-,3,3
109 Gsies,92,,1,3,4
109 Gsies,93,,1,3,4
109 Gsies,96,,-,1,1
109 Gsies,97,,-,1,1
110 Vintl,0,,16,15,31
110 Vintl,1,,17,20,37
110 Vintl,2,,15,20,35
110 Vintl,3,,17,22,39
110 Vintl,4,,22,15,37
110 Vintl,5,,21,22,43
110 Vintl,6,,19,28,47
110 Vintl,7,,19,18,37
110 Vintl,8,,21,19,40
110 Vintl,9,,36,25,61
110 Vintl,10,,18,18,36
110 Vintl,11,,23,21,44
110 Vintl,12,,29,22,51
110 Vintl,13,,22,30,52
110 Vintl,14,,29,20,49
110 Vintl,15,,26,16,42
110 Vintl,16,,21,20,41
110 Vintl,17,,20,22,42
110 Vintl,18,,21,20,41
110 Vintl,19,,10,15,25
110 Vintl,20,,26,10,36
110 Vintl,21,,24,16,40
110 Vintl,22,,21,21,42
110 Vintl,23,,18,28,46
110 Vintl,24,,32,18,50
110 Vintl,25,,30,18,48
110 Vintl,26,,22,37,59
110 Vintl,27,,17,22,39
110 Vintl,28,,23,27,50
110 Vintl,29,,24,20,44
110 Vintl,30,,27,25,52
110 Vintl,31,,21,21,42
110 Vintl,32,,32,19,51
110 Vintl,33,,33,25,58
110 Vintl,34,,21,20,41
110 Vintl,35,,29,23,52
110 Vintl,36,,25,22,47
110 Vintl,37,,32,35,67
110 Vintl,38,,31,31,62
110 Vintl,39,,32,31,63
110 Vintl,40,,36,23,59
110 Vintl,41,,34,26,60
110 Vintl,42,,31,24,55
110 Vintl,43,,27,31,58
110 Vintl,44,,19,23,42
110 Vintl,45,,24,22,46
110 Vintl,46,,19,13,32
110 Vintl,47,,24,28,52
110 Vintl,48,,26,17,43
110 Vintl,49,,18,14,32
110 Vintl,50,,16,18,34
110 Vintl,51,,22,9,31
110 Vintl,52,,19,19,38
110 Vintl,53,,22,18,40
110 Vintl,54,,23,19,42
110 Vintl,55,,16,18,34
110 Vintl,56,,14,13,27
110 Vintl,57,,20,14,34
110 Vintl,58,,15,12,27
110 Vintl,59,,15,20,35
110 Vintl,60,,13,5,18
110 Vintl,61,,20,11,31
110 Vintl,62,,11,13,24
110 Vintl,63,,6,16,22
110 Vintl,64,,8,19,27
110 Vintl,65,,16,16,32
110 Vintl,66,,11,5,16
110 Vintl,67,,11,9,20
110 Vintl,68,,15,11,26
110 Vintl,69,,9,11,20
110 Vintl,70,,15,8,23
110 Vintl,71,,6,18,24
110 Vintl,72,,9,15,24
110 Vintl,73,,9,10,19
110 Vintl,74,,8,14,22
110 Vintl,75,,10,14,24
110 Vintl,76,,12,8,20
110 Vintl,77,,9,14,23
110 Vintl,78,,12,5,17
110 Vintl,79,,4,8,12
110 Vintl,80,,7,8,15
110 Vintl,81,,6,8,14
110 Vintl,82,,3,6,9
110 Vintl,83,,5,6,11
110 Vintl,84,,2,8,10
110 Vintl,85,,2,4,6
110 Vintl,86,,-,2,2
110 Vintl,87,,-,3,3
110 Vintl,88,,1,2,3
110 Vintl,89,,1,3,4
110 Vintl,90,,1,4,5
110 Vintl,91,,-,1,1
110 Vintl,92,,1,-,1
110 Vintl,93,,-,1,1
110 Vintl,94,,-,2,2
110 Vintl,97,,1,-,1
111 Vahrn,0,,23,25,48
111 Vahrn,1,,28,22,50
111 Vahrn,2,,28,28,56
111 Vahrn,3,,26,21,47
111 Vahrn,4,,24,19,43
111 Vahrn,5,,25,36,61
111 Vahrn,6,,21,21,42
111 Vahrn,7,,20,22,42
111 Vahrn,8,,37,20,57
111 Vahrn,9,,20,17,37
111 Vahrn,10,,20,23,43
111 Vahrn,11,,20,18,38
111 Vahrn,12,,17,23,40
111 Vahrn,13,,19,27,46
111 Vahrn,14,,15,27,42
111 Vahrn,15,,29,19,48
111 Vahrn,16,,23,18,41
111 Vahrn,17,,17,18,35
111 Vahrn,18,,21,16,37
111 Vahrn,19,,28,26,54
111 Vahrn,20,,20,21,41
111 Vahrn,21,,26,29,55
111 Vahrn,22,,24,24,48
111 Vahrn,23,,29,23,52
111 Vahrn,24,,22,24,46
111 Vahrn,25,,18,28,46
111 Vahrn,26,,24,26,50
111 Vahrn,27,,18,20,38
111 Vahrn,28,,40,20,60
111 Vahrn,29,,35,29,64
111 Vahrn,30,,24,33,57
111 Vahrn,31,,37,39,76
111 Vahrn,32,,33,32,65
111 Vahrn,33,,35,28,63
111 Vahrn,34,,41,42,83
111 Vahrn,35,,36,36,72
111 Vahrn,36,,27,29,56
111 Vahrn,37,,46,31,77
111 Vahrn,38,,37,29,66
111 Vahrn,39,,44,44,88
111 Vahrn,40,,35,35,70
111 Vahrn,41,,32,29,61
111 Vahrn,42,,31,32,63
111 Vahrn,43,,23,23,46
111 Vahrn,44,,31,30,61
111 Vahrn,45,,28,24,52
111 Vahrn,46,,18,18,36
111 Vahrn,47,,27,28,55
111 Vahrn,48,,20,19,39
111 Vahrn,49,,29,28,57
111 Vahrn,50,,20,30,50
111 Vahrn,51,,24,25,49
111 Vahrn,52,,25,17,42
111 Vahrn,53,,21,12,33
111 Vahrn,54,,16,18,34
111 Vahrn,55,,22,28,50
111 Vahrn,56,,18,16,34
111 Vahrn,57,,16,24,40
111 Vahrn,58,,20,23,43
111 Vahrn,59,,11,16,27
111 Vahrn,60,,19,20,39
111 Vahrn,61,,25,23,48
111 Vahrn,62,,19,22,41
111 Vahrn,63,,19,23,42
111 Vahrn,64,,20,15,35
111 Vahrn,65,,19,20,39
111 Vahrn,66,,15,9,24
111 Vahrn,67,,16,20,36
111 Vahrn,68,,11,17,28
111 Vahrn,69,,8,14,22
111 Vahrn,70,,10,15,25
111 Vahrn,71,,9,13,22
111 Vahrn,72,,11,13,24
111 Vahrn,73,,9,15,24
111 Vahrn,74,,15,16,31
111 Vahrn,75,,7,17,24
111 Vahrn,76,,8,12,20
111 Vahrn,77,,6,18,24
111 Vahrn,78,,6,4,10
111 Vahrn,79,,4,13,17
111 Vahrn,80,,6,16,22
111 Vahrn,81,,7,11,18
111 Vahrn,82,,5,10,15
111 Vahrn,83,,7,7,14
111 Vahrn,84,,2,4,6
111 Vahrn,85,,2,3,5
111 Vahrn,86,,1,4,5
111 Vahrn,87,,3,3,6
111 Vahrn,88,,1,-,1
111 Vahrn,89,,-,3,3
111 Vahrn,90,,1,2,3
111 Vahrn,91,,1,1,2
111 Vahrn,92,,1,2,3
111 Vahrn,93,,1,1,2
111 Vahrn,94,,-,1,1
111 Vahrn,95,,-,1,1
111 Vahrn,96,,-,1,1
111 Vahrn,98,,-,1,1
112 Vöran,0,,3,4,7
112 Vöran,1,,8,6,14
112 Vöran,2,,4,5,9
112 Vöran,3,,8,4,12
112 Vöran,4,,12,6,18
112 Vöran,5,,5,3,8
112 Vöran,6,,7,4,11
112 Vöran,7,,14,6,20
112 Vöran,8,,9,6,15
112 Vöran,9,,5,9,14
112 Vöran,10,,7,8,15
112 Vöran,11,,9,6,15
112 Vöran,12,,6,3,9
112 Vöran,13,,7,3,10
112 Vöran,14,,5,7,12
112 Vöran,15,,10,6,16
112 Vöran,16,,7,7,14
112 Vöran,17,,11,6,17
112 Vöran,18,,6,6,12
112 Vöran,19,,9,10,19
112 Vöran,20,,9,5,14
112 Vöran,21,,6,5,11
112 Vöran,22,,9,8,17
112 Vöran,23,,9,10,19
112 Vöran,24,,4,4,8
112 Vöran,25,,3,7,10
112 Vöran,26,,10,8,18
112 Vöran,27,,12,6,18
112 Vöran,28,,6,5,11
112 Vöran,29,,7,5,12
112 Vöran,30,,12,8,20
112 Vöran,31,,5,5,10
112 Vöran,32,,10,6,16
112 Vöran,33,,4,10,14
112 Vöran,34,,9,4,13
112 Vöran,35,,6,3,9
112 Vöran,36,,14,3,17
112 Vöran,37,,3,7,10
112 Vöran,38,,8,7,15
112 Vöran,39,,4,3,7
112 Vöran,40,,11,4,15
112 Vöran,41,,7,7,14
112 Vöran,42,,13,15,28
112 Vöran,43,,5,6,11
112 Vöran,44,,6,6,12
112 Vöran,45,,5,8,13
112 Vöran,46,,6,5,11
112 Vöran,47,,6,9,15
112 Vöran,48,,2,1,3
112 Vöran,49,,5,2,7
112 Vöran,50,,5,5,10
112 Vöran,51,,5,4,9
112 Vöran,52,,9,1,10
112 Vöran,53,,2,-,2
112 Vöran,54,,7,4,11
112 Vöran,55,,6,5,11
112 Vöran,56,,2,3,5
112 Vöran,57,,5,3,8
112 Vöran,58,,4,2,6
112 Vöran,59,,-,3,3
112 Vöran,60,,4,3,7
112 Vöran,61,,3,5,8
112 Vöran,62,,6,4,10
112 Vöran,63,,4,6,10
112 Vöran,64,,3,5,8
112 Vöran,65,,2,3,5
112 Vöran,66,,8,4,12
112 Vöran,67,,2,2,4
112 Vöran,68,,3,5,8
112 Vöran,69,,2,1,3
112 Vöran,70,,1,7,8
112 Vöran,71,,6,6,12
112 Vöran,72,,2,5,7
112 Vöran,73,,3,1,4
112 Vöran,74,,5,1,6
112 Vöran,75,,1,3,4
112 Vöran,76,,5,1,6
112 Vöran,77,,-,2,2
112 Vöran,78,,-,3,3
112 Vöran,79,,3,4,7
112 Vöran,80,,-,2,2
112 Vöran,81,,2,1,3
112 Vöran,82,,2,-,2
112 Vöran,83,,1,1,2
112 Vöran,84,,-,1,1
112 Vöran,88,,1,-,1
112 Vöran,95,,-,1,1
112 Vöran,100,,-,1,1
113 Niederdorf,0,,11,17,28
113 Niederdorf,1,,13,12,25
113 Niederdorf,2,,5,12,17
113 Niederdorf,3,,8,10,18
113 Niederdorf,4,,11,11,22
113 Niederdorf,5,,5,6,11
113 Niederdorf,6,,7,11,18
113 Niederdorf,7,,9,8,17
113 Niederdorf,8,,6,9,15
113 Niederdorf,9,,6,11,17
113 Niederdorf,10,,13,7,20
113 Niederdorf,11,,9,7,16
113 Niederdorf,12,,7,10,17
113 Niederdorf,13,,7,12,19
113 Niederdorf,14,,12,10,22
113 Niederdorf,15,,9,7,16
113 Niederdorf,16,,7,10,17
113 Niederdorf,17,,2,8,10
113 Niederdorf,18,,4,7,11
113 Niederdorf,19,,8,6,14
113 Niederdorf,20,,7,6,13
113 Niederdorf,21,,8,10,18
113 Niederdorf,22,,3,10,13
113 Niederdorf,23,,9,7,16
113 Niederdorf,24,,8,4,12
113 Niederdorf,25,,10,3,13
113 Niederdorf,26,,5,2,7
113 Niederdorf,27,,8,4,12
113 Niederdorf,28,,11,7,18
113 Niederdorf,29,,7,8,15
113 Niederdorf,30,,9,10,19
113 Niederdorf,31,,14,9,23
113 Niederdorf,32,,17,12,29
113 Niederdorf,33,,11,13,24
113 Niederdorf,34,,11,9,20
113 Niederdorf,35,,22,15,37
113 Niederdorf,36,,16,10,26
113 Niederdorf,37,,13,17,30
113 Niederdorf,38,,25,11,36
113 Niederdorf,39,,10,15,25
113 Niederdorf,40,,17,13,30
113 Niederdorf,41,,12,10,22
113 Niederdorf,42,,19,9,28
113 Niederdorf,43,,13,12,25
113 Niederdorf,44,,8,9,17
113 Niederdorf,45,,10,9,19
113 Niederdorf,46,,6,5,11
113 Niederdorf,47,,12,10,22
113 Niederdorf,48,,7,10,17
113 Niederdorf,49,,11,7,18
113 Niederdorf,50,,12,7,19
113 Niederdorf,51,,7,3,10
113 Niederdorf,52,,8,5,13
113 Niederdorf,53,,1,1,2
113 Niederdorf,54,,5,4,9
113 Niederdorf,55,,10,4,14
113 Niederdorf,56,,4,9,13
113 Niederdorf,57,,6,8,14
113 Niederdorf,58,,6,7,13
113 Niederdorf,59,,3,6,9
113 Niederdorf,60,,9,5,14
113 Niederdorf,61,,6,8,14
113 Niederdorf,62,,6,10,16
113 Niederdorf,63,,5,5,10
113 Niederdorf,64,,5,7,12
113 Niederdorf,65,,1,4,5
113 Niederdorf,66,,5,6,11
113 Niederdorf,67,,5,8,13
113 Niederdorf,68,,5,8,13
113 Niederdorf,69,,7,7,14
113 Niederdorf,70,,2,13,15
113 Niederdorf,71,,5,7,12
113 Niederdorf,72,,8,6,14
113 Niederdorf,73,,7,6,13
113 Niederdorf,74,,6,9,15
113 Niederdorf,75,,4,8,12
113 Niederdorf,76,,5,6,11
113 Niederdorf,77,,8,9,17
113 Niederdorf,78,,3,6,9
113 Niederdorf,79,,1,5,6
113 Niederdorf,80,,3,9,12
113 Niederdorf,81,,2,3,5
113 Niederdorf,82,,3,9,12
113 Niederdorf,83,,5,4,9
113 Niederdorf,84,,1,4,5
113 Niederdorf,85,,1,3,4
113 Niederdorf,86,,1,2,3
113 Niederdorf,87,,1,1,2
113 Niederdorf,88,,-,2,2
113 Niederdorf,89,,-,2,2
113 Niederdorf,90,,-,1,1
113 Niederdorf,91,,1,1,2
113 Niederdorf,92,,-,2,2
113 Niederdorf,93,,-,1,1
113 Niederdorf,94,,-,1,1
113 Niederdorf,99,,-,1,1
114 Villanders,0,,16,17,33
114 Villanders,1,,7,13,20
114 Villanders,2,,9,13,22
114 Villanders,3,,13,12,25
114 Villanders,4,,10,16,26
114 Villanders,5,,13,10,23
114 Villanders,6,,13,9,22
114 Villanders,7,,10,12,22
114 Villanders,8,,15,8,23
114 Villanders,9,,18,5,23
114 Villanders,10,,11,13,24
114 Villanders,11,,7,17,24
114 Villanders,12,,14,8,22
114 Villanders,13,,18,15,33
114 Villanders,14,,16,14,30
114 Villanders,15,,15,10,25
114 Villanders,16,,10,12,22
114 Villanders,17,,6,15,21
114 Villanders,18,,9,8,17
114 Villanders,19,,10,11,21
114 Villanders,20,,13,14,27
114 Villanders,21,,14,6,20
114 Villanders,22,,15,12,27
114 Villanders,23,,19,15,34
114 Villanders,24,,11,17,28
114 Villanders,25,,16,9,25
114 Villanders,26,,11,13,24
114 Villanders,27,,17,15,32
114 Villanders,28,,13,10,23
114 Villanders,29,,9,13,22
114 Villanders,30,,14,16,30
114 Villanders,31,,12,20,32
114 Villanders,32,,14,16,30
114 Villanders,33,,17,23,40
114 Villanders,34,,18,9,27
114 Villanders,35,,28,19,47
114 Villanders,36,,25,10,35
114 Villanders,37,,18,14,32
114 Villanders,38,,21,16,37
114 Villanders,39,,21,17,38
114 Villanders,40,,23,16,39
114 Villanders,41,,16,14,30
114 Villanders,42,,18,11,29
114 Villanders,43,,15,12,27
114 Villanders,44,,19,6,25
114 Villanders,45,,16,11,27
114 Villanders,46,,18,7,25
114 Villanders,47,,10,7,17
114 Villanders,48,,10,12,22
114 Villanders,49,,10,17,27
114 Villanders,50,,9,5,14
114 Villanders,51,,10,9,19
114 Villanders,52,,11,7,18
114 Villanders,53,,10,7,17
114 Villanders,54,,10,8,18
114 Villanders,55,,11,5,16
114 Villanders,56,,7,11,18
114 Villanders,57,,6,7,13
114 Villanders,58,,10,10,20
114 Villanders,59,,6,3,9
114 Villanders,60,,5,9,14
114 Villanders,61,,7,8,15
114 Villanders,62,,10,8,18
114 Villanders,63,,8,9,17
114 Villanders,64,,9,12,21
114 Villanders,65,,7,5,12
114 Villanders,66,,8,6,14
114 Villanders,67,,5,9,14
114 Villanders,68,,6,6,12
114 Villanders,69,,2,8,10
114 Villanders,70,,1,9,10
114 Villanders,71,,9,9,18
114 Villanders,72,,9,9,18
114 Villanders,73,,5,7,12
114 Villanders,74,,8,5,13
114 Villanders,75,,3,9,12
114 Villanders,76,,3,8,11
114 Villanders,77,,8,6,14
114 Villanders,78,,5,5,10
114 Villanders,79,,2,7,9
114 Villanders,80,,5,5,10
114 Villanders,81,,5,3,8
114 Villanders,82,,2,5,7
114 Villanders,83,,2,9,11
114 Villanders,84,,4,4,8
114 Villanders,85,,-,2,2
114 Villanders,87,,-,1,1
114 Villanders,88,,-,1,1
114 Villanders,89,,-,2,2
114 Villanders,90,,1,3,4
114 Villanders,91,,1,2,3
114 Villanders,92,,1,2,3
114 Villanders,93,,-,2,2
114 Villanders,95,,-,1,1
114 Villanders,98,,1,-,1
114 Villanders,101,,-,1,1
115 Sterzing,0,,31,33,64
115 Sterzing,1,,26,38,64
115 Sterzing,2,,36,26,62
115 Sterzing,3,,37,31,68
115 Sterzing,4,,28,35,63
115 Sterzing,5,,26,25,51
115 Sterzing,6,,24,30,54
115 Sterzing,7,,30,32,62
115 Sterzing,8,,27,35,62
115 Sterzing,9,,33,29,62
115 Sterzing,10,,32,20,52
115 Sterzing,11,,34,29,63
115 Sterzing,12,,30,33,63
115 Sterzing,13,,33,33,66
115 Sterzing,14,,23,33,56
115 Sterzing,15,,39,19,58
115 Sterzing,16,,28,27,55
115 Sterzing,17,,29,24,53
115 Sterzing,18,,36,30,66
115 Sterzing,19,,16,29,45
115 Sterzing,20,,31,27,58
115 Sterzing,21,,32,32,64
115 Sterzing,22,,38,37,75
115 Sterzing,23,,69,35,104
115 Sterzing,24,,48,44,92
115 Sterzing,25,,44,47,91
115 Sterzing,26,,58,34,92
115 Sterzing,27,,52,42,94
115 Sterzing,28,,41,41,82
115 Sterzing,29,,61,46,107
115 Sterzing,30,,53,36,89
115 Sterzing,31,,45,58,103
115 Sterzing,32,,55,55,110
115 Sterzing,33,,61,48,109
115 Sterzing,34,,51,52,103
115 Sterzing,35,,44,39,83
115 Sterzing,36,,56,50,106
115 Sterzing,37,,62,41,103
115 Sterzing,38,,50,50,100
115 Sterzing,39,,58,48,106
115 Sterzing,40,,47,43,90
115 Sterzing,41,,54,52,106
115 Sterzing,42,,40,47,87
115 Sterzing,43,,42,34,76
115 Sterzing,44,,46,46,92
115 Sterzing,45,,52,41,93
115 Sterzing,46,,44,39,83
115 Sterzing,47,,36,49,85
115 Sterzing,48,,45,27,72
115 Sterzing,49,,34,46,80
115 Sterzing,50,,34,36,70
115 Sterzing,51,,31,40,71
115 Sterzing,52,,43,38,81
115 Sterzing,53,,37,42,79
115 Sterzing,54,,39,40,79
115 Sterzing,55,,34,49,83
115 Sterzing,56,,38,43,81
115 Sterzing,57,,30,29,59
115 Sterzing,58,,45,43,88
115 Sterzing,59,,38,36,74
115 Sterzing,60,,34,29,63
115 Sterzing,61,,45,44,89
115 Sterzing,62,,30,35,65
115 Sterzing,63,,30,28,58
115 Sterzing,64,,41,32,73
115 Sterzing,65,,27,29,56
115 Sterzing,66,,31,29,60
115 Sterzing,67,,22,36,58
115 Sterzing,68,,23,44,67
115 Sterzing,69,,23,22,45
115 Sterzing,70,,18,24,42
115 Sterzing,71,,26,29,55
115 Sterzing,72,,15,16,31
115 Sterzing,73,,23,32,55
115 Sterzing,74,,8,24,32
115 Sterzing,75,,20,20,40
115 Sterzing,76,,18,28,46
115 Sterzing,77,,20,18,38
115 Sterzing,78,,12,20,32
115 Sterzing,79,,5,18,23
115 Sterzing,80,,11,18,29
115 Sterzing,81,,12,18,30
115 Sterzing,82,,11,21,32
115 Sterzing,83,,3,15,18
115 Sterzing,84,,3,8,11
115 Sterzing,85,,5,5,10
115 Sterzing,86,,3,4,7
115 Sterzing,87,,3,2,5
115 Sterzing,88,,2,5,7
115 Sterzing,89,,2,3,5
115 Sterzing,90,,2,9,11
115 Sterzing,91,,1,2,3
115 Sterzing,92,,-,5,5
115 Sterzing,93,,-,2,2
115 Sterzing,94,,-,2,2
115 Sterzing,95,,1,1,2
115 Sterzing,96,,1,-,1
115 Sterzing,97,,-,1,1
115 Sterzing,98,,-,1,1
115 Sterzing,103,,-,1,1
116 Feldthurns,0,,22,16,38
116 Feldthurns,1,,13,14,27
116 Feldthurns,2,,23,25,48
116 Feldthurns,3,,16,20,36
116 Feldthurns,4,,25,14,39
116 Feldthurns,5,,18,24,42
116 Feldthurns,6,,22,19,41
116 Feldthurns,7,,22,16,38
116 Feldthurns,8,,16,20,36
116 Feldthurns,9,,19,19,38
116 Feldthurns,10,,15,17,32
116 Feldthurns,11,,27,20,47
116 Feldthurns,12,,17,19,36
116 Feldthurns,13,,13,13,26
116 Feldthurns,14,,13,17,30
116 Feldthurns,15,,20,14,34
116 Feldthurns,16,,15,19,34
116 Feldthurns,17,,21,13,34
116 Feldthurns,18,,18,20,38
116 Feldthurns,19,,13,20,33
116 Feldthurns,20,,16,19,35
116 Feldthurns,21,,26,23,49
116 Feldthurns,22,,15,20,35
116 Feldthurns,23,,20,20,40
116 Feldthurns,24,,11,25,36
116 Feldthurns,25,,13,15,28
116 Feldthurns,26,,31,23,54
116 Feldthurns,27,,21,19,40
116 Feldthurns,28,,23,26,49
116 Feldthurns,29,,17,16,33
116 Feldthurns,30,,26,33,59
116 Feldthurns,31,,21,18,39
116 Feldthurns,32,,35,30,65
116 Feldthurns,33,,18,27,45
116 Feldthurns,34,,19,20,39
116 Feldthurns,35,,22,27,49
116 Feldthurns,36,,20,28,48
116 Feldthurns,37,,24,22,46
116 Feldthurns,38,,21,20,41
116 Feldthurns,39,,25,28,53
116 Feldthurns,40,,24,18,42
116 Feldthurns,41,,27,19,46
116 Feldthurns,42,,15,17,32
116 Feldthurns,43,,17,17,34
116 Feldthurns,44,,17,12,29
116 Feldthurns,45,,15,15,30
116 Feldthurns,46,,15,20,35
116 Feldthurns,47,,14,13,27
116 Feldthurns,48,,11,18,29
116 Feldthurns,49,,14,13,27
116 Feldthurns,50,,13,15,28
116 Feldthurns,51,,18,13,31
116 Feldthurns,52,,22,15,37
116 Feldthurns,53,,14,12,26
116 Feldthurns,54,,14,14,28
116 Feldthurns,55,,7,15,22
116 Feldthurns,56,,14,12,26
116 Feldthurns,57,,16,8,24
116 Feldthurns,58,,10,9,19
116 Feldthurns,59,,13,13,26
116 Feldthurns,60,,20,11,31
116 Feldthurns,61,,13,12,25
116 Feldthurns,62,,9,7,16
116 Feldthurns,63,,8,4,12
116 Feldthurns,64,,11,7,18
116 Feldthurns,65,,7,11,18
116 Feldthurns,66,,11,8,19
116 Feldthurns,67,,4,10,14
116 Feldthurns,68,,8,10,18
116 Feldthurns,69,,10,11,21
116 Feldthurns,70,,2,5,7
116 Feldthurns,71,,7,4,11
116 Feldthurns,72,,7,10,17
116 Feldthurns,73,,5,6,11
116 Feldthurns,74,,4,13,17
116 Feldthurns,75,,4,11,15
116 Feldthurns,76,,9,4,13
116 Feldthurns,77,,5,5,10
116 Feldthurns,78,,3,7,10
116 Feldthurns,79,,5,7,12
116 Feldthurns,80,,4,9,13
116 Feldthurns,81,,6,8,14
116 Feldthurns,82,,2,8,10
116 Feldthurns,83,,2,9,11
116 Feldthurns,84,,5,10,15
116 Feldthurns,85,,5,7,12
116 Feldthurns,86,,3,-,3
116 Feldthurns,87,,-,2,2
116 Feldthurns,88,,-,3,3
116 Feldthurns,89,,2,6,8
116 Feldthurns,90,,1,3,4
116 Feldthurns,91,,-,1,1
116 Feldthurns,92,,1,1,2
116 Feldthurns,93,,-,1,1
116 Feldthurns,95,,1,-,1
117 Wengen,0,,6,8,14
117 Wengen,1,,5,7,12
117 Wengen,2,,10,4,14
117 Wengen,3,,5,11,16
117 Wengen,4,,10,6,16
117 Wengen,5,,9,5,14
117 Wengen,6,,7,8,15
117 Wengen,7,,12,7,19
117 Wengen,8,,9,8,17
117 Wengen,9,,11,9,20
117 Wengen,10,,12,7,19
117 Wengen,11,,10,7,17
117 Wengen,12,,10,7,17
117 Wengen,13,,17,8,25
117 Wengen,14,,12,7,19
117 Wengen,15,,6,7,13
117 Wengen,16,,6,9,15
117 Wengen,17,,11,5,16
117 Wengen,18,,8,8,16
117 Wengen,19,,9,6,15
117 Wengen,20,,14,7,21
117 Wengen,21,,13,5,18
117 Wengen,22,,11,5,16
117 Wengen,23,,6,8,14
117 Wengen,24,,9,11,20
117 Wengen,25,,13,6,19
117 Wengen,26,,7,6,13
117 Wengen,27,,10,8,18
117 Wengen,28,,6,7,13
117 Wengen,29,,17,9,26
117 Wengen,30,,10,6,16
117 Wengen,31,,17,11,28
117 Wengen,32,,11,11,22
117 Wengen,33,,12,12,24
117 Wengen,34,,11,13,24
117 Wengen,35,,9,12,21
117 Wengen,36,,18,10,28
117 Wengen,37,,10,12,22
117 Wengen,38,,13,5,18
117 Wengen,39,,8,10,18
117 Wengen,40,,11,5,16
117 Wengen,41,,12,13,25
117 Wengen,42,,14,7,21
117 Wengen,43,,8,9,17
117 Wengen,44,,10,12,22
117 Wengen,45,,7,6,13
117 Wengen,46,,6,8,14
117 Wengen,47,,6,11,17
117 Wengen,48,,5,6,11
117 Wengen,49,,8,6,14
117 Wengen,50,,9,4,13
117 Wengen,51,,6,2,8
117 Wengen,52,,6,7,13
117 Wengen,53,,9,6,15
117 Wengen,54,,3,6,9
117 Wengen,55,,5,9,14
117 Wengen,56,,2,12,14
117 Wengen,57,,6,3,9
117 Wengen,58,,5,3,8
117 Wengen,59,,6,3,9
117 Wengen,60,,9,8,17
117 Wengen,61,,3,7,10
117 Wengen,62,,8,6,14
117 Wengen,63,,4,4,8
117 Wengen,64,,7,9,16
117 Wengen,65,,6,3,9
117 Wengen,66,,5,4,9
117 Wengen,67,,7,7,14
117 Wengen,68,,2,1,3
117 Wengen,69,,2,7,9
117 Wengen,70,,2,10,12
117 Wengen,71,,4,2,6
117 Wengen,72,,2,7,9
117 Wengen,73,,6,2,8
117 Wengen,74,,4,2,6
117 Wengen,75,,2,9,11
117 Wengen,76,,2,3,5
117 Wengen,77,,4,5,9
117 Wengen,78,,4,5,9
117 Wengen,79,,3,4,7
117 Wengen,80,,-,6,6
117 Wengen,81,,3,6,9
117 Wengen,82,,3,4,7
117 Wengen,83,,4,7,11
117 Wengen,84,,1,2,3
117 Wengen,85,,1,-,1
117 Wengen,87,,2,-,2
117 Wengen,89,,1,1,2
117 Wengen,91,,-,2,2
117 Wengen,92,,1,-,1
117 Wengen,94,,-,1,1
117 Wengen,98,,1,-,1
117 Wengen,100,,-,1,1
118 U.L.Frau i.W.-St.Felix,0,,6,3,9
118 U.L.Frau i.W.-St.Felix,1,,8,8,16
118 U.L.Frau i.W.-St.Felix,2,,5,3,8
118 U.L.Frau i.W.-St.Felix,3,,6,5,11
118 U.L.Frau i.W.-St.Felix,4,,5,2,7
118 U.L.Frau i.W.-St.Felix,5,,5,5,10
118 U.L.Frau i.W.-St.Felix,6,,6,8,14
118 U.L.Frau i.W.-St.Felix,7,,5,5,10
118 U.L.Frau i.W.-St.Felix,8,,8,5,13
118 U.L.Frau i.W.-St.Felix,9,,4,10,14
118 U.L.Frau i.W.-St.Felix,10,,7,8,15
118 U.L.Frau i.W.-St.Felix,11,,9,7,16
118 U.L.Frau i.W.-St.Felix,12,,7,4,11
118 U.L.Frau i.W.-St.Felix,13,,10,9,19
118 U.L.Frau i.W.-St.Felix,14,,8,4,12
118 U.L.Frau i.W.-St.Felix,15,,8,6,14
118 U.L.Frau i.W.-St.Felix,16,,8,6,14
118 U.L.Frau i.W.-St.Felix,17,,4,7,11
118 U.L.Frau i.W.-St.Felix,18,,7,4,11
118 U.L.Frau i.W.-St.Felix,19,,5,7,12
118 U.L.Frau i.W.-St.Felix,20,,5,5,10
118 U.L.Frau i.W.-St.Felix,21,,2,12,14
118 U.L.Frau i.W.-St.Felix,22,,3,6,9
118 U.L.Frau i.W.-St.Felix,23,,6,4,10
118 U.L.Frau i.W.-St.Felix,24,,3,6,9
118 U.L.Frau i.W.-St.Felix,25,,1,4,5
118 U.L.Frau i.W.-St.Felix,26,,1,5,6
118 U.L.Frau i.W.-St.Felix,27,,6,3,9
118 U.L.Frau i.W.-St.Felix,28,,4,8,12
118 U.L.Frau i.W.-St.Felix,29,,8,2,10
118 U.L.Frau i.W.-St.Felix,30,,5,5,10
118 U.L.Frau i.W.-St.Felix,31,,3,4,7
118 U.L.Frau i.W.-St.Felix,32,,8,4,12
118 U.L.Frau i.W.-St.Felix,33,,2,5,7
118 U.L.Frau i.W.-St.Felix,34,,5,8,13
118 U.L.Frau i.W.-St.Felix,35,,7,4,11
118 U.L.Frau i.W.-St.Felix,36,,5,9,14
118 U.L.Frau i.W.-St.Felix,37,,5,4,9
118 U.L.Frau i.W.-St.Felix,38,,8,7,15
118 U.L.Frau i.W.-St.Felix,39,,10,6,16
118 U.L.Frau i.W.-St.Felix,40,,5,8,13
118 U.L.Frau i.W.-St.Felix,41,,16,8,24
118 U.L.Frau i.W.-St.Felix,42,,8,11,19
118 U.L.Frau i.W.-St.Felix,43,,4,4,8
118 U.L.Frau i.W.-St.Felix,44,,8,9,17
118 U.L.Frau i.W.-St.Felix,45,,5,5,10
118 U.L.Frau i.W.-St.Felix,46,,4,2,6
118 U.L.Frau i.W.-St.Felix,47,,3,6,9
118 U.L.Frau i.W.-St.Felix,48,,5,6,11
118 U.L.Frau i.W.-St.Felix,49,,3,4,7
118 U.L.Frau i.W.-St.Felix,50,,7,3,10
118 U.L.Frau i.W.-St.Felix,51,,3,3,6
118 U.L.Frau i.W.-St.Felix,52,,6,3,9
118 U.L.Frau i.W.-St.Felix,53,,6,3,9
118 U.L.Frau i.W.-St.Felix,54,,4,3,7
118 U.L.Frau i.W.-St.Felix,55,,5,-,5
118 U.L.Frau i.W.-St.Felix,56,,4,2,6
118 U.L.Frau i.W.-St.Felix,57,,2,7,9
118 U.L.Frau i.W.-St.Felix,58,,1,4,5
118 U.L.Frau i.W.-St.Felix,59,,3,1,4
118 U.L.Frau i.W.-St.Felix,60,,5,1,6
118 U.L.Frau i.W.-St.Felix,61,,7,4,11
118 U.L.Frau i.W.-St.Felix,62,,5,4,9
118 U.L.Frau i.W.-St.Felix,63,,5,9,14
118 U.L.Frau i.W.-St.Felix,64,,3,1,4
118 U.L.Frau i.W.-St.Felix,65,,1,4,5
118 U.L.Frau i.W.-St.Felix,66,,3,4,7
118 U.L.Frau i.W.-St.Felix,67,,3,-,3
118 U.L.Frau i.W.-St.Felix,68,,5,2,7
118 U.L.Frau i.W.-St.Felix,69,,3,3,6
118 U.L.Frau i.W.-St.Felix,70,,3,3,6
118 U.L.Frau i.W.-St.Felix,71,,5,4,9
118 U.L.Frau i.W.-St.Felix,72,,7,1,8
118 U.L.Frau i.W.-St.Felix,73,,4,1,5
118 U.L.Frau i.W.-St.Felix,74,,4,5,9
118 U.L.Frau i.W.-St.Felix,75,,1,3,4
118 U.L.Frau i.W.-St.Felix,76,,3,5,8
118 U.L.Frau i.W.-St.Felix,77,,3,4,7
118 U.L.Frau i.W.-St.Felix,78,,2,3,5
118 U.L.Frau i.W.-St.Felix,79,,4,5,9
118 U.L.Frau i.W.-St.Felix,80,,3,4,7
118 U.L.Frau i.W.-St.Felix,81,,2,4,6
118 U.L.Frau i.W.-St.Felix,82,,1,-,1
118 U.L.Frau i.W.-St.Felix,83,,-,3,3
118 U.L.Frau i.W.-St.Felix,84,,-,1,1
118 U.L.Frau i.W.-St.Felix,85,,1,2,3
118 U.L.Frau i.W.-St.Felix,87,,1,-,1
118 U.L.Frau i.W.-St.Felix,90,,-,1,1
118 U.L.Frau i.W.-St.Felix,91,,1,1,2
118 U.L.Frau i.W.-St.Felix,92,,2,-,2
118 U.L.Frau i.W.-St.Felix,94,,-,2,2

