Gemeinde,Altersklassen,Geschlecht,Männer,Frauen,Insgesamt
001 Aldein,0,,14,9,23
001 Aldein,1,,16,10,26
001 Aldein,2,,17,8,25
001 Aldein,3,,10,11,21
001 Aldein,4,,18,9,27
001 Aldein,5,,12,4,16
001 Aldein,6,,16,15,31
001 Aldein,7,,11,15,26
001 Aldein,8,,14,9,23
001 Aldein,9,,7,8,15
001 Aldein,10,,9,12,21
001 Aldein,11,,14,8,22
001 Aldein,12,,13,12,25
001 Aldein,13,,9,13,22
001 Aldein,14,,7,9,16
001 Aldein,15,,8,6,14
001 Aldein,16,,9,16,25
001 Aldein,17,,11,9,20
001 Aldein,18,,11,7,18
001 Aldein,19,,11,10,21
001 Aldein,20,,13,13,26
001 Aldein,21,,10,8,18
001 Aldein,22,,14,14,28
001 Aldein,23,,13,6,19
001 Aldein,24,,10,14,24
001 Aldein,25,,9,13,22
001 Aldein,26,,11,16,27
001 Aldein,27,,10,6,16
001 Aldein,28,,6,22,28
001 Aldein,29,,10,16,26
001 Aldein,30,,16,15,31
001 Aldein,31,,11,14,25
001 Aldein,32,,15,9,24
001 Aldein,33,,18,12,30
001 Aldein,34,,15,14,29
001 Aldein,35,,13,13,26
001 Aldein,36,,23,7,30
001 Aldein,37,,12,16,28
001 Aldein,38,,6,15,21
001 Aldein,39,,7,20,27
001 Aldein,40,,18,10,28
001 Aldein,41,,14,11,25
001 Aldein,42,,15,6,21
001 Aldein,43,,8,17,25
001 Aldein,44,,15,15,30
001 Aldein,45,,15,9,24
001 Aldein,46,,12,14,26
001 Aldein,47,,8,5,13
001 Aldein,48,,9,10,19
001 Aldein,49,,10,8,18
001 Aldein,50,,9,9,18
001 Aldein,51,,9,6,15
001 Aldein,52,,8,9,17
001 Aldein,53,,7,5,12
001 Aldein,54,,16,10,26
001 Aldein,55,,5,12,17
001 Aldein,56,,8,6,14
001 Aldein,57,,9,9,18
001 Aldein,58,,6,10,16
001 Aldein,59,,7,12,19
001 Aldein,60,,10,5,15
001 Aldein,61,,5,7,12
001 Aldein,62,,11,11,22
001 Aldein,63,,8,12,20
001 Aldein,64,,5,12,17
001 Aldein,65,,9,8,17
001 Aldein,66,,5,8,13
001 Aldein,67,,7,7,14
001 Aldein,68,,7,10,17
001 Aldein,69,,8,6,14
001 Aldein,70,,4,4,8
001 Aldein,71,,14,5,19
001 Aldein,72,,8,4,12
001 Aldein,73,,4,7,11
001 Aldein,74,,7,4,11
001 Aldein,75,,4,5,9
001 Aldein,76,,7,8,15
001 Aldein,77,,5,2,7
001 Aldein,78,,5,5,10
001 Aldein,79,,-,5,5
001 Aldein,80,,1,5,6
001 Aldein,81,,-,8,8
001 Aldein,82,,2,5,7
001 Aldein,83,,1,9,10
001 Aldein,84,,3,8,11
001 Aldein,85,,4,1,5
001 Aldein,86,,-,4,4
001 Aldein,89,,1,1,2
001 Aldein,92,,-,2,2
001 Aldein,93,,-,2,2
001 Aldein,98,,-,1,1
002 Andrian,0,,9,6,15
002 Andrian,1,,9,3,12
002 Andrian,2,,7,10,17
002 Andrian,3,,3,-,3
002 Andrian,4,,3,2,5
002 Andrian,5,,6,5,11
002 Andrian,6,,3,6,9
002 Andrian,7,,8,1,9
002 Andrian,8,,10,6,16
002 Andrian,9,,2,11,13
002 Andrian,10,,8,4,12
002 Andrian,11,,5,5,10
002 Andrian,12,,5,5,10
002 Andrian,13,,6,6,12
002 Andrian,14,,5,7,12
002 Andrian,15,,5,5,10
002 Andrian,16,,4,4,8
002 Andrian,17,,12,7,19
002 Andrian,18,,6,8,14
002 Andrian,19,,9,6,15
002 Andrian,20,,1,3,4
002 Andrian,21,,8,5,13
002 Andrian,22,,7,2,9
002 Andrian,23,,10,8,18
002 Andrian,24,,2,3,5
002 Andrian,25,,7,5,12
002 Andrian,26,,5,6,11
002 Andrian,27,,4,3,7
002 Andrian,28,,7,6,13
002 Andrian,29,,6,5,11
002 Andrian,30,,8,4,12
002 Andrian,31,,6,10,16
002 Andrian,32,,8,9,17
002 Andrian,33,,7,7,14
002 Andrian,34,,7,10,17
002 Andrian,35,,13,5,18
002 Andrian,36,,7,7,14
002 Andrian,37,,9,12,21
002 Andrian,38,,8,7,15
002 Andrian,39,,9,8,17
002 Andrian,40,,10,11,21
002 Andrian,41,,10,7,17
002 Andrian,42,,6,12,18
002 Andrian,43,,10,8,18
002 Andrian,44,,7,3,10
002 Andrian,45,,8,4,12
002 Andrian,46,,7,6,13
002 Andrian,47,,7,8,15
002 Andrian,48,,4,6,10
002 Andrian,49,,5,9,14
002 Andrian,50,,2,4,6
002 Andrian,51,,6,2,8
002 Andrian,52,,7,7,14
002 Andrian,53,,2,3,5
002 Andrian,54,,3,3,6
002 Andrian,55,,7,5,12
002 Andrian,56,,4,2,6
002 Andrian,57,,6,4,10
002 Andrian,58,,5,4,9
002 Andrian,59,,4,8,12
002 Andrian,60,,1,3,4
002 Andrian,61,,1,4,5
002 Andrian,62,,6,7,13
002 Andrian,63,,4,5,9
002 Andrian,64,,6,4,10
002 Andrian,65,,3,7,10
002 Andrian,66,,1,7,8
002 Andrian,67,,4,3,7
002 Andrian,68,,5,4,9
002 Andrian,69,,2,2,4
002 Andrian,70,,3,2,5
002 Andrian,71,,5,3,8
002 Andrian,72,,3,4,7
002 Andrian,73,,7,5,12
002 Andrian,74,,3,4,7
002 Andrian,75,,4,2,6
002 Andrian,76,,2,1,3
002 Andrian,77,,1,4,5
002 Andrian,78,,-,2,2
002 Andrian,79,,3,4,7
002 Andrian,80,,2,1,3
002 Andrian,81,,2,4,6
002 Andrian,82,,-,1,1
002 Andrian,83,,1,4,5
002 Andrian,84,,1,4,5
002 Andrian,85,,1,-,1
002 Andrian,86,,2,1,3
002 Andrian,87,,1,1,2
002 Andrian,89,,1,-,1
002 Andrian,90,,-,2,2
002 Andrian,91,,1,1,2
002 Andrian,92,,-,1,1
002 Andrian,93,,-,1,1
002 Andrian,94,,-,1,1
002 Andrian,98,,-,1,1
003 Altrei,0,,3,1,4
003 Altrei,1,,2,1,3
003 Altrei,2,,-,1,1
003 Altrei,3,,3,1,4
003 Altrei,4,,3,1,4
003 Altrei,5,,1,1,2
003 Altrei,6,,3,-,3
003 Altrei,7,,3,1,4
003 Altrei,8,,1,1,2
003 Altrei,9,,-,3,3
003 Altrei,10,,1,2,3
003 Altrei,11,,3,2,5
003 Altrei,12,,3,-,3
003 Altrei,13,,6,3,9
003 Altrei,14,,1,1,2
003 Altrei,15,,3,2,5
003 Altrei,16,,2,2,4
003 Altrei,17,,4,5,9
003 Altrei,18,,2,1,3
003 Altrei,19,,3,3,6
003 Altrei,20,,3,1,4
003 Altrei,21,,4,1,5
003 Altrei,22,,4,1,5
003 Altrei,23,,3,2,5
003 Altrei,24,,3,1,4
003 Altrei,25,,3,3,6
003 Altrei,26,,-,2,2
003 Altrei,27,,2,6,8
003 Altrei,28,,-,3,3
003 Altrei,29,,2,3,5
003 Altrei,30,,3,1,4
003 Altrei,31,,1,-,1
003 Altrei,32,,2,4,6
003 Altrei,33,,3,1,4
003 Altrei,34,,5,4,9
003 Altrei,35,,1,3,4
003 Altrei,36,,3,5,8
003 Altrei,37,,1,4,5
003 Altrei,38,,4,1,5
003 Altrei,39,,3,4,7
003 Altrei,40,,2,5,7
003 Altrei,41,,3,6,9
003 Altrei,42,,2,2,4
003 Altrei,43,,11,2,13
003 Altrei,44,,2,3,5
003 Altrei,45,,5,2,7
003 Altrei,46,,5,3,8
003 Altrei,47,,2,3,5
003 Altrei,48,,1,3,4
003 Altrei,49,,5,1,6
003 Altrei,50,,3,3,6
003 Altrei,51,,1,1,2
003 Altrei,52,,3,2,5
003 Altrei,53,,6,3,9
003 Altrei,54,,5,3,8
003 Altrei,55,,1,2,3
003 Altrei,56,,1,-,1
003 Altrei,57,,3,3,6
003 Altrei,58,,3,2,5
003 Altrei,59,,2,3,5
003 Altrei,60,,3,1,4
003 Altrei,61,,2,3,5
003 Altrei,62,,1,3,4
003 Altrei,63,,3,1,4
003 Altrei,64,,2,3,5
003 Altrei,65,,1,4,5
003 Altrei,66,,2,3,5
003 Altrei,67,,1,1,2
003 Altrei,68,,2,1,3
003 Altrei,69,,3,1,4
003 Altrei,70,,3,2,5
003 Altrei,71,,-,2,2
003 Altrei,72,,3,2,5
003 Altrei,73,,-,3,3
003 Altrei,74,,-,2,2
003 Altrei,75,,2,2,4
003 Altrei,76,,2,2,4
003 Altrei,77,,-,2,2
003 Altrei,78,,2,4,6
003 Altrei,79,,1,4,5
003 Altrei,80,,-,1,1
003 Altrei,81,,1,2,3
003 Altrei,82,,-,1,1
003 Altrei,83,,1,1,2
003 Altrei,84,,-,1,1
003 Altrei,85,,1,1,2
003 Altrei,88,,-,2,2
003 Altrei,90,,-,1,1
003 Altrei,91,,-,1,1
003 Altrei,92,,1,-,1
003 Altrei,94,,-,2,2
003 Altrei,97,,-,1,1
004 Eppan a.d. Weinstr.,0,,83,102,185
004 Eppan a.d. Weinstr.,1,,88,62,150
004 Eppan a.d. Weinstr.,2,,85,67,152
004 Eppan a.d. Weinstr.,3,,79,73,152
004 Eppan a.d. Weinstr.,4,,77,73,150
004 Eppan a.d. Weinstr.,5,,72,81,153
004 Eppan a.d. Weinstr.,6,,88,55,143
004 Eppan a.d. Weinstr.,7,,86,80,166
004 Eppan a.d. Weinstr.,8,,73,72,145
004 Eppan a.d. Weinstr.,9,,75,71,146
004 Eppan a.d. Weinstr.,10,,72,70,142
004 Eppan a.d. Weinstr.,11,,74,79,153
004 Eppan a.d. Weinstr.,12,,80,86,166
004 Eppan a.d. Weinstr.,13,,68,76,144
004 Eppan a.d. Weinstr.,14,,78,61,139
004 Eppan a.d. Weinstr.,15,,84,65,149
004 Eppan a.d. Weinstr.,16,,80,62,142
004 Eppan a.d. Weinstr.,17,,82,82,164
004 Eppan a.d. Weinstr.,18,,72,64,136
004 Eppan a.d. Weinstr.,19,,88,70,158
004 Eppan a.d. Weinstr.,20,,79,57,136
004 Eppan a.d. Weinstr.,21,,75,76,151
004 Eppan a.d. Weinstr.,22,,68,71,139
004 Eppan a.d. Weinstr.,23,,71,75,146
004 Eppan a.d. Weinstr.,24,,61,79,140
004 Eppan a.d. Weinstr.,25,,86,72,158
004 Eppan a.d. Weinstr.,26,,77,82,159
004 Eppan a.d. Weinstr.,27,,87,76,163
004 Eppan a.d. Weinstr.,28,,83,75,158
004 Eppan a.d. Weinstr.,29,,86,82,168
004 Eppan a.d. Weinstr.,30,,91,95,186
004 Eppan a.d. Weinstr.,31,,91,102,193
004 Eppan a.d. Weinstr.,32,,99,99,198
004 Eppan a.d. Weinstr.,33,,110,125,235
004 Eppan a.d. Weinstr.,34,,108,104,212
004 Eppan a.d. Weinstr.,35,,132,121,253
004 Eppan a.d. Weinstr.,36,,131,123,254
004 Eppan a.d. Weinstr.,37,,124,114,238
004 Eppan a.d. Weinstr.,38,,132,118,250
004 Eppan a.d. Weinstr.,39,,125,139,264
004 Eppan a.d. Weinstr.,40,,104,113,217
004 Eppan a.d. Weinstr.,41,,129,117,246
004 Eppan a.d. Weinstr.,42,,104,128,232
004 Eppan a.d. Weinstr.,43,,122,113,235
004 Eppan a.d. Weinstr.,44,,121,100,221
004 Eppan a.d. Weinstr.,45,,109,117,226
004 Eppan a.d. Weinstr.,46,,119,107,226
004 Eppan a.d. Weinstr.,47,,107,101,208
004 Eppan a.d. Weinstr.,48,,97,94,191
004 Eppan a.d. Weinstr.,49,,87,75,162
004 Eppan a.d. Weinstr.,50,,88,86,174
004 Eppan a.d. Weinstr.,51,,68,87,155
004 Eppan a.d. Weinstr.,52,,85,77,162
004 Eppan a.d. Weinstr.,53,,70,84,154
004 Eppan a.d. Weinstr.,54,,84,64,148
004 Eppan a.d. Weinstr.,55,,59,72,131
004 Eppan a.d. Weinstr.,56,,64,61,125
004 Eppan a.d. Weinstr.,57,,78,70,148
004 Eppan a.d. Weinstr.,58,,63,81,144
004 Eppan a.d. Weinstr.,59,,83,69,152
004 Eppan a.d. Weinstr.,60,,57,48,105
004 Eppan a.d. Weinstr.,61,,74,82,156
004 Eppan a.d. Weinstr.,62,,95,80,175
004 Eppan a.d. Weinstr.,63,,91,80,171
004 Eppan a.d. Weinstr.,64,,64,103,167
004 Eppan a.d. Weinstr.,65,,74,58,132
004 Eppan a.d. Weinstr.,66,,59,80,139
004 Eppan a.d. Weinstr.,67,,56,53,109
004 Eppan a.d. Weinstr.,68,,45,56,101
004 Eppan a.d. Weinstr.,69,,45,52,97
004 Eppan a.d. Weinstr.,70,,40,48,88
004 Eppan a.d. Weinstr.,71,,31,50,81
004 Eppan a.d. Weinstr.,72,,52,55,107
004 Eppan a.d. Weinstr.,73,,43,49,92
004 Eppan a.d. Weinstr.,74,,37,58,95
004 Eppan a.d. Weinstr.,75,,47,61,108
004 Eppan a.d. Weinstr.,76,,36,52,88
004 Eppan a.d. Weinstr.,77,,37,40,77
004 Eppan a.d. Weinstr.,78,,29,42,71
004 Eppan a.d. Weinstr.,79,,38,51,89
004 Eppan a.d. Weinstr.,80,,32,53,85
004 Eppan a.d. Weinstr.,81,,17,58,75
004 Eppan a.d. Weinstr.,82,,19,34,53
004 Eppan a.d. Weinstr.,83,,11,36,47
004 Eppan a.d. Weinstr.,84,,19,35,54
004 Eppan a.d. Weinstr.,85,,10,24,34
004 Eppan a.d. Weinstr.,86,,11,17,28
004 Eppan a.d. Weinstr.,87,,9,12,21
004 Eppan a.d. Weinstr.,88,,8,8,16
004 Eppan a.d. Weinstr.,89,,5,11,16
004 Eppan a.d. Weinstr.,90,,2,9,11
004 Eppan a.d. Weinstr.,91,,5,15,20
004 Eppan a.d. Weinstr.,92,,2,6,8
004 Eppan a.d. Weinstr.,93,,1,13,14
004 Eppan a.d. Weinstr.,94,,2,11,13
004 Eppan a.d. Weinstr.,95,,-,4,4
004 Eppan a.d. Weinstr.,96,,3,6,9
004 Eppan a.d. Weinstr.,97,,-,2,2
004 Eppan a.d. Weinstr.,98,,-,4,4
004 Eppan a.d. Weinstr.,100,,1,-,1
004 Eppan a.d. Weinstr.,101,,-,1,1
005 Hafling,0,,5,4,9
005 Hafling,1,,4,8,12
005 Hafling,2,,1,5,6
005 Hafling,3,,4,5,9
005 Hafling,4,,5,2,7
005 Hafling,5,,5,9,14
005 Hafling,6,,4,3,7
005 Hafling,7,,3,7,10
005 Hafling,8,,1,9,10
005 Hafling,9,,12,4,16
005 Hafling,10,,6,4,10
005 Hafling,11,,3,5,8
005 Hafling,12,,2,7,9
005 Hafling,13,,3,4,7
005 Hafling,14,,8,3,11
005 Hafling,15,,4,6,10
005 Hafling,16,,4,2,6
005 Hafling,17,,2,7,9
005 Hafling,18,,4,4,8
005 Hafling,19,,5,2,7
005 Hafling,20,,5,5,10
005 Hafling,21,,4,9,13
005 Hafling,22,,2,-,2
005 Hafling,23,,6,4,10
005 Hafling,24,,4,5,9
005 Hafling,25,,3,8,11
005 Hafling,26,,5,3,8
005 Hafling,27,,4,5,9
005 Hafling,28,,4,3,7
005 Hafling,29,,5,7,12
005 Hafling,30,,7,4,11
005 Hafling,31,,7,7,14
005 Hafling,32,,10,2,12
005 Hafling,33,,8,2,10
005 Hafling,34,,10,5,15
005 Hafling,35,,8,5,13
005 Hafling,36,,9,10,19
005 Hafling,37,,3,10,13
005 Hafling,38,,5,3,8
005 Hafling,39,,10,7,17
005 Hafling,40,,9,12,21
005 Hafling,41,,3,2,5
005 Hafling,42,,6,3,9
005 Hafling,43,,5,2,7
005 Hafling,44,,5,3,8
005 Hafling,45,,8,7,15
005 Hafling,46,,5,5,10
005 Hafling,47,,3,4,7
005 Hafling,48,,1,4,5
005 Hafling,49,,3,9,12
005 Hafling,50,,7,3,10
005 Hafling,51,,3,1,4
005 Hafling,52,,2,3,5
005 Hafling,53,,5,2,7
005 Hafling,54,,2,3,5
005 Hafling,55,,4,3,7
005 Hafling,56,,5,3,8
005 Hafling,57,,6,2,8
005 Hafling,58,,2,4,6
005 Hafling,59,,-,4,4
005 Hafling,60,,5,3,8
005 Hafling,61,,1,3,4
005 Hafling,62,,5,4,9
005 Hafling,63,,6,3,9
005 Hafling,64,,5,4,9
005 Hafling,65,,2,1,3
005 Hafling,66,,4,5,9
005 Hafling,67,,3,3,6
005 Hafling,68,,3,2,5
005 Hafling,69,,1,1,2
005 Hafling,70,,1,1,2
005 Hafling,71,,1,2,3
005 Hafling,72,,5,4,9
005 Hafling,73,,3,4,7
005 Hafling,74,,3,7,10
005 Hafling,75,,1,4,5
005 Hafling,76,,3,1,4
005 Hafling,77,,2,3,5
005 Hafling,78,,3,5,8
005 Hafling,79,,1,2,3
005 Hafling,80,,1,-,1
005 Hafling,81,,1,2,3
005 Hafling,82,,1,-,1
005 Hafling,83,,-,2,2
005 Hafling,84,,-,3,3
005 Hafling,85,,3,1,4
005 Hafling,86,,-,2,2
005 Hafling,88,,-,1,1
005 Hafling,89,,-,1,1
005 Hafling,90,,1,-,1
005 Hafling,94,,1,-,1
006 Abtei,0,,20,29,49
006 Abtei,1,,27,16,43
006 Abtei,2,,21,17,38
006 Abtei,3,,11,29,40
006 Abtei,4,,27,25,52
006 Abtei,5,,24,32,56
006 Abtei,6,,23,26,49
006 Abtei,7,,12,14,26
006 Abtei,8,,26,22,48
006 Abtei,9,,29,14,43
006 Abtei,10,,25,29,54
006 Abtei,11,,19,14,33
006 Abtei,12,,15,19,34
006 Abtei,13,,23,15,38
006 Abtei,14,,21,12,33
006 Abtei,15,,23,16,39
006 Abtei,16,,15,14,29
006 Abtei,17,,14,10,24
006 Abtei,18,,19,12,31
006 Abtei,19,,17,18,35
006 Abtei,20,,11,14,25
006 Abtei,21,,12,19,31
006 Abtei,22,,13,11,24
006 Abtei,23,,20,20,40
006 Abtei,24,,16,17,33
006 Abtei,25,,23,17,40
006 Abtei,26,,12,23,35
006 Abtei,27,,23,29,52
006 Abtei,28,,22,31,53
006 Abtei,29,,29,25,54
006 Abtei,30,,16,30,46
006 Abtei,31,,21,25,46
006 Abtei,32,,27,24,51
006 Abtei,33,,45,32,77
006 Abtei,34,,16,34,50
006 Abtei,35,,30,31,61
006 Abtei,36,,28,34,62
006 Abtei,37,,28,36,64
006 Abtei,38,,36,35,71
006 Abtei,39,,24,31,55
006 Abtei,40,,36,27,63
006 Abtei,41,,23,31,54
006 Abtei,42,,32,25,57
006 Abtei,43,,25,29,54
006 Abtei,44,,23,27,50
006 Abtei,45,,28,22,50
006 Abtei,46,,24,23,47
006 Abtei,47,,18,23,41
006 Abtei,48,,20,15,35
006 Abtei,49,,19,17,36
006 Abtei,50,,17,15,32
006 Abtei,51,,12,15,27
006 Abtei,52,,14,19,33
006 Abtei,53,,14,13,27
006 Abtei,54,,12,13,25
006 Abtei,55,,15,19,34
006 Abtei,56,,10,19,29
006 Abtei,57,,24,17,41
006 Abtei,58,,15,16,31
006 Abtei,59,,23,19,42
006 Abtei,60,,15,20,35
006 Abtei,61,,13,17,30
006 Abtei,62,,13,11,24
006 Abtei,63,,21,12,33
006 Abtei,64,,16,24,40
006 Abtei,65,,16,18,34
006 Abtei,66,,14,13,27
006 Abtei,67,,16,17,33
006 Abtei,68,,6,18,24
006 Abtei,69,,16,9,25
006 Abtei,70,,13,18,31
006 Abtei,71,,13,15,28
006 Abtei,72,,9,15,24
006 Abtei,73,,8,5,13
006 Abtei,74,,11,12,23
006 Abtei,75,,15,12,27
006 Abtei,76,,7,8,15
006 Abtei,77,,6,14,20
006 Abtei,78,,6,9,15
006 Abtei,79,,7,6,13
006 Abtei,80,,8,4,12
006 Abtei,81,,5,9,14
006 Abtei,82,,6,9,15
006 Abtei,83,,7,5,12
006 Abtei,84,,3,2,5
006 Abtei,85,,3,8,11
006 Abtei,86,,1,3,4
006 Abtei,87,,2,2,4
006 Abtei,89,,1,3,4
006 Abtei,90,,-,2,2
006 Abtei,91,,-,2,2
006 Abtei,92,,1,-,1
006 Abtei,93,,-,4,4
006 Abtei,94,,-,1,1
006 Abtei,95,,1,1,2
007 Barbian,0,,14,5,19
007 Barbian,1,,9,5,14
007 Barbian,2,,8,13,21
007 Barbian,3,,8,6,14
007 Barbian,4,,11,15,26
007 Barbian,5,,13,7,20
007 Barbian,6,,11,10,21
007 Barbian,7,,16,8,24
007 Barbian,8,,9,9,18
007 Barbian,9,,11,10,21
007 Barbian,10,,10,8,18
007 Barbian,11,,8,5,13
007 Barbian,12,,10,13,23
007 Barbian,13,,12,7,19
007 Barbian,14,,12,11,23
007 Barbian,15,,14,13,27
007 Barbian,16,,10,13,23
007 Barbian,17,,12,6,18
007 Barbian,18,,7,7,14
007 Barbian,19,,14,7,21
007 Barbian,20,,7,8,15
007 Barbian,21,,10,6,16
007 Barbian,22,,11,7,18
007 Barbian,23,,9,5,14
007 Barbian,24,,13,14,27
007 Barbian,25,,10,7,17
007 Barbian,26,,18,13,31
007 Barbian,27,,12,11,23
007 Barbian,28,,8,16,24
007 Barbian,29,,9,12,21
007 Barbian,30,,11,12,23
007 Barbian,31,,13,15,28
007 Barbian,32,,9,15,24
007 Barbian,33,,18,17,35
007 Barbian,34,,16,11,27
007 Barbian,35,,10,10,20
007 Barbian,36,,16,7,23
007 Barbian,37,,13,12,25
007 Barbian,38,,9,8,17
007 Barbian,39,,13,13,26
007 Barbian,40,,7,13,20
007 Barbian,41,,14,16,30
007 Barbian,42,,13,15,28
007 Barbian,43,,15,15,30
007 Barbian,44,,17,11,28
007 Barbian,45,,12,16,28
007 Barbian,46,,12,9,21
007 Barbian,47,,8,9,17
007 Barbian,48,,15,7,22
007 Barbian,49,,4,9,13
007 Barbian,50,,7,7,14
007 Barbian,51,,6,14,20
007 Barbian,52,,10,9,19
007 Barbian,53,,7,5,12
007 Barbian,54,,7,10,17
007 Barbian,55,,11,11,22
007 Barbian,56,,5,6,11
007 Barbian,57,,3,5,8
007 Barbian,58,,6,11,17
007 Barbian,59,,18,6,24
007 Barbian,60,,8,4,12
007 Barbian,61,,10,9,19
007 Barbian,62,,8,6,14
007 Barbian,63,,11,12,23
007 Barbian,64,,8,12,20
007 Barbian,65,,9,3,12
007 Barbian,66,,6,4,10
007 Barbian,67,,5,10,15
007 Barbian,68,,8,8,16
007 Barbian,69,,3,5,8
007 Barbian,70,,3,6,9
007 Barbian,71,,5,5,10
007 Barbian,72,,7,4,11
007 Barbian,73,,6,6,12
007 Barbian,74,,4,8,12
007 Barbian,75,,7,5,12
007 Barbian,76,,7,7,14
007 Barbian,77,,4,9,13
007 Barbian,78,,4,2,6
007 Barbian,79,,3,3,6
007 Barbian,80,,4,3,7
007 Barbian,81,,1,5,6
007 Barbian,82,,3,6,9
007 Barbian,83,,2,5,7
007 Barbian,84,,1,2,3
007 Barbian,85,,1,2,3
007 Barbian,86,,-,2,2
007 Barbian,87,,1,-,1
007 Barbian,88,,-,1,1
007 Barbian,89,,-,1,1
007 Barbian,90,,-,1,1
007 Barbian,91,,1,1,2
007 Barbian,94,,2,-,2
007 Barbian,95,,1,-,1
008 Bozen,0,,512,433,945
008 Bozen,1,,481,447,928
008 Bozen,2,,490,480,970
008 Bozen,3,,474,434,908
008 Bozen,4,,483,435,918
008 Bozen,5,,433,449,882
008 Bozen,6,,479,464,943
008 Bozen,7,,450,456,906
008 Bozen,8,,466,397,863
008 Bozen,9,,436,454,890
008 Bozen,10,,423,381,804
008 Bozen,11,,464,434,898
008 Bozen,12,,409,410,819
008 Bozen,13,,440,397,837
008 Bozen,14,,478,395,873
008 Bozen,15,,444,414,858
008 Bozen,16,,436,407,843
008 Bozen,17,,439,404,843
008 Bozen,18,,364,396,760
008 Bozen,19,,410,371,781
008 Bozen,20,,420,396,816
008 Bozen,21,,418,413,831
008 Bozen,22,,483,398,881
008 Bozen,23,,495,429,924
008 Bozen,24,,513,447,960
008 Bozen,25,,571,461,1.032
008 Bozen,26,,519,487,1.006
008 Bozen,27,,592,506,1.098
008 Bozen,28,,588,538,1.126
008 Bozen,29,,607,614,1.221
008 Bozen,30,,683,661,1.344
008 Bozen,31,,721,744,1.465
008 Bozen,32,,739,790,1.529
008 Bozen,33,,824,769,1.593
008 Bozen,34,,885,855,1.740
008 Bozen,35,,845,767,1.612
008 Bozen,36,,904,823,1.727
008 Bozen,37,,818,771,1.589
008 Bozen,38,,796,819,1.615
008 Bozen,39,,884,851,1.735
008 Bozen,40,,907,857,1.764
008 Bozen,41,,903,890,1.793
008 Bozen,42,,769,824,1.593
008 Bozen,43,,760,780,1.540
008 Bozen,44,,770,722,1.492
008 Bozen,45,,694,713,1.407
008 Bozen,46,,699,693,1.392
008 Bozen,47,,684,691,1.375
008 Bozen,48,,612,714,1.326
008 Bozen,49,,639,660,1.299
008 Bozen,50,,610,634,1.244
008 Bozen,51,,615,601,1.216
008 Bozen,52,,540,614,1.154
008 Bozen,53,,542,645,1.187
008 Bozen,54,,535,632,1.167
008 Bozen,55,,585,679,1.264
008 Bozen,56,,605,642,1.247
008 Bozen,57,,644,731,1.375
008 Bozen,58,,622,794,1.416
008 Bozen,59,,710,874,1.584
008 Bozen,60,,542,593,1.135
008 Bozen,61,,590,715,1.305
008 Bozen,62,,621,725,1.346
008 Bozen,63,,637,713,1.350
008 Bozen,64,,685,751,1.436
008 Bozen,65,,666,730,1.396
008 Bozen,66,,579,724,1.303
008 Bozen,67,,621,665,1.286
008 Bozen,68,,539,573,1.112
008 Bozen,69,,489,557,1.046
008 Bozen,70,,464,568,1.032
008 Bozen,71,,486,565,1.051
008 Bozen,72,,400,564,964
008 Bozen,73,,422,570,992
008 Bozen,74,,416,551,967
008 Bozen,75,,415,551,966
008 Bozen,76,,298,522,820
008 Bozen,77,,341,490,831
008 Bozen,78,,301,482,783
008 Bozen,79,,344,462,806
008 Bozen,80,,267,491,758
008 Bozen,81,,251,451,702
008 Bozen,82,,233,466,699
008 Bozen,83,,225,478,703
008 Bozen,84,,192,421,613
008 Bozen,85,,151,377,528
008 Bozen,86,,80,237,317
008 Bozen,87,,53,136,189
008 Bozen,88,,47,125,172
008 Bozen,89,,51,131,182
008 Bozen,90,,49,174,223
008 Bozen,91,,61,152,213
008 Bozen,92,,40,128,168
008 Bozen,93,,28,95,123
008 Bozen,94,,19,78,97
008 Bozen,95,,17,56,73
008 Bozen,96,,10,35,45
008 Bozen,97,,6,30,36
008 Bozen,98,,3,16,19
008 Bozen,99,,2,13,15
008 Bozen,100,,1,9,10
008 Bozen,101,,-,3,3
008 Bozen,102,,-,3,3
008 Bozen,103,,-,1,1
008 Bozen,104,,-,2,2
009 Prags,0,,3,3,6
009 Prags,1,,3,4,7
009 Prags,2,,2,4,6
009 Prags,3,,2,5,7
009 Prags,4,,4,6,10
009 Prags,5,,2,3,5
009 Prags,6,,4,9,13
009 Prags,7,,2,4,6
009 Prags,8,,3,5,8
009 Prags,9,,2,7,9
009 Prags,10,,2,2,4
009 Prags,11,,4,6,10
009 Prags,12,,7,3,10
009 Prags,13,,6,3,9
009 Prags,14,,8,2,10
009 Prags,15,,4,2,6
009 Prags,16,,8,3,11
009 Prags,17,,2,3,5
009 Prags,18,,3,3,6
009 Prags,19,,6,5,11
009 Prags,20,,8,2,10
009 Prags,21,,4,3,7
009 Prags,22,,3,7,10
009 Prags,23,,3,5,8
009 Prags,24,,2,7,9
009 Prags,25,,4,1,5
009 Prags,26,,2,1,3
009 Prags,27,,6,3,9
009 Prags,28,,4,2,6
009 Prags,29,,5,3,8
009 Prags,30,,3,6,9
009 Prags,31,,2,4,6
009 Prags,32,,8,3,11
009 Prags,33,,3,1,4
009 Prags,34,,6,5,11
009 Prags,35,,4,8,12
009 Prags,36,,7,5,12
009 Prags,37,,8,7,15
009 Prags,38,,7,7,14
009 Prags,39,,7,5,12
009 Prags,40,,7,6,13
009 Prags,41,,6,5,11
009 Prags,42,,7,5,12
009 Prags,43,,3,4,7
009 Prags,44,,5,12,17
009 Prags,45,,6,4,10
009 Prags,46,,12,5,17
009 Prags,47,,6,2,8
009 Prags,48,,6,4,10
009 Prags,49,,1,5,6
009 Prags,50,,3,4,7
009 Prags,51,,6,4,10
009 Prags,52,,4,2,6
009 Prags,53,,2,5,7
009 Prags,54,,3,1,4
009 Prags,55,,5,1,6
009 Prags,56,,1,1,2
009 Prags,57,,5,1,6
009 Prags,58,,1,-,1
009 Prags,59,,2,4,6
009 Prags,60,,2,2,4
009 Prags,61,,4,4,8
009 Prags,62,,1,3,4
009 Prags,63,,4,4,8
009 Prags,64,,5,2,7
009 Prags,65,,1,3,4
009 Prags,66,,3,5,8
009 Prags,67,,3,2,5
009 Prags,68,,1,2,3
009 Prags,69,,2,3,5
009 Prags,70,,1,3,4
009 Prags,71,,3,2,5
009 Prags,72,,4,2,6
009 Prags,73,,4,6,10
009 Prags,74,,1,4,5
009 Prags,75,,1,1,2
009 Prags,76,,3,2,5
009 Prags,77,,3,2,5
009 Prags,78,,2,5,7
009 Prags,79,,2,4,6
009 Prags,80,,1,5,6
009 Prags,81,,3,2,5
009 Prags,82,,-,4,4
009 Prags,83,,2,1,3
009 Prags,84,,1,2,3
009 Prags,85,,1,1,2
009 Prags,86,,-,2,2
009 Prags,88,,-,1,1
009 Prags,89,,-,1,1
009 Prags,90,,-,1,1
009 Prags,91,,-,1,1
009 Prags,94,,-,1,1
010 Brenner,0,,11,10,21
010 Brenner,1,,8,17,25
010 Brenner,2,,10,6,16
010 Brenner,3,,9,14,23
010 Brenner,4,,6,7,13
010 Brenner,5,,15,14,29
010 Brenner,6,,11,14,25
010 Brenner,7,,16,5,21
010 Brenner,8,,17,6,23
010 Brenner,9,,5,11,16
010 Brenner,10,,6,10,16
010 Brenner,11,,19,13,32
010 Brenner,12,,12,7,19
010 Brenner,13,,12,9,21
010 Brenner,14,,7,16,23
010 Brenner,15,,9,7,16
010 Brenner,16,,15,5,20
010 Brenner,17,,10,4,14
010 Brenner,18,,7,8,15
010 Brenner,19,,12,11,23
010 Brenner,20,,19,10,29
010 Brenner,21,,14,16,30
010 Brenner,22,,16,16,32
010 Brenner,23,,12,9,21
010 Brenner,24,,12,18,30
010 Brenner,25,,9,13,22
010 Brenner,26,,14,14,28
010 Brenner,27,,18,11,29
010 Brenner,28,,18,9,27
010 Brenner,29,,12,9,21
010 Brenner,30,,12,20,32
010 Brenner,31,,18,11,29
010 Brenner,32,,12,9,21
010 Brenner,33,,22,23,45
010 Brenner,34,,26,10,36
010 Brenner,35,,24,17,41
010 Brenner,36,,15,16,31
010 Brenner,37,,13,20,33
010 Brenner,38,,21,15,36
010 Brenner,39,,18,17,35
010 Brenner,40,,22,19,41
010 Brenner,41,,21,15,36
010 Brenner,42,,12,19,31
010 Brenner,43,,16,14,30
010 Brenner,44,,20,11,31
010 Brenner,45,,22,12,34
010 Brenner,46,,19,12,31
010 Brenner,47,,15,10,25
010 Brenner,48,,15,20,35
010 Brenner,49,,16,13,29
010 Brenner,50,,14,9,23
010 Brenner,51,,8,14,22
010 Brenner,52,,10,16,26
010 Brenner,53,,20,8,28
010 Brenner,54,,15,11,26
010 Brenner,55,,11,11,22
010 Brenner,56,,17,16,33
010 Brenner,57,,6,8,14
010 Brenner,58,,22,13,35
010 Brenner,59,,8,17,25
010 Brenner,60,,7,9,16
010 Brenner,61,,17,14,31
010 Brenner,62,,19,14,33
010 Brenner,63,,6,9,15
010 Brenner,64,,11,12,23
010 Brenner,65,,11,11,22
010 Brenner,66,,9,9,18
010 Brenner,67,,10,17,27
010 Brenner,68,,10,14,24
010 Brenner,69,,12,7,19
010 Brenner,70,,5,6,11
010 Brenner,71,,9,8,17
010 Brenner,72,,6,8,14
010 Brenner,73,,2,5,7
010 Brenner,74,,6,9,15
010 Brenner,75,,9,12,21
010 Brenner,76,,11,10,21
010 Brenner,77,,9,9,18
010 Brenner,78,,5,3,8
010 Brenner,79,,8,9,17
010 Brenner,80,,3,8,11
010 Brenner,81,,2,7,9
010 Brenner,82,,4,11,15
010 Brenner,83,,-,6,6
010 Brenner,84,,1,2,3
010 Brenner,85,,1,5,6
010 Brenner,86,,2,3,5
010 Brenner,87,,2,-,2
010 Brenner,88,,-,1,1
010 Brenner,89,,1,-,1
010 Brenner,90,,-,1,1
010 Brenner,91,,1,3,4
010 Brenner,92,,-,2,2
010 Brenner,93,,-,3,3
010 Brenner,94,,1,-,1
010 Brenner,96,,-,1,1
011 Brixen,0,,116,114,230
011 Brixen,1,,119,114,233
011 Brixen,2,,106,101,207
011 Brixen,3,,110,110,220
011 Brixen,4,,122,119,241
011 Brixen,5,,113,113,226
011 Brixen,6,,137,121,258
011 Brixen,7,,107,138,245
011 Brixen,8,,119,104,223
011 Brixen,9,,119,105,224
011 Brixen,10,,112,117,229
011 Brixen,11,,119,117,236
011 Brixen,12,,113,103,216
011 Brixen,13,,110,122,232
011 Brixen,14,,115,102,217
011 Brixen,15,,98,107,205
011 Brixen,16,,116,94,210
011 Brixen,17,,118,99,217
011 Brixen,18,,103,95,198
011 Brixen,19,,101,112,213
011 Brixen,20,,110,87,197
011 Brixen,21,,120,90,210
011 Brixen,22,,120,120,240
011 Brixen,23,,119,106,225
011 Brixen,24,,119,110,229
011 Brixen,25,,103,105,208
011 Brixen,26,,130,113,243
011 Brixen,27,,97,120,217
011 Brixen,28,,130,122,252
011 Brixen,29,,132,143,275
011 Brixen,30,,125,119,244
011 Brixen,31,,142,144,286
011 Brixen,32,,157,163,320
011 Brixen,33,,152,153,305
011 Brixen,34,,157,157,314
011 Brixen,35,,165,155,320
011 Brixen,36,,191,173,364
011 Brixen,37,,176,192,368
011 Brixen,38,,172,160,332
011 Brixen,39,,169,186,355
011 Brixen,40,,186,163,349
011 Brixen,41,,182,180,362
011 Brixen,42,,157,166,323
011 Brixen,43,,162,165,327
011 Brixen,44,,137,172,309
011 Brixen,45,,147,150,297
011 Brixen,46,,151,136,287
011 Brixen,47,,155,119,274
011 Brixen,48,,132,139,271
011 Brixen,49,,114,134,248
011 Brixen,50,,123,91,214
011 Brixen,51,,97,110,207
011 Brixen,52,,87,109,196
011 Brixen,53,,99,103,202
011 Brixen,54,,99,104,203
011 Brixen,55,,107,98,205
011 Brixen,56,,79,123,202
011 Brixen,57,,111,117,228
011 Brixen,58,,91,115,206
011 Brixen,59,,101,111,212
011 Brixen,60,,69,97,166
011 Brixen,61,,114,107,221
011 Brixen,62,,132,120,252
011 Brixen,63,,91,98,189
011 Brixen,64,,104,124,228
011 Brixen,65,,86,120,206
011 Brixen,66,,91,110,201
011 Brixen,67,,88,97,185
011 Brixen,68,,86,91,177
011 Brixen,69,,68,92,160
011 Brixen,70,,77,83,160
011 Brixen,71,,71,93,164
011 Brixen,72,,73,68,141
011 Brixen,73,,73,79,152
011 Brixen,74,,64,85,149
011 Brixen,75,,61,94,155
011 Brixen,76,,53,87,140
011 Brixen,77,,57,71,128
011 Brixen,78,,38,90,128
011 Brixen,79,,38,67,105
011 Brixen,80,,45,71,116
011 Brixen,81,,36,75,111
011 Brixen,82,,38,62,100
011 Brixen,83,,27,71,98
011 Brixen,84,,23,66,89
011 Brixen,85,,19,52,71
011 Brixen,86,,15,38,53
011 Brixen,87,,7,22,29
011 Brixen,88,,12,30,42
011 Brixen,89,,5,17,22
011 Brixen,90,,5,22,27
011 Brixen,91,,14,26,40
011 Brixen,92,,6,18,24
011 Brixen,93,,3,22,25
011 Brixen,94,,2,16,18
011 Brixen,95,,2,11,13
011 Brixen,96,,2,6,8
011 Brixen,97,,-,3,3
011 Brixen,98,,1,5,6
011 Brixen,99,,-,1,1
011 Brixen,100,,1,-,1
012 Branzoll,0,,8,11,19
012 Branzoll,1,,14,18,32
012 Branzoll,2,,18,22,40
012 Branzoll,3,,16,8,24
012 Branzoll,4,,12,11,23
012 Branzoll,5,,18,8,26
012 Branzoll,6,,10,14,24
012 Branzoll,7,,14,8,22
012 Branzoll,8,,11,20,31
012 Branzoll,9,,15,9,24
012 Branzoll,10,,13,11,24
012 Branzoll,11,,15,8,23
012 Branzoll,12,,21,12,33
012 Branzoll,13,,15,13,28
012 Branzoll,14,,15,15,30
012 Branzoll,15,,11,17,28
012 Branzoll,16,,11,14,25
012 Branzoll,17,,15,13,28
012 Branzoll,18,,12,4,16
012 Branzoll,19,,10,12,22
012 Branzoll,20,,13,15,28
012 Branzoll,21,,18,10,28
012 Branzoll,22,,14,9,23
012 Branzoll,23,,17,13,30
012 Branzoll,24,,14,17,31
012 Branzoll,25,,9,13,22
012 Branzoll,26,,12,10,22
012 Branzoll,27,,16,19,35
012 Branzoll,28,,13,23,36
012 Branzoll,29,,21,16,37
012 Branzoll,30,,16,15,31
012 Branzoll,31,,18,22,40
012 Branzoll,32,,24,13,37
012 Branzoll,33,,22,16,38
012 Branzoll,34,,21,24,45
012 Branzoll,35,,16,20,36
012 Branzoll,36,,25,22,47
012 Branzoll,37,,21,22,43
012 Branzoll,38,,20,24,44
012 Branzoll,39,,22,17,39
012 Branzoll,40,,24,23,47
012 Branzoll,41,,27,26,53
012 Branzoll,42,,16,16,32
012 Branzoll,43,,17,19,36
012 Branzoll,44,,28,26,54
012 Branzoll,45,,25,19,44
012 Branzoll,46,,16,25,41
012 Branzoll,47,,21,15,36
012 Branzoll,48,,19,17,36
012 Branzoll,49,,14,16,30
012 Branzoll,50,,16,17,33
012 Branzoll,51,,22,16,38
012 Branzoll,52,,11,18,29
012 Branzoll,53,,14,18,32
012 Branzoll,54,,17,13,30
012 Branzoll,55,,18,15,33
012 Branzoll,56,,16,14,30
012 Branzoll,57,,15,17,32
012 Branzoll,58,,12,17,29
012 Branzoll,59,,15,20,35
012 Branzoll,60,,12,8,20
012 Branzoll,61,,13,11,24
012 Branzoll,62,,14,12,26
012 Branzoll,63,,18,7,25
012 Branzoll,64,,19,12,31
012 Branzoll,65,,10,13,23
012 Branzoll,66,,15,14,29
012 Branzoll,67,,9,11,20
012 Branzoll,68,,3,9,12
012 Branzoll,69,,8,9,17
012 Branzoll,70,,7,9,16
012 Branzoll,71,,5,10,15
012 Branzoll,72,,19,10,29
012 Branzoll,73,,10,11,21
012 Branzoll,74,,3,10,13
012 Branzoll,75,,8,15,23
012 Branzoll,76,,6,10,16
012 Branzoll,77,,5,10,15
012 Branzoll,78,,5,7,12
012 Branzoll,79,,7,11,18
012 Branzoll,80,,4,5,9
012 Branzoll,81,,2,7,9
012 Branzoll,82,,6,11,17
012 Branzoll,83,,1,3,4
012 Branzoll,84,,3,7,10
012 Branzoll,85,,1,4,5
012 Branzoll,86,,2,4,6
012 Branzoll,87,,2,4,6
012 Branzoll,91,,-,3,3
012 Branzoll,92,,-,2,2
012 Branzoll,93,,-,2,2
012 Branzoll,94,,1,-,1
012 Branzoll,96,,-,2,2
012 Branzoll,99,,1,-,1
013 Bruneck,0,,69,80,149
013 Bruneck,1,,84,88,172
013 Bruneck,2,,93,68,161
013 Bruneck,3,,66,86,152
013 Bruneck,4,,89,71,160
013 Bruneck,5,,82,88,170
013 Bruneck,6,,93,94,187
013 Bruneck,7,,93,84,177
013 Bruneck,8,,105,70,175
013 Bruneck,9,,71,85,156
013 Bruneck,10,,61,72,133
013 Bruneck,11,,81,72,153
013 Bruneck,12,,79,64,143
013 Bruneck,13,,89,72,161
013 Bruneck,14,,88,59,147
013 Bruneck,15,,83,70,153
013 Bruneck,16,,79,80,159
013 Bruneck,17,,70,72,142
013 Bruneck,18,,58,55,113
013 Bruneck,19,,106,75,181
013 Bruneck,20,,75,64,139
013 Bruneck,21,,79,72,151
013 Bruneck,22,,75,78,153
013 Bruneck,23,,82,77,159
013 Bruneck,24,,91,95,186
013 Bruneck,25,,101,96,197
013 Bruneck,26,,96,97,193
013 Bruneck,27,,118,104,222
013 Bruneck,28,,111,93,204
013 Bruneck,29,,91,111,202
013 Bruneck,30,,109,113,222
013 Bruneck,31,,111,98,209
013 Bruneck,32,,119,112,231
013 Bruneck,33,,113,110,223
013 Bruneck,34,,136,113,249
013 Bruneck,35,,124,136,260
013 Bruneck,36,,133,119,252
013 Bruneck,37,,115,143,258
013 Bruneck,38,,130,116,246
013 Bruneck,39,,132,112,244
013 Bruneck,40,,136,135,271
013 Bruneck,41,,130,134,264
013 Bruneck,42,,123,114,237
013 Bruneck,43,,122,110,232
013 Bruneck,44,,115,96,211
013 Bruneck,45,,104,115,219
013 Bruneck,46,,109,94,203
013 Bruneck,47,,101,104,205
013 Bruneck,48,,82,96,178
013 Bruneck,49,,83,95,178
013 Bruneck,50,,78,79,157
013 Bruneck,51,,87,83,170
013 Bruneck,52,,76,98,174
013 Bruneck,53,,87,93,180
013 Bruneck,54,,68,91,159
013 Bruneck,55,,80,97,177
013 Bruneck,56,,83,90,173
013 Bruneck,57,,77,105,182
013 Bruneck,58,,89,70,159
013 Bruneck,59,,100,82,182
013 Bruneck,60,,61,69,130
013 Bruneck,61,,88,93,181
013 Bruneck,62,,96,85,181
013 Bruneck,63,,83,86,169
013 Bruneck,64,,75,95,170
013 Bruneck,65,,75,87,162
013 Bruneck,66,,84,91,175
013 Bruneck,67,,55,52,107
013 Bruneck,68,,52,56,108
013 Bruneck,69,,53,56,109
013 Bruneck,70,,49,50,99
013 Bruneck,71,,42,52,94
013 Bruneck,72,,53,60,113
013 Bruneck,73,,50,50,100
013 Bruneck,74,,36,47,83
013 Bruneck,75,,39,62,101
013 Bruneck,76,,31,62,93
013 Bruneck,77,,37,57,94
013 Bruneck,78,,26,48,74
013 Bruneck,79,,25,34,59
013 Bruneck,80,,25,45,70
013 Bruneck,81,,13,56,69
013 Bruneck,82,,25,43,68
013 Bruneck,83,,21,33,54
013 Bruneck,84,,15,27,42
013 Bruneck,85,,10,25,35
013 Bruneck,86,,9,20,29
013 Bruneck,87,,2,16,18
013 Bruneck,88,,5,17,22
013 Bruneck,89,,2,20,22
013 Bruneck,90,,3,11,14
013 Bruneck,91,,6,15,21
013 Bruneck,92,,5,14,19
013 Bruneck,93,,7,10,17
013 Bruneck,94,,-,11,11
013 Bruneck,95,,3,4,7
013 Bruneck,96,,4,4,8
013 Bruneck,97,,-,3,3
013 Bruneck,98,,-,1,1
013 Bruneck,99,,-,1,1
013 Bruneck,100,,1,-,1
013 Bruneck,102,,-,1,1
013 Bruneck,103,,-,1,1
014 Kuens,0,,4,2,6
014 Kuens,1,,1,4,5
014 Kuens,2,,3,3,6
014 Kuens,3,,2,1,3
014 Kuens,4,,4,2,6
014 Kuens,5,,2,6,8
014 Kuens,6,,2,3,5
014 Kuens,7,,2,4,6
014 Kuens,8,,2,1,3
014 Kuens,9,,5,3,8
014 Kuens,10,,2,3,5
014 Kuens,11,,2,4,6
014 Kuens,12,,3,3,6
014 Kuens,13,,3,2,5
014 Kuens,14,,3,2,5
014 Kuens,15,,3,2,5
014 Kuens,16,,3,2,5
014 Kuens,17,,1,3,4
014 Kuens,18,,3,-,3
014 Kuens,19,,1,1,2
014 Kuens,21,,1,-,1
014 Kuens,22,,2,1,3
014 Kuens,23,,2,-,2
014 Kuens,24,,2,1,3
014 Kuens,25,,3,2,5
014 Kuens,26,,2,1,3
014 Kuens,27,,2,-,2
014 Kuens,28,,2,-,2
014 Kuens,29,,3,2,5
014 Kuens,30,,3,4,7
014 Kuens,31,,2,4,6
014 Kuens,32,,1,5,6
014 Kuens,33,,4,1,5
014 Kuens,34,,2,4,6
014 Kuens,35,,8,3,11
014 Kuens,36,,5,1,6
014 Kuens,37,,3,4,7
014 Kuens,38,,5,11,16
014 Kuens,39,,3,5,8
014 Kuens,40,,7,1,8
014 Kuens,41,,7,5,12
014 Kuens,42,,8,2,10
014 Kuens,43,,6,2,8
014 Kuens,44,,-,3,3
014 Kuens,45,,-,1,1
014 Kuens,46,,1,-,1
014 Kuens,47,,-,3,3
014 Kuens,48,,3,-,3
014 Kuens,49,,3,-,3
014 Kuens,50,,1,2,3
014 Kuens,52,,1,1,2
014 Kuens,53,,-,2,2
014 Kuens,55,,-,3,3
014 Kuens,56,,-,2,2
014 Kuens,57,,3,1,4
014 Kuens,58,,1,2,3
014 Kuens,59,,1,2,3
014 Kuens,60,,3,1,4
014 Kuens,62,,-,2,2
014 Kuens,63,,-,3,3
014 Kuens,64,,-,2,2
014 Kuens,65,,-,1,1
014 Kuens,66,,5,2,7
014 Kuens,67,,3,2,5
014 Kuens,68,,1,3,4
014 Kuens,69,,2,2,4
014 Kuens,70,,1,3,4
014 Kuens,71,,-,1,1
014 Kuens,72,,1,1,2
014 Kuens,73,,4,2,6
014 Kuens,74,,2,2,4
014 Kuens,75,,2,2,4
014 Kuens,76,,1,-,1
014 Kuens,77,,1,-,1
014 Kuens,78,,1,-,1
014 Kuens,79,,1,-,1
014 Kuens,83,,-,2,2
014 Kuens,86,,-,2,2
014 Kuens,89,,-,1,1
014 Kuens,90,,1,-,1
014 Kuens,93,,1,-,1
015 Kaltern a.d. Weinstr.,0,,44,45,89
015 Kaltern a.d. Weinstr.,1,,45,45,90
015 Kaltern a.d. Weinstr.,2,,46,36,82
015 Kaltern a.d. Weinstr.,3,,44,37,81
015 Kaltern a.d. Weinstr.,4,,35,50,85
015 Kaltern a.d. Weinstr.,5,,34,36,70
015 Kaltern a.d. Weinstr.,6,,42,38,80
015 Kaltern a.d. Weinstr.,7,,39,44,83
015 Kaltern a.d. Weinstr.,8,,43,41,84
015 Kaltern a.d. Weinstr.,9,,39,46,85
015 Kaltern a.d. Weinstr.,10,,44,35,79
015 Kaltern a.d. Weinstr.,11,,36,37,73
015 Kaltern a.d. Weinstr.,12,,30,39,69
015 Kaltern a.d. Weinstr.,13,,41,38,79
015 Kaltern a.d. Weinstr.,14,,33,40,73
015 Kaltern a.d. Weinstr.,15,,38,35,73
015 Kaltern a.d. Weinstr.,16,,54,27,81
015 Kaltern a.d. Weinstr.,17,,39,34,73
015 Kaltern a.d. Weinstr.,18,,41,31,72
015 Kaltern a.d. Weinstr.,19,,52,42,94
015 Kaltern a.d. Weinstr.,20,,49,37,86
015 Kaltern a.d. Weinstr.,21,,38,39,77
015 Kaltern a.d. Weinstr.,22,,46,43,89
015 Kaltern a.d. Weinstr.,23,,44,49,93
015 Kaltern a.d. Weinstr.,24,,43,43,86
015 Kaltern a.d. Weinstr.,25,,41,46,87
015 Kaltern a.d. Weinstr.,26,,46,45,91
015 Kaltern a.d. Weinstr.,27,,45,40,85
015 Kaltern a.d. Weinstr.,28,,40,41,81
015 Kaltern a.d. Weinstr.,29,,38,51,89
015 Kaltern a.d. Weinstr.,30,,47,71,118
015 Kaltern a.d. Weinstr.,31,,53,50,103
015 Kaltern a.d. Weinstr.,32,,39,51,90
015 Kaltern a.d. Weinstr.,33,,51,70,121
015 Kaltern a.d. Weinstr.,34,,66,51,117
015 Kaltern a.d. Weinstr.,35,,65,59,124
015 Kaltern a.d. Weinstr.,36,,59,66,125
015 Kaltern a.d. Weinstr.,37,,77,70,147
015 Kaltern a.d. Weinstr.,38,,65,62,127
015 Kaltern a.d. Weinstr.,39,,64,72,136
015 Kaltern a.d. Weinstr.,40,,55,59,114
015 Kaltern a.d. Weinstr.,41,,84,55,139
015 Kaltern a.d. Weinstr.,42,,53,56,109
015 Kaltern a.d. Weinstr.,43,,62,60,122
015 Kaltern a.d. Weinstr.,44,,64,64,128
015 Kaltern a.d. Weinstr.,45,,55,62,117
015 Kaltern a.d. Weinstr.,46,,51,55,106
015 Kaltern a.d. Weinstr.,47,,57,62,119
015 Kaltern a.d. Weinstr.,48,,50,58,108
015 Kaltern a.d. Weinstr.,49,,65,45,110
015 Kaltern a.d. Weinstr.,50,,56,41,97
015 Kaltern a.d. Weinstr.,51,,37,51,88
015 Kaltern a.d. Weinstr.,52,,34,38,72
015 Kaltern a.d. Weinstr.,53,,40,57,97
015 Kaltern a.d. Weinstr.,54,,30,34,64
015 Kaltern a.d. Weinstr.,55,,44,35,79
015 Kaltern a.d. Weinstr.,56,,30,40,70
015 Kaltern a.d. Weinstr.,57,,41,36,77
015 Kaltern a.d. Weinstr.,58,,36,57,93
015 Kaltern a.d. Weinstr.,59,,49,45,94
015 Kaltern a.d. Weinstr.,60,,39,37,76
015 Kaltern a.d. Weinstr.,61,,38,43,81
015 Kaltern a.d. Weinstr.,62,,35,38,73
015 Kaltern a.d. Weinstr.,63,,42,43,85
015 Kaltern a.d. Weinstr.,64,,44,43,87
015 Kaltern a.d. Weinstr.,65,,31,43,74
015 Kaltern a.d. Weinstr.,66,,24,35,59
015 Kaltern a.d. Weinstr.,67,,41,40,81
015 Kaltern a.d. Weinstr.,68,,27,33,60
015 Kaltern a.d. Weinstr.,69,,23,23,46
015 Kaltern a.d. Weinstr.,70,,26,26,52
015 Kaltern a.d. Weinstr.,71,,27,27,54
015 Kaltern a.d. Weinstr.,72,,27,36,63
015 Kaltern a.d. Weinstr.,73,,26,31,57
015 Kaltern a.d. Weinstr.,74,,22,34,56
015 Kaltern a.d. Weinstr.,75,,27,38,65
015 Kaltern a.d. Weinstr.,76,,23,33,56
015 Kaltern a.d. Weinstr.,77,,21,29,50
015 Kaltern a.d. Weinstr.,78,,16,34,50
015 Kaltern a.d. Weinstr.,79,,15,31,46
015 Kaltern a.d. Weinstr.,80,,21,34,55
015 Kaltern a.d. Weinstr.,81,,15,27,42
015 Kaltern a.d. Weinstr.,82,,7,26,33
015 Kaltern a.d. Weinstr.,83,,11,30,41
015 Kaltern a.d. Weinstr.,84,,7,27,34
015 Kaltern a.d. Weinstr.,85,,6,22,28
015 Kaltern a.d. Weinstr.,86,,4,16,20
015 Kaltern a.d. Weinstr.,87,,2,7,9
015 Kaltern a.d. Weinstr.,88,,3,8,11
015 Kaltern a.d. Weinstr.,89,,2,3,5
015 Kaltern a.d. Weinstr.,90,,3,7,10
015 Kaltern a.d. Weinstr.,91,,2,9,11
015 Kaltern a.d. Weinstr.,92,,3,9,12
015 Kaltern a.d. Weinstr.,93,,-,11,11
015 Kaltern a.d. Weinstr.,94,,1,3,4
015 Kaltern a.d. Weinstr.,95,,1,-,1
015 Kaltern a.d. Weinstr.,96,,-,2,2
015 Kaltern a.d. Weinstr.,97,,1,-,1
015 Kaltern a.d. Weinstr.,98,,-,2,2
016 Freienfeld,0,,15,18,33
016 Freienfeld,1,,16,12,28
016 Freienfeld,2,,18,15,33
016 Freienfeld,3,,15,23,38
016 Freienfeld,4,,17,19,36
016 Freienfeld,5,,14,15,29
016 Freienfeld,6,,15,19,34
016 Freienfeld,7,,13,16,29
016 Freienfeld,8,,22,17,39
016 Freienfeld,9,,23,13,36
016 Freienfeld,10,,14,16,30
016 Freienfeld,11,,15,11,26
016 Freienfeld,12,,16,11,27
016 Freienfeld,13,,19,23,42
016 Freienfeld,14,,10,12,22
016 Freienfeld,15,,19,20,39
016 Freienfeld,16,,26,20,46
016 Freienfeld,17,,20,15,35
016 Freienfeld,18,,15,19,34
016 Freienfeld,19,,15,12,27
016 Freienfeld,20,,17,14,31
016 Freienfeld,21,,27,14,41
016 Freienfeld,22,,23,20,43
016 Freienfeld,23,,14,16,30
016 Freienfeld,24,,24,23,47
016 Freienfeld,25,,18,15,33
016 Freienfeld,26,,21,18,39
016 Freienfeld,27,,14,15,29
016 Freienfeld,28,,18,19,37
016 Freienfeld,29,,15,10,25
016 Freienfeld,30,,20,15,35
016 Freienfeld,31,,22,17,39
016 Freienfeld,32,,21,19,40
016 Freienfeld,33,,19,22,41
016 Freienfeld,34,,24,24,48
016 Freienfeld,35,,23,16,39
016 Freienfeld,36,,27,25,52
016 Freienfeld,37,,25,20,45
016 Freienfeld,38,,18,30,48
016 Freienfeld,39,,25,21,46
016 Freienfeld,40,,24,19,43
016 Freienfeld,41,,23,20,43
016 Freienfeld,42,,20,18,38
016 Freienfeld,43,,29,28,57
016 Freienfeld,44,,23,20,43
016 Freienfeld,45,,23,22,45
016 Freienfeld,46,,27,13,40
016 Freienfeld,47,,15,19,34
016 Freienfeld,48,,15,20,35
016 Freienfeld,49,,23,17,40
016 Freienfeld,50,,20,9,29
016 Freienfeld,51,,17,18,35
016 Freienfeld,52,,17,10,27
016 Freienfeld,53,,15,18,33
016 Freienfeld,54,,15,11,26
016 Freienfeld,55,,20,9,29
016 Freienfeld,56,,16,13,29
016 Freienfeld,57,,20,13,33
016 Freienfeld,58,,5,12,17
016 Freienfeld,59,,11,16,27
016 Freienfeld,60,,12,2,14
016 Freienfeld,61,,10,5,15
016 Freienfeld,62,,12,10,22
016 Freienfeld,63,,11,9,20
016 Freienfeld,64,,13,12,25
016 Freienfeld,65,,10,4,14
016 Freienfeld,66,,10,9,19
016 Freienfeld,67,,14,11,25
016 Freienfeld,68,,6,11,17
016 Freienfeld,69,,8,10,18
016 Freienfeld,70,,7,12,19
016 Freienfeld,71,,4,6,10
016 Freienfeld,72,,7,8,15
016 Freienfeld,73,,9,10,19
016 Freienfeld,74,,9,8,17
016 Freienfeld,75,,7,7,14
016 Freienfeld,76,,4,7,11
016 Freienfeld,77,,5,5,10
016 Freienfeld,78,,5,7,12
016 Freienfeld,79,,8,12,20
016 Freienfeld,80,,6,8,14
016 Freienfeld,81,,2,3,5
016 Freienfeld,82,,2,14,16
016 Freienfeld,83,,2,9,11
016 Freienfeld,84,,1,3,4
016 Freienfeld,85,,4,3,7
016 Freienfeld,86,,3,3,6
016 Freienfeld,87,,-,2,2
016 Freienfeld,88,,-,1,1
016 Freienfeld,89,,1,1,2
016 Freienfeld,90,,-,2,2
016 Freienfeld,91,,-,4,4
016 Freienfeld,92,,-,1,1
016 Freienfeld,94,,1,1,2
016 Freienfeld,95,,2,-,2
017 Sand in Taufers,0,,37,29,66
017 Sand in Taufers,1,,39,21,60
017 Sand in Taufers,2,,35,26,61
017 Sand in Taufers,3,,27,32,59
017 Sand in Taufers,4,,36,39,75
017 Sand in Taufers,5,,42,22,64
017 Sand in Taufers,6,,37,34,71
017 Sand in Taufers,7,,27,33,60
017 Sand in Taufers,8,,34,36,70
017 Sand in Taufers,9,,28,30,58
017 Sand in Taufers,10,,27,28,55
017 Sand in Taufers,11,,39,34,73
017 Sand in Taufers,12,,25,33,58
017 Sand in Taufers,13,,32,35,67
017 Sand in Taufers,14,,28,32,60
017 Sand in Taufers,15,,24,30,54
017 Sand in Taufers,16,,29,27,56
017 Sand in Taufers,17,,28,29,57
017 Sand in Taufers,18,,21,23,44
017 Sand in Taufers,19,,23,19,42
017 Sand in Taufers,20,,24,25,49
017 Sand in Taufers,21,,32,30,62
017 Sand in Taufers,22,,34,31,65
017 Sand in Taufers,23,,22,36,58
017 Sand in Taufers,24,,31,36,67
017 Sand in Taufers,25,,37,35,72
017 Sand in Taufers,26,,31,38,69
017 Sand in Taufers,27,,38,33,71
017 Sand in Taufers,28,,33,39,72
017 Sand in Taufers,29,,41,34,75
017 Sand in Taufers,30,,43,39,82
017 Sand in Taufers,31,,59,48,107
017 Sand in Taufers,32,,59,50,109
017 Sand in Taufers,33,,53,48,101
017 Sand in Taufers,34,,46,48,94
017 Sand in Taufers,35,,43,53,96
017 Sand in Taufers,36,,53,43,96
017 Sand in Taufers,37,,54,41,95
017 Sand in Taufers,38,,31,44,75
017 Sand in Taufers,39,,51,35,86
017 Sand in Taufers,40,,50,36,86
017 Sand in Taufers,41,,49,42,91
017 Sand in Taufers,42,,48,43,91
017 Sand in Taufers,43,,35,39,74
017 Sand in Taufers,44,,45,41,86
017 Sand in Taufers,45,,40,31,71
017 Sand in Taufers,46,,34,32,66
017 Sand in Taufers,47,,33,21,54
017 Sand in Taufers,48,,24,36,60
017 Sand in Taufers,49,,27,34,61
017 Sand in Taufers,50,,23,21,44
017 Sand in Taufers,51,,29,29,58
017 Sand in Taufers,52,,31,22,53
017 Sand in Taufers,53,,17,28,45
017 Sand in Taufers,54,,26,22,48
017 Sand in Taufers,55,,32,34,66
017 Sand in Taufers,56,,31,22,53
017 Sand in Taufers,57,,21,25,46
017 Sand in Taufers,58,,25,29,54
017 Sand in Taufers,59,,25,24,49
017 Sand in Taufers,60,,27,9,36
017 Sand in Taufers,61,,17,30,47
017 Sand in Taufers,62,,29,29,58
017 Sand in Taufers,63,,29,33,62
017 Sand in Taufers,64,,27,32,59
017 Sand in Taufers,65,,23,18,41
017 Sand in Taufers,66,,27,30,57
017 Sand in Taufers,67,,18,26,44
017 Sand in Taufers,68,,27,12,39
017 Sand in Taufers,69,,15,25,40
017 Sand in Taufers,70,,28,16,44
017 Sand in Taufers,71,,15,13,28
017 Sand in Taufers,72,,14,17,31
017 Sand in Taufers,73,,10,17,27
017 Sand in Taufers,74,,12,12,24
017 Sand in Taufers,75,,14,18,32
017 Sand in Taufers,76,,13,11,24
017 Sand in Taufers,77,,10,15,25
017 Sand in Taufers,78,,11,11,22
017 Sand in Taufers,79,,8,18,26
017 Sand in Taufers,80,,8,12,20
017 Sand in Taufers,81,,5,15,20
017 Sand in Taufers,82,,10,7,17
017 Sand in Taufers,83,,7,14,21
017 Sand in Taufers,84,,6,14,20
017 Sand in Taufers,85,,6,8,14
017 Sand in Taufers,86,,5,8,13
017 Sand in Taufers,87,,3,3,6
017 Sand in Taufers,88,,1,5,6
017 Sand in Taufers,89,,-,1,1
017 Sand in Taufers,90,,4,5,9
017 Sand in Taufers,91,,1,5,6
017 Sand in Taufers,92,,-,4,4
017 Sand in Taufers,93,,-,2,2
017 Sand in Taufers,94,,-,4,4
017 Sand in Taufers,96,,1,2,3
017 Sand in Taufers,98,,-,1,1
018 Kastelbell-Tschars,0,,8,9,17
018 Kastelbell-Tschars,1,,11,10,21
018 Kastelbell-Tschars,2,,11,9,20
018 Kastelbell-Tschars,3,,8,9,17
018 Kastelbell-Tschars,4,,17,13,30
018 Kastelbell-Tschars,5,,10,8,18
018 Kastelbell-Tschars,6,,23,11,34
018 Kastelbell-Tschars,7,,17,9,26
018 Kastelbell-Tschars,8,,9,11,20
018 Kastelbell-Tschars,9,,15,18,33
018 Kastelbell-Tschars,10,,15,9,24
018 Kastelbell-Tschars,11,,14,15,29
018 Kastelbell-Tschars,12,,14,14,28
018 Kastelbell-Tschars,13,,13,13,26
018 Kastelbell-Tschars,14,,18,13,31
018 Kastelbell-Tschars,15,,15,10,25
018 Kastelbell-Tschars,16,,18,10,28
018 Kastelbell-Tschars,17,,20,7,27
018 Kastelbell-Tschars,18,,18,16,34
018 Kastelbell-Tschars,19,,16,21,37
018 Kastelbell-Tschars,20,,21,17,38
018 Kastelbell-Tschars,21,,8,10,18
018 Kastelbell-Tschars,22,,14,21,35
018 Kastelbell-Tschars,23,,26,14,40
018 Kastelbell-Tschars,24,,15,18,33
018 Kastelbell-Tschars,25,,18,17,35
018 Kastelbell-Tschars,26,,15,13,28
018 Kastelbell-Tschars,27,,15,17,32
018 Kastelbell-Tschars,28,,10,15,25
018 Kastelbell-Tschars,29,,21,16,37
018 Kastelbell-Tschars,30,,16,12,28
018 Kastelbell-Tschars,31,,16,12,28
018 Kastelbell-Tschars,32,,19,23,42
018 Kastelbell-Tschars,33,,14,22,36
018 Kastelbell-Tschars,34,,15,14,29
018 Kastelbell-Tschars,35,,17,15,32
018 Kastelbell-Tschars,36,,25,22,47
018 Kastelbell-Tschars,37,,17,16,33
018 Kastelbell-Tschars,38,,11,20,31
018 Kastelbell-Tschars,39,,20,10,30
018 Kastelbell-Tschars,40,,21,16,37
018 Kastelbell-Tschars,41,,20,15,35
018 Kastelbell-Tschars,42,,26,21,47
018 Kastelbell-Tschars,43,,6,24,30
018 Kastelbell-Tschars,44,,21,19,40
018 Kastelbell-Tschars,45,,24,19,43
018 Kastelbell-Tschars,46,,25,19,44
018 Kastelbell-Tschars,47,,17,13,30
018 Kastelbell-Tschars,48,,17,11,28
018 Kastelbell-Tschars,49,,14,17,31
018 Kastelbell-Tschars,50,,19,18,37
018 Kastelbell-Tschars,51,,8,13,21
018 Kastelbell-Tschars,52,,8,16,24
018 Kastelbell-Tschars,53,,15,16,31
018 Kastelbell-Tschars,54,,16,12,28
018 Kastelbell-Tschars,55,,12,13,25
018 Kastelbell-Tschars,56,,13,9,22
018 Kastelbell-Tschars,57,,12,10,22
018 Kastelbell-Tschars,58,,9,8,17
018 Kastelbell-Tschars,59,,15,13,28
018 Kastelbell-Tschars,60,,9,4,13
018 Kastelbell-Tschars,61,,10,6,16
018 Kastelbell-Tschars,62,,7,7,14
018 Kastelbell-Tschars,63,,12,12,24
018 Kastelbell-Tschars,64,,10,8,18
018 Kastelbell-Tschars,65,,8,10,18
018 Kastelbell-Tschars,66,,12,12,24
018 Kastelbell-Tschars,67,,7,15,22
018 Kastelbell-Tschars,68,,11,10,21
018 Kastelbell-Tschars,69,,10,15,25
018 Kastelbell-Tschars,70,,11,9,20
018 Kastelbell-Tschars,71,,5,14,19
018 Kastelbell-Tschars,72,,16,13,29
018 Kastelbell-Tschars,73,,7,13,20
018 Kastelbell-Tschars,74,,10,14,24
018 Kastelbell-Tschars,75,,20,16,36
018 Kastelbell-Tschars,76,,10,11,21
018 Kastelbell-Tschars,77,,6,11,17
018 Kastelbell-Tschars,78,,7,9,16
018 Kastelbell-Tschars,79,,10,14,24
018 Kastelbell-Tschars,80,,9,12,21
018 Kastelbell-Tschars,81,,3,8,11
018 Kastelbell-Tschars,82,,6,9,15
018 Kastelbell-Tschars,83,,3,6,9
018 Kastelbell-Tschars,84,,1,6,7
018 Kastelbell-Tschars,85,,4,6,10
018 Kastelbell-Tschars,86,,1,3,4
018 Kastelbell-Tschars,87,,-,3,3
018 Kastelbell-Tschars,88,,1,2,3
018 Kastelbell-Tschars,89,,-,1,1
018 Kastelbell-Tschars,90,,1,3,4
018 Kastelbell-Tschars,91,,-,3,3
018 Kastelbell-Tschars,92,,-,1,1
018 Kastelbell-Tschars,93,,-,1,1
018 Kastelbell-Tschars,94,,-,4,4
018 Kastelbell-Tschars,95,,-,1,1
018 Kastelbell-Tschars,96,,1,-,1
019 Kastelruth,0,,47,32,79
019 Kastelruth,1,,43,37,80
019 Kastelruth,2,,46,40,86
019 Kastelruth,3,,36,31,67
019 Kastelruth,4,,43,30,73
019 Kastelruth,5,,34,29,63
019 Kastelruth,6,,34,42,76
019 Kastelruth,7,,50,44,94
019 Kastelruth,8,,47,46,93
019 Kastelruth,9,,41,36,77
019 Kastelruth,10,,53,41,94
019 Kastelruth,11,,32,32,64
019 Kastelruth,12,,38,36,74
019 Kastelruth,13,,36,53,89
019 Kastelruth,14,,34,39,73
019 Kastelruth,15,,38,41,79
019 Kastelruth,16,,47,38,85
019 Kastelruth,17,,26,24,50
019 Kastelruth,18,,37,41,78
019 Kastelruth,19,,36,25,61
019 Kastelruth,20,,27,34,61
019 Kastelruth,21,,34,29,63
019 Kastelruth,22,,36,43,79
019 Kastelruth,23,,46,39,85
019 Kastelruth,24,,40,37,77
019 Kastelruth,25,,45,39,84
019 Kastelruth,26,,32,41,73
019 Kastelruth,27,,32,37,69
019 Kastelruth,28,,39,38,77
019 Kastelruth,29,,35,61,96
019 Kastelruth,30,,51,43,94
019 Kastelruth,31,,56,45,101
019 Kastelruth,32,,44,60,104
019 Kastelruth,33,,70,40,110
019 Kastelruth,34,,59,45,104
019 Kastelruth,35,,55,54,109
019 Kastelruth,36,,64,50,114
019 Kastelruth,37,,64,58,122
019 Kastelruth,38,,70,54,124
019 Kastelruth,39,,71,50,121
019 Kastelruth,40,,43,75,118
019 Kastelruth,41,,55,40,95
019 Kastelruth,42,,54,34,88
019 Kastelruth,43,,36,48,84
019 Kastelruth,44,,54,44,98
019 Kastelruth,45,,49,42,91
019 Kastelruth,46,,44,42,86
019 Kastelruth,47,,49,41,90
019 Kastelruth,48,,39,39,78
019 Kastelruth,49,,35,31,66
019 Kastelruth,50,,36,37,73
019 Kastelruth,51,,36,29,65
019 Kastelruth,52,,28,29,57
019 Kastelruth,53,,37,26,63
019 Kastelruth,54,,29,25,54
019 Kastelruth,55,,44,22,66
019 Kastelruth,56,,18,35,53
019 Kastelruth,57,,26,38,64
019 Kastelruth,58,,36,32,68
019 Kastelruth,59,,22,37,59
019 Kastelruth,60,,24,21,45
019 Kastelruth,61,,19,46,65
019 Kastelruth,62,,42,41,83
019 Kastelruth,63,,34,27,61
019 Kastelruth,64,,31,45,76
019 Kastelruth,65,,27,36,63
019 Kastelruth,66,,27,28,55
019 Kastelruth,67,,24,25,49
019 Kastelruth,68,,28,26,54
019 Kastelruth,69,,29,19,48
019 Kastelruth,70,,29,29,58
019 Kastelruth,71,,22,23,45
019 Kastelruth,72,,35,28,63
019 Kastelruth,73,,18,37,55
019 Kastelruth,74,,36,25,61
019 Kastelruth,75,,11,25,36
019 Kastelruth,76,,23,27,50
019 Kastelruth,77,,10,16,26
019 Kastelruth,78,,20,28,48
019 Kastelruth,79,,12,22,34
019 Kastelruth,80,,11,19,30
019 Kastelruth,81,,12,21,33
019 Kastelruth,82,,8,17,25
019 Kastelruth,83,,10,13,23
019 Kastelruth,84,,7,18,25
019 Kastelruth,85,,7,14,21
019 Kastelruth,86,,6,6,12
019 Kastelruth,87,,2,6,8
019 Kastelruth,88,,-,4,4
019 Kastelruth,89,,-,3,3
019 Kastelruth,90,,1,12,13
019 Kastelruth,91,,3,6,9
019 Kastelruth,92,,2,4,6
019 Kastelruth,93,,3,6,9
019 Kastelruth,94,,-,2,2
019 Kastelruth,95,,-,1,1
019 Kastelruth,96,,-,2,2
019 Kastelruth,97,,1,-,1
019 Kastelruth,99,,-,1,1
019 Kastelruth,100,,-,1,1
019 Kastelruth,103,,-,1,1
020 Tscherms,0,,2,8,10
020 Tscherms,1,,8,6,14
020 Tscherms,2,,9,6,15
020 Tscherms,3,,7,8,15
020 Tscherms,4,,7,8,15
020 Tscherms,5,,8,5,13
020 Tscherms,6,,7,8,15
020 Tscherms,7,,4,7,11
020 Tscherms,8,,8,11,19
020 Tscherms,9,,6,4,10
020 Tscherms,10,,10,10,20
020 Tscherms,11,,10,17,27
020 Tscherms,12,,8,9,17
020 Tscherms,13,,14,8,22
020 Tscherms,14,,5,9,14
020 Tscherms,15,,8,7,15
020 Tscherms,16,,5,5,10
020 Tscherms,17,,5,15,20
020 Tscherms,18,,10,6,16
020 Tscherms,19,,11,8,19
020 Tscherms,20,,12,11,23
020 Tscherms,21,,13,7,20
020 Tscherms,22,,11,10,21
020 Tscherms,23,,7,8,15
020 Tscherms,24,,10,7,17
020 Tscherms,25,,7,7,14
020 Tscherms,26,,6,11,17
020 Tscherms,27,,3,14,17
020 Tscherms,28,,7,5,12
020 Tscherms,29,,7,8,15
020 Tscherms,30,,10,7,17
020 Tscherms,31,,9,7,16
020 Tscherms,32,,8,13,21
020 Tscherms,33,,10,8,18
020 Tscherms,34,,9,15,24
020 Tscherms,35,,12,6,18
020 Tscherms,36,,13,16,29
020 Tscherms,37,,14,8,22
020 Tscherms,38,,14,16,30
020 Tscherms,39,,14,5,19
020 Tscherms,40,,18,14,32
020 Tscherms,41,,12,15,27
020 Tscherms,42,,16,13,29
020 Tscherms,43,,17,11,28
020 Tscherms,44,,10,10,20
020 Tscherms,45,,11,14,25
020 Tscherms,46,,9,16,25
020 Tscherms,47,,8,7,15
020 Tscherms,48,,8,9,17
020 Tscherms,49,,8,6,14
020 Tscherms,50,,11,8,19
020 Tscherms,51,,9,8,17
020 Tscherms,52,,11,7,18
020 Tscherms,53,,12,7,19
020 Tscherms,54,,5,11,16
020 Tscherms,55,,8,7,15
020 Tscherms,56,,4,3,7
020 Tscherms,57,,6,5,11
020 Tscherms,58,,8,7,15
020 Tscherms,59,,5,7,12
020 Tscherms,60,,5,7,12
020 Tscherms,61,,5,9,14
020 Tscherms,62,,6,3,9
020 Tscherms,63,,8,4,12
020 Tscherms,64,,10,8,18
020 Tscherms,65,,5,5,10
020 Tscherms,66,,4,5,9
020 Tscherms,67,,8,2,10
020 Tscherms,68,,5,8,13
020 Tscherms,69,,5,7,12
020 Tscherms,70,,4,4,8
020 Tscherms,71,,2,9,11
020 Tscherms,72,,4,3,7
020 Tscherms,73,,5,5,10
020 Tscherms,74,,2,3,5
020 Tscherms,75,,3,5,8
020 Tscherms,76,,3,2,5
020 Tscherms,77,,5,5,10
020 Tscherms,78,,5,4,9
020 Tscherms,79,,3,2,5
020 Tscherms,80,,3,5,8
020 Tscherms,81,,3,5,8
020 Tscherms,82,,1,4,5
020 Tscherms,83,,1,4,5
020 Tscherms,84,,2,3,5
020 Tscherms,85,,4,3,7
020 Tscherms,86,,-,1,1
020 Tscherms,87,,1,1,2
020 Tscherms,88,,-,1,1
020 Tscherms,89,,-,1,1
020 Tscherms,90,,1,-,1
020 Tscherms,91,,-,1,1
020 Tscherms,92,,-,1,1
020 Tscherms,93,,1,-,1
020 Tscherms,94,,-,1,1
020 Tscherms,95,,1,1,2
021 Kiens,0,,13,20,33
021 Kiens,1,,15,13,28
021 Kiens,2,,17,20,37
021 Kiens,3,,10,13,23
021 Kiens,4,,22,20,42
021 Kiens,5,,11,22,33
021 Kiens,6,,15,18,33
021 Kiens,7,,22,7,29
021 Kiens,8,,16,13,29
021 Kiens,9,,16,19,35
021 Kiens,10,,14,20,34
021 Kiens,11,,18,17,35
021 Kiens,12,,18,17,35
021 Kiens,13,,26,17,43
021 Kiens,14,,12,23,35
021 Kiens,15,,16,21,37
021 Kiens,16,,12,19,31
021 Kiens,17,,13,14,27
021 Kiens,18,,13,15,28
021 Kiens,19,,19,11,30
021 Kiens,20,,19,14,33
021 Kiens,21,,18,11,29
021 Kiens,22,,14,19,33
021 Kiens,23,,22,17,39
021 Kiens,24,,13,17,30
021 Kiens,25,,18,25,43
021 Kiens,26,,14,18,32
021 Kiens,27,,27,20,47
021 Kiens,28,,18,18,36
021 Kiens,29,,28,22,50
021 Kiens,30,,17,23,40
021 Kiens,31,,17,24,41
021 Kiens,32,,31,27,58
021 Kiens,33,,22,19,41
021 Kiens,34,,25,23,48
021 Kiens,35,,25,26,51
021 Kiens,36,,31,21,52
021 Kiens,37,,39,18,57
021 Kiens,38,,23,23,46
021 Kiens,39,,28,27,55
021 Kiens,40,,25,21,46
021 Kiens,41,,33,23,56
021 Kiens,42,,17,22,39
021 Kiens,43,,29,19,48
021 Kiens,44,,22,25,47
021 Kiens,45,,21,19,40
021 Kiens,46,,24,15,39
021 Kiens,47,,14,13,27
021 Kiens,48,,12,16,28
021 Kiens,49,,19,13,32
021 Kiens,50,,15,8,23
021 Kiens,51,,11,16,27
021 Kiens,52,,14,23,37
021 Kiens,53,,12,8,20
021 Kiens,54,,12,12,24
021 Kiens,55,,16,10,26
021 Kiens,56,,10,13,23
021 Kiens,57,,15,17,32
021 Kiens,58,,15,14,29
021 Kiens,59,,19,13,32
021 Kiens,60,,8,12,20
021 Kiens,61,,11,14,25
021 Kiens,62,,20,12,32
021 Kiens,63,,16,11,27
021 Kiens,64,,17,11,28
021 Kiens,65,,11,16,27
021 Kiens,66,,11,8,19
021 Kiens,67,,13,14,27
021 Kiens,68,,10,12,22
021 Kiens,69,,10,11,21
021 Kiens,70,,4,17,21
021 Kiens,71,,9,11,20
021 Kiens,72,,12,8,20
021 Kiens,73,,13,13,26
021 Kiens,74,,13,8,21
021 Kiens,75,,8,11,19
021 Kiens,76,,7,9,16
021 Kiens,77,,2,5,7
021 Kiens,78,,5,5,10
021 Kiens,79,,3,5,8
021 Kiens,80,,5,3,8
021 Kiens,81,,2,6,8
021 Kiens,82,,5,6,11
021 Kiens,83,,4,4,8
021 Kiens,84,,-,6,6
021 Kiens,85,,3,3,6
021 Kiens,86,,1,2,3
021 Kiens,87,,-,2,2
021 Kiens,88,,-,1,1
021 Kiens,89,,-,2,2
021 Kiens,90,,1,2,3
021 Kiens,91,,1,1,2
021 Kiens,92,,3,2,5
021 Kiens,93,,1,3,4
022 Klausen,0,,43,35,78
022 Klausen,1,,35,35,70
022 Klausen,2,,30,31,61
022 Klausen,3,,40,25,65
022 Klausen,4,,31,33,64
022 Klausen,5,,31,31,62
022 Klausen,6,,30,29,59
022 Klausen,7,,21,28,49
022 Klausen,8,,40,34,74
022 Klausen,9,,28,28,56
022 Klausen,10,,34,25,59
022 Klausen,11,,16,32,48
022 Klausen,12,,31,26,57
022 Klausen,13,,44,26,70
022 Klausen,14,,31,34,65
022 Klausen,15,,39,25,64
022 Klausen,16,,29,30,59
022 Klausen,17,,31,33,64
022 Klausen,18,,22,32,54
022 Klausen,19,,37,33,70
022 Klausen,20,,38,37,75
022 Klausen,21,,31,28,59
022 Klausen,22,,22,39,61
022 Klausen,23,,39,34,73
022 Klausen,24,,35,29,64
022 Klausen,25,,29,38,67
022 Klausen,26,,32,38,70
022 Klausen,27,,37,43,80
022 Klausen,28,,36,35,71
022 Klausen,29,,45,27,72
022 Klausen,30,,37,38,75
022 Klausen,31,,41,30,71
022 Klausen,32,,47,33,80
022 Klausen,33,,35,41,76
022 Klausen,34,,46,45,91
022 Klausen,35,,41,46,87
022 Klausen,36,,50,54,104
022 Klausen,37,,48,46,94
022 Klausen,38,,49,43,92
022 Klausen,39,,59,43,102
022 Klausen,40,,38,44,82
022 Klausen,41,,42,46,88
022 Klausen,42,,36,39,75
022 Klausen,43,,34,40,74
022 Klausen,44,,49,44,93
022 Klausen,45,,38,26,64
022 Klausen,46,,31,38,69
022 Klausen,47,,26,29,55
022 Klausen,48,,33,25,58
022 Klausen,49,,31,22,53
022 Klausen,50,,30,35,65
022 Klausen,51,,32,41,73
022 Klausen,52,,19,31,50
022 Klausen,53,,26,15,41
022 Klausen,54,,33,27,60
022 Klausen,55,,28,24,52
022 Klausen,56,,30,26,56
022 Klausen,57,,29,26,55
022 Klausen,58,,29,20,49
022 Klausen,59,,30,20,50
022 Klausen,60,,14,16,30
022 Klausen,61,,23,18,41
022 Klausen,62,,20,30,50
022 Klausen,63,,22,26,48
022 Klausen,64,,28,20,48
022 Klausen,65,,23,22,45
022 Klausen,66,,25,18,43
022 Klausen,67,,16,19,35
022 Klausen,68,,18,17,35
022 Klausen,69,,18,22,40
022 Klausen,70,,12,18,30
022 Klausen,71,,18,15,33
022 Klausen,72,,22,16,38
022 Klausen,73,,11,19,30
022 Klausen,74,,12,14,26
022 Klausen,75,,12,18,30
022 Klausen,76,,16,19,35
022 Klausen,77,,5,17,22
022 Klausen,78,,4,14,18
022 Klausen,79,,10,11,21
022 Klausen,80,,12,9,21
022 Klausen,81,,8,13,21
022 Klausen,82,,3,13,16
022 Klausen,83,,5,10,15
022 Klausen,84,,-,9,9
022 Klausen,85,,4,10,14
022 Klausen,86,,1,7,8
022 Klausen,87,,2,9,11
022 Klausen,88,,2,6,8
022 Klausen,89,,1,1,2
022 Klausen,91,,3,4,7
022 Klausen,92,,-,7,7
022 Klausen,93,,2,-,2
022 Klausen,94,,1,-,1
022 Klausen,95,,-,3,3
022 Klausen,96,,-,2,2
023 Karneid,0,,20,15,35
023 Karneid,1,,22,23,45
023 Karneid,2,,23,16,39
023 Karneid,3,,14,13,27
023 Karneid,4,,22,20,42
023 Karneid,5,,19,20,39
023 Karneid,6,,25,28,53
023 Karneid,7,,20,20,40
023 Karneid,8,,29,21,50
023 Karneid,9,,20,21,41
023 Karneid,10,,24,20,44
023 Karneid,11,,23,23,46
023 Karneid,12,,21,20,41
023 Karneid,13,,25,18,43
023 Karneid,14,,16,21,37
023 Karneid,15,,26,16,42
023 Karneid,16,,15,19,34
023 Karneid,17,,19,19,38
023 Karneid,18,,13,21,34
023 Karneid,19,,20,20,40
023 Karneid,20,,21,14,35
023 Karneid,21,,27,14,41
023 Karneid,22,,18,12,30
023 Karneid,23,,23,14,37
023 Karneid,24,,28,26,54
023 Karneid,25,,25,19,44
023 Karneid,26,,27,26,53
023 Karneid,27,,25,13,38
023 Karneid,28,,21,17,38
023 Karneid,29,,27,28,55
023 Karneid,30,,20,19,39
023 Karneid,31,,24,22,46
023 Karneid,32,,31,30,61
023 Karneid,33,,29,24,53
023 Karneid,34,,36,37,73
023 Karneid,35,,39,20,59
023 Karneid,36,,20,28,48
023 Karneid,37,,35,32,67
023 Karneid,38,,35,34,69
023 Karneid,39,,37,38,75
023 Karneid,40,,32,23,55
023 Karneid,41,,32,26,58
023 Karneid,42,,39,25,64
023 Karneid,43,,27,36,63
023 Karneid,44,,27,22,49
023 Karneid,45,,31,27,58
023 Karneid,46,,29,19,48
023 Karneid,47,,21,18,39
023 Karneid,48,,18,17,35
023 Karneid,49,,22,18,40
023 Karneid,50,,16,11,27
023 Karneid,51,,16,15,31
023 Karneid,52,,20,15,35
023 Karneid,53,,12,20,32
023 Karneid,54,,20,11,31
023 Karneid,55,,24,18,42
023 Karneid,56,,13,15,28
023 Karneid,57,,16,24,40
023 Karneid,58,,9,15,24
023 Karneid,59,,12,21,33
023 Karneid,60,,12,15,27
023 Karneid,61,,12,14,26
023 Karneid,62,,20,14,34
023 Karneid,63,,17,24,41
023 Karneid,64,,21,14,35
023 Karneid,65,,14,15,29
023 Karneid,66,,17,17,34
023 Karneid,67,,21,11,32
023 Karneid,68,,9,8,17
023 Karneid,69,,12,12,24
023 Karneid,70,,8,12,20
023 Karneid,71,,12,15,27
023 Karneid,72,,8,14,22
023 Karneid,73,,13,5,18
023 Karneid,74,,19,11,30
023 Karneid,75,,7,8,15
023 Karneid,76,,12,10,22
023 Karneid,77,,9,8,17
023 Karneid,78,,4,9,13
023 Karneid,79,,8,10,18
023 Karneid,80,,3,7,10
023 Karneid,81,,7,8,15
023 Karneid,82,,4,2,6
023 Karneid,83,,-,7,7
023 Karneid,84,,1,5,6
023 Karneid,85,,3,7,10
023 Karneid,86,,5,2,7
023 Karneid,87,,-,4,4
023 Karneid,88,,1,2,3
023 Karneid,89,,-,2,2
023 Karneid,90,,-,1,1
023 Karneid,91,,1,-,1
023 Karneid,92,,-,2,2
023 Karneid,93,,-,4,4
023 Karneid,94,,-,1,1
023 Karneid,95,,1,-,1
023 Karneid,97,,-,1,1
024 Kurtatsch a.d.Weinstr.,0,,13,15,28
024 Kurtatsch a.d.Weinstr.,1,,10,12,22
024 Kurtatsch a.d.Weinstr.,2,,11,12,23
024 Kurtatsch a.d.Weinstr.,3,,10,19,29
024 Kurtatsch a.d.Weinstr.,4,,20,14,34
024 Kurtatsch a.d.Weinstr.,5,,17,15,32
024 Kurtatsch a.d.Weinstr.,6,,18,11,29
024 Kurtatsch a.d.Weinstr.,7,,16,14,30
024 Kurtatsch a.d.Weinstr.,8,,13,14,27
024 Kurtatsch a.d.Weinstr.,9,,23,18,41
024 Kurtatsch a.d.Weinstr.,10,,19,13,32
024 Kurtatsch a.d.Weinstr.,11,,16,6,22
024 Kurtatsch a.d.Weinstr.,12,,24,20,44
024 Kurtatsch a.d.Weinstr.,13,,21,11,32
024 Kurtatsch a.d.Weinstr.,14,,16,17,33
024 Kurtatsch a.d.Weinstr.,15,,11,7,18
024 Kurtatsch a.d.Weinstr.,16,,10,18,28
024 Kurtatsch a.d.Weinstr.,17,,7,14,21
024 Kurtatsch a.d.Weinstr.,18,,11,12,23
024 Kurtatsch a.d.Weinstr.,19,,10,10,20
024 Kurtatsch a.d.Weinstr.,20,,13,11,24
024 Kurtatsch a.d.Weinstr.,21,,15,10,25
024 Kurtatsch a.d.Weinstr.,22,,15,7,22
024 Kurtatsch a.d.Weinstr.,23,,11,18,29
024 Kurtatsch a.d.Weinstr.,24,,10,11,21
024 Kurtatsch a.d.Weinstr.,25,,7,14,21
024 Kurtatsch a.d.Weinstr.,26,,10,10,20
024 Kurtatsch a.d.Weinstr.,27,,11,9,20
024 Kurtatsch a.d.Weinstr.,28,,10,16,26
024 Kurtatsch a.d.Weinstr.,29,,13,11,24
024 Kurtatsch a.d.Weinstr.,30,,12,12,24
024 Kurtatsch a.d.Weinstr.,31,,9,18,27
024 Kurtatsch a.d.Weinstr.,32,,16,18,34
024 Kurtatsch a.d.Weinstr.,33,,13,18,31
024 Kurtatsch a.d.Weinstr.,34,,12,19,31
024 Kurtatsch a.d.Weinstr.,35,,14,26,40
024 Kurtatsch a.d.Weinstr.,36,,27,23,50
024 Kurtatsch a.d.Weinstr.,37,,29,16,45
024 Kurtatsch a.d.Weinstr.,38,,18,20,38
024 Kurtatsch a.d.Weinstr.,39,,30,16,46
024 Kurtatsch a.d.Weinstr.,40,,26,27,53
024 Kurtatsch a.d.Weinstr.,41,,15,26,41
024 Kurtatsch a.d.Weinstr.,42,,22,20,42
024 Kurtatsch a.d.Weinstr.,43,,27,10,37
024 Kurtatsch a.d.Weinstr.,44,,17,15,32
024 Kurtatsch a.d.Weinstr.,45,,19,22,41
024 Kurtatsch a.d.Weinstr.,46,,19,10,29
024 Kurtatsch a.d.Weinstr.,47,,16,16,32
024 Kurtatsch a.d.Weinstr.,48,,10,10,20
024 Kurtatsch a.d.Weinstr.,49,,9,9,18
024 Kurtatsch a.d.Weinstr.,50,,15,17,32
024 Kurtatsch a.d.Weinstr.,51,,15,8,23
024 Kurtatsch a.d.Weinstr.,52,,17,17,34
024 Kurtatsch a.d.Weinstr.,53,,10,8,18
024 Kurtatsch a.d.Weinstr.,54,,9,13,22
024 Kurtatsch a.d.Weinstr.,55,,14,6,20
024 Kurtatsch a.d.Weinstr.,56,,13,9,22
024 Kurtatsch a.d.Weinstr.,57,,10,7,17
024 Kurtatsch a.d.Weinstr.,58,,12,8,20
024 Kurtatsch a.d.Weinstr.,59,,12,8,20
024 Kurtatsch a.d.Weinstr.,60,,7,8,15
024 Kurtatsch a.d.Weinstr.,61,,5,8,13
024 Kurtatsch a.d.Weinstr.,62,,10,7,17
024 Kurtatsch a.d.Weinstr.,63,,10,12,22
024 Kurtatsch a.d.Weinstr.,64,,8,12,20
024 Kurtatsch a.d.Weinstr.,65,,11,11,22
024 Kurtatsch a.d.Weinstr.,66,,4,15,19
024 Kurtatsch a.d.Weinstr.,67,,12,11,23
024 Kurtatsch a.d.Weinstr.,68,,5,10,15
024 Kurtatsch a.d.Weinstr.,69,,9,7,16
024 Kurtatsch a.d.Weinstr.,70,,5,7,12
024 Kurtatsch a.d.Weinstr.,71,,6,9,15
024 Kurtatsch a.d.Weinstr.,72,,8,7,15
024 Kurtatsch a.d.Weinstr.,73,,11,16,27
024 Kurtatsch a.d.Weinstr.,74,,7,11,18
024 Kurtatsch a.d.Weinstr.,75,,9,15,24
024 Kurtatsch a.d.Weinstr.,76,,8,10,18
024 Kurtatsch a.d.Weinstr.,77,,7,9,16
024 Kurtatsch a.d.Weinstr.,78,,9,6,15
024 Kurtatsch a.d.Weinstr.,79,,5,6,11
024 Kurtatsch a.d.Weinstr.,80,,4,8,12
024 Kurtatsch a.d.Weinstr.,81,,5,8,13
024 Kurtatsch a.d.Weinstr.,82,,7,17,24
024 Kurtatsch a.d.Weinstr.,83,,-,2,2
024 Kurtatsch a.d.Weinstr.,84,,2,6,8
024 Kurtatsch a.d.Weinstr.,85,,5,3,8
024 Kurtatsch a.d.Weinstr.,86,,1,1,2
024 Kurtatsch a.d.Weinstr.,88,,-,3,3
024 Kurtatsch a.d.Weinstr.,89,,-,1,1
024 Kurtatsch a.d.Weinstr.,91,,2,1,3
024 Kurtatsch a.d.Weinstr.,92,,-,1,1
024 Kurtatsch a.d.Weinstr.,93,,2,1,3
024 Kurtatsch a.d.Weinstr.,94,,-,2,2
025 Kurtinig a.d. Weinstr.,0,,-,4,4
025 Kurtinig a.d. Weinstr.,1,,1,2,3
025 Kurtinig a.d. Weinstr.,2,,4,3,7
025 Kurtinig a.d. Weinstr.,3,,3,3,6
025 Kurtinig a.d. Weinstr.,4,,2,8,10
025 Kurtinig a.d. Weinstr.,5,,3,5,8
025 Kurtinig a.d. Weinstr.,6,,3,3,6
025 Kurtinig a.d. Weinstr.,7,,3,6,9
025 Kurtinig a.d. Weinstr.,8,,3,4,7
025 Kurtinig a.d. Weinstr.,9,,1,2,3
025 Kurtinig a.d. Weinstr.,10,,6,2,8
025 Kurtinig a.d. Weinstr.,11,,2,4,6
025 Kurtinig a.d. Weinstr.,12,,4,4,8
025 Kurtinig a.d. Weinstr.,13,,2,3,5
025 Kurtinig a.d. Weinstr.,14,,6,2,8
025 Kurtinig a.d. Weinstr.,15,,3,2,5
025 Kurtinig a.d. Weinstr.,16,,6,4,10
025 Kurtinig a.d. Weinstr.,17,,6,4,10
025 Kurtinig a.d. Weinstr.,18,,5,6,11
025 Kurtinig a.d. Weinstr.,19,,4,4,8
025 Kurtinig a.d. Weinstr.,20,,3,3,6
025 Kurtinig a.d. Weinstr.,21,,3,4,7
025 Kurtinig a.d. Weinstr.,22,,4,4,8
025 Kurtinig a.d. Weinstr.,23,,6,5,11
025 Kurtinig a.d. Weinstr.,24,,4,4,8
025 Kurtinig a.d. Weinstr.,25,,5,4,9
025 Kurtinig a.d. Weinstr.,26,,4,8,12
025 Kurtinig a.d. Weinstr.,27,,3,3,6
025 Kurtinig a.d. Weinstr.,28,,3,1,4
025 Kurtinig a.d. Weinstr.,29,,2,-,2
025 Kurtinig a.d. Weinstr.,30,,2,8,10
025 Kurtinig a.d. Weinstr.,31,,3,2,5
025 Kurtinig a.d. Weinstr.,32,,6,3,9
025 Kurtinig a.d. Weinstr.,33,,2,5,7
025 Kurtinig a.d. Weinstr.,34,,4,3,7
025 Kurtinig a.d. Weinstr.,35,,7,3,10
025 Kurtinig a.d. Weinstr.,36,,7,6,13
025 Kurtinig a.d. Weinstr.,37,,3,3,6
025 Kurtinig a.d. Weinstr.,38,,4,4,8
025 Kurtinig a.d. Weinstr.,39,,2,5,7
025 Kurtinig a.d. Weinstr.,40,,5,4,9
025 Kurtinig a.d. Weinstr.,41,,7,5,12
025 Kurtinig a.d. Weinstr.,42,,8,6,14
025 Kurtinig a.d. Weinstr.,43,,5,5,10
025 Kurtinig a.d. Weinstr.,44,,8,9,17
025 Kurtinig a.d. Weinstr.,45,,5,4,9
025 Kurtinig a.d. Weinstr.,46,,11,5,16
025 Kurtinig a.d. Weinstr.,47,,3,8,11
025 Kurtinig a.d. Weinstr.,48,,7,7,14
025 Kurtinig a.d. Weinstr.,49,,4,2,6
025 Kurtinig a.d. Weinstr.,50,,3,1,4
025 Kurtinig a.d. Weinstr.,51,,7,2,9
025 Kurtinig a.d. Weinstr.,52,,4,6,10
025 Kurtinig a.d. Weinstr.,53,,2,4,6
025 Kurtinig a.d. Weinstr.,54,,3,4,7
025 Kurtinig a.d. Weinstr.,55,,2,3,5
025 Kurtinig a.d. Weinstr.,56,,3,3,6
025 Kurtinig a.d. Weinstr.,57,,4,5,9
025 Kurtinig a.d. Weinstr.,58,,5,2,7
025 Kurtinig a.d. Weinstr.,59,,-,5,5
025 Kurtinig a.d. Weinstr.,60,,3,2,5
025 Kurtinig a.d. Weinstr.,61,,3,2,5
025 Kurtinig a.d. Weinstr.,62,,4,2,6
025 Kurtinig a.d. Weinstr.,63,,2,2,4
025 Kurtinig a.d. Weinstr.,64,,4,2,6
025 Kurtinig a.d. Weinstr.,65,,2,2,4
025 Kurtinig a.d. Weinstr.,66,,5,3,8
025 Kurtinig a.d. Weinstr.,67,,2,2,4
025 Kurtinig a.d. Weinstr.,68,,2,4,6
025 Kurtinig a.d. Weinstr.,69,,5,3,8
025 Kurtinig a.d. Weinstr.,70,,-,6,6
025 Kurtinig a.d. Weinstr.,71,,2,4,6
025 Kurtinig a.d. Weinstr.,72,,1,2,3
025 Kurtinig a.d. Weinstr.,73,,3,4,7
025 Kurtinig a.d. Weinstr.,74,,3,2,5
025 Kurtinig a.d. Weinstr.,75,,4,4,8
025 Kurtinig a.d. Weinstr.,76,,1,3,4
025 Kurtinig a.d. Weinstr.,77,,2,4,6
025 Kurtinig a.d. Weinstr.,78,,2,2,4
025 Kurtinig a.d. Weinstr.,79,,3,1,4
025 Kurtinig a.d. Weinstr.,80,,-,5,5
025 Kurtinig a.d. Weinstr.,81,,1,4,5
025 Kurtinig a.d. Weinstr.,82,,-,1,1
025 Kurtinig a.d. Weinstr.,83,,-,2,2
025 Kurtinig a.d. Weinstr.,84,,2,1,3
025 Kurtinig a.d. Weinstr.,85,,1,-,1
025 Kurtinig a.d. Weinstr.,86,,-,2,2
025 Kurtinig a.d. Weinstr.,87,,-,1,1
025 Kurtinig a.d. Weinstr.,90,,-,1,1
025 Kurtinig a.d. Weinstr.,91,,-,2,2
025 Kurtinig a.d. Weinstr.,93,,-,1,1
026 Corvara,0,,5,6,11
026 Corvara,1,,6,4,10
026 Corvara,2,,12,5,17
026 Corvara,3,,5,4,9
026 Corvara,4,,4,8,12
026 Corvara,5,,7,3,10
026 Corvara,6,,8,7,15
026 Corvara,7,,10,8,18
026 Corvara,8,,3,5,8
026 Corvara,9,,8,4,12
026 Corvara,10,,7,7,14
026 Corvara,11,,6,5,11
026 Corvara,12,,6,3,9
026 Corvara,13,,6,10,16
026 Corvara,14,,2,5,7
026 Corvara,15,,9,7,16
026 Corvara,16,,5,5,10
026 Corvara,17,,5,3,8
026 Corvara,18,,9,7,16
026 Corvara,19,,3,-,3
026 Corvara,20,,5,8,13
026 Corvara,21,,7,3,10
026 Corvara,22,,7,7,14
026 Corvara,23,,8,11,19
026 Corvara,24,,15,3,18
026 Corvara,25,,11,6,17
026 Corvara,26,,10,7,17
026 Corvara,27,,10,3,13
026 Corvara,28,,16,9,25
026 Corvara,29,,11,5,16
026 Corvara,30,,8,20,28
026 Corvara,31,,7,15,22
026 Corvara,32,,11,7,18
026 Corvara,33,,6,8,14
026 Corvara,34,,13,5,18
026 Corvara,35,,9,12,21
026 Corvara,36,,16,10,26
026 Corvara,37,,8,14,22
026 Corvara,38,,15,20,35
026 Corvara,39,,12,17,29
026 Corvara,40,,16,16,32
026 Corvara,41,,8,8,16
026 Corvara,42,,12,10,22
026 Corvara,43,,13,12,25
026 Corvara,44,,8,7,15
026 Corvara,45,,16,13,29
026 Corvara,46,,7,7,14
026 Corvara,47,,10,6,16
026 Corvara,48,,7,5,12
026 Corvara,49,,4,7,11
026 Corvara,50,,11,7,18
026 Corvara,51,,10,8,18
026 Corvara,52,,6,12,18
026 Corvara,53,,5,8,13
026 Corvara,54,,5,9,14
026 Corvara,55,,7,8,15
026 Corvara,56,,3,9,12
026 Corvara,57,,5,5,10
026 Corvara,58,,4,10,14
026 Corvara,59,,14,11,25
026 Corvara,60,,5,5,10
026 Corvara,61,,7,8,15
026 Corvara,62,,5,10,15
026 Corvara,63,,6,8,14
026 Corvara,64,,12,12,24
026 Corvara,65,,9,6,15
026 Corvara,66,,6,4,10
026 Corvara,67,,4,7,11
026 Corvara,68,,5,8,13
026 Corvara,69,,5,7,12
026 Corvara,70,,7,4,11
026 Corvara,71,,6,8,14
026 Corvara,72,,3,4,7
026 Corvara,73,,5,4,9
026 Corvara,74,,7,10,17
026 Corvara,75,,7,3,10
026 Corvara,76,,4,4,8
026 Corvara,77,,1,2,3
026 Corvara,78,,5,3,8
026 Corvara,79,,3,2,5
026 Corvara,80,,1,3,4
026 Corvara,81,,3,-,3
026 Corvara,82,,4,2,6
026 Corvara,83,,3,3,6
026 Corvara,84,,4,1,5
026 Corvara,85,,3,1,4
026 Corvara,86,,1,2,3
026 Corvara,87,,-,1,1
026 Corvara,88,,1,2,3
026 Corvara,91,,-,3,3
026 Corvara,92,,-,2,2
026 Corvara,93,,1,2,3
026 Corvara,94,,1,-,1
026 Corvara,97,,-,1,1
026 Corvara,102,,1,-,1
027 Graun im Vinschgau,0,,12,14,26
027 Graun im Vinschgau,1,,12,16,28
027 Graun im Vinschgau,2,,9,12,21
027 Graun im Vinschgau,3,,10,12,22
027 Graun im Vinschgau,4,,16,15,31
027 Graun im Vinschgau,5,,18,16,34
027 Graun im Vinschgau,6,,15,10,25
027 Graun im Vinschgau,7,,10,15,25
027 Graun im Vinschgau,8,,18,17,35
027 Graun im Vinschgau,9,,22,18,40
027 Graun im Vinschgau,10,,19,16,35
027 Graun im Vinschgau,11,,19,12,31
027 Graun im Vinschgau,12,,21,14,35
027 Graun im Vinschgau,13,,17,15,32
027 Graun im Vinschgau,14,,10,13,23
027 Graun im Vinschgau,15,,18,19,37
027 Graun im Vinschgau,16,,26,17,43
027 Graun im Vinschgau,17,,20,11,31
027 Graun im Vinschgau,18,,16,10,26
027 Graun im Vinschgau,19,,7,8,15
027 Graun im Vinschgau,20,,19,10,29
027 Graun im Vinschgau,21,,18,15,33
027 Graun im Vinschgau,22,,7,16,23
027 Graun im Vinschgau,23,,17,19,36
027 Graun im Vinschgau,24,,21,20,41
027 Graun im Vinschgau,25,,21,17,38
027 Graun im Vinschgau,26,,13,22,35
027 Graun im Vinschgau,27,,17,15,32
027 Graun im Vinschgau,28,,16,19,35
027 Graun im Vinschgau,29,,15,18,33
027 Graun im Vinschgau,30,,21,17,38
027 Graun im Vinschgau,31,,21,14,35
027 Graun im Vinschgau,32,,21,18,39
027 Graun im Vinschgau,33,,22,20,42
027 Graun im Vinschgau,34,,20,12,32
027 Graun im Vinschgau,35,,23,15,38
027 Graun im Vinschgau,36,,27,21,48
027 Graun im Vinschgau,37,,15,22,37
027 Graun im Vinschgau,38,,27,22,49
027 Graun im Vinschgau,39,,19,21,40
027 Graun im Vinschgau,40,,17,20,37
027 Graun im Vinschgau,41,,19,23,42
027 Graun im Vinschgau,42,,23,17,40
027 Graun im Vinschgau,43,,22,24,46
027 Graun im Vinschgau,44,,19,14,33
027 Graun im Vinschgau,45,,20,20,40
027 Graun im Vinschgau,46,,20,11,31
027 Graun im Vinschgau,47,,19,14,33
027 Graun im Vinschgau,48,,12,13,25
027 Graun im Vinschgau,49,,15,10,25
027 Graun im Vinschgau,50,,13,9,22
027 Graun im Vinschgau,51,,17,16,33
027 Graun im Vinschgau,52,,14,6,20
027 Graun im Vinschgau,53,,17,11,28
027 Graun im Vinschgau,54,,13,16,29
027 Graun im Vinschgau,55,,12,12,24
027 Graun im Vinschgau,56,,7,21,28
027 Graun im Vinschgau,57,,14,12,26
027 Graun im Vinschgau,58,,5,10,15
027 Graun im Vinschgau,59,,10,8,18
027 Graun im Vinschgau,60,,8,8,16
027 Graun im Vinschgau,61,,11,10,21
027 Graun im Vinschgau,62,,9,11,20
027 Graun im Vinschgau,63,,10,12,22
027 Graun im Vinschgau,64,,15,10,25
027 Graun im Vinschgau,65,,12,9,21
027 Graun im Vinschgau,66,,11,11,22
027 Graun im Vinschgau,67,,11,11,22
027 Graun im Vinschgau,68,,11,3,14
027 Graun im Vinschgau,69,,13,14,27
027 Graun im Vinschgau,70,,9,8,17
027 Graun im Vinschgau,71,,11,9,20
027 Graun im Vinschgau,72,,8,7,15
027 Graun im Vinschgau,73,,11,7,18
027 Graun im Vinschgau,74,,9,10,19
027 Graun im Vinschgau,75,,4,6,10
027 Graun im Vinschgau,76,,12,13,25
027 Graun im Vinschgau,77,,7,11,18
027 Graun im Vinschgau,78,,6,7,13
027 Graun im Vinschgau,79,,8,12,20
027 Graun im Vinschgau,80,,3,4,7
027 Graun im Vinschgau,81,,5,8,13
027 Graun im Vinschgau,82,,4,11,15
027 Graun im Vinschgau,83,,6,7,13
027 Graun im Vinschgau,84,,6,9,15
027 Graun im Vinschgau,85,,3,1,4
027 Graun im Vinschgau,86,,-,5,5
027 Graun im Vinschgau,87,,2,2,4
027 Graun im Vinschgau,88,,-,1,1
027 Graun im Vinschgau,89,,-,2,2
027 Graun im Vinschgau,90,,-,1,1
027 Graun im Vinschgau,91,,1,2,3
027 Graun im Vinschgau,92,,-,1,1
027 Graun im Vinschgau,93,,1,1,2
027 Graun im Vinschgau,94,,-,2,2
027 Graun im Vinschgau,97,,-,2,2
027 Graun im Vinschgau,102,,-,1,1
028 Toblach,0,,15,17,32
028 Toblach,1,,19,21,40
028 Toblach,2,,16,28,44
028 Toblach,3,,12,21,33
028 Toblach,4,,28,17,45
028 Toblach,5,,22,14,36
028 Toblach,6,,15,23,38
028 Toblach,7,,18,11,29
028 Toblach,8,,24,18,42
028 Toblach,9,,28,22,50
028 Toblach,10,,17,10,27
028 Toblach,11,,23,18,41
028 Toblach,12,,18,19,37
028 Toblach,13,,15,17,32
028 Toblach,14,,17,28,45
028 Toblach,15,,16,22,38
028 Toblach,16,,10,15,25
028 Toblach,17,,13,23,36
028 Toblach,18,,31,16,47
028 Toblach,19,,15,21,36
028 Toblach,20,,23,21,44
028 Toblach,21,,21,27,48
028 Toblach,22,,25,19,44
028 Toblach,23,,28,28,56
028 Toblach,24,,26,22,48
028 Toblach,25,,26,16,42
028 Toblach,26,,32,25,57
028 Toblach,27,,25,24,49
028 Toblach,28,,15,22,37
028 Toblach,29,,23,36,59
028 Toblach,30,,20,21,41
028 Toblach,31,,33,20,53
028 Toblach,32,,31,20,51
028 Toblach,33,,27,32,59
028 Toblach,34,,29,22,51
028 Toblach,35,,21,21,42
028 Toblach,36,,40,27,67
028 Toblach,37,,33,29,62
028 Toblach,38,,26,21,47
028 Toblach,39,,26,28,54
028 Toblach,40,,34,27,61
028 Toblach,41,,35,29,64
028 Toblach,42,,29,25,54
028 Toblach,43,,37,29,66
028 Toblach,44,,23,30,53
028 Toblach,45,,21,16,37
028 Toblach,46,,36,27,63
028 Toblach,47,,24,17,41
028 Toblach,48,,26,22,48
028 Toblach,49,,16,23,39
028 Toblach,50,,17,27,44
028 Toblach,51,,19,20,39
028 Toblach,52,,21,24,45
028 Toblach,53,,20,16,36
028 Toblach,54,,26,11,37
028 Toblach,55,,14,16,30
028 Toblach,56,,19,14,33
028 Toblach,57,,14,24,38
028 Toblach,58,,21,14,35
028 Toblach,59,,12,15,27
028 Toblach,60,,10,17,27
028 Toblach,61,,18,12,30
028 Toblach,62,,13,18,31
028 Toblach,63,,15,19,34
028 Toblach,64,,17,12,29
028 Toblach,65,,13,13,26
028 Toblach,66,,14,13,27
028 Toblach,67,,14,8,22
028 Toblach,68,,4,10,14
028 Toblach,69,,9,16,25
028 Toblach,70,,7,17,24
028 Toblach,71,,14,16,30
028 Toblach,72,,9,10,19
028 Toblach,73,,12,17,29
028 Toblach,74,,14,11,25
028 Toblach,75,,9,11,20
028 Toblach,76,,9,12,21
028 Toblach,77,,10,9,19
028 Toblach,78,,8,14,22
028 Toblach,79,,9,12,21
028 Toblach,80,,10,7,17
028 Toblach,81,,5,8,13
028 Toblach,82,,7,6,13
028 Toblach,83,,4,11,15
028 Toblach,84,,3,8,11
028 Toblach,85,,4,6,10
028 Toblach,86,,3,6,9
028 Toblach,87,,2,2,4
028 Toblach,88,,2,2,4
028 Toblach,89,,1,-,1
028 Toblach,90,,1,6,7
028 Toblach,91,,1,-,1
028 Toblach,92,,1,3,4
028 Toblach,93,,1,1,2
028 Toblach,94,,-,1,1
028 Toblach,95,,-,1,1
028 Toblach,96,,1,-,1
028 Toblach,98,,1,-,1
029 Neumarkt,0,,27,28,55
029 Neumarkt,1,,22,16,38
029 Neumarkt,2,,39,26,65
029 Neumarkt,3,,30,23,53
029 Neumarkt,4,,30,34,64
029 Neumarkt,5,,32,17,49
029 Neumarkt,6,,21,27,48
029 Neumarkt,7,,19,40,59
029 Neumarkt,8,,21,17,38
029 Neumarkt,9,,22,24,46
029 Neumarkt,10,,23,23,46
029 Neumarkt,11,,25,21,46
029 Neumarkt,12,,22,38,60
029 Neumarkt,13,,22,26,48
029 Neumarkt,14,,22,19,41
029 Neumarkt,15,,25,28,53
029 Neumarkt,16,,21,32,53
029 Neumarkt,17,,19,27,46
029 Neumarkt,18,,24,28,52
029 Neumarkt,19,,21,17,38
029 Neumarkt,20,,26,18,44
029 Neumarkt,21,,20,24,44
029 Neumarkt,22,,17,27,44
029 Neumarkt,23,,27,24,51
029 Neumarkt,24,,26,21,47
029 Neumarkt,25,,16,29,45
029 Neumarkt,26,,31,24,55
029 Neumarkt,27,,41,31,72
029 Neumarkt,28,,20,21,41
029 Neumarkt,29,,27,34,61
029 Neumarkt,30,,37,34,71
029 Neumarkt,31,,36,40,76
029 Neumarkt,32,,26,28,54
029 Neumarkt,33,,38,44,82
029 Neumarkt,34,,30,50,80
029 Neumarkt,35,,32,32,64
029 Neumarkt,36,,33,37,70
029 Neumarkt,37,,28,46,74
029 Neumarkt,38,,47,46,93
029 Neumarkt,39,,54,45,99
029 Neumarkt,40,,49,39,88
029 Neumarkt,41,,50,45,95
029 Neumarkt,42,,48,43,91
029 Neumarkt,43,,49,33,82
029 Neumarkt,44,,34,37,71
029 Neumarkt,45,,48,43,91
029 Neumarkt,46,,47,33,80
029 Neumarkt,47,,29,37,66
029 Neumarkt,48,,38,31,69
029 Neumarkt,49,,31,27,58
029 Neumarkt,50,,40,41,81
029 Neumarkt,51,,35,28,63
029 Neumarkt,52,,18,18,36
029 Neumarkt,53,,28,22,50
029 Neumarkt,54,,24,24,48
029 Neumarkt,55,,23,22,45
029 Neumarkt,56,,15,26,41
029 Neumarkt,57,,20,23,43
029 Neumarkt,58,,25,30,55
029 Neumarkt,59,,33,32,65
029 Neumarkt,60,,24,22,46
029 Neumarkt,61,,20,18,38
029 Neumarkt,62,,24,21,45
029 Neumarkt,63,,22,25,47
029 Neumarkt,64,,37,26,63
029 Neumarkt,65,,28,32,60
029 Neumarkt,66,,17,28,45
029 Neumarkt,67,,19,18,37
029 Neumarkt,68,,22,15,37
029 Neumarkt,69,,19,17,36
029 Neumarkt,70,,20,22,42
029 Neumarkt,71,,14,21,35
029 Neumarkt,72,,17,19,36
029 Neumarkt,73,,18,22,40
029 Neumarkt,74,,21,30,51
029 Neumarkt,75,,17,23,40
029 Neumarkt,76,,12,16,28
029 Neumarkt,77,,6,19,25
029 Neumarkt,78,,16,16,32
029 Neumarkt,79,,13,18,31
029 Neumarkt,80,,14,20,34
029 Neumarkt,81,,7,14,21
029 Neumarkt,82,,14,24,38
029 Neumarkt,83,,7,13,20
029 Neumarkt,84,,5,21,26
029 Neumarkt,85,,2,16,18
029 Neumarkt,86,,3,6,9
029 Neumarkt,87,,4,3,7
029 Neumarkt,88,,-,5,5
029 Neumarkt,89,,1,2,3
029 Neumarkt,90,,-,5,5
029 Neumarkt,91,,2,4,6
029 Neumarkt,92,,3,4,7
029 Neumarkt,93,,1,6,7
029 Neumarkt,94,,1,3,4
029 Neumarkt,95,,-,1,1
029 Neumarkt,96,,1,1,2
029 Neumarkt,99,,-,1,1
030 Pfalzen,0,,16,13,29
030 Pfalzen,1,,16,16,32
030 Pfalzen,2,,19,13,32
030 Pfalzen,3,,14,15,29
030 Pfalzen,4,,15,15,30
030 Pfalzen,5,,13,16,29
030 Pfalzen,6,,18,18,36
030 Pfalzen,7,,16,18,34
030 Pfalzen,8,,13,16,29
030 Pfalzen,9,,15,16,31
030 Pfalzen,10,,22,18,40
030 Pfalzen,11,,10,16,26
030 Pfalzen,12,,11,19,30
030 Pfalzen,13,,13,22,35
030 Pfalzen,14,,14,19,33
030 Pfalzen,15,,18,13,31
030 Pfalzen,16,,18,20,38
030 Pfalzen,17,,13,9,22
030 Pfalzen,18,,14,23,37
030 Pfalzen,19,,19,18,37
030 Pfalzen,20,,22,14,36
030 Pfalzen,21,,15,12,27
030 Pfalzen,22,,12,9,21
030 Pfalzen,23,,18,21,39
030 Pfalzen,24,,18,19,37
030 Pfalzen,25,,19,16,35
030 Pfalzen,26,,16,20,36
030 Pfalzen,27,,19,16,35
030 Pfalzen,28,,20,14,34
030 Pfalzen,29,,21,12,33
030 Pfalzen,30,,10,17,27
030 Pfalzen,31,,24,18,42
030 Pfalzen,32,,19,21,40
030 Pfalzen,33,,19,18,37
030 Pfalzen,34,,25,24,49
030 Pfalzen,35,,20,25,45
030 Pfalzen,36,,29,12,41
030 Pfalzen,37,,21,34,55
030 Pfalzen,38,,21,20,41
030 Pfalzen,39,,23,23,46
030 Pfalzen,40,,22,26,48
030 Pfalzen,41,,18,19,37
030 Pfalzen,42,,31,19,50
030 Pfalzen,43,,22,30,52
030 Pfalzen,44,,25,19,44
030 Pfalzen,45,,21,14,35
030 Pfalzen,46,,14,14,28
030 Pfalzen,47,,17,21,38
030 Pfalzen,48,,24,19,43
030 Pfalzen,49,,16,14,30
030 Pfalzen,50,,15,11,26
030 Pfalzen,51,,13,11,24
030 Pfalzen,52,,14,11,25
030 Pfalzen,53,,10,11,21
030 Pfalzen,54,,16,18,34
030 Pfalzen,55,,11,11,22
030 Pfalzen,56,,16,6,22
030 Pfalzen,57,,10,10,20
030 Pfalzen,58,,11,3,14
030 Pfalzen,59,,8,9,17
030 Pfalzen,60,,7,8,15
030 Pfalzen,61,,9,6,15
030 Pfalzen,62,,8,11,19
030 Pfalzen,63,,7,13,20
030 Pfalzen,64,,11,8,19
030 Pfalzen,65,,12,9,21
030 Pfalzen,66,,9,5,14
030 Pfalzen,67,,12,10,22
030 Pfalzen,68,,6,5,11
030 Pfalzen,69,,2,9,11
030 Pfalzen,70,,7,5,12
030 Pfalzen,71,,8,13,21
030 Pfalzen,72,,6,8,14
030 Pfalzen,73,,9,5,14
030 Pfalzen,74,,10,6,16
030 Pfalzen,75,,7,10,17
030 Pfalzen,76,,9,5,14
030 Pfalzen,77,,2,5,7
030 Pfalzen,78,,5,5,10
030 Pfalzen,79,,4,4,8
030 Pfalzen,80,,6,3,9
030 Pfalzen,81,,3,9,12
030 Pfalzen,82,,5,5,10
030 Pfalzen,83,,2,3,5
030 Pfalzen,84,,-,5,5
030 Pfalzen,85,,1,6,7
030 Pfalzen,86,,3,2,5
030 Pfalzen,87,,1,1,2
030 Pfalzen,88,,-,1,1
030 Pfalzen,89,,-,2,2
030 Pfalzen,91,,1,4,5
030 Pfalzen,92,,1,1,2
030 Pfalzen,96,,-,1,1
030 Pfalzen,97,,1,-,1
031 Völs am Schlern,0,,33,13,46
031 Völs am Schlern,1,,15,14,29
031 Völs am Schlern,2,,12,23,35
031 Völs am Schlern,3,,19,30,49
031 Völs am Schlern,4,,19,25,44
031 Völs am Schlern,5,,22,29,51
031 Völs am Schlern,6,,22,18,40
031 Völs am Schlern,7,,25,26,51
031 Völs am Schlern,8,,19,24,43
031 Völs am Schlern,9,,14,21,35
031 Völs am Schlern,10,,21,23,44
031 Völs am Schlern,11,,20,10,30
031 Völs am Schlern,12,,16,16,32
031 Völs am Schlern,13,,19,17,36
031 Völs am Schlern,14,,13,20,33
031 Völs am Schlern,15,,20,18,38
031 Völs am Schlern,16,,19,15,34
031 Völs am Schlern,17,,17,14,31
031 Völs am Schlern,18,,18,14,32
031 Völs am Schlern,19,,23,13,36
031 Völs am Schlern,20,,16,13,29
031 Völs am Schlern,21,,17,5,22
031 Völs am Schlern,22,,11,23,34
031 Völs am Schlern,23,,17,21,38
031 Völs am Schlern,24,,28,18,46
031 Völs am Schlern,25,,29,16,45
031 Völs am Schlern,26,,24,25,49
031 Völs am Schlern,27,,25,18,43
031 Völs am Schlern,28,,20,25,45
031 Völs am Schlern,29,,34,19,53
031 Völs am Schlern,30,,24,19,43
031 Völs am Schlern,31,,21,23,44
031 Völs am Schlern,32,,27,28,55
031 Völs am Schlern,33,,38,26,64
031 Völs am Schlern,34,,37,35,72
031 Völs am Schlern,35,,29,36,65
031 Völs am Schlern,36,,35,32,67
031 Völs am Schlern,37,,30,37,67
031 Völs am Schlern,38,,28,26,54
031 Völs am Schlern,39,,37,29,66
031 Völs am Schlern,40,,29,27,56
031 Völs am Schlern,41,,28,24,52
031 Völs am Schlern,42,,33,22,55
031 Völs am Schlern,43,,30,19,49
031 Völs am Schlern,44,,23,20,43
031 Völs am Schlern,45,,20,18,38
031 Völs am Schlern,46,,20,11,31
031 Völs am Schlern,47,,21,16,37
031 Völs am Schlern,48,,22,18,40
031 Völs am Schlern,49,,18,18,36
031 Völs am Schlern,50,,18,15,33
031 Völs am Schlern,51,,17,26,43
031 Völs am Schlern,52,,17,23,40
031 Völs am Schlern,53,,19,17,36
031 Völs am Schlern,54,,17,21,38
031 Völs am Schlern,55,,19,16,35
031 Völs am Schlern,56,,17,9,26
031 Völs am Schlern,57,,16,12,28
031 Völs am Schlern,58,,16,20,36
031 Völs am Schlern,59,,17,12,29
031 Völs am Schlern,60,,10,13,23
031 Völs am Schlern,61,,15,10,25
031 Völs am Schlern,62,,14,23,37
031 Völs am Schlern,63,,15,17,32
031 Völs am Schlern,64,,20,20,40
031 Völs am Schlern,65,,11,20,31
031 Völs am Schlern,66,,13,11,24
031 Völs am Schlern,67,,11,15,26
031 Völs am Schlern,68,,9,10,19
031 Völs am Schlern,69,,8,18,26
031 Völs am Schlern,70,,15,12,27
031 Völs am Schlern,71,,13,8,21
031 Völs am Schlern,72,,7,14,21
031 Völs am Schlern,73,,13,7,20
031 Völs am Schlern,74,,12,15,27
031 Völs am Schlern,75,,6,12,18
031 Völs am Schlern,76,,7,10,17
031 Völs am Schlern,77,,5,13,18
031 Völs am Schlern,78,,8,10,18
031 Völs am Schlern,79,,5,6,11
031 Völs am Schlern,80,,6,10,16
031 Völs am Schlern,81,,8,12,20
031 Völs am Schlern,82,,3,4,7
031 Völs am Schlern,83,,3,7,10
031 Völs am Schlern,84,,4,10,14
031 Völs am Schlern,85,,3,6,9
031 Völs am Schlern,86,,1,5,6
031 Völs am Schlern,87,,1,4,5
031 Völs am Schlern,88,,1,3,4
031 Völs am Schlern,89,,1,2,3
031 Völs am Schlern,90,,2,2,4
031 Völs am Schlern,91,,2,5,7
031 Völs am Schlern,92,,2,-,2
031 Völs am Schlern,94,,1,1,2
031 Völs am Schlern,95,,1,1,2
031 Völs am Schlern,96,,1,-,1
031 Völs am Schlern,97,,-,2,2
032 Franzensfeste,0,,5,5,10
032 Franzensfeste,1,,4,4,8
032 Franzensfeste,2,,7,2,9
032 Franzensfeste,3,,9,5,14
032 Franzensfeste,4,,5,6,11
032 Franzensfeste,5,,3,4,7
032 Franzensfeste,6,,6,5,11
032 Franzensfeste,7,,6,5,11
032 Franzensfeste,8,,6,2,8
032 Franzensfeste,9,,5,4,9
032 Franzensfeste,10,,6,2,8
032 Franzensfeste,11,,5,6,11
032 Franzensfeste,12,,7,5,12
032 Franzensfeste,13,,5,7,12
032 Franzensfeste,14,,5,4,9
032 Franzensfeste,15,,2,5,7
032 Franzensfeste,16,,5,4,9
032 Franzensfeste,17,,3,3,6
032 Franzensfeste,18,,5,3,8
032 Franzensfeste,19,,6,4,10
032 Franzensfeste,20,,5,6,11
032 Franzensfeste,21,,6,7,13
032 Franzensfeste,22,,8,6,14
032 Franzensfeste,23,,5,7,12
032 Franzensfeste,24,,8,4,12
032 Franzensfeste,25,,6,8,14
032 Franzensfeste,26,,11,4,15
032 Franzensfeste,27,,6,5,11
032 Franzensfeste,28,,2,4,6
032 Franzensfeste,29,,3,4,7
032 Franzensfeste,30,,6,10,16
032 Franzensfeste,31,,10,7,17
032 Franzensfeste,32,,3,5,8
032 Franzensfeste,33,,5,11,16
032 Franzensfeste,34,,5,2,7
032 Franzensfeste,35,,12,7,19
032 Franzensfeste,36,,10,5,15
032 Franzensfeste,37,,9,13,22
032 Franzensfeste,38,,9,5,14
032 Franzensfeste,39,,10,5,15
032 Franzensfeste,40,,9,6,15
032 Franzensfeste,41,,15,8,23
032 Franzensfeste,42,,7,10,17
032 Franzensfeste,43,,12,3,15
032 Franzensfeste,44,,6,10,16
032 Franzensfeste,45,,5,7,12
032 Franzensfeste,46,,8,10,18
032 Franzensfeste,47,,12,3,15
032 Franzensfeste,48,,5,6,11
032 Franzensfeste,49,,4,7,11
032 Franzensfeste,50,,9,7,16
032 Franzensfeste,51,,6,10,16
032 Franzensfeste,52,,7,6,13
032 Franzensfeste,53,,5,4,9
032 Franzensfeste,54,,8,1,9
032 Franzensfeste,55,,11,3,14
032 Franzensfeste,56,,2,4,6
032 Franzensfeste,57,,6,4,10
032 Franzensfeste,58,,2,3,5
032 Franzensfeste,59,,8,6,14
032 Franzensfeste,60,,4,7,11
032 Franzensfeste,61,,4,9,13
032 Franzensfeste,62,,3,3,6
032 Franzensfeste,63,,5,2,7
032 Franzensfeste,64,,5,2,7
032 Franzensfeste,65,,3,4,7
032 Franzensfeste,66,,6,3,9
032 Franzensfeste,67,,1,3,4
032 Franzensfeste,68,,7,5,12
032 Franzensfeste,69,,4,2,6
032 Franzensfeste,70,,3,2,5
032 Franzensfeste,71,,3,3,6
032 Franzensfeste,72,,2,6,8
032 Franzensfeste,73,,3,6,9
032 Franzensfeste,74,,2,8,10
032 Franzensfeste,75,,6,4,10
032 Franzensfeste,76,,4,7,11
032 Franzensfeste,77,,2,2,4
032 Franzensfeste,78,,3,6,9
032 Franzensfeste,79,,4,10,14
032 Franzensfeste,80,,3,1,4
032 Franzensfeste,81,,5,5,10
032 Franzensfeste,82,,3,6,9
032 Franzensfeste,83,,3,4,7
032 Franzensfeste,84,,1,3,4
032 Franzensfeste,85,,-,1,1
032 Franzensfeste,86,,1,-,1
032 Franzensfeste,87,,-,2,2
032 Franzensfeste,90,,1,2,3
032 Franzensfeste,92,,1,-,1
032 Franzensfeste,93,,-,1,1
032 Franzensfeste,94,,-,1,1
033 Villnöss,0,,18,20,38
033 Villnöss,1,,12,14,26
033 Villnöss,2,,16,14,30
033 Villnöss,3,,20,13,33
033 Villnöss,4,,14,22,36
033 Villnöss,5,,18,14,32
033 Villnöss,6,,17,30,47
033 Villnöss,7,,23,19,42
033 Villnöss,8,,17,22,39
033 Villnöss,9,,22,17,39
033 Villnöss,10,,16,13,29
033 Villnöss,11,,15,12,27
033 Villnöss,12,,17,12,29
033 Villnöss,13,,12,14,26
033 Villnöss,14,,20,16,36
033 Villnöss,15,,15,11,26
033 Villnöss,16,,13,8,21
033 Villnöss,17,,15,23,38
033 Villnöss,18,,16,21,37
033 Villnöss,19,,10,16,26
033 Villnöss,20,,16,18,34
033 Villnöss,21,,15,14,29
033 Villnöss,22,,16,14,30
033 Villnöss,23,,12,16,28
033 Villnöss,24,,13,16,29
033 Villnöss,25,,19,11,30
033 Villnöss,26,,11,10,21
033 Villnöss,27,,16,14,30
033 Villnöss,28,,16,11,27
033 Villnöss,29,,14,11,25
033 Villnöss,30,,22,13,35
033 Villnöss,31,,21,19,40
033 Villnöss,32,,9,17,26
033 Villnöss,33,,19,23,42
033 Villnöss,34,,25,25,50
033 Villnöss,35,,18,25,43
033 Villnöss,36,,27,22,49
033 Villnöss,37,,30,20,50
033 Villnöss,38,,19,17,36
033 Villnöss,39,,25,20,45
033 Villnöss,40,,26,23,49
033 Villnöss,41,,32,26,58
033 Villnöss,42,,30,19,49
033 Villnöss,43,,27,20,47
033 Villnöss,44,,24,14,38
033 Villnöss,45,,21,11,32
033 Villnöss,46,,10,10,20
033 Villnöss,47,,10,15,25
033 Villnöss,48,,13,12,25
033 Villnöss,49,,15,16,31
033 Villnöss,50,,12,3,15
033 Villnöss,51,,17,13,30
033 Villnöss,52,,13,14,27
033 Villnöss,53,,13,11,24
033 Villnöss,54,,11,9,20
033 Villnöss,55,,7,9,16
033 Villnöss,56,,7,13,20
033 Villnöss,57,,10,10,20
033 Villnöss,58,,11,11,22
033 Villnöss,59,,11,5,16
033 Villnöss,60,,8,4,12
033 Villnöss,61,,8,14,22
033 Villnöss,62,,12,10,22
033 Villnöss,63,,11,18,29
033 Villnöss,64,,13,10,23
033 Villnöss,65,,8,18,26
033 Villnöss,66,,12,13,25
033 Villnöss,67,,12,9,21
033 Villnöss,68,,9,14,23
033 Villnöss,69,,4,16,20
033 Villnöss,70,,6,9,15
033 Villnöss,71,,10,9,19
033 Villnöss,72,,9,11,20
033 Villnöss,73,,13,13,26
033 Villnöss,74,,10,11,21
033 Villnöss,75,,10,10,20
033 Villnöss,76,,9,12,21
033 Villnöss,77,,14,6,20
033 Villnöss,78,,6,9,15
033 Villnöss,79,,3,8,11
033 Villnöss,80,,6,6,12
033 Villnöss,81,,4,9,13
033 Villnöss,82,,6,11,17
033 Villnöss,83,,3,6,9
033 Villnöss,84,,1,4,5
033 Villnöss,85,,-,6,6
033 Villnöss,86,,2,4,6
033 Villnöss,87,,-,1,1
033 Villnöss,88,,1,3,4
033 Villnöss,89,,-,1,1
033 Villnöss,90,,1,2,3
033 Villnöss,91,,1,3,4
033 Villnöss,92,,-,2,2
033 Villnöss,94,,1,1,2
033 Villnöss,96,,-,2,2
034 Gais,0,,25,19,44
034 Gais,1,,12,24,36
034 Gais,2,,19,16,35
034 Gais,3,,26,22,48
034 Gais,4,,22,14,36
034 Gais,5,,21,18,39
034 Gais,6,,21,29,50
034 Gais,7,,23,22,45
034 Gais,8,,29,12,41
034 Gais,9,,9,19,28
034 Gais,10,,28,19,47
034 Gais,11,,23,25,48
034 Gais,12,,12,19,31
034 Gais,13,,22,30,52
034 Gais,14,,24,31,55
034 Gais,15,,15,20,35
034 Gais,16,,17,14,31
034 Gais,17,,16,16,32
034 Gais,18,,18,23,41
034 Gais,19,,17,18,35
034 Gais,20,,21,16,37
034 Gais,21,,21,15,36
034 Gais,22,,22,21,43
034 Gais,23,,18,17,35
034 Gais,24,,24,18,42
034 Gais,25,,24,25,49
034 Gais,26,,24,14,38
034 Gais,27,,19,20,39
034 Gais,28,,19,26,45
034 Gais,29,,24,23,47
034 Gais,30,,26,19,45
034 Gais,31,,30,26,56
034 Gais,32,,25,25,50
034 Gais,33,,30,40,70
034 Gais,34,,36,27,63
034 Gais,35,,27,25,52
034 Gais,36,,38,33,71
034 Gais,37,,23,21,44
034 Gais,38,,26,30,56
034 Gais,39,,35,21,56
034 Gais,40,,26,23,49
034 Gais,41,,30,32,62
034 Gais,42,,16,18,34
034 Gais,43,,31,20,51
034 Gais,44,,24,30,54
034 Gais,45,,17,13,30
034 Gais,46,,17,21,38
034 Gais,47,,26,20,46
034 Gais,48,,12,17,29
034 Gais,49,,24,20,44
034 Gais,50,,18,13,31
034 Gais,51,,15,13,28
034 Gais,52,,13,14,27
034 Gais,53,,15,18,33
034 Gais,54,,17,20,37
034 Gais,55,,22,21,43
034 Gais,56,,15,12,27
034 Gais,57,,24,14,38
034 Gais,58,,20,11,31
034 Gais,59,,18,19,37
034 Gais,60,,13,9,22
034 Gais,61,,12,13,25
034 Gais,62,,12,16,28
034 Gais,63,,13,13,26
034 Gais,64,,21,12,33
034 Gais,65,,18,12,30
034 Gais,66,,13,15,28
034 Gais,67,,15,13,28
034 Gais,68,,17,16,33
034 Gais,69,,10,13,23
034 Gais,70,,12,12,24
034 Gais,71,,6,6,12
034 Gais,72,,4,10,14
034 Gais,73,,7,9,16
034 Gais,74,,11,7,18
034 Gais,75,,4,13,17
034 Gais,76,,4,5,9
034 Gais,77,,10,7,17
034 Gais,78,,7,8,15
034 Gais,79,,11,7,18
034 Gais,80,,4,5,9
034 Gais,81,,4,6,10
034 Gais,82,,4,9,13
034 Gais,83,,2,4,6
034 Gais,84,,3,4,7
034 Gais,85,,2,1,3
034 Gais,86,,2,2,4
034 Gais,87,,2,2,4
034 Gais,88,,1,-,1
034 Gais,89,,-,2,2
034 Gais,90,,-,2,2
034 Gais,91,,1,1,2
034 Gais,92,,2,1,3
034 Gais,94,,-,1,1
035 Gargazon,0,,5,10,15
035 Gargazon,1,,10,7,17
035 Gargazon,2,,8,13,21
035 Gargazon,3,,8,15,23
035 Gargazon,4,,4,8,12
035 Gargazon,5,,10,6,16
035 Gargazon,6,,13,8,21
035 Gargazon,7,,15,10,25
035 Gargazon,8,,5,14,19
035 Gargazon,9,,10,6,16
035 Gargazon,10,,11,4,15
035 Gargazon,11,,3,7,10
035 Gargazon,12,,9,8,17
035 Gargazon,13,,14,8,22
035 Gargazon,14,,16,9,25
035 Gargazon,15,,7,10,17
035 Gargazon,16,,8,7,15
035 Gargazon,17,,9,5,14
035 Gargazon,18,,6,9,15
035 Gargazon,19,,5,10,15
035 Gargazon,20,,11,5,16
035 Gargazon,21,,9,3,12
035 Gargazon,22,,4,9,13
035 Gargazon,23,,6,7,13
035 Gargazon,24,,9,6,15
035 Gargazon,25,,9,12,21
035 Gargazon,26,,6,8,14
035 Gargazon,27,,4,14,18
035 Gargazon,28,,8,7,15
035 Gargazon,29,,4,7,11
035 Gargazon,30,,8,11,19
035 Gargazon,31,,15,10,25
035 Gargazon,32,,15,10,25
035 Gargazon,33,,8,20,28
035 Gargazon,34,,15,13,28
035 Gargazon,35,,10,13,23
035 Gargazon,36,,15,14,29
035 Gargazon,37,,16,18,34
035 Gargazon,38,,13,15,28
035 Gargazon,39,,14,14,28
035 Gargazon,40,,14,8,22
035 Gargazon,41,,16,16,32
035 Gargazon,42,,21,17,38
035 Gargazon,43,,12,14,26
035 Gargazon,44,,10,13,23
035 Gargazon,45,,11,11,22
035 Gargazon,46,,17,14,31
035 Gargazon,47,,6,7,13
035 Gargazon,48,,14,10,24
035 Gargazon,49,,12,6,18
035 Gargazon,50,,6,3,9
035 Gargazon,51,,10,10,20
035 Gargazon,52,,13,9,22
035 Gargazon,53,,4,8,12
035 Gargazon,54,,10,9,19
035 Gargazon,55,,8,6,14
035 Gargazon,56,,6,10,16
035 Gargazon,57,,8,8,16
035 Gargazon,58,,5,6,11
035 Gargazon,59,,7,14,21
035 Gargazon,60,,8,6,14
035 Gargazon,61,,4,4,8
035 Gargazon,62,,5,7,12
035 Gargazon,63,,6,12,18
035 Gargazon,64,,9,8,17
035 Gargazon,65,,5,17,22
035 Gargazon,66,,8,7,15
035 Gargazon,67,,9,7,16
035 Gargazon,68,,8,14,22
035 Gargazon,69,,6,4,10
035 Gargazon,70,,12,2,14
035 Gargazon,71,,6,5,11
035 Gargazon,72,,1,10,11
035 Gargazon,73,,6,2,8
035 Gargazon,74,,3,7,10
035 Gargazon,75,,3,5,8
035 Gargazon,76,,2,9,11
035 Gargazon,77,,2,4,6
035 Gargazon,78,,3,5,8
035 Gargazon,79,,5,3,8
035 Gargazon,80,,2,6,8
035 Gargazon,81,,1,3,4
035 Gargazon,82,,5,4,9
035 Gargazon,83,,3,7,10
035 Gargazon,84,,4,3,7
035 Gargazon,85,,1,1,2
035 Gargazon,86,,2,1,3
035 Gargazon,87,,-,2,2
035 Gargazon,88,,-,1,1
035 Gargazon,89,,-,1,1
035 Gargazon,90,,2,3,5
035 Gargazon,91,,2,-,2
035 Gargazon,92,,1,4,5
035 Gargazon,93,,1,2,3
035 Gargazon,96,,-,1,1
035 Gargazon,99,,-,1,1
036 Glurns,0,,9,4,13
036 Glurns,1,,3,5,8
036 Glurns,2,,6,5,11
036 Glurns,3,,3,6,9
036 Glurns,4,,5,-,5
036 Glurns,5,,4,4,8
036 Glurns,6,,3,4,7
036 Glurns,7,,10,4,14
036 Glurns,8,,4,7,11
036 Glurns,9,,8,4,12
036 Glurns,10,,7,4,11
036 Glurns,11,,2,3,5
036 Glurns,12,,7,7,14
036 Glurns,13,,5,8,13
036 Glurns,14,,6,4,10
036 Glurns,15,,8,6,14
036 Glurns,16,,4,3,7
036 Glurns,17,,7,9,16
036 Glurns,18,,6,6,12
036 Glurns,19,,6,7,13
036 Glurns,20,,3,3,6
036 Glurns,21,,6,6,12
036 Glurns,22,,8,6,14
036 Glurns,23,,9,8,17
036 Glurns,24,,7,5,12
036 Glurns,25,,13,6,19
036 Glurns,26,,6,9,15
036 Glurns,27,,5,6,11
036 Glurns,28,,5,4,9
036 Glurns,29,,10,6,16
036 Glurns,30,,8,9,17
036 Glurns,31,,9,11,20
036 Glurns,32,,3,4,7
036 Glurns,33,,4,6,10
036 Glurns,34,,6,4,10
036 Glurns,35,,5,-,5
036 Glurns,36,,3,5,8
036 Glurns,37,,6,4,10
036 Glurns,38,,6,9,15
036 Glurns,39,,5,8,13
036 Glurns,40,,1,6,7
036 Glurns,41,,9,4,13
036 Glurns,42,,6,9,15
036 Glurns,43,,4,6,10
036 Glurns,44,,4,5,9
036 Glurns,45,,7,9,16
036 Glurns,46,,12,8,20
036 Glurns,47,,4,10,14
036 Glurns,48,,6,12,18
036 Glurns,49,,7,5,12
036 Glurns,50,,9,7,16
036 Glurns,51,,12,4,16
036 Glurns,52,,8,9,17
036 Glurns,53,,5,10,15
036 Glurns,54,,8,10,18
036 Glurns,55,,6,5,11
036 Glurns,56,,6,3,9
036 Glurns,57,,8,5,13
036 Glurns,58,,11,7,18
036 Glurns,59,,8,2,10
036 Glurns,60,,6,1,7
036 Glurns,61,,4,4,8
036 Glurns,62,,1,4,5
036 Glurns,63,,4,6,10
036 Glurns,64,,4,2,6
036 Glurns,65,,6,1,7
036 Glurns,66,,1,3,4
036 Glurns,67,,4,4,8
036 Glurns,68,,4,5,9
036 Glurns,69,,-,1,1
036 Glurns,70,,2,4,6
036 Glurns,71,,1,5,6
036 Glurns,72,,1,1,2
036 Glurns,73,,6,3,9
036 Glurns,74,,4,1,5
036 Glurns,75,,3,2,5
036 Glurns,76,,2,7,9
036 Glurns,77,,-,3,3
036 Glurns,78,,1,3,4
036 Glurns,79,,-,2,2
036 Glurns,80,,1,6,7
036 Glurns,81,,2,2,4
036 Glurns,82,,-,1,1
036 Glurns,83,,1,-,1
036 Glurns,84,,1,-,1
036 Glurns,85,,1,-,1
036 Glurns,86,,1,2,3
036 Glurns,88,,-,2,2
036 Glurns,90,,-,1,1
036 Glurns,92,,-,2,2
036 Glurns,93,,-,2,2
036 Glurns,94,,1,-,1
037 Latsch,0,,21,26,47
037 Latsch,1,,30,22,52
037 Latsch,2,,26,24,50
037 Latsch,3,,28,30,58
037 Latsch,4,,34,25,59
037 Latsch,5,,33,31,64
037 Latsch,6,,32,22,54
037 Latsch,7,,27,19,46
037 Latsch,8,,35,39,74
037 Latsch,9,,36,35,71
037 Latsch,10,,46,35,81
037 Latsch,11,,39,22,61
037 Latsch,12,,34,34,68
037 Latsch,13,,35,35,70
037 Latsch,14,,29,36,65
037 Latsch,15,,34,51,85
037 Latsch,16,,35,32,67
037 Latsch,17,,40,34,74
037 Latsch,18,,32,38,70
037 Latsch,19,,37,26,63
037 Latsch,20,,32,35,67
037 Latsch,21,,35,36,71
037 Latsch,22,,30,36,66
037 Latsch,23,,31,49,80
037 Latsch,24,,30,46,76
037 Latsch,25,,32,37,69
037 Latsch,26,,39,34,73
037 Latsch,27,,31,19,50
037 Latsch,28,,28,32,60
037 Latsch,29,,29,23,52
037 Latsch,30,,35,31,66
037 Latsch,31,,26,28,54
037 Latsch,32,,33,34,67
037 Latsch,33,,33,36,69
037 Latsch,34,,44,43,87
037 Latsch,35,,36,33,69
037 Latsch,36,,41,44,85
037 Latsch,37,,47,48,95
037 Latsch,38,,55,51,106
037 Latsch,39,,32,51,83
037 Latsch,40,,55,48,103
037 Latsch,41,,61,45,106
037 Latsch,42,,56,45,101
037 Latsch,43,,43,43,86
037 Latsch,44,,47,39,86
037 Latsch,45,,39,54,93
037 Latsch,46,,43,46,89
037 Latsch,47,,40,30,70
037 Latsch,48,,31,33,64
037 Latsch,49,,31,33,64
037 Latsch,50,,37,28,65
037 Latsch,51,,32,22,54
037 Latsch,52,,26,22,48
037 Latsch,53,,40,20,60
037 Latsch,54,,20,33,53
037 Latsch,55,,31,15,46
037 Latsch,56,,16,21,37
037 Latsch,57,,17,23,40
037 Latsch,58,,18,16,34
037 Latsch,59,,20,21,41
037 Latsch,60,,20,18,38
037 Latsch,61,,24,13,37
037 Latsch,62,,25,22,47
037 Latsch,63,,25,24,49
037 Latsch,64,,18,26,44
037 Latsch,65,,19,24,43
037 Latsch,66,,18,18,36
037 Latsch,67,,16,27,43
037 Latsch,68,,13,26,39
037 Latsch,69,,17,13,30
037 Latsch,70,,28,14,42
037 Latsch,71,,17,26,43
037 Latsch,72,,17,22,39
037 Latsch,73,,23,20,43
037 Latsch,74,,17,18,35
037 Latsch,75,,18,19,37
037 Latsch,76,,17,17,34
037 Latsch,77,,16,18,34
037 Latsch,78,,13,27,40
037 Latsch,79,,19,17,36
037 Latsch,80,,15,19,34
037 Latsch,81,,7,16,23
037 Latsch,82,,8,17,25
037 Latsch,83,,7,16,23
037 Latsch,84,,12,8,20
037 Latsch,85,,5,7,12
037 Latsch,86,,4,10,14
037 Latsch,87,,3,3,6
037 Latsch,88,,1,2,3
037 Latsch,89,,1,1,2
037 Latsch,90,,-,4,4
037 Latsch,91,,2,6,8
037 Latsch,92,,1,3,4
037 Latsch,93,,1,2,3
037 Latsch,94,,-,1,1
037 Latsch,96,,1,1,2
038 Algund,0,,19,21,40
038 Algund,1,,18,18,36
038 Algund,2,,25,21,46
038 Algund,3,,19,24,43
038 Algund,4,,30,24,54
038 Algund,5,,20,24,44
038 Algund,6,,33,25,58
038 Algund,7,,21,21,42
038 Algund,8,,21,19,40
038 Algund,9,,14,20,34
038 Algund,10,,30,21,51
038 Algund,11,,26,15,41
038 Algund,12,,23,16,39
038 Algund,13,,30,20,50
038 Algund,14,,25,24,49
038 Algund,15,,30,19,49
038 Algund,16,,19,27,46
038 Algund,17,,18,25,43
038 Algund,18,,31,22,53
038 Algund,19,,21,33,54
038 Algund,20,,25,19,44
038 Algund,21,,22,25,47
038 Algund,22,,27,32,59
038 Algund,23,,25,21,46
038 Algund,24,,24,26,50
038 Algund,25,,30,26,56
038 Algund,26,,19,26,45
038 Algund,27,,19,31,50
038 Algund,28,,20,38,58
038 Algund,29,,21,25,46
038 Algund,30,,30,22,52
038 Algund,31,,21,26,47
038 Algund,32,,35,19,54
038 Algund,33,,32,27,59
038 Algund,34,,34,33,67
038 Algund,35,,49,28,77
038 Algund,36,,40,39,79
038 Algund,37,,38,30,68
038 Algund,38,,39,41,80
038 Algund,39,,35,38,73
038 Algund,40,,32,37,69
038 Algund,41,,45,26,71
038 Algund,42,,27,35,62
038 Algund,43,,32,44,76
038 Algund,44,,28,46,74
038 Algund,45,,30,41,71
038 Algund,46,,38,31,69
038 Algund,47,,43,28,71
038 Algund,48,,24,33,57
038 Algund,49,,33,27,60
038 Algund,50,,23,26,49
038 Algund,51,,33,23,56
038 Algund,52,,17,32,49
038 Algund,53,,26,24,50
038 Algund,54,,25,30,55
038 Algund,55,,23,25,48
038 Algund,56,,24,24,48
038 Algund,57,,29,23,52
038 Algund,58,,21,20,41
038 Algund,59,,29,29,58
038 Algund,60,,24,24,48
038 Algund,61,,26,25,51
038 Algund,62,,18,21,39
038 Algund,63,,16,35,51
038 Algund,64,,21,21,42
038 Algund,65,,18,26,44
038 Algund,66,,23,30,53
038 Algund,67,,21,22,43
038 Algund,68,,16,15,31
038 Algund,69,,15,28,43
038 Algund,70,,15,17,32
038 Algund,71,,22,25,47
038 Algund,72,,22,24,46
038 Algund,73,,15,22,37
038 Algund,74,,13,23,36
038 Algund,75,,15,21,36
038 Algund,76,,13,22,35
038 Algund,77,,10,20,30
038 Algund,78,,11,16,27
038 Algund,79,,13,18,31
038 Algund,80,,11,13,24
038 Algund,81,,6,17,23
038 Algund,82,,5,11,16
038 Algund,83,,8,16,24
038 Algund,84,,9,10,19
038 Algund,85,,8,10,18
038 Algund,86,,2,10,12
038 Algund,87,,3,5,8
038 Algund,88,,-,4,4
038 Algund,89,,2,4,6
038 Algund,90,,1,3,4
038 Algund,91,,1,4,5
038 Algund,92,,1,1,2
038 Algund,93,,3,6,9
038 Algund,94,,1,7,8
038 Algund,95,,1,3,4
038 Algund,96,,1,-,1
038 Algund,97,,-,2,2
038 Algund,98,,-,1,1
038 Algund,99,,-,1,1
039 Lajen,0,,20,18,38
039 Lajen,1,,16,25,41
039 Lajen,2,,23,23,46
039 Lajen,3,,23,7,30
039 Lajen,4,,22,19,41
039 Lajen,5,,27,16,43
039 Lajen,6,,17,15,32
039 Lajen,7,,18,16,34
039 Lajen,8,,15,22,37
039 Lajen,9,,16,12,28
039 Lajen,10,,8,13,21
039 Lajen,11,,11,16,27
039 Lajen,12,,13,15,28
039 Lajen,13,,15,10,25
039 Lajen,14,,19,19,38
039 Lajen,15,,8,8,16
039 Lajen,16,,16,15,31
039 Lajen,17,,12,11,23
039 Lajen,18,,13,6,19
039 Lajen,19,,17,16,33
039 Lajen,20,,19,11,30
039 Lajen,21,,10,15,25
039 Lajen,22,,10,19,29
039 Lajen,23,,17,18,35
039 Lajen,24,,9,23,32
039 Lajen,25,,21,21,42
039 Lajen,26,,18,20,38
039 Lajen,27,,24,22,46
039 Lajen,28,,24,16,40
039 Lajen,29,,23,19,42
039 Lajen,30,,20,21,41
039 Lajen,31,,28,21,49
039 Lajen,32,,21,24,45
039 Lajen,33,,22,24,46
039 Lajen,34,,19,26,45
039 Lajen,35,,24,25,49
039 Lajen,36,,35,17,52
039 Lajen,37,,22,21,43
039 Lajen,38,,26,23,49
039 Lajen,39,,22,17,39
039 Lajen,40,,29,18,47
039 Lajen,41,,22,17,39
039 Lajen,42,,15,13,28
039 Lajen,43,,29,17,46
039 Lajen,44,,11,17,28
039 Lajen,45,,12,9,21
039 Lajen,46,,17,25,42
039 Lajen,47,,22,11,33
039 Lajen,48,,13,11,24
039 Lajen,49,,11,15,26
039 Lajen,50,,12,12,24
039 Lajen,51,,5,14,19
039 Lajen,52,,10,8,18
039 Lajen,53,,7,10,17
039 Lajen,54,,9,11,20
039 Lajen,55,,12,13,25
039 Lajen,56,,5,13,18
039 Lajen,57,,9,15,24
039 Lajen,58,,16,8,24
039 Lajen,59,,12,14,26
039 Lajen,60,,10,10,20
039 Lajen,61,,14,8,22
039 Lajen,62,,12,12,24
039 Lajen,63,,18,14,32
039 Lajen,64,,17,17,34
039 Lajen,65,,16,10,26
039 Lajen,66,,15,10,25
039 Lajen,67,,7,16,23
039 Lajen,68,,7,9,16
039 Lajen,69,,7,9,16
039 Lajen,70,,6,7,13
039 Lajen,71,,9,6,15
039 Lajen,72,,5,12,17
039 Lajen,73,,10,4,14
039 Lajen,74,,1,8,9
039 Lajen,75,,7,4,11
039 Lajen,76,,7,6,13
039 Lajen,77,,8,7,15
039 Lajen,78,,7,9,16
039 Lajen,79,,9,6,15
039 Lajen,80,,4,8,12
039 Lajen,81,,2,8,10
039 Lajen,82,,-,9,9
039 Lajen,83,,4,4,8
039 Lajen,84,,3,4,7
039 Lajen,85,,1,2,3
039 Lajen,86,,1,1,2
039 Lajen,87,,-,2,2
039 Lajen,88,,-,1,1
039 Lajen,90,,1,1,2
039 Lajen,91,,-,1,1
039 Lajen,92,,1,2,3
039 Lajen,93,,-,1,1
039 Lajen,98,,-,1,1
039 Lajen,99,,1,-,1
040 Leifers,0,,82,73,155
040 Leifers,1,,86,76,162
040 Leifers,2,,95,76,171
040 Leifers,3,,86,89,175
040 Leifers,4,,85,79,164
040 Leifers,5,,97,91,188
040 Leifers,6,,88,86,174
040 Leifers,7,,75,106,181
040 Leifers,8,,109,81,190
040 Leifers,9,,99,81,180
040 Leifers,10,,95,92,187
040 Leifers,11,,87,92,179
040 Leifers,12,,79,71,150
040 Leifers,13,,87,74,161
040 Leifers,14,,85,82,167
040 Leifers,15,,98,80,178
040 Leifers,16,,70,80,150
040 Leifers,17,,73,80,153
040 Leifers,18,,71,71,142
040 Leifers,19,,80,83,163
040 Leifers,20,,83,67,150
040 Leifers,21,,74,71,145
040 Leifers,22,,86,97,183
040 Leifers,23,,72,79,151
040 Leifers,24,,77,66,143
040 Leifers,25,,76,87,163
040 Leifers,26,,91,102,193
040 Leifers,27,,99,89,188
040 Leifers,28,,117,94,211
040 Leifers,29,,133,105,238
040 Leifers,30,,138,115,253
040 Leifers,31,,163,134,297
040 Leifers,32,,131,143,274
040 Leifers,33,,136,143,279
040 Leifers,34,,129,136,265
040 Leifers,35,,155,138,293
040 Leifers,36,,152,140,292
040 Leifers,37,,147,156,303
040 Leifers,38,,152,128,280
040 Leifers,39,,154,139,293
040 Leifers,40,,151,127,278
040 Leifers,41,,169,160,329
040 Leifers,42,,148,137,285
040 Leifers,43,,134,126,260
040 Leifers,44,,132,139,271
040 Leifers,45,,139,116,255
040 Leifers,46,,123,103,226
040 Leifers,47,,94,107,201
040 Leifers,48,,105,107,212
040 Leifers,49,,135,135,270
040 Leifers,50,,105,122,227
040 Leifers,51,,90,108,198
040 Leifers,52,,104,117,221
040 Leifers,53,,104,97,201
040 Leifers,54,,103,98,201
040 Leifers,55,,97,87,184
040 Leifers,56,,92,96,188
040 Leifers,57,,109,101,210
040 Leifers,58,,105,100,205
040 Leifers,59,,116,151,267
040 Leifers,60,,81,81,162
040 Leifers,61,,88,91,179
040 Leifers,62,,94,92,186
040 Leifers,63,,95,94,189
040 Leifers,64,,90,79,169
040 Leifers,65,,93,92,185
040 Leifers,66,,92,91,183
040 Leifers,67,,89,73,162
040 Leifers,68,,54,78,132
040 Leifers,69,,53,64,117
040 Leifers,70,,55,64,119
040 Leifers,71,,57,64,121
040 Leifers,72,,48,64,112
040 Leifers,73,,65,74,139
040 Leifers,74,,53,60,113
040 Leifers,75,,51,63,114
040 Leifers,76,,40,52,92
040 Leifers,77,,40,41,81
040 Leifers,78,,26,53,79
040 Leifers,79,,27,50,77
040 Leifers,80,,23,43,66
040 Leifers,81,,22,42,64
040 Leifers,82,,18,34,52
040 Leifers,83,,18,38,56
040 Leifers,84,,15,25,40
040 Leifers,85,,12,20,32
040 Leifers,86,,6,31,37
040 Leifers,87,,1,10,11
040 Leifers,88,,1,10,11
040 Leifers,89,,3,12,15
040 Leifers,90,,1,14,15
040 Leifers,91,,2,12,14
040 Leifers,92,,8,11,19
040 Leifers,93,,1,8,9
040 Leifers,94,,2,3,5
040 Leifers,95,,1,5,6
040 Leifers,96,,2,1,3
040 Leifers,98,,1,1,2
040 Leifers,99,,-,1,1
040 Leifers,100,,-,1,1
040 Leifers,102,,-,1,1
041 Lana,0,,68,71,139
041 Lana,1,,70,55,125
041 Lana,2,,58,62,120
041 Lana,3,,58,47,105
041 Lana,4,,70,50,120
041 Lana,5,,70,72,142
041 Lana,6,,71,51,122
041 Lana,7,,62,65,127
041 Lana,8,,60,62,122
041 Lana,9,,69,75,144
041 Lana,10,,63,59,122
041 Lana,11,,65,71,136
041 Lana,12,,59,59,118
041 Lana,13,,61,54,115
041 Lana,14,,56,58,114
041 Lana,15,,54,63,117
041 Lana,16,,50,74,124
041 Lana,17,,59,48,107
041 Lana,18,,73,49,122
041 Lana,19,,56,55,111
041 Lana,20,,65,61,126
041 Lana,21,,57,53,110
041 Lana,22,,69,62,131
041 Lana,23,,70,58,128
041 Lana,24,,50,72,122
041 Lana,25,,52,60,112
041 Lana,26,,65,76,141
041 Lana,27,,75,65,140
041 Lana,28,,65,65,130
041 Lana,29,,67,82,149
041 Lana,30,,57,77,134
041 Lana,31,,85,74,159
041 Lana,32,,70,94,164
041 Lana,33,,104,92,196
041 Lana,34,,90,96,186
041 Lana,35,,100,106,206
041 Lana,36,,120,78,198
041 Lana,37,,89,92,181
041 Lana,38,,91,91,182
041 Lana,39,,100,103,203
041 Lana,40,,96,92,188
041 Lana,41,,100,99,199
041 Lana,42,,102,81,183
041 Lana,43,,85,76,161
041 Lana,44,,81,84,165
041 Lana,45,,76,77,153
041 Lana,46,,87,77,164
041 Lana,47,,81,85,166
041 Lana,48,,76,75,151
041 Lana,49,,58,63,121
041 Lana,50,,62,73,135
041 Lana,51,,61,65,126
041 Lana,52,,57,61,118
041 Lana,53,,51,60,111
041 Lana,54,,56,63,119
041 Lana,55,,54,54,108
041 Lana,56,,54,52,106
041 Lana,57,,55,64,119
041 Lana,58,,60,43,103
041 Lana,59,,62,61,123
041 Lana,60,,44,50,94
041 Lana,61,,48,56,104
041 Lana,62,,61,57,118
041 Lana,63,,51,67,118
041 Lana,64,,50,47,97
041 Lana,65,,41,48,89
041 Lana,66,,53,52,105
041 Lana,67,,43,55,98
041 Lana,68,,37,39,76
041 Lana,69,,40,49,89
041 Lana,70,,33,37,70
041 Lana,71,,34,45,79
041 Lana,72,,31,42,73
041 Lana,73,,30,34,64
041 Lana,74,,27,42,69
041 Lana,75,,26,38,64
041 Lana,76,,22,35,57
041 Lana,77,,32,29,61
041 Lana,78,,26,35,61
041 Lana,79,,19,38,57
041 Lana,80,,25,38,63
041 Lana,81,,6,21,27
041 Lana,82,,18,22,40
041 Lana,83,,20,34,54
041 Lana,84,,9,27,36
041 Lana,85,,12,25,37
041 Lana,86,,6,19,25
041 Lana,87,,2,9,11
041 Lana,88,,3,12,15
041 Lana,89,,3,4,7
041 Lana,90,,7,9,16
041 Lana,91,,5,11,16
041 Lana,92,,2,11,13
041 Lana,93,,3,8,11
041 Lana,94,,1,7,8
041 Lana,95,,1,8,9
041 Lana,96,,-,5,5
041 Lana,98,,-,4,4
041 Lana,99,,-,1,1
041 Lana,101,,-,2,2
042 Laas,0,,35,16,51
042 Laas,1,,22,19,41
042 Laas,2,,19,17,36
042 Laas,3,,30,19,49
042 Laas,4,,16,20,36
042 Laas,5,,23,24,47
042 Laas,6,,18,13,31
042 Laas,7,,25,31,56
042 Laas,8,,27,26,53
042 Laas,9,,30,33,63
042 Laas,10,,33,23,56
042 Laas,11,,24,25,49
042 Laas,12,,22,20,42
042 Laas,13,,17,27,44
042 Laas,14,,22,22,44
042 Laas,15,,20,26,46
042 Laas,16,,22,24,46
042 Laas,17,,23,19,42
042 Laas,18,,30,23,53
042 Laas,19,,32,21,53
042 Laas,20,,28,28,56
042 Laas,21,,24,26,50
042 Laas,22,,22,35,57
042 Laas,23,,36,22,58
042 Laas,24,,27,28,55
042 Laas,25,,24,28,52
042 Laas,26,,27,28,55
042 Laas,27,,26,31,57
042 Laas,28,,25,18,43
042 Laas,29,,26,28,54
042 Laas,30,,30,22,52
042 Laas,31,,43,30,73
042 Laas,32,,33,34,67
042 Laas,33,,28,26,54
042 Laas,34,,25,25,50
042 Laas,35,,35,22,57
042 Laas,36,,34,40,74
042 Laas,37,,38,24,62
042 Laas,38,,32,24,56
042 Laas,39,,34,25,59
042 Laas,40,,38,36,74
042 Laas,41,,27,29,56
042 Laas,42,,28,28,56
042 Laas,43,,35,27,62
042 Laas,44,,26,28,54
042 Laas,45,,37,24,61
042 Laas,46,,33,26,59
042 Laas,47,,27,24,51
042 Laas,48,,20,28,48
042 Laas,49,,22,15,37
042 Laas,50,,15,14,29
042 Laas,51,,16,24,40
042 Laas,52,,24,12,36
042 Laas,53,,29,25,54
042 Laas,54,,13,17,30
042 Laas,55,,21,25,46
042 Laas,56,,18,19,37
042 Laas,57,,16,22,38
042 Laas,58,,27,11,38
042 Laas,59,,13,15,28
042 Laas,60,,14,11,25
042 Laas,61,,12,15,27
042 Laas,62,,14,15,29
042 Laas,63,,17,19,36
042 Laas,64,,15,21,36
042 Laas,65,,17,25,42
042 Laas,66,,12,25,37
042 Laas,67,,18,12,30
042 Laas,68,,15,14,29
042 Laas,69,,19,13,32
042 Laas,70,,18,23,41
042 Laas,71,,14,19,33
042 Laas,72,,18,12,30
042 Laas,73,,14,15,29
042 Laas,74,,18,22,40
042 Laas,75,,13,15,28
042 Laas,76,,15,8,23
042 Laas,77,,11,11,22
042 Laas,78,,13,17,30
042 Laas,79,,14,11,25
042 Laas,80,,6,11,17
042 Laas,81,,6,19,25
042 Laas,82,,10,8,18
042 Laas,83,,4,18,22
042 Laas,84,,3,5,8
042 Laas,85,,5,10,15
042 Laas,86,,2,8,10
042 Laas,87,,4,1,5
042 Laas,88,,1,2,3
042 Laas,89,,1,4,5
042 Laas,90,,-,1,1
042 Laas,91,,1,4,5
042 Laas,92,,-,5,5
042 Laas,93,,-,3,3
042 Laas,94,,-,1,1
042 Laas,95,,1,1,2
043 Laurein,0,,4,5,9
043 Laurein,1,,3,1,4
043 Laurein,2,,3,4,7
043 Laurein,3,,2,3,5
043 Laurein,4,,7,1,8
043 Laurein,5,,3,8,11
043 Laurein,6,,3,2,5
043 Laurein,7,,4,3,7
043 Laurein,8,,3,5,8
043 Laurein,9,,1,2,3
043 Laurein,10,,2,2,4
043 Laurein,11,,2,4,6
043 Laurein,12,,1,5,6
043 Laurein,13,,1,1,2
043 Laurein,14,,1,1,2
043 Laurein,15,,4,-,4
043 Laurein,16,,3,2,5
043 Laurein,17,,1,-,1
043 Laurein,18,,2,2,4
043 Laurein,19,,4,2,6
043 Laurein,20,,2,2,4
043 Laurein,21,,1,2,3
043 Laurein,23,,2,2,4
043 Laurein,24,,3,1,4
043 Laurein,25,,2,-,2
043 Laurein,26,,2,-,2
043 Laurein,27,,3,5,8
043 Laurein,28,,1,3,4
043 Laurein,29,,5,2,7
043 Laurein,30,,-,5,5
043 Laurein,31,,1,1,2
043 Laurein,32,,5,2,7
043 Laurein,33,,1,2,3
043 Laurein,34,,6,6,12
043 Laurein,35,,4,3,7
043 Laurein,36,,5,4,9
043 Laurein,37,,-,3,3
043 Laurein,38,,4,7,11
043 Laurein,39,,6,3,9
043 Laurein,40,,5,1,6
043 Laurein,41,,4,2,6
043 Laurein,42,,-,2,2
043 Laurein,43,,1,2,3
043 Laurein,44,,5,4,9
043 Laurein,45,,1,1,2
043 Laurein,46,,3,4,7
043 Laurein,47,,3,2,5
043 Laurein,48,,7,-,7
043 Laurein,50,,2,-,2
043 Laurein,51,,3,1,4
043 Laurein,52,,2,1,3
043 Laurein,53,,2,1,3
043 Laurein,55,,2,1,3
043 Laurein,56,,3,2,5
043 Laurein,57,,2,-,2
043 Laurein,58,,2,3,5
043 Laurein,59,,-,1,1
043 Laurein,60,,-,1,1
043 Laurein,61,,-,1,1
043 Laurein,62,,1,-,1
043 Laurein,63,,1,-,1
043 Laurein,65,,3,2,5
043 Laurein,66,,1,3,4
043 Laurein,67,,1,1,2
043 Laurein,68,,2,1,3
043 Laurein,69,,1,2,3
043 Laurein,70,,1,3,4
043 Laurein,71,,1,5,6
043 Laurein,72,,1,2,3
043 Laurein,73,,2,2,4
043 Laurein,74,,-,3,3
043 Laurein,75,,1,5,6
043 Laurein,76,,3,-,3
043 Laurein,77,,4,1,5
043 Laurein,78,,5,1,6
043 Laurein,79,,2,1,3
043 Laurein,80,,1,2,3
043 Laurein,81,,-,1,1
043 Laurein,83,,-,2,2
043 Laurein,84,,1,-,1
043 Laurein,85,,1,2,3
043 Laurein,86,,-,1,1
043 Laurein,89,,1,-,1
043 Laurein,92,,-,1,1
043 Laurein,94,,-,1,1
044 Lüsen,0,,10,5,15
044 Lüsen,1,,8,10,18
044 Lüsen,2,,10,6,16
044 Lüsen,3,,10,8,18
044 Lüsen,4,,10,11,21
044 Lüsen,5,,16,8,24
044 Lüsen,6,,5,10,15
044 Lüsen,7,,11,11,22
044 Lüsen,8,,16,6,22
044 Lüsen,9,,8,13,21
044 Lüsen,10,,10,12,22
044 Lüsen,11,,14,13,27
044 Lüsen,12,,10,8,18
044 Lüsen,13,,12,10,22
044 Lüsen,14,,8,9,17
044 Lüsen,15,,6,12,18
044 Lüsen,16,,16,8,24
044 Lüsen,17,,9,9,18
044 Lüsen,18,,7,8,15
044 Lüsen,19,,12,10,22
044 Lüsen,20,,3,2,5
044 Lüsen,21,,9,16,25
044 Lüsen,22,,6,8,14
044 Lüsen,23,,15,10,25
044 Lüsen,24,,10,11,21
044 Lüsen,25,,12,13,25
044 Lüsen,26,,7,9,16
044 Lüsen,27,,14,18,32
044 Lüsen,28,,7,11,18
044 Lüsen,29,,15,10,25
044 Lüsen,30,,14,12,26
044 Lüsen,31,,14,12,26
044 Lüsen,32,,9,7,16
044 Lüsen,33,,10,8,18
044 Lüsen,34,,15,8,23
044 Lüsen,35,,15,14,29
044 Lüsen,36,,9,9,18
044 Lüsen,37,,13,16,29
044 Lüsen,38,,11,21,32
044 Lüsen,39,,15,13,28
044 Lüsen,40,,18,13,31
044 Lüsen,41,,13,10,23
044 Lüsen,42,,15,11,26
044 Lüsen,43,,8,11,19
044 Lüsen,44,,12,10,22
044 Lüsen,45,,10,12,22
044 Lüsen,46,,8,5,13
044 Lüsen,47,,11,11,22
044 Lüsen,48,,9,11,20
044 Lüsen,49,,9,9,18
044 Lüsen,50,,6,6,12
044 Lüsen,51,,13,5,18
044 Lüsen,52,,6,10,16
044 Lüsen,53,,11,4,15
044 Lüsen,54,,5,7,12
044 Lüsen,55,,6,7,13
044 Lüsen,56,,8,11,19
044 Lüsen,57,,7,1,8
044 Lüsen,58,,6,4,10
044 Lüsen,59,,10,6,16
044 Lüsen,60,,4,9,13
044 Lüsen,61,,4,5,9
044 Lüsen,62,,7,7,14
044 Lüsen,63,,2,6,8
044 Lüsen,64,,7,4,11
044 Lüsen,65,,5,9,14
044 Lüsen,66,,9,7,16
044 Lüsen,67,,8,5,13
044 Lüsen,68,,7,6,13
044 Lüsen,69,,6,9,15
044 Lüsen,70,,6,4,10
044 Lüsen,71,,3,5,8
044 Lüsen,72,,7,3,10
044 Lüsen,73,,2,11,13
044 Lüsen,74,,6,5,11
044 Lüsen,75,,3,5,8
044 Lüsen,76,,4,8,12
044 Lüsen,77,,6,7,13
044 Lüsen,78,,4,4,8
044 Lüsen,79,,2,6,8
044 Lüsen,80,,3,4,7
044 Lüsen,81,,2,3,5
044 Lüsen,82,,2,4,6
044 Lüsen,83,,1,2,3
044 Lüsen,84,,2,7,9
044 Lüsen,85,,1,2,3
044 Lüsen,86,,1,1,2
044 Lüsen,87,,-,2,2
044 Lüsen,88,,1,2,3
044 Lüsen,89,,-,1,1
044 Lüsen,91,,1,1,2
044 Lüsen,92,,-,3,3
045 Margreid a.d. Weinstr.,0,,7,7,14
045 Margreid a.d. Weinstr.,1,,10,8,18
045 Margreid a.d. Weinstr.,2,,4,5,9
045 Margreid a.d. Weinstr.,3,,12,8,20
045 Margreid a.d. Weinstr.,4,,11,9,20
045 Margreid a.d. Weinstr.,5,,7,7,14
045 Margreid a.d. Weinstr.,6,,8,7,15
045 Margreid a.d. Weinstr.,7,,3,12,15
045 Margreid a.d. Weinstr.,8,,9,12,21
045 Margreid a.d. Weinstr.,9,,5,3,8
045 Margreid a.d. Weinstr.,10,,1,7,8
045 Margreid a.d. Weinstr.,11,,5,8,13
045 Margreid a.d. Weinstr.,12,,4,11,15
045 Margreid a.d. Weinstr.,13,,4,2,6
045 Margreid a.d. Weinstr.,14,,6,6,12
045 Margreid a.d. Weinstr.,15,,6,10,16
045 Margreid a.d. Weinstr.,16,,7,5,12
045 Margreid a.d. Weinstr.,17,,8,6,14
045 Margreid a.d. Weinstr.,18,,9,4,13
045 Margreid a.d. Weinstr.,19,,6,11,17
045 Margreid a.d. Weinstr.,20,,10,-,10
045 Margreid a.d. Weinstr.,21,,6,13,19
045 Margreid a.d. Weinstr.,22,,6,9,15
045 Margreid a.d. Weinstr.,23,,8,9,17
045 Margreid a.d. Weinstr.,24,,17,4,21
045 Margreid a.d. Weinstr.,25,,3,3,6
045 Margreid a.d. Weinstr.,26,,9,5,14
045 Margreid a.d. Weinstr.,27,,7,5,12
045 Margreid a.d. Weinstr.,28,,9,6,15
045 Margreid a.d. Weinstr.,29,,10,13,23
045 Margreid a.d. Weinstr.,30,,7,5,12
045 Margreid a.d. Weinstr.,31,,4,5,9
045 Margreid a.d. Weinstr.,32,,11,11,22
045 Margreid a.d. Weinstr.,33,,10,4,14
045 Margreid a.d. Weinstr.,34,,9,11,20
045 Margreid a.d. Weinstr.,35,,9,9,18
045 Margreid a.d. Weinstr.,36,,6,7,13
045 Margreid a.d. Weinstr.,37,,21,17,38
045 Margreid a.d. Weinstr.,38,,12,15,27
045 Margreid a.d. Weinstr.,39,,21,14,35
045 Margreid a.d. Weinstr.,40,,11,5,16
045 Margreid a.d. Weinstr.,41,,7,5,12
045 Margreid a.d. Weinstr.,42,,14,15,29
045 Margreid a.d. Weinstr.,43,,10,14,24
045 Margreid a.d. Weinstr.,44,,15,12,27
045 Margreid a.d. Weinstr.,45,,15,11,26
045 Margreid a.d. Weinstr.,46,,10,12,22
045 Margreid a.d. Weinstr.,47,,6,6,12
045 Margreid a.d. Weinstr.,48,,8,4,12
045 Margreid a.d. Weinstr.,49,,15,5,20
045 Margreid a.d. Weinstr.,50,,7,7,14
045 Margreid a.d. Weinstr.,51,,4,4,8
045 Margreid a.d. Weinstr.,52,,8,7,15
045 Margreid a.d. Weinstr.,53,,6,8,14
045 Margreid a.d. Weinstr.,54,,3,8,11
045 Margreid a.d. Weinstr.,55,,6,6,12
045 Margreid a.d. Weinstr.,56,,7,4,11
045 Margreid a.d. Weinstr.,57,,6,8,14
045 Margreid a.d. Weinstr.,58,,6,7,13
045 Margreid a.d. Weinstr.,59,,2,4,6
045 Margreid a.d. Weinstr.,60,,6,7,13
045 Margreid a.d. Weinstr.,61,,3,6,9
045 Margreid a.d. Weinstr.,62,,6,4,10
045 Margreid a.d. Weinstr.,63,,11,4,15
045 Margreid a.d. Weinstr.,64,,7,7,14
045 Margreid a.d. Weinstr.,65,,5,3,8
045 Margreid a.d. Weinstr.,66,,3,6,9
045 Margreid a.d. Weinstr.,67,,4,9,13
045 Margreid a.d. Weinstr.,68,,4,3,7
045 Margreid a.d. Weinstr.,69,,7,4,11
045 Margreid a.d. Weinstr.,70,,2,7,9
045 Margreid a.d. Weinstr.,71,,5,3,8
045 Margreid a.d. Weinstr.,72,,4,4,8
045 Margreid a.d. Weinstr.,73,,4,7,11
045 Margreid a.d. Weinstr.,74,,4,5,9
045 Margreid a.d. Weinstr.,75,,6,3,9
045 Margreid a.d. Weinstr.,76,,1,4,5
045 Margreid a.d. Weinstr.,77,,5,3,8
045 Margreid a.d. Weinstr.,78,,2,5,7
045 Margreid a.d. Weinstr.,79,,2,8,10
045 Margreid a.d. Weinstr.,80,,3,2,5
045 Margreid a.d. Weinstr.,81,,1,4,5
045 Margreid a.d. Weinstr.,82,,1,4,5
045 Margreid a.d. Weinstr.,83,,1,3,4
045 Margreid a.d. Weinstr.,84,,-,3,3
045 Margreid a.d. Weinstr.,85,,-,1,1
045 Margreid a.d. Weinstr.,86,,1,5,6
045 Margreid a.d. Weinstr.,87,,1,1,2
045 Margreid a.d. Weinstr.,89,,2,2,4
045 Margreid a.d. Weinstr.,91,,-,1,1
045 Margreid a.d. Weinstr.,92,,1,-,1
045 Margreid a.d. Weinstr.,93,,-,1,1
045 Margreid a.d. Weinstr.,94,,-,1,1
045 Margreid a.d. Weinstr.,99,,-,1,1
046 Mals,0,,27,28,55
046 Mals,1,,29,25,54
046 Mals,2,,32,22,54
046 Mals,3,,21,26,47
046 Mals,4,,31,28,59
046 Mals,5,,32,36,68
046 Mals,6,,41,29,70
046 Mals,7,,35,32,67
046 Mals,8,,33,32,65
046 Mals,9,,32,26,58
046 Mals,10,,34,43,77
046 Mals,11,,38,31,69
046 Mals,12,,35,32,67
046 Mals,13,,31,32,63
046 Mals,14,,35,33,68
046 Mals,15,,35,27,62
046 Mals,16,,40,34,74
046 Mals,17,,31,25,56
046 Mals,18,,31,30,61
046 Mals,19,,28,37,65
046 Mals,20,,34,36,70
046 Mals,21,,34,34,68
046 Mals,22,,32,30,62
046 Mals,23,,37,28,65
046 Mals,24,,35,40,75
046 Mals,25,,35,33,68
046 Mals,26,,33,30,63
046 Mals,27,,44,35,79
046 Mals,28,,32,33,65
046 Mals,29,,33,29,62
046 Mals,30,,41,32,73
046 Mals,31,,46,26,72
046 Mals,32,,30,37,67
046 Mals,33,,32,43,75
046 Mals,34,,37,46,83
046 Mals,35,,48,50,98
046 Mals,36,,47,44,91
046 Mals,37,,57,40,97
046 Mals,38,,48,28,76
046 Mals,39,,52,50,102
046 Mals,40,,47,36,83
046 Mals,41,,48,44,92
046 Mals,42,,50,53,103
046 Mals,43,,37,26,63
046 Mals,44,,50,37,87
046 Mals,45,,30,40,70
046 Mals,46,,32,33,65
046 Mals,47,,34,23,57
046 Mals,48,,37,34,71
046 Mals,49,,33,27,60
046 Mals,50,,33,23,56
046 Mals,51,,20,20,40
046 Mals,52,,33,31,64
046 Mals,53,,30,21,51
046 Mals,54,,30,22,52
046 Mals,55,,33,22,55
046 Mals,56,,19,25,44
046 Mals,57,,26,17,43
046 Mals,58,,23,20,43
046 Mals,59,,21,29,50
046 Mals,60,,11,19,30
046 Mals,61,,31,14,45
046 Mals,62,,24,20,44
046 Mals,63,,24,23,47
046 Mals,64,,19,18,37
046 Mals,65,,21,28,49
046 Mals,66,,25,27,52
046 Mals,67,,21,20,41
046 Mals,68,,13,28,41
046 Mals,69,,21,19,40
046 Mals,70,,15,18,33
046 Mals,71,,14,20,34
046 Mals,72,,15,20,35
046 Mals,73,,17,11,28
046 Mals,74,,11,17,28
046 Mals,75,,22,16,38
046 Mals,76,,18,15,33
046 Mals,77,,22,14,36
046 Mals,78,,12,14,26
046 Mals,79,,8,20,28
046 Mals,80,,7,16,23
046 Mals,81,,7,14,21
046 Mals,82,,3,10,13
046 Mals,83,,12,14,26
046 Mals,84,,6,12,18
046 Mals,85,,3,16,19
046 Mals,86,,3,14,17
046 Mals,87,,1,3,4
046 Mals,88,,3,2,5
046 Mals,89,,1,4,5
046 Mals,90,,3,2,5
046 Mals,91,,1,4,5
046 Mals,92,,4,9,13
046 Mals,93,,1,-,1
046 Mals,94,,-,2,2
046 Mals,95,,1,2,3
046 Mals,96,,1,1,2
046 Mals,97,,-,1,1
047 Enneberg,0,,21,14,35
047 Enneberg,1,,14,18,32
047 Enneberg,2,,23,27,50
047 Enneberg,3,,16,13,29
047 Enneberg,4,,25,18,43
047 Enneberg,5,,17,20,37
047 Enneberg,6,,28,17,45
047 Enneberg,7,,19,10,29
047 Enneberg,8,,23,15,38
047 Enneberg,9,,17,13,30
047 Enneberg,10,,20,8,28
047 Enneberg,11,,21,14,35
047 Enneberg,12,,20,17,37
047 Enneberg,13,,15,15,30
047 Enneberg,14,,18,22,40
047 Enneberg,15,,15,17,32
047 Enneberg,16,,20,18,38
047 Enneberg,17,,21,16,37
047 Enneberg,18,,18,13,31
047 Enneberg,19,,19,10,29
047 Enneberg,20,,26,16,42
047 Enneberg,21,,20,21,41
047 Enneberg,22,,15,16,31
047 Enneberg,23,,25,20,45
047 Enneberg,24,,21,20,41
047 Enneberg,25,,25,17,42
047 Enneberg,26,,13,18,31
047 Enneberg,27,,13,22,35
047 Enneberg,28,,21,18,39
047 Enneberg,29,,13,17,30
047 Enneberg,30,,12,29,41
047 Enneberg,31,,26,29,55
047 Enneberg,32,,22,25,47
047 Enneberg,33,,24,28,52
047 Enneberg,34,,30,33,63
047 Enneberg,35,,27,20,47
047 Enneberg,36,,26,18,44
047 Enneberg,37,,25,20,45
047 Enneberg,38,,25,19,44
047 Enneberg,39,,23,21,44
047 Enneberg,40,,28,21,49
047 Enneberg,41,,23,22,45
047 Enneberg,42,,22,19,41
047 Enneberg,43,,17,16,33
047 Enneberg,44,,21,16,37
047 Enneberg,45,,15,17,32
047 Enneberg,46,,23,13,36
047 Enneberg,47,,21,8,29
047 Enneberg,48,,16,14,30
047 Enneberg,49,,16,19,35
047 Enneberg,50,,15,13,28
047 Enneberg,51,,14,12,26
047 Enneberg,52,,17,20,37
047 Enneberg,53,,14,16,30
047 Enneberg,54,,17,10,27
047 Enneberg,55,,10,15,25
047 Enneberg,56,,19,8,27
047 Enneberg,57,,16,13,29
047 Enneberg,58,,8,12,20
047 Enneberg,59,,14,17,31
047 Enneberg,60,,5,13,18
047 Enneberg,61,,20,16,36
047 Enneberg,62,,16,11,27
047 Enneberg,63,,12,20,32
047 Enneberg,64,,13,11,24
047 Enneberg,65,,12,7,19
047 Enneberg,66,,18,9,27
047 Enneberg,67,,14,17,31
047 Enneberg,68,,14,12,26
047 Enneberg,69,,12,12,24
047 Enneberg,70,,12,16,28
047 Enneberg,71,,9,10,19
047 Enneberg,72,,12,9,21
047 Enneberg,73,,8,18,26
047 Enneberg,74,,11,10,21
047 Enneberg,75,,12,14,26
047 Enneberg,76,,7,7,14
047 Enneberg,77,,9,12,21
047 Enneberg,78,,8,7,15
047 Enneberg,79,,6,9,15
047 Enneberg,80,,11,8,19
047 Enneberg,81,,2,8,10
047 Enneberg,82,,5,11,16
047 Enneberg,83,,7,6,13
047 Enneberg,84,,2,7,9
047 Enneberg,85,,5,3,8
047 Enneberg,86,,1,3,4
047 Enneberg,87,,4,3,7
047 Enneberg,88,,-,4,4
047 Enneberg,89,,1,6,7
047 Enneberg,90,,-,3,3
047 Enneberg,91,,2,4,6
047 Enneberg,92,,1,-,1
047 Enneberg,93,,-,2,2
047 Enneberg,94,,2,-,2
047 Enneberg,100,,-,1,1
048 Marling,0,,21,10,31
048 Marling,1,,16,14,30
048 Marling,2,,10,9,19
048 Marling,3,,17,14,31
048 Marling,4,,8,15,23
048 Marling,5,,17,17,34
048 Marling,6,,13,7,20
048 Marling,7,,10,11,21
048 Marling,8,,13,9,22
048 Marling,9,,11,13,24
048 Marling,10,,18,11,29
048 Marling,11,,10,7,17
048 Marling,12,,16,8,24
048 Marling,13,,15,14,29
048 Marling,14,,12,12,24
048 Marling,15,,10,14,24
048 Marling,16,,9,17,26
048 Marling,17,,10,14,24
048 Marling,18,,6,10,16
048 Marling,19,,12,9,21
048 Marling,20,,7,16,23
048 Marling,21,,12,7,19
048 Marling,22,,11,12,23
048 Marling,23,,14,10,24
048 Marling,24,,16,10,26
048 Marling,25,,14,9,23
048 Marling,26,,17,18,35
048 Marling,27,,17,16,33
048 Marling,28,,12,17,29
048 Marling,29,,18,24,42
048 Marling,30,,17,13,30
048 Marling,31,,12,9,21
048 Marling,32,,13,20,33
048 Marling,33,,16,20,36
048 Marling,34,,25,17,42
048 Marling,35,,14,18,32
048 Marling,36,,21,19,40
048 Marling,37,,27,18,45
048 Marling,38,,18,12,30
048 Marling,39,,23,25,48
048 Marling,40,,25,21,46
048 Marling,41,,30,19,49
048 Marling,42,,27,29,56
048 Marling,43,,22,18,40
048 Marling,44,,25,12,37
048 Marling,45,,19,21,40
048 Marling,46,,16,14,30
048 Marling,47,,16,13,29
048 Marling,48,,11,9,20
048 Marling,49,,9,11,20
048 Marling,50,,10,8,18
048 Marling,51,,17,11,28
048 Marling,52,,12,17,29
048 Marling,53,,13,14,27
048 Marling,54,,6,13,19
048 Marling,55,,15,14,29
048 Marling,56,,18,19,37
048 Marling,57,,6,14,20
048 Marling,58,,17,13,30
048 Marling,59,,12,15,27
048 Marling,60,,21,14,35
048 Marling,61,,15,15,30
048 Marling,62,,11,16,27
048 Marling,63,,11,12,23
048 Marling,64,,21,18,39
048 Marling,65,,11,13,24
048 Marling,66,,14,15,29
048 Marling,67,,11,13,24
048 Marling,68,,11,17,28
048 Marling,69,,14,8,22
048 Marling,70,,5,16,21
048 Marling,71,,12,9,21
048 Marling,72,,8,13,21
048 Marling,73,,10,10,20
048 Marling,74,,9,7,16
048 Marling,75,,4,10,14
048 Marling,76,,7,7,14
048 Marling,77,,7,3,10
048 Marling,78,,10,7,17
048 Marling,79,,5,11,16
048 Marling,80,,2,12,14
048 Marling,81,,1,6,7
048 Marling,82,,4,5,9
048 Marling,83,,2,5,7
048 Marling,84,,4,6,10
048 Marling,85,,-,2,2
048 Marling,86,,3,4,7
048 Marling,87,,1,2,3
048 Marling,88,,1,-,1
048 Marling,89,,-,2,2
048 Marling,90,,2,3,5
048 Marling,91,,2,1,3
048 Marling,92,,1,2,3
048 Marling,93,,2,1,3
048 Marling,95,,-,1,1
048 Marling,96,,1,-,1
048 Marling,100,,-,1,1
049 Martell,0,,8,2,10
049 Martell,1,,7,2,9
049 Martell,2,,5,5,10
049 Martell,3,,3,5,8
049 Martell,4,,4,8,12
049 Martell,5,,7,5,12
049 Martell,6,,2,7,9
049 Martell,7,,6,7,13
049 Martell,8,,5,7,12
049 Martell,9,,4,6,10
049 Martell,10,,7,7,14
049 Martell,11,,7,8,15
049 Martell,12,,6,6,12
049 Martell,13,,5,6,11
049 Martell,14,,8,5,13
049 Martell,15,,6,5,11
049 Martell,16,,9,4,13
049 Martell,17,,4,1,5
049 Martell,18,,7,3,10
049 Martell,19,,-,4,4
049 Martell,20,,4,6,10
049 Martell,21,,6,2,8
049 Martell,22,,8,3,11
049 Martell,23,,5,7,12
049 Martell,24,,7,5,12
049 Martell,25,,9,4,13
049 Martell,26,,9,6,15
049 Martell,27,,4,5,9
049 Martell,28,,6,5,11
049 Martell,29,,4,5,9
049 Martell,30,,1,6,7
049 Martell,31,,6,9,15
049 Martell,32,,9,5,14
049 Martell,33,,4,9,13
049 Martell,34,,10,4,14
049 Martell,35,,8,4,12
049 Martell,36,,6,13,19
049 Martell,37,,8,6,14
049 Martell,38,,6,7,13
049 Martell,39,,15,6,21
049 Martell,40,,18,10,28
049 Martell,41,,10,9,19
049 Martell,42,,13,1,14
049 Martell,43,,10,8,18
049 Martell,44,,7,5,12
049 Martell,45,,9,3,12
049 Martell,46,,8,6,14
049 Martell,47,,8,6,14
049 Martell,48,,7,3,10
049 Martell,49,,5,4,9
049 Martell,50,,7,2,9
049 Martell,51,,7,6,13
049 Martell,52,,4,4,8
049 Martell,53,,4,3,7
049 Martell,54,,6,8,14
049 Martell,55,,2,4,6
049 Martell,56,,4,1,5
049 Martell,57,,5,4,9
049 Martell,58,,4,3,7
049 Martell,59,,3,-,3
049 Martell,60,,4,1,5
049 Martell,61,,1,3,4
049 Martell,62,,2,4,6
049 Martell,63,,6,5,11
049 Martell,64,,4,4,8
049 Martell,65,,6,2,8
049 Martell,66,,2,4,6
049 Martell,67,,2,6,8
049 Martell,68,,3,4,7
049 Martell,69,,3,4,7
049 Martell,70,,4,9,13
049 Martell,71,,7,1,8
049 Martell,72,,4,6,10
049 Martell,73,,2,4,6
049 Martell,74,,5,-,5
049 Martell,75,,7,4,11
049 Martell,76,,4,3,7
049 Martell,77,,3,4,7
049 Martell,78,,2,3,5
049 Martell,79,,2,8,10
049 Martell,80,,2,2,4
049 Martell,81,,3,5,8
049 Martell,82,,-,6,6
049 Martell,83,,1,1,2
049 Martell,84,,-,1,1
049 Martell,86,,-,1,1
049 Martell,87,,1,1,2
049 Martell,90,,2,1,3
049 Martell,91,,-,1,1
049 Martell,92,,1,-,1
049 Martell,94,,3,1,4
049 Martell,98,,-,1,1
050 Mölten,0,,9,11,20
050 Mölten,1,,11,8,19
050 Mölten,2,,10,8,18
050 Mölten,3,,15,11,26
050 Mölten,4,,15,17,32
050 Mölten,5,,13,12,25
050 Mölten,6,,11,18,29
050 Mölten,7,,8,15,23
050 Mölten,8,,10,7,17
050 Mölten,9,,16,13,29
050 Mölten,10,,11,10,21
050 Mölten,11,,13,5,18
050 Mölten,12,,12,11,23
050 Mölten,13,,6,12,18
050 Mölten,14,,10,6,16
050 Mölten,15,,12,6,18
050 Mölten,16,,13,5,18
050 Mölten,17,,7,9,16
050 Mölten,18,,9,8,17
050 Mölten,19,,10,6,16
050 Mölten,20,,7,13,20
050 Mölten,21,,7,3,10
050 Mölten,22,,6,13,19
050 Mölten,23,,9,7,16
050 Mölten,24,,13,10,23
050 Mölten,25,,13,8,21
050 Mölten,26,,12,12,24
050 Mölten,27,,11,6,17
050 Mölten,28,,7,9,16
050 Mölten,29,,11,16,27
050 Mölten,30,,18,10,28
050 Mölten,31,,15,9,24
050 Mölten,32,,13,15,28
050 Mölten,33,,9,10,19
050 Mölten,34,,18,13,31
050 Mölten,35,,17,12,29
050 Mölten,36,,14,15,29
050 Mölten,37,,15,17,32
050 Mölten,38,,20,14,34
050 Mölten,39,,13,13,26
050 Mölten,40,,11,16,27
050 Mölten,41,,20,13,33
050 Mölten,42,,20,6,26
050 Mölten,43,,11,9,20
050 Mölten,44,,17,9,26
050 Mölten,45,,9,8,17
050 Mölten,46,,12,5,17
050 Mölten,47,,2,10,12
050 Mölten,48,,7,3,10
050 Mölten,49,,5,8,13
050 Mölten,50,,12,7,19
050 Mölten,51,,7,6,13
050 Mölten,52,,7,6,13
050 Mölten,53,,8,6,14
050 Mölten,54,,5,5,10
050 Mölten,55,,10,9,19
050 Mölten,56,,6,6,12
050 Mölten,57,,7,4,11
050 Mölten,58,,3,8,11
050 Mölten,59,,9,3,12
050 Mölten,60,,6,5,11
050 Mölten,61,,2,6,8
050 Mölten,62,,13,8,21
050 Mölten,63,,7,10,17
050 Mölten,64,,9,4,13
050 Mölten,65,,5,7,12
050 Mölten,66,,6,7,13
050 Mölten,67,,2,3,5
050 Mölten,68,,5,6,11
050 Mölten,69,,4,6,10
050 Mölten,70,,10,6,16
050 Mölten,71,,9,5,14
050 Mölten,72,,9,8,17
050 Mölten,73,,3,5,8
050 Mölten,74,,8,3,11
050 Mölten,75,,7,4,11
050 Mölten,76,,2,7,9
050 Mölten,77,,1,5,6
050 Mölten,78,,3,4,7
050 Mölten,79,,3,5,8
050 Mölten,80,,2,4,6
050 Mölten,81,,1,2,3
050 Mölten,82,,6,4,10
050 Mölten,83,,1,1,2
050 Mölten,84,,1,3,4
050 Mölten,85,,1,7,8
050 Mölten,86,,-,5,5
050 Mölten,87,,-,1,1
050 Mölten,88,,-,1,1
050 Mölten,89,,1,1,2
050 Mölten,90,,-,1,1
050 Mölten,91,,-,4,4
050 Mölten,92,,1,-,1
050 Mölten,94,,-,1,1
050 Mölten,97,,-,1,1
050 Mölten,99,,-,1,1
051 Meran,0,,163,139,302
051 Meran,1,,208,169,377
051 Meran,2,,176,170,346
051 Meran,3,,170,158,328
051 Meran,4,,166,173,339
051 Meran,5,,180,143,323
051 Meran,6,,172,182,354
051 Meran,7,,151,139,290
051 Meran,8,,186,159,345
051 Meran,9,,193,158,351
051 Meran,10,,168,153,321
051 Meran,11,,162,183,345
051 Meran,12,,129,151,280
051 Meran,13,,172,142,314
051 Meran,14,,159,173,332
051 Meran,15,,157,151,308
051 Meran,16,,174,157,331
051 Meran,17,,167,126,293
051 Meran,18,,169,147,316
051 Meran,19,,159,123,282
051 Meran,20,,135,181,316
051 Meran,21,,173,150,323
051 Meran,22,,157,162,319
051 Meran,23,,160,187,347
051 Meran,24,,198,168,366
051 Meran,25,,196,164,360
051 Meran,26,,175,176,351
051 Meran,27,,209,180,389
051 Meran,28,,200,220,420
051 Meran,29,,218,243,461
051 Meran,30,,246,250,496
051 Meran,31,,274,286,560
051 Meran,32,,260,255,515
051 Meran,33,,277,272,549
051 Meran,34,,292,273,565
051 Meran,35,,289,296,585
051 Meran,36,,315,299,614
051 Meran,37,,330,324,654
051 Meran,38,,341,328,669
051 Meran,39,,321,295,616
051 Meran,40,,338,306,644
051 Meran,41,,341,300,641
051 Meran,42,,340,271,611
051 Meran,43,,263,279,542
051 Meran,44,,295,295,590
051 Meran,45,,297,261,558
051 Meran,46,,265,240,505
051 Meran,47,,249,241,490
051 Meran,48,,228,250,478
051 Meran,49,,220,217,437
051 Meran,50,,199,215,414
051 Meran,51,,186,228,414
051 Meran,52,,183,220,403
051 Meran,53,,210,219,429
051 Meran,54,,204,207,411
051 Meran,55,,188,219,407
051 Meran,56,,226,246,472
051 Meran,57,,215,256,471
051 Meran,58,,215,280,495
051 Meran,59,,235,292,527
051 Meran,60,,205,216,421
051 Meran,61,,202,233,435
051 Meran,62,,252,238,490
051 Meran,63,,257,294,551
051 Meran,64,,228,282,510
051 Meran,65,,195,222,417
051 Meran,66,,200,249,449
051 Meran,67,,180,226,406
051 Meran,68,,182,218,400
051 Meran,69,,167,202,369
051 Meran,70,,166,197,363
051 Meran,71,,155,180,335
051 Meran,72,,147,171,318
051 Meran,73,,130,195,325
051 Meran,74,,120,175,295
051 Meran,75,,121,187,308
051 Meran,76,,102,142,244
051 Meran,77,,104,177,281
051 Meran,78,,101,149,250
051 Meran,79,,98,172,270
051 Meran,80,,70,161,231
051 Meran,81,,86,149,235
051 Meran,82,,59,141,200
051 Meran,83,,71,156,227
051 Meran,84,,41,148,189
051 Meran,85,,45,136,181
051 Meran,86,,35,93,128
051 Meran,87,,23,64,87
051 Meran,88,,23,62,85
051 Meran,89,,15,37,52
051 Meran,90,,23,56,79
051 Meran,91,,20,61,81
051 Meran,92,,15,45,60
051 Meran,93,,9,39,48
051 Meran,94,,8,23,31
051 Meran,95,,3,21,24
051 Meran,96,,5,20,25
051 Meran,97,,4,13,17
051 Meran,98,,1,7,8
051 Meran,99,,-,11,11
051 Meran,100,,-,4,4
051 Meran,101,,-,3,3
051 Meran,103,,-,1,1
051 Meran,104,,-,1,1
052 Welsberg-Taisten,0,,24,21,45
052 Welsberg-Taisten,1,,12,19,31
052 Welsberg-Taisten,2,,16,15,31
052 Welsberg-Taisten,3,,21,22,43
052 Welsberg-Taisten,4,,31,18,49
052 Welsberg-Taisten,5,,17,16,33
052 Welsberg-Taisten,6,,23,19,42
052 Welsberg-Taisten,7,,21,14,35
052 Welsberg-Taisten,8,,20,19,39
052 Welsberg-Taisten,9,,16,15,31
052 Welsberg-Taisten,10,,18,14,32
052 Welsberg-Taisten,11,,12,15,27
052 Welsberg-Taisten,12,,15,19,34
052 Welsberg-Taisten,13,,10,10,20
052 Welsberg-Taisten,14,,20,17,37
052 Welsberg-Taisten,15,,10,20,30
052 Welsberg-Taisten,16,,4,18,22
052 Welsberg-Taisten,17,,12,17,29
052 Welsberg-Taisten,18,,13,14,27
052 Welsberg-Taisten,19,,9,10,19
052 Welsberg-Taisten,20,,8,13,21
052 Welsberg-Taisten,21,,26,14,40
052 Welsberg-Taisten,22,,19,18,37
052 Welsberg-Taisten,23,,18,15,33
052 Welsberg-Taisten,24,,9,13,22
052 Welsberg-Taisten,25,,15,15,30
052 Welsberg-Taisten,26,,23,18,41
052 Welsberg-Taisten,27,,20,21,41
052 Welsberg-Taisten,28,,14,23,37
052 Welsberg-Taisten,29,,17,10,27
052 Welsberg-Taisten,30,,15,26,41
052 Welsberg-Taisten,31,,26,21,47
052 Welsberg-Taisten,32,,30,10,40
052 Welsberg-Taisten,33,,18,27,45
052 Welsberg-Taisten,34,,31,24,55
052 Welsberg-Taisten,35,,27,22,49
052 Welsberg-Taisten,36,,19,20,39
052 Welsberg-Taisten,37,,25,16,41
052 Welsberg-Taisten,38,,30,20,50
052 Welsberg-Taisten,39,,28,22,50
052 Welsberg-Taisten,40,,21,17,38
052 Welsberg-Taisten,41,,37,20,57
052 Welsberg-Taisten,42,,27,22,49
052 Welsberg-Taisten,43,,20,23,43
052 Welsberg-Taisten,44,,17,16,33
052 Welsberg-Taisten,45,,11,15,26
052 Welsberg-Taisten,46,,19,21,40
052 Welsberg-Taisten,47,,25,18,43
052 Welsberg-Taisten,48,,11,19,30
052 Welsberg-Taisten,49,,19,19,38
052 Welsberg-Taisten,50,,17,11,28
052 Welsberg-Taisten,51,,14,14,28
052 Welsberg-Taisten,52,,19,12,31
052 Welsberg-Taisten,53,,18,11,29
052 Welsberg-Taisten,54,,19,10,29
052 Welsberg-Taisten,55,,15,13,28
052 Welsberg-Taisten,56,,14,11,25
052 Welsberg-Taisten,57,,16,17,33
052 Welsberg-Taisten,58,,11,11,22
052 Welsberg-Taisten,59,,12,14,26
052 Welsberg-Taisten,60,,10,14,24
052 Welsberg-Taisten,61,,13,10,23
052 Welsberg-Taisten,62,,10,15,25
052 Welsberg-Taisten,63,,10,14,24
052 Welsberg-Taisten,64,,19,17,36
052 Welsberg-Taisten,65,,6,13,19
052 Welsberg-Taisten,66,,14,13,27
052 Welsberg-Taisten,67,,13,11,24
052 Welsberg-Taisten,68,,11,8,19
052 Welsberg-Taisten,69,,10,10,20
052 Welsberg-Taisten,70,,3,16,19
052 Welsberg-Taisten,71,,17,15,32
052 Welsberg-Taisten,72,,10,11,21
052 Welsberg-Taisten,73,,11,12,23
052 Welsberg-Taisten,74,,6,12,18
052 Welsberg-Taisten,75,,8,7,15
052 Welsberg-Taisten,76,,8,10,18
052 Welsberg-Taisten,77,,5,19,24
052 Welsberg-Taisten,78,,6,12,18
052 Welsberg-Taisten,79,,7,7,14
052 Welsberg-Taisten,80,,-,8,8
052 Welsberg-Taisten,81,,3,8,11
052 Welsberg-Taisten,82,,5,9,14
052 Welsberg-Taisten,83,,4,4,8
052 Welsberg-Taisten,84,,3,9,12
052 Welsberg-Taisten,85,,2,5,7
052 Welsberg-Taisten,86,,1,7,8
052 Welsberg-Taisten,87,,2,1,3
052 Welsberg-Taisten,88,,1,2,3
052 Welsberg-Taisten,89,,1,-,1
052 Welsberg-Taisten,90,,2,3,5
052 Welsberg-Taisten,91,,1,-,1
052 Welsberg-Taisten,92,,-,3,3
052 Welsberg-Taisten,93,,1,2,3
052 Welsberg-Taisten,94,,-,2,2
052 Welsberg-Taisten,95,,1,2,3
052 Welsberg-Taisten,97,,-,2,2
052 Welsberg-Taisten,98,,1,1,2
052 Welsberg-Taisten,105,,1,-,1
052 Welsberg-Taisten,-,,-,1,1
053 Montan,0,,12,8,20
053 Montan,1,,7,8,15
053 Montan,2,,8,6,14
053 Montan,3,,6,4,10
053 Montan,4,,10,4,14
053 Montan,5,,10,6,16
053 Montan,6,,6,10,16
053 Montan,7,,9,12,21
053 Montan,8,,7,8,15
053 Montan,9,,14,11,25
053 Montan,10,,16,16,32
053 Montan,11,,14,6,20
053 Montan,12,,5,8,13
053 Montan,13,,9,10,19
053 Montan,14,,14,9,23
053 Montan,15,,12,8,20
053 Montan,16,,11,11,22
053 Montan,17,,12,14,26
053 Montan,18,,12,17,29
053 Montan,19,,14,7,21
053 Montan,20,,12,9,21
053 Montan,21,,7,3,10
053 Montan,22,,12,5,17
053 Montan,23,,10,7,17
053 Montan,24,,10,8,18
053 Montan,25,,6,4,10
053 Montan,26,,10,4,14
053 Montan,27,,9,5,14
053 Montan,28,,7,4,11
053 Montan,29,,10,5,15
053 Montan,30,,12,12,24
053 Montan,31,,11,16,27
053 Montan,32,,13,4,17
053 Montan,33,,7,9,16
053 Montan,34,,12,8,20
053 Montan,35,,15,12,27
053 Montan,36,,16,17,33
053 Montan,37,,14,18,32
053 Montan,38,,12,11,23
053 Montan,39,,12,18,30
053 Montan,40,,31,14,45
053 Montan,41,,17,11,28
053 Montan,42,,12,17,29
053 Montan,43,,15,17,32
053 Montan,44,,18,12,30
053 Montan,45,,14,11,25
053 Montan,46,,15,10,25
053 Montan,47,,12,10,22
053 Montan,48,,17,11,28
053 Montan,49,,7,14,21
053 Montan,50,,7,11,18
053 Montan,51,,14,11,25
053 Montan,52,,12,8,20
053 Montan,53,,12,3,15
053 Montan,54,,7,6,13
053 Montan,55,,4,5,9
053 Montan,56,,8,3,11
053 Montan,57,,5,7,12
053 Montan,58,,8,11,19
053 Montan,59,,5,2,7
053 Montan,60,,4,3,7
053 Montan,61,,2,5,7
053 Montan,62,,5,7,12
053 Montan,63,,8,6,14
053 Montan,64,,6,5,11
053 Montan,65,,9,7,16
053 Montan,66,,5,10,15
053 Montan,67,,8,9,17
053 Montan,68,,2,7,9
053 Montan,69,,8,10,18
053 Montan,70,,1,8,9
053 Montan,71,,3,6,9
053 Montan,72,,15,5,20
053 Montan,73,,5,7,12
053 Montan,74,,7,11,18
053 Montan,75,,10,12,22
053 Montan,76,,6,9,15
053 Montan,77,,7,3,10
053 Montan,78,,5,5,10
053 Montan,79,,6,8,14
053 Montan,80,,3,9,12
053 Montan,81,,2,5,7
053 Montan,82,,5,10,15
053 Montan,83,,3,6,9
053 Montan,84,,1,3,4
053 Montan,85,,1,5,6
053 Montan,86,,1,3,4
053 Montan,87,,-,4,4
053 Montan,88,,1,3,4
053 Montan,89,,-,2,2
053 Montan,90,,-,5,5
053 Montan,91,,1,1,2
053 Montan,92,,1,4,5
053 Montan,93,,1,-,1
053 Montan,94,,-,1,1
053 Montan,96,,-,1,1
054 Moos in Passeier,0,,16,10,26
054 Moos in Passeier,1,,17,18,35
054 Moos in Passeier,2,,14,10,24
054 Moos in Passeier,3,,20,17,37
054 Moos in Passeier,4,,14,12,26
054 Moos in Passeier,5,,12,18,30
054 Moos in Passeier,6,,26,9,35
054 Moos in Passeier,7,,14,16,30
054 Moos in Passeier,8,,13,17,30
054 Moos in Passeier,9,,18,19,37
054 Moos in Passeier,10,,8,13,21
054 Moos in Passeier,11,,17,21,38
054 Moos in Passeier,12,,18,12,30
054 Moos in Passeier,13,,18,18,36
054 Moos in Passeier,14,,16,21,37
054 Moos in Passeier,15,,15,13,28
054 Moos in Passeier,16,,17,19,36
054 Moos in Passeier,17,,16,15,31
054 Moos in Passeier,18,,15,14,29
054 Moos in Passeier,19,,17,15,32
054 Moos in Passeier,20,,19,12,31
054 Moos in Passeier,21,,22,21,43
054 Moos in Passeier,22,,15,13,28
054 Moos in Passeier,23,,17,19,36
054 Moos in Passeier,24,,17,17,34
054 Moos in Passeier,25,,17,18,35
054 Moos in Passeier,26,,18,15,33
054 Moos in Passeier,27,,22,9,31
054 Moos in Passeier,28,,20,17,37
054 Moos in Passeier,29,,14,10,24
054 Moos in Passeier,30,,18,15,33
054 Moos in Passeier,31,,23,13,36
054 Moos in Passeier,32,,9,22,31
054 Moos in Passeier,33,,20,15,35
054 Moos in Passeier,34,,16,16,32
054 Moos in Passeier,35,,20,11,31
054 Moos in Passeier,36,,17,19,36
054 Moos in Passeier,37,,20,19,39
054 Moos in Passeier,38,,23,18,41
054 Moos in Passeier,39,,25,21,46
054 Moos in Passeier,40,,20,9,29
054 Moos in Passeier,41,,23,10,33
054 Moos in Passeier,42,,16,19,35
054 Moos in Passeier,43,,11,20,31
054 Moos in Passeier,44,,9,8,17
054 Moos in Passeier,45,,18,15,33
054 Moos in Passeier,46,,16,13,29
054 Moos in Passeier,47,,13,14,27
054 Moos in Passeier,48,,19,7,26
054 Moos in Passeier,49,,9,8,17
054 Moos in Passeier,50,,8,8,16
054 Moos in Passeier,51,,16,9,25
054 Moos in Passeier,52,,6,9,15
054 Moos in Passeier,53,,8,5,13
054 Moos in Passeier,54,,10,10,20
054 Moos in Passeier,55,,8,10,18
054 Moos in Passeier,56,,16,9,25
054 Moos in Passeier,57,,6,6,12
054 Moos in Passeier,58,,18,10,28
054 Moos in Passeier,59,,9,8,17
054 Moos in Passeier,60,,9,7,16
054 Moos in Passeier,61,,10,9,19
054 Moos in Passeier,62,,13,12,25
054 Moos in Passeier,63,,5,12,17
054 Moos in Passeier,64,,10,15,25
054 Moos in Passeier,65,,9,10,19
054 Moos in Passeier,66,,5,5,10
054 Moos in Passeier,67,,10,7,17
054 Moos in Passeier,68,,5,6,11
054 Moos in Passeier,69,,8,7,15
054 Moos in Passeier,70,,8,7,15
054 Moos in Passeier,71,,11,14,25
054 Moos in Passeier,72,,7,10,17
054 Moos in Passeier,73,,8,4,12
054 Moos in Passeier,74,,9,7,16
054 Moos in Passeier,75,,9,7,16
054 Moos in Passeier,76,,7,12,19
054 Moos in Passeier,77,,3,10,13
054 Moos in Passeier,78,,7,5,12
054 Moos in Passeier,79,,8,2,10
054 Moos in Passeier,80,,6,7,13
054 Moos in Passeier,81,,3,4,7
054 Moos in Passeier,82,,4,3,7
054 Moos in Passeier,83,,-,6,6
054 Moos in Passeier,84,,1,2,3
054 Moos in Passeier,85,,2,2,4
054 Moos in Passeier,86,,1,4,5
054 Moos in Passeier,88,,1,2,3
054 Moos in Passeier,89,,-,2,2
054 Moos in Passeier,91,,1,1,2
054 Moos in Passeier,93,,-,1,1
054 Moos in Passeier,95,,-,1,1
054 Moos in Passeier,97,,1,-,1
055 Nals,0,,8,12,20
055 Nals,1,,6,8,14
055 Nals,2,,6,8,14
055 Nals,3,,12,12,24
055 Nals,4,,6,10,16
055 Nals,5,,7,13,20
055 Nals,6,,13,8,21
055 Nals,7,,13,9,22
055 Nals,8,,12,6,18
055 Nals,9,,11,10,21
055 Nals,10,,9,6,15
055 Nals,11,,9,8,17
055 Nals,12,,7,12,19
055 Nals,13,,13,9,22
055 Nals,14,,8,11,19
055 Nals,15,,9,7,16
055 Nals,16,,12,7,19
055 Nals,17,,9,12,21
055 Nals,18,,12,10,22
055 Nals,19,,5,2,7
055 Nals,20,,12,5,17
055 Nals,21,,9,11,20
055 Nals,22,,5,11,16
055 Nals,23,,8,9,17
055 Nals,24,,11,11,22
055 Nals,25,,14,10,24
055 Nals,26,,8,11,19
055 Nals,27,,11,8,19
055 Nals,28,,6,7,13
055 Nals,29,,11,15,26
055 Nals,30,,7,10,17
055 Nals,31,,20,13,33
055 Nals,32,,11,8,19
055 Nals,33,,12,15,27
055 Nals,34,,15,15,30
055 Nals,35,,24,10,34
055 Nals,36,,15,16,31
055 Nals,37,,24,16,40
055 Nals,38,,19,14,33
055 Nals,39,,12,12,24
055 Nals,40,,17,15,32
055 Nals,41,,19,19,38
055 Nals,42,,11,19,30
055 Nals,43,,9,15,24
055 Nals,44,,16,14,30
055 Nals,45,,13,8,21
055 Nals,46,,17,15,32
055 Nals,47,,18,16,34
055 Nals,48,,8,9,17
055 Nals,49,,7,8,15
055 Nals,50,,20,15,35
055 Nals,51,,6,7,13
055 Nals,52,,7,7,14
055 Nals,53,,6,6,12
055 Nals,54,,3,10,13
055 Nals,55,,6,10,16
055 Nals,56,,10,9,19
055 Nals,57,,12,12,24
055 Nals,58,,12,6,18
055 Nals,59,,8,13,21
055 Nals,60,,7,11,18
055 Nals,61,,6,12,18
055 Nals,62,,10,6,16
055 Nals,63,,5,8,13
055 Nals,64,,10,6,16
055 Nals,65,,7,12,19
055 Nals,66,,9,10,19
055 Nals,67,,7,9,16
055 Nals,68,,3,14,17
055 Nals,69,,6,3,9
055 Nals,70,,6,6,12
055 Nals,71,,5,6,11
055 Nals,72,,9,10,19
055 Nals,73,,6,4,10
055 Nals,74,,3,6,9
055 Nals,75,,4,5,9
055 Nals,76,,9,7,16
055 Nals,77,,7,7,14
055 Nals,78,,6,6,12
055 Nals,79,,7,6,13
055 Nals,80,,4,4,8
055 Nals,81,,3,1,4
055 Nals,82,,1,6,7
055 Nals,83,,1,6,7
055 Nals,84,,1,8,9
055 Nals,85,,-,1,1
055 Nals,86,,1,3,4
055 Nals,88,,1,-,1
055 Nals,89,,-,1,1
055 Nals,90,,2,2,4
055 Nals,91,,-,3,3
055 Nals,92,,-,1,1
055 Nals,93,,1,-,1
055 Nals,94,,-,1,1
055 Nals,95,,-,1,1
056 Naturns,0,,31,20,51
056 Naturns,1,,32,30,62
056 Naturns,2,,36,26,62
056 Naturns,3,,25,26,51
056 Naturns,4,,30,28,58
056 Naturns,5,,28,24,52
056 Naturns,6,,29,28,57
056 Naturns,7,,31,32,63
056 Naturns,8,,21,18,39
056 Naturns,9,,31,34,65
056 Naturns,10,,45,35,80
056 Naturns,11,,37,38,75
056 Naturns,12,,31,38,69
056 Naturns,13,,31,39,70
056 Naturns,14,,42,36,78
056 Naturns,15,,35,31,66
056 Naturns,16,,37,24,61
056 Naturns,17,,41,36,77
056 Naturns,18,,36,18,54
056 Naturns,19,,29,26,55
056 Naturns,20,,35,23,58
056 Naturns,21,,41,19,60
056 Naturns,22,,30,34,64
056 Naturns,23,,35,29,64
056 Naturns,24,,39,47,86
056 Naturns,25,,37,31,68
056 Naturns,26,,40,37,77
056 Naturns,27,,39,41,80
056 Naturns,28,,37,32,69
056 Naturns,29,,34,34,68
056 Naturns,30,,43,38,81
056 Naturns,31,,40,43,83
056 Naturns,32,,43,47,90
056 Naturns,33,,42,40,82
056 Naturns,34,,39,41,80
056 Naturns,35,,45,43,88
056 Naturns,36,,37,46,83
056 Naturns,37,,46,42,88
056 Naturns,38,,51,40,91
056 Naturns,39,,55,45,100
056 Naturns,40,,38,51,89
056 Naturns,41,,48,39,87
056 Naturns,42,,40,48,88
056 Naturns,43,,40,46,86
056 Naturns,44,,36,47,83
056 Naturns,45,,56,39,95
056 Naturns,46,,43,38,81
056 Naturns,47,,32,36,68
056 Naturns,48,,37,34,71
056 Naturns,49,,40,35,75
056 Naturns,50,,32,31,63
056 Naturns,51,,39,30,69
056 Naturns,52,,34,24,58
056 Naturns,53,,36,34,70
056 Naturns,54,,38,35,73
056 Naturns,55,,27,33,60
056 Naturns,56,,25,19,44
056 Naturns,57,,31,25,56
056 Naturns,58,,13,20,33
056 Naturns,59,,22,30,52
056 Naturns,60,,25,19,44
056 Naturns,61,,19,20,39
056 Naturns,62,,25,34,59
056 Naturns,63,,32,33,65
056 Naturns,64,,41,28,69
056 Naturns,65,,21,20,41
056 Naturns,66,,20,21,41
056 Naturns,67,,22,18,40
056 Naturns,68,,23,23,46
056 Naturns,69,,20,21,41
056 Naturns,70,,22,10,32
056 Naturns,71,,15,20,35
056 Naturns,72,,15,13,28
056 Naturns,73,,11,19,30
056 Naturns,74,,12,21,33
056 Naturns,75,,14,24,38
056 Naturns,76,,14,17,31
056 Naturns,77,,17,16,33
056 Naturns,78,,9,16,25
056 Naturns,79,,13,14,27
056 Naturns,80,,13,17,30
056 Naturns,81,,11,15,26
056 Naturns,82,,7,8,15
056 Naturns,83,,5,9,14
056 Naturns,84,,3,13,16
056 Naturns,85,,3,8,11
056 Naturns,86,,-,7,7
056 Naturns,87,,2,3,5
056 Naturns,88,,3,1,4
056 Naturns,89,,2,1,3
056 Naturns,90,,1,4,5
056 Naturns,91,,2,7,9
056 Naturns,92,,3,8,11
056 Naturns,93,,1,2,3
056 Naturns,94,,-,1,1
056 Naturns,95,,2,-,2
056 Naturns,96,,-,5,5
057 Natz-Schabs,0,,14,13,27
057 Natz-Schabs,1,,10,18,28
057 Natz-Schabs,2,,21,17,38
057 Natz-Schabs,3,,22,16,38
057 Natz-Schabs,4,,10,20,30
057 Natz-Schabs,5,,20,18,38
057 Natz-Schabs,6,,14,21,35
057 Natz-Schabs,7,,22,15,37
057 Natz-Schabs,8,,18,18,36
057 Natz-Schabs,9,,23,17,40
057 Natz-Schabs,10,,13,13,26
057 Natz-Schabs,11,,23,16,39
057 Natz-Schabs,12,,15,19,34
057 Natz-Schabs,13,,18,13,31
057 Natz-Schabs,14,,21,21,42
057 Natz-Schabs,15,,14,25,39
057 Natz-Schabs,16,,17,24,41
057 Natz-Schabs,17,,25,15,40
057 Natz-Schabs,18,,19,20,39
057 Natz-Schabs,19,,17,20,37
057 Natz-Schabs,20,,21,24,45
057 Natz-Schabs,21,,17,15,32
057 Natz-Schabs,22,,21,17,38
057 Natz-Schabs,23,,13,21,34
057 Natz-Schabs,24,,19,17,36
057 Natz-Schabs,25,,26,14,40
057 Natz-Schabs,26,,16,14,30
057 Natz-Schabs,27,,17,16,33
057 Natz-Schabs,28,,18,18,36
057 Natz-Schabs,29,,12,17,29
057 Natz-Schabs,30,,17,29,46
057 Natz-Schabs,31,,18,20,38
057 Natz-Schabs,32,,26,19,45
057 Natz-Schabs,33,,24,22,46
057 Natz-Schabs,34,,27,25,52
057 Natz-Schabs,35,,30,25,55
057 Natz-Schabs,36,,31,21,52
057 Natz-Schabs,37,,30,18,48
057 Natz-Schabs,38,,29,24,53
057 Natz-Schabs,39,,31,20,51
057 Natz-Schabs,40,,34,28,62
057 Natz-Schabs,41,,26,27,53
057 Natz-Schabs,42,,25,27,52
057 Natz-Schabs,43,,19,22,41
057 Natz-Schabs,44,,22,19,41
057 Natz-Schabs,45,,32,22,54
057 Natz-Schabs,46,,23,20,43
057 Natz-Schabs,47,,22,18,40
057 Natz-Schabs,48,,20,20,40
057 Natz-Schabs,49,,17,22,39
057 Natz-Schabs,50,,20,17,37
057 Natz-Schabs,51,,9,16,25
057 Natz-Schabs,52,,20,15,35
057 Natz-Schabs,53,,13,10,23
057 Natz-Schabs,54,,15,11,26
057 Natz-Schabs,55,,16,15,31
057 Natz-Schabs,56,,19,15,34
057 Natz-Schabs,57,,13,12,25
057 Natz-Schabs,58,,12,12,24
057 Natz-Schabs,59,,15,11,26
057 Natz-Schabs,60,,10,6,16
057 Natz-Schabs,61,,12,12,24
057 Natz-Schabs,62,,11,7,18
057 Natz-Schabs,63,,12,6,18
057 Natz-Schabs,64,,13,9,22
057 Natz-Schabs,65,,4,6,10
057 Natz-Schabs,66,,2,6,8
057 Natz-Schabs,67,,6,6,12
057 Natz-Schabs,68,,12,6,18
057 Natz-Schabs,69,,9,5,14
057 Natz-Schabs,70,,8,7,15
057 Natz-Schabs,71,,4,5,9
057 Natz-Schabs,72,,7,9,16
057 Natz-Schabs,73,,5,7,12
057 Natz-Schabs,74,,4,4,8
057 Natz-Schabs,75,,5,7,12
057 Natz-Schabs,76,,10,2,12
057 Natz-Schabs,77,,4,6,10
057 Natz-Schabs,78,,1,4,5
057 Natz-Schabs,79,,4,7,11
057 Natz-Schabs,80,,3,5,8
057 Natz-Schabs,81,,2,7,9
057 Natz-Schabs,82,,-,10,10
057 Natz-Schabs,83,,5,3,8
057 Natz-Schabs,84,,5,3,8
057 Natz-Schabs,85,,1,7,8
057 Natz-Schabs,86,,-,2,2
057 Natz-Schabs,87,,1,4,5
057 Natz-Schabs,88,,-,1,1
057 Natz-Schabs,90,,1,-,1
057 Natz-Schabs,92,,1,-,1
057 Natz-Schabs,93,,-,1,1
057 Natz-Schabs,94,,-,2,2
057 Natz-Schabs,97,,-,1,1
058 Welschnofen,0,,9,12,21
058 Welschnofen,1,,17,8,25
058 Welschnofen,2,,9,8,17
058 Welschnofen,3,,17,6,23
058 Welschnofen,4,,6,11,17
058 Welschnofen,5,,8,8,16
058 Welschnofen,6,,10,12,22
058 Welschnofen,7,,15,9,24
058 Welschnofen,8,,12,13,25
058 Welschnofen,9,,10,11,21
058 Welschnofen,10,,14,14,28
058 Welschnofen,11,,11,10,21
058 Welschnofen,12,,14,10,24
058 Welschnofen,13,,16,10,26
058 Welschnofen,14,,16,11,27
058 Welschnofen,15,,12,14,26
058 Welschnofen,16,,14,9,23
058 Welschnofen,17,,11,17,28
058 Welschnofen,18,,11,9,20
058 Welschnofen,19,,7,9,16
058 Welschnofen,20,,10,8,18
058 Welschnofen,21,,6,8,14
058 Welschnofen,22,,11,12,23
058 Welschnofen,23,,10,15,25
058 Welschnofen,24,,14,11,25
058 Welschnofen,25,,14,9,23
058 Welschnofen,26,,9,5,14
058 Welschnofen,27,,12,11,23
058 Welschnofen,28,,12,18,30
058 Welschnofen,29,,18,10,28
058 Welschnofen,30,,17,11,28
058 Welschnofen,31,,12,15,27
058 Welschnofen,32,,12,15,27
058 Welschnofen,33,,11,15,26
058 Welschnofen,34,,16,17,33
058 Welschnofen,35,,18,12,30
058 Welschnofen,36,,14,13,27
058 Welschnofen,37,,16,20,36
058 Welschnofen,38,,16,16,32
058 Welschnofen,39,,15,12,27
058 Welschnofen,40,,22,15,37
058 Welschnofen,41,,14,8,22
058 Welschnofen,42,,17,17,34
058 Welschnofen,43,,13,16,29
058 Welschnofen,44,,17,18,35
058 Welschnofen,45,,19,8,27
058 Welschnofen,46,,13,13,26
058 Welschnofen,47,,16,11,27
058 Welschnofen,48,,12,13,25
058 Welschnofen,49,,9,13,22
058 Welschnofen,50,,16,14,30
058 Welschnofen,51,,15,11,26
058 Welschnofen,52,,11,13,24
058 Welschnofen,53,,11,8,19
058 Welschnofen,54,,15,7,22
058 Welschnofen,55,,8,9,17
058 Welschnofen,56,,11,13,24
058 Welschnofen,57,,9,9,18
058 Welschnofen,58,,9,8,17
058 Welschnofen,59,,11,10,21
058 Welschnofen,60,,10,6,16
058 Welschnofen,61,,7,9,16
058 Welschnofen,62,,13,9,22
058 Welschnofen,63,,10,13,23
058 Welschnofen,64,,10,7,17
058 Welschnofen,65,,7,7,14
058 Welschnofen,66,,8,6,14
058 Welschnofen,67,,6,6,12
058 Welschnofen,68,,9,4,13
058 Welschnofen,69,,4,12,16
058 Welschnofen,70,,7,6,13
058 Welschnofen,71,,10,10,20
058 Welschnofen,72,,9,13,22
058 Welschnofen,73,,7,7,14
058 Welschnofen,74,,4,8,12
058 Welschnofen,75,,6,8,14
058 Welschnofen,76,,6,12,18
058 Welschnofen,77,,7,4,11
058 Welschnofen,78,,2,3,5
058 Welschnofen,79,,4,7,11
058 Welschnofen,80,,5,6,11
058 Welschnofen,81,,2,12,14
058 Welschnofen,82,,7,6,13
058 Welschnofen,83,,6,4,10
058 Welschnofen,84,,1,9,10
058 Welschnofen,85,,2,4,6
058 Welschnofen,86,,1,5,6
058 Welschnofen,87,,1,1,2
058 Welschnofen,88,,1,-,1
058 Welschnofen,89,,1,4,5
058 Welschnofen,90,,-,3,3
058 Welschnofen,91,,-,2,2
058 Welschnofen,92,,-,1,1
058 Welschnofen,93,,2,5,7
058 Welschnofen,94,,1,-,1
058 Welschnofen,95,,1,1,2
058 Welschnofen,96,,-,2,2
058 Welschnofen,97,,1,-,1
058 Welschnofen,99,,-,1,1
059 Deutschnofen,0,,27,33,60
059 Deutschnofen,1,,21,29,50
059 Deutschnofen,2,,19,30,49
059 Deutschnofen,3,,32,10,42
059 Deutschnofen,4,,21,29,50
059 Deutschnofen,5,,21,26,47
059 Deutschnofen,6,,29,23,52
059 Deutschnofen,7,,31,15,46
059 Deutschnofen,8,,22,27,49
059 Deutschnofen,9,,19,25,44
059 Deutschnofen,10,,26,25,51
059 Deutschnofen,11,,27,15,42
059 Deutschnofen,12,,22,26,48
059 Deutschnofen,13,,34,28,62
059 Deutschnofen,14,,20,22,42
059 Deutschnofen,15,,34,28,62
059 Deutschnofen,16,,23,22,45
059 Deutschnofen,17,,21,34,55
059 Deutschnofen,18,,21,24,45
059 Deutschnofen,19,,30,17,47
059 Deutschnofen,20,,24,19,43
059 Deutschnofen,21,,31,24,55
059 Deutschnofen,22,,22,23,45
059 Deutschnofen,23,,21,36,57
059 Deutschnofen,24,,20,19,39
059 Deutschnofen,25,,27,22,49
059 Deutschnofen,26,,23,22,45
059 Deutschnofen,27,,24,18,42
059 Deutschnofen,28,,31,26,57
059 Deutschnofen,29,,18,20,38
059 Deutschnofen,30,,26,22,48
059 Deutschnofen,31,,26,33,59
059 Deutschnofen,32,,17,29,46
059 Deutschnofen,33,,27,35,62
059 Deutschnofen,34,,25,24,49
059 Deutschnofen,35,,31,27,58
059 Deutschnofen,36,,43,29,72
059 Deutschnofen,37,,23,27,50
059 Deutschnofen,38,,31,29,60
059 Deutschnofen,39,,35,35,70
059 Deutschnofen,40,,37,18,55
059 Deutschnofen,41,,30,28,58
059 Deutschnofen,42,,33,25,58
059 Deutschnofen,43,,27,28,55
059 Deutschnofen,44,,35,21,56
059 Deutschnofen,45,,41,26,67
059 Deutschnofen,46,,27,18,45
059 Deutschnofen,47,,24,32,56
059 Deutschnofen,48,,23,25,48
059 Deutschnofen,49,,34,27,61
059 Deutschnofen,50,,29,21,50
059 Deutschnofen,51,,27,21,48
059 Deutschnofen,52,,22,23,45
059 Deutschnofen,53,,23,21,44
059 Deutschnofen,54,,20,14,34
059 Deutschnofen,55,,16,20,36
059 Deutschnofen,56,,22,13,35
059 Deutschnofen,57,,22,14,36
059 Deutschnofen,58,,12,14,26
059 Deutschnofen,59,,17,22,39
059 Deutschnofen,60,,17,15,32
059 Deutschnofen,61,,16,16,32
059 Deutschnofen,62,,23,20,43
059 Deutschnofen,63,,17,17,34
059 Deutschnofen,64,,16,25,41
059 Deutschnofen,65,,14,20,34
059 Deutschnofen,66,,26,14,40
059 Deutschnofen,67,,14,21,35
059 Deutschnofen,68,,13,7,20
059 Deutschnofen,69,,14,10,24
059 Deutschnofen,70,,9,13,22
059 Deutschnofen,71,,16,9,25
059 Deutschnofen,72,,8,13,21
059 Deutschnofen,73,,14,14,28
059 Deutschnofen,74,,11,8,19
059 Deutschnofen,75,,10,10,20
059 Deutschnofen,76,,7,10,17
059 Deutschnofen,77,,9,20,29
059 Deutschnofen,78,,8,14,22
059 Deutschnofen,79,,15,10,25
059 Deutschnofen,80,,8,19,27
059 Deutschnofen,81,,4,10,14
059 Deutschnofen,82,,4,10,14
059 Deutschnofen,83,,6,15,21
059 Deutschnofen,84,,4,12,16
059 Deutschnofen,85,,2,9,11
059 Deutschnofen,86,,1,6,7
059 Deutschnofen,87,,1,5,6
059 Deutschnofen,88,,-,2,2
059 Deutschnofen,89,,3,2,5
059 Deutschnofen,90,,2,3,5
059 Deutschnofen,91,,1,4,5
059 Deutschnofen,92,,-,6,6
059 Deutschnofen,93,,-,4,4
059 Deutschnofen,94,,1,6,7
059 Deutschnofen,95,,1,1,2
059 Deutschnofen,97,,1,-,1
059 Deutschnofen,98,,1,-,1
060 Auer,0,,22,19,41
060 Auer,1,,23,17,40
060 Auer,2,,22,17,39
060 Auer,3,,32,18,50
060 Auer,4,,19,21,40
060 Auer,5,,21,22,43
060 Auer,6,,21,25,46
060 Auer,7,,23,23,46
060 Auer,8,,20,18,38
060 Auer,9,,21,23,44
060 Auer,10,,17,17,34
060 Auer,11,,25,23,48
060 Auer,12,,11,23,34
060 Auer,13,,19,20,39
060 Auer,14,,28,16,44
060 Auer,15,,17,20,37
060 Auer,16,,23,20,43
060 Auer,17,,17,25,42
060 Auer,18,,23,19,42
060 Auer,19,,16,15,31
060 Auer,20,,24,17,41
060 Auer,21,,15,14,29
060 Auer,22,,16,20,36
060 Auer,23,,17,26,43
060 Auer,24,,13,19,32
060 Auer,25,,15,19,34
060 Auer,26,,16,19,35
060 Auer,27,,12,14,26
060 Auer,28,,18,28,46
060 Auer,29,,18,33,51
060 Auer,30,,22,17,39
060 Auer,31,,32,25,57
060 Auer,32,,30,20,50
060 Auer,33,,20,26,46
060 Auer,34,,38,27,65
060 Auer,35,,27,30,57
060 Auer,36,,20,31,51
060 Auer,37,,38,38,76
060 Auer,38,,27,28,55
060 Auer,39,,34,36,70
060 Auer,40,,33,26,59
060 Auer,41,,34,25,59
060 Auer,42,,34,41,75
060 Auer,43,,26,24,50
060 Auer,44,,38,35,73
060 Auer,45,,27,35,62
060 Auer,46,,35,28,63
060 Auer,47,,34,21,55
060 Auer,48,,22,25,47
060 Auer,49,,30,28,58
060 Auer,50,,15,23,38
060 Auer,51,,21,13,34
060 Auer,52,,16,23,39
060 Auer,53,,18,21,39
060 Auer,54,,16,21,37
060 Auer,55,,16,22,38
060 Auer,56,,13,14,27
060 Auer,57,,29,14,43
060 Auer,58,,16,22,38
060 Auer,59,,17,24,41
060 Auer,60,,12,12,24
060 Auer,61,,22,15,37
060 Auer,62,,16,18,34
060 Auer,63,,17,18,35
060 Auer,64,,20,14,34
060 Auer,65,,12,9,21
060 Auer,66,,13,20,33
060 Auer,67,,16,18,34
060 Auer,68,,12,12,24
060 Auer,69,,11,9,20
060 Auer,70,,9,16,25
060 Auer,71,,16,14,30
060 Auer,72,,5,8,13
060 Auer,73,,3,16,19
060 Auer,74,,9,12,21
060 Auer,75,,7,9,16
060 Auer,76,,8,14,22
060 Auer,77,,10,8,18
060 Auer,78,,8,13,21
060 Auer,79,,3,17,20
060 Auer,80,,10,11,21
060 Auer,81,,9,10,19
060 Auer,82,,8,14,22
060 Auer,83,,2,15,17
060 Auer,84,,2,11,13
060 Auer,85,,6,10,16
060 Auer,86,,2,3,5
060 Auer,87,,-,7,7
060 Auer,88,,1,3,4
060 Auer,89,,-,2,2
060 Auer,90,,-,2,2
060 Auer,91,,-,2,2
060 Auer,92,,1,4,5
060 Auer,93,,-,2,2
060 Auer,94,,-,1,1
060 Auer,95,,1,1,2
061 St.Ulrich,0,,36,23,59
061 St.Ulrich,1,,23,31,54
061 St.Ulrich,2,,23,32,55
061 St.Ulrich,3,,26,39,65
061 St.Ulrich,4,,21,24,45
061 St.Ulrich,5,,32,32,64
061 St.Ulrich,6,,45,30,75
061 St.Ulrich,7,,44,35,79
061 St.Ulrich,8,,31,28,59
061 St.Ulrich,9,,33,24,57
061 St.Ulrich,10,,32,31,63
061 St.Ulrich,11,,29,30,59
061 St.Ulrich,12,,22,27,49
061 St.Ulrich,13,,35,29,64
061 St.Ulrich,14,,31,32,63
061 St.Ulrich,15,,28,20,48
061 St.Ulrich,16,,17,22,39
061 St.Ulrich,17,,17,22,39
061 St.Ulrich,18,,25,19,44
061 St.Ulrich,19,,19,15,34
061 St.Ulrich,20,,22,21,43
061 St.Ulrich,21,,23,18,41
061 St.Ulrich,22,,21,18,39
061 St.Ulrich,23,,24,26,50
061 St.Ulrich,24,,19,28,47
061 St.Ulrich,25,,25,33,58
061 St.Ulrich,26,,28,30,58
061 St.Ulrich,27,,23,29,52
061 St.Ulrich,28,,22,25,47
061 St.Ulrich,29,,34,36,70
061 St.Ulrich,30,,36,28,64
061 St.Ulrich,31,,38,34,72
061 St.Ulrich,32,,38,33,71
061 St.Ulrich,33,,39,34,73
061 St.Ulrich,34,,41,36,77
061 St.Ulrich,35,,41,33,74
061 St.Ulrich,36,,47,46,93
061 St.Ulrich,37,,42,47,89
061 St.Ulrich,38,,42,38,80
061 St.Ulrich,39,,36,40,76
061 St.Ulrich,40,,36,34,70
061 St.Ulrich,41,,43,42,85
061 St.Ulrich,42,,36,33,69
061 St.Ulrich,43,,30,35,65
061 St.Ulrich,44,,27,23,50
061 St.Ulrich,45,,32,26,58
061 St.Ulrich,46,,41,26,67
061 St.Ulrich,47,,22,18,40
061 St.Ulrich,48,,24,31,55
061 St.Ulrich,49,,16,27,43
061 St.Ulrich,50,,26,36,62
061 St.Ulrich,51,,27,32,59
061 St.Ulrich,52,,28,17,45
061 St.Ulrich,53,,11,25,36
061 St.Ulrich,54,,25,24,49
061 St.Ulrich,55,,20,27,47
061 St.Ulrich,56,,19,27,46
061 St.Ulrich,57,,30,30,60
061 St.Ulrich,58,,23,26,49
061 St.Ulrich,59,,32,27,59
061 St.Ulrich,60,,17,19,36
061 St.Ulrich,61,,29,32,61
061 St.Ulrich,62,,40,38,78
061 St.Ulrich,63,,29,36,65
061 St.Ulrich,64,,37,45,82
061 St.Ulrich,65,,33,28,61
061 St.Ulrich,66,,19,19,38
061 St.Ulrich,67,,24,25,49
061 St.Ulrich,68,,23,26,49
061 St.Ulrich,69,,24,17,41
061 St.Ulrich,70,,13,26,39
061 St.Ulrich,71,,17,12,29
061 St.Ulrich,72,,19,13,32
061 St.Ulrich,73,,15,22,37
061 St.Ulrich,74,,19,15,34
061 St.Ulrich,75,,21,9,30
061 St.Ulrich,76,,13,4,17
061 St.Ulrich,77,,16,13,29
061 St.Ulrich,78,,16,14,30
061 St.Ulrich,79,,8,14,22
061 St.Ulrich,80,,9,10,19
061 St.Ulrich,81,,9,20,29
061 St.Ulrich,82,,10,22,32
061 St.Ulrich,83,,4,18,22
061 St.Ulrich,84,,6,13,19
061 St.Ulrich,85,,4,18,22
061 St.Ulrich,86,,6,7,13
061 St.Ulrich,87,,5,6,11
061 St.Ulrich,88,,2,6,8
061 St.Ulrich,89,,3,3,6
061 St.Ulrich,90,,1,7,8
061 St.Ulrich,91,,5,5,10
061 St.Ulrich,92,,3,6,9
061 St.Ulrich,93,,3,4,7
061 St.Ulrich,94,,-,2,2
061 St.Ulrich,95,,1,1,2
061 St.Ulrich,96,,1,-,1
061 St.Ulrich,97,,1,1,2
061 St.Ulrich,98,,-,1,1
062 Partschins,0,,21,18,39
062 Partschins,1,,12,23,35
062 Partschins,2,,24,19,43
062 Partschins,3,,26,20,46
062 Partschins,4,,15,17,32
062 Partschins,5,,19,15,34
062 Partschins,6,,14,18,32
062 Partschins,7,,17,12,29
062 Partschins,8,,23,22,45
062 Partschins,9,,13,18,31
062 Partschins,10,,22,16,38
062 Partschins,11,,21,18,39
062 Partschins,12,,23,18,41
062 Partschins,13,,21,16,37
062 Partschins,14,,25,26,51
062 Partschins,15,,24,23,47
062 Partschins,16,,10,23,33
062 Partschins,17,,17,28,45
062 Partschins,18,,16,15,31
062 Partschins,19,,22,19,41
062 Partschins,20,,11,15,26
062 Partschins,21,,19,21,40
062 Partschins,22,,16,24,40
062 Partschins,23,,17,20,37
062 Partschins,24,,22,26,48
062 Partschins,25,,24,22,46
062 Partschins,26,,19,21,40
062 Partschins,27,,17,16,33
062 Partschins,28,,23,19,42
062 Partschins,29,,23,23,46
062 Partschins,30,,28,20,48
062 Partschins,31,,25,19,44
062 Partschins,32,,29,25,54
062 Partschins,33,,27,30,57
062 Partschins,34,,27,33,60
062 Partschins,35,,23,31,54
062 Partschins,36,,36,24,60
062 Partschins,37,,20,31,51
062 Partschins,38,,34,23,57
062 Partschins,39,,35,35,70
062 Partschins,40,,28,31,59
062 Partschins,41,,29,38,67
062 Partschins,42,,37,25,62
062 Partschins,43,,33,25,58
062 Partschins,44,,23,23,46
062 Partschins,45,,25,38,63
062 Partschins,46,,27,17,44
062 Partschins,47,,20,19,39
062 Partschins,48,,25,23,48
062 Partschins,49,,23,20,43
062 Partschins,50,,24,24,48
062 Partschins,51,,12,26,38
062 Partschins,52,,22,16,38
062 Partschins,53,,17,15,32
062 Partschins,54,,20,16,36
062 Partschins,55,,19,20,39
062 Partschins,56,,8,13,21
062 Partschins,57,,19,19,38
062 Partschins,58,,14,17,31
062 Partschins,59,,28,26,54
062 Partschins,60,,13,18,31
062 Partschins,61,,18,16,34
062 Partschins,62,,23,26,49
062 Partschins,63,,15,16,31
062 Partschins,64,,21,30,51
062 Partschins,65,,13,13,26
062 Partschins,66,,10,16,26
062 Partschins,67,,17,13,30
062 Partschins,68,,14,17,31
062 Partschins,69,,15,16,31
062 Partschins,70,,11,10,21
062 Partschins,71,,9,17,26
062 Partschins,72,,12,16,28
062 Partschins,73,,14,11,25
062 Partschins,74,,13,21,34
062 Partschins,75,,10,10,20
062 Partschins,76,,12,8,20
062 Partschins,77,,10,11,21
062 Partschins,78,,11,11,22
062 Partschins,79,,8,8,16
062 Partschins,80,,4,9,13
062 Partschins,81,,4,12,16
062 Partschins,82,,6,9,15
062 Partschins,83,,4,8,12
062 Partschins,84,,12,7,19
062 Partschins,85,,3,6,9
062 Partschins,86,,2,5,7
062 Partschins,87,,1,2,3
062 Partschins,88,,1,4,5
062 Partschins,89,,-,4,4
062 Partschins,90,,1,1,2
062 Partschins,91,,1,4,5
062 Partschins,92,,1,1,2
062 Partschins,93,,-,3,3
062 Partschins,94,,-,1,1
062 Partschins,100,,-,1,1
063 Percha,0,,9,12,21
063 Percha,1,,10,17,27
063 Percha,2,,8,5,13
063 Percha,3,,12,6,18
063 Percha,4,,5,6,11
063 Percha,5,,12,11,23
063 Percha,6,,5,7,12
063 Percha,7,,9,8,17
063 Percha,8,,10,16,26
063 Percha,9,,9,4,13
063 Percha,10,,8,9,17
063 Percha,11,,9,12,21
063 Percha,12,,7,9,16
063 Percha,13,,12,6,18
063 Percha,14,,10,9,19
063 Percha,15,,8,6,14
063 Percha,16,,6,8,14
063 Percha,17,,6,4,10
063 Percha,18,,9,18,27
063 Percha,19,,6,7,13
063 Percha,20,,8,13,21
063 Percha,21,,17,9,26
063 Percha,22,,14,9,23
063 Percha,23,,6,10,16
063 Percha,24,,9,6,15
063 Percha,25,,11,5,16
063 Percha,26,,7,13,20
063 Percha,27,,9,13,22
063 Percha,28,,8,11,19
063 Percha,29,,14,12,26
063 Percha,30,,10,8,18
063 Percha,31,,9,13,22
063 Percha,32,,13,10,23
063 Percha,33,,14,10,24
063 Percha,34,,18,15,33
063 Percha,35,,7,12,19
063 Percha,36,,18,16,34
063 Percha,37,,16,13,29
063 Percha,38,,7,11,18
063 Percha,39,,17,6,23
063 Percha,40,,15,23,38
063 Percha,41,,15,7,22
063 Percha,42,,12,17,29
063 Percha,43,,14,10,24
063 Percha,44,,11,11,22
063 Percha,45,,10,6,16
063 Percha,46,,6,9,15
063 Percha,47,,10,10,20
063 Percha,48,,10,5,15
063 Percha,49,,7,12,19
063 Percha,50,,11,10,21
063 Percha,51,,4,4,8
063 Percha,52,,8,6,14
063 Percha,53,,4,8,12
063 Percha,54,,7,7,14
063 Percha,55,,6,8,14
063 Percha,56,,9,6,15
063 Percha,57,,4,4,8
063 Percha,58,,6,6,12
063 Percha,59,,6,8,14
063 Percha,60,,8,5,13
063 Percha,61,,14,5,19
063 Percha,62,,8,8,16
063 Percha,63,,8,7,15
063 Percha,64,,7,6,13
063 Percha,65,,5,5,10
063 Percha,66,,6,5,11
063 Percha,67,,5,9,14
063 Percha,68,,1,5,6
063 Percha,69,,3,3,6
063 Percha,70,,4,4,8
063 Percha,71,,8,6,14
063 Percha,72,,4,5,9
063 Percha,73,,4,3,7
063 Percha,74,,6,1,7
063 Percha,75,,9,3,12
063 Percha,76,,2,5,7
063 Percha,77,,2,4,6
063 Percha,78,,4,2,6
063 Percha,79,,2,5,7
063 Percha,80,,4,5,9
063 Percha,81,,-,3,3
063 Percha,82,,1,3,4
063 Percha,83,,2,1,3
063 Percha,84,,-,2,2
063 Percha,85,,-,1,1
063 Percha,87,,-,1,1
063 Percha,91,,-,3,3
064 Plaus,0,,3,1,4
064 Plaus,1,,6,1,7
064 Plaus,2,,4,1,5
064 Plaus,3,,5,5,10
064 Plaus,4,,8,3,11
064 Plaus,5,,10,3,13
064 Plaus,6,,10,5,15
064 Plaus,7,,4,7,11
064 Plaus,8,,7,5,12
064 Plaus,9,,4,2,6
064 Plaus,10,,2,2,4
064 Plaus,11,,4,1,5
064 Plaus,12,,9,3,12
064 Plaus,13,,7,6,13
064 Plaus,14,,3,10,13
064 Plaus,15,,4,3,7
064 Plaus,16,,5,7,12
064 Plaus,17,,4,2,6
064 Plaus,18,,4,2,6
064 Plaus,19,,-,4,4
064 Plaus,20,,3,5,8
064 Plaus,21,,4,-,4
064 Plaus,22,,1,3,4
064 Plaus,23,,1,3,4
064 Plaus,24,,2,7,9
064 Plaus,25,,1,4,5
064 Plaus,26,,3,6,9
064 Plaus,27,,6,2,8
064 Plaus,28,,4,6,10
064 Plaus,29,,3,3,6
064 Plaus,30,,9,3,12
064 Plaus,31,,5,6,11
064 Plaus,32,,8,6,14
064 Plaus,33,,5,4,9
064 Plaus,34,,6,6,12
064 Plaus,35,,9,4,13
064 Plaus,36,,7,9,16
064 Plaus,37,,3,8,11
064 Plaus,38,,7,10,17
064 Plaus,39,,5,5,10
064 Plaus,40,,15,2,17
064 Plaus,41,,7,8,15
064 Plaus,42,,2,5,7
064 Plaus,43,,6,5,11
064 Plaus,44,,7,3,10
064 Plaus,45,,3,6,9
064 Plaus,46,,7,2,9
064 Plaus,47,,3,3,6
064 Plaus,48,,1,2,3
064 Plaus,49,,2,1,3
064 Plaus,50,,4,4,8
064 Plaus,51,,1,1,2
064 Plaus,52,,2,4,6
064 Plaus,53,,5,2,7
064 Plaus,54,,5,3,8
064 Plaus,55,,1,2,3
064 Plaus,56,,4,3,7
064 Plaus,57,,1,3,4
064 Plaus,58,,2,5,7
064 Plaus,59,,5,2,7
064 Plaus,60,,4,1,5
064 Plaus,61,,2,3,5
064 Plaus,62,,5,1,6
064 Plaus,63,,-,4,4
064 Plaus,64,,3,3,6
064 Plaus,65,,3,1,4
064 Plaus,66,,3,2,5
064 Plaus,67,,1,1,2
064 Plaus,68,,3,3,6
064 Plaus,70,,2,2,4
064 Plaus,71,,4,2,6
064 Plaus,72,,1,3,4
064 Plaus,73,,1,3,4
064 Plaus,74,,1,1,2
064 Plaus,76,,1,1,2
064 Plaus,78,,1,1,2
064 Plaus,79,,1,1,2
064 Plaus,80,,1,-,1
064 Plaus,81,,-,3,3
064 Plaus,82,,-,2,2
064 Plaus,83,,1,1,2
064 Plaus,84,,-,1,1
064 Plaus,86,,-,2,2
064 Plaus,87,,-,1,1
064 Plaus,90,,-,1,1
064 Plaus,93,,1,-,1
065 Waidbruck,1,,1,-,1
065 Waidbruck,2,,-,1,1
065 Waidbruck,3,,-,1,1
065 Waidbruck,4,,1,1,2
065 Waidbruck,5,,1,2,3
065 Waidbruck,6,,3,2,5
065 Waidbruck,8,,3,3,6
065 Waidbruck,9,,2,-,2
065 Waidbruck,10,,1,3,4
065 Waidbruck,11,,3,1,4
065 Waidbruck,12,,1,1,2
065 Waidbruck,13,,-,2,2
065 Waidbruck,14,,1,-,1
065 Waidbruck,15,,1,1,2
065 Waidbruck,16,,1,-,1
065 Waidbruck,17,,-,1,1
065 Waidbruck,18,,1,1,2
065 Waidbruck,20,,1,1,2
065 Waidbruck,21,,3,1,4
065 Waidbruck,22,,1,-,1
065 Waidbruck,24,,-,2,2
065 Waidbruck,25,,1,-,1
065 Waidbruck,26,,1,-,1
065 Waidbruck,27,,4,1,5
065 Waidbruck,28,,1,2,3
065 Waidbruck,29,,-,1,1
065 Waidbruck,30,,2,-,2
065 Waidbruck,31,,5,1,6
065 Waidbruck,32,,-,1,1
065 Waidbruck,33,,4,1,5
065 Waidbruck,34,,2,-,2
065 Waidbruck,35,,2,1,3
065 Waidbruck,36,,2,3,5
065 Waidbruck,37,,4,1,5
065 Waidbruck,38,,2,4,6
065 Waidbruck,39,,2,2,4
065 Waidbruck,40,,4,1,5
065 Waidbruck,41,,4,-,4
065 Waidbruck,42,,1,1,2
065 Waidbruck,43,,1,-,1
065 Waidbruck,44,,-,1,1
065 Waidbruck,45,,5,1,6
065 Waidbruck,46,,4,1,5
065 Waidbruck,47,,-,1,1
065 Waidbruck,48,,3,1,4
065 Waidbruck,49,,2,-,2
065 Waidbruck,50,,2,-,2
065 Waidbruck,53,,1,1,2
065 Waidbruck,54,,-,1,1
065 Waidbruck,59,,-,3,3
065 Waidbruck,60,,1,1,2
065 Waidbruck,61,,2,1,3
065 Waidbruck,63,,2,-,2
065 Waidbruck,64,,1,2,3
065 Waidbruck,65,,-,3,3
065 Waidbruck,66,,1,-,1
065 Waidbruck,67,,-,2,2
065 Waidbruck,68,,1,1,2
065 Waidbruck,69,,2,2,4
065 Waidbruck,70,,-,3,3
065 Waidbruck,71,,2,1,3
065 Waidbruck,72,,2,-,2
065 Waidbruck,73,,-,3,3
065 Waidbruck,74,,1,-,1
065 Waidbruck,75,,1,-,1
065 Waidbruck,76,,-,3,3
065 Waidbruck,77,,1,1,2
065 Waidbruck,78,,2,1,3
065 Waidbruck,79,,-,1,1
065 Waidbruck,80,,1,1,2
065 Waidbruck,82,,-,2,2
065 Waidbruck,83,,-,1,1
065 Waidbruck,85,,-,1,1
065 Waidbruck,86,,-,2,2
065 Waidbruck,91,,-,1,1
065 Waidbruck,95,,-,1,1
066 Burgstall,0,,6,8,14
066 Burgstall,1,,13,5,18
066 Burgstall,2,,10,10,20
066 Burgstall,3,,9,9,18
066 Burgstall,4,,9,8,17
066 Burgstall,5,,13,12,25
066 Burgstall,6,,9,9,18
066 Burgstall,7,,9,10,19
066 Burgstall,8,,8,6,14
066 Burgstall,9,,7,9,16
066 Burgstall,10,,10,10,20
066 Burgstall,11,,6,5,11
066 Burgstall,12,,8,10,18
066 Burgstall,13,,3,6,9
066 Burgstall,14,,8,11,19
066 Burgstall,15,,14,8,22
066 Burgstall,16,,11,3,14
066 Burgstall,17,,7,7,14
066 Burgstall,18,,9,9,18
066 Burgstall,19,,10,4,14
066 Burgstall,20,,7,13,20
066 Burgstall,21,,10,13,23
066 Burgstall,22,,8,10,18
066 Burgstall,23,,13,8,21
066 Burgstall,24,,5,7,12
066 Burgstall,25,,10,10,20
066 Burgstall,26,,5,6,11
066 Burgstall,27,,7,8,15
066 Burgstall,28,,6,17,23
066 Burgstall,29,,9,10,19
066 Burgstall,30,,17,12,29
066 Burgstall,31,,9,12,21
066 Burgstall,32,,15,14,29
066 Burgstall,33,,8,21,29
066 Burgstall,34,,17,11,28
066 Burgstall,35,,17,13,30
066 Burgstall,36,,18,9,27
066 Burgstall,37,,15,18,33
066 Burgstall,38,,11,14,25
066 Burgstall,39,,14,19,33
066 Burgstall,40,,20,18,38
066 Burgstall,41,,16,12,28
066 Burgstall,42,,16,14,30
066 Burgstall,43,,16,12,28
066 Burgstall,44,,10,15,25
066 Burgstall,45,,14,10,24
066 Burgstall,46,,9,9,18
066 Burgstall,47,,16,7,23
066 Burgstall,48,,10,9,19
066 Burgstall,49,,13,11,24
066 Burgstall,50,,7,12,19
066 Burgstall,51,,10,17,27
066 Burgstall,52,,9,9,18
066 Burgstall,53,,12,15,27
066 Burgstall,54,,15,7,22
066 Burgstall,55,,9,12,21
066 Burgstall,56,,9,6,15
066 Burgstall,57,,7,13,20
066 Burgstall,58,,8,10,18
066 Burgstall,59,,13,8,21
066 Burgstall,60,,8,9,17
066 Burgstall,61,,12,10,22
066 Burgstall,62,,11,9,20
066 Burgstall,63,,5,7,12
066 Burgstall,64,,8,4,12
066 Burgstall,65,,5,12,17
066 Burgstall,66,,7,8,15
066 Burgstall,67,,10,14,24
066 Burgstall,68,,4,10,14
066 Burgstall,69,,5,5,10
066 Burgstall,70,,7,4,11
066 Burgstall,71,,8,7,15
066 Burgstall,72,,8,4,12
066 Burgstall,73,,2,8,10
066 Burgstall,74,,6,3,9
066 Burgstall,75,,5,7,12
066 Burgstall,76,,1,4,5
066 Burgstall,77,,5,7,12
066 Burgstall,78,,2,12,14
066 Burgstall,79,,4,9,13
066 Burgstall,80,,6,5,11
066 Burgstall,81,,1,5,6
066 Burgstall,82,,4,3,7
066 Burgstall,83,,4,6,10
066 Burgstall,84,,1,-,1
066 Burgstall,85,,1,3,4
066 Burgstall,86,,1,3,4
066 Burgstall,87,,-,1,1
066 Burgstall,88,,1,-,1
066 Burgstall,89,,-,2,2
066 Burgstall,90,,1,3,4
066 Burgstall,91,,-,2,2
066 Burgstall,92,,-,1,1
066 Burgstall,93,,-,1,1
066 Burgstall,95,,-,1,1
066 Burgstall,96,,-,1,1
066 Burgstall,98,,1,-,1
067 Prad am Stilfser Joch,0,,21,11,32
067 Prad am Stilfser Joch,1,,20,22,42
067 Prad am Stilfser Joch,2,,16,11,27
067 Prad am Stilfser Joch,3,,10,14,24
067 Prad am Stilfser Joch,4,,23,14,37
067 Prad am Stilfser Joch,5,,18,16,34
067 Prad am Stilfser Joch,6,,15,17,32
067 Prad am Stilfser Joch,7,,21,22,43
067 Prad am Stilfser Joch,8,,24,16,40
067 Prad am Stilfser Joch,9,,22,19,41
067 Prad am Stilfser Joch,10,,20,13,33
067 Prad am Stilfser Joch,11,,22,28,50
067 Prad am Stilfser Joch,12,,22,29,51
067 Prad am Stilfser Joch,13,,19,20,39
067 Prad am Stilfser Joch,14,,20,10,30
067 Prad am Stilfser Joch,15,,20,22,42
067 Prad am Stilfser Joch,16,,20,24,44
067 Prad am Stilfser Joch,17,,32,18,50
067 Prad am Stilfser Joch,18,,13,19,32
067 Prad am Stilfser Joch,19,,29,28,57
067 Prad am Stilfser Joch,20,,29,22,51
067 Prad am Stilfser Joch,21,,29,29,58
067 Prad am Stilfser Joch,22,,29,27,56
067 Prad am Stilfser Joch,23,,28,26,54
067 Prad am Stilfser Joch,24,,22,22,44
067 Prad am Stilfser Joch,25,,29,19,48
067 Prad am Stilfser Joch,26,,19,16,35
067 Prad am Stilfser Joch,27,,25,20,45
067 Prad am Stilfser Joch,28,,17,38,55
067 Prad am Stilfser Joch,29,,25,21,46
067 Prad am Stilfser Joch,30,,20,17,37
067 Prad am Stilfser Joch,31,,32,15,47
067 Prad am Stilfser Joch,32,,24,38,62
067 Prad am Stilfser Joch,33,,27,22,49
067 Prad am Stilfser Joch,34,,28,20,48
067 Prad am Stilfser Joch,35,,26,23,49
067 Prad am Stilfser Joch,36,,27,26,53
067 Prad am Stilfser Joch,37,,33,33,66
067 Prad am Stilfser Joch,38,,21,25,46
067 Prad am Stilfser Joch,39,,38,29,67
067 Prad am Stilfser Joch,40,,33,26,59
067 Prad am Stilfser Joch,41,,25,27,52
067 Prad am Stilfser Joch,42,,26,11,37
067 Prad am Stilfser Joch,43,,26,30,56
067 Prad am Stilfser Joch,44,,20,28,48
067 Prad am Stilfser Joch,45,,18,26,44
067 Prad am Stilfser Joch,46,,33,13,46
067 Prad am Stilfser Joch,47,,21,29,50
067 Prad am Stilfser Joch,48,,27,26,53
067 Prad am Stilfser Joch,49,,24,24,48
067 Prad am Stilfser Joch,50,,26,17,43
067 Prad am Stilfser Joch,51,,29,17,46
067 Prad am Stilfser Joch,52,,25,18,43
067 Prad am Stilfser Joch,53,,15,19,34
067 Prad am Stilfser Joch,54,,20,21,41
067 Prad am Stilfser Joch,55,,21,17,38
067 Prad am Stilfser Joch,56,,21,20,41
067 Prad am Stilfser Joch,57,,19,10,29
067 Prad am Stilfser Joch,58,,16,12,28
067 Prad am Stilfser Joch,59,,17,14,31
067 Prad am Stilfser Joch,60,,16,11,27
067 Prad am Stilfser Joch,61,,10,16,26
067 Prad am Stilfser Joch,62,,25,17,42
067 Prad am Stilfser Joch,63,,16,16,32
067 Prad am Stilfser Joch,64,,23,9,32
067 Prad am Stilfser Joch,65,,10,16,26
067 Prad am Stilfser Joch,66,,13,14,27
067 Prad am Stilfser Joch,67,,18,13,31
067 Prad am Stilfser Joch,68,,9,13,22
067 Prad am Stilfser Joch,69,,10,11,21
067 Prad am Stilfser Joch,70,,15,12,27
067 Prad am Stilfser Joch,71,,7,22,29
067 Prad am Stilfser Joch,72,,12,11,23
067 Prad am Stilfser Joch,73,,11,18,29
067 Prad am Stilfser Joch,74,,6,14,20
067 Prad am Stilfser Joch,75,,12,12,24
067 Prad am Stilfser Joch,76,,9,13,22
067 Prad am Stilfser Joch,77,,6,9,15
067 Prad am Stilfser Joch,78,,6,11,17
067 Prad am Stilfser Joch,79,,8,12,20
067 Prad am Stilfser Joch,80,,9,7,16
067 Prad am Stilfser Joch,81,,2,10,12
067 Prad am Stilfser Joch,82,,2,10,12
067 Prad am Stilfser Joch,83,,5,11,16
067 Prad am Stilfser Joch,84,,4,7,11
067 Prad am Stilfser Joch,85,,4,4,8
067 Prad am Stilfser Joch,86,,5,4,9
067 Prad am Stilfser Joch,87,,1,2,3
067 Prad am Stilfser Joch,88,,-,4,4
067 Prad am Stilfser Joch,89,,-,2,2
067 Prad am Stilfser Joch,90,,1,-,1
067 Prad am Stilfser Joch,91,,-,3,3
067 Prad am Stilfser Joch,92,,-,2,2
067 Prad am Stilfser Joch,93,,2,2,4
067 Prad am Stilfser Joch,94,,-,1,1
067 Prad am Stilfser Joch,95,,-,2,2
068 Prettau,0,,2,1,3
068 Prettau,1,,5,5,10
068 Prettau,2,,1,4,5
068 Prettau,3,,1,3,4
068 Prettau,4,,3,4,7
068 Prettau,5,,2,4,6
068 Prettau,6,,6,6,12
068 Prettau,7,,6,4,10
068 Prettau,8,,2,4,6
068 Prettau,9,,1,2,3
068 Prettau,10,,5,4,9
068 Prettau,11,,4,7,11
068 Prettau,12,,3,7,10
068 Prettau,13,,3,3,6
068 Prettau,14,,1,4,5
068 Prettau,15,,1,7,8
068 Prettau,16,,-,3,3
068 Prettau,17,,5,3,8
068 Prettau,18,,5,1,6
068 Prettau,19,,2,2,4
068 Prettau,20,,2,1,3
068 Prettau,21,,3,6,9
068 Prettau,22,,4,2,6
068 Prettau,23,,2,1,3
068 Prettau,24,,2,1,3
068 Prettau,25,,4,4,8
068 Prettau,26,,5,3,8
068 Prettau,27,,1,1,2
068 Prettau,28,,4,3,7
068 Prettau,29,,1,2,3
068 Prettau,30,,4,2,6
068 Prettau,31,,5,-,5
068 Prettau,32,,6,6,12
068 Prettau,33,,9,4,13
068 Prettau,34,,4,6,10
068 Prettau,35,,3,6,9
068 Prettau,36,,7,7,14
068 Prettau,37,,3,2,5
068 Prettau,38,,10,4,14
068 Prettau,39,,6,1,7
068 Prettau,40,,5,10,15
068 Prettau,41,,8,6,14
068 Prettau,42,,5,6,11
068 Prettau,43,,2,5,7
068 Prettau,44,,5,5,10
068 Prettau,45,,8,4,12
068 Prettau,46,,5,2,7
068 Prettau,47,,7,-,7
068 Prettau,48,,4,1,5
068 Prettau,49,,6,5,11
068 Prettau,50,,6,5,11
068 Prettau,51,,5,2,7
068 Prettau,52,,3,3,6
068 Prettau,53,,4,3,7
068 Prettau,54,,3,2,5
068 Prettau,55,,2,2,4
068 Prettau,56,,2,3,5
068 Prettau,57,,2,2,4
068 Prettau,58,,4,5,9
068 Prettau,59,,7,4,11
068 Prettau,60,,1,3,4
068 Prettau,61,,6,5,11
068 Prettau,62,,3,2,5
068 Prettau,63,,3,2,5
068 Prettau,64,,3,3,6
068 Prettau,65,,4,5,9
068 Prettau,66,,4,3,7
068 Prettau,67,,5,7,12
068 Prettau,68,,2,6,8
068 Prettau,69,,3,3,6
068 Prettau,70,,6,2,8
068 Prettau,71,,1,3,4
068 Prettau,72,,3,3,6
068 Prettau,73,,3,-,3
068 Prettau,74,,2,1,3
068 Prettau,75,,5,4,9
068 Prettau,76,,4,5,9
068 Prettau,77,,-,2,2
068 Prettau,78,,3,1,4
068 Prettau,79,,1,7,8
068 Prettau,80,,1,1,2
068 Prettau,81,,1,1,2
068 Prettau,82,,-,1,1
068 Prettau,83,,2,-,2
068 Prettau,84,,1,2,3
068 Prettau,85,,1,1,2
068 Prettau,86,,2,-,2
068 Prettau,87,,1,1,2
068 Prettau,88,,1,-,1
068 Prettau,89,,2,2,4
068 Prettau,91,,-,1,1
068 Prettau,92,,-,1,1
068 Prettau,99,,-,1,1
068 Prettau,100,,-,1,1
069 Proveis,0,,-,4,4
069 Proveis,1,,2,2,4
069 Proveis,2,,1,1,2
069 Proveis,3,,4,-,4
069 Proveis,4,,1,1,2
069 Proveis,5,,-,1,1
069 Proveis,6,,4,-,4
069 Proveis,7,,2,2,4
069 Proveis,8,,1,2,3
069 Proveis,9,,1,1,2
069 Proveis,10,,-,5,5
069 Proveis,11,,2,-,2
069 Proveis,12,,2,1,3
069 Proveis,13,,3,1,4
069 Proveis,14,,3,2,5
069 Proveis,15,,-,1,1
069 Proveis,16,,1,1,2
069 Proveis,17,,2,3,5
069 Proveis,18,,2,2,4
069 Proveis,19,,3,1,4
069 Proveis,20,,5,-,5
069 Proveis,21,,3,3,6
069 Proveis,22,,3,3,6
069 Proveis,23,,2,-,2
069 Proveis,24,,2,2,4
069 Proveis,26,,3,1,4
069 Proveis,27,,2,2,4
069 Proveis,28,,2,3,5
069 Proveis,29,,2,2,4
069 Proveis,30,,2,-,2
069 Proveis,31,,5,2,7
069 Proveis,32,,2,-,2
069 Proveis,33,,1,1,2
069 Proveis,34,,-,1,1
069 Proveis,35,,3,3,6
069 Proveis,36,,3,4,7
069 Proveis,37,,5,1,6
069 Proveis,38,,2,1,3
069 Proveis,39,,2,2,4
069 Proveis,40,,1,1,2
069 Proveis,41,,3,-,3
069 Proveis,42,,4,2,6
069 Proveis,43,,4,2,6
069 Proveis,44,,3,1,4
069 Proveis,45,,-,4,4
069 Proveis,46,,4,-,4
069 Proveis,47,,1,3,4
069 Proveis,48,,2,2,4
069 Proveis,49,,4,1,5
069 Proveis,50,,4,4,8
069 Proveis,51,,3,2,5
069 Proveis,52,,1,1,2
069 Proveis,53,,2,3,5
069 Proveis,54,,2,-,2
069 Proveis,55,,1,1,2
069 Proveis,56,,1,-,1
069 Proveis,57,,2,1,3
069 Proveis,58,,2,2,4
069 Proveis,59,,3,-,3
069 Proveis,60,,1,1,2
069 Proveis,61,,2,-,2
069 Proveis,62,,2,1,3
069 Proveis,63,,1,1,2
069 Proveis,64,,1,1,2
069 Proveis,65,,3,-,3
069 Proveis,66,,1,3,4
069 Proveis,67,,-,2,2
069 Proveis,68,,1,1,2
069 Proveis,69,,2,1,3
069 Proveis,70,,1,1,2
069 Proveis,71,,-,1,1
069 Proveis,72,,-,2,2
069 Proveis,73,,1,1,2
069 Proveis,74,,1,1,2
069 Proveis,76,,3,3,6
069 Proveis,77,,3,1,4
069 Proveis,78,,-,1,1
069 Proveis,80,,-,1,1
069 Proveis,81,,1,-,1
069 Proveis,83,,-,2,2
069 Proveis,84,,-,4,4
069 Proveis,85,,-,1,1
070 Ratschings,0,,25,33,58
070 Ratschings,1,,35,24,59
070 Ratschings,2,,29,22,51
070 Ratschings,3,,15,26,41
070 Ratschings,4,,26,34,60
070 Ratschings,5,,35,23,58
070 Ratschings,6,,27,20,47
070 Ratschings,7,,33,21,54
070 Ratschings,8,,37,37,74
070 Ratschings,9,,30,34,64
070 Ratschings,10,,30,25,55
070 Ratschings,11,,22,28,50
070 Ratschings,12,,25,21,46
070 Ratschings,13,,39,30,69
070 Ratschings,14,,24,22,46
070 Ratschings,15,,31,27,58
070 Ratschings,16,,26,18,44
070 Ratschings,17,,34,30,64
070 Ratschings,18,,29,31,60
070 Ratschings,19,,28,25,53
070 Ratschings,20,,28,34,62
070 Ratschings,21,,25,20,45
070 Ratschings,22,,31,20,51
070 Ratschings,23,,34,24,58
070 Ratschings,24,,26,31,57
070 Ratschings,25,,27,24,51
070 Ratschings,26,,33,25,58
070 Ratschings,27,,30,19,49
070 Ratschings,28,,35,19,54
070 Ratschings,29,,23,29,52
070 Ratschings,30,,33,31,64
070 Ratschings,31,,39,24,63
070 Ratschings,32,,32,33,65
070 Ratschings,33,,38,35,73
070 Ratschings,34,,38,42,80
070 Ratschings,35,,30,40,70
070 Ratschings,36,,36,44,80
070 Ratschings,37,,50,40,90
070 Ratschings,38,,38,40,78
070 Ratschings,39,,43,45,88
070 Ratschings,40,,35,46,81
070 Ratschings,41,,50,37,87
070 Ratschings,42,,45,29,74
070 Ratschings,43,,36,40,76
070 Ratschings,44,,33,27,60
070 Ratschings,45,,41,24,65
070 Ratschings,46,,41,25,66
070 Ratschings,47,,30,24,54
070 Ratschings,48,,34,18,52
070 Ratschings,49,,35,19,54
070 Ratschings,50,,14,32,46
070 Ratschings,51,,27,16,43
070 Ratschings,52,,21,25,46
070 Ratschings,53,,22,19,41
070 Ratschings,54,,17,13,30
070 Ratschings,55,,24,21,45
070 Ratschings,56,,24,23,47
070 Ratschings,57,,29,18,47
070 Ratschings,58,,17,14,31
070 Ratschings,59,,23,7,30
070 Ratschings,60,,17,18,35
070 Ratschings,61,,16,11,27
070 Ratschings,62,,16,12,28
070 Ratschings,63,,19,18,37
070 Ratschings,64,,22,20,42
070 Ratschings,65,,17,17,34
070 Ratschings,66,,18,16,34
070 Ratschings,67,,14,20,34
070 Ratschings,68,,20,9,29
070 Ratschings,69,,13,13,26
070 Ratschings,70,,13,17,30
070 Ratschings,71,,12,9,21
070 Ratschings,72,,15,19,34
070 Ratschings,73,,15,13,28
070 Ratschings,74,,11,11,22
070 Ratschings,75,,10,16,26
070 Ratschings,76,,7,21,28
070 Ratschings,77,,9,12,21
070 Ratschings,78,,12,11,23
070 Ratschings,79,,10,11,21
070 Ratschings,80,,10,8,18
070 Ratschings,81,,8,10,18
070 Ratschings,82,,6,9,15
070 Ratschings,83,,3,9,12
070 Ratschings,84,,2,9,11
070 Ratschings,85,,2,10,12
070 Ratschings,86,,1,2,3
070 Ratschings,87,,-,5,5
070 Ratschings,89,,2,1,3
070 Ratschings,90,,2,2,4
070 Ratschings,91,,-,2,2
070 Ratschings,92,,1,-,1
070 Ratschings,97,,-,1,1
071 Rasen-Antholz,0,,26,15,41
071 Rasen-Antholz,1,,13,16,29
071 Rasen-Antholz,2,,9,25,34
071 Rasen-Antholz,3,,14,24,38
071 Rasen-Antholz,4,,18,20,38
071 Rasen-Antholz,5,,26,21,47
071 Rasen-Antholz,6,,13,18,31
071 Rasen-Antholz,7,,18,13,31
071 Rasen-Antholz,8,,27,19,46
071 Rasen-Antholz,9,,26,16,42
071 Rasen-Antholz,10,,8,14,22
071 Rasen-Antholz,11,,21,11,32
071 Rasen-Antholz,12,,20,14,34
071 Rasen-Antholz,13,,26,19,45
071 Rasen-Antholz,14,,14,14,28
071 Rasen-Antholz,15,,14,27,41
071 Rasen-Antholz,16,,19,17,36
071 Rasen-Antholz,17,,20,18,38
071 Rasen-Antholz,18,,26,9,35
071 Rasen-Antholz,19,,17,20,37
071 Rasen-Antholz,20,,24,13,37
071 Rasen-Antholz,21,,18,16,34
071 Rasen-Antholz,22,,14,20,34
071 Rasen-Antholz,23,,21,24,45
071 Rasen-Antholz,24,,16,14,30
071 Rasen-Antholz,25,,18,14,32
071 Rasen-Antholz,26,,17,20,37
071 Rasen-Antholz,27,,17,22,39
071 Rasen-Antholz,28,,17,15,32
071 Rasen-Antholz,29,,22,18,40
071 Rasen-Antholz,30,,23,26,49
071 Rasen-Antholz,31,,26,20,46
071 Rasen-Antholz,32,,30,24,54
071 Rasen-Antholz,33,,28,19,47
071 Rasen-Antholz,34,,25,23,48
071 Rasen-Antholz,35,,25,22,47
071 Rasen-Antholz,36,,28,27,55
071 Rasen-Antholz,37,,27,26,53
071 Rasen-Antholz,38,,25,28,53
071 Rasen-Antholz,39,,29,18,47
071 Rasen-Antholz,40,,35,24,59
071 Rasen-Antholz,41,,29,24,53
071 Rasen-Antholz,42,,20,22,42
071 Rasen-Antholz,43,,27,20,47
071 Rasen-Antholz,44,,19,25,44
071 Rasen-Antholz,45,,21,24,45
071 Rasen-Antholz,46,,26,19,45
071 Rasen-Antholz,47,,22,16,38
071 Rasen-Antholz,48,,22,11,33
071 Rasen-Antholz,49,,18,14,32
071 Rasen-Antholz,50,,18,14,32
071 Rasen-Antholz,51,,14,13,27
071 Rasen-Antholz,52,,15,9,24
071 Rasen-Antholz,53,,12,15,27
071 Rasen-Antholz,54,,12,12,24
071 Rasen-Antholz,55,,14,8,22
071 Rasen-Antholz,56,,14,8,22
071 Rasen-Antholz,57,,14,10,24
071 Rasen-Antholz,58,,9,14,23
071 Rasen-Antholz,59,,10,14,24
071 Rasen-Antholz,60,,11,10,21
071 Rasen-Antholz,61,,10,8,18
071 Rasen-Antholz,62,,13,13,26
071 Rasen-Antholz,63,,11,14,25
071 Rasen-Antholz,64,,15,12,27
071 Rasen-Antholz,65,,10,17,27
071 Rasen-Antholz,66,,16,13,29
071 Rasen-Antholz,67,,13,8,21
071 Rasen-Antholz,68,,9,11,20
071 Rasen-Antholz,69,,9,12,21
071 Rasen-Antholz,70,,10,8,18
071 Rasen-Antholz,71,,12,10,22
071 Rasen-Antholz,72,,10,15,25
071 Rasen-Antholz,73,,13,11,24
071 Rasen-Antholz,74,,13,15,28
071 Rasen-Antholz,75,,4,11,15
071 Rasen-Antholz,76,,11,4,15
071 Rasen-Antholz,77,,4,3,7
071 Rasen-Antholz,78,,7,8,15
071 Rasen-Antholz,79,,7,6,13
071 Rasen-Antholz,80,,7,12,19
071 Rasen-Antholz,81,,4,10,14
071 Rasen-Antholz,82,,1,10,11
071 Rasen-Antholz,83,,4,6,10
071 Rasen-Antholz,84,,5,4,9
071 Rasen-Antholz,85,,2,5,7
071 Rasen-Antholz,86,,1,4,5
071 Rasen-Antholz,87,,-,3,3
071 Rasen-Antholz,88,,2,3,5
071 Rasen-Antholz,89,,-,2,2
071 Rasen-Antholz,90,,3,1,4
071 Rasen-Antholz,91,,1,1,2
071 Rasen-Antholz,92,,-,2,2
071 Rasen-Antholz,93,,1,1,2
071 Rasen-Antholz,94,,-,1,1
071 Rasen-Antholz,95,,-,1,1
071 Rasen-Antholz,96,,-,1,1
071 Rasen-Antholz,100,,-,1,1
072 Ritten,0,,40,47,87
072 Ritten,1,,48,48,96
072 Ritten,2,,44,37,81
072 Ritten,3,,32,47,79
072 Ritten,4,,52,44,96
072 Ritten,5,,44,44,88
072 Ritten,6,,52,54,106
072 Ritten,7,,40,44,84
072 Ritten,8,,56,52,108
072 Ritten,9,,39,50,89
072 Ritten,10,,55,43,98
072 Ritten,11,,59,46,105
072 Ritten,12,,57,50,107
072 Ritten,13,,45,69,114
072 Ritten,14,,61,51,112
072 Ritten,15,,59,45,104
072 Ritten,16,,52,41,93
072 Ritten,17,,58,51,109
072 Ritten,18,,49,40,89
072 Ritten,19,,49,43,92
072 Ritten,20,,44,48,92
072 Ritten,21,,45,23,68
072 Ritten,22,,51,42,93
072 Ritten,23,,41,51,92
072 Ritten,24,,47,52,99
072 Ritten,25,,45,40,85
072 Ritten,26,,49,41,90
072 Ritten,27,,45,35,80
072 Ritten,28,,59,37,96
072 Ritten,29,,42,46,88
072 Ritten,30,,57,41,98
072 Ritten,31,,62,56,118
072 Ritten,32,,64,45,109
072 Ritten,33,,53,57,110
072 Ritten,34,,51,67,118
072 Ritten,35,,54,69,123
072 Ritten,36,,44,69,113
072 Ritten,37,,70,61,131
072 Ritten,38,,69,53,122
072 Ritten,39,,63,49,112
072 Ritten,40,,79,42,121
072 Ritten,41,,63,57,120
072 Ritten,42,,62,54,116
072 Ritten,43,,55,61,116
072 Ritten,44,,48,57,105
072 Ritten,45,,65,58,123
072 Ritten,46,,66,51,117
072 Ritten,47,,37,46,83
072 Ritten,48,,40,39,79
072 Ritten,49,,45,42,87
072 Ritten,50,,51,39,90
072 Ritten,51,,38,31,69
072 Ritten,52,,49,33,82
072 Ritten,53,,41,43,84
072 Ritten,54,,43,35,78
072 Ritten,55,,35,43,78
072 Ritten,56,,36,44,80
072 Ritten,57,,51,32,83
072 Ritten,58,,34,31,65
072 Ritten,59,,27,38,65
072 Ritten,60,,21,25,46
072 Ritten,61,,34,39,73
072 Ritten,62,,33,38,71
072 Ritten,63,,47,34,81
072 Ritten,64,,38,38,76
072 Ritten,65,,35,24,59
072 Ritten,66,,37,31,68
072 Ritten,67,,34,33,67
072 Ritten,68,,25,26,51
072 Ritten,69,,21,24,45
072 Ritten,70,,22,30,52
072 Ritten,71,,25,28,53
072 Ritten,72,,17,26,43
072 Ritten,73,,21,24,45
072 Ritten,74,,15,32,47
072 Ritten,75,,14,21,35
072 Ritten,76,,21,20,41
072 Ritten,77,,16,12,28
072 Ritten,78,,15,17,32
072 Ritten,79,,12,19,31
072 Ritten,80,,11,33,44
072 Ritten,81,,14,24,38
072 Ritten,82,,16,27,43
072 Ritten,83,,4,20,24
072 Ritten,84,,7,17,24
072 Ritten,85,,6,16,22
072 Ritten,86,,5,11,16
072 Ritten,87,,1,5,6
072 Ritten,88,,2,6,8
072 Ritten,89,,-,2,2
072 Ritten,90,,3,6,9
072 Ritten,91,,1,4,5
072 Ritten,92,,3,4,7
072 Ritten,93,,1,1,2
072 Ritten,94,,2,1,3
072 Ritten,95,,1,1,2
072 Ritten,96,,1,-,1
072 Ritten,98,,-,1,1
073 Riffian,0,,11,5,16
073 Riffian,1,,6,4,10
073 Riffian,2,,8,3,11
073 Riffian,3,,7,5,12
073 Riffian,4,,11,9,20
073 Riffian,5,,10,6,16
073 Riffian,6,,7,10,17
073 Riffian,7,,11,8,19
073 Riffian,8,,10,7,17
073 Riffian,9,,6,6,12
073 Riffian,10,,6,10,16
073 Riffian,11,,5,8,13
073 Riffian,12,,6,5,11
073 Riffian,13,,8,9,17
073 Riffian,14,,8,13,21
073 Riffian,15,,6,7,13
073 Riffian,16,,12,4,16
073 Riffian,17,,6,11,17
073 Riffian,18,,4,8,12
073 Riffian,19,,8,6,14
073 Riffian,20,,8,2,10
073 Riffian,21,,8,7,15
073 Riffian,22,,9,9,18
073 Riffian,23,,8,11,19
073 Riffian,24,,10,8,18
073 Riffian,25,,5,5,10
073 Riffian,26,,5,9,14
073 Riffian,27,,12,6,18
073 Riffian,28,,14,14,28
073 Riffian,29,,10,2,12
073 Riffian,30,,9,11,20
073 Riffian,31,,9,6,15
073 Riffian,32,,8,8,16
073 Riffian,33,,10,21,31
073 Riffian,34,,13,14,27
073 Riffian,35,,8,9,17
073 Riffian,36,,10,13,23
073 Riffian,37,,8,13,21
073 Riffian,38,,12,12,24
073 Riffian,39,,12,6,18
073 Riffian,40,,10,4,14
073 Riffian,41,,8,7,15
073 Riffian,42,,16,11,27
073 Riffian,43,,11,10,21
073 Riffian,44,,9,8,17
073 Riffian,45,,14,5,19
073 Riffian,46,,8,13,21
073 Riffian,47,,7,6,13
073 Riffian,48,,7,11,18
073 Riffian,49,,10,4,14
073 Riffian,50,,4,8,12
073 Riffian,51,,11,6,17
073 Riffian,52,,8,5,13
073 Riffian,53,,7,3,10
073 Riffian,54,,5,10,15
073 Riffian,55,,3,3,6
073 Riffian,56,,6,7,13
073 Riffian,57,,6,3,9
073 Riffian,58,,3,4,7
073 Riffian,59,,2,7,9
073 Riffian,60,,6,3,9
073 Riffian,61,,7,9,16
073 Riffian,62,,8,7,15
073 Riffian,63,,12,7,19
073 Riffian,64,,7,3,10
073 Riffian,65,,4,3,7
073 Riffian,66,,4,9,13
073 Riffian,67,,10,4,14
073 Riffian,68,,4,5,9
073 Riffian,69,,3,5,8
073 Riffian,70,,-,3,3
073 Riffian,71,,1,3,4
073 Riffian,72,,5,5,10
073 Riffian,73,,2,4,6
073 Riffian,74,,4,9,13
073 Riffian,75,,4,3,7
073 Riffian,76,,2,7,9
073 Riffian,77,,3,5,8
073 Riffian,78,,4,6,10
073 Riffian,79,,4,3,7
073 Riffian,80,,4,3,7
073 Riffian,81,,4,3,7
073 Riffian,82,,3,6,9
073 Riffian,83,,1,-,1
073 Riffian,84,,1,3,4
073 Riffian,85,,-,2,2
073 Riffian,87,,1,-,1
073 Riffian,88,,-,3,3
073 Riffian,91,,1,2,3
073 Riffian,93,,-,1,1
073 Riffian,95,,1,-,1
073 Riffian,97,,-,1,1
074 Mühlbach,0,,13,12,25
074 Mühlbach,1,,18,18,36
074 Mühlbach,2,,20,11,31
074 Mühlbach,3,,18,17,35
074 Mühlbach,4,,13,18,31
074 Mühlbach,5,,18,19,37
074 Mühlbach,6,,18,13,31
074 Mühlbach,7,,18,16,34
074 Mühlbach,8,,17,16,33
074 Mühlbach,9,,16,19,35
074 Mühlbach,10,,14,15,29
074 Mühlbach,11,,21,14,35
074 Mühlbach,12,,19,20,39
074 Mühlbach,13,,15,23,38
074 Mühlbach,14,,14,20,34
074 Mühlbach,15,,14,15,29
074 Mühlbach,16,,15,21,36
074 Mühlbach,17,,20,17,37
074 Mühlbach,18,,22,12,34
074 Mühlbach,19,,15,9,24
074 Mühlbach,20,,18,17,35
074 Mühlbach,21,,16,22,38
074 Mühlbach,22,,20,17,37
074 Mühlbach,23,,25,24,49
074 Mühlbach,24,,23,16,39
074 Mühlbach,25,,17,15,32
074 Mühlbach,26,,17,15,32
074 Mühlbach,27,,27,25,52
074 Mühlbach,28,,22,18,40
074 Mühlbach,29,,18,23,41
074 Mühlbach,30,,15,20,35
074 Mühlbach,31,,18,19,37
074 Mühlbach,32,,22,16,38
074 Mühlbach,33,,21,21,42
074 Mühlbach,34,,29,24,53
074 Mühlbach,35,,23,12,35
074 Mühlbach,36,,27,32,59
074 Mühlbach,37,,37,16,53
074 Mühlbach,38,,23,19,42
074 Mühlbach,39,,27,16,43
074 Mühlbach,40,,19,25,44
074 Mühlbach,41,,14,22,36
074 Mühlbach,42,,20,20,40
074 Mühlbach,43,,22,16,38
074 Mühlbach,44,,25,22,47
074 Mühlbach,45,,21,14,35
074 Mühlbach,46,,21,18,39
074 Mühlbach,47,,19,12,31
074 Mühlbach,48,,16,22,38
074 Mühlbach,49,,19,22,41
074 Mühlbach,50,,21,16,37
074 Mühlbach,51,,13,21,34
074 Mühlbach,52,,19,17,36
074 Mühlbach,53,,15,21,36
074 Mühlbach,54,,12,21,33
074 Mühlbach,55,,21,18,39
074 Mühlbach,56,,15,13,28
074 Mühlbach,57,,17,13,30
074 Mühlbach,58,,10,19,29
074 Mühlbach,59,,22,11,33
074 Mühlbach,60,,9,8,17
074 Mühlbach,61,,14,12,26
074 Mühlbach,62,,11,10,21
074 Mühlbach,63,,17,13,30
074 Mühlbach,64,,17,15,32
074 Mühlbach,65,,14,11,25
074 Mühlbach,66,,12,17,29
074 Mühlbach,67,,14,8,22
074 Mühlbach,68,,5,12,17
074 Mühlbach,69,,7,7,14
074 Mühlbach,70,,8,10,18
074 Mühlbach,71,,12,13,25
074 Mühlbach,72,,9,10,19
074 Mühlbach,73,,6,10,16
074 Mühlbach,74,,6,11,17
074 Mühlbach,75,,12,7,19
074 Mühlbach,76,,7,1,8
074 Mühlbach,77,,10,16,26
074 Mühlbach,78,,5,7,12
074 Mühlbach,79,,7,8,15
074 Mühlbach,80,,5,6,11
074 Mühlbach,81,,4,7,11
074 Mühlbach,82,,5,8,13
074 Mühlbach,83,,3,11,14
074 Mühlbach,84,,2,3,5
074 Mühlbach,85,,2,7,9
074 Mühlbach,86,,1,4,5
074 Mühlbach,87,,-,2,2
074 Mühlbach,88,,-,1,1
074 Mühlbach,90,,-,1,1
074 Mühlbach,91,,-,2,2
074 Mühlbach,92,,1,2,3
074 Mühlbach,93,,-,1,1
074 Mühlbach,98,,-,1,1
074 Mühlbach,99,,-,1,1
074 Mühlbach,100,,-,1,1
075 Rodeneck,0,,10,7,17
075 Rodeneck,1,,5,4,9
075 Rodeneck,2,,8,7,15
075 Rodeneck,3,,8,3,11
075 Rodeneck,4,,10,4,14
075 Rodeneck,5,,7,14,21
075 Rodeneck,6,,8,9,17
075 Rodeneck,7,,12,7,19
075 Rodeneck,8,,10,7,17
075 Rodeneck,9,,12,9,21
075 Rodeneck,10,,4,9,13
075 Rodeneck,11,,7,10,17
075 Rodeneck,12,,6,7,13
075 Rodeneck,13,,9,10,19
075 Rodeneck,14,,6,8,14
075 Rodeneck,15,,12,8,20
075 Rodeneck,16,,7,5,12
075 Rodeneck,17,,12,8,20
075 Rodeneck,18,,6,5,11
075 Rodeneck,19,,8,11,19
075 Rodeneck,20,,12,8,20
075 Rodeneck,21,,15,10,25
075 Rodeneck,22,,10,8,18
075 Rodeneck,23,,7,5,12
075 Rodeneck,24,,10,6,16
075 Rodeneck,25,,7,12,19
075 Rodeneck,26,,9,3,12
075 Rodeneck,27,,6,9,15
075 Rodeneck,28,,8,7,15
075 Rodeneck,29,,8,8,16
075 Rodeneck,30,,9,8,17
075 Rodeneck,31,,8,5,13
075 Rodeneck,32,,14,10,24
075 Rodeneck,33,,10,9,19
075 Rodeneck,34,,14,5,19
075 Rodeneck,35,,10,11,21
075 Rodeneck,36,,14,11,25
075 Rodeneck,37,,8,11,19
075 Rodeneck,38,,12,10,22
075 Rodeneck,39,,13,9,22
075 Rodeneck,40,,8,7,15
075 Rodeneck,41,,11,11,22
075 Rodeneck,42,,9,8,17
075 Rodeneck,43,,9,11,20
075 Rodeneck,44,,10,11,21
075 Rodeneck,45,,5,10,15
075 Rodeneck,46,,10,6,16
075 Rodeneck,47,,8,5,13
075 Rodeneck,48,,6,6,12
075 Rodeneck,49,,8,4,12
075 Rodeneck,50,,7,6,13
075 Rodeneck,51,,11,3,14
075 Rodeneck,52,,3,1,4
075 Rodeneck,53,,7,4,11
075 Rodeneck,54,,4,3,7
075 Rodeneck,55,,2,7,9
075 Rodeneck,56,,3,6,9
075 Rodeneck,57,,4,7,11
075 Rodeneck,58,,6,4,10
075 Rodeneck,59,,10,6,16
075 Rodeneck,60,,-,5,5
075 Rodeneck,61,,5,5,10
075 Rodeneck,62,,3,2,5
075 Rodeneck,63,,2,7,9
075 Rodeneck,64,,10,3,13
075 Rodeneck,65,,5,4,9
075 Rodeneck,66,,3,9,12
075 Rodeneck,67,,4,3,7
075 Rodeneck,68,,2,4,6
075 Rodeneck,69,,4,5,9
075 Rodeneck,70,,5,2,7
075 Rodeneck,71,,1,10,11
075 Rodeneck,72,,3,1,4
075 Rodeneck,73,,6,5,11
075 Rodeneck,74,,4,4,8
075 Rodeneck,75,,4,5,9
075 Rodeneck,76,,7,2,9
075 Rodeneck,77,,4,4,8
075 Rodeneck,78,,3,5,8
075 Rodeneck,79,,3,4,7
075 Rodeneck,80,,2,7,9
075 Rodeneck,81,,3,4,7
075 Rodeneck,82,,2,1,3
075 Rodeneck,83,,1,2,3
075 Rodeneck,84,,2,-,2
075 Rodeneck,85,,2,1,3
075 Rodeneck,86,,3,2,5
075 Rodeneck,87,,-,2,2
075 Rodeneck,90,,1,-,1
075 Rodeneck,93,,1,-,1
076 Salurn,0,,18,22,40
076 Salurn,1,,18,16,34
076 Salurn,2,,29,20,49
076 Salurn,3,,18,16,34
076 Salurn,4,,14,14,28
076 Salurn,5,,22,16,38
076 Salurn,6,,20,10,30
076 Salurn,7,,19,24,43
076 Salurn,8,,15,12,27
076 Salurn,9,,20,24,44
076 Salurn,10,,19,13,32
076 Salurn,11,,19,21,40
076 Salurn,12,,18,16,34
076 Salurn,13,,22,17,39
076 Salurn,14,,14,16,30
076 Salurn,15,,14,15,29
076 Salurn,16,,18,19,37
076 Salurn,17,,20,22,42
076 Salurn,18,,24,17,41
076 Salurn,19,,16,19,35
076 Salurn,20,,17,18,35
076 Salurn,21,,9,17,26
076 Salurn,22,,12,21,33
076 Salurn,23,,19,24,43
076 Salurn,24,,17,22,39
076 Salurn,25,,18,22,40
076 Salurn,26,,15,21,36
076 Salurn,27,,15,20,35
076 Salurn,28,,28,25,53
076 Salurn,29,,24,23,47
076 Salurn,30,,24,26,50
076 Salurn,31,,19,19,38
076 Salurn,32,,21,33,54
076 Salurn,33,,28,25,53
076 Salurn,34,,40,24,64
076 Salurn,35,,30,26,56
076 Salurn,36,,29,25,54
076 Salurn,37,,33,22,55
076 Salurn,38,,27,25,52
076 Salurn,39,,30,23,53
076 Salurn,40,,29,32,61
076 Salurn,41,,34,27,61
076 Salurn,42,,41,25,66
076 Salurn,43,,33,28,61
076 Salurn,44,,30,31,61
076 Salurn,45,,20,28,48
076 Salurn,46,,27,31,58
076 Salurn,47,,27,18,45
076 Salurn,48,,21,23,44
076 Salurn,49,,19,12,31
076 Salurn,50,,19,19,38
076 Salurn,51,,22,17,39
076 Salurn,52,,15,16,31
076 Salurn,53,,28,20,48
076 Salurn,54,,29,20,49
076 Salurn,55,,23,17,40
076 Salurn,56,,26,12,38
076 Salurn,57,,15,21,36
076 Salurn,58,,17,21,38
076 Salurn,59,,23,15,38
076 Salurn,60,,14,10,24
076 Salurn,61,,20,20,40
076 Salurn,62,,19,17,36
076 Salurn,63,,19,18,37
076 Salurn,64,,19,16,35
076 Salurn,65,,13,10,23
076 Salurn,66,,9,10,19
076 Salurn,67,,5,10,15
076 Salurn,68,,12,13,25
076 Salurn,69,,13,20,33
076 Salurn,70,,17,17,34
076 Salurn,71,,10,7,17
076 Salurn,72,,11,7,18
076 Salurn,73,,10,18,28
076 Salurn,74,,6,11,17
076 Salurn,75,,11,12,23
076 Salurn,76,,18,12,30
076 Salurn,77,,8,20,28
076 Salurn,78,,5,18,23
076 Salurn,79,,7,15,22
076 Salurn,80,,6,20,26
076 Salurn,81,,5,15,20
076 Salurn,82,,4,9,13
076 Salurn,83,,5,18,23
076 Salurn,84,,1,11,12
076 Salurn,85,,9,11,20
076 Salurn,86,,6,10,16
076 Salurn,87,,4,5,9
076 Salurn,88,,-,3,3
076 Salurn,89,,2,5,7
076 Salurn,90,,4,4,8
076 Salurn,91,,2,3,5
076 Salurn,92,,-,3,3
076 Salurn,93,,2,4,6
076 Salurn,94,,-,3,3
076 Salurn,95,,-,2,2
076 Salurn,96,,-,1,1
076 Salurn,97,,-,1,1
077 Innichen,0,,10,18,28
077 Innichen,1,,13,11,24
077 Innichen,2,,17,16,33
077 Innichen,3,,14,15,29
077 Innichen,4,,23,20,43
077 Innichen,5,,16,14,30
077 Innichen,6,,11,14,25
077 Innichen,7,,20,13,33
077 Innichen,8,,20,16,36
077 Innichen,9,,17,17,34
077 Innichen,10,,22,12,34
077 Innichen,11,,19,17,36
077 Innichen,12,,24,21,45
077 Innichen,13,,22,16,38
077 Innichen,14,,21,27,48
077 Innichen,15,,18,14,32
077 Innichen,16,,18,22,40
077 Innichen,17,,30,19,49
077 Innichen,18,,23,20,43
077 Innichen,19,,20,17,37
077 Innichen,20,,21,20,41
077 Innichen,21,,22,20,42
077 Innichen,22,,21,15,36
077 Innichen,23,,21,22,43
077 Innichen,24,,14,24,38
077 Innichen,25,,22,18,40
077 Innichen,26,,27,24,51
077 Innichen,27,,13,15,28
077 Innichen,28,,18,22,40
077 Innichen,29,,14,24,38
077 Innichen,30,,23,10,33
077 Innichen,31,,28,17,45
077 Innichen,32,,25,22,47
077 Innichen,33,,24,21,45
077 Innichen,34,,24,16,40
077 Innichen,35,,23,31,54
077 Innichen,36,,26,23,49
077 Innichen,37,,27,28,55
077 Innichen,38,,27,27,54
077 Innichen,39,,24,31,55
077 Innichen,40,,35,29,64
077 Innichen,41,,32,30,62
077 Innichen,42,,27,27,54
077 Innichen,43,,30,23,53
077 Innichen,44,,23,26,49
077 Innichen,45,,31,19,50
077 Innichen,46,,26,25,51
077 Innichen,47,,21,25,46
077 Innichen,48,,18,25,43
077 Innichen,49,,28,15,43
077 Innichen,50,,25,19,44
077 Innichen,51,,23,11,34
077 Innichen,52,,23,17,40
077 Innichen,53,,12,26,38
077 Innichen,54,,12,18,30
077 Innichen,55,,18,21,39
077 Innichen,56,,21,16,37
077 Innichen,57,,18,11,29
077 Innichen,58,,10,14,24
077 Innichen,59,,16,15,31
077 Innichen,60,,11,8,19
077 Innichen,61,,8,13,21
077 Innichen,62,,24,9,33
077 Innichen,63,,16,18,34
077 Innichen,64,,14,20,34
077 Innichen,65,,10,24,34
077 Innichen,66,,13,12,25
077 Innichen,67,,8,11,19
077 Innichen,68,,11,10,21
077 Innichen,69,,9,18,27
077 Innichen,70,,6,19,25
077 Innichen,71,,12,13,25
077 Innichen,72,,11,9,20
077 Innichen,73,,10,17,27
077 Innichen,74,,14,19,33
077 Innichen,75,,14,11,25
077 Innichen,76,,13,15,28
077 Innichen,77,,11,17,28
077 Innichen,78,,5,11,16
077 Innichen,79,,14,13,27
077 Innichen,80,,4,19,23
077 Innichen,81,,7,4,11
077 Innichen,82,,3,12,15
077 Innichen,83,,3,12,15
077 Innichen,84,,5,10,15
077 Innichen,85,,4,12,16
077 Innichen,86,,-,4,4
077 Innichen,87,,1,4,5
077 Innichen,88,,1,4,5
077 Innichen,89,,2,3,5
077 Innichen,90,,3,3,6
077 Innichen,91,,2,3,5
077 Innichen,92,,2,3,5
077 Innichen,93,,1,3,4
077 Innichen,96,,-,1,1
077 Innichen,97,,-,2,2
077 Innichen,103,,-,1,1
079 Jenesien,0,,16,14,30
079 Jenesien,1,,19,17,36
079 Jenesien,2,,17,25,42
079 Jenesien,3,,12,17,29
079 Jenesien,4,,18,23,41
079 Jenesien,5,,16,18,34
079 Jenesien,6,,25,22,47
079 Jenesien,7,,16,27,43
079 Jenesien,8,,20,19,39
079 Jenesien,9,,24,11,35
079 Jenesien,10,,25,15,40
079 Jenesien,11,,21,21,42
079 Jenesien,12,,15,19,34
079 Jenesien,13,,29,23,52
079 Jenesien,14,,19,22,41
079 Jenesien,15,,18,15,33
079 Jenesien,16,,18,13,31
079 Jenesien,17,,23,16,39
079 Jenesien,18,,15,21,36
079 Jenesien,19,,17,16,33
079 Jenesien,20,,15,6,21
079 Jenesien,21,,20,14,34
079 Jenesien,22,,18,20,38
079 Jenesien,23,,14,21,35
079 Jenesien,24,,8,17,25
079 Jenesien,25,,15,21,36
079 Jenesien,26,,22,17,39
079 Jenesien,27,,12,13,25
079 Jenesien,28,,19,21,40
079 Jenesien,29,,16,17,33
079 Jenesien,30,,13,20,33
079 Jenesien,31,,20,22,42
079 Jenesien,32,,21,28,49
079 Jenesien,33,,24,27,51
079 Jenesien,34,,29,24,53
079 Jenesien,35,,30,31,61
079 Jenesien,36,,32,19,51
079 Jenesien,37,,19,27,46
079 Jenesien,38,,19,24,43
079 Jenesien,39,,33,29,62
079 Jenesien,40,,35,30,65
079 Jenesien,41,,35,31,66
079 Jenesien,42,,26,25,51
079 Jenesien,43,,27,22,49
079 Jenesien,44,,30,21,51
079 Jenesien,45,,26,13,39
079 Jenesien,46,,24,16,40
079 Jenesien,47,,23,10,33
079 Jenesien,48,,15,18,33
079 Jenesien,49,,17,11,28
079 Jenesien,50,,10,11,21
079 Jenesien,51,,17,14,31
079 Jenesien,52,,12,11,23
079 Jenesien,53,,12,20,32
079 Jenesien,54,,13,11,24
079 Jenesien,55,,13,21,34
079 Jenesien,56,,11,12,23
079 Jenesien,57,,11,7,18
079 Jenesien,58,,15,11,26
079 Jenesien,59,,10,11,21
079 Jenesien,60,,8,13,21
079 Jenesien,61,,14,13,27
079 Jenesien,62,,18,10,28
079 Jenesien,63,,16,11,27
079 Jenesien,64,,14,20,34
079 Jenesien,65,,16,11,27
079 Jenesien,66,,15,18,33
079 Jenesien,67,,20,9,29
079 Jenesien,68,,10,16,26
079 Jenesien,69,,5,18,23
079 Jenesien,70,,6,7,13
079 Jenesien,71,,8,7,15
079 Jenesien,72,,17,12,29
079 Jenesien,73,,7,10,17
079 Jenesien,74,,9,9,18
079 Jenesien,75,,7,14,21
079 Jenesien,76,,6,15,21
079 Jenesien,77,,10,9,19
079 Jenesien,78,,6,10,16
079 Jenesien,79,,9,12,21
079 Jenesien,80,,3,12,15
079 Jenesien,81,,7,8,15
079 Jenesien,82,,4,7,11
079 Jenesien,83,,7,7,14
079 Jenesien,84,,1,5,6
079 Jenesien,85,,3,5,8
079 Jenesien,86,,1,3,4
079 Jenesien,87,,-,1,1
079 Jenesien,89,,1,1,2
079 Jenesien,90,,-,2,2
079 Jenesien,91,,1,-,1
079 Jenesien,92,,-,3,3
079 Jenesien,93,,1,1,2
079 Jenesien,94,,-,2,2
079 Jenesien,95,,-,1,1
079 Jenesien,97,,-,1,1
080 St.Leonhard in Pass.,0,,18,18,36
080 St.Leonhard in Pass.,1,,16,21,37
080 St.Leonhard in Pass.,2,,22,15,37
080 St.Leonhard in Pass.,3,,20,21,41
080 St.Leonhard in Pass.,4,,29,12,41
080 St.Leonhard in Pass.,5,,23,18,41
080 St.Leonhard in Pass.,6,,20,21,41
080 St.Leonhard in Pass.,7,,23,19,42
080 St.Leonhard in Pass.,8,,23,18,41
080 St.Leonhard in Pass.,9,,23,20,43
080 St.Leonhard in Pass.,10,,22,11,33
080 St.Leonhard in Pass.,11,,22,19,41
080 St.Leonhard in Pass.,12,,24,22,46
080 St.Leonhard in Pass.,13,,21,19,40
080 St.Leonhard in Pass.,14,,21,18,39
080 St.Leonhard in Pass.,15,,24,21,45
080 St.Leonhard in Pass.,16,,35,30,65
080 St.Leonhard in Pass.,17,,21,29,50
080 St.Leonhard in Pass.,18,,30,23,53
080 St.Leonhard in Pass.,19,,35,32,67
080 St.Leonhard in Pass.,20,,23,24,47
080 St.Leonhard in Pass.,21,,29,22,51
080 St.Leonhard in Pass.,22,,29,24,53
080 St.Leonhard in Pass.,23,,30,23,53
080 St.Leonhard in Pass.,24,,23,28,51
080 St.Leonhard in Pass.,25,,24,33,57
080 St.Leonhard in Pass.,26,,26,25,51
080 St.Leonhard in Pass.,27,,30,27,57
080 St.Leonhard in Pass.,28,,32,21,53
080 St.Leonhard in Pass.,29,,20,18,38
080 St.Leonhard in Pass.,30,,27,11,38
080 St.Leonhard in Pass.,31,,31,30,61
080 St.Leonhard in Pass.,32,,30,30,60
080 St.Leonhard in Pass.,33,,28,24,52
080 St.Leonhard in Pass.,34,,36,20,56
080 St.Leonhard in Pass.,35,,25,25,50
080 St.Leonhard in Pass.,36,,24,25,49
080 St.Leonhard in Pass.,37,,31,20,51
080 St.Leonhard in Pass.,38,,26,28,54
080 St.Leonhard in Pass.,39,,31,32,63
080 St.Leonhard in Pass.,40,,31,31,62
080 St.Leonhard in Pass.,41,,25,30,55
080 St.Leonhard in Pass.,42,,21,24,45
080 St.Leonhard in Pass.,43,,23,28,51
080 St.Leonhard in Pass.,44,,30,21,51
080 St.Leonhard in Pass.,45,,30,18,48
080 St.Leonhard in Pass.,46,,26,28,54
080 St.Leonhard in Pass.,47,,25,20,45
080 St.Leonhard in Pass.,48,,22,27,49
080 St.Leonhard in Pass.,49,,24,18,42
080 St.Leonhard in Pass.,50,,24,18,42
080 St.Leonhard in Pass.,51,,20,15,35
080 St.Leonhard in Pass.,52,,29,25,54
080 St.Leonhard in Pass.,53,,20,25,45
080 St.Leonhard in Pass.,54,,25,16,41
080 St.Leonhard in Pass.,55,,18,14,32
080 St.Leonhard in Pass.,56,,22,11,33
080 St.Leonhard in Pass.,57,,22,13,35
080 St.Leonhard in Pass.,58,,17,16,33
080 St.Leonhard in Pass.,59,,16,19,35
080 St.Leonhard in Pass.,60,,11,11,22
080 St.Leonhard in Pass.,61,,15,13,28
080 St.Leonhard in Pass.,62,,10,24,34
080 St.Leonhard in Pass.,63,,8,14,22
080 St.Leonhard in Pass.,64,,14,15,29
080 St.Leonhard in Pass.,65,,19,13,32
080 St.Leonhard in Pass.,66,,19,18,37
080 St.Leonhard in Pass.,67,,12,13,25
080 St.Leonhard in Pass.,68,,18,8,26
080 St.Leonhard in Pass.,69,,19,11,30
080 St.Leonhard in Pass.,70,,11,14,25
080 St.Leonhard in Pass.,71,,11,15,26
080 St.Leonhard in Pass.,72,,10,14,24
080 St.Leonhard in Pass.,73,,8,12,20
080 St.Leonhard in Pass.,74,,7,14,21
080 St.Leonhard in Pass.,75,,8,11,19
080 St.Leonhard in Pass.,76,,9,8,17
080 St.Leonhard in Pass.,77,,6,14,20
080 St.Leonhard in Pass.,78,,5,14,19
080 St.Leonhard in Pass.,79,,6,12,18
080 St.Leonhard in Pass.,80,,8,9,17
080 St.Leonhard in Pass.,81,,5,10,15
080 St.Leonhard in Pass.,82,,6,10,16
080 St.Leonhard in Pass.,83,,3,7,10
080 St.Leonhard in Pass.,84,,1,5,6
080 St.Leonhard in Pass.,85,,2,7,9
080 St.Leonhard in Pass.,86,,1,3,4
080 St.Leonhard in Pass.,87,,-,2,2
080 St.Leonhard in Pass.,88,,-,5,5
080 St.Leonhard in Pass.,89,,1,-,1
080 St.Leonhard in Pass.,90,,2,3,5
080 St.Leonhard in Pass.,91,,1,4,5
080 St.Leonhard in Pass.,92,,-,2,2
080 St.Leonhard in Pass.,93,,1,3,4
080 St.Leonhard in Pass.,97,,2,-,2
080 St.Leonhard in Pass.,98,,-,1,1
081 St.Lorenzen,0,,25,20,45
081 St.Lorenzen,1,,25,19,44
081 St.Lorenzen,2,,23,16,39
081 St.Lorenzen,3,,22,23,45
081 St.Lorenzen,4,,29,19,48
081 St.Lorenzen,5,,20,27,47
081 St.Lorenzen,6,,28,25,53
081 St.Lorenzen,7,,30,29,59
081 St.Lorenzen,8,,15,30,45
081 St.Lorenzen,9,,32,29,61
081 St.Lorenzen,10,,23,14,37
081 St.Lorenzen,11,,33,20,53
081 St.Lorenzen,12,,25,31,56
081 St.Lorenzen,13,,26,21,47
081 St.Lorenzen,14,,21,14,35
081 St.Lorenzen,15,,25,20,45
081 St.Lorenzen,16,,19,18,37
081 St.Lorenzen,17,,18,26,44
081 St.Lorenzen,18,,21,22,43
081 St.Lorenzen,19,,27,20,47
081 St.Lorenzen,20,,25,21,46
081 St.Lorenzen,21,,28,25,53
081 St.Lorenzen,22,,21,17,38
081 St.Lorenzen,23,,31,21,52
081 St.Lorenzen,24,,22,22,44
081 St.Lorenzen,25,,17,21,38
081 St.Lorenzen,26,,23,25,48
081 St.Lorenzen,27,,26,22,48
081 St.Lorenzen,28,,23,19,42
081 St.Lorenzen,29,,27,16,43
081 St.Lorenzen,30,,20,25,45
081 St.Lorenzen,31,,22,30,52
081 St.Lorenzen,32,,33,28,61
081 St.Lorenzen,33,,34,34,68
081 St.Lorenzen,34,,35,26,61
081 St.Lorenzen,35,,30,26,56
081 St.Lorenzen,36,,26,31,57
081 St.Lorenzen,37,,40,37,77
081 St.Lorenzen,38,,29,39,68
081 St.Lorenzen,39,,35,31,66
081 St.Lorenzen,40,,38,24,62
081 St.Lorenzen,41,,29,24,53
081 St.Lorenzen,42,,34,30,64
081 St.Lorenzen,43,,26,34,60
081 St.Lorenzen,44,,24,38,62
081 St.Lorenzen,45,,31,19,50
081 St.Lorenzen,46,,33,27,60
081 St.Lorenzen,47,,31,32,63
081 St.Lorenzen,48,,24,26,50
081 St.Lorenzen,49,,27,28,55
081 St.Lorenzen,50,,17,17,34
081 St.Lorenzen,51,,18,19,37
081 St.Lorenzen,52,,23,16,39
081 St.Lorenzen,53,,17,10,27
081 St.Lorenzen,54,,18,17,35
081 St.Lorenzen,55,,15,18,33
081 St.Lorenzen,56,,12,22,34
081 St.Lorenzen,57,,14,14,28
081 St.Lorenzen,58,,20,10,30
081 St.Lorenzen,59,,19,11,30
081 St.Lorenzen,60,,13,18,31
081 St.Lorenzen,61,,16,15,31
081 St.Lorenzen,62,,14,16,30
081 St.Lorenzen,63,,17,24,41
081 St.Lorenzen,64,,19,17,36
081 St.Lorenzen,65,,15,12,27
081 St.Lorenzen,66,,15,17,32
081 St.Lorenzen,67,,14,14,28
081 St.Lorenzen,68,,17,15,32
081 St.Lorenzen,69,,13,15,28
081 St.Lorenzen,70,,9,14,23
081 St.Lorenzen,71,,14,12,26
081 St.Lorenzen,72,,11,11,22
081 St.Lorenzen,73,,12,12,24
081 St.Lorenzen,74,,11,15,26
081 St.Lorenzen,75,,10,9,19
081 St.Lorenzen,76,,10,16,26
081 St.Lorenzen,77,,10,15,25
081 St.Lorenzen,78,,9,8,17
081 St.Lorenzen,79,,8,9,17
081 St.Lorenzen,80,,5,14,19
081 St.Lorenzen,81,,2,9,11
081 St.Lorenzen,82,,7,12,19
081 St.Lorenzen,83,,3,4,7
081 St.Lorenzen,84,,4,5,9
081 St.Lorenzen,85,,1,5,6
081 St.Lorenzen,86,,4,6,10
081 St.Lorenzen,87,,2,4,6
081 St.Lorenzen,88,,-,1,1
081 St.Lorenzen,89,,1,-,1
081 St.Lorenzen,91,,3,2,5
081 St.Lorenzen,92,,1,1,2
081 St.Lorenzen,93,,1,-,1
081 St.Lorenzen,94,,-,1,1
081 St.Lorenzen,95,,-,1,1
081 St.Lorenzen,103,,-,1,1
082 St.Martin in Thurn,0,,13,11,24
082 St.Martin in Thurn,1,,21,12,33
082 St.Martin in Thurn,2,,4,6,10
082 St.Martin in Thurn,3,,17,9,26
082 St.Martin in Thurn,4,,8,13,21
082 St.Martin in Thurn,5,,7,9,16
082 St.Martin in Thurn,6,,8,20,28
082 St.Martin in Thurn,7,,11,11,22
082 St.Martin in Thurn,8,,17,11,28
082 St.Martin in Thurn,9,,24,14,38
082 St.Martin in Thurn,10,,15,11,26
082 St.Martin in Thurn,11,,15,8,23
082 St.Martin in Thurn,12,,9,9,18
082 St.Martin in Thurn,13,,17,14,31
082 St.Martin in Thurn,14,,11,11,22
082 St.Martin in Thurn,15,,6,17,23
082 St.Martin in Thurn,16,,15,15,30
082 St.Martin in Thurn,17,,8,6,14
082 St.Martin in Thurn,18,,14,12,26
082 St.Martin in Thurn,19,,13,10,23
082 St.Martin in Thurn,20,,11,15,26
082 St.Martin in Thurn,21,,8,5,13
082 St.Martin in Thurn,22,,15,10,25
082 St.Martin in Thurn,23,,15,14,29
082 St.Martin in Thurn,24,,16,7,23
082 St.Martin in Thurn,25,,9,15,24
082 St.Martin in Thurn,26,,9,11,20
082 St.Martin in Thurn,27,,17,12,29
082 St.Martin in Thurn,28,,14,10,24
082 St.Martin in Thurn,29,,13,11,24
082 St.Martin in Thurn,30,,7,11,18
082 St.Martin in Thurn,31,,6,9,15
082 St.Martin in Thurn,32,,11,10,21
082 St.Martin in Thurn,33,,13,9,22
082 St.Martin in Thurn,34,,16,13,29
082 St.Martin in Thurn,35,,12,14,26
082 St.Martin in Thurn,36,,16,15,31
082 St.Martin in Thurn,37,,13,15,28
082 St.Martin in Thurn,38,,10,10,20
082 St.Martin in Thurn,39,,15,24,39
082 St.Martin in Thurn,40,,16,20,36
082 St.Martin in Thurn,41,,12,16,28
082 St.Martin in Thurn,42,,15,14,29
082 St.Martin in Thurn,43,,16,15,31
082 St.Martin in Thurn,44,,15,21,36
082 St.Martin in Thurn,45,,15,5,20
082 St.Martin in Thurn,46,,12,10,22
082 St.Martin in Thurn,47,,12,8,20
082 St.Martin in Thurn,48,,12,9,21
082 St.Martin in Thurn,49,,7,6,13
082 St.Martin in Thurn,50,,13,9,22
082 St.Martin in Thurn,51,,8,8,16
082 St.Martin in Thurn,52,,5,12,17
082 St.Martin in Thurn,53,,3,4,7
082 St.Martin in Thurn,54,,8,8,16
082 St.Martin in Thurn,55,,11,6,17
082 St.Martin in Thurn,56,,3,7,10
082 St.Martin in Thurn,57,,10,6,16
082 St.Martin in Thurn,58,,9,6,15
082 St.Martin in Thurn,59,,8,7,15
082 St.Martin in Thurn,60,,6,4,10
082 St.Martin in Thurn,61,,11,8,19
082 St.Martin in Thurn,62,,4,8,12
082 St.Martin in Thurn,63,,7,6,13
082 St.Martin in Thurn,64,,7,6,13
082 St.Martin in Thurn,65,,5,5,10
082 St.Martin in Thurn,66,,5,8,13
082 St.Martin in Thurn,67,,9,8,17
082 St.Martin in Thurn,68,,7,13,20
082 St.Martin in Thurn,69,,4,6,10
082 St.Martin in Thurn,70,,6,5,11
082 St.Martin in Thurn,71,,5,4,9
082 St.Martin in Thurn,72,,3,9,12
082 St.Martin in Thurn,73,,8,7,15
082 St.Martin in Thurn,74,,9,8,17
082 St.Martin in Thurn,75,,6,6,12
082 St.Martin in Thurn,76,,6,7,13
082 St.Martin in Thurn,77,,3,3,6
082 St.Martin in Thurn,78,,5,5,10
082 St.Martin in Thurn,79,,7,3,10
082 St.Martin in Thurn,80,,6,4,10
082 St.Martin in Thurn,81,,7,8,15
082 St.Martin in Thurn,82,,3,9,12
082 St.Martin in Thurn,83,,7,5,12
082 St.Martin in Thurn,84,,5,2,7
082 St.Martin in Thurn,85,,5,7,12
082 St.Martin in Thurn,86,,2,4,6
082 St.Martin in Thurn,87,,1,-,1
082 St.Martin in Thurn,88,,-,2,2
082 St.Martin in Thurn,89,,1,1,2
082 St.Martin in Thurn,90,,1,1,2
082 St.Martin in Thurn,91,,-,2,2
082 St.Martin in Thurn,92,,-,1,1
082 St.Martin in Thurn,93,,1,-,1
082 St.Martin in Thurn,94,,1,-,1
082 St.Martin in Thurn,101,,1,-,1
083 St.Martin in Passeier,0,,22,22,44
083 St.Martin in Passeier,1,,20,20,40
083 St.Martin in Passeier,2,,21,18,39
083 St.Martin in Passeier,3,,18,13,31
083 St.Martin in Passeier,4,,18,17,35
083 St.Martin in Passeier,5,,14,21,35
083 St.Martin in Passeier,6,,9,20,29
083 St.Martin in Passeier,7,,20,19,39
083 St.Martin in Passeier,8,,28,25,53
083 St.Martin in Passeier,9,,22,21,43
083 St.Martin in Passeier,10,,19,18,37
083 St.Martin in Passeier,11,,20,23,43
083 St.Martin in Passeier,12,,20,23,43
083 St.Martin in Passeier,13,,22,20,42
083 St.Martin in Passeier,14,,21,25,46
083 St.Martin in Passeier,15,,19,25,44
083 St.Martin in Passeier,16,,19,21,40
083 St.Martin in Passeier,17,,15,15,30
083 St.Martin in Passeier,18,,18,23,41
083 St.Martin in Passeier,19,,22,24,46
083 St.Martin in Passeier,20,,17,19,36
083 St.Martin in Passeier,21,,17,24,41
083 St.Martin in Passeier,22,,17,10,27
083 St.Martin in Passeier,23,,20,20,40
083 St.Martin in Passeier,24,,22,20,42
083 St.Martin in Passeier,25,,20,24,44
083 St.Martin in Passeier,26,,22,11,33
083 St.Martin in Passeier,27,,29,17,46
083 St.Martin in Passeier,28,,22,26,48
083 St.Martin in Passeier,29,,21,24,45
083 St.Martin in Passeier,30,,26,23,49
083 St.Martin in Passeier,31,,21,21,42
083 St.Martin in Passeier,32,,28,27,55
083 St.Martin in Passeier,33,,24,27,51
083 St.Martin in Passeier,34,,28,25,53
083 St.Martin in Passeier,35,,29,25,54
083 St.Martin in Passeier,36,,30,25,55
083 St.Martin in Passeier,37,,24,23,47
083 St.Martin in Passeier,38,,22,25,47
083 St.Martin in Passeier,39,,26,31,57
083 St.Martin in Passeier,40,,32,25,57
083 St.Martin in Passeier,41,,20,20,40
083 St.Martin in Passeier,42,,34,20,54
083 St.Martin in Passeier,43,,23,30,53
083 St.Martin in Passeier,44,,35,22,57
083 St.Martin in Passeier,45,,22,23,45
083 St.Martin in Passeier,46,,25,22,47
083 St.Martin in Passeier,47,,23,20,43
083 St.Martin in Passeier,48,,25,12,37
083 St.Martin in Passeier,49,,22,15,37
083 St.Martin in Passeier,50,,31,14,45
083 St.Martin in Passeier,51,,15,10,25
083 St.Martin in Passeier,52,,21,16,37
083 St.Martin in Passeier,53,,5,19,24
083 St.Martin in Passeier,54,,21,14,35
083 St.Martin in Passeier,55,,10,15,25
083 St.Martin in Passeier,56,,14,9,23
083 St.Martin in Passeier,57,,12,10,22
083 St.Martin in Passeier,58,,14,13,27
083 St.Martin in Passeier,59,,13,11,24
083 St.Martin in Passeier,60,,13,12,25
083 St.Martin in Passeier,61,,18,12,30
083 St.Martin in Passeier,62,,14,11,25
083 St.Martin in Passeier,63,,15,14,29
083 St.Martin in Passeier,64,,10,15,25
083 St.Martin in Passeier,65,,4,12,16
083 St.Martin in Passeier,66,,6,13,19
083 St.Martin in Passeier,67,,12,8,20
083 St.Martin in Passeier,68,,14,19,33
083 St.Martin in Passeier,69,,14,14,28
083 St.Martin in Passeier,70,,7,13,20
083 St.Martin in Passeier,71,,16,9,25
083 St.Martin in Passeier,72,,13,9,22
083 St.Martin in Passeier,73,,8,9,17
083 St.Martin in Passeier,74,,7,12,19
083 St.Martin in Passeier,75,,4,12,16
083 St.Martin in Passeier,76,,11,9,20
083 St.Martin in Passeier,77,,7,7,14
083 St.Martin in Passeier,78,,11,5,16
083 St.Martin in Passeier,79,,3,11,14
083 St.Martin in Passeier,80,,5,8,13
083 St.Martin in Passeier,81,,3,12,15
083 St.Martin in Passeier,82,,1,7,8
083 St.Martin in Passeier,83,,4,5,9
083 St.Martin in Passeier,84,,4,11,15
083 St.Martin in Passeier,85,,1,4,5
083 St.Martin in Passeier,86,,1,3,4
083 St.Martin in Passeier,87,,-,2,2
083 St.Martin in Passeier,88,,-,4,4
083 St.Martin in Passeier,89,,-,1,1
083 St.Martin in Passeier,90,,1,1,2
083 St.Martin in Passeier,91,,1,2,3
083 St.Martin in Passeier,92,,-,1,1
083 St.Martin in Passeier,94,,1,-,1
084 St.Pankraz,0,,12,8,20
084 St.Pankraz,1,,13,8,21
084 St.Pankraz,2,,12,6,18
084 St.Pankraz,3,,8,4,12
084 St.Pankraz,4,,13,15,28
084 St.Pankraz,5,,11,15,26
084 St.Pankraz,6,,9,5,14
084 St.Pankraz,7,,13,6,19
084 St.Pankraz,8,,9,11,20
084 St.Pankraz,9,,10,8,18
084 St.Pankraz,10,,10,5,15
084 St.Pankraz,11,,8,9,17
084 St.Pankraz,12,,5,12,17
084 St.Pankraz,13,,6,8,14
084 St.Pankraz,14,,12,12,24
084 St.Pankraz,15,,9,3,12
084 St.Pankraz,16,,11,14,25
084 St.Pankraz,17,,14,8,22
084 St.Pankraz,18,,10,6,16
084 St.Pankraz,19,,9,6,15
084 St.Pankraz,20,,9,7,16
084 St.Pankraz,21,,9,5,14
084 St.Pankraz,22,,11,6,17
084 St.Pankraz,23,,12,8,20
084 St.Pankraz,24,,11,13,24
084 St.Pankraz,25,,14,10,24
084 St.Pankraz,26,,4,5,9
084 St.Pankraz,27,,14,9,23
084 St.Pankraz,28,,8,9,17
084 St.Pankraz,29,,5,10,15
084 St.Pankraz,30,,10,8,18
084 St.Pankraz,31,,14,11,25
084 St.Pankraz,32,,11,8,19
084 St.Pankraz,33,,11,16,27
084 St.Pankraz,34,,17,10,27
084 St.Pankraz,35,,12,11,23
084 St.Pankraz,36,,17,12,29
084 St.Pankraz,37,,18,17,35
084 St.Pankraz,38,,10,14,24
084 St.Pankraz,39,,14,5,19
084 St.Pankraz,40,,22,14,36
084 St.Pankraz,41,,14,15,29
084 St.Pankraz,42,,9,10,19
084 St.Pankraz,43,,17,7,24
084 St.Pankraz,44,,15,13,28
084 St.Pankraz,45,,13,5,18
084 St.Pankraz,46,,15,11,26
084 St.Pankraz,47,,6,9,15
084 St.Pankraz,48,,12,9,21
084 St.Pankraz,49,,10,15,25
084 St.Pankraz,50,,6,4,10
084 St.Pankraz,51,,10,8,18
084 St.Pankraz,52,,11,9,20
084 St.Pankraz,53,,15,10,25
084 St.Pankraz,54,,5,3,8
084 St.Pankraz,55,,11,6,17
084 St.Pankraz,56,,8,6,14
084 St.Pankraz,57,,8,3,11
084 St.Pankraz,58,,7,8,15
084 St.Pankraz,59,,4,7,11
084 St.Pankraz,60,,3,6,9
084 St.Pankraz,61,,5,7,12
084 St.Pankraz,62,,10,15,25
084 St.Pankraz,63,,9,15,24
084 St.Pankraz,64,,8,12,20
084 St.Pankraz,65,,8,6,14
084 St.Pankraz,66,,9,7,16
084 St.Pankraz,67,,5,11,16
084 St.Pankraz,68,,9,9,18
084 St.Pankraz,69,,5,5,10
084 St.Pankraz,70,,4,4,8
084 St.Pankraz,71,,6,7,13
084 St.Pankraz,72,,8,3,11
084 St.Pankraz,73,,7,10,17
084 St.Pankraz,74,,9,4,13
084 St.Pankraz,75,,7,7,14
084 St.Pankraz,76,,7,10,17
084 St.Pankraz,77,,7,9,16
084 St.Pankraz,78,,7,4,11
084 St.Pankraz,79,,6,6,12
084 St.Pankraz,80,,6,8,14
084 St.Pankraz,81,,5,7,12
084 St.Pankraz,82,,10,3,13
084 St.Pankraz,83,,8,7,15
084 St.Pankraz,84,,2,6,8
084 St.Pankraz,85,,1,8,9
084 St.Pankraz,86,,2,1,3
084 St.Pankraz,87,,1,2,3
084 St.Pankraz,88,,-,1,1
084 St.Pankraz,89,,1,-,1
084 St.Pankraz,90,,1,2,3
084 St.Pankraz,91,,-,1,1
084 St.Pankraz,92,,1,1,2
084 St.Pankraz,93,,1,1,2
084 St.Pankraz,95,,-,1,1
084 St.Pankraz,96,,-,2,2
085 St.Christina in Gröden,0,,16,11,27
085 St.Christina in Gröden,1,,13,15,28
085 St.Christina in Gröden,2,,9,8,17
085 St.Christina in Gröden,3,,12,11,23
085 St.Christina in Gröden,4,,10,13,23
085 St.Christina in Gröden,5,,20,12,32
085 St.Christina in Gröden,6,,18,11,29
085 St.Christina in Gröden,7,,12,15,27
085 St.Christina in Gröden,8,,12,11,23
085 St.Christina in Gröden,9,,11,5,16
085 St.Christina in Gröden,10,,16,9,25
085 St.Christina in Gröden,11,,7,15,22
085 St.Christina in Gröden,12,,13,13,26
085 St.Christina in Gröden,13,,13,13,26
085 St.Christina in Gröden,14,,13,17,30
085 St.Christina in Gröden,15,,8,13,21
085 St.Christina in Gröden,16,,5,8,13
085 St.Christina in Gröden,17,,9,11,20
085 St.Christina in Gröden,18,,12,6,18
085 St.Christina in Gröden,19,,12,9,21
085 St.Christina in Gröden,20,,5,11,16
085 St.Christina in Gröden,21,,11,6,17
085 St.Christina in Gröden,22,,17,13,30
085 St.Christina in Gröden,23,,12,5,17
085 St.Christina in Gröden,24,,8,13,21
085 St.Christina in Gröden,25,,10,15,25
085 St.Christina in Gröden,26,,14,8,22
085 St.Christina in Gröden,27,,4,12,16
085 St.Christina in Gröden,28,,6,9,15
085 St.Christina in Gröden,29,,14,9,23
085 St.Christina in Gröden,30,,14,13,27
085 St.Christina in Gröden,31,,10,19,29
085 St.Christina in Gröden,32,,9,14,23
085 St.Christina in Gröden,33,,17,12,29
085 St.Christina in Gröden,34,,12,16,28
085 St.Christina in Gröden,35,,20,19,39
085 St.Christina in Gröden,36,,20,12,32
085 St.Christina in Gröden,37,,22,22,44
085 St.Christina in Gröden,38,,16,15,31
085 St.Christina in Gröden,39,,18,9,27
085 St.Christina in Gröden,40,,14,16,30
085 St.Christina in Gröden,41,,11,23,34
085 St.Christina in Gröden,42,,14,16,30
085 St.Christina in Gröden,43,,22,14,36
085 St.Christina in Gröden,44,,23,15,38
085 St.Christina in Gröden,45,,22,18,40
085 St.Christina in Gröden,46,,10,8,18
085 St.Christina in Gröden,47,,9,11,20
085 St.Christina in Gröden,48,,16,11,27
085 St.Christina in Gröden,49,,12,10,22
085 St.Christina in Gröden,50,,9,9,18
085 St.Christina in Gröden,51,,14,14,28
085 St.Christina in Gröden,52,,9,9,18
085 St.Christina in Gröden,53,,5,7,12
085 St.Christina in Gröden,54,,11,5,16
085 St.Christina in Gröden,55,,6,5,11
085 St.Christina in Gröden,56,,8,12,20
085 St.Christina in Gröden,57,,8,5,13
085 St.Christina in Gröden,58,,5,7,12
085 St.Christina in Gröden,59,,9,10,19
085 St.Christina in Gröden,60,,6,6,12
085 St.Christina in Gröden,61,,5,11,16
085 St.Christina in Gröden,62,,11,15,26
085 St.Christina in Gröden,63,,10,6,16
085 St.Christina in Gröden,64,,12,8,20
085 St.Christina in Gröden,65,,9,11,20
085 St.Christina in Gröden,66,,10,11,21
085 St.Christina in Gröden,67,,7,8,15
085 St.Christina in Gröden,68,,9,4,13
085 St.Christina in Gröden,69,,12,10,22
085 St.Christina in Gröden,70,,13,5,18
085 St.Christina in Gröden,71,,7,12,19
085 St.Christina in Gröden,72,,5,12,17
085 St.Christina in Gröden,73,,7,8,15
085 St.Christina in Gröden,74,,4,7,11
085 St.Christina in Gröden,75,,13,4,17
085 St.Christina in Gröden,76,,2,9,11
085 St.Christina in Gröden,77,,5,4,9
085 St.Christina in Gröden,78,,5,6,11
085 St.Christina in Gröden,79,,8,6,14
085 St.Christina in Gröden,80,,4,8,12
085 St.Christina in Gröden,81,,2,2,4
085 St.Christina in Gröden,82,,3,4,7
085 St.Christina in Gröden,83,,-,10,10
085 St.Christina in Gröden,84,,1,3,4
085 St.Christina in Gröden,85,,1,3,4
085 St.Christina in Gröden,86,,3,1,4
085 St.Christina in Gröden,89,,-,2,2
085 St.Christina in Gröden,90,,2,1,3
085 St.Christina in Gröden,91,,-,1,1
085 St.Christina in Gröden,92,,2,-,2
085 St.Christina in Gröden,93,,-,1,1
086 Sarntal,0,,34,35,69
086 Sarntal,1,,42,37,79
086 Sarntal,2,,48,33,81
086 Sarntal,3,,30,43,73
086 Sarntal,4,,49,27,76
086 Sarntal,5,,37,40,77
086 Sarntal,6,,34,35,69
086 Sarntal,7,,51,41,92
086 Sarntal,8,,46,46,92
086 Sarntal,9,,48,41,89
086 Sarntal,10,,44,42,86
086 Sarntal,11,,34,41,75
086 Sarntal,12,,33,39,72
086 Sarntal,13,,45,36,81
086 Sarntal,14,,43,42,85
086 Sarntal,15,,45,33,78
086 Sarntal,16,,54,36,90
086 Sarntal,17,,43,42,85
086 Sarntal,18,,36,31,67
086 Sarntal,19,,37,42,79
086 Sarntal,20,,44,38,82
086 Sarntal,21,,38,40,78
086 Sarntal,22,,55,40,95
086 Sarntal,23,,60,48,108
086 Sarntal,24,,42,54,96
086 Sarntal,25,,60,47,107
086 Sarntal,26,,59,50,109
086 Sarntal,27,,55,57,112
086 Sarntal,28,,59,40,99
086 Sarntal,29,,48,39,87
086 Sarntal,30,,61,48,109
086 Sarntal,31,,51,62,113
086 Sarntal,32,,61,62,123
086 Sarntal,33,,71,39,110
086 Sarntal,34,,44,49,93
086 Sarntal,35,,66,58,124
086 Sarntal,36,,63,54,117
086 Sarntal,37,,52,45,97
086 Sarntal,38,,54,47,101
086 Sarntal,39,,54,51,105
086 Sarntal,40,,69,53,122
086 Sarntal,41,,57,61,118
086 Sarntal,42,,44,43,87
086 Sarntal,43,,64,34,98
086 Sarntal,44,,38,46,84
086 Sarntal,45,,64,46,110
086 Sarntal,46,,43,42,85
086 Sarntal,47,,53,43,96
086 Sarntal,48,,38,43,81
086 Sarntal,49,,40,31,71
086 Sarntal,50,,40,40,80
086 Sarntal,51,,36,29,65
086 Sarntal,52,,40,30,70
086 Sarntal,53,,35,41,76
086 Sarntal,54,,46,34,80
086 Sarntal,55,,38,34,72
086 Sarntal,56,,50,24,74
086 Sarntal,57,,33,39,72
086 Sarntal,58,,39,28,67
086 Sarntal,59,,36,36,72
086 Sarntal,60,,29,32,61
086 Sarntal,61,,29,31,60
086 Sarntal,62,,39,40,79
086 Sarntal,63,,39,38,77
086 Sarntal,64,,34,30,64
086 Sarntal,65,,29,44,73
086 Sarntal,66,,38,32,70
086 Sarntal,67,,33,27,60
086 Sarntal,68,,24,33,57
086 Sarntal,69,,19,24,43
086 Sarntal,70,,23,25,48
086 Sarntal,71,,26,19,45
086 Sarntal,72,,21,25,46
086 Sarntal,73,,25,24,49
086 Sarntal,74,,18,25,43
086 Sarntal,75,,17,25,42
086 Sarntal,76,,18,30,48
086 Sarntal,77,,20,26,46
086 Sarntal,78,,13,31,44
086 Sarntal,79,,16,14,30
086 Sarntal,80,,17,18,35
086 Sarntal,81,,11,21,32
086 Sarntal,82,,8,20,28
086 Sarntal,83,,10,29,39
086 Sarntal,84,,5,10,15
086 Sarntal,85,,9,15,24
086 Sarntal,86,,3,15,18
086 Sarntal,87,,1,9,10
086 Sarntal,88,,3,7,10
086 Sarntal,89,,-,3,3
086 Sarntal,90,,1,3,4
086 Sarntal,91,,1,3,4
086 Sarntal,92,,6,4,10
086 Sarntal,93,,2,6,8
086 Sarntal,94,,-,1,1
086 Sarntal,95,,-,2,2
086 Sarntal,96,,-,1,1
086 Sarntal,98,,1,2,3
087 Schenna,0,,11,14,25
087 Schenna,1,,19,17,36
087 Schenna,2,,12,13,25
087 Schenna,3,,15,19,34
087 Schenna,4,,19,16,35
087 Schenna,5,,19,21,40
087 Schenna,6,,23,18,41
087 Schenna,7,,16,12,28
087 Schenna,8,,12,19,31
087 Schenna,9,,16,17,33
087 Schenna,10,,19,18,37
087 Schenna,11,,20,16,36
087 Schenna,12,,13,8,21
087 Schenna,13,,17,16,33
087 Schenna,14,,12,20,32
087 Schenna,15,,19,16,35
087 Schenna,16,,20,10,30
087 Schenna,17,,21,19,40
087 Schenna,18,,22,17,39
087 Schenna,19,,19,12,31
087 Schenna,20,,16,18,34
087 Schenna,21,,14,15,29
087 Schenna,22,,16,11,27
087 Schenna,23,,12,13,25
087 Schenna,24,,21,8,29
087 Schenna,25,,18,18,36
087 Schenna,26,,23,19,42
087 Schenna,27,,14,19,33
087 Schenna,28,,18,24,42
087 Schenna,29,,21,17,38
087 Schenna,30,,17,29,46
087 Schenna,31,,35,20,55
087 Schenna,32,,26,22,48
087 Schenna,33,,26,17,43
087 Schenna,34,,27,27,54
087 Schenna,35,,22,26,48
087 Schenna,36,,26,21,47
087 Schenna,37,,24,20,44
087 Schenna,38,,31,21,52
087 Schenna,39,,16,19,35
087 Schenna,40,,25,27,52
087 Schenna,41,,22,24,46
087 Schenna,42,,27,19,46
087 Schenna,43,,20,12,32
087 Schenna,44,,28,23,51
087 Schenna,45,,32,24,56
087 Schenna,46,,14,12,26
087 Schenna,47,,21,19,40
087 Schenna,48,,14,19,33
087 Schenna,49,,18,17,35
087 Schenna,50,,11,16,27
087 Schenna,51,,14,17,31
087 Schenna,52,,15,15,30
087 Schenna,53,,13,16,29
087 Schenna,54,,14,13,27
087 Schenna,55,,18,14,32
087 Schenna,56,,20,18,38
087 Schenna,57,,15,15,30
087 Schenna,58,,16,18,34
087 Schenna,59,,18,21,39
087 Schenna,60,,16,13,29
087 Schenna,61,,17,9,26
087 Schenna,62,,19,12,31
087 Schenna,63,,9,19,28
087 Schenna,64,,12,13,25
087 Schenna,65,,10,10,20
087 Schenna,66,,11,14,25
087 Schenna,67,,16,19,35
087 Schenna,68,,7,10,17
087 Schenna,69,,8,11,19
087 Schenna,70,,13,11,24
087 Schenna,71,,12,15,27
087 Schenna,72,,8,9,17
087 Schenna,73,,10,11,21
087 Schenna,74,,11,10,21
087 Schenna,75,,11,7,18
087 Schenna,76,,6,10,16
087 Schenna,77,,7,10,17
087 Schenna,78,,5,13,18
087 Schenna,79,,5,7,12
087 Schenna,80,,1,9,10
087 Schenna,81,,8,8,16
087 Schenna,82,,3,4,7
087 Schenna,83,,8,5,13
087 Schenna,84,,6,9,15
087 Schenna,85,,4,4,8
087 Schenna,86,,1,4,5
087 Schenna,87,,-,2,2
087 Schenna,88,,1,1,2
087 Schenna,89,,1,1,2
087 Schenna,90,,1,1,2
087 Schenna,91,,2,-,2
087 Schenna,92,,-,2,2
087 Schenna,93,,3,2,5
087 Schenna,95,,-,1,1
087 Schenna,96,,-,1,1
087 Schenna,99,,1,-,1
088 Mühlwald,0,,7,6,13
088 Mühlwald,1,,9,10,19
088 Mühlwald,2,,15,10,25
088 Mühlwald,3,,8,12,20
088 Mühlwald,4,,9,13,22
088 Mühlwald,5,,8,11,19
088 Mühlwald,6,,12,9,21
088 Mühlwald,7,,12,14,26
088 Mühlwald,8,,11,8,19
088 Mühlwald,9,,14,12,26
088 Mühlwald,10,,13,4,17
088 Mühlwald,11,,9,6,15
088 Mühlwald,12,,14,12,26
088 Mühlwald,13,,5,5,10
088 Mühlwald,14,,11,7,18
088 Mühlwald,15,,9,6,15
088 Mühlwald,16,,16,9,25
088 Mühlwald,17,,8,3,11
088 Mühlwald,18,,9,14,23
088 Mühlwald,19,,7,7,14
088 Mühlwald,20,,11,19,30
088 Mühlwald,21,,12,17,29
088 Mühlwald,22,,11,9,20
088 Mühlwald,23,,8,14,22
088 Mühlwald,24,,16,12,28
088 Mühlwald,25,,21,4,25
088 Mühlwald,26,,7,17,24
088 Mühlwald,27,,12,8,20
088 Mühlwald,28,,8,7,15
088 Mühlwald,29,,12,10,22
088 Mühlwald,30,,11,9,20
088 Mühlwald,31,,10,4,14
088 Mühlwald,32,,16,8,24
088 Mühlwald,33,,10,9,19
088 Mühlwald,34,,16,14,30
088 Mühlwald,35,,8,11,19
088 Mühlwald,36,,13,16,29
088 Mühlwald,37,,16,10,26
088 Mühlwald,38,,18,14,32
088 Mühlwald,39,,13,8,21
088 Mühlwald,40,,17,14,31
088 Mühlwald,41,,16,10,26
088 Mühlwald,42,,11,11,22
088 Mühlwald,43,,8,12,20
088 Mühlwald,44,,6,10,16
088 Mühlwald,45,,14,9,23
088 Mühlwald,46,,15,5,20
088 Mühlwald,47,,9,6,15
088 Mühlwald,48,,13,12,25
088 Mühlwald,49,,8,8,16
088 Mühlwald,50,,7,8,15
088 Mühlwald,51,,9,4,13
088 Mühlwald,52,,10,9,19
088 Mühlwald,53,,10,7,17
088 Mühlwald,54,,9,4,13
088 Mühlwald,55,,5,9,14
088 Mühlwald,56,,9,3,12
088 Mühlwald,57,,12,4,16
088 Mühlwald,58,,10,7,17
088 Mühlwald,59,,8,3,11
088 Mühlwald,60,,4,4,8
088 Mühlwald,61,,8,4,12
088 Mühlwald,62,,10,2,12
088 Mühlwald,63,,6,7,13
088 Mühlwald,64,,4,7,11
088 Mühlwald,65,,3,9,12
088 Mühlwald,66,,6,11,17
088 Mühlwald,67,,9,4,13
088 Mühlwald,68,,11,3,14
088 Mühlwald,69,,4,3,7
088 Mühlwald,70,,6,3,9
088 Mühlwald,71,,4,6,10
088 Mühlwald,72,,4,10,14
088 Mühlwald,73,,1,2,3
088 Mühlwald,74,,5,5,10
088 Mühlwald,75,,3,5,8
088 Mühlwald,76,,7,8,15
088 Mühlwald,77,,4,4,8
088 Mühlwald,78,,7,2,9
088 Mühlwald,79,,3,5,8
088 Mühlwald,80,,3,3,6
088 Mühlwald,81,,6,3,9
088 Mühlwald,82,,1,4,5
088 Mühlwald,83,,-,3,3
088 Mühlwald,84,,-,5,5
088 Mühlwald,85,,1,-,1
088 Mühlwald,86,,-,1,1
088 Mühlwald,87,,-,2,2
088 Mühlwald,88,,3,1,4
088 Mühlwald,89,,-,1,1
088 Mühlwald,90,,-,1,1
088 Mühlwald,91,,1,-,1
088 Mühlwald,92,,-,1,1
088 Mühlwald,94,,-,1,1
088 Mühlwald,97,,1,-,1
089 Wolkenstein in Gröden,0,,12,19,31
089 Wolkenstein in Gröden,1,,13,10,23
089 Wolkenstein in Gröden,2,,13,17,30
089 Wolkenstein in Gröden,3,,24,18,42
089 Wolkenstein in Gröden,4,,22,19,41
089 Wolkenstein in Gröden,5,,20,22,42
089 Wolkenstein in Gröden,6,,12,17,29
089 Wolkenstein in Gröden,7,,14,23,37
089 Wolkenstein in Gröden,8,,22,30,52
089 Wolkenstein in Gröden,9,,15,13,28
089 Wolkenstein in Gröden,10,,17,12,29
089 Wolkenstein in Gröden,11,,15,18,33
089 Wolkenstein in Gröden,12,,13,15,28
089 Wolkenstein in Gröden,13,,24,14,38
089 Wolkenstein in Gröden,14,,19,17,36
089 Wolkenstein in Gröden,15,,12,12,24
089 Wolkenstein in Gröden,16,,16,13,29
089 Wolkenstein in Gröden,17,,18,17,35
089 Wolkenstein in Gröden,18,,11,20,31
089 Wolkenstein in Gröden,19,,17,14,31
089 Wolkenstein in Gröden,20,,16,11,27
089 Wolkenstein in Gröden,21,,13,11,24
089 Wolkenstein in Gröden,22,,15,10,25
089 Wolkenstein in Gröden,23,,10,18,28
089 Wolkenstein in Gröden,24,,17,11,28
089 Wolkenstein in Gröden,25,,16,12,28
089 Wolkenstein in Gröden,26,,7,15,22
089 Wolkenstein in Gröden,27,,7,7,14
089 Wolkenstein in Gröden,28,,11,9,20
089 Wolkenstein in Gröden,29,,14,11,25
089 Wolkenstein in Gröden,30,,22,20,42
089 Wolkenstein in Gröden,31,,10,18,28
089 Wolkenstein in Gröden,32,,25,20,45
089 Wolkenstein in Gröden,33,,19,19,38
089 Wolkenstein in Gröden,34,,20,25,45
089 Wolkenstein in Gröden,35,,23,28,51
089 Wolkenstein in Gröden,36,,27,18,45
089 Wolkenstein in Gröden,37,,27,25,52
089 Wolkenstein in Gröden,38,,32,27,59
089 Wolkenstein in Gröden,39,,26,23,49
089 Wolkenstein in Gröden,40,,25,33,58
089 Wolkenstein in Gröden,41,,30,21,51
089 Wolkenstein in Gröden,42,,23,21,44
089 Wolkenstein in Gröden,43,,20,22,42
089 Wolkenstein in Gröden,44,,24,27,51
089 Wolkenstein in Gröden,45,,23,22,45
089 Wolkenstein in Gröden,46,,14,16,30
089 Wolkenstein in Gröden,47,,17,16,33
089 Wolkenstein in Gröden,48,,21,17,38
089 Wolkenstein in Gröden,49,,11,14,25
089 Wolkenstein in Gröden,50,,14,10,24
089 Wolkenstein in Gröden,51,,15,9,24
089 Wolkenstein in Gröden,52,,8,14,22
089 Wolkenstein in Gröden,53,,11,7,18
089 Wolkenstein in Gröden,54,,13,12,25
089 Wolkenstein in Gröden,55,,6,17,23
089 Wolkenstein in Gröden,56,,17,12,29
089 Wolkenstein in Gröden,57,,13,14,27
089 Wolkenstein in Gröden,58,,11,17,28
089 Wolkenstein in Gröden,59,,17,19,36
089 Wolkenstein in Gröden,60,,5,14,19
089 Wolkenstein in Gröden,61,,12,9,21
089 Wolkenstein in Gröden,62,,21,15,36
089 Wolkenstein in Gröden,63,,12,12,24
089 Wolkenstein in Gröden,64,,14,18,32
089 Wolkenstein in Gröden,65,,15,18,33
089 Wolkenstein in Gröden,66,,17,14,31
089 Wolkenstein in Gröden,67,,19,7,26
089 Wolkenstein in Gröden,68,,11,19,30
089 Wolkenstein in Gröden,69,,11,15,26
089 Wolkenstein in Gröden,70,,14,8,22
089 Wolkenstein in Gröden,71,,17,10,27
089 Wolkenstein in Gröden,72,,7,11,18
089 Wolkenstein in Gröden,73,,5,9,14
089 Wolkenstein in Gröden,74,,8,10,18
089 Wolkenstein in Gröden,75,,7,10,17
089 Wolkenstein in Gröden,76,,8,7,15
089 Wolkenstein in Gröden,77,,5,9,14
089 Wolkenstein in Gröden,78,,10,6,16
089 Wolkenstein in Gröden,79,,7,5,12
089 Wolkenstein in Gröden,80,,6,7,13
089 Wolkenstein in Gröden,81,,3,10,13
089 Wolkenstein in Gröden,82,,4,6,10
089 Wolkenstein in Gröden,83,,5,9,14
089 Wolkenstein in Gröden,84,,1,5,6
089 Wolkenstein in Gröden,85,,3,4,7
089 Wolkenstein in Gröden,86,,1,2,3
089 Wolkenstein in Gröden,88,,1,3,4
089 Wolkenstein in Gröden,90,,-,4,4
089 Wolkenstein in Gröden,91,,1,1,2
089 Wolkenstein in Gröden,93,,-,4,4
089 Wolkenstein in Gröden,94,,-,3,3
089 Wolkenstein in Gröden,96,,-,1,1
089 Wolkenstein in Gröden,98,,-,1,1
091 Schnals,0,,6,6,12
091 Schnals,1,,9,7,16
091 Schnals,2,,2,6,8
091 Schnals,3,,12,1,13
091 Schnals,4,,4,4,8
091 Schnals,5,,5,5,10
091 Schnals,6,,6,9,15
091 Schnals,7,,7,16,23
091 Schnals,8,,13,11,24
091 Schnals,9,,7,14,21
091 Schnals,10,,5,9,14
091 Schnals,11,,4,7,11
091 Schnals,12,,11,5,16
091 Schnals,13,,13,10,23
091 Schnals,14,,13,9,22
091 Schnals,15,,5,7,12
091 Schnals,16,,19,9,28
091 Schnals,17,,10,5,15
091 Schnals,18,,12,10,22
091 Schnals,19,,9,10,19
091 Schnals,20,,7,9,16
091 Schnals,21,,13,15,28
091 Schnals,22,,9,8,17
091 Schnals,23,,11,5,16
091 Schnals,24,,16,8,24
091 Schnals,25,,14,11,25
091 Schnals,26,,11,9,20
091 Schnals,27,,11,10,21
091 Schnals,28,,9,8,17
091 Schnals,29,,13,1,14
091 Schnals,30,,6,6,12
091 Schnals,31,,14,7,21
091 Schnals,32,,7,9,16
091 Schnals,33,,9,10,19
091 Schnals,34,,12,11,23
091 Schnals,35,,13,11,24
091 Schnals,36,,13,8,21
091 Schnals,37,,10,10,20
091 Schnals,38,,15,12,27
091 Schnals,39,,14,15,29
091 Schnals,40,,19,8,27
091 Schnals,41,,6,9,15
091 Schnals,42,,10,15,25
091 Schnals,43,,15,13,28
091 Schnals,44,,12,13,25
091 Schnals,45,,11,8,19
091 Schnals,46,,17,14,31
091 Schnals,47,,13,10,23
091 Schnals,48,,13,5,18
091 Schnals,49,,14,5,19
091 Schnals,50,,9,6,15
091 Schnals,51,,10,10,20
091 Schnals,52,,13,9,22
091 Schnals,53,,13,7,20
091 Schnals,54,,12,8,20
091 Schnals,55,,10,7,17
091 Schnals,56,,10,9,19
091 Schnals,57,,3,3,6
091 Schnals,58,,10,8,18
091 Schnals,59,,5,6,11
091 Schnals,60,,7,4,11
091 Schnals,61,,4,7,11
091 Schnals,62,,6,9,15
091 Schnals,63,,4,4,8
091 Schnals,64,,4,4,8
091 Schnals,65,,7,7,14
091 Schnals,66,,7,7,14
091 Schnals,67,,2,11,13
091 Schnals,68,,7,5,12
091 Schnals,69,,5,5,10
091 Schnals,70,,3,5,8
091 Schnals,71,,2,4,6
091 Schnals,72,,5,4,9
091 Schnals,73,,2,10,12
091 Schnals,74,,2,4,6
091 Schnals,75,,-,5,5
091 Schnals,76,,5,6,11
091 Schnals,77,,2,6,8
091 Schnals,78,,3,7,10
091 Schnals,79,,9,3,12
091 Schnals,80,,5,11,16
091 Schnals,81,,-,6,6
091 Schnals,82,,-,1,1
091 Schnals,83,,6,3,9
091 Schnals,84,,-,5,5
091 Schnals,85,,1,3,4
091 Schnals,86,,-,1,1
091 Schnals,87,,3,2,5
091 Schnals,88,,-,3,3
091 Schnals,89,,-,2,2
091 Schnals,90,,-,3,3
091 Schnals,91,,-,2,2
091 Schnals,92,,-,1,1
091 Schnals,93,,1,2,3
091 Schnals,94,,-,2,2
091 Schnals,96,,-,1,1
092 Sexten,0,,12,10,22
092 Sexten,1,,11,6,17
092 Sexten,2,,11,10,21
092 Sexten,3,,17,19,36
092 Sexten,4,,17,13,30
092 Sexten,5,,8,15,23
092 Sexten,6,,8,16,24
092 Sexten,7,,11,7,18
092 Sexten,8,,12,9,21
092 Sexten,9,,12,12,24
092 Sexten,10,,15,14,29
092 Sexten,11,,16,11,27
092 Sexten,12,,8,5,13
092 Sexten,13,,13,10,23
092 Sexten,14,,11,12,23
092 Sexten,15,,11,19,30
092 Sexten,16,,9,9,18
092 Sexten,17,,10,5,15
092 Sexten,18,,12,8,20
092 Sexten,19,,6,9,15
092 Sexten,20,,10,11,21
092 Sexten,21,,6,11,17
092 Sexten,22,,11,9,20
092 Sexten,23,,10,18,28
092 Sexten,24,,15,13,28
092 Sexten,25,,15,5,20
092 Sexten,26,,11,23,34
092 Sexten,27,,11,10,21
092 Sexten,28,,10,4,14
092 Sexten,29,,21,10,31
092 Sexten,30,,8,8,16
092 Sexten,31,,8,6,14
092 Sexten,32,,10,11,21
092 Sexten,33,,15,15,30
092 Sexten,34,,13,15,28
092 Sexten,35,,11,17,28
092 Sexten,36,,23,20,43
092 Sexten,37,,17,17,34
092 Sexten,38,,19,18,37
092 Sexten,39,,15,16,31
092 Sexten,40,,19,18,37
092 Sexten,41,,18,19,37
092 Sexten,42,,30,19,49
092 Sexten,43,,14,15,29
092 Sexten,44,,18,14,32
092 Sexten,45,,19,9,28
092 Sexten,46,,15,15,30
092 Sexten,47,,22,15,37
092 Sexten,48,,17,13,30
092 Sexten,49,,13,14,27
092 Sexten,50,,10,12,22
092 Sexten,51,,12,11,23
092 Sexten,52,,5,12,17
092 Sexten,53,,6,11,17
092 Sexten,54,,7,9,16
092 Sexten,55,,13,7,20
092 Sexten,56,,6,5,11
092 Sexten,57,,10,7,17
092 Sexten,58,,10,4,14
092 Sexten,59,,6,9,15
092 Sexten,60,,9,4,13
092 Sexten,61,,6,12,18
092 Sexten,62,,8,6,14
092 Sexten,63,,5,7,12
092 Sexten,64,,10,16,26
092 Sexten,65,,9,13,22
092 Sexten,66,,6,10,16
092 Sexten,67,,14,12,26
092 Sexten,68,,11,8,19
092 Sexten,69,,7,10,17
092 Sexten,70,,9,16,25
092 Sexten,71,,12,7,19
092 Sexten,72,,5,10,15
092 Sexten,73,,6,7,13
092 Sexten,74,,9,13,22
092 Sexten,75,,9,11,20
092 Sexten,76,,7,13,20
092 Sexten,77,,9,11,20
092 Sexten,78,,9,15,24
092 Sexten,79,,7,3,10
092 Sexten,80,,5,10,15
092 Sexten,81,,6,7,13
092 Sexten,82,,6,10,16
092 Sexten,83,,6,7,13
092 Sexten,84,,3,8,11
092 Sexten,85,,2,4,6
092 Sexten,86,,2,3,5
092 Sexten,87,,-,1,1
092 Sexten,88,,1,1,2
092 Sexten,89,,-,1,1
092 Sexten,91,,1,-,1
092 Sexten,92,,-,3,3
092 Sexten,93,,-,4,4
093 Schlanders,0,,29,38,67
093 Schlanders,1,,28,37,65
093 Schlanders,2,,30,21,51
093 Schlanders,3,,29,29,58
093 Schlanders,4,,30,33,63
093 Schlanders,5,,39,40,79
093 Schlanders,6,,27,41,68
093 Schlanders,7,,41,38,79
093 Schlanders,8,,58,49,107
093 Schlanders,9,,44,38,82
093 Schlanders,10,,38,29,67
093 Schlanders,11,,39,39,78
093 Schlanders,12,,46,43,89
093 Schlanders,13,,34,45,79
093 Schlanders,14,,40,39,79
093 Schlanders,15,,51,41,92
093 Schlanders,16,,35,34,69
093 Schlanders,17,,36,42,78
093 Schlanders,18,,37,30,67
093 Schlanders,19,,35,34,69
093 Schlanders,20,,39,38,77
093 Schlanders,21,,39,38,77
093 Schlanders,22,,34,35,69
093 Schlanders,23,,50,41,91
093 Schlanders,24,,42,34,76
093 Schlanders,25,,31,31,62
093 Schlanders,26,,36,43,79
093 Schlanders,27,,51,36,87
093 Schlanders,28,,39,45,84
093 Schlanders,29,,42,33,75
093 Schlanders,30,,39,42,81
093 Schlanders,31,,56,39,95
093 Schlanders,32,,40,46,86
093 Schlanders,33,,54,37,91
093 Schlanders,34,,47,49,96
093 Schlanders,35,,48,56,104
093 Schlanders,36,,61,44,105
093 Schlanders,37,,50,43,93
093 Schlanders,38,,50,55,105
093 Schlanders,39,,48,52,100
093 Schlanders,40,,56,47,103
093 Schlanders,41,,41,42,83
093 Schlanders,42,,55,61,116
093 Schlanders,43,,53,44,97
093 Schlanders,44,,44,57,101
093 Schlanders,45,,45,44,89
093 Schlanders,46,,40,40,80
093 Schlanders,47,,46,54,100
093 Schlanders,48,,43,34,77
093 Schlanders,49,,25,34,59
093 Schlanders,50,,27,37,64
093 Schlanders,51,,31,32,63
093 Schlanders,52,,34,38,72
093 Schlanders,53,,31,23,54
093 Schlanders,54,,30,31,61
093 Schlanders,55,,24,31,55
093 Schlanders,56,,29,36,65
093 Schlanders,57,,38,26,64
093 Schlanders,58,,23,24,47
093 Schlanders,59,,31,20,51
093 Schlanders,60,,30,14,44
093 Schlanders,61,,29,31,60
093 Schlanders,62,,29,32,61
093 Schlanders,63,,36,37,73
093 Schlanders,64,,33,37,70
093 Schlanders,65,,29,28,57
093 Schlanders,66,,29,35,64
093 Schlanders,67,,16,22,38
093 Schlanders,68,,26,26,52
093 Schlanders,69,,18,26,44
093 Schlanders,70,,17,25,42
093 Schlanders,71,,19,22,41
093 Schlanders,72,,19,30,49
093 Schlanders,73,,21,17,38
093 Schlanders,74,,23,18,41
093 Schlanders,75,,15,25,40
093 Schlanders,76,,13,15,28
093 Schlanders,77,,16,22,38
093 Schlanders,78,,17,22,39
093 Schlanders,79,,14,24,38
093 Schlanders,80,,10,18,28
093 Schlanders,81,,12,16,28
093 Schlanders,82,,8,17,25
093 Schlanders,83,,6,13,19
093 Schlanders,84,,5,9,14
093 Schlanders,85,,3,16,19
093 Schlanders,86,,3,10,13
093 Schlanders,87,,4,11,15
093 Schlanders,88,,3,1,4
093 Schlanders,89,,1,3,4
093 Schlanders,90,,3,2,5
093 Schlanders,91,,3,5,8
093 Schlanders,92,,2,5,7
093 Schlanders,93,,1,5,6
093 Schlanders,94,,1,5,6
093 Schlanders,95,,1,3,4
093 Schlanders,96,,-,1,1
093 Schlanders,99,,-,1,1
093 Schlanders,102,,-,1,1
094 Schluderns,0,,6,9,15
094 Schluderns,1,,5,15,20
094 Schluderns,2,,16,11,27
094 Schluderns,3,,14,9,23
094 Schluderns,4,,13,8,21
094 Schluderns,5,,17,8,25
094 Schluderns,6,,9,15,24
094 Schluderns,7,,6,9,15
094 Schluderns,8,,14,11,25
094 Schluderns,9,,12,16,28
094 Schluderns,10,,9,12,21
094 Schluderns,11,,13,18,31
094 Schluderns,12,,17,7,24
094 Schluderns,13,,8,9,17
094 Schluderns,14,,9,10,19
094 Schluderns,15,,22,7,29
094 Schluderns,16,,15,12,27
094 Schluderns,17,,11,13,24
094 Schluderns,18,,6,10,16
094 Schluderns,19,,13,20,33
094 Schluderns,20,,19,11,30
094 Schluderns,21,,16,11,27
094 Schluderns,22,,13,9,22
094 Schluderns,23,,8,13,21
094 Schluderns,24,,21,14,35
094 Schluderns,25,,6,6,12
094 Schluderns,26,,6,16,22
094 Schluderns,27,,12,11,23
094 Schluderns,28,,13,8,21
094 Schluderns,29,,8,14,22
094 Schluderns,30,,16,10,26
094 Schluderns,31,,17,13,30
094 Schluderns,32,,21,13,34
094 Schluderns,33,,13,14,27
094 Schluderns,34,,13,13,26
094 Schluderns,35,,11,15,26
094 Schluderns,36,,20,9,29
094 Schluderns,37,,17,16,33
094 Schluderns,38,,14,16,30
094 Schluderns,39,,16,18,34
094 Schluderns,40,,25,10,35
094 Schluderns,41,,26,12,38
094 Schluderns,42,,14,19,33
094 Schluderns,43,,12,20,32
094 Schluderns,44,,16,16,32
094 Schluderns,45,,10,4,14
094 Schluderns,46,,14,20,34
094 Schluderns,47,,10,12,22
094 Schluderns,48,,17,7,24
094 Schluderns,49,,10,16,26
094 Schluderns,50,,17,11,28
094 Schluderns,51,,13,7,20
094 Schluderns,52,,11,7,18
094 Schluderns,53,,7,5,12
094 Schluderns,54,,11,3,14
094 Schluderns,55,,9,13,22
094 Schluderns,56,,13,10,23
094 Schluderns,57,,10,9,19
094 Schluderns,58,,6,5,11
094 Schluderns,59,,8,9,17
094 Schluderns,60,,6,3,9
094 Schluderns,61,,4,12,16
094 Schluderns,62,,3,8,11
094 Schluderns,63,,8,8,16
094 Schluderns,64,,11,14,25
094 Schluderns,65,,8,5,13
094 Schluderns,66,,13,8,21
094 Schluderns,67,,9,10,19
094 Schluderns,68,,7,10,17
094 Schluderns,69,,5,7,12
094 Schluderns,70,,5,10,15
094 Schluderns,71,,9,11,20
094 Schluderns,72,,5,9,14
094 Schluderns,73,,12,9,21
094 Schluderns,74,,4,8,12
094 Schluderns,75,,7,9,16
094 Schluderns,76,,7,7,14
094 Schluderns,77,,6,9,15
094 Schluderns,78,,5,1,6
094 Schluderns,79,,2,12,14
094 Schluderns,80,,2,7,9
094 Schluderns,81,,2,3,5
094 Schluderns,82,,1,5,6
094 Schluderns,83,,5,5,10
094 Schluderns,84,,1,6,7
094 Schluderns,85,,1,3,4
094 Schluderns,86,,2,3,5
094 Schluderns,87,,3,2,5
094 Schluderns,88,,1,2,3
094 Schluderns,89,,1,3,4
094 Schluderns,90,,1,2,3
094 Schluderns,91,,1,1,2
094 Schluderns,92,,1,-,1
094 Schluderns,93,,-,1,1
094 Schluderns,96,,-,1,1
095 Stilfs,0,,6,5,11
095 Stilfs,1,,8,5,13
095 Stilfs,2,,7,7,14
095 Stilfs,3,,5,3,8
095 Stilfs,4,,5,11,16
095 Stilfs,5,,11,4,15
095 Stilfs,6,,2,7,9
095 Stilfs,7,,8,3,11
095 Stilfs,8,,9,11,20
095 Stilfs,9,,12,1,13
095 Stilfs,10,,7,6,13
095 Stilfs,11,,8,6,14
095 Stilfs,12,,5,15,20
095 Stilfs,13,,3,9,12
095 Stilfs,14,,11,5,16
095 Stilfs,15,,17,7,24
095 Stilfs,16,,10,6,16
095 Stilfs,17,,6,4,10
095 Stilfs,18,,6,7,13
095 Stilfs,19,,9,8,17
095 Stilfs,20,,12,4,16
095 Stilfs,21,,15,6,21
095 Stilfs,22,,8,6,14
095 Stilfs,23,,12,4,16
095 Stilfs,24,,11,4,15
095 Stilfs,25,,7,3,10
095 Stilfs,26,,5,5,10
095 Stilfs,27,,8,8,16
095 Stilfs,28,,8,7,15
095 Stilfs,29,,14,4,18
095 Stilfs,30,,9,8,17
095 Stilfs,31,,5,8,13
095 Stilfs,32,,6,18,24
095 Stilfs,33,,13,11,24
095 Stilfs,34,,13,13,26
095 Stilfs,35,,12,13,25
095 Stilfs,36,,11,12,23
095 Stilfs,37,,9,11,20
095 Stilfs,38,,9,9,18
095 Stilfs,39,,15,8,23
095 Stilfs,40,,11,10,21
095 Stilfs,41,,11,5,16
095 Stilfs,42,,9,5,14
095 Stilfs,43,,9,16,25
095 Stilfs,44,,9,2,11
095 Stilfs,45,,8,6,14
095 Stilfs,46,,10,8,18
095 Stilfs,47,,6,12,18
095 Stilfs,48,,9,6,15
095 Stilfs,49,,6,11,17
095 Stilfs,50,,4,3,7
095 Stilfs,51,,16,9,25
095 Stilfs,52,,10,5,15
095 Stilfs,53,,10,5,15
095 Stilfs,54,,14,10,24
095 Stilfs,55,,1,7,8
095 Stilfs,56,,7,3,10
095 Stilfs,57,,8,10,18
095 Stilfs,58,,6,4,10
095 Stilfs,59,,10,10,20
095 Stilfs,60,,2,4,6
095 Stilfs,61,,13,9,22
095 Stilfs,62,,9,8,17
095 Stilfs,63,,5,12,17
095 Stilfs,64,,7,4,11
095 Stilfs,65,,7,11,18
095 Stilfs,66,,5,9,14
095 Stilfs,67,,4,5,9
095 Stilfs,68,,7,5,12
095 Stilfs,69,,3,9,12
095 Stilfs,70,,3,7,10
095 Stilfs,71,,6,4,10
095 Stilfs,72,,4,6,10
095 Stilfs,73,,4,7,11
095 Stilfs,74,,3,4,7
095 Stilfs,75,,5,7,12
095 Stilfs,76,,5,1,6
095 Stilfs,77,,4,7,11
095 Stilfs,78,,5,7,12
095 Stilfs,79,,3,5,8
095 Stilfs,80,,4,3,7
095 Stilfs,81,,1,7,8
095 Stilfs,82,,4,5,9
095 Stilfs,83,,1,5,6
095 Stilfs,84,,1,5,6
095 Stilfs,85,,1,7,8
095 Stilfs,86,,1,1,2
095 Stilfs,87,,1,2,3
095 Stilfs,88,,-,2,2
095 Stilfs,89,,-,3,3
095 Stilfs,91,,2,2,4
095 Stilfs,92,,-,1,1
095 Stilfs,93,,-,1,1
095 Stilfs,95,,-,2,2
095 Stilfs,96,,-,1,1
096 Terenten,0,,15,9,24
096 Terenten,1,,11,21,32
096 Terenten,2,,10,12,22
096 Terenten,3,,8,8,16
096 Terenten,4,,10,14,24
096 Terenten,5,,9,9,18
096 Terenten,6,,10,17,27
096 Terenten,7,,21,19,40
096 Terenten,8,,9,7,16
096 Terenten,9,,12,11,23
096 Terenten,10,,13,8,21
096 Terenten,11,,14,14,28
096 Terenten,12,,7,13,20
096 Terenten,13,,9,8,17
096 Terenten,14,,6,15,21
096 Terenten,15,,13,16,29
096 Terenten,16,,14,7,21
096 Terenten,17,,10,8,18
096 Terenten,18,,16,6,22
096 Terenten,19,,10,9,19
096 Terenten,20,,11,15,26
096 Terenten,21,,12,11,23
096 Terenten,22,,14,16,30
096 Terenten,23,,12,9,21
096 Terenten,24,,13,7,20
096 Terenten,25,,11,13,24
096 Terenten,26,,11,11,22
096 Terenten,27,,17,17,34
096 Terenten,28,,11,6,17
096 Terenten,29,,16,9,25
096 Terenten,30,,16,10,26
096 Terenten,31,,16,16,32
096 Terenten,32,,9,19,28
096 Terenten,33,,20,10,30
096 Terenten,34,,15,16,31
096 Terenten,35,,20,11,31
096 Terenten,36,,17,14,31
096 Terenten,37,,12,13,25
096 Terenten,38,,16,17,33
096 Terenten,39,,12,18,30
096 Terenten,40,,17,10,27
096 Terenten,41,,16,15,31
096 Terenten,42,,24,13,37
096 Terenten,43,,20,10,30
096 Terenten,44,,10,16,26
096 Terenten,45,,12,9,21
096 Terenten,46,,14,11,25
096 Terenten,47,,12,8,20
096 Terenten,48,,13,9,22
096 Terenten,49,,10,12,22
096 Terenten,50,,12,10,22
096 Terenten,51,,16,11,27
096 Terenten,52,,9,6,15
096 Terenten,53,,6,7,13
096 Terenten,54,,5,6,11
096 Terenten,55,,8,7,15
096 Terenten,56,,9,6,15
096 Terenten,57,,10,8,18
096 Terenten,58,,7,3,10
096 Terenten,59,,8,3,11
096 Terenten,60,,6,3,9
096 Terenten,61,,3,6,9
096 Terenten,62,,8,4,12
096 Terenten,63,,5,5,10
096 Terenten,64,,6,4,10
096 Terenten,65,,8,5,13
096 Terenten,66,,2,6,8
096 Terenten,67,,4,10,14
096 Terenten,68,,6,5,11
096 Terenten,69,,5,9,14
096 Terenten,70,,7,5,12
096 Terenten,71,,1,4,5
096 Terenten,72,,5,3,8
096 Terenten,73,,4,4,8
096 Terenten,74,,6,11,17
096 Terenten,75,,5,6,11
096 Terenten,76,,4,4,8
096 Terenten,77,,5,6,11
096 Terenten,78,,2,3,5
096 Terenten,79,,3,7,10
096 Terenten,80,,6,2,8
096 Terenten,81,,1,6,7
096 Terenten,82,,4,3,7
096 Terenten,83,,2,1,3
096 Terenten,84,,-,2,2
096 Terenten,85,,2,3,5
096 Terenten,86,,1,1,2
096 Terenten,87,,-,2,2
096 Terenten,88,,1,-,1
096 Terenten,89,,-,1,1
096 Terenten,91,,2,1,3
096 Terenten,92,,1,-,1
096 Terenten,93,,-,1,1
097 Terlan,0,,15,25,40
097 Terlan,1,,26,22,48
097 Terlan,2,,27,25,52
097 Terlan,3,,17,20,37
097 Terlan,4,,21,27,48
097 Terlan,5,,32,27,59
097 Terlan,6,,29,20,49
097 Terlan,7,,20,22,42
097 Terlan,8,,32,27,59
097 Terlan,9,,16,25,41
097 Terlan,10,,26,24,50
097 Terlan,11,,20,19,39
097 Terlan,12,,26,22,48
097 Terlan,13,,23,29,52
097 Terlan,14,,24,20,44
097 Terlan,15,,15,22,37
097 Terlan,16,,21,30,51
097 Terlan,17,,21,18,39
097 Terlan,18,,26,16,42
097 Terlan,19,,15,22,37
097 Terlan,20,,25,18,43
097 Terlan,21,,16,13,29
097 Terlan,22,,21,14,35
097 Terlan,23,,22,17,39
097 Terlan,24,,14,19,33
097 Terlan,25,,28,25,53
097 Terlan,26,,19,25,44
097 Terlan,27,,18,26,44
097 Terlan,28,,25,24,49
097 Terlan,29,,35,34,69
097 Terlan,30,,34,24,58
097 Terlan,31,,26,43,69
097 Terlan,32,,24,34,58
097 Terlan,33,,49,23,72
097 Terlan,34,,32,27,59
097 Terlan,35,,41,43,84
097 Terlan,36,,33,34,67
097 Terlan,37,,37,26,63
097 Terlan,38,,24,38,62
097 Terlan,39,,36,24,60
097 Terlan,40,,33,28,61
097 Terlan,41,,33,30,63
097 Terlan,42,,37,35,72
097 Terlan,43,,32,34,66
097 Terlan,44,,43,26,69
097 Terlan,45,,26,35,61
097 Terlan,46,,18,25,43
097 Terlan,47,,33,24,57
097 Terlan,48,,23,24,47
097 Terlan,49,,33,31,64
097 Terlan,50,,20,21,41
097 Terlan,51,,22,21,43
097 Terlan,52,,20,24,44
097 Terlan,53,,18,27,45
097 Terlan,54,,20,18,38
097 Terlan,55,,21,24,45
097 Terlan,56,,20,17,37
097 Terlan,57,,19,23,42
097 Terlan,58,,15,19,34
097 Terlan,59,,13,23,36
097 Terlan,60,,22,23,45
097 Terlan,61,,21,25,46
097 Terlan,62,,16,29,45
097 Terlan,63,,32,19,51
097 Terlan,64,,22,24,46
097 Terlan,65,,21,15,36
097 Terlan,66,,16,20,36
097 Terlan,67,,23,18,41
097 Terlan,68,,14,16,30
097 Terlan,69,,6,12,18
097 Terlan,70,,15,22,37
097 Terlan,71,,7,23,30
097 Terlan,72,,13,15,28
097 Terlan,73,,14,11,25
097 Terlan,74,,19,15,34
097 Terlan,75,,15,15,30
097 Terlan,76,,11,13,24
097 Terlan,77,,11,11,22
097 Terlan,78,,10,11,21
097 Terlan,79,,11,18,29
097 Terlan,80,,10,11,21
097 Terlan,81,,5,12,17
097 Terlan,82,,6,23,29
097 Terlan,83,,8,10,18
097 Terlan,84,,6,12,18
097 Terlan,85,,2,7,9
097 Terlan,86,,-,6,6
097 Terlan,87,,3,3,6
097 Terlan,88,,-,4,4
097 Terlan,89,,-,4,4
097 Terlan,90,,1,3,4
097 Terlan,91,,-,4,4
097 Terlan,92,,1,3,4
097 Terlan,93,,-,4,4
097 Terlan,94,,-,3,3
097 Terlan,95,,-,1,1
097 Terlan,96,,1,-,1
097 Terlan,97,,-,1,1
097 Terlan,98,,-,1,1
098 Tramin a.d. Weinstr.,0,,15,14,29
098 Tramin a.d. Weinstr.,1,,13,17,30
098 Tramin a.d. Weinstr.,2,,24,15,39
098 Tramin a.d. Weinstr.,3,,13,17,30
098 Tramin a.d. Weinstr.,4,,16,19,35
098 Tramin a.d. Weinstr.,5,,24,14,38
098 Tramin a.d. Weinstr.,6,,19,19,38
098 Tramin a.d. Weinstr.,7,,15,18,33
098 Tramin a.d. Weinstr.,8,,28,16,44
098 Tramin a.d. Weinstr.,9,,19,26,45
098 Tramin a.d. Weinstr.,10,,18,22,40
098 Tramin a.d. Weinstr.,11,,20,23,43
098 Tramin a.d. Weinstr.,12,,16,17,33
098 Tramin a.d. Weinstr.,13,,19,25,44
098 Tramin a.d. Weinstr.,14,,17,9,26
098 Tramin a.d. Weinstr.,15,,23,20,43
098 Tramin a.d. Weinstr.,16,,11,30,41
098 Tramin a.d. Weinstr.,17,,12,26,38
098 Tramin a.d. Weinstr.,18,,19,26,45
098 Tramin a.d. Weinstr.,19,,11,15,26
098 Tramin a.d. Weinstr.,20,,21,20,41
098 Tramin a.d. Weinstr.,21,,21,16,37
098 Tramin a.d. Weinstr.,22,,14,14,28
098 Tramin a.d. Weinstr.,23,,24,19,43
098 Tramin a.d. Weinstr.,24,,32,19,51
098 Tramin a.d. Weinstr.,25,,18,16,34
098 Tramin a.d. Weinstr.,26,,13,15,28
098 Tramin a.d. Weinstr.,27,,11,18,29
098 Tramin a.d. Weinstr.,28,,17,17,34
098 Tramin a.d. Weinstr.,29,,20,11,31
098 Tramin a.d. Weinstr.,30,,21,21,42
098 Tramin a.d. Weinstr.,31,,17,16,33
098 Tramin a.d. Weinstr.,32,,21,14,35
098 Tramin a.d. Weinstr.,33,,21,25,46
098 Tramin a.d. Weinstr.,34,,26,34,60
098 Tramin a.d. Weinstr.,35,,30,20,50
098 Tramin a.d. Weinstr.,36,,33,24,57
098 Tramin a.d. Weinstr.,37,,24,25,49
098 Tramin a.d. Weinstr.,38,,30,29,59
098 Tramin a.d. Weinstr.,39,,27,30,57
098 Tramin a.d. Weinstr.,40,,34,29,63
098 Tramin a.d. Weinstr.,41,,28,28,56
098 Tramin a.d. Weinstr.,42,,23,23,46
098 Tramin a.d. Weinstr.,43,,19,13,32
098 Tramin a.d. Weinstr.,44,,31,27,58
098 Tramin a.d. Weinstr.,45,,29,33,62
098 Tramin a.d. Weinstr.,46,,18,31,49
098 Tramin a.d. Weinstr.,47,,25,22,47
098 Tramin a.d. Weinstr.,48,,20,19,39
098 Tramin a.d. Weinstr.,49,,23,19,42
098 Tramin a.d. Weinstr.,50,,17,19,36
098 Tramin a.d. Weinstr.,51,,20,18,38
098 Tramin a.d. Weinstr.,52,,16,17,33
098 Tramin a.d. Weinstr.,53,,19,17,36
098 Tramin a.d. Weinstr.,54,,11,14,25
098 Tramin a.d. Weinstr.,55,,14,20,34
098 Tramin a.d. Weinstr.,56,,15,15,30
098 Tramin a.d. Weinstr.,57,,17,18,35
098 Tramin a.d. Weinstr.,58,,14,22,36
098 Tramin a.d. Weinstr.,59,,24,17,41
098 Tramin a.d. Weinstr.,60,,7,9,16
098 Tramin a.d. Weinstr.,61,,23,25,48
098 Tramin a.d. Weinstr.,62,,19,22,41
098 Tramin a.d. Weinstr.,63,,21,20,41
098 Tramin a.d. Weinstr.,64,,15,24,39
098 Tramin a.d. Weinstr.,65,,21,15,36
098 Tramin a.d. Weinstr.,66,,14,12,26
098 Tramin a.d. Weinstr.,67,,8,19,27
098 Tramin a.d. Weinstr.,68,,15,13,28
098 Tramin a.d. Weinstr.,69,,12,13,25
098 Tramin a.d. Weinstr.,70,,15,14,29
098 Tramin a.d. Weinstr.,71,,10,12,22
098 Tramin a.d. Weinstr.,72,,9,14,23
098 Tramin a.d. Weinstr.,73,,11,18,29
098 Tramin a.d. Weinstr.,74,,6,18,24
098 Tramin a.d. Weinstr.,75,,19,14,33
098 Tramin a.d. Weinstr.,76,,9,14,23
098 Tramin a.d. Weinstr.,77,,14,17,31
098 Tramin a.d. Weinstr.,78,,17,13,30
098 Tramin a.d. Weinstr.,79,,13,18,31
098 Tramin a.d. Weinstr.,80,,10,18,28
098 Tramin a.d. Weinstr.,81,,6,15,21
098 Tramin a.d. Weinstr.,82,,7,18,25
098 Tramin a.d. Weinstr.,83,,3,9,12
098 Tramin a.d. Weinstr.,84,,9,10,19
098 Tramin a.d. Weinstr.,85,,6,9,15
098 Tramin a.d. Weinstr.,86,,2,9,11
098 Tramin a.d. Weinstr.,87,,2,2,4
098 Tramin a.d. Weinstr.,88,,1,4,5
098 Tramin a.d. Weinstr.,89,,1,-,1
098 Tramin a.d. Weinstr.,90,,1,5,6
098 Tramin a.d. Weinstr.,91,,2,6,8
098 Tramin a.d. Weinstr.,92,,1,-,1
098 Tramin a.d. Weinstr.,93,,1,2,3
098 Tramin a.d. Weinstr.,94,,-,2,2
098 Tramin a.d. Weinstr.,95,,1,1,2
098 Tramin a.d. Weinstr.,98,,-,1,1
098 Tramin a.d. Weinstr.,105,,-,1,1
099 Tisens,0,,7,15,22
099 Tisens,1,,13,12,25
099 Tisens,2,,9,8,17
099 Tisens,3,,10,9,19
099 Tisens,4,,10,14,24
099 Tisens,5,,9,10,19
099 Tisens,6,,11,7,18
099 Tisens,7,,11,14,25
099 Tisens,8,,4,7,11
099 Tisens,9,,11,7,18
099 Tisens,10,,10,7,17
099 Tisens,11,,11,11,22
099 Tisens,12,,6,8,14
099 Tisens,13,,6,16,22
099 Tisens,14,,16,9,25
099 Tisens,15,,10,15,25
099 Tisens,16,,11,9,20
099 Tisens,17,,7,13,20
099 Tisens,18,,14,9,23
099 Tisens,19,,15,7,22
099 Tisens,20,,9,4,13
099 Tisens,21,,11,12,23
099 Tisens,22,,18,6,24
099 Tisens,23,,11,14,25
099 Tisens,24,,5,21,26
099 Tisens,25,,15,9,24
099 Tisens,26,,11,8,19
099 Tisens,27,,11,15,26
099 Tisens,28,,12,9,21
099 Tisens,29,,9,5,14
099 Tisens,30,,15,10,25
099 Tisens,31,,11,9,20
099 Tisens,32,,10,9,19
099 Tisens,33,,8,13,21
099 Tisens,34,,21,16,37
099 Tisens,35,,14,20,34
099 Tisens,36,,16,14,30
099 Tisens,37,,17,18,35
099 Tisens,38,,19,21,40
099 Tisens,39,,21,10,31
099 Tisens,40,,16,27,43
099 Tisens,41,,15,5,20
099 Tisens,42,,18,14,32
099 Tisens,43,,24,7,31
099 Tisens,44,,14,14,28
099 Tisens,45,,17,6,23
099 Tisens,46,,13,12,25
099 Tisens,47,,10,12,22
099 Tisens,48,,16,20,36
099 Tisens,49,,9,12,21
099 Tisens,50,,21,12,33
099 Tisens,51,,9,8,17
099 Tisens,52,,11,11,22
099 Tisens,53,,7,12,19
099 Tisens,54,,10,11,21
099 Tisens,55,,9,7,16
099 Tisens,56,,5,8,13
099 Tisens,57,,15,8,23
099 Tisens,58,,9,9,18
099 Tisens,59,,8,6,14
099 Tisens,60,,3,7,10
099 Tisens,61,,10,11,21
099 Tisens,62,,11,10,21
099 Tisens,63,,9,9,18
099 Tisens,64,,8,14,22
099 Tisens,65,,8,8,16
099 Tisens,66,,13,9,22
099 Tisens,67,,7,12,19
099 Tisens,68,,6,4,10
099 Tisens,69,,6,8,14
099 Tisens,70,,4,11,15
099 Tisens,71,,7,7,14
099 Tisens,72,,2,10,12
099 Tisens,73,,6,9,15
099 Tisens,74,,7,9,16
099 Tisens,75,,4,15,19
099 Tisens,76,,8,10,18
099 Tisens,77,,8,12,20
099 Tisens,78,,10,9,19
099 Tisens,79,,5,9,14
099 Tisens,80,,4,7,11
099 Tisens,81,,1,3,4
099 Tisens,82,,5,9,14
099 Tisens,83,,5,4,9
099 Tisens,84,,4,6,10
099 Tisens,85,,2,5,7
099 Tisens,86,,2,7,9
099 Tisens,87,,1,2,3
099 Tisens,88,,-,2,2
099 Tisens,89,,1,2,3
099 Tisens,90,,1,3,4
099 Tisens,91,,1,1,2
099 Tisens,93,,-,2,2
099 Tisens,94,,1,2,3
099 Tisens,97,,-,2,2
099 Tisens,102,,-,1,1
100 Tiers,0,,3,8,11
100 Tiers,1,,4,3,7
100 Tiers,2,,4,8,12
100 Tiers,3,,7,4,11
100 Tiers,4,,3,9,12
100 Tiers,5,,2,8,10
100 Tiers,6,,4,9,13
100 Tiers,7,,5,10,15
100 Tiers,8,,7,5,12
100 Tiers,9,,7,4,11
100 Tiers,10,,6,10,16
100 Tiers,11,,5,7,12
100 Tiers,12,,4,2,6
100 Tiers,13,,6,3,9
100 Tiers,14,,5,3,8
100 Tiers,15,,6,5,11
100 Tiers,16,,4,7,11
100 Tiers,17,,6,8,14
100 Tiers,18,,6,4,10
100 Tiers,19,,8,6,14
100 Tiers,20,,5,6,11
100 Tiers,21,,4,10,14
100 Tiers,22,,6,7,13
100 Tiers,23,,6,6,12
100 Tiers,24,,5,6,11
100 Tiers,25,,3,6,9
100 Tiers,26,,1,7,8
100 Tiers,27,,9,11,20
100 Tiers,28,,6,2,8
100 Tiers,29,,1,5,6
100 Tiers,30,,9,4,13
100 Tiers,31,,5,9,14
100 Tiers,32,,8,9,17
100 Tiers,33,,11,8,19
100 Tiers,34,,5,7,12
100 Tiers,35,,7,8,15
100 Tiers,36,,14,10,24
100 Tiers,37,,6,5,11
100 Tiers,38,,10,11,21
100 Tiers,39,,10,6,16
100 Tiers,40,,7,6,13
100 Tiers,41,,8,4,12
100 Tiers,42,,7,9,16
100 Tiers,43,,5,7,12
100 Tiers,44,,6,4,10
100 Tiers,45,,5,8,13
100 Tiers,46,,12,5,17
100 Tiers,47,,7,4,11
100 Tiers,48,,5,9,14
100 Tiers,49,,10,9,19
100 Tiers,50,,5,3,8
100 Tiers,51,,8,5,13
100 Tiers,52,,6,4,10
100 Tiers,53,,3,2,5
100 Tiers,54,,1,3,4
100 Tiers,55,,8,4,12
100 Tiers,56,,3,6,9
100 Tiers,57,,4,5,9
100 Tiers,58,,3,3,6
100 Tiers,59,,6,5,11
100 Tiers,60,,8,3,11
100 Tiers,61,,1,5,6
100 Tiers,62,,8,10,18
100 Tiers,63,,2,5,7
100 Tiers,64,,4,6,10
100 Tiers,65,,2,3,5
100 Tiers,66,,5,6,11
100 Tiers,67,,6,5,11
100 Tiers,68,,6,5,11
100 Tiers,69,,4,6,10
100 Tiers,70,,7,2,9
100 Tiers,71,,2,5,7
100 Tiers,72,,7,3,10
100 Tiers,73,,2,5,7
100 Tiers,74,,7,2,9
100 Tiers,75,,3,-,3
100 Tiers,76,,2,3,5
100 Tiers,77,,3,3,6
100 Tiers,78,,4,4,8
100 Tiers,79,,4,2,6
100 Tiers,80,,6,3,9
100 Tiers,81,,2,4,6
100 Tiers,82,,-,2,2
100 Tiers,83,,3,1,4
100 Tiers,84,,1,7,8
100 Tiers,85,,2,2,4
100 Tiers,86,,2,-,2
100 Tiers,87,,-,1,1
100 Tiers,88,,1,1,2
100 Tiers,90,,1,1,2
100 Tiers,92,,-,1,1
100 Tiers,93,,-,2,2
101 Tirol,0,,15,6,21
101 Tirol,1,,13,16,29
101 Tirol,2,,13,12,25
101 Tirol,3,,14,11,25
101 Tirol,4,,18,9,27
101 Tirol,5,,20,11,31
101 Tirol,6,,13,16,29
101 Tirol,7,,17,12,29
101 Tirol,8,,19,22,41
101 Tirol,9,,19,16,35
101 Tirol,10,,8,16,24
101 Tirol,11,,13,15,28
101 Tirol,12,,20,9,29
101 Tirol,13,,15,14,29
101 Tirol,14,,8,8,16
101 Tirol,15,,16,12,28
101 Tirol,16,,11,18,29
101 Tirol,17,,12,16,28
101 Tirol,18,,16,9,25
101 Tirol,19,,11,12,23
101 Tirol,20,,10,15,25
101 Tirol,21,,17,11,28
101 Tirol,22,,18,16,34
101 Tirol,23,,12,11,23
101 Tirol,24,,16,21,37
101 Tirol,25,,20,12,32
101 Tirol,26,,16,5,21
101 Tirol,27,,8,12,20
101 Tirol,28,,14,18,32
101 Tirol,29,,16,13,29
101 Tirol,30,,17,16,33
101 Tirol,31,,14,20,34
101 Tirol,32,,22,14,36
101 Tirol,33,,24,17,41
101 Tirol,34,,22,15,37
101 Tirol,35,,17,15,32
101 Tirol,36,,22,20,42
101 Tirol,37,,25,22,47
101 Tirol,38,,22,19,41
101 Tirol,39,,20,17,37
101 Tirol,40,,21,19,40
101 Tirol,41,,28,23,51
101 Tirol,42,,21,13,34
101 Tirol,43,,16,15,31
101 Tirol,44,,17,22,39
101 Tirol,45,,23,15,38
101 Tirol,46,,18,10,28
101 Tirol,47,,11,18,29
101 Tirol,48,,15,17,32
101 Tirol,49,,8,15,23
101 Tirol,50,,13,15,28
101 Tirol,51,,13,17,30
101 Tirol,52,,18,17,35
101 Tirol,53,,12,12,24
101 Tirol,54,,15,18,33
101 Tirol,55,,14,11,25
101 Tirol,56,,18,16,34
101 Tirol,57,,20,15,35
101 Tirol,58,,9,15,24
101 Tirol,59,,13,6,19
101 Tirol,60,,12,14,26
101 Tirol,61,,16,17,33
101 Tirol,62,,12,13,25
101 Tirol,63,,13,18,31
101 Tirol,64,,12,17,29
101 Tirol,65,,10,14,24
101 Tirol,66,,12,11,23
101 Tirol,67,,7,10,17
101 Tirol,68,,9,14,23
101 Tirol,69,,6,11,17
101 Tirol,70,,10,10,20
101 Tirol,71,,13,7,20
101 Tirol,72,,7,10,17
101 Tirol,73,,8,7,15
101 Tirol,74,,7,6,13
101 Tirol,75,,4,7,11
101 Tirol,76,,7,14,21
101 Tirol,77,,7,9,16
101 Tirol,78,,8,7,15
101 Tirol,79,,5,8,13
101 Tirol,80,,6,8,14
101 Tirol,81,,7,10,17
101 Tirol,82,,4,5,9
101 Tirol,83,,4,5,9
101 Tirol,84,,6,4,10
101 Tirol,85,,2,5,7
101 Tirol,86,,3,3,6
101 Tirol,87,,1,3,4
101 Tirol,89,,1,-,1
101 Tirol,90,,-,1,1
101 Tirol,91,,1,3,4
101 Tirol,92,,-,1,1
101 Tirol,93,,1,1,2
101 Tirol,94,,-,2,2
101 Tirol,98,,1,-,1
102 Truden im Naturpark,0,,2,6,8
102 Truden im Naturpark,1,,3,8,11
102 Truden im Naturpark,2,,6,4,10
102 Truden im Naturpark,3,,-,3,3
102 Truden im Naturpark,4,,6,3,9
102 Truden im Naturpark,5,,6,8,14
102 Truden im Naturpark,6,,-,4,4
102 Truden im Naturpark,7,,3,8,11
102 Truden im Naturpark,8,,6,6,12
102 Truden im Naturpark,9,,6,6,12
102 Truden im Naturpark,10,,7,6,13
102 Truden im Naturpark,11,,5,5,10
102 Truden im Naturpark,12,,11,5,16
102 Truden im Naturpark,13,,7,4,11
102 Truden im Naturpark,14,,7,8,15
102 Truden im Naturpark,15,,4,6,10
102 Truden im Naturpark,16,,9,9,18
102 Truden im Naturpark,17,,9,10,19
102 Truden im Naturpark,18,,7,5,12
102 Truden im Naturpark,19,,1,8,9
102 Truden im Naturpark,20,,9,6,15
102 Truden im Naturpark,21,,11,4,15
102 Truden im Naturpark,22,,6,5,11
102 Truden im Naturpark,23,,13,3,16
102 Truden im Naturpark,24,,3,9,12
102 Truden im Naturpark,25,,5,4,9
102 Truden im Naturpark,26,,9,9,18
102 Truden im Naturpark,27,,7,6,13
102 Truden im Naturpark,28,,3,4,7
102 Truden im Naturpark,29,,10,6,16
102 Truden im Naturpark,30,,7,2,9
102 Truden im Naturpark,31,,4,9,13
102 Truden im Naturpark,32,,9,8,17
102 Truden im Naturpark,33,,7,9,16
102 Truden im Naturpark,34,,4,4,8
102 Truden im Naturpark,35,,2,7,9
102 Truden im Naturpark,36,,7,9,16
102 Truden im Naturpark,37,,6,9,15
102 Truden im Naturpark,38,,11,9,20
102 Truden im Naturpark,39,,7,7,14
102 Truden im Naturpark,40,,8,7,15
102 Truden im Naturpark,41,,9,7,16
102 Truden im Naturpark,42,,11,6,17
102 Truden im Naturpark,43,,6,5,11
102 Truden im Naturpark,44,,9,6,15
102 Truden im Naturpark,45,,10,12,22
102 Truden im Naturpark,46,,7,9,16
102 Truden im Naturpark,47,,5,9,14
102 Truden im Naturpark,48,,6,10,16
102 Truden im Naturpark,49,,8,5,13
102 Truden im Naturpark,50,,8,10,18
102 Truden im Naturpark,51,,5,6,11
102 Truden im Naturpark,52,,9,5,14
102 Truden im Naturpark,53,,6,6,12
102 Truden im Naturpark,54,,8,6,14
102 Truden im Naturpark,55,,3,2,5
102 Truden im Naturpark,56,,5,3,8
102 Truden im Naturpark,57,,1,6,7
102 Truden im Naturpark,58,,6,1,7
102 Truden im Naturpark,59,,7,6,13
102 Truden im Naturpark,60,,4,2,6
102 Truden im Naturpark,61,,3,5,8
102 Truden im Naturpark,62,,4,5,9
102 Truden im Naturpark,63,,4,4,8
102 Truden im Naturpark,64,,5,5,10
102 Truden im Naturpark,65,,2,4,6
102 Truden im Naturpark,66,,8,3,11
102 Truden im Naturpark,67,,6,7,13
102 Truden im Naturpark,68,,3,4,7
102 Truden im Naturpark,69,,5,3,8
102 Truden im Naturpark,70,,3,3,6
102 Truden im Naturpark,71,,5,-,5
102 Truden im Naturpark,72,,6,7,13
102 Truden im Naturpark,73,,4,4,8
102 Truden im Naturpark,74,,5,4,9
102 Truden im Naturpark,75,,3,9,12
102 Truden im Naturpark,76,,-,6,6
102 Truden im Naturpark,77,,-,6,6
102 Truden im Naturpark,78,,4,6,10
102 Truden im Naturpark,79,,2,7,9
102 Truden im Naturpark,80,,-,5,5
102 Truden im Naturpark,81,,-,7,7
102 Truden im Naturpark,82,,2,6,8
102 Truden im Naturpark,83,,2,4,6
102 Truden im Naturpark,84,,1,4,5
102 Truden im Naturpark,85,,-,5,5
102 Truden im Naturpark,86,,1,4,5
102 Truden im Naturpark,87,,-,1,1
102 Truden im Naturpark,94,,-,1,1
103 Taufers im Münstertal,0,,1,7,8
103 Taufers im Münstertal,1,,7,5,12
103 Taufers im Münstertal,2,,4,4,8
103 Taufers im Münstertal,3,,5,5,10
103 Taufers im Münstertal,4,,5,6,11
103 Taufers im Münstertal,5,,5,5,10
103 Taufers im Münstertal,6,,4,3,7
103 Taufers im Münstertal,7,,8,9,17
103 Taufers im Münstertal,8,,5,4,9
103 Taufers im Münstertal,9,,6,4,10
103 Taufers im Münstertal,10,,9,9,18
103 Taufers im Münstertal,11,,6,8,14
103 Taufers im Münstertal,12,,3,5,8
103 Taufers im Münstertal,13,,9,8,17
103 Taufers im Münstertal,14,,7,10,17
103 Taufers im Münstertal,15,,9,8,17
103 Taufers im Münstertal,16,,9,2,11
103 Taufers im Münstertal,17,,6,8,14
103 Taufers im Münstertal,18,,4,6,10
103 Taufers im Münstertal,19,,5,4,9
103 Taufers im Münstertal,20,,5,3,8
103 Taufers im Münstertal,21,,5,7,12
103 Taufers im Münstertal,22,,6,5,11
103 Taufers im Münstertal,23,,6,10,16
103 Taufers im Münstertal,24,,10,2,12
103 Taufers im Münstertal,25,,8,7,15
103 Taufers im Münstertal,26,,7,5,12
103 Taufers im Münstertal,27,,9,3,12
103 Taufers im Münstertal,28,,7,4,11
103 Taufers im Münstertal,29,,5,3,8
103 Taufers im Münstertal,30,,9,6,15
103 Taufers im Münstertal,31,,5,6,11
103 Taufers im Münstertal,32,,2,5,7
103 Taufers im Münstertal,33,,4,9,13
103 Taufers im Münstertal,34,,7,15,22
103 Taufers im Münstertal,35,,6,8,14
103 Taufers im Münstertal,36,,11,7,18
103 Taufers im Münstertal,37,,10,10,20
103 Taufers im Münstertal,38,,4,5,9
103 Taufers im Münstertal,39,,7,8,15
103 Taufers im Münstertal,40,,12,7,19
103 Taufers im Münstertal,41,,7,12,19
103 Taufers im Münstertal,42,,10,9,19
103 Taufers im Münstertal,43,,11,9,20
103 Taufers im Münstertal,44,,9,8,17
103 Taufers im Münstertal,45,,14,6,20
103 Taufers im Münstertal,46,,6,10,16
103 Taufers im Münstertal,47,,5,6,11
103 Taufers im Münstertal,48,,9,7,16
103 Taufers im Münstertal,49,,10,10,20
103 Taufers im Münstertal,50,,4,3,7
103 Taufers im Münstertal,51,,4,6,10
103 Taufers im Münstertal,52,,7,4,11
103 Taufers im Münstertal,53,,6,2,8
103 Taufers im Münstertal,54,,5,4,9
103 Taufers im Münstertal,55,,7,1,8
103 Taufers im Münstertal,56,,5,1,6
103 Taufers im Münstertal,57,,5,1,6
103 Taufers im Münstertal,58,,3,7,10
103 Taufers im Münstertal,59,,3,3,6
103 Taufers im Münstertal,60,,3,3,6
103 Taufers im Münstertal,61,,1,-,1
103 Taufers im Münstertal,62,,6,5,11
103 Taufers im Münstertal,63,,5,5,10
103 Taufers im Münstertal,64,,4,6,10
103 Taufers im Münstertal,65,,3,3,6
103 Taufers im Münstertal,66,,5,4,9
103 Taufers im Münstertal,67,,7,9,16
103 Taufers im Münstertal,68,,3,4,7
103 Taufers im Münstertal,69,,2,9,11
103 Taufers im Münstertal,70,,6,2,8
103 Taufers im Münstertal,71,,3,8,11
103 Taufers im Münstertal,72,,6,5,11
103 Taufers im Münstertal,73,,5,1,6
103 Taufers im Münstertal,74,,8,3,11
103 Taufers im Münstertal,75,,3,3,6
103 Taufers im Münstertal,76,,4,6,10
103 Taufers im Münstertal,77,,3,3,6
103 Taufers im Münstertal,78,,3,4,7
103 Taufers im Münstertal,79,,2,4,6
103 Taufers im Münstertal,80,,1,5,6
103 Taufers im Münstertal,81,,-,6,6
103 Taufers im Münstertal,82,,3,5,8
103 Taufers im Münstertal,83,,2,2,4
103 Taufers im Münstertal,84,,2,-,2
103 Taufers im Münstertal,85,,3,2,5
103 Taufers im Münstertal,86,,1,1,2
103 Taufers im Münstertal,87,,-,2,2
103 Taufers im Münstertal,88,,1,3,4
103 Taufers im Münstertal,90,,-,1,1
103 Taufers im Münstertal,91,,1,-,1
103 Taufers im Münstertal,92,,-,1,1
103 Taufers im Münstertal,93,,-,2,2
103 Taufers im Münstertal,96,,-,1,1
103 Taufers im Münstertal,97,,-,1,1
104 Ulten,0,,19,21,40
104 Ulten,1,,20,12,32
104 Ulten,2,,22,19,41
104 Ulten,3,,14,21,35
104 Ulten,4,,19,17,36
104 Ulten,5,,17,16,33
104 Ulten,6,,14,15,29
104 Ulten,7,,18,18,36
104 Ulten,8,,14,20,34
104 Ulten,9,,11,13,24
104 Ulten,10,,11,16,27
104 Ulten,11,,20,15,35
104 Ulten,12,,23,14,37
104 Ulten,13,,17,17,34
104 Ulten,14,,23,31,54
104 Ulten,15,,16,18,34
104 Ulten,16,,18,29,47
104 Ulten,17,,16,20,36
104 Ulten,18,,19,18,37
104 Ulten,19,,22,11,33
104 Ulten,20,,14,17,31
104 Ulten,21,,20,21,41
104 Ulten,22,,22,18,40
104 Ulten,23,,16,23,39
104 Ulten,24,,18,15,33
104 Ulten,25,,18,19,37
104 Ulten,26,,17,17,34
104 Ulten,27,,20,17,37
104 Ulten,28,,21,13,34
104 Ulten,29,,17,19,36
104 Ulten,30,,23,21,44
104 Ulten,31,,21,27,48
104 Ulten,32,,27,15,42
104 Ulten,33,,24,21,45
104 Ulten,34,,26,20,46
104 Ulten,35,,22,26,48
104 Ulten,36,,29,21,50
104 Ulten,37,,28,25,53
104 Ulten,38,,16,22,38
104 Ulten,39,,21,19,40
104 Ulten,40,,26,25,51
104 Ulten,41,,24,21,45
104 Ulten,42,,28,26,54
104 Ulten,43,,30,22,52
104 Ulten,44,,28,17,45
104 Ulten,45,,25,21,46
104 Ulten,46,,23,23,46
104 Ulten,47,,25,16,41
104 Ulten,48,,35,22,57
104 Ulten,49,,18,16,34
104 Ulten,50,,13,12,25
104 Ulten,51,,19,16,35
104 Ulten,52,,24,13,37
104 Ulten,53,,18,13,31
104 Ulten,54,,19,19,38
104 Ulten,55,,21,14,35
104 Ulten,56,,17,10,27
104 Ulten,57,,13,12,25
104 Ulten,58,,16,9,25
104 Ulten,59,,15,15,30
104 Ulten,60,,8,13,21
104 Ulten,61,,14,20,34
104 Ulten,62,,17,16,33
104 Ulten,63,,9,17,26
104 Ulten,64,,13,11,24
104 Ulten,65,,16,9,25
104 Ulten,66,,20,16,36
104 Ulten,67,,7,10,17
104 Ulten,68,,10,10,20
104 Ulten,69,,9,9,18
104 Ulten,70,,10,14,24
104 Ulten,71,,11,14,25
104 Ulten,72,,5,14,19
104 Ulten,73,,12,8,20
104 Ulten,74,,10,8,18
104 Ulten,75,,15,17,32
104 Ulten,76,,5,14,19
104 Ulten,77,,9,16,25
104 Ulten,78,,6,17,23
104 Ulten,79,,5,14,19
104 Ulten,80,,15,12,27
104 Ulten,81,,9,11,20
104 Ulten,82,,9,24,33
104 Ulten,83,,6,10,16
104 Ulten,84,,8,14,22
104 Ulten,85,,9,10,19
104 Ulten,86,,1,13,14
104 Ulten,87,,3,2,5
104 Ulten,88,,1,2,3
104 Ulten,89,,-,2,2
104 Ulten,90,,2,1,3
104 Ulten,91,,1,6,7
104 Ulten,92,,1,3,4
104 Ulten,93,,1,2,3
104 Ulten,94,,1,4,5
104 Ulten,95,,-,3,3
104 Ulten,96,,1,-,1
104 Ulten,107,,-,1,1
105 Pfatten,0,,2,9,11
105 Pfatten,1,,1,6,7
105 Pfatten,2,,11,5,16
105 Pfatten,3,,4,5,9
105 Pfatten,4,,4,3,7
105 Pfatten,5,,7,7,14
105 Pfatten,6,,4,6,10
105 Pfatten,7,,12,4,16
105 Pfatten,8,,4,1,5
105 Pfatten,9,,4,9,13
105 Pfatten,10,,5,6,11
105 Pfatten,11,,10,12,22
105 Pfatten,12,,4,5,9
105 Pfatten,13,,7,7,14
105 Pfatten,14,,8,5,13
105 Pfatten,15,,9,7,16
105 Pfatten,16,,6,5,11
105 Pfatten,17,,2,7,9
105 Pfatten,18,,6,4,10
105 Pfatten,19,,5,10,15
105 Pfatten,20,,4,6,10
105 Pfatten,21,,3,7,10
105 Pfatten,22,,2,3,5
105 Pfatten,23,,6,3,9
105 Pfatten,24,,8,3,11
105 Pfatten,25,,3,6,9
105 Pfatten,26,,5,7,12
105 Pfatten,27,,5,6,11
105 Pfatten,28,,7,2,9
105 Pfatten,29,,5,2,7
105 Pfatten,30,,-,11,11
105 Pfatten,31,,9,11,20
105 Pfatten,32,,9,5,14
105 Pfatten,33,,6,11,17
105 Pfatten,34,,11,7,18
105 Pfatten,35,,9,5,14
105 Pfatten,36,,7,5,12
105 Pfatten,37,,5,8,13
105 Pfatten,38,,14,5,19
105 Pfatten,39,,10,8,18
105 Pfatten,40,,10,11,21
105 Pfatten,41,,9,4,13
105 Pfatten,42,,8,10,18
105 Pfatten,43,,8,13,21
105 Pfatten,44,,11,16,27
105 Pfatten,45,,6,8,14
105 Pfatten,46,,4,13,17
105 Pfatten,47,,7,8,15
105 Pfatten,48,,17,5,22
105 Pfatten,49,,9,7,16
105 Pfatten,50,,6,4,10
105 Pfatten,51,,11,2,13
105 Pfatten,52,,7,7,14
105 Pfatten,53,,1,6,7
105 Pfatten,54,,3,3,6
105 Pfatten,55,,4,5,9
105 Pfatten,56,,7,2,9
105 Pfatten,57,,3,2,5
105 Pfatten,58,,6,8,14
105 Pfatten,59,,5,4,9
105 Pfatten,60,,5,3,8
105 Pfatten,61,,6,2,8
105 Pfatten,62,,2,2,4
105 Pfatten,63,,4,2,6
105 Pfatten,64,,5,6,11
105 Pfatten,65,,3,4,7
105 Pfatten,66,,4,2,6
105 Pfatten,67,,2,2,4
105 Pfatten,68,,4,1,5
105 Pfatten,69,,3,4,7
105 Pfatten,70,,6,3,9
105 Pfatten,71,,2,6,8
105 Pfatten,72,,2,3,5
105 Pfatten,73,,-,4,4
105 Pfatten,74,,2,4,6
105 Pfatten,75,,2,3,5
105 Pfatten,76,,-,6,6
105 Pfatten,77,,-,1,1
105 Pfatten,78,,1,-,1
105 Pfatten,79,,3,2,5
105 Pfatten,80,,1,3,4
105 Pfatten,81,,1,3,4
105 Pfatten,82,,3,1,4
105 Pfatten,83,,2,1,3
105 Pfatten,84,,-,1,1
105 Pfatten,85,,1,1,2
105 Pfatten,86,,1,-,1
105 Pfatten,87,,-,1,1
105 Pfatten,88,,1,1,2
105 Pfatten,89,,-,2,2
105 Pfatten,92,,1,-,1
105 Pfatten,93,,-,1,1
106 Olang,0,,22,14,36
106 Olang,1,,16,15,31
106 Olang,2,,19,13,32
106 Olang,3,,15,13,28
106 Olang,4,,17,21,38
106 Olang,5,,19,19,38
106 Olang,6,,16,17,33
106 Olang,7,,19,23,42
106 Olang,8,,24,18,42
106 Olang,9,,27,22,49
106 Olang,10,,20,10,30
106 Olang,11,,20,11,31
106 Olang,12,,21,22,43
106 Olang,13,,14,17,31
106 Olang,14,,25,19,44
106 Olang,15,,23,22,45
106 Olang,16,,21,20,41
106 Olang,17,,15,18,33
106 Olang,18,,26,19,45
106 Olang,19,,17,17,34
106 Olang,20,,12,24,36
106 Olang,21,,22,15,37
106 Olang,22,,15,19,34
106 Olang,23,,21,25,46
106 Olang,24,,15,22,37
106 Olang,25,,19,26,45
106 Olang,26,,20,19,39
106 Olang,27,,19,18,37
106 Olang,28,,30,30,60
106 Olang,29,,20,23,43
106 Olang,30,,25,30,55
106 Olang,31,,18,26,44
106 Olang,32,,28,25,53
106 Olang,33,,25,19,44
106 Olang,34,,29,20,49
106 Olang,35,,22,21,43
106 Olang,36,,21,30,51
106 Olang,37,,28,23,51
106 Olang,38,,34,23,57
106 Olang,39,,30,24,54
106 Olang,40,,19,26,45
106 Olang,41,,20,29,49
106 Olang,42,,22,24,46
106 Olang,43,,26,11,37
106 Olang,44,,15,27,42
106 Olang,45,,22,25,47
106 Olang,46,,26,16,42
106 Olang,47,,21,12,33
106 Olang,48,,26,13,39
106 Olang,49,,14,28,42
106 Olang,50,,17,19,36
106 Olang,51,,16,19,35
106 Olang,52,,16,20,36
106 Olang,53,,17,13,30
106 Olang,54,,9,12,21
106 Olang,55,,33,16,49
106 Olang,56,,24,11,35
106 Olang,57,,19,22,41
106 Olang,58,,14,23,37
106 Olang,59,,16,13,29
106 Olang,60,,18,10,28
106 Olang,61,,14,6,20
106 Olang,62,,11,16,27
106 Olang,63,,14,16,30
106 Olang,64,,13,13,26
106 Olang,65,,17,10,27
106 Olang,66,,13,8,21
106 Olang,67,,7,14,21
106 Olang,68,,8,9,17
106 Olang,69,,8,8,16
106 Olang,70,,8,14,22
106 Olang,71,,11,8,19
106 Olang,72,,11,15,26
106 Olang,73,,10,12,22
106 Olang,74,,4,6,10
106 Olang,75,,13,7,20
106 Olang,76,,11,13,24
106 Olang,77,,4,9,13
106 Olang,78,,6,8,14
106 Olang,79,,5,12,17
106 Olang,80,,4,4,8
106 Olang,81,,3,7,10
106 Olang,82,,5,4,9
106 Olang,83,,3,6,9
106 Olang,84,,3,3,6
106 Olang,85,,1,5,6
106 Olang,86,,1,2,3
106 Olang,87,,-,1,1
106 Olang,88,,1,2,3
106 Olang,89,,-,1,1
106 Olang,90,,1,3,4
106 Olang,91,,1,3,4
106 Olang,92,,-,1,1
106 Olang,94,,-,3,3
106 Olang,99,,1,-,1
107 Pfitsch,0,,16,15,31
107 Pfitsch,1,,18,13,31
107 Pfitsch,2,,17,13,30
107 Pfitsch,3,,22,20,42
107 Pfitsch,4,,11,10,21
107 Pfitsch,5,,23,25,48
107 Pfitsch,6,,18,17,35
107 Pfitsch,7,,11,17,28
107 Pfitsch,8,,15,11,26
107 Pfitsch,9,,11,14,25
107 Pfitsch,10,,16,10,26
107 Pfitsch,11,,15,21,36
107 Pfitsch,12,,15,16,31
107 Pfitsch,13,,14,15,29
107 Pfitsch,14,,20,13,33
107 Pfitsch,15,,18,14,32
107 Pfitsch,16,,8,22,30
107 Pfitsch,17,,15,13,28
107 Pfitsch,18,,11,18,29
107 Pfitsch,19,,16,10,26
107 Pfitsch,20,,16,13,29
107 Pfitsch,21,,23,13,36
107 Pfitsch,22,,22,24,46
107 Pfitsch,23,,28,15,43
107 Pfitsch,24,,21,17,38
107 Pfitsch,25,,20,25,45
107 Pfitsch,26,,27,15,42
107 Pfitsch,27,,24,20,44
107 Pfitsch,28,,13,17,30
107 Pfitsch,29,,20,20,40
107 Pfitsch,30,,17,24,41
107 Pfitsch,31,,16,22,38
107 Pfitsch,32,,18,17,35
107 Pfitsch,33,,19,20,39
107 Pfitsch,34,,29,18,47
107 Pfitsch,35,,25,20,45
107 Pfitsch,36,,28,24,52
107 Pfitsch,37,,24,20,44
107 Pfitsch,38,,19,16,35
107 Pfitsch,39,,27,16,43
107 Pfitsch,40,,23,21,44
107 Pfitsch,41,,16,26,42
107 Pfitsch,42,,21,20,41
107 Pfitsch,43,,24,22,46
107 Pfitsch,44,,22,23,45
107 Pfitsch,45,,14,25,39
107 Pfitsch,46,,14,18,32
107 Pfitsch,47,,25,16,41
107 Pfitsch,48,,23,23,46
107 Pfitsch,49,,18,12,30
107 Pfitsch,50,,14,14,28
107 Pfitsch,51,,21,21,42
107 Pfitsch,52,,20,15,35
107 Pfitsch,53,,19,23,42
107 Pfitsch,54,,23,13,36
107 Pfitsch,55,,21,18,39
107 Pfitsch,56,,15,20,35
107 Pfitsch,57,,8,10,18
107 Pfitsch,58,,11,13,24
107 Pfitsch,59,,14,13,27
107 Pfitsch,60,,12,12,24
107 Pfitsch,61,,11,14,25
107 Pfitsch,62,,22,12,34
107 Pfitsch,63,,24,13,37
107 Pfitsch,64,,17,16,33
107 Pfitsch,65,,13,14,27
107 Pfitsch,66,,15,8,23
107 Pfitsch,67,,5,14,19
107 Pfitsch,68,,9,11,20
107 Pfitsch,69,,8,12,20
107 Pfitsch,70,,8,7,15
107 Pfitsch,71,,11,5,16
107 Pfitsch,72,,14,12,26
107 Pfitsch,73,,4,12,16
107 Pfitsch,74,,8,11,19
107 Pfitsch,75,,6,13,19
107 Pfitsch,76,,16,11,27
107 Pfitsch,77,,5,12,17
107 Pfitsch,78,,8,11,19
107 Pfitsch,79,,3,12,15
107 Pfitsch,80,,10,9,19
107 Pfitsch,81,,-,17,17
107 Pfitsch,82,,6,11,17
107 Pfitsch,83,,5,4,9
107 Pfitsch,84,,5,7,12
107 Pfitsch,85,,-,5,5
107 Pfitsch,86,,2,6,8
107 Pfitsch,87,,-,3,3
107 Pfitsch,88,,2,2,4
107 Pfitsch,89,,1,1,2
107 Pfitsch,90,,2,3,5
107 Pfitsch,91,,-,1,1
107 Pfitsch,92,,-,2,2
107 Pfitsch,93,,-,1,1
107 Pfitsch,94,,-,1,1
107 Pfitsch,95,,1,1,2
107 Pfitsch,97,,-,2,2
108 Ahrntal,0,,32,35,67
108 Ahrntal,1,,32,38,70
108 Ahrntal,2,,35,39,74
108 Ahrntal,3,,30,33,63
108 Ahrntal,4,,29,29,58
108 Ahrntal,5,,49,39,88
108 Ahrntal,6,,32,38,70
108 Ahrntal,7,,35,36,71
108 Ahrntal,8,,41,43,84
108 Ahrntal,9,,37,50,87
108 Ahrntal,10,,36,31,67
108 Ahrntal,11,,26,26,52
108 Ahrntal,12,,39,41,80
108 Ahrntal,13,,41,34,75
108 Ahrntal,14,,26,35,61
108 Ahrntal,15,,40,31,71
108 Ahrntal,16,,38,33,71
108 Ahrntal,17,,28,33,61
108 Ahrntal,18,,36,37,73
108 Ahrntal,19,,39,49,88
108 Ahrntal,20,,34,45,79
108 Ahrntal,21,,41,32,73
108 Ahrntal,22,,44,47,91
108 Ahrntal,23,,40,44,84
108 Ahrntal,24,,54,42,96
108 Ahrntal,25,,37,31,68
108 Ahrntal,26,,43,37,80
108 Ahrntal,27,,34,44,78
108 Ahrntal,28,,51,45,96
108 Ahrntal,29,,44,47,91
108 Ahrntal,30,,44,44,88
108 Ahrntal,31,,48,38,86
108 Ahrntal,32,,43,40,83
108 Ahrntal,33,,50,53,103
108 Ahrntal,34,,70,42,112
108 Ahrntal,35,,51,44,95
108 Ahrntal,36,,51,43,94
108 Ahrntal,37,,51,47,98
108 Ahrntal,38,,45,50,95
108 Ahrntal,39,,61,40,101
108 Ahrntal,40,,55,43,98
108 Ahrntal,41,,54,43,97
108 Ahrntal,42,,51,43,94
108 Ahrntal,43,,38,49,87
108 Ahrntal,44,,36,34,70
108 Ahrntal,45,,40,30,70
108 Ahrntal,46,,43,38,81
108 Ahrntal,47,,48,27,75
108 Ahrntal,48,,26,39,65
108 Ahrntal,49,,37,19,56
108 Ahrntal,50,,36,27,63
108 Ahrntal,51,,33,21,54
108 Ahrntal,52,,26,29,55
108 Ahrntal,53,,27,33,60
108 Ahrntal,54,,33,26,59
108 Ahrntal,55,,31,20,51
108 Ahrntal,56,,32,29,61
108 Ahrntal,57,,28,28,56
108 Ahrntal,58,,26,19,45
108 Ahrntal,59,,17,22,39
108 Ahrntal,60,,20,14,34
108 Ahrntal,61,,20,18,38
108 Ahrntal,62,,22,33,55
108 Ahrntal,63,,29,30,59
108 Ahrntal,64,,31,33,64
108 Ahrntal,65,,30,25,55
108 Ahrntal,66,,26,23,49
108 Ahrntal,67,,36,29,65
108 Ahrntal,68,,26,22,48
108 Ahrntal,69,,21,15,36
108 Ahrntal,70,,20,37,57
108 Ahrntal,71,,20,20,40
108 Ahrntal,72,,18,17,35
108 Ahrntal,73,,21,26,47
108 Ahrntal,74,,31,20,51
108 Ahrntal,75,,19,17,36
108 Ahrntal,76,,16,15,31
108 Ahrntal,77,,13,24,37
108 Ahrntal,78,,17,18,35
108 Ahrntal,79,,14,15,29
108 Ahrntal,80,,10,16,26
108 Ahrntal,81,,11,14,25
108 Ahrntal,82,,6,12,18
108 Ahrntal,83,,7,15,22
108 Ahrntal,84,,5,7,12
108 Ahrntal,85,,2,7,9
108 Ahrntal,86,,7,4,11
108 Ahrntal,87,,-,4,4
108 Ahrntal,88,,2,7,9
108 Ahrntal,89,,-,4,4
108 Ahrntal,90,,1,9,10
108 Ahrntal,91,,2,6,8
108 Ahrntal,92,,1,2,3
108 Ahrntal,93,,1,-,1
108 Ahrntal,95,,1,1,2
108 Ahrntal,96,,-,2,2
108 Ahrntal,98,,-,1,1
108 Ahrntal,100,,1,-,1
109 Gsies,0,,15,16,31
109 Gsies,1,,9,11,20
109 Gsies,2,,19,18,37
109 Gsies,3,,12,11,23
109 Gsies,4,,14,14,28
109 Gsies,5,,10,12,22
109 Gsies,6,,26,13,39
109 Gsies,7,,18,5,23
109 Gsies,8,,13,16,29
109 Gsies,9,,10,17,27
109 Gsies,10,,15,16,31
109 Gsies,11,,10,19,29
109 Gsies,12,,17,19,36
109 Gsies,13,,16,10,26
109 Gsies,14,,16,25,41
109 Gsies,15,,16,13,29
109 Gsies,16,,9,12,21
109 Gsies,17,,7,15,22
109 Gsies,18,,19,17,36
109 Gsies,19,,12,17,29
109 Gsies,20,,17,13,30
109 Gsies,21,,13,8,21
109 Gsies,22,,18,10,28
109 Gsies,23,,18,19,37
109 Gsies,24,,15,17,32
109 Gsies,25,,23,22,45
109 Gsies,26,,10,15,25
109 Gsies,27,,14,12,26
109 Gsies,28,,15,17,32
109 Gsies,29,,14,17,31
109 Gsies,30,,19,21,40
109 Gsies,31,,20,21,41
109 Gsies,32,,13,13,26
109 Gsies,33,,10,20,30
109 Gsies,34,,21,17,38
109 Gsies,35,,27,14,41
109 Gsies,36,,26,11,37
109 Gsies,37,,16,14,30
109 Gsies,38,,16,12,28
109 Gsies,39,,15,19,34
109 Gsies,40,,20,5,25
109 Gsies,41,,14,17,31
109 Gsies,42,,13,15,28
109 Gsies,43,,17,8,25
109 Gsies,44,,9,14,23
109 Gsies,45,,17,19,36
109 Gsies,46,,12,15,27
109 Gsies,47,,17,16,33
109 Gsies,48,,12,14,26
109 Gsies,49,,17,7,24
109 Gsies,50,,14,10,24
109 Gsies,51,,16,6,22
109 Gsies,52,,19,6,25
109 Gsies,53,,17,13,30
109 Gsies,54,,16,13,29
109 Gsies,55,,8,8,16
109 Gsies,56,,15,16,31
109 Gsies,57,,7,11,18
109 Gsies,58,,22,7,29
109 Gsies,59,,15,10,25
109 Gsies,60,,4,12,16
109 Gsies,61,,8,13,21
109 Gsies,62,,10,9,19
109 Gsies,63,,5,13,18
109 Gsies,64,,6,11,17
109 Gsies,65,,9,11,20
109 Gsies,66,,6,8,14
109 Gsies,67,,7,8,15
109 Gsies,68,,10,7,17
109 Gsies,69,,4,10,14
109 Gsies,70,,4,9,13
109 Gsies,71,,5,9,14
109 Gsies,72,,6,4,10
109 Gsies,73,,9,5,14
109 Gsies,74,,6,8,14
109 Gsies,75,,11,6,17
109 Gsies,76,,3,5,8
109 Gsies,77,,8,9,17
109 Gsies,78,,2,11,13
109 Gsies,79,,4,4,8
109 Gsies,80,,5,5,10
109 Gsies,81,,5,6,11
109 Gsies,82,,5,6,11
109 Gsies,83,,7,7,14
109 Gsies,84,,2,10,12
109 Gsies,85,,3,3,6
109 Gsies,86,,2,1,3
109 Gsies,87,,1,1,2
109 Gsies,88,,1,2,3
109 Gsies,90,,1,-,1
109 Gsies,92,,-,1,1
109 Gsies,93,,1,2,3
109 Gsies,94,,1,2,3
109 Gsies,97,,-,1,1
109 Gsies,98,,-,1,1
110 Vintl,0,,20,20,40
110 Vintl,1,,14,15,29
110 Vintl,2,,16,20,36
110 Vintl,3,,14,19,33
110 Vintl,4,,17,22,39
110 Vintl,5,,22,15,37
110 Vintl,6,,21,22,43
110 Vintl,7,,19,29,48
110 Vintl,8,,20,17,37
110 Vintl,9,,22,19,41
110 Vintl,10,,37,24,61
110 Vintl,11,,18,18,36
110 Vintl,12,,23,21,44
110 Vintl,13,,31,21,52
110 Vintl,14,,23,30,53
110 Vintl,15,,29,20,49
110 Vintl,16,,25,16,41
110 Vintl,17,,22,20,42
110 Vintl,18,,20,22,42
110 Vintl,19,,22,20,42
110 Vintl,20,,10,15,25
110 Vintl,21,,27,11,38
110 Vintl,22,,24,19,43
110 Vintl,23,,21,21,42
110 Vintl,24,,18,25,43
110 Vintl,25,,33,18,51
110 Vintl,26,,31,17,48
110 Vintl,27,,23,36,59
110 Vintl,28,,17,20,37
110 Vintl,29,,23,26,49
110 Vintl,30,,24,19,43
110 Vintl,31,,31,25,56
110 Vintl,32,,22,20,42
110 Vintl,33,,31,19,50
110 Vintl,34,,32,25,57
110 Vintl,35,,21,16,37
110 Vintl,36,,29,24,53
110 Vintl,37,,26,23,49
110 Vintl,38,,33,35,68
110 Vintl,39,,31,32,63
110 Vintl,40,,32,31,63
110 Vintl,41,,37,24,61
110 Vintl,42,,34,27,61
110 Vintl,43,,31,24,55
110 Vintl,44,,27,31,58
110 Vintl,45,,19,22,41
110 Vintl,46,,24,21,45
110 Vintl,47,,19,13,32
110 Vintl,48,,24,28,52
110 Vintl,49,,25,17,42
110 Vintl,50,,19,13,32
110 Vintl,51,,16,18,34
110 Vintl,52,,22,9,31
110 Vintl,53,,19,19,38
110 Vintl,54,,22,18,40
110 Vintl,55,,22,19,41
110 Vintl,56,,18,19,37
110 Vintl,57,,14,13,27
110 Vintl,58,,21,14,35
110 Vintl,59,,17,12,29
110 Vintl,60,,15,20,35
110 Vintl,61,,12,5,17
110 Vintl,62,,20,11,31
110 Vintl,63,,11,13,24
110 Vintl,64,,6,15,21
110 Vintl,65,,8,19,27
110 Vintl,66,,16,16,32
110 Vintl,67,,11,5,16
110 Vintl,68,,11,9,20
110 Vintl,69,,15,11,26
110 Vintl,70,,9,11,20
110 Vintl,71,,15,9,24
110 Vintl,72,,5,18,23
110 Vintl,73,,9,14,23
110 Vintl,74,,9,10,19
110 Vintl,75,,8,14,22
110 Vintl,76,,8,14,22
110 Vintl,77,,9,8,17
110 Vintl,78,,9,13,22
110 Vintl,79,,11,5,16
110 Vintl,80,,4,8,12
110 Vintl,81,,5,7,12
110 Vintl,82,,6,7,13
110 Vintl,83,,3,5,8
110 Vintl,84,,4,4,8
110 Vintl,85,,2,8,10
110 Vintl,86,,2,4,6
110 Vintl,87,,-,2,2
110 Vintl,88,,-,2,2
110 Vintl,89,,1,2,3
110 Vintl,90,,1,3,4
110 Vintl,91,,1,3,4
110 Vintl,92,,-,1,1
110 Vintl,93,,1,-,1
110 Vintl,94,,-,1,1
111 Vahrn,0,,27,22,49
111 Vahrn,1,,27,30,57
111 Vahrn,2,,28,19,47
111 Vahrn,3,,29,29,58
111 Vahrn,4,,26,19,45
111 Vahrn,5,,25,20,45
111 Vahrn,6,,25,38,63
111 Vahrn,7,,22,23,45
111 Vahrn,8,,22,22,44
111 Vahrn,9,,37,21,58
111 Vahrn,10,,21,20,41
111 Vahrn,11,,22,22,44
111 Vahrn,12,,20,19,39
111 Vahrn,13,,20,24,44
111 Vahrn,14,,20,28,48
111 Vahrn,15,,15,27,42
111 Vahrn,16,,28,20,48
111 Vahrn,17,,25,18,43
111 Vahrn,18,,17,19,36
111 Vahrn,19,,22,15,37
111 Vahrn,20,,28,27,55
111 Vahrn,21,,18,21,39
111 Vahrn,22,,27,29,56
111 Vahrn,23,,25,25,50
111 Vahrn,24,,28,25,53
111 Vahrn,25,,21,27,48
111 Vahrn,26,,19,29,48
111 Vahrn,27,,24,27,51
111 Vahrn,28,,19,24,43
111 Vahrn,29,,44,22,66
111 Vahrn,30,,38,27,65
111 Vahrn,31,,25,35,60
111 Vahrn,32,,40,41,81
111 Vahrn,33,,33,35,68
111 Vahrn,34,,36,27,63
111 Vahrn,35,,42,41,83
111 Vahrn,36,,37,40,77
111 Vahrn,37,,29,29,58
111 Vahrn,38,,46,30,76
111 Vahrn,39,,39,33,72
111 Vahrn,40,,44,43,87
111 Vahrn,41,,35,36,71
111 Vahrn,42,,33,30,63
111 Vahrn,43,,33,34,67
111 Vahrn,44,,23,21,44
111 Vahrn,45,,32,30,62
111 Vahrn,46,,29,25,54
111 Vahrn,47,,18,19,37
111 Vahrn,48,,27,27,54
111 Vahrn,49,,21,23,44
111 Vahrn,50,,29,28,57
111 Vahrn,51,,18,30,48
111 Vahrn,52,,23,24,47
111 Vahrn,53,,24,17,41
111 Vahrn,54,,21,12,33
111 Vahrn,55,,16,19,35
111 Vahrn,56,,21,28,49
111 Vahrn,57,,17,16,33
111 Vahrn,58,,16,24,40
111 Vahrn,59,,19,22,41
111 Vahrn,60,,11,16,27
111 Vahrn,61,,19,19,38
111 Vahrn,62,,24,23,47
111 Vahrn,63,,19,22,41
111 Vahrn,64,,20,23,43
111 Vahrn,65,,20,15,35
111 Vahrn,66,,19,20,39
111 Vahrn,67,,14,9,23
111 Vahrn,68,,16,19,35
111 Vahrn,69,,11,17,28
111 Vahrn,70,,8,14,22
111 Vahrn,71,,10,15,25
111 Vahrn,72,,9,13,22
111 Vahrn,73,,11,13,24
111 Vahrn,74,,9,13,22
111 Vahrn,75,,15,15,30
111 Vahrn,76,,7,17,24
111 Vahrn,77,,8,12,20
111 Vahrn,78,,4,18,22
111 Vahrn,79,,6,4,10
111 Vahrn,80,,4,13,17
111 Vahrn,81,,6,14,20
111 Vahrn,82,,7,8,15
111 Vahrn,83,,5,10,15
111 Vahrn,84,,5,7,12
111 Vahrn,85,,2,4,6
111 Vahrn,86,,2,3,5
111 Vahrn,87,,1,3,4
111 Vahrn,88,,3,2,5
111 Vahrn,89,,1,-,1
111 Vahrn,90,,-,1,1
111 Vahrn,91,,-,2,2
111 Vahrn,92,,1,1,2
111 Vahrn,93,,1,2,3
111 Vahrn,94,,-,1,1
111 Vahrn,95,,-,1,1
111 Vahrn,97,,-,1,1
111 Vahrn,99,,-,1,1
112 Vöran,0,,2,4,6
112 Vöran,1,,2,4,6
112 Vöran,2,,8,6,14
112 Vöran,3,,5,5,10
112 Vöran,4,,8,4,12
112 Vöran,5,,11,6,17
112 Vöran,6,,5,3,8
112 Vöran,7,,7,4,11
112 Vöran,8,,14,6,20
112 Vöran,9,,9,6,15
112 Vöran,10,,5,9,14
112 Vöran,11,,7,8,15
112 Vöran,12,,9,6,15
112 Vöran,13,,6,3,9
112 Vöran,14,,7,3,10
112 Vöran,15,,5,7,12
112 Vöran,16,,10,6,16
112 Vöran,17,,7,7,14
112 Vöran,18,,11,6,17
112 Vöran,19,,7,6,13
112 Vöran,20,,9,10,19
112 Vöran,21,,9,5,14
112 Vöran,22,,6,6,12
112 Vöran,23,,9,8,17
112 Vöran,24,,9,10,19
112 Vöran,25,,4,4,8
112 Vöran,26,,3,7,10
112 Vöran,27,,10,9,19
112 Vöran,28,,12,6,18
112 Vöran,29,,6,6,12
112 Vöran,30,,7,5,12
112 Vöran,31,,12,9,21
112 Vöran,32,,5,5,10
112 Vöran,33,,10,7,17
112 Vöran,34,,4,10,14
112 Vöran,35,,9,4,13
112 Vöran,36,,7,3,10
112 Vöran,37,,14,3,17
112 Vöran,38,,3,7,10
112 Vöran,39,,7,7,14
112 Vöran,40,,4,3,7
112 Vöran,41,,12,4,16
112 Vöran,42,,8,7,15
112 Vöran,43,,13,15,28
112 Vöran,44,,4,6,10
112 Vöran,45,,6,6,12
112 Vöran,46,,5,8,13
112 Vöran,47,,6,5,11
112 Vöran,48,,6,9,15
112 Vöran,49,,2,1,3
112 Vöran,50,,5,2,7
112 Vöran,51,,5,5,10
112 Vöran,52,,5,4,9
112 Vöran,53,,9,1,10
112 Vöran,54,,3,-,3
112 Vöran,55,,7,4,11
112 Vöran,56,,6,5,11
112 Vöran,57,,2,3,5
112 Vöran,58,,5,3,8
112 Vöran,59,,4,2,6
112 Vöran,60,,-,3,3
112 Vöran,61,,4,3,7
112 Vöran,62,,3,5,8
112 Vöran,63,,6,4,10
112 Vöran,64,,4,6,10
112 Vöran,65,,3,5,8
112 Vöran,66,,2,3,5
112 Vöran,67,,8,3,11
112 Vöran,68,,2,2,4
112 Vöran,69,,3,5,8
112 Vöran,70,,2,1,3
112 Vöran,71,,1,7,8
112 Vöran,72,,6,6,12
112 Vöran,73,,2,5,7
112 Vöran,74,,3,1,4
112 Vöran,75,,5,1,6
112 Vöran,76,,1,3,4
112 Vöran,77,,4,1,5
112 Vöran,78,,-,2,2
112 Vöran,79,,-,3,3
112 Vöran,80,,3,4,7
112 Vöran,81,,-,2,2
112 Vöran,82,,2,1,3
112 Vöran,83,,1,-,1
112 Vöran,84,,1,1,2
112 Vöran,85,,-,1,1
112 Vöran,89,,1,-,1
112 Vöran,94,,-,1,1
113 Niederdorf,0,,14,8,22
113 Niederdorf,1,,11,17,28
113 Niederdorf,2,,13,12,25
113 Niederdorf,3,,5,12,17
113 Niederdorf,4,,8,10,18
113 Niederdorf,5,,11,11,22
113 Niederdorf,6,,5,6,11
113 Niederdorf,7,,8,11,19
113 Niederdorf,8,,9,8,17
113 Niederdorf,9,,6,9,15
113 Niederdorf,10,,6,11,17
113 Niederdorf,11,,13,7,20
113 Niederdorf,12,,9,7,16
113 Niederdorf,13,,7,10,17
113 Niederdorf,14,,8,12,20
113 Niederdorf,15,,12,10,22
113 Niederdorf,16,,9,7,16
113 Niederdorf,17,,7,10,17
113 Niederdorf,18,,2,9,11
113 Niederdorf,19,,4,7,11
113 Niederdorf,20,,8,6,14
113 Niederdorf,21,,7,6,13
113 Niederdorf,22,,9,9,18
113 Niederdorf,23,,4,11,15
113 Niederdorf,24,,8,6,14
113 Niederdorf,25,,8,6,14
113 Niederdorf,26,,10,2,12
113 Niederdorf,27,,4,2,6
113 Niederdorf,28,,9,5,14
113 Niederdorf,29,,12,7,19
113 Niederdorf,30,,8,8,16
113 Niederdorf,31,,10,10,20
113 Niederdorf,32,,14,10,24
113 Niederdorf,33,,16,11,27
113 Niederdorf,34,,10,13,23
113 Niederdorf,35,,10,10,20
113 Niederdorf,36,,24,16,40
113 Niederdorf,37,,16,11,27
113 Niederdorf,38,,13,15,28
113 Niederdorf,39,,25,10,35
113 Niederdorf,40,,10,16,26
113 Niederdorf,41,,17,14,31
113 Niederdorf,42,,11,10,21
113 Niederdorf,43,,19,9,28
113 Niederdorf,44,,13,10,23
113 Niederdorf,45,,9,10,19
113 Niederdorf,46,,10,10,20
113 Niederdorf,47,,6,5,11
113 Niederdorf,48,,12,10,22
113 Niederdorf,49,,8,10,18
113 Niederdorf,50,,11,7,18
113 Niederdorf,51,,12,7,19
113 Niederdorf,52,,7,3,10
113 Niederdorf,53,,8,5,13
113 Niederdorf,54,,1,1,2
113 Niederdorf,55,,5,4,9
113 Niederdorf,56,,11,4,15
113 Niederdorf,57,,4,9,13
113 Niederdorf,58,,6,8,14
113 Niederdorf,59,,6,7,13
113 Niederdorf,60,,3,6,9
113 Niederdorf,61,,8,6,14
113 Niederdorf,62,,5,8,13
113 Niederdorf,63,,6,10,16
113 Niederdorf,64,,5,6,11
113 Niederdorf,65,,5,8,13
113 Niederdorf,66,,1,3,4
113 Niederdorf,67,,4,6,10
113 Niederdorf,68,,5,8,13
113 Niederdorf,69,,5,8,13
113 Niederdorf,70,,7,7,14
113 Niederdorf,71,,2,13,15
113 Niederdorf,72,,5,7,12
113 Niederdorf,73,,8,6,14
113 Niederdorf,74,,7,6,13
113 Niederdorf,75,,6,9,15
113 Niederdorf,76,,4,8,12
113 Niederdorf,77,,3,6,9
113 Niederdorf,78,,8,9,17
113 Niederdorf,79,,3,6,9
113 Niederdorf,80,,1,5,6
113 Niederdorf,81,,3,9,12
113 Niederdorf,82,,2,3,5
113 Niederdorf,83,,3,7,10
113 Niederdorf,84,,5,4,9
113 Niederdorf,85,,1,4,5
113 Niederdorf,86,,1,2,3
113 Niederdorf,87,,1,2,3
113 Niederdorf,88,,1,1,2
113 Niederdorf,89,,-,2,2
113 Niederdorf,90,,-,2,2
113 Niederdorf,91,,-,1,1
113 Niederdorf,92,,-,1,1
113 Niederdorf,94,,-,1,1
113 Niederdorf,95,,-,1,1
113 Niederdorf,100,,-,1,1
114 Villanders,0,,18,8,26
114 Villanders,1,,13,16,29
114 Villanders,2,,6,13,19
114 Villanders,3,,9,12,21
114 Villanders,4,,13,11,24
114 Villanders,5,,10,17,27
114 Villanders,6,,13,11,24
114 Villanders,7,,13,9,22
114 Villanders,8,,10,12,22
114 Villanders,9,,14,8,22
114 Villanders,10,,18,5,23
114 Villanders,11,,11,12,23
114 Villanders,12,,7,17,24
114 Villanders,13,,14,8,22
114 Villanders,14,,17,15,32
114 Villanders,15,,16,14,30
114 Villanders,16,,15,10,25
114 Villanders,17,,10,12,22
114 Villanders,18,,6,16,22
114 Villanders,19,,9,8,17
114 Villanders,20,,10,11,21
114 Villanders,21,,13,15,28
114 Villanders,22,,14,6,20
114 Villanders,23,,15,13,28
114 Villanders,24,,19,16,35
114 Villanders,25,,10,15,25
114 Villanders,26,,16,6,22
114 Villanders,27,,11,13,24
114 Villanders,28,,15,16,31
114 Villanders,29,,12,10,22
114 Villanders,30,,9,14,23
114 Villanders,31,,14,16,30
114 Villanders,32,,11,18,29
114 Villanders,33,,15,16,31
114 Villanders,34,,16,21,37
114 Villanders,35,,20,9,29
114 Villanders,36,,27,17,44
114 Villanders,37,,24,11,35
114 Villanders,38,,18,12,30
114 Villanders,39,,20,16,36
114 Villanders,40,,22,17,39
114 Villanders,41,,23,16,39
114 Villanders,42,,15,14,29
114 Villanders,43,,18,11,29
114 Villanders,44,,15,12,27
114 Villanders,45,,19,6,25
114 Villanders,46,,15,11,26
114 Villanders,47,,17,7,24
114 Villanders,48,,10,7,17
114 Villanders,49,,10,11,21
114 Villanders,50,,10,17,27
114 Villanders,51,,9,5,14
114 Villanders,52,,10,9,19
114 Villanders,53,,12,7,19
114 Villanders,54,,10,7,17
114 Villanders,55,,11,8,19
114 Villanders,56,,11,5,16
114 Villanders,57,,7,11,18
114 Villanders,58,,6,7,13
114 Villanders,59,,10,10,20
114 Villanders,60,,6,3,9
114 Villanders,61,,5,9,14
114 Villanders,62,,7,8,15
114 Villanders,63,,10,8,18
114 Villanders,64,,8,9,17
114 Villanders,65,,9,12,21
114 Villanders,66,,7,5,12
114 Villanders,67,,8,6,14
114 Villanders,68,,4,9,13
114 Villanders,69,,6,5,11
114 Villanders,70,,2,8,10
114 Villanders,71,,1,9,10
114 Villanders,72,,9,9,18
114 Villanders,73,,8,9,17
114 Villanders,74,,5,7,12
114 Villanders,75,,8,5,13
114 Villanders,76,,3,8,11
114 Villanders,77,,3,7,10
114 Villanders,78,,7,6,13
114 Villanders,79,,3,5,8
114 Villanders,80,,2,7,9
114 Villanders,81,,5,5,10
114 Villanders,82,,5,3,8
114 Villanders,83,,2,4,6
114 Villanders,84,,1,9,10
114 Villanders,85,,3,4,7
114 Villanders,86,,-,2,2
114 Villanders,89,,-,1,1
114 Villanders,90,,-,2,2
114 Villanders,91,,1,2,3
114 Villanders,92,,1,2,3
114 Villanders,93,,1,1,2
114 Villanders,94,,-,1,1
114 Villanders,99,,1,-,1
114 Villanders,102,,-,1,1
115 Sterzing,0,,31,21,52
115 Sterzing,1,,31,28,59
115 Sterzing,2,,27,38,65
115 Sterzing,3,,37,27,64
115 Sterzing,4,,34,33,67
115 Sterzing,5,,28,31,59
115 Sterzing,6,,27,24,51
115 Sterzing,7,,24,29,53
115 Sterzing,8,,31,32,63
115 Sterzing,9,,27,35,62
115 Sterzing,10,,32,28,60
115 Sterzing,11,,32,19,51
115 Sterzing,12,,32,28,60
115 Sterzing,13,,29,33,62
115 Sterzing,14,,35,34,69
115 Sterzing,15,,25,34,59
115 Sterzing,16,,40,21,61
115 Sterzing,17,,29,27,56
115 Sterzing,18,,31,25,56
115 Sterzing,19,,35,30,65
115 Sterzing,20,,16,27,43
115 Sterzing,21,,30,25,55
115 Sterzing,22,,30,33,63
115 Sterzing,23,,38,37,75
115 Sterzing,24,,67,40,107
115 Sterzing,25,,47,47,94
115 Sterzing,26,,45,45,90
115 Sterzing,27,,56,30,86
115 Sterzing,28,,53,41,94
115 Sterzing,29,,43,41,84
115 Sterzing,30,,64,49,113
115 Sterzing,31,,54,38,92
115 Sterzing,32,,47,63,110
115 Sterzing,33,,53,55,108
115 Sterzing,34,,61,51,112
115 Sterzing,35,,50,52,102
115 Sterzing,36,,42,38,80
115 Sterzing,37,,55,55,110
115 Sterzing,38,,63,45,108
115 Sterzing,39,,52,49,101
115 Sterzing,40,,59,48,107
115 Sterzing,41,,50,45,95
115 Sterzing,42,,51,50,101
115 Sterzing,43,,40,48,88
115 Sterzing,44,,43,35,78
115 Sterzing,45,,49,45,94
115 Sterzing,46,,54,41,95
115 Sterzing,47,,42,40,82
115 Sterzing,48,,36,47,83
115 Sterzing,49,,43,26,69
115 Sterzing,50,,34,46,80
115 Sterzing,51,,33,33,66
115 Sterzing,52,,31,40,71
115 Sterzing,53,,42,38,80
115 Sterzing,54,,36,42,78
115 Sterzing,55,,40,39,79
115 Sterzing,56,,33,50,83
115 Sterzing,57,,38,44,82
115 Sterzing,58,,29,29,58
115 Sterzing,59,,44,43,87
115 Sterzing,60,,38,36,74
115 Sterzing,61,,35,27,62
115 Sterzing,62,,43,44,87
115 Sterzing,63,,27,35,62
115 Sterzing,64,,30,28,58
115 Sterzing,65,,39,31,70
115 Sterzing,66,,27,28,55
115 Sterzing,67,,27,28,55
115 Sterzing,68,,20,36,56
115 Sterzing,69,,22,42,64
115 Sterzing,70,,23,23,46
115 Sterzing,71,,18,25,43
115 Sterzing,72,,25,28,53
115 Sterzing,73,,14,16,30
115 Sterzing,74,,21,31,52
115 Sterzing,75,,8,23,31
115 Sterzing,76,,16,20,36
115 Sterzing,77,,18,28,46
115 Sterzing,78,,16,17,33
115 Sterzing,79,,11,19,30
115 Sterzing,80,,4,19,23
115 Sterzing,81,,11,18,29
115 Sterzing,82,,11,17,28
115 Sterzing,83,,11,21,32
115 Sterzing,84,,3,13,16
115 Sterzing,85,,3,8,11
115 Sterzing,86,,4,5,9
115 Sterzing,87,,3,2,5
115 Sterzing,88,,3,2,5
115 Sterzing,89,,1,3,4
115 Sterzing,90,,1,2,3
115 Sterzing,91,,2,7,9
115 Sterzing,92,,-,2,2
115 Sterzing,93,,-,4,4
115 Sterzing,94,,-,1,1
115 Sterzing,95,,-,2,2
115 Sterzing,96,,-,1,1
115 Sterzing,97,,1,-,1
115 Sterzing,104,,-,1,1
116 Feldthurns,0,,24,19,43
116 Feldthurns,1,,23,16,39
116 Feldthurns,2,,13,14,27
116 Feldthurns,3,,23,25,48
116 Feldthurns,4,,17,20,37
116 Feldthurns,5,,26,15,41
116 Feldthurns,6,,18,24,42
116 Feldthurns,7,,22,19,41
116 Feldthurns,8,,22,16,38
116 Feldthurns,9,,17,20,37
116 Feldthurns,10,,18,18,36
116 Feldthurns,11,,15,18,33
116 Feldthurns,12,,27,19,46
116 Feldthurns,13,,17,19,36
116 Feldthurns,14,,14,13,27
116 Feldthurns,15,,13,17,30
116 Feldthurns,16,,20,14,34
116 Feldthurns,17,,15,19,34
116 Feldthurns,18,,22,13,35
116 Feldthurns,19,,19,20,39
116 Feldthurns,20,,13,20,33
116 Feldthurns,21,,16,19,35
116 Feldthurns,22,,24,23,47
116 Feldthurns,23,,15,21,36
116 Feldthurns,24,,21,21,42
116 Feldthurns,25,,12,24,36
116 Feldthurns,26,,14,17,31
116 Feldthurns,27,,31,26,57
116 Feldthurns,28,,20,18,38
116 Feldthurns,29,,22,25,47
116 Feldthurns,30,,19,19,38
116 Feldthurns,31,,25,33,58
116 Feldthurns,32,,19,18,37
116 Feldthurns,33,,35,30,65
116 Feldthurns,34,,17,26,43
116 Feldthurns,35,,18,19,37
116 Feldthurns,36,,22,26,48
116 Feldthurns,37,,19,28,47
116 Feldthurns,38,,22,22,44
116 Feldthurns,39,,20,19,39
116 Feldthurns,40,,25,29,54
116 Feldthurns,41,,23,19,42
116 Feldthurns,42,,27,19,46
116 Feldthurns,43,,15,18,33
116 Feldthurns,44,,17,17,34
116 Feldthurns,45,,17,13,30
116 Feldthurns,46,,15,15,30
116 Feldthurns,47,,15,20,35
116 Feldthurns,48,,14,13,27
116 Feldthurns,49,,11,18,29
116 Feldthurns,50,,14,13,27
116 Feldthurns,51,,14,15,29
116 Feldthurns,52,,18,13,31
116 Feldthurns,53,,22,15,37
116 Feldthurns,54,,14,13,27
116 Feldthurns,55,,14,14,28
116 Feldthurns,56,,7,15,22
116 Feldthurns,57,,14,12,26
116 Feldthurns,58,,16,8,24
116 Feldthurns,59,,11,9,20
116 Feldthurns,60,,13,13,26
116 Feldthurns,61,,21,11,32
116 Feldthurns,62,,12,12,24
116 Feldthurns,63,,9,7,16
116 Feldthurns,64,,8,4,12
116 Feldthurns,65,,10,6,16
116 Feldthurns,66,,7,11,18
116 Feldthurns,67,,11,8,19
116 Feldthurns,68,,4,10,14
116 Feldthurns,69,,8,10,18
116 Feldthurns,70,,10,11,21
116 Feldthurns,71,,2,5,7
116 Feldthurns,72,,7,4,11
116 Feldthurns,73,,6,10,16
116 Feldthurns,74,,4,6,10
116 Feldthurns,75,,4,13,17
116 Feldthurns,76,,4,11,15
116 Feldthurns,77,,9,4,13
116 Feldthurns,78,,4,4,8
116 Feldthurns,79,,2,7,9
116 Feldthurns,80,,5,7,12
116 Feldthurns,81,,4,8,12
116 Feldthurns,82,,6,6,12
116 Feldthurns,83,,2,6,8
116 Feldthurns,84,,1,8,9
116 Feldthurns,85,,5,10,15
116 Feldthurns,86,,4,7,11
116 Feldthurns,87,,3,-,3
116 Feldthurns,88,,-,2,2
116 Feldthurns,89,,-,2,2
116 Feldthurns,90,,2,5,7
116 Feldthurns,91,,1,2,3
116 Feldthurns,92,,-,1,1
116 Feldthurns,93,,1,1,2
116 Feldthurns,94,,-,1,1
117 Wengen,0,,10,4,14
117 Wengen,1,,7,8,15
117 Wengen,2,,5,7,12
117 Wengen,3,,10,4,14
117 Wengen,4,,5,11,16
117 Wengen,5,,10,6,16
117 Wengen,6,,9,5,14
117 Wengen,7,,7,8,15
117 Wengen,8,,12,7,19
117 Wengen,9,,9,8,17
117 Wengen,10,,11,9,20
117 Wengen,11,,12,7,19
117 Wengen,12,,10,7,17
117 Wengen,13,,10,7,17
117 Wengen,14,,17,8,25
117 Wengen,15,,12,7,19
117 Wengen,16,,6,7,13
117 Wengen,17,,6,9,15
117 Wengen,18,,11,5,16
117 Wengen,19,,8,8,16
117 Wengen,20,,9,6,15
117 Wengen,21,,14,7,21
117 Wengen,22,,13,5,18
117 Wengen,23,,11,5,16
117 Wengen,24,,6,8,14
117 Wengen,25,,9,11,20
117 Wengen,26,,13,6,19
117 Wengen,27,,6,6,12
117 Wengen,28,,10,8,18
117 Wengen,29,,6,7,13
117 Wengen,30,,17,9,26
117 Wengen,31,,10,8,18
117 Wengen,32,,17,11,28
117 Wengen,33,,12,11,23
117 Wengen,34,,12,13,25
117 Wengen,35,,12,13,25
117 Wengen,36,,9,12,21
117 Wengen,37,,18,10,28
117 Wengen,38,,10,11,21
117 Wengen,39,,13,5,18
117 Wengen,40,,9,11,20
117 Wengen,41,,11,5,16
117 Wengen,42,,12,13,25
117 Wengen,43,,14,7,21
117 Wengen,44,,8,9,17
117 Wengen,45,,10,12,22
117 Wengen,46,,7,6,13
117 Wengen,47,,6,8,14
117 Wengen,48,,6,11,17
117 Wengen,49,,5,6,11
117 Wengen,50,,7,6,13
117 Wengen,51,,9,4,13
117 Wengen,52,,6,2,8
117 Wengen,53,,6,7,13
117 Wengen,54,,9,6,15
117 Wengen,55,,3,6,9
117 Wengen,56,,5,8,13
117 Wengen,57,,2,12,14
117 Wengen,58,,6,3,9
117 Wengen,59,,5,3,8
117 Wengen,60,,6,3,9
117 Wengen,61,,9,8,17
117 Wengen,62,,3,7,10
117 Wengen,63,,8,6,14
117 Wengen,64,,4,4,8
117 Wengen,65,,8,9,17
117 Wengen,66,,6,3,9
117 Wengen,67,,5,4,9
117 Wengen,68,,7,8,15
117 Wengen,69,,2,1,3
117 Wengen,70,,2,7,9
117 Wengen,71,,2,10,12
117 Wengen,72,,4,2,6
117 Wengen,73,,2,7,9
117 Wengen,74,,6,2,8
117 Wengen,75,,4,2,6
117 Wengen,76,,2,8,10
117 Wengen,77,,2,3,5
117 Wengen,78,,4,5,9
117 Wengen,79,,1,4,5
117 Wengen,80,,3,4,7
117 Wengen,81,,-,6,6
117 Wengen,82,,3,6,9
117 Wengen,83,,3,4,7
117 Wengen,84,,4,7,11
117 Wengen,85,,1,1,2
117 Wengen,86,,1,-,1
117 Wengen,88,,2,-,2
117 Wengen,90,,1,-,1
117 Wengen,92,,-,1,1
117 Wengen,93,,1,-,1
117 Wengen,95,,-,1,1
117 Wengen,101,,-,1,1
118 U.L.Frau i.W.-St.Felix,0,,5,8,13
118 U.L.Frau i.W.-St.Felix,1,,6,3,9
118 U.L.Frau i.W.-St.Felix,2,,8,7,15
118 U.L.Frau i.W.-St.Felix,3,,7,3,10
118 U.L.Frau i.W.-St.Felix,4,,8,5,13
118 U.L.Frau i.W.-St.Felix,5,,4,1,5
118 U.L.Frau i.W.-St.Felix,6,,5,5,10
118 U.L.Frau i.W.-St.Felix,7,,6,8,14
118 U.L.Frau i.W.-St.Felix,8,,5,5,10
118 U.L.Frau i.W.-St.Felix,9,,8,5,13
118 U.L.Frau i.W.-St.Felix,10,,4,10,14
118 U.L.Frau i.W.-St.Felix,11,,7,8,15
118 U.L.Frau i.W.-St.Felix,12,,9,6,15
118 U.L.Frau i.W.-St.Felix,13,,7,4,11
118 U.L.Frau i.W.-St.Felix,14,,10,9,19
118 U.L.Frau i.W.-St.Felix,15,,7,4,11
118 U.L.Frau i.W.-St.Felix,16,,8,6,14
118 U.L.Frau i.W.-St.Felix,17,,8,6,14
118 U.L.Frau i.W.-St.Felix,18,,4,7,11
118 U.L.Frau i.W.-St.Felix,19,,7,4,11
118 U.L.Frau i.W.-St.Felix,20,,5,6,11
118 U.L.Frau i.W.-St.Felix,21,,8,5,13
118 U.L.Frau i.W.-St.Felix,22,,2,12,14
118 U.L.Frau i.W.-St.Felix,23,,3,7,10
118 U.L.Frau i.W.-St.Felix,24,,6,4,10
118 U.L.Frau i.W.-St.Felix,25,,3,6,9
118 U.L.Frau i.W.-St.Felix,26,,1,4,5
118 U.L.Frau i.W.-St.Felix,27,,-,3,3
118 U.L.Frau i.W.-St.Felix,28,,6,3,9
118 U.L.Frau i.W.-St.Felix,29,,4,8,12
118 U.L.Frau i.W.-St.Felix,30,,8,2,10
118 U.L.Frau i.W.-St.Felix,31,,5,6,11
118 U.L.Frau i.W.-St.Felix,32,,3,4,7
118 U.L.Frau i.W.-St.Felix,33,,7,5,12
118 U.L.Frau i.W.-St.Felix,34,,2,4,6
118 U.L.Frau i.W.-St.Felix,35,,5,9,14
118 U.L.Frau i.W.-St.Felix,36,,7,4,11
118 U.L.Frau i.W.-St.Felix,37,,4,9,13
118 U.L.Frau i.W.-St.Felix,38,,4,4,8
118 U.L.Frau i.W.-St.Felix,39,,8,7,15
118 U.L.Frau i.W.-St.Felix,40,,10,6,16
118 U.L.Frau i.W.-St.Felix,41,,5,8,13
118 U.L.Frau i.W.-St.Felix,42,,16,8,24
118 U.L.Frau i.W.-St.Felix,43,,8,10,18
118 U.L.Frau i.W.-St.Felix,44,,4,4,8
118 U.L.Frau i.W.-St.Felix,45,,8,9,17
118 U.L.Frau i.W.-St.Felix,46,,5,5,10
118 U.L.Frau i.W.-St.Felix,47,,4,2,6
118 U.L.Frau i.W.-St.Felix,48,,3,7,10
118 U.L.Frau i.W.-St.Felix,49,,5,6,11
118 U.L.Frau i.W.-St.Felix,50,,3,4,7
118 U.L.Frau i.W.-St.Felix,51,,7,3,10
118 U.L.Frau i.W.-St.Felix,52,,3,2,5
118 U.L.Frau i.W.-St.Felix,53,,6,3,9
118 U.L.Frau i.W.-St.Felix,54,,6,3,9
118 U.L.Frau i.W.-St.Felix,55,,4,3,7
118 U.L.Frau i.W.-St.Felix,56,,5,-,5
118 U.L.Frau i.W.-St.Felix,57,,4,1,5
118 U.L.Frau i.W.-St.Felix,58,,1,7,8
118 U.L.Frau i.W.-St.Felix,59,,1,5,6
118 U.L.Frau i.W.-St.Felix,60,,3,1,4
118 U.L.Frau i.W.-St.Felix,61,,5,1,6
118 U.L.Frau i.W.-St.Felix,62,,6,4,10
118 U.L.Frau i.W.-St.Felix,63,,5,4,9
118 U.L.Frau i.W.-St.Felix,64,,5,9,14
118 U.L.Frau i.W.-St.Felix,65,,3,1,4
118 U.L.Frau i.W.-St.Felix,66,,1,4,5
118 U.L.Frau i.W.-St.Felix,67,,3,4,7
118 U.L.Frau i.W.-St.Felix,68,,3,-,3
118 U.L.Frau i.W.-St.Felix,69,,5,2,7
118 U.L.Frau i.W.-St.Felix,70,,3,3,6
118 U.L.Frau i.W.-St.Felix,71,,3,3,6
118 U.L.Frau i.W.-St.Felix,72,,5,4,9
118 U.L.Frau i.W.-St.Felix,73,,7,1,8
118 U.L.Frau i.W.-St.Felix,74,,4,1,5
118 U.L.Frau i.W.-St.Felix,75,,4,5,9
118 U.L.Frau i.W.-St.Felix,76,,1,3,4
118 U.L.Frau i.W.-St.Felix,77,,3,4,7
118 U.L.Frau i.W.-St.Felix,78,,3,4,7
118 U.L.Frau i.W.-St.Felix,79,,2,3,5
118 U.L.Frau i.W.-St.Felix,80,,4,5,9
118 U.L.Frau i.W.-St.Felix,81,,3,4,7
118 U.L.Frau i.W.-St.Felix,82,,2,4,6
118 U.L.Frau i.W.-St.Felix,83,,2,-,2
118 U.L.Frau i.W.-St.Felix,84,,-,3,3
118 U.L.Frau i.W.-St.Felix,85,,-,1,1
118 U.L.Frau i.W.-St.Felix,86,,1,2,3
118 U.L.Frau i.W.-St.Felix,88,,1,-,1
118 U.L.Frau i.W.-St.Felix,91,,-,1,1
118 U.L.Frau i.W.-St.Felix,92,,1,-,1
118 U.L.Frau i.W.-St.Felix,93,,1,-,1
118 U.L.Frau i.W.-St.Felix,95,,-,1,1

