Gemeinde,Altersklassen,Geschlecht,Männer,Frauen,Insgesamt
001 Aldein,0,,7,11,18
001 Aldein,1,,7,15,22
001 Aldein,2,,10,8,18
001 Aldein,3,,17,9,26
001 Aldein,4,,15,9,24
001 Aldein,5,,11,10,21
001 Aldein,6,,17,7,24
001 Aldein,7,,13,4,17
001 Aldein,8,,16,14,30
001 Aldein,9,,10,16,26
001 Aldein,10,,15,8,23
001 Aldein,11,,7,8,15
001 Aldein,12,,9,12,21
001 Aldein,13,,14,8,22
001 Aldein,14,,13,12,25
001 Aldein,15,,9,13,22
001 Aldein,16,,7,8,15
001 Aldein,17,,7,6,13
001 Aldein,18,,9,16,25
001 Aldein,19,,11,9,20
001 Aldein,20,,12,8,20
001 Aldein,21,,10,9,19
001 Aldein,22,,16,12,28
001 Aldein,23,,9,8,17
001 Aldein,24,,12,13,25
001 Aldein,25,,14,5,19
001 Aldein,26,,11,13,24
001 Aldein,27,,10,14,24
001 Aldein,28,,9,14,23
001 Aldein,29,,11,8,19
001 Aldein,30,,8,18,26
001 Aldein,31,,10,14,24
001 Aldein,32,,17,14,31
001 Aldein,33,,12,14,26
001 Aldein,34,,14,10,24
001 Aldein,35,,20,11,31
001 Aldein,36,,14,15,29
001 Aldein,37,,13,15,28
001 Aldein,38,,22,7,29
001 Aldein,39,,13,16,29
001 Aldein,40,,6,14,20
001 Aldein,41,,6,19,25
001 Aldein,42,,16,9,25
001 Aldein,43,,14,11,25
001 Aldein,44,,13,6,19
001 Aldein,45,,8,17,25
001 Aldein,46,,17,14,31
001 Aldein,47,,15,9,24
001 Aldein,48,,11,13,24
001 Aldein,49,,7,5,12
001 Aldein,50,,9,10,19
001 Aldein,51,,9,8,17
001 Aldein,52,,10,9,19
001 Aldein,53,,9,6,15
001 Aldein,54,,9,9,18
001 Aldein,55,,7,5,12
001 Aldein,56,,16,10,26
001 Aldein,57,,5,12,17
001 Aldein,58,,8,6,14
001 Aldein,59,,9,9,18
001 Aldein,60,,5,10,15
001 Aldein,61,,7,12,19
001 Aldein,62,,10,5,15
001 Aldein,63,,5,7,12
001 Aldein,64,,11,10,21
001 Aldein,65,,7,12,19
001 Aldein,66,,5,12,17
001 Aldein,67,,6,8,14
001 Aldein,68,,5,8,13
001 Aldein,69,,7,7,14
001 Aldein,70,,5,10,15
001 Aldein,71,,8,6,14
001 Aldein,72,,4,4,8
001 Aldein,73,,14,4,18
001 Aldein,74,,7,4,11
001 Aldein,75,,3,7,10
001 Aldein,76,,6,4,10
001 Aldein,77,,4,5,9
001 Aldein,78,,6,8,14
001 Aldein,79,,5,1,6
001 Aldein,80,,5,5,10
001 Aldein,81,,-,4,4
001 Aldein,82,,1,5,6
001 Aldein,83,,-,7,7
001 Aldein,84,,2,4,6
001 Aldein,85,,1,8,9
001 Aldein,86,,2,8,10
001 Aldein,87,,4,1,5
001 Aldein,88,,-,3,3
001 Aldein,91,,1,-,1
001 Aldein,94,,-,2,2
001 Aldein,95,,-,1,1
001 Aldein,100,,-,1,1
002 Andrian,0,,5,7,12
002 Andrian,1,,8,4,12
002 Andrian,2,,7,6,13
002 Andrian,3,,9,3,12
002 Andrian,4,,7,9,16
002 Andrian,5,,3,3,6
002 Andrian,6,,3,3,6
002 Andrian,7,,6,5,11
002 Andrian,8,,3,6,9
002 Andrian,9,,8,2,10
002 Andrian,10,,9,6,15
002 Andrian,11,,2,11,13
002 Andrian,12,,8,4,12
002 Andrian,13,,7,6,13
002 Andrian,14,,5,5,10
002 Andrian,15,,6,6,12
002 Andrian,16,,5,7,12
002 Andrian,17,,5,5,10
002 Andrian,18,,5,4,9
002 Andrian,19,,11,6,17
002 Andrian,20,,5,8,13
002 Andrian,21,,9,4,13
002 Andrian,22,,1,3,4
002 Andrian,23,,8,5,13
002 Andrian,24,,7,3,10
002 Andrian,25,,10,8,18
002 Andrian,26,,3,7,10
002 Andrian,27,,8,6,14
002 Andrian,28,,6,7,13
002 Andrian,29,,7,4,11
002 Andrian,30,,7,7,14
002 Andrian,31,,6,7,13
002 Andrian,32,,10,4,14
002 Andrian,33,,7,9,16
002 Andrian,34,,12,12,24
002 Andrian,35,,8,10,18
002 Andrian,36,,10,11,21
002 Andrian,37,,14,5,19
002 Andrian,38,,6,7,13
002 Andrian,39,,9,10,19
002 Andrian,40,,9,9,18
002 Andrian,41,,8,7,15
002 Andrian,42,,11,11,22
002 Andrian,43,,8,8,16
002 Andrian,44,,6,12,18
002 Andrian,45,,10,8,18
002 Andrian,46,,7,4,11
002 Andrian,47,,8,4,12
002 Andrian,48,,7,4,11
002 Andrian,49,,7,8,15
002 Andrian,50,,7,5,12
002 Andrian,51,,4,9,13
002 Andrian,52,,2,4,6
002 Andrian,53,,6,3,9
002 Andrian,54,,6,9,15
002 Andrian,55,,2,3,5
002 Andrian,56,,3,3,6
002 Andrian,57,,6,6,12
002 Andrian,58,,4,2,6
002 Andrian,59,,5,4,9
002 Andrian,60,,5,4,9
002 Andrian,61,,7,8,15
002 Andrian,62,,1,3,4
002 Andrian,63,,2,5,7
002 Andrian,64,,6,7,13
002 Andrian,65,,3,5,8
002 Andrian,66,,6,4,10
002 Andrian,67,,3,7,10
002 Andrian,68,,1,7,8
002 Andrian,69,,4,3,7
002 Andrian,70,,5,4,9
002 Andrian,71,,2,2,4
002 Andrian,72,,3,2,5
002 Andrian,73,,5,3,8
002 Andrian,74,,3,4,7
002 Andrian,75,,7,4,11
002 Andrian,76,,3,4,7
002 Andrian,77,,4,2,6
002 Andrian,78,,2,1,3
002 Andrian,79,,1,4,5
002 Andrian,80,,-,2,2
002 Andrian,81,,3,4,7
002 Andrian,82,,1,1,2
002 Andrian,83,,2,4,6
002 Andrian,84,,-,1,1
002 Andrian,85,,1,3,4
002 Andrian,86,,1,3,4
002 Andrian,87,,1,-,1
002 Andrian,88,,2,1,3
002 Andrian,89,,-,1,1
002 Andrian,92,,-,1,1
002 Andrian,93,,1,1,2
002 Andrian,95,,-,1,1
002 Andrian,96,,-,1,1
002 Andrian,100,,-,1,1
003 Altrei,0,,6,5,11
003 Altrei,1,,2,-,2
003 Altrei,2,,3,1,4
003 Altrei,3,,1,1,2
003 Altrei,4,,-,1,1
003 Altrei,5,,4,1,5
003 Altrei,6,,3,1,4
003 Altrei,7,,1,1,2
003 Altrei,8,,3,-,3
003 Altrei,9,,3,1,4
003 Altrei,10,,-,1,1
003 Altrei,11,,-,3,3
003 Altrei,12,,1,2,3
003 Altrei,13,,3,2,5
003 Altrei,14,,3,-,3
003 Altrei,15,,6,3,9
003 Altrei,16,,1,-,1
003 Altrei,17,,3,2,5
003 Altrei,18,,2,2,4
003 Altrei,19,,4,5,9
003 Altrei,20,,2,1,3
003 Altrei,21,,3,2,5
003 Altrei,22,,3,1,4
003 Altrei,23,,3,-,3
003 Altrei,24,,4,1,5
003 Altrei,25,,3,3,6
003 Altrei,26,,3,2,5
003 Altrei,27,,2,3,5
003 Altrei,28,,1,2,3
003 Altrei,29,,2,6,8
003 Altrei,30,,-,2,2
003 Altrei,31,,2,3,5
003 Altrei,32,,3,1,4
003 Altrei,33,,1,-,1
003 Altrei,34,,2,3,5
003 Altrei,35,,3,1,4
003 Altrei,36,,4,3,7
003 Altrei,37,,1,3,4
003 Altrei,38,,3,5,8
003 Altrei,39,,1,4,5
003 Altrei,40,,4,1,5
003 Altrei,41,,3,4,7
003 Altrei,42,,2,5,7
003 Altrei,43,,3,6,9
003 Altrei,44,,2,2,4
003 Altrei,45,,10,2,12
003 Altrei,46,,2,2,4
003 Altrei,47,,5,2,7
003 Altrei,48,,5,3,8
003 Altrei,49,,2,3,5
003 Altrei,50,,1,3,4
003 Altrei,51,,5,1,6
003 Altrei,52,,3,3,6
003 Altrei,53,,1,1,2
003 Altrei,54,,3,2,5
003 Altrei,55,,6,3,9
003 Altrei,56,,5,3,8
003 Altrei,57,,1,2,3
003 Altrei,58,,1,-,1
003 Altrei,59,,3,2,5
003 Altrei,60,,3,2,5
003 Altrei,61,,2,3,5
003 Altrei,62,,3,1,4
003 Altrei,63,,2,3,5
003 Altrei,64,,1,3,4
003 Altrei,65,,3,1,4
003 Altrei,66,,1,3,4
003 Altrei,67,,1,4,5
003 Altrei,68,,2,3,5
003 Altrei,69,,1,1,2
003 Altrei,70,,3,1,4
003 Altrei,71,,3,1,4
003 Altrei,72,,3,2,5
003 Altrei,73,,-,2,2
003 Altrei,74,,3,2,5
003 Altrei,75,,-,3,3
003 Altrei,76,,-,2,2
003 Altrei,77,,2,2,4
003 Altrei,78,,2,2,4
003 Altrei,79,,-,2,2
003 Altrei,80,,2,3,5
003 Altrei,81,,1,4,5
003 Altrei,83,,-,2,2
003 Altrei,84,,-,1,1
003 Altrei,85,,1,1,2
003 Altrei,86,,-,1,1
003 Altrei,90,,-,2,2
003 Altrei,92,,-,1,1
003 Altrei,93,,-,1,1
003 Altrei,94,,1,-,1
003 Altrei,96,,-,2,2
003 Altrei,99,,-,1,1
004 Eppan a.d. Weinstr.,0,,68,68,136
004 Eppan a.d. Weinstr.,1,,105,75,180
004 Eppan a.d. Weinstr.,2,,78,105,183
004 Eppan a.d. Weinstr.,3,,84,63,147
004 Eppan a.d. Weinstr.,4,,82,70,152
004 Eppan a.d. Weinstr.,5,,81,76,157
004 Eppan a.d. Weinstr.,6,,76,77,153
004 Eppan a.d. Weinstr.,7,,71,78,149
004 Eppan a.d. Weinstr.,8,,92,58,150
004 Eppan a.d. Weinstr.,9,,83,83,166
004 Eppan a.d. Weinstr.,10,,72,70,142
004 Eppan a.d. Weinstr.,11,,76,71,147
004 Eppan a.d. Weinstr.,12,,72,70,142
004 Eppan a.d. Weinstr.,13,,75,79,154
004 Eppan a.d. Weinstr.,14,,83,85,168
004 Eppan a.d. Weinstr.,15,,69,71,140
004 Eppan a.d. Weinstr.,16,,83,63,146
004 Eppan a.d. Weinstr.,17,,84,61,145
004 Eppan a.d. Weinstr.,18,,79,63,142
004 Eppan a.d. Weinstr.,19,,78,82,160
004 Eppan a.d. Weinstr.,20,,73,64,137
004 Eppan a.d. Weinstr.,21,,90,77,167
004 Eppan a.d. Weinstr.,22,,83,59,142
004 Eppan a.d. Weinstr.,23,,85,79,164
004 Eppan a.d. Weinstr.,24,,81,89,170
004 Eppan a.d. Weinstr.,25,,76,78,154
004 Eppan a.d. Weinstr.,26,,63,85,148
004 Eppan a.d. Weinstr.,27,,92,85,177
004 Eppan a.d. Weinstr.,28,,84,80,164
004 Eppan a.d. Weinstr.,29,,94,96,190
004 Eppan a.d. Weinstr.,30,,85,87,172
004 Eppan a.d. Weinstr.,31,,94,91,185
004 Eppan a.d. Weinstr.,32,,88,104,192
004 Eppan a.d. Weinstr.,33,,94,105,199
004 Eppan a.d. Weinstr.,34,,108,98,206
004 Eppan a.d. Weinstr.,35,,109,132,241
004 Eppan a.d. Weinstr.,36,,107,103,210
004 Eppan a.d. Weinstr.,37,,128,120,248
004 Eppan a.d. Weinstr.,38,,137,125,262
004 Eppan a.d. Weinstr.,39,,124,119,243
004 Eppan a.d. Weinstr.,40,,128,123,251
004 Eppan a.d. Weinstr.,41,,128,138,266
004 Eppan a.d. Weinstr.,42,,107,113,220
004 Eppan a.d. Weinstr.,43,,133,116,249
004 Eppan a.d. Weinstr.,44,,106,125,231
004 Eppan a.d. Weinstr.,45,,124,114,238
004 Eppan a.d. Weinstr.,46,,124,105,229
004 Eppan a.d. Weinstr.,47,,112,117,229
004 Eppan a.d. Weinstr.,48,,112,111,223
004 Eppan a.d. Weinstr.,49,,104,105,209
004 Eppan a.d. Weinstr.,50,,96,96,192
004 Eppan a.d. Weinstr.,51,,92,78,170
004 Eppan a.d. Weinstr.,52,,87,88,175
004 Eppan a.d. Weinstr.,53,,71,84,155
004 Eppan a.d. Weinstr.,54,,88,78,166
004 Eppan a.d. Weinstr.,55,,69,83,152
004 Eppan a.d. Weinstr.,56,,84,66,150
004 Eppan a.d. Weinstr.,57,,56,73,129
004 Eppan a.d. Weinstr.,58,,62,60,122
004 Eppan a.d. Weinstr.,59,,79,70,149
004 Eppan a.d. Weinstr.,60,,61,81,142
004 Eppan a.d. Weinstr.,61,,82,71,153
004 Eppan a.d. Weinstr.,62,,56,48,104
004 Eppan a.d. Weinstr.,63,,72,83,155
004 Eppan a.d. Weinstr.,64,,93,82,175
004 Eppan a.d. Weinstr.,65,,87,80,167
004 Eppan a.d. Weinstr.,66,,62,104,166
004 Eppan a.d. Weinstr.,67,,72,56,128
004 Eppan a.d. Weinstr.,68,,58,79,137
004 Eppan a.d. Weinstr.,69,,55,51,106
004 Eppan a.d. Weinstr.,70,,43,57,100
004 Eppan a.d. Weinstr.,71,,45,47,92
004 Eppan a.d. Weinstr.,72,,34,46,80
004 Eppan a.d. Weinstr.,73,,31,48,79
004 Eppan a.d. Weinstr.,74,,50,52,102
004 Eppan a.d. Weinstr.,75,,40,48,88
004 Eppan a.d. Weinstr.,76,,32,56,88
004 Eppan a.d. Weinstr.,77,,44,58,102
004 Eppan a.d. Weinstr.,78,,34,50,84
004 Eppan a.d. Weinstr.,79,,33,39,72
004 Eppan a.d. Weinstr.,80,,26,41,67
004 Eppan a.d. Weinstr.,81,,29,46,75
004 Eppan a.d. Weinstr.,82,,29,47,76
004 Eppan a.d. Weinstr.,83,,15,51,66
004 Eppan a.d. Weinstr.,84,,15,34,49
004 Eppan a.d. Weinstr.,85,,10,34,44
004 Eppan a.d. Weinstr.,86,,15,30,45
004 Eppan a.d. Weinstr.,87,,10,21,31
004 Eppan a.d. Weinstr.,88,,7,14,21
004 Eppan a.d. Weinstr.,89,,8,10,18
004 Eppan a.d. Weinstr.,90,,7,5,12
004 Eppan a.d. Weinstr.,91,,3,7,10
004 Eppan a.d. Weinstr.,92,,1,5,6
004 Eppan a.d. Weinstr.,93,,4,8,12
004 Eppan a.d. Weinstr.,94,,1,5,6
004 Eppan a.d. Weinstr.,95,,-,8,8
004 Eppan a.d. Weinstr.,96,,2,10,12
004 Eppan a.d. Weinstr.,97,,-,2,2
004 Eppan a.d. Weinstr.,98,,3,5,8
004 Eppan a.d. Weinstr.,99,,-,2,2
004 Eppan a.d. Weinstr.,100,,-,1,1
004 Eppan a.d. Weinstr.,102,,1,-,1
004 Eppan a.d. Weinstr.,103,,-,1,1
005 Hafling,0,,2,3,5
005 Hafling,1,,5,5,10
005 Hafling,2,,5,4,9
005 Hafling,3,,4,8,12
005 Hafling,4,,1,6,7
005 Hafling,5,,4,4,8
005 Hafling,6,,4,3,7
005 Hafling,7,,5,9,14
005 Hafling,8,,5,3,8
005 Hafling,9,,3,8,11
005 Hafling,10,,2,10,12
005 Hafling,11,,11,4,15
005 Hafling,12,,6,4,10
005 Hafling,13,,4,5,9
005 Hafling,14,,2,7,9
005 Hafling,15,,3,4,7
005 Hafling,16,,8,3,11
005 Hafling,17,,4,6,10
005 Hafling,18,,4,2,6
005 Hafling,19,,2,7,9
005 Hafling,20,,4,4,8
005 Hafling,21,,5,2,7
005 Hafling,22,,5,5,10
005 Hafling,23,,4,7,11
005 Hafling,24,,2,-,2
005 Hafling,25,,6,4,10
005 Hafling,26,,4,5,9
005 Hafling,27,,4,8,12
005 Hafling,28,,5,4,9
005 Hafling,29,,4,6,10
005 Hafling,30,,5,5,10
005 Hafling,31,,5,7,12
005 Hafling,32,,6,6,12
005 Hafling,33,,6,10,16
005 Hafling,34,,9,1,10
005 Hafling,35,,9,2,11
005 Hafling,36,,12,5,17
005 Hafling,37,,8,6,14
005 Hafling,38,,7,11,18
005 Hafling,39,,2,9,11
005 Hafling,40,,4,3,7
005 Hafling,41,,10,8,18
005 Hafling,42,,7,12,19
005 Hafling,43,,3,2,5
005 Hafling,44,,7,2,9
005 Hafling,45,,6,2,8
005 Hafling,46,,5,3,8
005 Hafling,47,,9,7,16
005 Hafling,48,,6,5,11
005 Hafling,49,,3,4,7
005 Hafling,50,,1,4,5
005 Hafling,51,,3,10,13
005 Hafling,52,,7,3,10
005 Hafling,53,,3,1,4
005 Hafling,54,,2,3,5
005 Hafling,55,,5,2,7
005 Hafling,56,,2,3,5
005 Hafling,57,,5,3,8
005 Hafling,58,,5,4,9
005 Hafling,59,,6,2,8
005 Hafling,60,,2,4,6
005 Hafling,61,,-,4,4
005 Hafling,62,,4,3,7
005 Hafling,63,,1,3,4
005 Hafling,64,,5,4,9
005 Hafling,65,,6,3,9
005 Hafling,66,,4,4,8
005 Hafling,67,,2,1,3
005 Hafling,68,,4,5,9
005 Hafling,69,,3,3,6
005 Hafling,70,,3,1,4
005 Hafling,71,,1,1,2
005 Hafling,72,,2,1,3
005 Hafling,73,,-,2,2
005 Hafling,74,,4,3,7
005 Hafling,75,,3,4,7
005 Hafling,76,,3,6,9
005 Hafling,77,,1,4,5
005 Hafling,78,,3,1,4
005 Hafling,79,,-,3,3
005 Hafling,80,,3,3,6
005 Hafling,81,,-,2,2
005 Hafling,82,,1,-,1
005 Hafling,83,,1,1,2
005 Hafling,84,,1,-,1
005 Hafling,85,,-,2,2
005 Hafling,86,,-,3,3
005 Hafling,87,,3,1,4
005 Hafling,88,,-,1,1
005 Hafling,90,,-,1,1
005 Hafling,91,,-,1,1
005 Hafling,96,,1,-,1
006 Abtei,0,,28,23,51
006 Abtei,1,,29,21,50
006 Abtei,2,,20,27,47
006 Abtei,3,,26,16,42
006 Abtei,4,,21,19,40
006 Abtei,5,,13,31,44
006 Abtei,6,,25,24,49
006 Abtei,7,,23,32,55
006 Abtei,8,,21,26,47
006 Abtei,9,,15,14,29
006 Abtei,10,,26,22,48
006 Abtei,11,,29,15,44
006 Abtei,12,,24,30,54
006 Abtei,13,,19,15,34
006 Abtei,14,,16,18,34
006 Abtei,15,,24,14,38
006 Abtei,16,,21,13,34
006 Abtei,17,,23,16,39
006 Abtei,18,,15,16,31
006 Abtei,19,,15,11,26
006 Abtei,20,,19,12,31
006 Abtei,21,,17,18,35
006 Abtei,22,,11,11,22
006 Abtei,23,,13,20,33
006 Abtei,24,,14,12,26
006 Abtei,25,,20,20,40
006 Abtei,26,,17,19,36
006 Abtei,27,,25,19,44
006 Abtei,28,,13,22,35
006 Abtei,29,,24,31,55
006 Abtei,30,,21,33,54
006 Abtei,31,,27,24,51
006 Abtei,32,,16,31,47
006 Abtei,33,,20,28,48
006 Abtei,34,,27,23,50
006 Abtei,35,,44,33,77
006 Abtei,36,,17,33,50
006 Abtei,37,,29,31,60
006 Abtei,38,,29,35,64
006 Abtei,39,,28,35,63
006 Abtei,40,,34,33,67
006 Abtei,41,,23,32,55
006 Abtei,42,,37,25,62
006 Abtei,43,,23,31,54
006 Abtei,44,,31,26,57
006 Abtei,45,,25,31,56
006 Abtei,46,,25,27,52
006 Abtei,47,,27,23,50
006 Abtei,48,,25,23,48
006 Abtei,49,,19,23,42
006 Abtei,50,,20,15,35
006 Abtei,51,,19,17,36
006 Abtei,52,,17,15,32
006 Abtei,53,,12,16,28
006 Abtei,54,,14,20,34
006 Abtei,55,,15,13,28
006 Abtei,56,,12,13,25
006 Abtei,57,,15,19,34
006 Abtei,58,,10,19,29
006 Abtei,59,,24,17,41
006 Abtei,60,,15,16,31
006 Abtei,61,,23,19,42
006 Abtei,62,,15,20,35
006 Abtei,63,,13,17,30
006 Abtei,64,,13,11,24
006 Abtei,65,,21,12,33
006 Abtei,66,,16,23,39
006 Abtei,67,,16,18,34
006 Abtei,68,,15,13,28
006 Abtei,69,,15,17,32
006 Abtei,70,,6,18,24
006 Abtei,71,,16,9,25
006 Abtei,72,,12,18,30
006 Abtei,73,,13,15,28
006 Abtei,74,,8,15,23
006 Abtei,75,,7,5,12
006 Abtei,76,,10,12,22
006 Abtei,77,,14,11,25
006 Abtei,78,,5,7,12
006 Abtei,79,,5,13,18
006 Abtei,80,,6,9,15
006 Abtei,81,,5,6,11
006 Abtei,82,,7,4,11
006 Abtei,83,,5,9,14
006 Abtei,84,,4,8,12
006 Abtei,85,,5,5,10
006 Abtei,86,,2,2,4
006 Abtei,87,,3,7,10
006 Abtei,88,,1,3,4
006 Abtei,89,,1,1,2
006 Abtei,91,,1,2,3
006 Abtei,92,,-,2,2
006 Abtei,93,,-,2,2
006 Abtei,94,,1,-,1
006 Abtei,95,,-,3,3
006 Abtei,97,,1,-,1
007 Barbian,0,,9,11,20
007 Barbian,1,,6,3,9
007 Barbian,2,,14,6,20
007 Barbian,3,,7,5,12
007 Barbian,4,,8,14,22
007 Barbian,5,,7,6,13
007 Barbian,6,,11,14,25
007 Barbian,7,,14,5,19
007 Barbian,8,,11,10,21
007 Barbian,9,,16,8,24
007 Barbian,10,,8,8,16
007 Barbian,11,,12,10,22
007 Barbian,12,,12,8,20
007 Barbian,13,,9,5,14
007 Barbian,14,,10,13,23
007 Barbian,15,,12,7,19
007 Barbian,16,,12,12,24
007 Barbian,17,,15,14,29
007 Barbian,18,,8,13,21
007 Barbian,19,,12,6,18
007 Barbian,20,,8,7,15
007 Barbian,21,,14,7,21
007 Barbian,22,,7,7,14
007 Barbian,23,,10,6,16
007 Barbian,24,,11,11,22
007 Barbian,25,,9,7,16
007 Barbian,26,,12,14,26
007 Barbian,27,,10,6,16
007 Barbian,28,,17,12,29
007 Barbian,29,,10,11,21
007 Barbian,30,,9,15,24
007 Barbian,31,,9,12,21
007 Barbian,32,,12,11,23
007 Barbian,33,,11,11,22
007 Barbian,34,,10,17,27
007 Barbian,35,,18,13,31
007 Barbian,36,,16,10,26
007 Barbian,37,,11,12,23
007 Barbian,38,,15,7,22
007 Barbian,39,,13,11,24
007 Barbian,40,,9,8,17
007 Barbian,41,,12,13,25
007 Barbian,42,,8,13,21
007 Barbian,43,,15,15,30
007 Barbian,44,,14,14,28
007 Barbian,45,,15,16,31
007 Barbian,46,,18,11,29
007 Barbian,47,,13,15,28
007 Barbian,48,,12,9,21
007 Barbian,49,,7,9,16
007 Barbian,50,,14,7,21
007 Barbian,51,,4,9,13
007 Barbian,52,,7,6,13
007 Barbian,53,,7,14,21
007 Barbian,54,,8,9,17
007 Barbian,55,,7,5,12
007 Barbian,56,,7,10,17
007 Barbian,57,,10,11,21
007 Barbian,58,,5,6,11
007 Barbian,59,,3,5,8
007 Barbian,60,,5,11,16
007 Barbian,61,,17,6,23
007 Barbian,62,,7,4,11
007 Barbian,63,,10,10,20
007 Barbian,64,,8,7,15
007 Barbian,65,,11,11,22
007 Barbian,66,,8,12,20
007 Barbian,67,,9,3,12
007 Barbian,68,,6,4,10
007 Barbian,69,,5,10,15
007 Barbian,70,,8,8,16
007 Barbian,71,,3,5,8
007 Barbian,72,,3,6,9
007 Barbian,73,,5,5,10
007 Barbian,74,,7,4,11
007 Barbian,75,,8,6,14
007 Barbian,76,,4,7,11
007 Barbian,77,,5,5,10
007 Barbian,78,,7,7,14
007 Barbian,79,,4,8,12
007 Barbian,80,,4,2,6
007 Barbian,81,,3,2,5
007 Barbian,82,,3,2,5
007 Barbian,83,,1,4,5
007 Barbian,84,,-,4,4
007 Barbian,85,,2,3,5
007 Barbian,86,,1,2,3
007 Barbian,87,,1,2,3
007 Barbian,88,,-,1,1
007 Barbian,89,,1,-,1
007 Barbian,90,,-,1,1
007 Barbian,91,,-,1,1
007 Barbian,93,,1,-,1
007 Barbian,96,,1,-,1
008 Bozen,0,,525,450,975
008 Bozen,1,,457,483,940
008 Bozen,2,,522,455,977
008 Bozen,3,,504,464,968
008 Bozen,4,,507,496,1.003
008 Bozen,5,,491,439,930
008 Bozen,6,,491,448,939
008 Bozen,7,,449,466,915
008 Bozen,8,,485,461,946
008 Bozen,9,,465,456,921
008 Bozen,10,,472,400,872
008 Bozen,11,,447,475,922
008 Bozen,12,,441,393,834
008 Bozen,13,,472,445,917
008 Bozen,14,,415,440,855
008 Bozen,15,,445,403,848
008 Bozen,16,,484,412,896
008 Bozen,17,,459,422,881
008 Bozen,18,,454,427,881
008 Bozen,19,,461,419,880
008 Bozen,20,,379,403,782
008 Bozen,21,,432,400,832
008 Bozen,22,,458,417,875
008 Bozen,23,,459,450,909
008 Bozen,24,,522,436,958
008 Bozen,25,,514,458,972
008 Bozen,26,,546,467,1.013
008 Bozen,27,,628,494,1.122
008 Bozen,28,,541,546,1.087
008 Bozen,29,,584,551,1.135
008 Bozen,30,,604,571,1.175
008 Bozen,31,,649,642,1.291
008 Bozen,32,,687,687,1.374
008 Bozen,33,,754,746,1.500
008 Bozen,34,,701,807,1.508
008 Bozen,35,,842,801,1.643
008 Bozen,36,,859,864,1.723
008 Bozen,37,,831,789,1.620
008 Bozen,38,,912,863,1.775
008 Bozen,39,,822,781,1.603
008 Bozen,40,,808,837,1.645
008 Bozen,41,,884,874,1.758
008 Bozen,42,,928,884,1.812
008 Bozen,43,,895,903,1.798
008 Bozen,44,,768,855,1.623
008 Bozen,45,,764,792,1.556
008 Bozen,46,,768,730,1.498
008 Bozen,47,,705,729,1.434
008 Bozen,48,,700,694,1.394
008 Bozen,49,,700,703,1.403
008 Bozen,50,,610,727,1.337
008 Bozen,51,,632,665,1.297
008 Bozen,52,,599,637,1.236
008 Bozen,53,,605,607,1.212
008 Bozen,54,,538,624,1.162
008 Bozen,55,,538,645,1.183
008 Bozen,56,,530,630,1.160
008 Bozen,57,,579,678,1.257
008 Bozen,58,,581,637,1.218
008 Bozen,59,,628,725,1.353
008 Bozen,60,,608,795,1.403
008 Bozen,61,,693,870,1.563
008 Bozen,62,,526,580,1.106
008 Bozen,63,,569,704,1.273
008 Bozen,64,,620,717,1.337
008 Bozen,65,,627,699,1.326
008 Bozen,66,,666,740,1.406
008 Bozen,67,,638,711,1.349
008 Bozen,68,,561,711,1.272
008 Bozen,69,,600,655,1.255
008 Bozen,70,,526,569,1.095
008 Bozen,71,,467,550,1.017
008 Bozen,72,,452,561,1.013
008 Bozen,73,,466,548,1.014
008 Bozen,74,,385,550,935
008 Bozen,75,,407,552,959
008 Bozen,76,,402,547,949
008 Bozen,77,,389,528,917
008 Bozen,78,,270,486,756
008 Bozen,79,,308,466,774
008 Bozen,80,,275,454,729
008 Bozen,81,,316,431,747
008 Bozen,82,,234,460,694
008 Bozen,83,,220,403,623
008 Bozen,84,,203,417,620
008 Bozen,85,,181,424,605
008 Bozen,86,,165,361,526
008 Bozen,87,,122,323,445
008 Bozen,88,,63,195,258
008 Bozen,89,,37,106,143
008 Bozen,90,,35,92,127
008 Bozen,91,,36,103,139
008 Bozen,92,,32,129,161
008 Bozen,93,,38,107,145
008 Bozen,94,,25,89,114
008 Bozen,95,,20,66,86
008 Bozen,96,,8,49,57
008 Bozen,97,,5,30,35
008 Bozen,98,,6,20,26
008 Bozen,99,,4,15,19
008 Bozen,100,,1,9,10
008 Bozen,101,,1,6,7
008 Bozen,102,,1,4,5
008 Bozen,103,,-,1,1
008 Bozen,106,,-,2,2
009 Prags,0,,3,6,9
009 Prags,1,,4,3,7
009 Prags,2,,3,2,5
009 Prags,3,,3,3,6
009 Prags,4,,2,5,7
009 Prags,5,,2,5,7
009 Prags,6,,6,6,12
009 Prags,7,,2,3,5
009 Prags,8,,5,9,14
009 Prags,9,,1,4,5
009 Prags,10,,3,5,8
009 Prags,11,,2,7,9
009 Prags,12,,3,1,4
009 Prags,13,,4,6,10
009 Prags,14,,7,3,10
009 Prags,15,,6,2,8
009 Prags,16,,8,1,9
009 Prags,17,,5,2,7
009 Prags,18,,8,3,11
009 Prags,19,,2,3,5
009 Prags,20,,3,3,6
009 Prags,21,,7,5,12
009 Prags,22,,8,2,10
009 Prags,23,,5,3,8
009 Prags,24,,3,5,8
009 Prags,25,,3,6,9
009 Prags,26,,2,5,7
009 Prags,27,,5,1,6
009 Prags,28,,2,1,3
009 Prags,29,,6,5,11
009 Prags,30,,4,4,8
009 Prags,31,,5,4,9
009 Prags,32,,4,5,9
009 Prags,33,,2,4,6
009 Prags,34,,7,4,11
009 Prags,35,,3,3,6
009 Prags,36,,6,4,10
009 Prags,37,,4,7,11
009 Prags,38,,8,5,13
009 Prags,39,,8,8,16
009 Prags,40,,7,6,13
009 Prags,41,,7,5,12
009 Prags,42,,8,7,15
009 Prags,43,,6,4,10
009 Prags,44,,6,5,11
009 Prags,45,,3,4,7
009 Prags,46,,5,12,17
009 Prags,47,,6,3,9
009 Prags,48,,12,5,17
009 Prags,49,,6,2,8
009 Prags,50,,6,4,10
009 Prags,51,,1,5,6
009 Prags,52,,4,5,9
009 Prags,53,,6,4,10
009 Prags,54,,4,2,6
009 Prags,55,,2,5,7
009 Prags,56,,3,1,4
009 Prags,57,,5,1,6
009 Prags,58,,1,1,2
009 Prags,59,,4,1,5
009 Prags,60,,1,-,1
009 Prags,61,,2,4,6
009 Prags,62,,2,2,4
009 Prags,63,,4,4,8
009 Prags,64,,1,3,4
009 Prags,65,,4,4,8
009 Prags,66,,5,2,7
009 Prags,67,,1,3,4
009 Prags,68,,3,5,8
009 Prags,69,,3,2,5
009 Prags,70,,-,2,2
009 Prags,71,,2,3,5
009 Prags,72,,1,3,4
009 Prags,73,,3,2,5
009 Prags,74,,3,2,5
009 Prags,75,,4,5,9
009 Prags,76,,1,3,4
009 Prags,77,,1,1,2
009 Prags,78,,1,2,3
009 Prags,79,,3,2,5
009 Prags,80,,2,5,7
009 Prags,81,,2,4,6
009 Prags,82,,1,4,5
009 Prags,83,,3,2,5
009 Prags,84,,-,4,4
009 Prags,85,,2,1,3
009 Prags,86,,1,2,3
009 Prags,88,,-,2,2
009 Prags,91,,-,1,1
009 Prags,92,,-,1,1
010 Brenner,0,,9,8,17
010 Brenner,1,,5,13,18
010 Brenner,2,,11,10,21
010 Brenner,3,,11,18,29
010 Brenner,4,,10,6,16
010 Brenner,5,,13,13,26
010 Brenner,6,,6,6,12
010 Brenner,7,,15,11,26
010 Brenner,8,,11,14,25
010 Brenner,9,,17,5,22
010 Brenner,10,,17,6,23
010 Brenner,11,,5,11,16
010 Brenner,12,,5,11,16
010 Brenner,13,,19,11,30
010 Brenner,14,,15,7,22
010 Brenner,15,,11,9,20
010 Brenner,16,,8,16,24
010 Brenner,17,,9,7,16
010 Brenner,18,,14,6,20
010 Brenner,19,,11,5,16
010 Brenner,20,,7,8,15
010 Brenner,21,,12,10,22
010 Brenner,22,,21,8,29
010 Brenner,23,,17,15,32
010 Brenner,24,,18,16,34
010 Brenner,25,,12,8,20
010 Brenner,26,,13,22,35
010 Brenner,27,,14,17,31
010 Brenner,28,,13,14,27
010 Brenner,29,,17,15,32
010 Brenner,30,,22,7,29
010 Brenner,31,,15,10,25
010 Brenner,32,,14,18,32
010 Brenner,33,,18,9,27
010 Brenner,34,,14,9,23
010 Brenner,35,,20,24,44
010 Brenner,36,,25,12,37
010 Brenner,37,,22,18,40
010 Brenner,38,,12,17,29
010 Brenner,39,,11,19,30
010 Brenner,40,,18,14,32
010 Brenner,41,,20,17,37
010 Brenner,42,,23,18,41
010 Brenner,43,,22,16,38
010 Brenner,44,,12,20,32
010 Brenner,45,,16,12,28
010 Brenner,46,,19,11,30
010 Brenner,47,,22,12,34
010 Brenner,48,,17,12,29
010 Brenner,49,,19,9,28
010 Brenner,50,,15,20,35
010 Brenner,51,,18,13,31
010 Brenner,52,,14,9,23
010 Brenner,53,,10,14,24
010 Brenner,54,,9,15,24
010 Brenner,55,,20,8,28
010 Brenner,56,,15,11,26
010 Brenner,57,,10,11,21
010 Brenner,58,,17,16,33
010 Brenner,59,,6,8,14
010 Brenner,60,,19,13,32
010 Brenner,61,,8,16,24
010 Brenner,62,,6,9,15
010 Brenner,63,,17,12,29
010 Brenner,64,,16,12,28
010 Brenner,65,,5,9,14
010 Brenner,66,,11,12,23
010 Brenner,67,,8,11,19
010 Brenner,68,,7,10,17
010 Brenner,69,,10,14,24
010 Brenner,70,,9,14,23
010 Brenner,71,,12,7,19
010 Brenner,72,,4,6,10
010 Brenner,73,,7,7,14
010 Brenner,74,,6,6,12
010 Brenner,75,,2,4,6
010 Brenner,76,,5,9,14
010 Brenner,77,,8,12,20
010 Brenner,78,,9,10,19
010 Brenner,79,,7,8,15
010 Brenner,80,,5,3,8
010 Brenner,81,,8,9,17
010 Brenner,82,,2,7,9
010 Brenner,83,,2,7,9
010 Brenner,84,,3,10,13
010 Brenner,85,,-,5,5
010 Brenner,86,,1,1,2
010 Brenner,87,,1,5,6
010 Brenner,88,,1,2,3
010 Brenner,89,,1,-,1
010 Brenner,92,,-,1,1
010 Brenner,93,,1,2,3
010 Brenner,95,,-,2,2
011 Brixen,0,,115,99,214
011 Brixen,1,,118,102,220
011 Brixen,2,,125,113,238
011 Brixen,3,,113,114,227
011 Brixen,4,,108,107,215
011 Brixen,5,,112,109,221
011 Brixen,6,,122,125,247
011 Brixen,7,,117,110,227
011 Brixen,8,,136,126,262
011 Brixen,9,,110,133,243
011 Brixen,10,,123,109,232
011 Brixen,11,,119,113,232
011 Brixen,12,,115,122,237
011 Brixen,13,,123,118,241
011 Brixen,14,,115,105,220
011 Brixen,15,,113,125,238
011 Brixen,16,,117,104,221
011 Brixen,17,,102,108,210
011 Brixen,18,,120,99,219
011 Brixen,19,,121,100,221
011 Brixen,20,,98,105,203
011 Brixen,21,,104,117,221
011 Brixen,22,,114,85,199
011 Brixen,23,,119,95,214
011 Brixen,24,,122,125,247
011 Brixen,25,,128,118,246
011 Brixen,26,,134,117,251
011 Brixen,27,,113,114,227
011 Brixen,28,,132,130,262
011 Brixen,29,,108,131,239
011 Brixen,30,,138,119,257
011 Brixen,31,,132,152,284
011 Brixen,32,,122,131,253
011 Brixen,33,,138,156,294
011 Brixen,34,,166,157,323
011 Brixen,35,,161,156,317
011 Brixen,36,,161,173,334
011 Brixen,37,,176,157,333
011 Brixen,38,,195,185,380
011 Brixen,39,,178,201,379
011 Brixen,40,,172,165,337
011 Brixen,41,,179,186,365
011 Brixen,42,,187,157,344
011 Brixen,43,,186,180,366
011 Brixen,44,,153,166,319
011 Brixen,45,,169,161,330
011 Brixen,46,,140,169,309
011 Brixen,47,,141,152,293
011 Brixen,48,,149,137,286
011 Brixen,49,,153,122,275
011 Brixen,50,,135,145,280
011 Brixen,51,,115,135,250
011 Brixen,52,,124,96,220
011 Brixen,53,,95,115,210
011 Brixen,54,,91,106,197
011 Brixen,55,,100,103,203
011 Brixen,56,,99,108,207
011 Brixen,57,,110,101,211
011 Brixen,58,,79,125,204
011 Brixen,59,,107,118,225
011 Brixen,60,,91,114,205
011 Brixen,61,,100,105,205
011 Brixen,62,,65,100,165
011 Brixen,63,,115,110,225
011 Brixen,64,,127,119,246
011 Brixen,65,,92,98,190
011 Brixen,66,,103,123,226
011 Brixen,67,,84,117,201
011 Brixen,68,,92,110,202
011 Brixen,69,,86,94,180
011 Brixen,70,,87,91,178
011 Brixen,71,,66,90,156
011 Brixen,72,,79,83,162
011 Brixen,73,,64,90,154
011 Brixen,74,,69,64,133
011 Brixen,75,,73,76,149
011 Brixen,76,,61,80,141
011 Brixen,77,,59,91,150
011 Brixen,78,,46,84,130
011 Brixen,79,,54,68,122
011 Brixen,80,,35,79,114
011 Brixen,81,,40,64,104
011 Brixen,82,,42,68,110
011 Brixen,83,,27,68,95
011 Brixen,84,,35,54,89
011 Brixen,85,,20,59,79
011 Brixen,86,,19,57,76
011 Brixen,87,,17,47,64
011 Brixen,88,,12,30,42
011 Brixen,89,,5,20,25
011 Brixen,90,,11,24,35
011 Brixen,91,,3,12,15
011 Brixen,92,,2,17,19
011 Brixen,93,,7,16,23
011 Brixen,94,,2,10,12
011 Brixen,95,,2,18,20
011 Brixen,96,,1,11,12
011 Brixen,97,,-,9,9
011 Brixen,98,,1,2,3
011 Brixen,99,,-,2,2
011 Brixen,100,,-,3,3
012 Branzoll,0,,11,18,29
012 Branzoll,1,,13,9,22
012 Branzoll,2,,8,9,17
012 Branzoll,3,,17,16,33
012 Branzoll,4,,17,25,42
012 Branzoll,5,,15,12,27
012 Branzoll,6,,12,12,24
012 Branzoll,7,,21,7,28
012 Branzoll,8,,9,14,23
012 Branzoll,9,,15,7,22
012 Branzoll,10,,13,21,34
012 Branzoll,11,,16,8,24
012 Branzoll,12,,13,12,25
012 Branzoll,13,,15,8,23
012 Branzoll,14,,20,14,34
012 Branzoll,15,,14,16,30
012 Branzoll,16,,16,16,32
012 Branzoll,17,,14,18,32
012 Branzoll,18,,11,13,24
012 Branzoll,19,,16,13,29
012 Branzoll,20,,12,5,17
012 Branzoll,21,,9,13,22
012 Branzoll,22,,13,17,30
012 Branzoll,23,,17,10,27
012 Branzoll,24,,14,11,25
012 Branzoll,25,,18,14,32
012 Branzoll,26,,14,16,30
012 Branzoll,27,,10,16,26
012 Branzoll,28,,13,10,23
012 Branzoll,29,,15,20,35
012 Branzoll,30,,18,27,45
012 Branzoll,31,,14,19,33
012 Branzoll,32,,25,16,41
012 Branzoll,33,,24,27,51
012 Branzoll,34,,21,14,35
012 Branzoll,35,,22,17,39
012 Branzoll,36,,24,29,53
012 Branzoll,37,,19,24,43
012 Branzoll,38,,28,24,52
012 Branzoll,39,,21,26,47
012 Branzoll,40,,21,24,45
012 Branzoll,41,,21,18,39
012 Branzoll,42,,24,22,46
012 Branzoll,43,,28,26,54
012 Branzoll,44,,18,17,35
012 Branzoll,45,,18,17,35
012 Branzoll,46,,30,27,57
012 Branzoll,47,,27,20,47
012 Branzoll,48,,18,23,41
012 Branzoll,49,,19,18,37
012 Branzoll,50,,20,15,35
012 Branzoll,51,,13,16,29
012 Branzoll,52,,17,19,36
012 Branzoll,53,,21,16,37
012 Branzoll,54,,11,20,31
012 Branzoll,55,,14,20,34
012 Branzoll,56,,17,14,31
012 Branzoll,57,,18,15,33
012 Branzoll,58,,18,15,33
012 Branzoll,59,,15,16,31
012 Branzoll,60,,15,18,33
012 Branzoll,61,,15,20,35
012 Branzoll,62,,14,11,25
012 Branzoll,63,,12,11,23
012 Branzoll,64,,14,11,25
012 Branzoll,65,,18,10,28
012 Branzoll,66,,20,12,32
012 Branzoll,67,,11,13,24
012 Branzoll,68,,14,12,26
012 Branzoll,69,,9,11,20
012 Branzoll,70,,3,9,12
012 Branzoll,71,,8,8,16
012 Branzoll,72,,8,8,16
012 Branzoll,73,,5,10,15
012 Branzoll,74,,19,10,29
012 Branzoll,75,,8,11,19
012 Branzoll,76,,2,10,12
012 Branzoll,77,,7,15,22
012 Branzoll,78,,4,10,14
012 Branzoll,79,,4,9,13
012 Branzoll,80,,4,7,11
012 Branzoll,81,,4,9,13
012 Branzoll,82,,4,5,9
012 Branzoll,83,,1,6,7
012 Branzoll,84,,6,10,16
012 Branzoll,85,,-,3,3
012 Branzoll,86,,4,6,10
012 Branzoll,87,,1,4,5
012 Branzoll,88,,1,4,5
012 Branzoll,89,,2,3,5
012 Branzoll,93,,-,4,4
012 Branzoll,95,,-,2,2
012 Branzoll,96,,1,-,1
012 Branzoll,98,,-,1,1
013 Bruneck,0,,82,66,148
013 Bruneck,1,,103,73,176
013 Bruneck,2,,75,83,158
013 Bruneck,3,,86,96,182
013 Bruneck,4,,93,71,164
013 Bruneck,5,,72,90,162
013 Bruneck,6,,98,75,173
013 Bruneck,7,,89,86,175
013 Bruneck,8,,95,92,187
013 Bruneck,9,,96,87,183
013 Bruneck,10,,108,71,179
013 Bruneck,11,,72,88,160
013 Bruneck,12,,64,75,139
013 Bruneck,13,,87,75,162
013 Bruneck,14,,82,68,150
013 Bruneck,15,,91,73,164
013 Bruneck,16,,91,61,152
013 Bruneck,17,,87,70,157
013 Bruneck,18,,81,83,164
013 Bruneck,19,,73,72,145
013 Bruneck,20,,60,58,118
013 Bruneck,21,,108,81,189
013 Bruneck,22,,82,73,155
013 Bruneck,23,,82,81,163
013 Bruneck,24,,89,82,171
013 Bruneck,25,,98,90,188
013 Bruneck,26,,94,116,210
013 Bruneck,27,,106,96,202
013 Bruneck,28,,98,97,195
013 Bruneck,29,,120,112,232
013 Bruneck,30,,121,93,214
013 Bruneck,31,,107,114,221
013 Bruneck,32,,111,114,225
013 Bruneck,33,,119,103,222
013 Bruneck,34,,133,116,249
013 Bruneck,35,,116,115,231
013 Bruneck,36,,140,111,251
013 Bruneck,37,,126,135,261
013 Bruneck,38,,133,125,258
013 Bruneck,39,,123,144,267
013 Bruneck,40,,137,124,261
013 Bruneck,41,,133,121,254
013 Bruneck,42,,148,142,290
013 Bruneck,43,,134,136,270
013 Bruneck,44,,125,115,240
013 Bruneck,45,,126,112,238
013 Bruneck,46,,114,99,213
013 Bruneck,47,,104,115,219
013 Bruneck,48,,106,97,203
013 Bruneck,49,,103,105,208
013 Bruneck,50,,84,98,182
013 Bruneck,51,,85,94,179
013 Bruneck,52,,78,80,158
013 Bruneck,53,,91,83,174
013 Bruneck,54,,76,98,174
013 Bruneck,55,,85,97,182
013 Bruneck,56,,71,97,168
013 Bruneck,57,,79,96,175
013 Bruneck,58,,82,94,176
013 Bruneck,59,,77,108,185
013 Bruneck,60,,93,70,163
013 Bruneck,61,,101,85,186
013 Bruneck,62,,63,70,133
013 Bruneck,63,,86,95,181
013 Bruneck,64,,94,85,179
013 Bruneck,65,,86,87,173
013 Bruneck,66,,78,95,173
013 Bruneck,67,,72,87,159
013 Bruneck,68,,81,92,173
013 Bruneck,69,,57,49,106
013 Bruneck,70,,51,55,106
013 Bruneck,71,,53,55,108
013 Bruneck,72,,46,47,93
013 Bruneck,73,,40,51,91
013 Bruneck,74,,48,61,109
013 Bruneck,75,,48,52,100
013 Bruneck,76,,34,47,81
013 Bruneck,77,,33,57,90
013 Bruneck,78,,28,58,86
013 Bruneck,79,,32,54,86
013 Bruneck,80,,25,43,68
013 Bruneck,81,,21,33,54
013 Bruneck,82,,24,44,68
013 Bruneck,83,,13,53,66
013 Bruneck,84,,24,38,62
013 Bruneck,85,,18,28,46
013 Bruneck,86,,11,23,34
013 Bruneck,87,,8,22,30
013 Bruneck,88,,7,16,23
013 Bruneck,89,,2,12,14
013 Bruneck,90,,4,15,19
013 Bruneck,91,,2,17,19
013 Bruneck,92,,3,11,14
013 Bruneck,93,,5,13,18
013 Bruneck,94,,2,10,12
013 Bruneck,95,,5,3,8
013 Bruneck,96,,-,6,6
013 Bruneck,97,,-,3,3
013 Bruneck,98,,1,3,4
013 Bruneck,99,,-,2,2
014 Kuens,0,,1,3,4
014 Kuens,1,,2,-,2
014 Kuens,2,,6,2,8
014 Kuens,3,,1,3,4
014 Kuens,4,,4,3,7
014 Kuens,5,,2,1,3
014 Kuens,6,,5,3,8
014 Kuens,7,,2,6,8
014 Kuens,8,,2,3,5
014 Kuens,9,,3,5,8
014 Kuens,10,,2,1,3
014 Kuens,11,,5,2,7
014 Kuens,12,,2,3,5
014 Kuens,13,,1,4,5
014 Kuens,14,,3,3,6
014 Kuens,15,,4,2,6
014 Kuens,16,,2,2,4
014 Kuens,17,,4,2,6
014 Kuens,18,,3,2,5
014 Kuens,19,,1,3,4
014 Kuens,20,,3,-,3
014 Kuens,21,,1,1,2
014 Kuens,23,,-,1,1
014 Kuens,24,,2,-,2
014 Kuens,25,,2,-,2
014 Kuens,26,,2,3,5
014 Kuens,27,,3,2,5
014 Kuens,28,,3,1,4
014 Kuens,29,,2,-,2
014 Kuens,30,,2,-,2
014 Kuens,31,,3,2,5
014 Kuens,32,,4,4,8
014 Kuens,33,,3,5,8
014 Kuens,34,,-,4,4
014 Kuens,35,,4,1,5
014 Kuens,36,,2,5,7
014 Kuens,37,,7,3,10
014 Kuens,38,,5,1,6
014 Kuens,39,,3,4,7
014 Kuens,40,,6,11,17
014 Kuens,41,,1,6,7
014 Kuens,42,,8,1,9
014 Kuens,43,,7,5,12
014 Kuens,44,,8,2,10
014 Kuens,45,,5,2,7
014 Kuens,46,,-,5,5
014 Kuens,48,,1,-,1
014 Kuens,49,,-,3,3
014 Kuens,50,,3,-,3
014 Kuens,51,,3,-,3
014 Kuens,52,,1,2,3
014 Kuens,53,,-,1,1
014 Kuens,54,,1,2,3
014 Kuens,55,,1,3,4
014 Kuens,57,,-,3,3
014 Kuens,58,,-,2,2
014 Kuens,59,,3,1,4
014 Kuens,60,,1,2,3
014 Kuens,61,,1,2,3
014 Kuens,62,,3,1,4
014 Kuens,64,,-,2,2
014 Kuens,65,,-,3,3
014 Kuens,66,,-,2,2
014 Kuens,67,,-,1,1
014 Kuens,68,,5,2,7
014 Kuens,69,,3,2,5
014 Kuens,70,,1,3,4
014 Kuens,71,,2,2,4
014 Kuens,72,,1,3,4
014 Kuens,73,,-,1,1
014 Kuens,74,,1,1,2
014 Kuens,75,,4,2,6
014 Kuens,76,,2,2,4
014 Kuens,77,,2,2,4
014 Kuens,78,,1,-,1
014 Kuens,79,,1,-,1
014 Kuens,80,,1,-,1
014 Kuens,81,,1,1,2
014 Kuens,85,,-,2,2
014 Kuens,88,,-,2,2
014 Kuens,91,,-,1,1
014 Kuens,92,,1,-,1
014 Kuens,95,,1,-,1
015 Kaltern a.d. Weinstr.,0,,44,44,88
015 Kaltern a.d. Weinstr.,1,,47,39,86
015 Kaltern a.d. Weinstr.,2,,50,44,94
015 Kaltern a.d. Weinstr.,3,,44,49,93
015 Kaltern a.d. Weinstr.,4,,46,35,81
015 Kaltern a.d. Weinstr.,5,,45,40,85
015 Kaltern a.d. Weinstr.,6,,33,49,82
015 Kaltern a.d. Weinstr.,7,,39,38,77
015 Kaltern a.d. Weinstr.,8,,45,37,82
015 Kaltern a.d. Weinstr.,9,,39,45,84
015 Kaltern a.d. Weinstr.,10,,44,45,89
015 Kaltern a.d. Weinstr.,11,,42,45,87
015 Kaltern a.d. Weinstr.,12,,44,34,78
015 Kaltern a.d. Weinstr.,13,,35,38,73
015 Kaltern a.d. Weinstr.,14,,32,39,71
015 Kaltern a.d. Weinstr.,15,,39,39,78
015 Kaltern a.d. Weinstr.,16,,33,42,75
015 Kaltern a.d. Weinstr.,17,,39,35,74
015 Kaltern a.d. Weinstr.,18,,54,27,81
015 Kaltern a.d. Weinstr.,19,,42,36,78
015 Kaltern a.d. Weinstr.,20,,39,33,72
015 Kaltern a.d. Weinstr.,21,,57,38,95
015 Kaltern a.d. Weinstr.,22,,49,40,89
015 Kaltern a.d. Weinstr.,23,,38,34,72
015 Kaltern a.d. Weinstr.,24,,45,38,83
015 Kaltern a.d. Weinstr.,25,,49,52,101
015 Kaltern a.d. Weinstr.,26,,43,40,83
015 Kaltern a.d. Weinstr.,27,,44,58,102
015 Kaltern a.d. Weinstr.,28,,47,43,90
015 Kaltern a.d. Weinstr.,29,,51,43,94
015 Kaltern a.d. Weinstr.,30,,42,51,93
015 Kaltern a.d. Weinstr.,31,,42,54,96
015 Kaltern a.d. Weinstr.,32,,48,68,116
015 Kaltern a.d. Weinstr.,33,,51,55,106
015 Kaltern a.d. Weinstr.,34,,45,59,104
015 Kaltern a.d. Weinstr.,35,,60,69,129
015 Kaltern a.d. Weinstr.,36,,65,58,123
015 Kaltern a.d. Weinstr.,37,,65,61,126
015 Kaltern a.d. Weinstr.,38,,62,71,133
015 Kaltern a.d. Weinstr.,39,,81,74,155
015 Kaltern a.d. Weinstr.,40,,64,63,127
015 Kaltern a.d. Weinstr.,41,,62,71,133
015 Kaltern a.d. Weinstr.,42,,56,57,113
015 Kaltern a.d. Weinstr.,43,,80,51,131
015 Kaltern a.d. Weinstr.,44,,57,56,113
015 Kaltern a.d. Weinstr.,45,,61,62,123
015 Kaltern a.d. Weinstr.,46,,67,63,130
015 Kaltern a.d. Weinstr.,47,,54,63,117
015 Kaltern a.d. Weinstr.,48,,52,55,107
015 Kaltern a.d. Weinstr.,49,,57,62,119
015 Kaltern a.d. Weinstr.,50,,53,58,111
015 Kaltern a.d. Weinstr.,51,,63,44,107
015 Kaltern a.d. Weinstr.,52,,54,40,94
015 Kaltern a.d. Weinstr.,53,,36,51,87
015 Kaltern a.d. Weinstr.,54,,35,40,75
015 Kaltern a.d. Weinstr.,55,,40,58,98
015 Kaltern a.d. Weinstr.,56,,32,35,67
015 Kaltern a.d. Weinstr.,57,,44,35,79
015 Kaltern a.d. Weinstr.,58,,30,40,70
015 Kaltern a.d. Weinstr.,59,,39,35,74
015 Kaltern a.d. Weinstr.,60,,36,54,90
015 Kaltern a.d. Weinstr.,61,,48,47,95
015 Kaltern a.d. Weinstr.,62,,39,38,77
015 Kaltern a.d. Weinstr.,63,,36,40,76
015 Kaltern a.d. Weinstr.,64,,34,38,72
015 Kaltern a.d. Weinstr.,65,,42,42,84
015 Kaltern a.d. Weinstr.,66,,44,43,87
015 Kaltern a.d. Weinstr.,67,,31,44,75
015 Kaltern a.d. Weinstr.,68,,24,36,60
015 Kaltern a.d. Weinstr.,69,,38,40,78
015 Kaltern a.d. Weinstr.,70,,28,29,57
015 Kaltern a.d. Weinstr.,71,,24,22,46
015 Kaltern a.d. Weinstr.,72,,27,25,52
015 Kaltern a.d. Weinstr.,73,,24,25,49
015 Kaltern a.d. Weinstr.,74,,27,36,63
015 Kaltern a.d. Weinstr.,75,,26,30,56
015 Kaltern a.d. Weinstr.,76,,21,31,52
015 Kaltern a.d. Weinstr.,77,,24,38,62
015 Kaltern a.d. Weinstr.,78,,19,33,52
015 Kaltern a.d. Weinstr.,79,,18,29,47
015 Kaltern a.d. Weinstr.,80,,15,34,49
015 Kaltern a.d. Weinstr.,81,,13,27,40
015 Kaltern a.d. Weinstr.,82,,17,32,49
015 Kaltern a.d. Weinstr.,83,,12,21,33
015 Kaltern a.d. Weinstr.,84,,4,21,25
015 Kaltern a.d. Weinstr.,85,,8,27,35
015 Kaltern a.d. Weinstr.,86,,6,27,33
015 Kaltern a.d. Weinstr.,87,,5,20,25
015 Kaltern a.d. Weinstr.,88,,3,14,17
015 Kaltern a.d. Weinstr.,89,,2,7,9
015 Kaltern a.d. Weinstr.,90,,2,6,8
015 Kaltern a.d. Weinstr.,91,,1,-,1
015 Kaltern a.d. Weinstr.,92,,1,4,5
015 Kaltern a.d. Weinstr.,93,,1,8,9
015 Kaltern a.d. Weinstr.,94,,2,5,7
015 Kaltern a.d. Weinstr.,95,,-,9,9
015 Kaltern a.d. Weinstr.,96,,1,2,3
015 Kaltern a.d. Weinstr.,100,,-,1,1
016 Freienfeld,0,,22,13,35
016 Freienfeld,1,,17,15,32
016 Freienfeld,2,,16,16,32
016 Freienfeld,3,,16,10,26
016 Freienfeld,4,,19,15,34
016 Freienfeld,5,,18,21,39
016 Freienfeld,6,,16,20,36
016 Freienfeld,7,,16,14,30
016 Freienfeld,8,,14,19,33
016 Freienfeld,9,,13,19,32
016 Freienfeld,10,,21,17,38
016 Freienfeld,11,,23,12,35
016 Freienfeld,12,,14,17,31
016 Freienfeld,13,,15,11,26
016 Freienfeld,14,,15,12,27
016 Freienfeld,15,,18,23,41
016 Freienfeld,16,,11,12,23
016 Freienfeld,17,,20,19,39
016 Freienfeld,18,,27,19,46
016 Freienfeld,19,,19,16,35
016 Freienfeld,20,,15,17,32
016 Freienfeld,21,,16,13,29
016 Freienfeld,22,,15,12,27
016 Freienfeld,23,,24,14,38
016 Freienfeld,24,,25,18,43
016 Freienfeld,25,,15,16,31
016 Freienfeld,26,,21,21,42
016 Freienfeld,27,,17,13,30
016 Freienfeld,28,,19,20,39
016 Freienfeld,29,,14,16,30
016 Freienfeld,30,,17,21,38
016 Freienfeld,31,,19,14,33
016 Freienfeld,32,,23,15,38
016 Freienfeld,33,,23,17,40
016 Freienfeld,34,,22,20,42
016 Freienfeld,35,,17,24,41
016 Freienfeld,36,,23,23,46
016 Freienfeld,37,,23,20,43
016 Freienfeld,38,,28,26,54
016 Freienfeld,39,,24,23,47
016 Freienfeld,40,,21,29,50
016 Freienfeld,41,,26,20,46
016 Freienfeld,42,,27,20,47
016 Freienfeld,43,,26,18,44
016 Freienfeld,44,,19,18,37
016 Freienfeld,45,,25,28,53
016 Freienfeld,46,,23,20,43
016 Freienfeld,47,,24,22,46
016 Freienfeld,48,,24,13,37
016 Freienfeld,49,,16,20,36
016 Freienfeld,50,,15,19,34
016 Freienfeld,51,,23,17,40
016 Freienfeld,52,,21,9,30
016 Freienfeld,53,,16,18,34
016 Freienfeld,54,,17,10,27
016 Freienfeld,55,,15,18,33
016 Freienfeld,56,,13,11,24
016 Freienfeld,57,,20,9,29
016 Freienfeld,58,,16,13,29
016 Freienfeld,59,,19,13,32
016 Freienfeld,60,,4,10,14
016 Freienfeld,61,,12,16,28
016 Freienfeld,62,,11,2,13
016 Freienfeld,63,,10,5,15
016 Freienfeld,64,,12,9,21
016 Freienfeld,65,,12,9,21
016 Freienfeld,66,,12,11,23
016 Freienfeld,67,,10,4,14
016 Freienfeld,68,,10,9,19
016 Freienfeld,69,,13,11,24
016 Freienfeld,70,,6,11,17
016 Freienfeld,71,,8,11,19
016 Freienfeld,72,,7,12,19
016 Freienfeld,73,,4,6,10
016 Freienfeld,74,,7,8,15
016 Freienfeld,75,,9,9,18
016 Freienfeld,76,,8,9,17
016 Freienfeld,77,,7,5,12
016 Freienfeld,78,,4,6,10
016 Freienfeld,79,,5,5,10
016 Freienfeld,80,,4,7,11
016 Freienfeld,81,,7,11,18
016 Freienfeld,82,,5,8,13
016 Freienfeld,83,,1,3,4
016 Freienfeld,84,,1,11,12
016 Freienfeld,85,,2,7,9
016 Freienfeld,86,,1,1,2
016 Freienfeld,87,,4,3,7
016 Freienfeld,88,,1,1,2
016 Freienfeld,89,,-,2,2
016 Freienfeld,91,,-,1,1
016 Freienfeld,92,,-,2,2
016 Freienfeld,93,,-,3,3
016 Freienfeld,94,,-,1,1
016 Freienfeld,96,,-,1,1
016 Freienfeld,97,,1,-,1
017 Sand in Taufers,0,,53,35,88
017 Sand in Taufers,1,,31,23,54
017 Sand in Taufers,2,,34,30,64
017 Sand in Taufers,3,,38,20,58
017 Sand in Taufers,4,,35,24,59
017 Sand in Taufers,5,,28,32,60
017 Sand in Taufers,6,,34,37,71
017 Sand in Taufers,7,,43,21,64
017 Sand in Taufers,8,,36,35,71
017 Sand in Taufers,9,,27,34,61
017 Sand in Taufers,10,,35,36,71
017 Sand in Taufers,11,,29,30,59
017 Sand in Taufers,12,,27,27,54
017 Sand in Taufers,13,,39,34,73
017 Sand in Taufers,14,,24,34,58
017 Sand in Taufers,15,,32,36,68
017 Sand in Taufers,16,,27,31,58
017 Sand in Taufers,17,,23,31,54
017 Sand in Taufers,18,,29,28,57
017 Sand in Taufers,19,,28,31,59
017 Sand in Taufers,20,,22,20,42
017 Sand in Taufers,21,,24,21,45
017 Sand in Taufers,22,,24,27,51
017 Sand in Taufers,23,,32,26,58
017 Sand in Taufers,24,,36,32,68
017 Sand in Taufers,25,,24,34,58
017 Sand in Taufers,26,,33,36,69
017 Sand in Taufers,27,,35,37,72
017 Sand in Taufers,28,,31,37,68
017 Sand in Taufers,29,,38,33,71
017 Sand in Taufers,30,,32,39,71
017 Sand in Taufers,31,,41,35,76
017 Sand in Taufers,32,,43,34,77
017 Sand in Taufers,33,,60,50,110
017 Sand in Taufers,34,,56,48,104
017 Sand in Taufers,35,,47,47,94
017 Sand in Taufers,36,,46,46,92
017 Sand in Taufers,37,,43,54,97
017 Sand in Taufers,38,,53,41,94
017 Sand in Taufers,39,,54,38,92
017 Sand in Taufers,40,,32,46,78
017 Sand in Taufers,41,,53,35,88
017 Sand in Taufers,42,,50,37,87
017 Sand in Taufers,43,,48,42,90
017 Sand in Taufers,44,,48,43,91
017 Sand in Taufers,45,,37,40,77
017 Sand in Taufers,46,,44,42,86
017 Sand in Taufers,47,,40,31,71
017 Sand in Taufers,48,,33,33,66
017 Sand in Taufers,49,,31,21,52
017 Sand in Taufers,50,,25,38,63
017 Sand in Taufers,51,,26,34,60
017 Sand in Taufers,52,,23,21,44
017 Sand in Taufers,53,,29,30,59
017 Sand in Taufers,54,,31,23,54
017 Sand in Taufers,55,,17,28,45
017 Sand in Taufers,56,,25,23,48
017 Sand in Taufers,57,,33,32,65
017 Sand in Taufers,58,,30,22,52
017 Sand in Taufers,59,,22,27,49
017 Sand in Taufers,60,,25,28,53
017 Sand in Taufers,61,,27,24,51
017 Sand in Taufers,62,,27,9,36
017 Sand in Taufers,63,,15,30,45
017 Sand in Taufers,64,,29,28,57
017 Sand in Taufers,65,,28,32,60
017 Sand in Taufers,66,,25,31,56
017 Sand in Taufers,67,,23,18,41
017 Sand in Taufers,68,,26,29,55
017 Sand in Taufers,69,,17,26,43
017 Sand in Taufers,70,,27,12,39
017 Sand in Taufers,71,,15,25,40
017 Sand in Taufers,72,,28,15,43
017 Sand in Taufers,73,,13,12,25
017 Sand in Taufers,74,,13,17,30
017 Sand in Taufers,75,,10,16,26
017 Sand in Taufers,76,,12,11,23
017 Sand in Taufers,77,,14,18,32
017 Sand in Taufers,78,,12,12,24
017 Sand in Taufers,79,,9,14,23
017 Sand in Taufers,80,,10,9,19
017 Sand in Taufers,81,,7,18,25
017 Sand in Taufers,82,,7,9,16
017 Sand in Taufers,83,,5,13,18
017 Sand in Taufers,84,,9,7,16
017 Sand in Taufers,85,,3,14,17
017 Sand in Taufers,86,,3,13,16
017 Sand in Taufers,87,,5,7,12
017 Sand in Taufers,88,,4,6,10
017 Sand in Taufers,89,,2,3,5
017 Sand in Taufers,90,,1,3,4
017 Sand in Taufers,91,,-,1,1
017 Sand in Taufers,92,,2,5,7
017 Sand in Taufers,93,,1,5,6
017 Sand in Taufers,94,,-,3,3
017 Sand in Taufers,95,,-,2,2
017 Sand in Taufers,96,,-,3,3
017 Sand in Taufers,98,,1,1,2
018 Kastelbell-Tschars,0,,10,10,20
018 Kastelbell-Tschars,1,,15,9,24
018 Kastelbell-Tschars,2,,8,9,17
018 Kastelbell-Tschars,3,,12,9,21
018 Kastelbell-Tschars,4,,12,9,21
018 Kastelbell-Tschars,5,,8,7,15
018 Kastelbell-Tschars,6,,16,15,31
018 Kastelbell-Tschars,7,,11,8,19
018 Kastelbell-Tschars,8,,25,12,37
018 Kastelbell-Tschars,9,,16,9,25
018 Kastelbell-Tschars,10,,10,13,23
018 Kastelbell-Tschars,11,,15,18,33
018 Kastelbell-Tschars,12,,15,10,25
018 Kastelbell-Tschars,13,,15,15,30
018 Kastelbell-Tschars,14,,13,16,29
018 Kastelbell-Tschars,15,,13,13,26
018 Kastelbell-Tschars,16,,19,12,31
018 Kastelbell-Tschars,17,,15,11,26
018 Kastelbell-Tschars,18,,17,10,27
018 Kastelbell-Tschars,19,,19,8,27
018 Kastelbell-Tschars,20,,18,17,35
018 Kastelbell-Tschars,21,,16,19,35
018 Kastelbell-Tschars,22,,21,16,37
018 Kastelbell-Tschars,23,,9,11,20
018 Kastelbell-Tschars,24,,12,18,30
018 Kastelbell-Tschars,25,,25,13,38
018 Kastelbell-Tschars,26,,15,17,32
018 Kastelbell-Tschars,27,,14,19,33
018 Kastelbell-Tschars,28,,16,14,30
018 Kastelbell-Tschars,29,,16,21,37
018 Kastelbell-Tschars,30,,11,15,26
018 Kastelbell-Tschars,31,,27,20,47
018 Kastelbell-Tschars,32,,18,14,32
018 Kastelbell-Tschars,33,,18,11,29
018 Kastelbell-Tschars,34,,16,25,41
018 Kastelbell-Tschars,35,,11,22,33
018 Kastelbell-Tschars,36,,15,16,31
018 Kastelbell-Tschars,37,,15,16,31
018 Kastelbell-Tschars,38,,27,23,50
018 Kastelbell-Tschars,39,,17,17,34
018 Kastelbell-Tschars,40,,12,20,32
018 Kastelbell-Tschars,41,,18,12,30
018 Kastelbell-Tschars,42,,21,13,34
018 Kastelbell-Tschars,43,,22,13,35
018 Kastelbell-Tschars,44,,26,21,47
018 Kastelbell-Tschars,45,,7,23,30
018 Kastelbell-Tschars,46,,22,18,40
018 Kastelbell-Tschars,47,,24,19,43
018 Kastelbell-Tschars,48,,24,20,44
018 Kastelbell-Tschars,49,,18,13,31
018 Kastelbell-Tschars,50,,16,10,26
018 Kastelbell-Tschars,51,,14,16,30
018 Kastelbell-Tschars,52,,25,17,42
018 Kastelbell-Tschars,53,,9,13,22
018 Kastelbell-Tschars,54,,9,16,25
018 Kastelbell-Tschars,55,,14,15,29
018 Kastelbell-Tschars,56,,16,12,28
018 Kastelbell-Tschars,57,,11,13,24
018 Kastelbell-Tschars,58,,14,9,23
018 Kastelbell-Tschars,59,,12,11,23
018 Kastelbell-Tschars,60,,9,8,17
018 Kastelbell-Tschars,61,,14,13,27
018 Kastelbell-Tschars,62,,10,4,14
018 Kastelbell-Tschars,63,,11,6,17
018 Kastelbell-Tschars,64,,7,7,14
018 Kastelbell-Tschars,65,,12,12,24
018 Kastelbell-Tschars,66,,10,8,18
018 Kastelbell-Tschars,67,,8,9,17
018 Kastelbell-Tschars,68,,12,12,24
018 Kastelbell-Tschars,69,,7,16,23
018 Kastelbell-Tschars,70,,11,11,22
018 Kastelbell-Tschars,71,,10,15,25
018 Kastelbell-Tschars,72,,10,8,18
018 Kastelbell-Tschars,73,,5,14,19
018 Kastelbell-Tschars,74,,16,13,29
018 Kastelbell-Tschars,75,,7,13,20
018 Kastelbell-Tschars,76,,10,14,24
018 Kastelbell-Tschars,77,,17,15,32
018 Kastelbell-Tschars,78,,10,11,21
018 Kastelbell-Tschars,79,,6,10,16
018 Kastelbell-Tschars,80,,7,7,14
018 Kastelbell-Tschars,81,,8,12,20
018 Kastelbell-Tschars,82,,10,12,22
018 Kastelbell-Tschars,83,,2,8,10
018 Kastelbell-Tschars,84,,5,7,12
018 Kastelbell-Tschars,85,,2,6,8
018 Kastelbell-Tschars,86,,2,5,7
018 Kastelbell-Tschars,87,,3,4,7
018 Kastelbell-Tschars,88,,-,3,3
018 Kastelbell-Tschars,89,,-,3,3
018 Kastelbell-Tschars,90,,1,2,3
018 Kastelbell-Tschars,91,,-,1,1
018 Kastelbell-Tschars,92,,1,1,2
018 Kastelbell-Tschars,93,,-,1,1
018 Kastelbell-Tschars,94,,-,1,1
018 Kastelbell-Tschars,96,,-,2,2
018 Kastelbell-Tschars,97,,-,1,1
018 Kastelbell-Tschars,98,,1,-,1
019 Kastelruth,0,,46,39,85
019 Kastelruth,1,,48,39,87
019 Kastelruth,2,,45,34,79
019 Kastelruth,3,,44,37,81
019 Kastelruth,4,,43,40,83
019 Kastelruth,5,,39,32,71
019 Kastelruth,6,,43,32,75
019 Kastelruth,7,,36,29,65
019 Kastelruth,8,,35,42,77
019 Kastelruth,9,,51,46,97
019 Kastelruth,10,,46,45,91
019 Kastelruth,11,,42,37,79
019 Kastelruth,12,,51,42,93
019 Kastelruth,13,,33,32,65
019 Kastelruth,14,,38,34,72
019 Kastelruth,15,,36,53,89
019 Kastelruth,16,,34,39,73
019 Kastelruth,17,,39,39,78
019 Kastelruth,18,,48,38,86
019 Kastelruth,19,,26,23,49
019 Kastelruth,20,,36,40,76
019 Kastelruth,21,,37,27,64
019 Kastelruth,22,,28,33,61
019 Kastelruth,23,,35,32,67
019 Kastelruth,24,,33,39,72
019 Kastelruth,25,,50,38,88
019 Kastelruth,26,,42,42,84
019 Kastelruth,27,,46,39,85
019 Kastelruth,28,,36,42,78
019 Kastelruth,29,,34,36,70
019 Kastelruth,30,,37,34,71
019 Kastelruth,31,,37,67,104
019 Kastelruth,32,,52,44,96
019 Kastelruth,33,,59,42,101
019 Kastelruth,34,,43,61,104
019 Kastelruth,35,,64,40,104
019 Kastelruth,36,,60,47,107
019 Kastelruth,37,,54,56,110
019 Kastelruth,38,,62,45,107
019 Kastelruth,39,,63,60,123
019 Kastelruth,40,,69,53,122
019 Kastelruth,41,,74,51,125
019 Kastelruth,42,,44,73,117
019 Kastelruth,43,,55,39,94
019 Kastelruth,44,,51,34,85
019 Kastelruth,45,,37,51,88
019 Kastelruth,46,,54,44,98
019 Kastelruth,47,,46,43,89
019 Kastelruth,48,,46,42,88
019 Kastelruth,49,,51,41,92
019 Kastelruth,50,,40,41,81
019 Kastelruth,51,,36,31,67
019 Kastelruth,52,,38,37,75
019 Kastelruth,53,,35,30,65
019 Kastelruth,54,,28,29,57
019 Kastelruth,55,,38,26,64
019 Kastelruth,56,,30,25,55
019 Kastelruth,57,,45,23,68
019 Kastelruth,58,,19,36,55
019 Kastelruth,59,,26,38,64
019 Kastelruth,60,,36,29,65
019 Kastelruth,61,,22,37,59
019 Kastelruth,62,,23,21,44
019 Kastelruth,63,,19,47,66
019 Kastelruth,64,,41,40,81
019 Kastelruth,65,,33,29,62
019 Kastelruth,66,,31,45,76
019 Kastelruth,67,,29,35,64
019 Kastelruth,68,,27,28,55
019 Kastelruth,69,,25,23,48
019 Kastelruth,70,,27,26,53
019 Kastelruth,71,,29,19,48
019 Kastelruth,72,,26,27,53
019 Kastelruth,73,,21,23,44
019 Kastelruth,74,,33,28,61
019 Kastelruth,75,,18,37,55
019 Kastelruth,76,,33,24,57
019 Kastelruth,77,,11,25,36
019 Kastelruth,78,,21,27,48
019 Kastelruth,79,,9,16,25
019 Kastelruth,80,,17,28,45
019 Kastelruth,81,,11,17,28
019 Kastelruth,82,,11,16,27
019 Kastelruth,83,,11,19,30
019 Kastelruth,84,,7,17,24
019 Kastelruth,85,,9,12,21
019 Kastelruth,86,,5,12,17
019 Kastelruth,87,,4,11,15
019 Kastelruth,88,,4,4,8
019 Kastelruth,89,,2,6,8
019 Kastelruth,90,,1,3,4
019 Kastelruth,91,,-,3,3
019 Kastelruth,92,,1,7,8
019 Kastelruth,93,,-,6,6
019 Kastelruth,94,,2,4,6
019 Kastelruth,95,,1,4,5
019 Kastelruth,96,,-,1,1
019 Kastelruth,98,,-,2,2
019 Kastelruth,99,,1,-,1
019 Kastelruth,102,,-,1,1
020 Tscherms,0,,5,7,12
020 Tscherms,1,,9,8,17
020 Tscherms,2,,2,9,11
020 Tscherms,3,,8,6,14
020 Tscherms,4,,9,7,16
020 Tscherms,5,,7,9,16
020 Tscherms,6,,7,8,15
020 Tscherms,7,,9,5,14
020 Tscherms,8,,8,8,16
020 Tscherms,9,,4,8,12
020 Tscherms,10,,8,9,17
020 Tscherms,11,,6,3,9
020 Tscherms,12,,14,10,24
020 Tscherms,13,,9,18,27
020 Tscherms,14,,8,11,19
020 Tscherms,15,,14,7,21
020 Tscherms,16,,6,8,14
020 Tscherms,17,,9,7,16
020 Tscherms,18,,6,5,11
020 Tscherms,19,,5,15,20
020 Tscherms,20,,8,7,15
020 Tscherms,21,,12,9,21
020 Tscherms,22,,13,9,22
020 Tscherms,23,,13,7,20
020 Tscherms,24,,10,11,21
020 Tscherms,25,,8,7,15
020 Tscherms,26,,9,8,17
020 Tscherms,27,,9,9,18
020 Tscherms,28,,7,11,18
020 Tscherms,29,,4,12,16
020 Tscherms,30,,12,5,17
020 Tscherms,31,,5,8,13
020 Tscherms,32,,10,7,17
020 Tscherms,33,,9,7,16
020 Tscherms,34,,10,14,24
020 Tscherms,35,,12,9,21
020 Tscherms,36,,8,14,22
020 Tscherms,37,,12,8,20
020 Tscherms,38,,14,16,30
020 Tscherms,39,,14,11,25
020 Tscherms,40,,12,15,27
020 Tscherms,41,,16,5,21
020 Tscherms,42,,18,16,34
020 Tscherms,43,,12,15,27
020 Tscherms,44,,15,14,29
020 Tscherms,45,,19,12,31
020 Tscherms,46,,11,11,22
020 Tscherms,47,,10,15,25
020 Tscherms,48,,8,15,23
020 Tscherms,49,,8,8,16
020 Tscherms,50,,9,10,19
020 Tscherms,51,,9,6,15
020 Tscherms,52,,10,9,19
020 Tscherms,53,,8,9,17
020 Tscherms,54,,11,8,19
020 Tscherms,55,,11,8,19
020 Tscherms,56,,5,10,15
020 Tscherms,57,,9,7,16
020 Tscherms,58,,4,3,7
020 Tscherms,59,,6,5,11
020 Tscherms,60,,7,7,14
020 Tscherms,61,,5,7,12
020 Tscherms,62,,5,6,11
020 Tscherms,63,,4,9,13
020 Tscherms,64,,5,3,8
020 Tscherms,65,,7,4,11
020 Tscherms,66,,10,9,19
020 Tscherms,67,,5,5,10
020 Tscherms,68,,4,5,9
020 Tscherms,69,,8,2,10
020 Tscherms,70,,5,8,13
020 Tscherms,71,,6,7,13
020 Tscherms,72,,3,5,8
020 Tscherms,73,,2,8,10
020 Tscherms,74,,4,3,7
020 Tscherms,75,,4,5,9
020 Tscherms,76,,2,2,4
020 Tscherms,77,,3,5,8
020 Tscherms,78,,2,2,4
020 Tscherms,79,,4,5,9
020 Tscherms,80,,5,4,9
020 Tscherms,81,,3,2,5
020 Tscherms,82,,3,5,8
020 Tscherms,83,,3,5,8
020 Tscherms,84,,1,4,5
020 Tscherms,85,,1,4,5
020 Tscherms,86,,-,3,3
020 Tscherms,87,,4,3,7
020 Tscherms,88,,-,1,1
020 Tscherms,89,,1,1,2
020 Tscherms,90,,-,1,1
020 Tscherms,91,,-,1,1
020 Tscherms,92,,1,-,1
020 Tscherms,93,,-,1,1
020 Tscherms,95,,1,-,1
020 Tscherms,97,,1,1,2
021 Kiens,0,,13,13,26
021 Kiens,1,,11,11,22
021 Kiens,2,,13,20,33
021 Kiens,3,,16,12,28
021 Kiens,4,,14,18,32
021 Kiens,5,,10,13,23
021 Kiens,6,,21,21,42
021 Kiens,7,,9,20,29
021 Kiens,8,,14,17,31
021 Kiens,9,,22,8,30
021 Kiens,10,,17,13,30
021 Kiens,11,,15,19,34
021 Kiens,12,,14,21,35
021 Kiens,13,,18,17,35
021 Kiens,14,,17,18,35
021 Kiens,15,,26,18,44
021 Kiens,16,,12,25,37
021 Kiens,17,,16,21,37
021 Kiens,18,,12,19,31
021 Kiens,19,,12,14,26
021 Kiens,20,,12,16,28
021 Kiens,21,,20,10,30
021 Kiens,22,,19,13,32
021 Kiens,23,,18,11,29
021 Kiens,24,,14,20,34
021 Kiens,25,,20,16,36
021 Kiens,26,,14,16,30
021 Kiens,27,,20,20,40
021 Kiens,28,,13,16,29
021 Kiens,29,,25,16,41
021 Kiens,30,,19,17,36
021 Kiens,31,,24,19,43
021 Kiens,32,,19,19,38
021 Kiens,33,,17,22,39
021 Kiens,34,,29,25,54
021 Kiens,35,,20,21,41
021 Kiens,36,,27,24,51
021 Kiens,37,,24,25,49
021 Kiens,38,,33,22,55
021 Kiens,39,,36,15,51
021 Kiens,40,,20,23,43
021 Kiens,41,,30,25,55
021 Kiens,42,,21,21,42
021 Kiens,43,,31,23,54
021 Kiens,44,,18,21,39
021 Kiens,45,,29,18,47
021 Kiens,46,,23,22,45
021 Kiens,47,,21,18,39
021 Kiens,48,,24,15,39
021 Kiens,49,,14,13,27
021 Kiens,50,,12,17,29
021 Kiens,51,,19,13,32
021 Kiens,52,,14,8,22
021 Kiens,53,,11,15,26
021 Kiens,54,,14,22,36
021 Kiens,55,,13,8,21
021 Kiens,56,,13,12,25
021 Kiens,57,,16,10,26
021 Kiens,58,,10,13,23
021 Kiens,59,,15,17,32
021 Kiens,60,,13,14,27
021 Kiens,61,,18,13,31
021 Kiens,62,,8,12,20
021 Kiens,63,,11,14,25
021 Kiens,64,,19,10,29
021 Kiens,65,,16,11,27
021 Kiens,66,,14,11,25
021 Kiens,67,,11,16,27
021 Kiens,68,,11,9,20
021 Kiens,69,,13,13,26
021 Kiens,70,,10,11,21
021 Kiens,71,,9,11,20
021 Kiens,72,,4,17,21
021 Kiens,73,,9,10,19
021 Kiens,74,,12,8,20
021 Kiens,75,,13,13,26
021 Kiens,76,,12,8,20
021 Kiens,77,,7,11,18
021 Kiens,78,,5,9,14
021 Kiens,79,,2,4,6
021 Kiens,80,,5,5,10
021 Kiens,81,,3,5,8
021 Kiens,82,,4,3,7
021 Kiens,83,,2,6,8
021 Kiens,84,,3,5,8
021 Kiens,85,,3,3,6
021 Kiens,86,,-,5,5
021 Kiens,87,,2,2,4
021 Kiens,88,,-,2,2
021 Kiens,89,,-,2,2
021 Kiens,90,,-,1,1
021 Kiens,92,,1,1,2
021 Kiens,93,,1,1,2
021 Kiens,94,,2,2,4
021 Kiens,95,,1,2,3
022 Klausen,0,,33,32,65
022 Klausen,1,,40,40,80
022 Klausen,2,,38,34,72
022 Klausen,3,,36,36,72
022 Klausen,4,,29,31,60
022 Klausen,5,,41,27,68
022 Klausen,6,,30,31,61
022 Klausen,7,,30,31,61
022 Klausen,8,,29,30,59
022 Klausen,9,,23,29,52
022 Klausen,10,,40,35,75
022 Klausen,11,,29,27,56
022 Klausen,12,,32,25,57
022 Klausen,13,,16,33,49
022 Klausen,14,,31,27,58
022 Klausen,15,,44,26,70
022 Klausen,16,,34,35,69
022 Klausen,17,,38,25,63
022 Klausen,18,,27,31,58
022 Klausen,19,,33,33,66
022 Klausen,20,,22,33,55
022 Klausen,21,,36,32,68
022 Klausen,22,,37,38,75
022 Klausen,23,,31,27,58
022 Klausen,24,,23,39,62
022 Klausen,25,,38,36,74
022 Klausen,26,,40,29,69
022 Klausen,27,,30,39,69
022 Klausen,28,,35,31,66
022 Klausen,29,,36,44,80
022 Klausen,30,,34,39,73
022 Klausen,31,,43,29,72
022 Klausen,32,,38,41,79
022 Klausen,33,,44,35,79
022 Klausen,34,,43,35,78
022 Klausen,35,,35,41,76
022 Klausen,36,,45,42,87
022 Klausen,37,,44,46,90
022 Klausen,38,,50,50,100
022 Klausen,39,,51,44,95
022 Klausen,40,,53,42,95
022 Klausen,41,,59,42,101
022 Klausen,42,,39,49,88
022 Klausen,43,,41,49,90
022 Klausen,44,,39,39,78
022 Klausen,45,,34,38,72
022 Klausen,46,,50,43,93
022 Klausen,47,,40,26,66
022 Klausen,48,,35,38,73
022 Klausen,49,,25,30,55
022 Klausen,50,,32,26,58
022 Klausen,51,,30,24,54
022 Klausen,52,,29,35,64
022 Klausen,53,,33,41,74
022 Klausen,54,,20,30,50
022 Klausen,55,,25,15,40
022 Klausen,56,,33,26,59
022 Klausen,57,,29,24,53
022 Klausen,58,,30,25,55
022 Klausen,59,,28,26,54
022 Klausen,60,,27,20,47
022 Klausen,61,,31,20,51
022 Klausen,62,,12,17,29
022 Klausen,63,,23,18,41
022 Klausen,64,,18,29,47
022 Klausen,65,,22,26,48
022 Klausen,66,,28,20,48
022 Klausen,67,,22,21,43
022 Klausen,68,,24,18,42
022 Klausen,69,,16,20,36
022 Klausen,70,,18,17,35
022 Klausen,71,,16,22,38
022 Klausen,72,,11,17,28
022 Klausen,73,,18,14,32
022 Klausen,74,,23,16,39
022 Klausen,75,,10,19,29
022 Klausen,76,,12,14,26
022 Klausen,77,,10,17,27
022 Klausen,78,,16,18,34
022 Klausen,79,,4,16,20
022 Klausen,80,,3,15,18
022 Klausen,81,,9,11,20
022 Klausen,82,,12,8,20
022 Klausen,83,,8,12,20
022 Klausen,84,,2,9,11
022 Klausen,85,,3,7,10
022 Klausen,86,,-,5,5
022 Klausen,87,,2,8,10
022 Klausen,88,,1,6,7
022 Klausen,89,,1,5,6
022 Klausen,90,,1,5,6
022 Klausen,91,,1,1,2
022 Klausen,92,,-,1,1
022 Klausen,93,,2,2,4
022 Klausen,94,,-,7,7
022 Klausen,96,,1,-,1
022 Klausen,97,,-,2,2
022 Klausen,98,,-,1,1
023 Karneid,0,,21,18,39
023 Karneid,1,,20,12,32
023 Karneid,2,,24,18,42
023 Karneid,3,,20,23,43
023 Karneid,4,,24,19,43
023 Karneid,5,,15,13,28
023 Karneid,6,,22,19,41
023 Karneid,7,,16,20,36
023 Karneid,8,,24,25,49
023 Karneid,9,,21,19,40
023 Karneid,10,,29,19,48
023 Karneid,11,,21,22,43
023 Karneid,12,,25,20,45
023 Karneid,13,,22,22,44
023 Karneid,14,,22,19,41
023 Karneid,15,,24,19,43
023 Karneid,16,,16,20,36
023 Karneid,17,,24,18,42
023 Karneid,18,,15,20,35
023 Karneid,19,,16,18,34
023 Karneid,20,,14,22,36
023 Karneid,21,,20,21,41
023 Karneid,22,,21,14,35
023 Karneid,23,,25,16,41
023 Karneid,24,,19,11,30
023 Karneid,25,,20,14,34
023 Karneid,26,,28,30,58
023 Karneid,27,,22,20,42
023 Karneid,28,,27,32,59
023 Karneid,29,,23,12,35
023 Karneid,30,,18,22,40
023 Karneid,31,,24,28,52
023 Karneid,32,,18,19,37
023 Karneid,33,,24,23,47
023 Karneid,34,,30,30,60
023 Karneid,35,,30,24,54
023 Karneid,36,,33,35,68
023 Karneid,37,,40,23,63
023 Karneid,38,,22,27,49
023 Karneid,39,,36,32,68
023 Karneid,40,,33,33,66
023 Karneid,41,,34,35,69
023 Karneid,42,,29,23,52
023 Karneid,43,,33,24,57
023 Karneid,44,,38,24,62
023 Karneid,45,,27,39,66
023 Karneid,46,,28,21,49
023 Karneid,47,,30,26,56
023 Karneid,48,,27,19,46
023 Karneid,49,,21,18,39
023 Karneid,50,,18,15,33
023 Karneid,51,,22,20,42
023 Karneid,52,,16,11,27
023 Karneid,53,,16,13,29
023 Karneid,54,,19,14,33
023 Karneid,55,,13,20,33
023 Karneid,56,,18,12,30
023 Karneid,57,,24,17,41
023 Karneid,58,,11,15,26
023 Karneid,59,,16,25,41
023 Karneid,60,,9,15,24
023 Karneid,61,,12,20,32
023 Karneid,62,,12,14,26
023 Karneid,63,,12,15,27
023 Karneid,64,,20,14,34
023 Karneid,65,,17,24,41
023 Karneid,66,,19,15,34
023 Karneid,67,,14,15,29
023 Karneid,68,,18,14,32
023 Karneid,69,,21,12,33
023 Karneid,70,,9,8,17
023 Karneid,71,,12,12,24
023 Karneid,72,,9,10,19
023 Karneid,73,,11,15,26
023 Karneid,74,,8,14,22
023 Karneid,75,,12,5,17
023 Karneid,76,,16,11,27
023 Karneid,77,,7,8,15
023 Karneid,78,,11,10,21
023 Karneid,79,,8,7,15
023 Karneid,80,,2,9,11
023 Karneid,81,,6,9,15
023 Karneid,82,,3,7,10
023 Karneid,83,,7,7,14
023 Karneid,84,,4,2,6
023 Karneid,85,,1,7,8
023 Karneid,86,,1,5,6
023 Karneid,87,,2,8,10
023 Karneid,88,,5,1,6
023 Karneid,89,,-,3,3
023 Karneid,90,,1,1,2
023 Karneid,91,,-,1,1
023 Karneid,94,,-,1,1
023 Karneid,95,,-,3,3
023 Karneid,97,,1,-,1
024 Kurtatsch a.d.Weinstr.,0,,7,7,14
024 Kurtatsch a.d.Weinstr.,1,,6,15,21
024 Kurtatsch a.d.Weinstr.,2,,12,16,28
024 Kurtatsch a.d.Weinstr.,3,,12,14,26
024 Kurtatsch a.d.Weinstr.,4,,11,12,23
024 Kurtatsch a.d.Weinstr.,5,,10,18,28
024 Kurtatsch a.d.Weinstr.,6,,21,13,34
024 Kurtatsch a.d.Weinstr.,7,,17,14,31
024 Kurtatsch a.d.Weinstr.,8,,18,11,29
024 Kurtatsch a.d.Weinstr.,9,,16,15,31
024 Kurtatsch a.d.Weinstr.,10,,13,14,27
024 Kurtatsch a.d.Weinstr.,11,,23,19,42
024 Kurtatsch a.d.Weinstr.,12,,20,12,32
024 Kurtatsch a.d.Weinstr.,13,,15,7,22
024 Kurtatsch a.d.Weinstr.,14,,23,19,42
024 Kurtatsch a.d.Weinstr.,15,,21,11,32
024 Kurtatsch a.d.Weinstr.,16,,16,17,33
024 Kurtatsch a.d.Weinstr.,17,,12,7,19
024 Kurtatsch a.d.Weinstr.,18,,10,18,28
024 Kurtatsch a.d.Weinstr.,19,,7,14,21
024 Kurtatsch a.d.Weinstr.,20,,13,13,26
024 Kurtatsch a.d.Weinstr.,21,,10,11,21
024 Kurtatsch a.d.Weinstr.,22,,13,11,24
024 Kurtatsch a.d.Weinstr.,23,,14,10,24
024 Kurtatsch a.d.Weinstr.,24,,14,8,22
024 Kurtatsch a.d.Weinstr.,25,,10,19,29
024 Kurtatsch a.d.Weinstr.,26,,12,12,24
024 Kurtatsch a.d.Weinstr.,27,,8,13,21
024 Kurtatsch a.d.Weinstr.,28,,10,11,21
024 Kurtatsch a.d.Weinstr.,29,,12,9,21
024 Kurtatsch a.d.Weinstr.,30,,10,16,26
024 Kurtatsch a.d.Weinstr.,31,,12,11,23
024 Kurtatsch a.d.Weinstr.,32,,12,10,22
024 Kurtatsch a.d.Weinstr.,33,,13,18,31
024 Kurtatsch a.d.Weinstr.,34,,15,20,35
024 Kurtatsch a.d.Weinstr.,35,,13,17,30
024 Kurtatsch a.d.Weinstr.,36,,15,22,37
024 Kurtatsch a.d.Weinstr.,37,,15,26,41
024 Kurtatsch a.d.Weinstr.,38,,26,23,49
024 Kurtatsch a.d.Weinstr.,39,,27,16,43
024 Kurtatsch a.d.Weinstr.,40,,19,19,38
024 Kurtatsch a.d.Weinstr.,41,,30,16,46
024 Kurtatsch a.d.Weinstr.,42,,25,27,52
024 Kurtatsch a.d.Weinstr.,43,,15,25,40
024 Kurtatsch a.d.Weinstr.,44,,22,20,42
024 Kurtatsch a.d.Weinstr.,45,,25,10,35
024 Kurtatsch a.d.Weinstr.,46,,17,15,32
024 Kurtatsch a.d.Weinstr.,47,,20,22,42
024 Kurtatsch a.d.Weinstr.,48,,19,10,29
024 Kurtatsch a.d.Weinstr.,49,,15,15,30
024 Kurtatsch a.d.Weinstr.,50,,10,10,20
024 Kurtatsch a.d.Weinstr.,51,,9,9,18
024 Kurtatsch a.d.Weinstr.,52,,13,18,31
024 Kurtatsch a.d.Weinstr.,53,,15,8,23
024 Kurtatsch a.d.Weinstr.,54,,17,20,37
024 Kurtatsch a.d.Weinstr.,55,,10,8,18
024 Kurtatsch a.d.Weinstr.,56,,8,13,21
024 Kurtatsch a.d.Weinstr.,57,,14,6,20
024 Kurtatsch a.d.Weinstr.,58,,11,9,20
024 Kurtatsch a.d.Weinstr.,59,,10,8,18
024 Kurtatsch a.d.Weinstr.,60,,11,8,19
024 Kurtatsch a.d.Weinstr.,61,,12,8,20
024 Kurtatsch a.d.Weinstr.,62,,7,9,16
024 Kurtatsch a.d.Weinstr.,63,,5,9,14
024 Kurtatsch a.d.Weinstr.,64,,10,7,17
024 Kurtatsch a.d.Weinstr.,65,,9,12,21
024 Kurtatsch a.d.Weinstr.,66,,8,12,20
024 Kurtatsch a.d.Weinstr.,67,,11,11,22
024 Kurtatsch a.d.Weinstr.,68,,3,15,18
024 Kurtatsch a.d.Weinstr.,69,,12,11,23
024 Kurtatsch a.d.Weinstr.,70,,4,10,14
024 Kurtatsch a.d.Weinstr.,71,,9,7,16
024 Kurtatsch a.d.Weinstr.,72,,4,7,11
024 Kurtatsch a.d.Weinstr.,73,,5,9,14
024 Kurtatsch a.d.Weinstr.,74,,9,7,16
024 Kurtatsch a.d.Weinstr.,75,,10,16,26
024 Kurtatsch a.d.Weinstr.,76,,7,9,16
024 Kurtatsch a.d.Weinstr.,77,,9,15,24
024 Kurtatsch a.d.Weinstr.,78,,7,9,16
024 Kurtatsch a.d.Weinstr.,79,,7,8,15
024 Kurtatsch a.d.Weinstr.,80,,8,6,14
024 Kurtatsch a.d.Weinstr.,81,,4,5,9
024 Kurtatsch a.d.Weinstr.,82,,4,7,11
024 Kurtatsch a.d.Weinstr.,83,,5,8,13
024 Kurtatsch a.d.Weinstr.,84,,5,17,22
024 Kurtatsch a.d.Weinstr.,85,,-,2,2
024 Kurtatsch a.d.Weinstr.,86,,-,7,7
024 Kurtatsch a.d.Weinstr.,87,,4,3,7
024 Kurtatsch a.d.Weinstr.,88,,1,-,1
024 Kurtatsch a.d.Weinstr.,90,,-,2,2
024 Kurtatsch a.d.Weinstr.,91,,-,1,1
024 Kurtatsch a.d.Weinstr.,95,,2,-,2
024 Kurtatsch a.d.Weinstr.,96,,-,2,2
025 Kurtinig a.d. Weinstr.,0,,3,4,7
025 Kurtinig a.d. Weinstr.,1,,3,1,4
025 Kurtinig a.d. Weinstr.,2,,-,5,5
025 Kurtinig a.d. Weinstr.,3,,1,2,3
025 Kurtinig a.d. Weinstr.,4,,5,3,8
025 Kurtinig a.d. Weinstr.,5,,3,3,6
025 Kurtinig a.d. Weinstr.,6,,1,8,9
025 Kurtinig a.d. Weinstr.,7,,4,5,9
025 Kurtinig a.d. Weinstr.,8,,3,2,5
025 Kurtinig a.d. Weinstr.,9,,3,6,9
025 Kurtinig a.d. Weinstr.,10,,4,4,8
025 Kurtinig a.d. Weinstr.,11,,1,2,3
025 Kurtinig a.d. Weinstr.,12,,6,2,8
025 Kurtinig a.d. Weinstr.,13,,3,3,6
025 Kurtinig a.d. Weinstr.,14,,4,4,8
025 Kurtinig a.d. Weinstr.,15,,2,3,5
025 Kurtinig a.d. Weinstr.,16,,6,2,8
025 Kurtinig a.d. Weinstr.,17,,3,2,5
025 Kurtinig a.d. Weinstr.,18,,6,4,10
025 Kurtinig a.d. Weinstr.,19,,6,4,10
025 Kurtinig a.d. Weinstr.,20,,6,5,11
025 Kurtinig a.d. Weinstr.,21,,4,4,8
025 Kurtinig a.d. Weinstr.,22,,2,4,6
025 Kurtinig a.d. Weinstr.,23,,3,6,9
025 Kurtinig a.d. Weinstr.,24,,4,3,7
025 Kurtinig a.d. Weinstr.,25,,6,5,11
025 Kurtinig a.d. Weinstr.,26,,8,3,11
025 Kurtinig a.d. Weinstr.,27,,6,5,11
025 Kurtinig a.d. Weinstr.,28,,4,5,9
025 Kurtinig a.d. Weinstr.,29,,4,2,6
025 Kurtinig a.d. Weinstr.,30,,2,2,4
025 Kurtinig a.d. Weinstr.,31,,1,1,2
025 Kurtinig a.d. Weinstr.,32,,2,9,11
025 Kurtinig a.d. Weinstr.,33,,3,2,5
025 Kurtinig a.d. Weinstr.,34,,4,4,8
025 Kurtinig a.d. Weinstr.,35,,3,5,8
025 Kurtinig a.d. Weinstr.,36,,4,3,7
025 Kurtinig a.d. Weinstr.,37,,6,4,10
025 Kurtinig a.d. Weinstr.,38,,7,7,14
025 Kurtinig a.d. Weinstr.,39,,5,3,8
025 Kurtinig a.d. Weinstr.,40,,4,4,8
025 Kurtinig a.d. Weinstr.,41,,1,5,6
025 Kurtinig a.d. Weinstr.,42,,5,4,9
025 Kurtinig a.d. Weinstr.,43,,6,5,11
025 Kurtinig a.d. Weinstr.,44,,9,6,15
025 Kurtinig a.d. Weinstr.,45,,5,5,10
025 Kurtinig a.d. Weinstr.,46,,8,9,17
025 Kurtinig a.d. Weinstr.,47,,5,4,9
025 Kurtinig a.d. Weinstr.,48,,11,6,17
025 Kurtinig a.d. Weinstr.,49,,3,8,11
025 Kurtinig a.d. Weinstr.,50,,7,7,14
025 Kurtinig a.d. Weinstr.,51,,4,2,6
025 Kurtinig a.d. Weinstr.,52,,3,1,4
025 Kurtinig a.d. Weinstr.,53,,7,3,10
025 Kurtinig a.d. Weinstr.,54,,4,6,10
025 Kurtinig a.d. Weinstr.,55,,2,4,6
025 Kurtinig a.d. Weinstr.,56,,3,4,7
025 Kurtinig a.d. Weinstr.,57,,2,3,5
025 Kurtinig a.d. Weinstr.,58,,3,3,6
025 Kurtinig a.d. Weinstr.,59,,5,5,10
025 Kurtinig a.d. Weinstr.,60,,5,2,7
025 Kurtinig a.d. Weinstr.,61,,-,5,5
025 Kurtinig a.d. Weinstr.,62,,3,4,7
025 Kurtinig a.d. Weinstr.,63,,3,2,5
025 Kurtinig a.d. Weinstr.,64,,4,2,6
025 Kurtinig a.d. Weinstr.,65,,2,2,4
025 Kurtinig a.d. Weinstr.,66,,4,2,6
025 Kurtinig a.d. Weinstr.,67,,2,2,4
025 Kurtinig a.d. Weinstr.,68,,5,4,9
025 Kurtinig a.d. Weinstr.,69,,2,2,4
025 Kurtinig a.d. Weinstr.,70,,2,4,6
025 Kurtinig a.d. Weinstr.,71,,4,3,7
025 Kurtinig a.d. Weinstr.,72,,-,6,6
025 Kurtinig a.d. Weinstr.,73,,2,4,6
025 Kurtinig a.d. Weinstr.,74,,1,2,3
025 Kurtinig a.d. Weinstr.,75,,4,4,8
025 Kurtinig a.d. Weinstr.,76,,3,2,5
025 Kurtinig a.d. Weinstr.,77,,4,3,7
025 Kurtinig a.d. Weinstr.,78,,1,3,4
025 Kurtinig a.d. Weinstr.,79,,2,4,6
025 Kurtinig a.d. Weinstr.,80,,2,2,4
025 Kurtinig a.d. Weinstr.,81,,2,1,3
025 Kurtinig a.d. Weinstr.,82,,-,6,6
025 Kurtinig a.d. Weinstr.,83,,1,3,4
025 Kurtinig a.d. Weinstr.,84,,-,1,1
025 Kurtinig a.d. Weinstr.,85,,-,2,2
025 Kurtinig a.d. Weinstr.,86,,1,1,2
025 Kurtinig a.d. Weinstr.,88,,-,2,2
025 Kurtinig a.d. Weinstr.,89,,-,1,1
025 Kurtinig a.d. Weinstr.,92,,-,1,1
025 Kurtinig a.d. Weinstr.,93,,-,2,2
025 Kurtinig a.d. Weinstr.,95,,-,1,1
026 Corvara,0,,5,9,14
026 Corvara,1,,10,4,14
026 Corvara,2,,7,5,12
026 Corvara,3,,7,3,10
026 Corvara,4,,12,5,17
026 Corvara,5,,4,4,8
026 Corvara,6,,5,8,13
026 Corvara,7,,7,3,10
026 Corvara,8,,8,7,15
026 Corvara,9,,10,9,19
026 Corvara,10,,3,5,8
026 Corvara,11,,10,4,14
026 Corvara,12,,7,7,14
026 Corvara,13,,8,5,13
026 Corvara,14,,6,3,9
026 Corvara,15,,6,10,16
026 Corvara,16,,3,5,8
026 Corvara,17,,9,8,17
026 Corvara,18,,5,5,10
026 Corvara,19,,5,3,8
026 Corvara,20,,9,7,16
026 Corvara,21,,4,-,4
026 Corvara,22,,5,8,13
026 Corvara,23,,7,3,10
026 Corvara,24,,7,7,14
026 Corvara,25,,10,11,21
026 Corvara,26,,15,3,18
026 Corvara,27,,10,6,16
026 Corvara,28,,10,8,18
026 Corvara,29,,11,2,13
026 Corvara,30,,17,11,28
026 Corvara,31,,12,5,17
026 Corvara,32,,8,22,30
026 Corvara,33,,8,15,23
026 Corvara,34,,10,9,19
026 Corvara,35,,7,8,15
026 Corvara,36,,11,6,17
026 Corvara,37,,9,12,21
026 Corvara,38,,16,13,29
026 Corvara,39,,7,15,22
026 Corvara,40,,15,20,35
026 Corvara,41,,12,17,29
026 Corvara,42,,16,19,35
026 Corvara,43,,8,8,16
026 Corvara,44,,13,11,24
026 Corvara,45,,13,12,25
026 Corvara,46,,8,8,16
026 Corvara,47,,17,13,30
026 Corvara,48,,7,7,14
026 Corvara,49,,11,6,17
026 Corvara,50,,8,5,13
026 Corvara,51,,4,7,11
026 Corvara,52,,11,7,18
026 Corvara,53,,10,8,18
026 Corvara,54,,6,12,18
026 Corvara,55,,5,8,13
026 Corvara,56,,5,8,13
026 Corvara,57,,7,8,15
026 Corvara,58,,3,9,12
026 Corvara,59,,4,5,9
026 Corvara,60,,4,10,14
026 Corvara,61,,12,11,23
026 Corvara,62,,5,5,10
026 Corvara,63,,7,8,15
026 Corvara,64,,5,10,15
026 Corvara,65,,6,8,14
026 Corvara,66,,11,11,22
026 Corvara,67,,8,6,14
026 Corvara,68,,6,5,11
026 Corvara,69,,4,7,11
026 Corvara,70,,6,9,15
026 Corvara,71,,5,6,11
026 Corvara,72,,7,4,11
026 Corvara,73,,6,8,14
026 Corvara,74,,3,4,7
026 Corvara,75,,4,4,8
026 Corvara,76,,7,10,17
026 Corvara,77,,6,3,9
026 Corvara,78,,4,5,9
026 Corvara,79,,1,2,3
026 Corvara,80,,5,2,7
026 Corvara,81,,3,1,4
026 Corvara,82,,1,3,4
026 Corvara,83,,2,-,2
026 Corvara,84,,4,2,6
026 Corvara,85,,3,3,6
026 Corvara,86,,3,1,4
026 Corvara,87,,2,1,3
026 Corvara,88,,1,2,3
026 Corvara,89,,-,1,1
026 Corvara,90,,1,1,2
026 Corvara,93,,-,2,2
026 Corvara,95,,-,1,1
026 Corvara,96,,1,-,1
027 Graun im Vinschgau,0,,20,14,34
027 Graun im Vinschgau,1,,13,20,33
027 Graun im Vinschgau,2,,12,15,27
027 Graun im Vinschgau,3,,11,17,28
027 Graun im Vinschgau,4,,9,12,21
027 Graun im Vinschgau,5,,12,12,24
027 Graun im Vinschgau,6,,16,13,29
027 Graun im Vinschgau,7,,18,16,34
027 Graun im Vinschgau,8,,15,10,25
027 Graun im Vinschgau,9,,9,15,24
027 Graun im Vinschgau,10,,19,17,36
027 Graun im Vinschgau,11,,21,18,39
027 Graun im Vinschgau,12,,19,16,35
027 Graun im Vinschgau,13,,19,12,31
027 Graun im Vinschgau,14,,20,13,33
027 Graun im Vinschgau,15,,17,15,32
027 Graun im Vinschgau,16,,10,12,22
027 Graun im Vinschgau,17,,19,19,38
027 Graun im Vinschgau,18,,26,17,43
027 Graun im Vinschgau,19,,20,11,31
027 Graun im Vinschgau,20,,15,11,26
027 Graun im Vinschgau,21,,7,7,14
027 Graun im Vinschgau,22,,18,10,28
027 Graun im Vinschgau,23,,18,16,34
027 Graun im Vinschgau,24,,7,18,25
027 Graun im Vinschgau,25,,18,15,33
027 Graun im Vinschgau,26,,20,19,39
027 Graun im Vinschgau,27,,20,16,36
027 Graun im Vinschgau,28,,15,22,37
027 Graun im Vinschgau,29,,16,17,33
027 Graun im Vinschgau,30,,15,19,34
027 Graun im Vinschgau,31,,15,19,34
027 Graun im Vinschgau,32,,21,16,37
027 Graun im Vinschgau,33,,19,13,32
027 Graun im Vinschgau,34,,20,20,40
027 Graun im Vinschgau,35,,22,17,39
027 Graun im Vinschgau,36,,19,12,31
027 Graun im Vinschgau,37,,21,15,36
027 Graun im Vinschgau,38,,26,20,46
027 Graun im Vinschgau,39,,15,21,36
027 Graun im Vinschgau,40,,25,22,47
027 Graun im Vinschgau,41,,20,22,42
027 Graun im Vinschgau,42,,18,20,38
027 Graun im Vinschgau,43,,22,22,44
027 Graun im Vinschgau,44,,23,17,40
027 Graun im Vinschgau,45,,22,24,46
027 Graun im Vinschgau,46,,19,12,31
027 Graun im Vinschgau,47,,21,19,40
027 Graun im Vinschgau,48,,20,11,31
027 Graun im Vinschgau,49,,19,15,34
027 Graun im Vinschgau,50,,12,13,25
027 Graun im Vinschgau,51,,15,10,25
027 Graun im Vinschgau,52,,13,9,22
027 Graun im Vinschgau,53,,16,15,31
027 Graun im Vinschgau,54,,14,6,20
027 Graun im Vinschgau,55,,17,11,28
027 Graun im Vinschgau,56,,12,16,28
027 Graun im Vinschgau,57,,12,12,24
027 Graun im Vinschgau,58,,7,21,28
027 Graun im Vinschgau,59,,14,12,26
027 Graun im Vinschgau,60,,5,9,14
027 Graun im Vinschgau,61,,10,8,18
027 Graun im Vinschgau,62,,8,8,16
027 Graun im Vinschgau,63,,11,9,20
027 Graun im Vinschgau,64,,9,11,20
027 Graun im Vinschgau,65,,9,12,21
027 Graun im Vinschgau,66,,15,10,25
027 Graun im Vinschgau,67,,11,9,20
027 Graun im Vinschgau,68,,10,11,21
027 Graun im Vinschgau,69,,9,11,20
027 Graun im Vinschgau,70,,12,3,15
027 Graun im Vinschgau,71,,13,14,27
027 Graun im Vinschgau,72,,8,7,15
027 Graun im Vinschgau,73,,12,9,21
027 Graun im Vinschgau,74,,7,7,14
027 Graun im Vinschgau,75,,10,7,17
027 Graun im Vinschgau,76,,9,10,19
027 Graun im Vinschgau,77,,3,5,8
027 Graun im Vinschgau,78,,11,12,23
027 Graun im Vinschgau,79,,6,10,16
027 Graun im Vinschgau,80,,5,7,12
027 Graun im Vinschgau,81,,6,11,17
027 Graun im Vinschgau,82,,3,4,7
027 Graun im Vinschgau,83,,4,6,10
027 Graun im Vinschgau,84,,4,10,14
027 Graun im Vinschgau,85,,6,6,12
027 Graun im Vinschgau,86,,5,8,13
027 Graun im Vinschgau,87,,1,1,2
027 Graun im Vinschgau,88,,-,4,4
027 Graun im Vinschgau,89,,1,1,2
027 Graun im Vinschgau,90,,-,1,1
027 Graun im Vinschgau,91,,-,1,1
027 Graun im Vinschgau,92,,-,1,1
027 Graun im Vinschgau,93,,1,1,2
027 Graun im Vinschgau,96,,-,2,2
027 Graun im Vinschgau,99,,-,1,1
028 Toblach,0,,22,13,35
028 Toblach,1,,18,11,29
028 Toblach,2,,13,17,30
028 Toblach,3,,19,22,41
028 Toblach,4,,20,26,46
028 Toblach,5,,13,21,34
028 Toblach,6,,27,17,44
028 Toblach,7,,21,14,35
028 Toblach,8,,15,23,38
028 Toblach,9,,17,11,28
028 Toblach,10,,23,17,40
028 Toblach,11,,28,23,51
028 Toblach,12,,17,9,26
028 Toblach,13,,22,18,40
028 Toblach,14,,19,20,39
028 Toblach,15,,14,17,31
028 Toblach,16,,17,28,45
028 Toblach,17,,16,22,38
028 Toblach,18,,9,14,23
028 Toblach,19,,14,24,38
028 Toblach,20,,30,17,47
028 Toblach,21,,15,21,36
028 Toblach,22,,24,21,45
028 Toblach,23,,21,28,49
028 Toblach,24,,23,19,42
028 Toblach,25,,26,25,51
028 Toblach,26,,23,23,46
028 Toblach,27,,22,17,39
028 Toblach,28,,28,24,52
028 Toblach,29,,23,21,44
028 Toblach,30,,14,23,37
028 Toblach,31,,25,33,58
028 Toblach,32,,22,20,42
028 Toblach,33,,28,18,46
028 Toblach,34,,27,22,49
028 Toblach,35,,29,30,59
028 Toblach,36,,30,21,51
028 Toblach,37,,19,22,41
028 Toblach,38,,40,26,66
028 Toblach,39,,33,27,60
028 Toblach,40,,25,19,44
028 Toblach,41,,28,28,56
028 Toblach,42,,33,26,59
028 Toblach,43,,35,29,64
028 Toblach,44,,29,25,54
028 Toblach,45,,36,29,65
028 Toblach,46,,23,31,54
028 Toblach,47,,21,17,38
028 Toblach,48,,35,27,62
028 Toblach,49,,22,17,39
028 Toblach,50,,27,22,49
028 Toblach,51,,17,24,41
028 Toblach,52,,17,27,44
028 Toblach,53,,19,20,39
028 Toblach,54,,20,24,44
028 Toblach,55,,20,15,35
028 Toblach,56,,26,12,38
028 Toblach,57,,14,17,31
028 Toblach,58,,20,14,34
028 Toblach,59,,14,24,38
028 Toblach,60,,20,15,35
028 Toblach,61,,12,14,26
028 Toblach,62,,9,17,26
028 Toblach,63,,17,10,27
028 Toblach,64,,13,18,31
028 Toblach,65,,15,19,34
028 Toblach,66,,17,12,29
028 Toblach,67,,13,13,26
028 Toblach,68,,14,13,27
028 Toblach,69,,14,8,22
028 Toblach,70,,4,10,14
028 Toblach,71,,8,15,23
028 Toblach,72,,7,17,24
028 Toblach,73,,14,15,29
028 Toblach,74,,9,9,18
028 Toblach,75,,11,15,26
028 Toblach,76,,13,11,24
028 Toblach,77,,9,11,20
028 Toblach,78,,9,12,21
028 Toblach,79,,10,9,19
028 Toblach,80,,8,11,19
028 Toblach,81,,7,11,18
028 Toblach,82,,8,7,15
028 Toblach,83,,5,7,12
028 Toblach,84,,5,5,10
028 Toblach,85,,4,7,11
028 Toblach,86,,1,8,9
028 Toblach,87,,3,3,6
028 Toblach,88,,3,5,8
028 Toblach,89,,1,1,2
028 Toblach,90,,1,2,3
028 Toblach,92,,1,5,6
028 Toblach,93,,1,-,1
028 Toblach,94,,-,2,2
028 Toblach,95,,-,1,1
028 Toblach,100,,1,-,1
029 Neumarkt,0,,26,16,42
029 Neumarkt,1,,21,33,54
029 Neumarkt,2,,28,29,57
029 Neumarkt,3,,23,17,40
029 Neumarkt,4,,38,28,66
029 Neumarkt,5,,30,22,52
029 Neumarkt,6,,32,32,64
029 Neumarkt,7,,31,19,50
029 Neumarkt,8,,24,28,52
029 Neumarkt,9,,19,41,60
029 Neumarkt,10,,20,17,37
029 Neumarkt,11,,21,24,45
029 Neumarkt,12,,23,24,47
029 Neumarkt,13,,24,22,46
029 Neumarkt,14,,22,38,60
029 Neumarkt,15,,24,27,51
029 Neumarkt,16,,23,20,43
029 Neumarkt,17,,24,26,50
029 Neumarkt,18,,24,31,55
029 Neumarkt,19,,22,26,48
029 Neumarkt,20,,23,27,50
029 Neumarkt,21,,23,20,43
029 Neumarkt,22,,24,23,47
029 Neumarkt,23,,20,24,44
029 Neumarkt,24,,20,31,51
029 Neumarkt,25,,24,25,49
029 Neumarkt,26,,28,27,55
029 Neumarkt,27,,23,35,58
029 Neumarkt,28,,33,25,58
029 Neumarkt,29,,42,35,77
029 Neumarkt,30,,23,25,48
029 Neumarkt,31,,24,35,59
029 Neumarkt,32,,39,35,74
029 Neumarkt,33,,36,40,76
029 Neumarkt,34,,30,29,59
029 Neumarkt,35,,39,36,75
029 Neumarkt,36,,31,47,78
029 Neumarkt,37,,30,37,67
029 Neumarkt,38,,36,37,73
029 Neumarkt,39,,30,47,77
029 Neumarkt,40,,45,49,94
029 Neumarkt,41,,56,47,103
029 Neumarkt,42,,51,40,91
029 Neumarkt,43,,49,48,97
029 Neumarkt,44,,46,47,93
029 Neumarkt,45,,49,36,85
029 Neumarkt,46,,35,42,77
029 Neumarkt,47,,48,41,89
029 Neumarkt,48,,43,33,76
029 Neumarkt,49,,28,34,62
029 Neumarkt,50,,41,31,72
029 Neumarkt,51,,31,25,56
029 Neumarkt,52,,42,43,85
029 Neumarkt,53,,35,28,63
029 Neumarkt,54,,18,17,35
029 Neumarkt,55,,28,22,50
029 Neumarkt,56,,23,24,47
029 Neumarkt,57,,22,22,44
029 Neumarkt,58,,13,24,37
029 Neumarkt,59,,20,23,43
029 Neumarkt,60,,25,30,55
029 Neumarkt,61,,33,32,65
029 Neumarkt,62,,23,21,44
029 Neumarkt,63,,19,18,37
029 Neumarkt,64,,22,22,44
029 Neumarkt,65,,24,24,48
029 Neumarkt,66,,37,25,62
029 Neumarkt,67,,27,32,59
029 Neumarkt,68,,18,29,47
029 Neumarkt,69,,18,16,34
029 Neumarkt,70,,20,14,34
029 Neumarkt,71,,20,17,37
029 Neumarkt,72,,19,23,42
029 Neumarkt,73,,14,22,36
029 Neumarkt,74,,17,16,33
029 Neumarkt,75,,15,20,35
029 Neumarkt,76,,21,29,50
029 Neumarkt,77,,14,22,36
029 Neumarkt,78,,12,16,28
029 Neumarkt,79,,4,18,22
029 Neumarkt,80,,13,16,29
029 Neumarkt,81,,11,17,28
029 Neumarkt,82,,10,18,28
029 Neumarkt,83,,6,14,20
029 Neumarkt,84,,13,18,31
029 Neumarkt,85,,7,7,14
029 Neumarkt,86,,4,19,23
029 Neumarkt,87,,2,13,15
029 Neumarkt,88,,3,3,6
029 Neumarkt,89,,1,1,2
029 Neumarkt,90,,-,3,3
029 Neumarkt,91,,-,2,2
029 Neumarkt,92,,-,3,3
029 Neumarkt,93,,2,3,5
029 Neumarkt,94,,1,1,2
029 Neumarkt,95,,-,3,3
029 Neumarkt,96,,-,1,1
029 Neumarkt,97,,-,2,2
030 Pfalzen,0,,14,11,25
030 Pfalzen,1,,18,14,32
030 Pfalzen,2,,19,14,33
030 Pfalzen,3,,15,19,34
030 Pfalzen,4,,21,12,33
030 Pfalzen,5,,14,16,30
030 Pfalzen,6,,17,15,32
030 Pfalzen,7,,14,16,30
030 Pfalzen,8,,20,19,39
030 Pfalzen,9,,16,15,31
030 Pfalzen,10,,13,17,30
030 Pfalzen,11,,15,14,29
030 Pfalzen,12,,23,19,42
030 Pfalzen,13,,12,18,30
030 Pfalzen,14,,11,19,30
030 Pfalzen,15,,13,22,35
030 Pfalzen,16,,14,19,33
030 Pfalzen,17,,18,13,31
030 Pfalzen,18,,17,21,38
030 Pfalzen,19,,13,8,21
030 Pfalzen,20,,12,23,35
030 Pfalzen,21,,18,18,36
030 Pfalzen,22,,22,13,35
030 Pfalzen,23,,15,13,28
030 Pfalzen,24,,12,11,23
030 Pfalzen,25,,20,20,40
030 Pfalzen,26,,17,20,37
030 Pfalzen,27,,18,22,40
030 Pfalzen,28,,19,22,41
030 Pfalzen,29,,19,18,37
030 Pfalzen,30,,19,20,39
030 Pfalzen,31,,19,12,31
030 Pfalzen,32,,12,18,30
030 Pfalzen,33,,23,16,39
030 Pfalzen,34,,19,24,43
030 Pfalzen,35,,21,20,41
030 Pfalzen,36,,28,27,55
030 Pfalzen,37,,21,24,45
030 Pfalzen,38,,29,11,40
030 Pfalzen,39,,20,35,55
030 Pfalzen,40,,19,21,40
030 Pfalzen,41,,22,22,44
030 Pfalzen,42,,23,26,49
030 Pfalzen,43,,19,20,39
030 Pfalzen,44,,31,20,51
030 Pfalzen,45,,22,32,54
030 Pfalzen,46,,24,20,44
030 Pfalzen,47,,22,14,36
030 Pfalzen,48,,15,13,28
030 Pfalzen,49,,16,20,36
030 Pfalzen,50,,25,19,44
030 Pfalzen,51,,16,15,31
030 Pfalzen,52,,16,10,26
030 Pfalzen,53,,12,11,23
030 Pfalzen,54,,14,11,25
030 Pfalzen,55,,10,10,20
030 Pfalzen,56,,15,18,33
030 Pfalzen,57,,11,11,22
030 Pfalzen,58,,16,6,22
030 Pfalzen,59,,9,10,19
030 Pfalzen,60,,11,3,14
030 Pfalzen,61,,8,9,17
030 Pfalzen,62,,7,8,15
030 Pfalzen,63,,8,6,14
030 Pfalzen,64,,8,11,19
030 Pfalzen,65,,7,12,19
030 Pfalzen,66,,11,8,19
030 Pfalzen,67,,12,9,21
030 Pfalzen,68,,9,5,14
030 Pfalzen,69,,12,9,21
030 Pfalzen,70,,5,5,10
030 Pfalzen,71,,2,9,11
030 Pfalzen,72,,7,6,13
030 Pfalzen,73,,8,12,20
030 Pfalzen,74,,7,8,15
030 Pfalzen,75,,8,5,13
030 Pfalzen,76,,9,7,16
030 Pfalzen,77,,7,10,17
030 Pfalzen,78,,8,5,13
030 Pfalzen,79,,2,4,6
030 Pfalzen,80,,5,5,10
030 Pfalzen,81,,4,2,6
030 Pfalzen,82,,4,3,7
030 Pfalzen,83,,3,7,10
030 Pfalzen,84,,5,3,8
030 Pfalzen,85,,2,2,4
030 Pfalzen,86,,-,4,4
030 Pfalzen,87,,-,5,5
030 Pfalzen,88,,3,1,4
030 Pfalzen,89,,1,1,2
030 Pfalzen,90,,-,2,2
030 Pfalzen,91,,-,2,2
030 Pfalzen,93,,-,4,4
030 Pfalzen,94,,1,1,2
031 Völs am Schlern,0,,17,23,40
031 Völs am Schlern,1,,22,24,46
031 Völs am Schlern,2,,33,12,45
031 Völs am Schlern,3,,19,15,34
031 Völs am Schlern,4,,15,23,38
031 Völs am Schlern,5,,16,29,45
031 Völs am Schlern,6,,20,24,44
031 Völs am Schlern,7,,23,26,49
031 Völs am Schlern,8,,18,19,37
031 Völs am Schlern,9,,24,27,51
031 Völs am Schlern,10,,18,25,43
031 Völs am Schlern,11,,14,21,35
031 Völs am Schlern,12,,23,22,45
031 Völs am Schlern,13,,20,10,30
031 Völs am Schlern,14,,16,16,32
031 Völs am Schlern,15,,20,19,39
031 Völs am Schlern,16,,12,20,32
031 Völs am Schlern,17,,21,19,40
031 Völs am Schlern,18,,20,15,35
031 Völs am Schlern,19,,19,16,35
031 Völs am Schlern,20,,19,14,33
031 Völs am Schlern,21,,22,13,35
031 Völs am Schlern,22,,15,15,30
031 Völs am Schlern,23,,16,9,25
031 Völs am Schlern,24,,13,24,37
031 Völs am Schlern,25,,21,26,47
031 Völs am Schlern,26,,28,20,48
031 Völs am Schlern,27,,31,13,44
031 Völs am Schlern,28,,25,25,50
031 Völs am Schlern,29,,29,23,52
031 Völs am Schlern,30,,22,29,51
031 Völs am Schlern,31,,33,21,54
031 Völs am Schlern,32,,22,18,40
031 Völs am Schlern,33,,22,26,48
031 Völs am Schlern,34,,27,30,57
031 Völs am Schlern,35,,42,28,70
031 Völs am Schlern,36,,40,35,75
031 Völs am Schlern,37,,26,35,61
031 Völs am Schlern,38,,36,33,69
031 Völs am Schlern,39,,36,36,72
031 Völs am Schlern,40,,29,27,56
031 Völs am Schlern,41,,39,32,71
031 Völs am Schlern,42,,28,29,57
031 Völs am Schlern,43,,31,23,54
031 Völs am Schlern,44,,32,23,55
031 Völs am Schlern,45,,29,20,49
031 Völs am Schlern,46,,25,22,47
031 Völs am Schlern,47,,22,19,41
031 Völs am Schlern,48,,22,13,35
031 Völs am Schlern,49,,22,15,37
031 Völs am Schlern,50,,21,19,40
031 Völs am Schlern,51,,16,20,36
031 Völs am Schlern,52,,19,16,35
031 Völs am Schlern,53,,17,25,42
031 Völs am Schlern,54,,17,24,41
031 Völs am Schlern,55,,17,17,34
031 Völs am Schlern,56,,19,21,40
031 Völs am Schlern,57,,19,18,37
031 Völs am Schlern,58,,16,8,24
031 Völs am Schlern,59,,16,12,28
031 Völs am Schlern,60,,15,21,36
031 Völs am Schlern,61,,18,12,30
031 Völs am Schlern,62,,8,13,21
031 Völs am Schlern,63,,15,9,24
031 Völs am Schlern,64,,14,21,35
031 Völs am Schlern,65,,15,16,31
031 Völs am Schlern,66,,19,20,39
031 Völs am Schlern,67,,11,21,32
031 Völs am Schlern,68,,13,11,24
031 Völs am Schlern,69,,11,16,27
031 Völs am Schlern,70,,10,10,20
031 Völs am Schlern,71,,8,19,27
031 Völs am Schlern,72,,14,13,27
031 Völs am Schlern,73,,13,8,21
031 Völs am Schlern,74,,6,14,20
031 Völs am Schlern,75,,14,8,22
031 Völs am Schlern,76,,12,15,27
031 Völs am Schlern,77,,4,12,16
031 Völs am Schlern,78,,6,11,17
031 Völs am Schlern,79,,5,14,19
031 Völs am Schlern,80,,7,10,17
031 Völs am Schlern,81,,4,6,10
031 Völs am Schlern,82,,6,10,16
031 Völs am Schlern,83,,7,10,17
031 Völs am Schlern,84,,2,4,6
031 Völs am Schlern,85,,2,6,8
031 Völs am Schlern,86,,2,9,11
031 Völs am Schlern,87,,3,5,8
031 Völs am Schlern,88,,1,3,4
031 Völs am Schlern,89,,1,3,4
031 Völs am Schlern,90,,1,2,3
031 Völs am Schlern,91,,1,-,1
031 Völs am Schlern,92,,2,1,3
031 Völs am Schlern,93,,2,2,4
031 Völs am Schlern,97,,1,-,1
031 Völs am Schlern,98,,1,-,1
032 Franzensfeste,0,,7,5,12
032 Franzensfeste,1,,4,6,10
032 Franzensfeste,2,,4,5,9
032 Franzensfeste,3,,4,5,9
032 Franzensfeste,4,,7,3,10
032 Franzensfeste,5,,11,3,14
032 Franzensfeste,6,,5,6,11
032 Franzensfeste,7,,3,5,8
032 Franzensfeste,8,,6,5,11
032 Franzensfeste,9,,6,5,11
032 Franzensfeste,10,,5,2,7
032 Franzensfeste,11,,6,4,10
032 Franzensfeste,12,,5,1,6
032 Franzensfeste,13,,6,6,12
032 Franzensfeste,14,,6,5,11
032 Franzensfeste,15,,5,6,11
032 Franzensfeste,16,,5,5,10
032 Franzensfeste,17,,2,6,8
032 Franzensfeste,18,,5,4,9
032 Franzensfeste,19,,2,3,5
032 Franzensfeste,20,,4,-,4
032 Franzensfeste,21,,7,3,10
032 Franzensfeste,22,,4,7,11
032 Franzensfeste,23,,3,7,10
032 Franzensfeste,24,,8,7,15
032 Franzensfeste,25,,5,8,13
032 Franzensfeste,26,,11,5,16
032 Franzensfeste,27,,6,9,15
032 Franzensfeste,28,,12,4,16
032 Franzensfeste,29,,7,6,13
032 Franzensfeste,30,,5,4,9
032 Franzensfeste,31,,4,4,8
032 Franzensfeste,32,,11,12,23
032 Franzensfeste,33,,10,7,17
032 Franzensfeste,34,,3,7,10
032 Franzensfeste,35,,6,11,17
032 Franzensfeste,36,,4,3,7
032 Franzensfeste,37,,9,5,14
032 Franzensfeste,38,,10,7,17
032 Franzensfeste,39,,12,10,22
032 Franzensfeste,40,,8,6,14
032 Franzensfeste,41,,11,5,16
032 Franzensfeste,42,,9,8,17
032 Franzensfeste,43,,14,6,20
032 Franzensfeste,44,,6,9,15
032 Franzensfeste,45,,12,3,15
032 Franzensfeste,46,,6,9,15
032 Franzensfeste,47,,4,7,11
032 Franzensfeste,48,,8,9,17
032 Franzensfeste,49,,13,2,15
032 Franzensfeste,50,,5,6,11
032 Franzensfeste,51,,5,7,12
032 Franzensfeste,52,,8,7,15
032 Franzensfeste,53,,6,10,16
032 Franzensfeste,54,,6,6,12
032 Franzensfeste,55,,5,4,9
032 Franzensfeste,56,,7,1,8
032 Franzensfeste,57,,11,3,14
032 Franzensfeste,58,,3,5,8
032 Franzensfeste,59,,4,4,8
032 Franzensfeste,60,,2,3,5
032 Franzensfeste,61,,8,6,14
032 Franzensfeste,62,,5,7,12
032 Franzensfeste,63,,4,9,13
032 Franzensfeste,64,,3,3,6
032 Franzensfeste,65,,4,1,5
032 Franzensfeste,66,,5,2,7
032 Franzensfeste,67,,3,4,7
032 Franzensfeste,68,,5,3,8
032 Franzensfeste,69,,1,3,4
032 Franzensfeste,70,,7,5,12
032 Franzensfeste,71,,4,2,6
032 Franzensfeste,72,,2,2,4
032 Franzensfeste,73,,3,3,6
032 Franzensfeste,74,,1,6,7
032 Franzensfeste,75,,3,4,7
032 Franzensfeste,76,,2,7,9
032 Franzensfeste,77,,6,4,10
032 Franzensfeste,78,,3,7,10
032 Franzensfeste,79,,2,3,5
032 Franzensfeste,80,,3,5,8
032 Franzensfeste,81,,3,9,12
032 Franzensfeste,82,,3,1,4
032 Franzensfeste,83,,4,4,8
032 Franzensfeste,84,,3,6,9
032 Franzensfeste,85,,2,4,6
032 Franzensfeste,86,,1,3,4
032 Franzensfeste,87,,-,1,1
032 Franzensfeste,89,,-,2,2
032 Franzensfeste,92,,1,1,2
032 Franzensfeste,95,,-,1,1
032 Franzensfeste,96,,-,1,1
033 Villnöss,0,,15,16,31
033 Villnöss,1,,12,22,34
033 Villnöss,2,,19,22,41
033 Villnöss,3,,13,14,27
033 Villnöss,4,,16,14,30
033 Villnöss,5,,21,13,34
033 Villnöss,6,,15,22,37
033 Villnöss,7,,18,14,32
033 Villnöss,8,,16,30,46
033 Villnöss,9,,22,20,42
033 Villnöss,10,,17,23,40
033 Villnöss,11,,21,17,38
033 Villnöss,12,,17,13,30
033 Villnöss,13,,14,12,26
033 Villnöss,14,,17,12,29
033 Villnöss,15,,11,14,25
033 Villnöss,16,,21,16,37
033 Villnöss,17,,15,11,26
033 Villnöss,18,,13,9,22
033 Villnöss,19,,16,23,39
033 Villnöss,20,,17,21,38
033 Villnöss,21,,10,14,24
033 Villnöss,22,,17,15,32
033 Villnöss,23,,16,15,31
033 Villnöss,24,,16,13,29
033 Villnöss,25,,13,17,30
033 Villnöss,26,,16,17,33
033 Villnöss,27,,22,12,34
033 Villnöss,28,,10,11,21
033 Villnöss,29,,17,14,31
033 Villnöss,30,,15,13,28
033 Villnöss,31,,15,13,28
033 Villnöss,32,,22,17,39
033 Villnöss,33,,21,18,39
033 Villnöss,34,,9,17,26
033 Villnöss,35,,16,25,41
033 Villnöss,36,,22,26,48
033 Villnöss,37,,16,26,42
033 Villnöss,38,,27,22,49
033 Villnöss,39,,29,19,48
033 Villnöss,40,,18,18,36
033 Villnöss,41,,26,17,43
033 Villnöss,42,,26,21,47
033 Villnöss,43,,31,28,59
033 Villnöss,44,,30,20,50
033 Villnöss,45,,28,20,48
033 Villnöss,46,,24,14,38
033 Villnöss,47,,20,12,32
033 Villnöss,48,,10,10,20
033 Villnöss,49,,10,15,25
033 Villnöss,50,,13,11,24
033 Villnöss,51,,15,16,31
033 Villnöss,52,,11,3,14
033 Villnöss,53,,17,13,30
033 Villnöss,54,,13,16,29
033 Villnöss,55,,13,11,24
033 Villnöss,56,,12,9,21
033 Villnöss,57,,7,9,16
033 Villnöss,58,,7,14,21
033 Villnöss,59,,10,10,20
033 Villnöss,60,,12,11,23
033 Villnöss,61,,10,5,15
033 Villnöss,62,,8,4,12
033 Villnöss,63,,6,13,19
033 Villnöss,64,,12,10,22
033 Villnöss,65,,11,18,29
033 Villnöss,66,,11,9,20
033 Villnöss,67,,7,17,24
033 Villnöss,68,,12,13,25
033 Villnöss,69,,12,9,21
033 Villnöss,70,,8,15,23
033 Villnöss,71,,3,16,19
033 Villnöss,72,,4,9,13
033 Villnöss,73,,9,9,18
033 Villnöss,74,,7,11,18
033 Villnöss,75,,12,12,24
033 Villnöss,76,,9,11,20
033 Villnöss,77,,10,10,20
033 Villnöss,78,,9,11,20
033 Villnöss,79,,14,6,20
033 Villnöss,80,,6,9,15
033 Villnöss,81,,3,8,11
033 Villnöss,82,,5,6,11
033 Villnöss,83,,2,7,9
033 Villnöss,84,,5,11,16
033 Villnöss,85,,3,4,7
033 Villnöss,86,,1,3,4
033 Villnöss,87,,-,5,5
033 Villnöss,88,,2,2,4
033 Villnöss,89,,-,1,1
033 Villnöss,90,,-,3,3
033 Villnöss,92,,1,2,3
033 Villnöss,93,,-,1,1
033 Villnöss,94,,-,1,1
033 Villnöss,98,,-,1,1
034 Gais,0,,16,18,34
034 Gais,1,,23,16,39
034 Gais,2,,28,17,45
034 Gais,3,,11,26,37
034 Gais,4,,19,17,36
034 Gais,5,,21,23,44
034 Gais,6,,22,15,37
034 Gais,7,,21,16,37
034 Gais,8,,21,27,48
034 Gais,9,,22,21,43
034 Gais,10,,29,12,41
034 Gais,11,,10,18,28
034 Gais,12,,28,18,46
034 Gais,13,,22,24,46
034 Gais,14,,12,19,31
034 Gais,15,,21,30,51
034 Gais,16,,26,30,56
034 Gais,17,,15,21,36
034 Gais,18,,17,13,30
034 Gais,19,,16,15,31
034 Gais,20,,18,18,36
034 Gais,21,,17,19,36
034 Gais,22,,20,16,36
034 Gais,23,,22,17,39
034 Gais,24,,21,22,43
034 Gais,25,,18,15,33
034 Gais,26,,25,18,43
034 Gais,27,,26,27,53
034 Gais,28,,27,16,43
034 Gais,29,,19,22,41
034 Gais,30,,21,24,45
034 Gais,31,,24,26,50
034 Gais,32,,29,20,49
034 Gais,33,,31,27,58
034 Gais,34,,25,25,50
034 Gais,35,,31,38,69
034 Gais,36,,37,26,63
034 Gais,37,,28,28,56
034 Gais,38,,38,32,70
034 Gais,39,,22,20,42
034 Gais,40,,25,31,56
034 Gais,41,,34,20,54
034 Gais,42,,24,25,49
034 Gais,43,,31,30,61
034 Gais,44,,16,17,33
034 Gais,45,,30,19,49
034 Gais,46,,24,31,55
034 Gais,47,,18,11,29
034 Gais,48,,18,21,39
034 Gais,49,,25,20,45
034 Gais,50,,13,16,29
034 Gais,51,,24,18,42
034 Gais,52,,21,12,33
034 Gais,53,,15,14,29
034 Gais,54,,13,14,27
034 Gais,55,,15,17,32
034 Gais,56,,14,20,34
034 Gais,57,,22,21,43
034 Gais,58,,15,11,26
034 Gais,59,,23,13,36
034 Gais,60,,20,11,31
034 Gais,61,,16,18,34
034 Gais,62,,13,9,22
034 Gais,63,,12,13,25
034 Gais,64,,11,16,27
034 Gais,65,,12,13,25
034 Gais,66,,21,12,33
034 Gais,67,,17,13,30
034 Gais,68,,12,15,27
034 Gais,69,,14,13,27
034 Gais,70,,17,16,33
034 Gais,71,,10,13,23
034 Gais,72,,12,12,24
034 Gais,73,,6,6,12
034 Gais,74,,4,10,14
034 Gais,75,,6,8,14
034 Gais,76,,8,7,15
034 Gais,77,,3,12,15
034 Gais,78,,4,3,7
034 Gais,79,,10,8,18
034 Gais,80,,7,7,14
034 Gais,81,,9,6,15
034 Gais,82,,3,4,7
034 Gais,83,,4,3,7
034 Gais,84,,2,9,11
034 Gais,85,,2,4,6
034 Gais,86,,3,4,7
034 Gais,87,,2,1,3
034 Gais,88,,-,2,2
034 Gais,89,,1,1,2
034 Gais,90,,1,-,1
034 Gais,91,,-,2,2
034 Gais,92,,-,1,1
034 Gais,94,,2,-,2
034 Gais,96,,-,1,1
035 Gargazon,0,,8,4,12
035 Gargazon,1,,10,14,24
035 Gargazon,2,,4,6,10
035 Gargazon,3,,9,7,16
035 Gargazon,4,,7,13,20
035 Gargazon,5,,7,13,20
035 Gargazon,6,,4,8,12
035 Gargazon,7,,10,5,15
035 Gargazon,8,,14,9,23
035 Gargazon,9,,14,9,23
035 Gargazon,10,,6,13,19
035 Gargazon,11,,11,7,18
035 Gargazon,12,,11,4,15
035 Gargazon,13,,4,7,11
035 Gargazon,14,,9,8,17
035 Gargazon,15,,15,9,24
035 Gargazon,16,,17,9,26
035 Gargazon,17,,7,10,17
035 Gargazon,18,,8,8,16
035 Gargazon,19,,9,5,14
035 Gargazon,20,,6,9,15
035 Gargazon,21,,4,11,15
035 Gargazon,22,,11,4,15
035 Gargazon,23,,9,3,12
035 Gargazon,24,,5,9,14
035 Gargazon,25,,5,8,13
035 Gargazon,26,,10,7,17
035 Gargazon,27,,9,16,25
035 Gargazon,28,,10,7,17
035 Gargazon,29,,4,12,16
035 Gargazon,30,,10,10,20
035 Gargazon,31,,5,9,14
035 Gargazon,32,,9,10,19
035 Gargazon,33,,17,14,31
035 Gargazon,34,,14,11,25
035 Gargazon,35,,10,18,28
035 Gargazon,36,,18,15,33
035 Gargazon,37,,13,11,24
035 Gargazon,38,,18,14,32
035 Gargazon,39,,16,19,35
035 Gargazon,40,,11,14,25
035 Gargazon,41,,14,15,29
035 Gargazon,42,,13,9,22
035 Gargazon,43,,16,16,32
035 Gargazon,44,,20,19,39
035 Gargazon,45,,13,13,26
035 Gargazon,46,,11,14,25
035 Gargazon,47,,12,11,23
035 Gargazon,48,,18,14,32
035 Gargazon,49,,6,7,13
035 Gargazon,50,,14,11,25
035 Gargazon,51,,12,6,18
035 Gargazon,52,,8,3,11
035 Gargazon,53,,10,10,20
035 Gargazon,54,,14,9,23
035 Gargazon,55,,4,9,13
035 Gargazon,56,,10,9,19
035 Gargazon,57,,9,7,16
035 Gargazon,58,,6,9,15
035 Gargazon,59,,8,8,16
035 Gargazon,60,,5,7,12
035 Gargazon,61,,8,15,23
035 Gargazon,62,,9,5,14
035 Gargazon,63,,5,4,9
035 Gargazon,64,,5,7,12
035 Gargazon,65,,6,10,16
035 Gargazon,66,,9,9,18
035 Gargazon,67,,4,16,20
035 Gargazon,68,,9,7,16
035 Gargazon,69,,9,7,16
035 Gargazon,70,,7,13,20
035 Gargazon,71,,6,4,10
035 Gargazon,72,,12,2,14
035 Gargazon,73,,6,6,12
035 Gargazon,74,,1,10,11
035 Gargazon,75,,5,2,7
035 Gargazon,76,,3,7,10
035 Gargazon,77,,3,4,7
035 Gargazon,78,,2,5,7
035 Gargazon,79,,2,4,6
035 Gargazon,80,,2,5,7
035 Gargazon,81,,4,3,7
035 Gargazon,82,,2,4,6
035 Gargazon,83,,-,3,3
035 Gargazon,84,,4,4,8
035 Gargazon,85,,2,6,8
035 Gargazon,86,,1,3,4
035 Gargazon,88,,1,1,2
035 Gargazon,90,,-,1,1
035 Gargazon,91,,-,1,1
035 Gargazon,92,,2,2,4
035 Gargazon,93,,1,-,1
035 Gargazon,94,,1,3,4
035 Gargazon,95,,1,1,2
035 Gargazon,98,,-,1,1
035 Gargazon,101,,-,1,1
036 Glurns,0,,6,2,8
036 Glurns,1,,4,6,10
036 Glurns,2,,7,5,12
036 Glurns,3,,3,5,8
036 Glurns,4,,6,5,11
036 Glurns,5,,3,5,8
036 Glurns,6,,5,-,5
036 Glurns,7,,4,4,8
036 Glurns,8,,3,2,5
036 Glurns,9,,10,3,13
036 Glurns,10,,4,7,11
036 Glurns,11,,7,3,10
036 Glurns,12,,7,4,11
036 Glurns,13,,2,3,5
036 Glurns,14,,7,7,14
036 Glurns,15,,5,8,13
036 Glurns,16,,6,4,10
036 Glurns,17,,8,6,14
036 Glurns,18,,4,3,7
036 Glurns,19,,6,8,14
036 Glurns,20,,6,6,12
036 Glurns,21,,6,6,12
036 Glurns,22,,3,1,4
036 Glurns,23,,6,6,12
036 Glurns,24,,10,6,16
036 Glurns,25,,9,10,19
036 Glurns,26,,6,6,12
036 Glurns,27,,10,4,14
036 Glurns,28,,7,9,16
036 Glurns,29,,6,7,13
036 Glurns,30,,4,5,9
036 Glurns,31,,12,5,17
036 Glurns,32,,8,10,18
036 Glurns,33,,9,11,20
036 Glurns,34,,3,3,6
036 Glurns,35,,5,7,12
036 Glurns,36,,5,4,9
036 Glurns,37,,5,-,5
036 Glurns,38,,3,6,9
036 Glurns,39,,8,4,12
036 Glurns,40,,6,9,15
036 Glurns,41,,5,7,12
036 Glurns,42,,1,5,6
036 Glurns,43,,9,5,14
036 Glurns,44,,5,9,14
036 Glurns,45,,5,5,10
036 Glurns,46,,4,5,9
036 Glurns,47,,6,9,15
036 Glurns,48,,12,6,18
036 Glurns,49,,4,10,14
036 Glurns,50,,6,12,18
036 Glurns,51,,6,6,12
036 Glurns,52,,9,7,16
036 Glurns,53,,12,4,16
036 Glurns,54,,9,9,18
036 Glurns,55,,5,9,14
036 Glurns,56,,8,10,18
036 Glurns,57,,6,5,11
036 Glurns,58,,6,3,9
036 Glurns,59,,7,5,12
036 Glurns,60,,10,7,17
036 Glurns,61,,8,2,10
036 Glurns,62,,6,1,7
036 Glurns,63,,4,4,8
036 Glurns,64,,1,4,5
036 Glurns,65,,4,6,10
036 Glurns,66,,4,2,6
036 Glurns,67,,6,1,7
036 Glurns,68,,1,3,4
036 Glurns,69,,4,3,7
036 Glurns,70,,4,5,9
036 Glurns,71,,-,1,1
036 Glurns,72,,2,4,6
036 Glurns,73,,1,5,6
036 Glurns,74,,1,1,2
036 Glurns,75,,6,3,9
036 Glurns,76,,4,1,5
036 Glurns,77,,2,2,4
036 Glurns,78,,2,7,9
036 Glurns,79,,-,2,2
036 Glurns,80,,1,3,4
036 Glurns,81,,-,2,2
036 Glurns,82,,1,6,7
036 Glurns,83,,2,2,4
036 Glurns,84,,-,1,1
036 Glurns,86,,1,-,1
036 Glurns,87,,1,-,1
036 Glurns,88,,1,1,2
036 Glurns,90,,-,1,1
036 Glurns,92,,-,1,1
036 Glurns,94,,-,2,2
037 Latsch,0,,26,30,56
037 Latsch,1,,28,29,57
037 Latsch,2,,22,27,49
037 Latsch,3,,31,23,54
037 Latsch,4,,22,23,45
037 Latsch,5,,29,28,57
037 Latsch,6,,33,24,57
037 Latsch,7,,33,31,64
037 Latsch,8,,30,22,52
037 Latsch,9,,27,18,45
037 Latsch,10,,37,39,76
037 Latsch,11,,37,34,71
037 Latsch,12,,45,34,79
037 Latsch,13,,40,22,62
037 Latsch,14,,34,34,68
037 Latsch,15,,33,37,70
037 Latsch,16,,30,36,66
037 Latsch,17,,35,48,83
037 Latsch,18,,34,32,66
037 Latsch,19,,40,34,74
037 Latsch,20,,31,38,69
037 Latsch,21,,36,28,64
037 Latsch,22,,32,37,69
037 Latsch,23,,36,35,71
037 Latsch,24,,31,37,68
037 Latsch,25,,35,46,81
037 Latsch,26,,29,44,73
037 Latsch,27,,34,38,72
037 Latsch,28,,39,36,75
037 Latsch,29,,35,20,55
037 Latsch,30,,36,35,71
037 Latsch,31,,27,23,50
037 Latsch,32,,37,34,71
037 Latsch,33,,26,30,56
037 Latsch,34,,35,34,69
037 Latsch,35,,33,36,69
037 Latsch,36,,47,44,91
037 Latsch,37,,36,34,70
037 Latsch,38,,39,41,80
037 Latsch,39,,48,51,99
037 Latsch,40,,55,52,107
037 Latsch,41,,31,50,81
037 Latsch,42,,56,46,102
037 Latsch,43,,60,47,107
037 Latsch,44,,54,46,100
037 Latsch,45,,40,43,83
037 Latsch,46,,45,40,85
037 Latsch,47,,37,53,90
037 Latsch,48,,44,45,89
037 Latsch,49,,39,29,68
037 Latsch,50,,30,33,63
037 Latsch,51,,31,33,64
037 Latsch,52,,35,26,61
037 Latsch,53,,31,19,50
037 Latsch,54,,24,23,47
037 Latsch,55,,38,21,59
037 Latsch,56,,20,33,53
037 Latsch,57,,32,15,47
037 Latsch,58,,17,21,38
037 Latsch,59,,16,22,38
037 Latsch,60,,17,15,32
037 Latsch,61,,21,22,43
037 Latsch,62,,17,19,36
037 Latsch,63,,24,11,35
037 Latsch,64,,24,21,45
037 Latsch,65,,24,25,49
037 Latsch,66,,16,23,39
037 Latsch,67,,20,24,44
037 Latsch,68,,19,18,37
037 Latsch,69,,15,26,41
037 Latsch,70,,12,26,38
037 Latsch,71,,17,13,30
037 Latsch,72,,27,14,41
037 Latsch,73,,17,26,43
037 Latsch,74,,17,22,39
037 Latsch,75,,23,19,42
037 Latsch,76,,16,18,34
037 Latsch,77,,18,18,36
037 Latsch,78,,15,15,30
037 Latsch,79,,16,18,34
037 Latsch,80,,12,25,37
037 Latsch,81,,14,17,31
037 Latsch,82,,12,16,28
037 Latsch,83,,6,11,17
037 Latsch,84,,6,14,20
037 Latsch,85,,6,12,18
037 Latsch,86,,11,7,18
037 Latsch,87,,4,5,9
037 Latsch,88,,2,9,11
037 Latsch,89,,2,3,5
037 Latsch,90,,1,2,3
037 Latsch,91,,1,1,2
037 Latsch,92,,-,3,3
037 Latsch,93,,2,2,4
037 Latsch,94,,1,1,2
037 Latsch,95,,1,2,3
037 Latsch,96,,-,1,1
037 Latsch,98,,-,1,1
038 Algund,0,,22,24,46
038 Algund,1,,25,18,43
038 Algund,2,,20,24,44
038 Algund,3,,20,19,39
038 Algund,4,,30,22,52
038 Algund,5,,19,29,48
038 Algund,6,,31,24,55
038 Algund,7,,24,30,54
038 Algund,8,,35,27,62
038 Algund,9,,23,23,46
038 Algund,10,,22,19,41
038 Algund,11,,17,20,37
038 Algund,12,,31,23,54
038 Algund,13,,25,18,43
038 Algund,14,,24,18,42
038 Algund,15,,32,20,52
038 Algund,16,,26,23,49
038 Algund,17,,33,21,54
038 Algund,18,,22,29,51
038 Algund,19,,18,26,44
038 Algund,20,,28,25,53
038 Algund,21,,19,37,56
038 Algund,22,,26,20,46
038 Algund,23,,25,27,52
038 Algund,24,,27,33,60
038 Algund,25,,26,20,46
038 Algund,26,,29,31,60
038 Algund,27,,30,28,58
038 Algund,28,,21,28,49
038 Algund,29,,22,28,50
038 Algund,30,,25,38,63
038 Algund,31,,26,32,58
038 Algund,32,,36,35,71
038 Algund,33,,23,36,59
038 Algund,34,,34,26,60
038 Algund,35,,40,32,72
038 Algund,36,,33,38,71
038 Algund,37,,52,36,88
038 Algund,38,,44,46,90
038 Algund,39,,40,33,73
038 Algund,40,,39,43,82
038 Algund,41,,43,36,79
038 Algund,42,,36,41,77
038 Algund,43,,50,26,76
038 Algund,44,,31,36,67
038 Algund,45,,35,42,77
038 Algund,46,,28,50,78
038 Algund,47,,34,41,75
038 Algund,48,,37,34,71
038 Algund,49,,42,29,71
038 Algund,50,,25,34,59
038 Algund,51,,34,30,64
038 Algund,52,,27,28,55
038 Algund,53,,36,23,59
038 Algund,54,,17,31,48
038 Algund,55,,26,25,51
038 Algund,56,,26,29,55
038 Algund,57,,21,28,49
038 Algund,58,,24,25,49
038 Algund,59,,29,23,52
038 Algund,60,,20,21,41
038 Algund,61,,30,29,59
038 Algund,62,,26,25,51
038 Algund,63,,24,25,49
038 Algund,64,,20,21,41
038 Algund,65,,16,35,51
038 Algund,66,,17,21,38
038 Algund,67,,17,24,41
038 Algund,68,,23,28,51
038 Algund,69,,21,23,44
038 Algund,70,,15,15,30
038 Algund,71,,16,27,43
038 Algund,72,,14,15,29
038 Algund,73,,22,25,47
038 Algund,74,,21,22,43
038 Algund,75,,14,20,34
038 Algund,76,,13,24,37
038 Algund,77,,14,20,34
038 Algund,78,,8,21,29
038 Algund,79,,10,19,29
038 Algund,80,,11,15,26
038 Algund,81,,12,15,27
038 Algund,82,,11,13,24
038 Algund,83,,5,14,19
038 Algund,84,,3,9,12
038 Algund,85,,5,14,19
038 Algund,86,,3,8,11
038 Algund,87,,5,6,11
038 Algund,88,,2,8,10
038 Algund,89,,2,4,6
038 Algund,90,,-,4,4
038 Algund,91,,2,2,4
038 Algund,92,,-,2,2
038 Algund,93,,-,2,2
038 Algund,94,,1,1,2
038 Algund,95,,1,4,5
038 Algund,96,,-,6,6
038 Algund,97,,-,1,1
038 Algund,99,,-,2,2
038 Algund,101,,-,1,1
039 Lajen,0,,18,14,32
039 Lajen,1,,14,20,34
039 Lajen,2,,18,15,33
039 Lajen,3,,16,24,40
039 Lajen,4,,20,23,43
039 Lajen,5,,22,7,29
039 Lajen,6,,22,19,41
039 Lajen,7,,26,17,43
039 Lajen,8,,20,16,36
039 Lajen,9,,18,16,34
039 Lajen,10,,15,22,37
039 Lajen,11,,15,11,26
039 Lajen,12,,7,11,18
039 Lajen,13,,11,16,27
039 Lajen,14,,14,13,27
039 Lajen,15,,16,9,25
039 Lajen,16,,20,17,37
039 Lajen,17,,8,8,16
039 Lajen,18,,17,14,31
039 Lajen,19,,11,12,23
039 Lajen,20,,13,5,18
039 Lajen,21,,17,16,33
039 Lajen,22,,19,13,32
039 Lajen,23,,12,14,26
039 Lajen,24,,9,23,32
039 Lajen,25,,17,19,36
039 Lajen,26,,10,19,29
039 Lajen,27,,21,18,39
039 Lajen,28,,23,18,41
039 Lajen,29,,24,23,47
039 Lajen,30,,25,15,40
039 Lajen,31,,24,21,45
039 Lajen,32,,19,20,39
039 Lajen,33,,28,21,49
039 Lajen,34,,21,23,44
039 Lajen,35,,20,23,43
039 Lajen,36,,18,22,40
039 Lajen,37,,24,26,50
039 Lajen,38,,33,22,55
039 Lajen,39,,22,23,45
039 Lajen,40,,26,24,50
039 Lajen,41,,23,15,38
039 Lajen,42,,26,19,45
039 Lajen,43,,22,18,40
039 Lajen,44,,16,11,27
039 Lajen,45,,28,17,45
039 Lajen,46,,10,18,28
039 Lajen,47,,12,9,21
039 Lajen,48,,17,25,42
039 Lajen,49,,23,13,36
039 Lajen,50,,13,11,24
039 Lajen,51,,12,14,26
039 Lajen,52,,12,12,24
039 Lajen,53,,5,14,19
039 Lajen,54,,10,7,17
039 Lajen,55,,7,10,17
039 Lajen,56,,9,11,20
039 Lajen,57,,11,12,23
039 Lajen,58,,5,13,18
039 Lajen,59,,9,16,25
039 Lajen,60,,15,8,23
039 Lajen,61,,14,14,28
039 Lajen,62,,10,10,20
039 Lajen,63,,14,8,22
039 Lajen,64,,12,12,24
039 Lajen,65,,18,13,31
039 Lajen,66,,18,17,35
039 Lajen,67,,16,9,25
039 Lajen,68,,14,9,23
039 Lajen,69,,6,16,22
039 Lajen,70,,7,9,16
039 Lajen,71,,7,8,15
039 Lajen,72,,6,7,13
039 Lajen,73,,7,6,13
039 Lajen,74,,5,11,16
039 Lajen,75,,9,4,13
039 Lajen,76,,1,8,9
039 Lajen,77,,7,4,11
039 Lajen,78,,7,5,12
039 Lajen,79,,7,7,14
039 Lajen,80,,7,7,14
039 Lajen,81,,9,6,15
039 Lajen,82,,4,8,12
039 Lajen,83,,1,8,9
039 Lajen,84,,-,8,8
039 Lajen,85,,3,3,6
039 Lajen,86,,2,4,6
039 Lajen,87,,-,2,2
039 Lajen,88,,1,1,2
039 Lajen,89,,-,2,2
039 Lajen,92,,1,-,1
039 Lajen,93,,-,1,1
039 Lajen,94,,1,1,2
039 Lajen,95,,-,1,1
039 Lajen,100,,-,1,1
040 Leifers,0,,87,77,164
040 Leifers,1,,79,80,159
040 Leifers,2,,87,68,155
040 Leifers,3,,82,76,158
040 Leifers,4,,99,79,178
040 Leifers,5,,88,88,176
040 Leifers,6,,85,81,166
040 Leifers,7,,93,89,182
040 Leifers,8,,93,86,179
040 Leifers,9,,75,104,179
040 Leifers,10,,109,78,187
040 Leifers,11,,108,82,190
040 Leifers,12,,94,92,186
040 Leifers,13,,91,96,187
040 Leifers,14,,82,71,153
040 Leifers,15,,90,79,169
040 Leifers,16,,88,86,174
040 Leifers,17,,91,82,173
040 Leifers,18,,70,81,151
040 Leifers,19,,76,81,157
040 Leifers,20,,74,69,143
040 Leifers,21,,82,89,171
040 Leifers,22,,90,70,160
040 Leifers,23,,81,77,158
040 Leifers,24,,93,97,190
040 Leifers,25,,97,87,184
040 Leifers,26,,95,77,172
040 Leifers,27,,83,87,170
040 Leifers,28,,93,109,202
040 Leifers,29,,115,99,214
040 Leifers,30,,120,106,226
040 Leifers,31,,139,113,252
040 Leifers,32,,146,131,277
040 Leifers,33,,163,135,298
040 Leifers,34,,157,144,301
040 Leifers,35,,151,151,302
040 Leifers,36,,134,141,275
040 Leifers,37,,157,138,295
040 Leifers,38,,155,135,290
040 Leifers,39,,147,158,305
040 Leifers,40,,155,129,284
040 Leifers,41,,145,145,290
040 Leifers,42,,152,128,280
040 Leifers,43,,172,158,330
040 Leifers,44,,156,132,288
040 Leifers,45,,136,133,269
040 Leifers,46,,135,140,275
040 Leifers,47,,134,115,249
040 Leifers,48,,120,105,225
040 Leifers,49,,93,112,205
040 Leifers,50,,100,111,211
040 Leifers,51,,136,133,269
040 Leifers,52,,110,123,233
040 Leifers,53,,87,107,194
040 Leifers,54,,104,116,220
040 Leifers,55,,102,98,200
040 Leifers,56,,95,100,195
040 Leifers,57,,96,88,184
040 Leifers,58,,91,98,189
040 Leifers,59,,108,100,208
040 Leifers,60,,101,99,200
040 Leifers,61,,115,155,270
040 Leifers,62,,80,80,160
040 Leifers,63,,87,90,177
040 Leifers,64,,91,92,183
040 Leifers,65,,92,94,186
040 Leifers,66,,87,79,166
040 Leifers,67,,96,88,184
040 Leifers,68,,91,90,181
040 Leifers,69,,86,72,158
040 Leifers,70,,51,77,128
040 Leifers,71,,53,62,115
040 Leifers,72,,53,65,118
040 Leifers,73,,56,61,117
040 Leifers,74,,44,61,105
040 Leifers,75,,63,70,133
040 Leifers,76,,49,59,108
040 Leifers,77,,47,61,108
040 Leifers,78,,34,49,83
040 Leifers,79,,37,36,73
040 Leifers,80,,26,51,77
040 Leifers,81,,22,46,68
040 Leifers,82,,20,44,64
040 Leifers,83,,19,41,60
040 Leifers,84,,13,28,41
040 Leifers,85,,15,32,47
040 Leifers,86,,10,24,34
040 Leifers,87,,10,20,30
040 Leifers,88,,5,30,35
040 Leifers,89,,1,9,10
040 Leifers,90,,1,8,9
040 Leifers,91,,2,10,12
040 Leifers,92,,1,12,13
040 Leifers,93,,2,6,8
040 Leifers,94,,3,11,14
040 Leifers,95,,1,6,7
040 Leifers,96,,1,3,4
040 Leifers,97,,-,6,6
040 Leifers,98,,1,2,3
040 Leifers,101,,-,1,1
040 Leifers,102,,-,1,1
041 Lana,0,,71,59,130
041 Lana,1,,66,60,126
041 Lana,2,,76,65,141
041 Lana,3,,75,56,131
041 Lana,4,,60,63,123
041 Lana,5,,56,50,106
041 Lana,6,,71,51,122
041 Lana,7,,70,71,141
041 Lana,8,,71,55,126
041 Lana,9,,61,63,124
041 Lana,10,,60,67,127
041 Lana,11,,71,79,150
041 Lana,12,,66,63,129
041 Lana,13,,65,72,137
041 Lana,14,,61,59,120
041 Lana,15,,61,57,118
041 Lana,16,,61,58,119
041 Lana,17,,53,63,116
041 Lana,18,,50,75,125
041 Lana,19,,60,49,109
041 Lana,20,,74,48,122
041 Lana,21,,56,57,113
041 Lana,22,,59,67,126
041 Lana,23,,58,59,117
041 Lana,24,,77,66,143
041 Lana,25,,75,61,136
041 Lana,26,,58,77,135
041 Lana,27,,63,68,131
041 Lana,28,,66,88,154
041 Lana,29,,84,71,155
041 Lana,30,,76,74,150
041 Lana,31,,73,92,165
041 Lana,32,,64,86,150
041 Lana,33,,91,77,168
041 Lana,34,,85,90,175
041 Lana,35,,107,94,201
041 Lana,36,,96,105,201
041 Lana,37,,101,107,208
041 Lana,38,,124,82,206
041 Lana,39,,93,98,191
041 Lana,40,,91,94,185
041 Lana,41,,95,110,205
041 Lana,42,,94,87,181
041 Lana,43,,107,106,213
041 Lana,44,,103,81,184
041 Lana,45,,84,78,162
041 Lana,46,,85,85,170
041 Lana,47,,74,75,149
041 Lana,48,,85,77,162
041 Lana,49,,79,87,166
041 Lana,50,,75,76,151
041 Lana,51,,56,66,122
041 Lana,52,,66,73,139
041 Lana,53,,62,63,125
041 Lana,54,,57,60,117
041 Lana,55,,51,60,111
041 Lana,56,,56,65,121
041 Lana,57,,53,53,106
041 Lana,58,,57,52,109
041 Lana,59,,54,64,118
041 Lana,60,,58,45,103
041 Lana,61,,62,62,124
041 Lana,62,,41,51,92
041 Lana,63,,47,60,107
041 Lana,64,,59,58,117
041 Lana,65,,53,68,121
041 Lana,66,,50,49,99
041 Lana,67,,42,46,88
041 Lana,68,,51,52,103
041 Lana,69,,40,56,96
041 Lana,70,,37,37,74
041 Lana,71,,39,48,87
041 Lana,72,,33,37,70
041 Lana,73,,33,42,75
041 Lana,74,,27,41,68
041 Lana,75,,29,32,61
041 Lana,76,,25,42,67
041 Lana,77,,26,38,64
041 Lana,78,,17,34,51
041 Lana,79,,29,24,53
041 Lana,80,,27,31,58
041 Lana,81,,19,35,54
041 Lana,82,,22,37,59
041 Lana,83,,5,20,25
041 Lana,84,,14,20,34
041 Lana,85,,16,26,42
041 Lana,86,,9,29,38
041 Lana,87,,8,22,30
041 Lana,88,,4,16,20
041 Lana,89,,3,7,10
041 Lana,90,,3,9,12
041 Lana,91,,2,3,5
041 Lana,92,,2,8,10
041 Lana,93,,5,8,13
041 Lana,94,,1,8,9
041 Lana,95,,2,4,6
041 Lana,96,,-,4,4
041 Lana,97,,-,6,6
041 Lana,98,,-,3,3
041 Lana,103,,-,1,1
042 Laas,0,,29,10,39
042 Laas,1,,22,30,52
042 Laas,2,,34,17,51
042 Laas,3,,22,19,41
042 Laas,4,,24,18,42
042 Laas,5,,29,19,48
042 Laas,6,,17,19,36
042 Laas,7,,25,23,48
042 Laas,8,,19,12,31
042 Laas,9,,26,34,60
042 Laas,10,,26,24,50
042 Laas,11,,29,34,63
042 Laas,12,,32,23,55
042 Laas,13,,23,25,48
042 Laas,14,,22,21,43
042 Laas,15,,17,26,43
042 Laas,16,,22,22,44
042 Laas,17,,19,24,43
042 Laas,18,,21,25,46
042 Laas,19,,22,21,43
042 Laas,20,,30,23,53
042 Laas,21,,34,19,53
042 Laas,22,,27,28,55
042 Laas,23,,26,28,54
042 Laas,24,,22,39,61
042 Laas,25,,35,26,61
042 Laas,26,,29,26,55
042 Laas,27,,25,28,53
042 Laas,28,,26,27,53
042 Laas,29,,26,34,60
042 Laas,30,,26,14,40
042 Laas,31,,28,31,59
042 Laas,32,,28,20,48
042 Laas,33,,42,32,74
042 Laas,34,,33,29,62
042 Laas,35,,29,26,55
042 Laas,36,,24,26,50
042 Laas,37,,36,22,58
042 Laas,38,,33,40,73
042 Laas,39,,39,26,65
042 Laas,40,,33,22,55
042 Laas,41,,35,25,60
042 Laas,42,,36,33,69
042 Laas,43,,28,30,58
042 Laas,44,,27,29,56
042 Laas,45,,33,27,60
042 Laas,46,,25,29,54
042 Laas,47,,36,24,60
042 Laas,48,,32,26,58
042 Laas,49,,28,24,52
042 Laas,50,,19,28,47
042 Laas,51,,22,15,37
042 Laas,52,,15,14,29
042 Laas,53,,15,24,39
042 Laas,54,,22,13,35
042 Laas,55,,28,25,53
042 Laas,56,,12,17,29
042 Laas,57,,21,25,46
042 Laas,58,,18,19,37
042 Laas,59,,16,22,38
042 Laas,60,,27,11,38
042 Laas,61,,12,14,26
042 Laas,62,,14,12,26
042 Laas,63,,11,15,26
042 Laas,64,,13,16,29
042 Laas,65,,17,19,36
042 Laas,66,,14,22,36
042 Laas,67,,17,23,40
042 Laas,68,,12,25,37
042 Laas,69,,18,12,30
042 Laas,70,,12,14,26
042 Laas,71,,19,13,32
042 Laas,72,,18,22,40
042 Laas,73,,13,18,31
042 Laas,74,,16,11,27
042 Laas,75,,12,14,26
042 Laas,76,,15,22,37
042 Laas,77,,13,14,27
042 Laas,78,,12,8,20
042 Laas,79,,11,11,22
042 Laas,80,,10,13,23
042 Laas,81,,13,11,24
042 Laas,82,,6,9,15
042 Laas,83,,6,19,25
042 Laas,84,,9,7,16
042 Laas,85,,3,15,18
042 Laas,86,,2,4,6
042 Laas,87,,5,8,13
042 Laas,88,,2,5,7
042 Laas,89,,4,-,4
042 Laas,90,,-,2,2
042 Laas,91,,1,3,4
042 Laas,92,,-,1,1
042 Laas,93,,1,2,3
042 Laas,94,,-,4,4
042 Laas,95,,-,3,3
042 Laas,96,,-,1,1
042 Laas,97,,1,1,2
043 Laurein,0,,1,-,1
043 Laurein,1,,9,-,9
043 Laurein,2,,3,5,8
043 Laurein,3,,3,1,4
043 Laurein,4,,3,4,7
043 Laurein,5,,2,3,5
043 Laurein,6,,7,1,8
043 Laurein,7,,3,8,11
043 Laurein,8,,3,2,5
043 Laurein,9,,4,3,7
043 Laurein,10,,3,5,8
043 Laurein,11,,1,2,3
043 Laurein,12,,2,2,4
043 Laurein,13,,2,4,6
043 Laurein,14,,1,5,6
043 Laurein,15,,1,1,2
043 Laurein,16,,1,1,2
043 Laurein,17,,4,-,4
043 Laurein,18,,3,2,5
043 Laurein,19,,1,-,1
043 Laurein,20,,2,2,4
043 Laurein,21,,4,2,6
043 Laurein,22,,2,2,4
043 Laurein,23,,1,2,3
043 Laurein,25,,2,2,4
043 Laurein,26,,2,-,2
043 Laurein,27,,2,-,2
043 Laurein,28,,2,-,2
043 Laurein,29,,3,5,8
043 Laurein,30,,1,3,4
043 Laurein,31,,5,2,7
043 Laurein,32,,-,4,4
043 Laurein,33,,1,1,2
043 Laurein,34,,5,2,7
043 Laurein,35,,1,2,3
043 Laurein,36,,6,6,12
043 Laurein,37,,4,3,7
043 Laurein,38,,6,4,10
043 Laurein,39,,-,2,2
043 Laurein,40,,4,6,10
043 Laurein,41,,6,3,9
043 Laurein,42,,5,1,6
043 Laurein,43,,4,2,6
043 Laurein,44,,-,2,2
043 Laurein,45,,1,2,3
043 Laurein,46,,5,4,9
043 Laurein,47,,1,1,2
043 Laurein,48,,3,4,7
043 Laurein,49,,2,2,4
043 Laurein,50,,7,-,7
043 Laurein,52,,2,-,2
043 Laurein,53,,3,1,4
043 Laurein,54,,2,1,3
043 Laurein,55,,2,-,2
043 Laurein,57,,2,1,3
043 Laurein,58,,3,2,5
043 Laurein,59,,2,-,2
043 Laurein,60,,2,3,5
043 Laurein,61,,-,1,1
043 Laurein,62,,-,1,1
043 Laurein,63,,-,1,1
043 Laurein,64,,1,-,1
043 Laurein,65,,1,-,1
043 Laurein,67,,2,2,4
043 Laurein,68,,1,3,4
043 Laurein,69,,1,1,2
043 Laurein,70,,2,1,3
043 Laurein,71,,1,2,3
043 Laurein,72,,1,3,4
043 Laurein,73,,1,5,6
043 Laurein,74,,1,2,3
043 Laurein,75,,2,2,4
043 Laurein,76,,-,3,3
043 Laurein,77,,1,5,6
043 Laurein,78,,3,-,3
043 Laurein,79,,4,1,5
043 Laurein,80,,4,1,5
043 Laurein,81,,2,1,3
043 Laurein,82,,1,1,2
043 Laurein,83,,-,1,1
043 Laurein,85,,-,2,2
043 Laurein,87,,1,2,3
043 Laurein,91,,1,-,1
043 Laurein,94,,-,1,1
044 Lüsen,0,,11,9,20
044 Lüsen,1,,10,14,24
044 Lüsen,2,,9,8,17
044 Lüsen,3,,9,11,20
044 Lüsen,4,,10,8,18
044 Lüsen,5,,11,8,19
044 Lüsen,6,,10,11,21
044 Lüsen,7,,15,9,24
044 Lüsen,8,,5,10,15
044 Lüsen,9,,11,11,22
044 Lüsen,10,,16,6,22
044 Lüsen,11,,8,13,21
044 Lüsen,12,,10,12,22
044 Lüsen,13,,14,13,27
044 Lüsen,14,,9,8,17
044 Lüsen,15,,12,9,21
044 Lüsen,16,,9,9,18
044 Lüsen,17,,6,12,18
044 Lüsen,18,,16,8,24
044 Lüsen,19,,9,9,18
044 Lüsen,20,,7,9,16
044 Lüsen,21,,11,10,21
044 Lüsen,22,,4,4,8
044 Lüsen,23,,8,15,23
044 Lüsen,24,,6,8,14
044 Lüsen,25,,14,10,24
044 Lüsen,26,,12,13,25
044 Lüsen,27,,11,11,22
044 Lüsen,28,,7,7,14
044 Lüsen,29,,13,17,30
044 Lüsen,30,,9,14,23
044 Lüsen,31,,16,11,27
044 Lüsen,32,,13,13,26
044 Lüsen,33,,14,12,26
044 Lüsen,34,,9,7,16
044 Lüsen,35,,8,9,17
044 Lüsen,36,,16,7,23
044 Lüsen,37,,16,14,30
044 Lüsen,38,,9,10,19
044 Lüsen,39,,13,16,29
044 Lüsen,40,,11,19,30
044 Lüsen,41,,15,13,28
044 Lüsen,42,,18,13,31
044 Lüsen,43,,13,9,22
044 Lüsen,44,,15,12,27
044 Lüsen,45,,8,12,20
044 Lüsen,46,,13,10,23
044 Lüsen,47,,8,12,20
044 Lüsen,48,,8,6,14
044 Lüsen,49,,11,11,22
044 Lüsen,50,,10,10,20
044 Lüsen,51,,9,10,19
044 Lüsen,52,,6,6,12
044 Lüsen,53,,13,5,18
044 Lüsen,54,,6,10,16
044 Lüsen,55,,11,4,15
044 Lüsen,56,,5,7,12
044 Lüsen,57,,6,7,13
044 Lüsen,58,,8,11,19
044 Lüsen,59,,7,1,8
044 Lüsen,60,,5,5,10
044 Lüsen,61,,10,6,16
044 Lüsen,62,,3,9,12
044 Lüsen,63,,4,4,8
044 Lüsen,64,,7,7,14
044 Lüsen,65,,2,6,8
044 Lüsen,66,,7,3,10
044 Lüsen,67,,4,10,14
044 Lüsen,68,,8,7,15
044 Lüsen,69,,7,5,12
044 Lüsen,70,,7,5,12
044 Lüsen,71,,6,9,15
044 Lüsen,72,,6,4,10
044 Lüsen,73,,3,5,8
044 Lüsen,74,,7,3,10
044 Lüsen,75,,2,10,12
044 Lüsen,76,,6,5,11
044 Lüsen,77,,3,5,8
044 Lüsen,78,,3,6,9
044 Lüsen,79,,3,6,9
044 Lüsen,80,,3,4,7
044 Lüsen,81,,2,5,7
044 Lüsen,82,,1,4,5
044 Lüsen,83,,2,2,4
044 Lüsen,84,,1,4,5
044 Lüsen,85,,1,2,3
044 Lüsen,86,,2,5,7
044 Lüsen,87,,-,2,2
044 Lüsen,88,,1,1,2
044 Lüsen,89,,-,1,1
044 Lüsen,90,,-,1,1
044 Lüsen,91,,-,1,1
044 Lüsen,93,,-,1,1
044 Lüsen,94,,-,2,2
045 Margreid a.d. Weinstr.,0,,6,2,8
045 Margreid a.d. Weinstr.,1,,8,6,14
045 Margreid a.d. Weinstr.,2,,8,8,16
045 Margreid a.d. Weinstr.,3,,10,8,18
045 Margreid a.d. Weinstr.,4,,4,4,8
045 Margreid a.d. Weinstr.,5,,11,7,18
045 Margreid a.d. Weinstr.,6,,12,9,21
045 Margreid a.d. Weinstr.,7,,7,8,15
045 Margreid a.d. Weinstr.,8,,7,7,14
045 Margreid a.d. Weinstr.,9,,2,13,15
045 Margreid a.d. Weinstr.,10,,10,12,22
045 Margreid a.d. Weinstr.,11,,5,2,7
045 Margreid a.d. Weinstr.,12,,2,7,9
045 Margreid a.d. Weinstr.,13,,5,8,13
045 Margreid a.d. Weinstr.,14,,4,12,16
045 Margreid a.d. Weinstr.,15,,2,2,4
045 Margreid a.d. Weinstr.,16,,5,6,11
045 Margreid a.d. Weinstr.,17,,7,10,17
045 Margreid a.d. Weinstr.,18,,7,5,12
045 Margreid a.d. Weinstr.,19,,7,7,14
045 Margreid a.d. Weinstr.,20,,10,4,14
045 Margreid a.d. Weinstr.,21,,6,10,16
045 Margreid a.d. Weinstr.,22,,11,-,11
045 Margreid a.d. Weinstr.,23,,4,14,18
045 Margreid a.d. Weinstr.,24,,4,13,17
045 Margreid a.d. Weinstr.,25,,13,11,24
045 Margreid a.d. Weinstr.,26,,18,5,23
045 Margreid a.d. Weinstr.,27,,5,8,13
045 Margreid a.d. Weinstr.,28,,12,6,18
045 Margreid a.d. Weinstr.,29,,7,7,14
045 Margreid a.d. Weinstr.,30,,10,8,18
045 Margreid a.d. Weinstr.,31,,13,15,28
045 Margreid a.d. Weinstr.,32,,9,6,15
045 Margreid a.d. Weinstr.,33,,4,5,9
045 Margreid a.d. Weinstr.,34,,12,11,23
045 Margreid a.d. Weinstr.,35,,6,5,11
045 Margreid a.d. Weinstr.,36,,9,11,20
045 Margreid a.d. Weinstr.,37,,10,10,20
045 Margreid a.d. Weinstr.,38,,9,7,16
045 Margreid a.d. Weinstr.,39,,24,16,40
045 Margreid a.d. Weinstr.,40,,10,17,27
045 Margreid a.d. Weinstr.,41,,22,12,34
045 Margreid a.d. Weinstr.,42,,12,6,18
045 Margreid a.d. Weinstr.,43,,8,6,14
045 Margreid a.d. Weinstr.,44,,12,13,25
045 Margreid a.d. Weinstr.,45,,9,15,24
045 Margreid a.d. Weinstr.,46,,15,12,27
045 Margreid a.d. Weinstr.,47,,15,11,26
045 Margreid a.d. Weinstr.,48,,9,12,21
045 Margreid a.d. Weinstr.,49,,5,7,12
045 Margreid a.d. Weinstr.,50,,8,5,13
045 Margreid a.d. Weinstr.,51,,16,6,22
045 Margreid a.d. Weinstr.,52,,8,7,15
045 Margreid a.d. Weinstr.,53,,4,6,10
045 Margreid a.d. Weinstr.,54,,7,8,15
045 Margreid a.d. Weinstr.,55,,5,9,14
045 Margreid a.d. Weinstr.,56,,3,8,11
045 Margreid a.d. Weinstr.,57,,7,6,13
045 Margreid a.d. Weinstr.,58,,7,4,11
045 Margreid a.d. Weinstr.,59,,6,7,13
045 Margreid a.d. Weinstr.,60,,7,8,15
045 Margreid a.d. Weinstr.,61,,2,4,6
045 Margreid a.d. Weinstr.,62,,6,7,13
045 Margreid a.d. Weinstr.,63,,3,6,9
045 Margreid a.d. Weinstr.,64,,6,4,10
045 Margreid a.d. Weinstr.,65,,10,4,14
045 Margreid a.d. Weinstr.,66,,6,5,11
045 Margreid a.d. Weinstr.,67,,5,3,8
045 Margreid a.d. Weinstr.,68,,3,6,9
045 Margreid a.d. Weinstr.,69,,4,9,13
045 Margreid a.d. Weinstr.,70,,5,3,8
045 Margreid a.d. Weinstr.,71,,6,4,10
045 Margreid a.d. Weinstr.,72,,2,6,8
045 Margreid a.d. Weinstr.,73,,5,4,9
045 Margreid a.d. Weinstr.,74,,4,4,8
045 Margreid a.d. Weinstr.,75,,4,6,10
045 Margreid a.d. Weinstr.,76,,4,5,9
045 Margreid a.d. Weinstr.,77,,6,2,8
045 Margreid a.d. Weinstr.,78,,1,4,5
045 Margreid a.d. Weinstr.,79,,5,2,7
045 Margreid a.d. Weinstr.,80,,1,5,6
045 Margreid a.d. Weinstr.,81,,2,7,9
045 Margreid a.d. Weinstr.,82,,3,2,5
045 Margreid a.d. Weinstr.,83,,1,4,5
045 Margreid a.d. Weinstr.,84,,1,3,4
045 Margreid a.d. Weinstr.,85,,1,1,2
045 Margreid a.d. Weinstr.,86,,-,1,1
045 Margreid a.d. Weinstr.,87,,-,1,1
045 Margreid a.d. Weinstr.,88,,1,4,5
045 Margreid a.d. Weinstr.,89,,1,1,2
045 Margreid a.d. Weinstr.,91,,1,2,3
045 Margreid a.d. Weinstr.,93,,-,1,1
045 Margreid a.d. Weinstr.,101,,-,1,1
046 Mals,0,,22,32,54
046 Mals,1,,33,38,71
046 Mals,2,,28,31,59
046 Mals,3,,31,23,54
046 Mals,4,,29,19,48
046 Mals,5,,21,27,48
046 Mals,6,,29,29,58
046 Mals,7,,32,35,67
046 Mals,8,,41,29,70
046 Mals,9,,36,32,68
046 Mals,10,,32,32,64
046 Mals,11,,35,26,61
046 Mals,12,,34,42,76
046 Mals,13,,37,32,69
046 Mals,14,,35,32,67
046 Mals,15,,31,33,64
046 Mals,16,,35,35,70
046 Mals,17,,35,29,64
046 Mals,18,,41,35,76
046 Mals,19,,32,24,56
046 Mals,20,,31,31,62
046 Mals,21,,27,40,67
046 Mals,22,,35,35,70
046 Mals,23,,36,34,70
046 Mals,24,,32,29,61
046 Mals,25,,38,29,67
046 Mals,26,,35,36,71
046 Mals,27,,37,34,71
046 Mals,28,,35,26,61
046 Mals,29,,48,33,81
046 Mals,30,,32,35,67
046 Mals,31,,34,28,62
046 Mals,32,,42,30,72
046 Mals,33,,45,25,70
046 Mals,34,,34,41,75
046 Mals,35,,32,43,75
046 Mals,36,,36,45,81
046 Mals,37,,45,50,95
046 Mals,38,,47,42,89
046 Mals,39,,55,38,93
046 Mals,40,,49,31,80
046 Mals,41,,51,52,103
046 Mals,42,,49,39,88
046 Mals,43,,50,42,92
046 Mals,44,,50,53,103
046 Mals,45,,37,27,64
046 Mals,46,,49,37,86
046 Mals,47,,32,41,73
046 Mals,48,,33,33,66
046 Mals,49,,33,24,57
046 Mals,50,,36,34,70
046 Mals,51,,33,27,60
046 Mals,52,,33,23,56
046 Mals,53,,20,21,41
046 Mals,54,,34,32,66
046 Mals,55,,28,21,49
046 Mals,56,,32,21,53
046 Mals,57,,31,21,52
046 Mals,58,,18,24,42
046 Mals,59,,27,16,43
046 Mals,60,,22,20,42
046 Mals,61,,20,30,50
046 Mals,62,,11,20,31
046 Mals,63,,29,14,43
046 Mals,64,,24,20,44
046 Mals,65,,23,23,46
046 Mals,66,,18,18,36
046 Mals,67,,21,28,49
046 Mals,68,,23,27,50
046 Mals,69,,19,20,39
046 Mals,70,,12,27,39
046 Mals,71,,21,19,40
046 Mals,72,,14,19,33
046 Mals,73,,12,18,30
046 Mals,74,,11,21,32
046 Mals,75,,16,11,27
046 Mals,76,,11,17,28
046 Mals,77,,20,14,34
046 Mals,78,,15,14,29
046 Mals,79,,16,14,30
046 Mals,80,,10,14,24
046 Mals,81,,7,18,25
046 Mals,82,,5,16,21
046 Mals,83,,6,13,19
046 Mals,84,,2,9,11
046 Mals,85,,10,13,23
046 Mals,86,,7,8,15
046 Mals,87,,2,13,15
046 Mals,88,,2,14,16
046 Mals,89,,1,2,3
046 Mals,90,,3,2,5
046 Mals,91,,-,1,1
046 Mals,92,,3,2,5
046 Mals,93,,1,4,5
046 Mals,94,,1,6,7
046 Mals,95,,1,-,1
046 Mals,97,,-,2,2
046 Mals,98,,1,1,2
047 Enneberg,0,,15,15,30
047 Enneberg,1,,25,18,43
047 Enneberg,2,,22,18,40
047 Enneberg,3,,14,17,31
047 Enneberg,4,,23,27,50
047 Enneberg,5,,19,13,32
047 Enneberg,6,,27,17,44
047 Enneberg,7,,18,20,38
047 Enneberg,8,,27,17,44
047 Enneberg,9,,19,10,29
047 Enneberg,10,,23,15,38
047 Enneberg,11,,17,13,30
047 Enneberg,12,,20,8,28
047 Enneberg,13,,21,15,36
047 Enneberg,14,,20,17,37
047 Enneberg,15,,15,15,30
047 Enneberg,16,,17,22,39
047 Enneberg,17,,15,17,32
047 Enneberg,18,,20,17,37
047 Enneberg,19,,21,16,37
047 Enneberg,20,,18,13,31
047 Enneberg,21,,19,10,29
047 Enneberg,22,,26,17,43
047 Enneberg,23,,20,18,38
047 Enneberg,24,,15,16,31
047 Enneberg,25,,25,20,45
047 Enneberg,26,,23,22,45
047 Enneberg,27,,24,17,41
047 Enneberg,28,,12,17,29
047 Enneberg,29,,15,22,37
047 Enneberg,30,,21,19,40
047 Enneberg,31,,13,19,32
047 Enneberg,32,,13,30,43
047 Enneberg,33,,29,34,63
047 Enneberg,34,,22,23,45
047 Enneberg,35,,23,27,50
047 Enneberg,36,,30,32,62
047 Enneberg,37,,27,20,47
047 Enneberg,38,,26,19,45
047 Enneberg,39,,24,22,46
047 Enneberg,40,,26,19,45
047 Enneberg,41,,19,21,40
047 Enneberg,42,,29,21,50
047 Enneberg,43,,23,22,45
047 Enneberg,44,,22,19,41
047 Enneberg,45,,17,17,34
047 Enneberg,46,,21,16,37
047 Enneberg,47,,15,17,32
047 Enneberg,48,,23,13,36
047 Enneberg,49,,20,9,29
047 Enneberg,50,,16,14,30
047 Enneberg,51,,15,19,34
047 Enneberg,52,,15,13,28
047 Enneberg,53,,14,12,26
047 Enneberg,54,,18,21,39
047 Enneberg,55,,14,16,30
047 Enneberg,56,,17,10,27
047 Enneberg,57,,11,15,26
047 Enneberg,58,,19,8,27
047 Enneberg,59,,16,13,29
047 Enneberg,60,,8,13,21
047 Enneberg,61,,14,17,31
047 Enneberg,62,,5,12,17
047 Enneberg,63,,20,16,36
047 Enneberg,64,,16,10,26
047 Enneberg,65,,12,20,32
047 Enneberg,66,,13,11,24
047 Enneberg,67,,10,7,17
047 Enneberg,68,,17,9,26
047 Enneberg,69,,13,18,31
047 Enneberg,70,,14,12,26
047 Enneberg,71,,12,12,24
047 Enneberg,72,,12,15,27
047 Enneberg,73,,7,10,17
047 Enneberg,74,,10,8,18
047 Enneberg,75,,7,18,25
047 Enneberg,76,,10,10,20
047 Enneberg,77,,12,14,26
047 Enneberg,78,,5,7,12
047 Enneberg,79,,9,11,20
047 Enneberg,80,,6,6,12
047 Enneberg,81,,6,9,15
047 Enneberg,82,,9,8,17
047 Enneberg,83,,2,5,7
047 Enneberg,84,,4,11,15
047 Enneberg,85,,7,5,12
047 Enneberg,86,,1,6,7
047 Enneberg,87,,5,2,7
047 Enneberg,88,,-,1,1
047 Enneberg,89,,1,3,4
047 Enneberg,90,,-,3,3
047 Enneberg,91,,1,6,7
047 Enneberg,92,,-,2,2
047 Enneberg,93,,1,4,5
047 Enneberg,95,,-,2,2
047 Enneberg,96,,1,-,1
047 Enneberg,102,,-,1,1
048 Marling,0,,17,10,27
048 Marling,1,,13,14,27
048 Marling,2,,21,12,33
048 Marling,3,,15,12,27
048 Marling,4,,12,8,20
048 Marling,5,,17,12,29
048 Marling,6,,9,16,25
048 Marling,7,,16,15,31
048 Marling,8,,14,8,22
048 Marling,9,,10,11,21
048 Marling,10,,14,9,23
048 Marling,11,,13,13,26
048 Marling,12,,19,11,30
048 Marling,13,,10,7,17
048 Marling,14,,17,8,25
048 Marling,15,,16,15,31
048 Marling,16,,11,15,26
048 Marling,17,,10,17,27
048 Marling,18,,11,16,27
048 Marling,19,,12,13,25
048 Marling,20,,8,11,19
048 Marling,21,,14,12,26
048 Marling,22,,8,18,26
048 Marling,23,,14,8,22
048 Marling,24,,14,14,28
048 Marling,25,,12,10,22
048 Marling,26,,17,7,24
048 Marling,27,,14,14,28
048 Marling,28,,19,26,45
048 Marling,29,,20,17,37
048 Marling,30,,12,18,30
048 Marling,31,,17,27,44
048 Marling,32,,20,15,35
048 Marling,33,,14,10,24
048 Marling,34,,14,20,34
048 Marling,35,,16,21,37
048 Marling,36,,26,14,40
048 Marling,37,,16,18,34
048 Marling,38,,21,20,41
048 Marling,39,,29,19,48
048 Marling,40,,20,15,35
048 Marling,41,,20,26,46
048 Marling,42,,24,20,44
048 Marling,43,,30,21,51
048 Marling,44,,26,32,58
048 Marling,45,,22,19,41
048 Marling,46,,23,12,35
048 Marling,47,,19,21,40
048 Marling,48,,17,16,33
048 Marling,49,,17,14,31
048 Marling,50,,13,10,23
048 Marling,51,,10,11,21
048 Marling,52,,11,8,19
048 Marling,53,,17,12,29
048 Marling,54,,12,17,29
048 Marling,55,,16,15,31
048 Marling,56,,7,16,23
048 Marling,57,,14,14,28
048 Marling,58,,18,19,37
048 Marling,59,,6,14,20
048 Marling,60,,16,13,29
048 Marling,61,,12,15,27
048 Marling,62,,21,15,36
048 Marling,63,,15,16,31
048 Marling,64,,9,16,25
048 Marling,65,,10,11,21
048 Marling,66,,20,18,38
048 Marling,67,,11,13,24
048 Marling,68,,15,15,30
048 Marling,69,,8,13,21
048 Marling,70,,11,16,27
048 Marling,71,,15,8,23
048 Marling,72,,4,16,20
048 Marling,73,,12,9,21
048 Marling,74,,7,13,20
048 Marling,75,,8,10,18
048 Marling,76,,8,6,14
048 Marling,77,,4,9,13
048 Marling,78,,7,5,12
048 Marling,79,,7,2,9
048 Marling,80,,10,7,17
048 Marling,81,,4,9,13
048 Marling,82,,2,12,14
048 Marling,83,,-,5,5
048 Marling,84,,3,5,8
048 Marling,85,,2,4,6
048 Marling,86,,4,5,9
048 Marling,87,,-,1,1
048 Marling,88,,2,4,6
048 Marling,89,,1,2,3
048 Marling,91,,-,2,2
048 Marling,92,,2,1,3
048 Marling,93,,2,1,3
048 Marling,94,,-,2,2
048 Marling,95,,1,-,1
048 Marling,97,,-,1,1
048 Marling,98,,1,-,1
048 Marling,102,,-,1,1
049 Martell,0,,7,-,7
049 Martell,1,,5,5,10
049 Martell,2,,7,2,9
049 Martell,3,,7,2,9
049 Martell,4,,5,5,10
049 Martell,5,,3,5,8
049 Martell,6,,4,7,11
049 Martell,7,,7,4,11
049 Martell,8,,3,7,10
049 Martell,9,,6,7,13
049 Martell,10,,5,8,13
049 Martell,11,,4,6,10
049 Martell,12,,6,7,13
049 Martell,13,,6,8,14
049 Martell,14,,6,6,12
049 Martell,15,,4,7,11
049 Martell,16,,7,5,12
049 Martell,17,,6,5,11
049 Martell,18,,9,4,13
049 Martell,19,,4,1,5
049 Martell,20,,6,4,10
049 Martell,21,,-,4,4
049 Martell,22,,5,6,11
049 Martell,23,,4,-,4
049 Martell,24,,6,3,9
049 Martell,25,,5,8,13
049 Martell,26,,7,5,12
049 Martell,27,,9,4,13
049 Martell,28,,7,6,13
049 Martell,29,,4,5,9
049 Martell,30,,6,5,11
049 Martell,31,,5,5,10
049 Martell,32,,1,7,8
049 Martell,33,,6,9,15
049 Martell,34,,9,5,14
049 Martell,35,,4,8,12
049 Martell,36,,9,4,13
049 Martell,37,,8,4,12
049 Martell,38,,6,13,19
049 Martell,39,,8,6,14
049 Martell,40,,6,7,13
049 Martell,41,,16,7,23
049 Martell,42,,17,10,27
049 Martell,43,,9,9,18
049 Martell,44,,13,1,14
049 Martell,45,,10,8,18
049 Martell,46,,7,5,12
049 Martell,47,,9,3,12
049 Martell,48,,8,6,14
049 Martell,49,,8,6,14
049 Martell,50,,7,3,10
049 Martell,51,,5,3,8
049 Martell,52,,7,2,9
049 Martell,53,,6,6,12
049 Martell,54,,4,4,8
049 Martell,55,,3,3,6
049 Martell,56,,6,7,13
049 Martell,57,,2,4,6
049 Martell,58,,3,1,4
049 Martell,59,,5,4,9
049 Martell,60,,3,3,6
049 Martell,61,,3,-,3
049 Martell,62,,4,1,5
049 Martell,63,,1,3,4
049 Martell,64,,2,4,6
049 Martell,65,,6,5,11
049 Martell,66,,4,4,8
049 Martell,67,,6,2,8
049 Martell,68,,2,4,6
049 Martell,69,,2,6,8
049 Martell,70,,2,4,6
049 Martell,71,,3,4,7
049 Martell,72,,4,8,12
049 Martell,73,,7,1,8
049 Martell,74,,5,6,11
049 Martell,75,,2,3,5
049 Martell,76,,5,-,5
049 Martell,77,,7,4,11
049 Martell,78,,4,3,7
049 Martell,79,,3,3,6
049 Martell,80,,2,3,5
049 Martell,81,,1,8,9
049 Martell,82,,2,1,3
049 Martell,83,,3,5,8
049 Martell,84,,-,6,6
049 Martell,85,,1,1,2
049 Martell,86,,-,1,1
049 Martell,89,,1,1,2
049 Martell,92,,-,1,1
049 Martell,93,,-,1,1
049 Martell,94,,1,-,1
049 Martell,96,,2,-,2
050 Mölten,0,,13,12,25
050 Mölten,1,,8,9,17
050 Mölten,2,,9,11,20
050 Mölten,3,,10,9,19
050 Mölten,4,,10,9,19
050 Mölten,5,,15,11,26
050 Mölten,6,,15,17,32
050 Mölten,7,,14,13,27
050 Mölten,8,,12,18,30
050 Mölten,9,,8,16,24
050 Mölten,10,,10,7,17
050 Mölten,11,,16,13,29
050 Mölten,12,,11,10,21
050 Mölten,13,,13,5,18
050 Mölten,14,,12,11,23
050 Mölten,15,,6,12,18
050 Mölten,16,,10,6,16
050 Mölten,17,,12,6,18
050 Mölten,18,,13,5,18
050 Mölten,19,,7,9,16
050 Mölten,20,,9,8,17
050 Mölten,21,,10,5,15
050 Mölten,22,,7,12,19
050 Mölten,23,,7,3,10
050 Mölten,24,,6,12,18
050 Mölten,25,,10,9,19
050 Mölten,26,,13,12,25
050 Mölten,27,,15,9,24
050 Mölten,28,,14,14,28
050 Mölten,29,,11,6,17
050 Mölten,30,,10,10,20
050 Mölten,31,,12,17,29
050 Mölten,32,,21,13,34
050 Mölten,33,,13,9,22
050 Mölten,34,,12,17,29
050 Mölten,35,,9,10,19
050 Mölten,36,,19,14,33
050 Mölten,37,,16,11,27
050 Mölten,38,,14,14,28
050 Mölten,39,,15,16,31
050 Mölten,40,,18,14,32
050 Mölten,41,,14,13,27
050 Mölten,42,,10,16,26
050 Mölten,43,,20,15,35
050 Mölten,44,,20,6,26
050 Mölten,45,,14,9,23
050 Mölten,46,,16,10,26
050 Mölten,47,,9,8,17
050 Mölten,48,,14,6,20
050 Mölten,49,,2,10,12
050 Mölten,50,,7,3,10
050 Mölten,51,,5,8,13
050 Mölten,52,,12,7,19
050 Mölten,53,,6,7,13
050 Mölten,54,,7,6,13
050 Mölten,55,,8,6,14
050 Mölten,56,,5,6,11
050 Mölten,57,,9,9,18
050 Mölten,58,,8,6,14
050 Mölten,59,,7,4,11
050 Mölten,60,,3,8,11
050 Mölten,61,,8,3,11
050 Mölten,62,,6,5,11
050 Mölten,63,,2,6,8
050 Mölten,64,,13,8,21
050 Mölten,65,,6,10,16
050 Mölten,66,,9,5,14
050 Mölten,67,,5,7,12
050 Mölten,68,,5,7,12
050 Mölten,69,,2,3,5
050 Mölten,70,,5,6,11
050 Mölten,71,,4,5,9
050 Mölten,72,,9,6,15
050 Mölten,73,,9,5,14
050 Mölten,74,,7,8,15
050 Mölten,75,,3,5,8
050 Mölten,76,,8,3,11
050 Mölten,77,,7,3,10
050 Mölten,78,,1,7,8
050 Mölten,79,,1,4,5
050 Mölten,80,,2,3,5
050 Mölten,81,,3,5,8
050 Mölten,82,,2,4,6
050 Mölten,83,,1,1,2
050 Mölten,84,,6,5,11
050 Mölten,85,,1,1,2
050 Mölten,86,,-,2,2
050 Mölten,87,,-,5,5
050 Mölten,88,,-,5,5
050 Mölten,89,,-,1,1
050 Mölten,91,,-,1,1
050 Mölten,92,,-,1,1
050 Mölten,93,,-,1,1
051 Meran,0,,205,160,365
051 Meran,1,,190,201,391
051 Meran,2,,175,154,329
051 Meran,3,,213,171,384
051 Meran,4,,178,175,353
051 Meran,5,,175,160,335
051 Meran,6,,176,179,355
051 Meran,7,,188,150,338
051 Meran,8,,178,192,370
051 Meran,9,,157,142,299
051 Meran,10,,192,167,359
051 Meran,11,,198,165,363
051 Meran,12,,167,156,323
051 Meran,13,,171,185,356
051 Meran,14,,135,160,295
051 Meran,15,,170,145,315
051 Meran,16,,163,180,343
051 Meran,17,,162,152,314
051 Meran,18,,184,161,345
051 Meran,19,,176,133,309
051 Meran,20,,176,154,330
051 Meran,21,,169,132,301
051 Meran,22,,141,204,345
051 Meran,23,,184,169,353
051 Meran,24,,156,190,346
051 Meran,25,,189,202,391
051 Meran,26,,212,189,401
051 Meran,27,,213,189,402
051 Meran,28,,188,199,387
051 Meran,29,,236,210,446
051 Meran,30,,220,249,469
051 Meran,31,,236,256,492
051 Meran,32,,239,265,504
051 Meran,33,,276,304,580
051 Meran,34,,278,281,559
051 Meran,35,,297,289,586
051 Meran,36,,293,280,573
051 Meran,37,,301,299,600
051 Meran,38,,325,316,641
051 Meran,39,,347,326,673
051 Meran,40,,349,337,686
051 Meran,41,,330,303,633
051 Meran,42,,340,322,662
051 Meran,43,,337,296,633
051 Meran,44,,343,282,625
051 Meran,45,,273,289,562
051 Meran,46,,293,296,589
051 Meran,47,,291,273,564
051 Meran,48,,272,247,519
051 Meran,49,,246,241,487
051 Meran,50,,233,255,488
051 Meran,51,,226,218,444
051 Meran,52,,199,218,417
051 Meran,53,,180,237,417
051 Meran,54,,180,229,409
051 Meran,55,,201,222,423
051 Meran,56,,203,214,417
051 Meran,57,,190,227,417
051 Meran,58,,222,248,470
051 Meran,59,,218,255,473
051 Meran,60,,217,279,496
051 Meran,61,,240,297,537
051 Meran,62,,202,213,415
051 Meran,63,,207,230,437
051 Meran,64,,254,242,496
051 Meran,65,,255,297,552
051 Meran,66,,227,280,507
051 Meran,67,,187,224,411
051 Meran,68,,191,252,443
051 Meran,69,,178,219,397
051 Meran,70,,176,218,394
051 Meran,71,,167,200,367
051 Meran,72,,158,199,357
051 Meran,73,,142,177,319
051 Meran,74,,144,171,315
051 Meran,75,,123,186,309
051 Meran,76,,110,166,276
051 Meran,77,,117,182,299
051 Meran,78,,96,136,232
051 Meran,79,,89,166,255
051 Meran,80,,93,139,232
051 Meran,81,,84,157,241
051 Meran,82,,60,150,210
051 Meran,83,,73,139,212
051 Meran,84,,53,133,186
051 Meran,85,,59,137,196
051 Meran,86,,32,131,163
051 Meran,87,,36,118,154
051 Meran,88,,27,70,97
051 Meran,89,,14,50,64
051 Meran,90,,19,44,63
051 Meran,91,,9,29,38
051 Meran,92,,16,43,59
051 Meran,93,,13,42,55
051 Meran,94,,10,28,38
051 Meran,95,,9,28,37
051 Meran,96,,5,12,17
051 Meran,97,,3,12,15
051 Meran,98,,1,12,13
051 Meran,99,,2,8,10
051 Meran,100,,-,5,5
051 Meran,101,,-,4,4
051 Meran,103,,-,1,1
051 Meran,105,,-,1,1
052 Welsberg-Taisten,0,,20,20,40
052 Welsberg-Taisten,1,,12,28,40
052 Welsberg-Taisten,2,,22,24,46
052 Welsberg-Taisten,3,,13,20,33
052 Welsberg-Taisten,4,,19,15,34
052 Welsberg-Taisten,5,,22,22,44
052 Welsberg-Taisten,6,,30,18,48
052 Welsberg-Taisten,7,,18,16,34
052 Welsberg-Taisten,8,,21,19,40
052 Welsberg-Taisten,9,,21,11,32
052 Welsberg-Taisten,10,,20,19,39
052 Welsberg-Taisten,11,,16,16,32
052 Welsberg-Taisten,12,,17,15,32
052 Welsberg-Taisten,13,,12,15,27
052 Welsberg-Taisten,14,,16,21,37
052 Welsberg-Taisten,15,,10,10,20
052 Welsberg-Taisten,16,,21,18,39
052 Welsberg-Taisten,17,,10,20,30
052 Welsberg-Taisten,18,,4,18,22
052 Welsberg-Taisten,19,,12,17,29
052 Welsberg-Taisten,20,,13,15,28
052 Welsberg-Taisten,21,,10,11,21
052 Welsberg-Taisten,22,,8,14,22
052 Welsberg-Taisten,23,,27,15,42
052 Welsberg-Taisten,24,,21,19,40
052 Welsberg-Taisten,25,,17,18,35
052 Welsberg-Taisten,26,,11,15,26
052 Welsberg-Taisten,27,,16,14,30
052 Welsberg-Taisten,28,,24,17,41
052 Welsberg-Taisten,29,,18,20,38
052 Welsberg-Taisten,30,,15,23,38
052 Welsberg-Taisten,31,,18,10,28
052 Welsberg-Taisten,32,,18,24,42
052 Welsberg-Taisten,33,,27,20,47
052 Welsberg-Taisten,34,,28,11,39
052 Welsberg-Taisten,35,,16,29,45
052 Welsberg-Taisten,36,,31,23,54
052 Welsberg-Taisten,37,,29,25,54
052 Welsberg-Taisten,38,,20,20,40
052 Welsberg-Taisten,39,,28,17,45
052 Welsberg-Taisten,40,,30,19,49
052 Welsberg-Taisten,41,,30,22,52
052 Welsberg-Taisten,42,,20,15,35
052 Welsberg-Taisten,43,,33,20,53
052 Welsberg-Taisten,44,,27,24,51
052 Welsberg-Taisten,45,,19,22,41
052 Welsberg-Taisten,46,,18,16,34
052 Welsberg-Taisten,47,,11,16,27
052 Welsberg-Taisten,48,,20,21,41
052 Welsberg-Taisten,49,,25,19,44
052 Welsberg-Taisten,50,,11,20,31
052 Welsberg-Taisten,51,,21,19,40
052 Welsberg-Taisten,52,,16,11,27
052 Welsberg-Taisten,53,,15,14,29
052 Welsberg-Taisten,54,,19,12,31
052 Welsberg-Taisten,55,,17,11,28
052 Welsberg-Taisten,56,,19,10,29
052 Welsberg-Taisten,57,,15,14,29
052 Welsberg-Taisten,58,,15,11,26
052 Welsberg-Taisten,59,,16,17,33
052 Welsberg-Taisten,60,,11,13,24
052 Welsberg-Taisten,61,,13,12,25
052 Welsberg-Taisten,62,,10,13,23
052 Welsberg-Taisten,63,,14,11,25
052 Welsberg-Taisten,64,,10,15,25
052 Welsberg-Taisten,65,,11,14,25
052 Welsberg-Taisten,66,,18,17,35
052 Welsberg-Taisten,67,,6,13,19
052 Welsberg-Taisten,68,,12,12,24
052 Welsberg-Taisten,69,,12,11,23
052 Welsberg-Taisten,70,,10,8,18
052 Welsberg-Taisten,71,,10,10,20
052 Welsberg-Taisten,72,,3,16,19
052 Welsberg-Taisten,73,,17,15,32
052 Welsberg-Taisten,74,,9,10,19
052 Welsberg-Taisten,75,,10,11,21
052 Welsberg-Taisten,76,,6,12,18
052 Welsberg-Taisten,77,,8,7,15
052 Welsberg-Taisten,78,,8,10,18
052 Welsberg-Taisten,79,,5,16,21
052 Welsberg-Taisten,80,,3,12,15
052 Welsberg-Taisten,81,,6,5,11
052 Welsberg-Taisten,82,,-,8,8
052 Welsberg-Taisten,83,,1,8,9
052 Welsberg-Taisten,84,,3,8,11
052 Welsberg-Taisten,85,,3,4,7
052 Welsberg-Taisten,86,,3,5,8
052 Welsberg-Taisten,87,,2,3,5
052 Welsberg-Taisten,88,,1,5,6
052 Welsberg-Taisten,89,,1,-,1
052 Welsberg-Taisten,90,,1,1,2
052 Welsberg-Taisten,91,,1,-,1
052 Welsberg-Taisten,92,,1,2,3
052 Welsberg-Taisten,94,,-,1,1
052 Welsberg-Taisten,95,,-,2,2
052 Welsberg-Taisten,96,,-,1,1
052 Welsberg-Taisten,97,,-,2,2
052 Welsberg-Taisten,99,,-,2,2
052 Welsberg-Taisten,100,,1,1,2
052 Welsberg-Taisten,107,,1,-,1
052 Welsberg-Taisten,-,,-,1,1
053 Montan,0,,4,5,9
053 Montan,1,,8,7,15
053 Montan,2,,11,10,21
053 Montan,3,,7,9,16
053 Montan,4,,10,8,18
053 Montan,5,,6,4,10
053 Montan,6,,12,4,16
053 Montan,7,,9,6,15
053 Montan,8,,6,11,17
053 Montan,9,,9,12,21
053 Montan,10,,8,8,16
053 Montan,11,,14,11,25
053 Montan,12,,16,15,31
053 Montan,13,,14,7,21
053 Montan,14,,5,8,13
053 Montan,15,,7,10,17
053 Montan,16,,14,9,23
053 Montan,17,,11,8,19
053 Montan,18,,10,11,21
053 Montan,19,,12,14,26
053 Montan,20,,11,18,29
053 Montan,21,,13,6,19
053 Montan,22,,10,9,19
053 Montan,23,,8,2,10
053 Montan,24,,10,6,16
053 Montan,25,,9,7,16
053 Montan,26,,11,10,21
053 Montan,27,,6,5,11
053 Montan,28,,8,6,14
053 Montan,29,,9,3,12
053 Montan,30,,7,5,12
053 Montan,31,,7,7,14
053 Montan,32,,7,12,19
053 Montan,33,,10,14,24
053 Montan,34,,14,3,17
053 Montan,35,,7,10,17
053 Montan,36,,11,8,19
053 Montan,37,,15,12,27
053 Montan,38,,16,18,34
053 Montan,39,,14,17,31
053 Montan,40,,9,13,22
053 Montan,41,,13,16,29
053 Montan,42,,26,15,41
053 Montan,43,,17,11,28
053 Montan,44,,11,16,27
053 Montan,45,,14,17,31
053 Montan,46,,19,12,31
053 Montan,47,,13,11,24
053 Montan,48,,14,10,24
053 Montan,49,,13,9,22
053 Montan,50,,15,11,26
053 Montan,51,,7,14,21
053 Montan,52,,8,11,19
053 Montan,53,,13,11,24
053 Montan,54,,11,7,18
053 Montan,55,,12,3,15
053 Montan,56,,8,7,15
053 Montan,57,,4,5,9
053 Montan,58,,8,3,11
053 Montan,59,,5,6,11
053 Montan,60,,8,11,19
053 Montan,61,,4,2,6
053 Montan,62,,5,3,8
053 Montan,63,,2,6,8
053 Montan,64,,5,6,11
053 Montan,65,,7,6,13
053 Montan,66,,6,5,11
053 Montan,67,,9,7,16
053 Montan,68,,4,10,14
053 Montan,69,,7,9,16
053 Montan,70,,2,6,8
053 Montan,71,,7,10,17
053 Montan,72,,1,8,9
053 Montan,73,,2,6,8
053 Montan,74,,15,5,20
053 Montan,75,,5,7,12
053 Montan,76,,7,11,18
053 Montan,77,,9,12,21
053 Montan,78,,6,9,15
053 Montan,79,,6,3,9
053 Montan,80,,3,4,7
053 Montan,81,,6,8,14
053 Montan,82,,2,9,11
053 Montan,83,,1,5,6
053 Montan,84,,-,10,10
053 Montan,85,,3,5,8
053 Montan,86,,1,3,4
053 Montan,87,,1,5,6
053 Montan,88,,1,3,4
053 Montan,89,,-,3,3
053 Montan,90,,-,2,2
053 Montan,91,,-,1,1
053 Montan,92,,-,3,3
053 Montan,93,,1,-,1
053 Montan,94,,-,1,1
053 Montan,95,,1,-,1
053 Montan,96,,-,1,1
053 Montan,98,,-,1,1
054 Moos in Passeier,0,,17,6,23
054 Moos in Passeier,1,,13,8,21
054 Moos in Passeier,2,,17,12,29
054 Moos in Passeier,3,,18,20,38
054 Moos in Passeier,4,,14,11,25
054 Moos in Passeier,5,,21,18,39
054 Moos in Passeier,6,,14,12,26
054 Moos in Passeier,7,,12,17,29
054 Moos in Passeier,8,,25,9,34
054 Moos in Passeier,9,,14,15,29
054 Moos in Passeier,10,,12,17,29
054 Moos in Passeier,11,,18,19,37
054 Moos in Passeier,12,,8,11,19
054 Moos in Passeier,13,,17,21,38
054 Moos in Passeier,14,,17,13,30
054 Moos in Passeier,15,,18,17,35
054 Moos in Passeier,16,,16,20,36
054 Moos in Passeier,17,,15,13,28
054 Moos in Passeier,18,,17,19,36
054 Moos in Passeier,19,,16,14,30
054 Moos in Passeier,20,,15,14,29
054 Moos in Passeier,21,,17,15,32
054 Moos in Passeier,22,,19,11,30
054 Moos in Passeier,23,,23,19,42
054 Moos in Passeier,24,,12,13,25
054 Moos in Passeier,25,,14,19,33
054 Moos in Passeier,26,,17,15,32
054 Moos in Passeier,27,,17,18,35
054 Moos in Passeier,28,,18,13,31
054 Moos in Passeier,29,,20,11,31
054 Moos in Passeier,30,,21,18,39
054 Moos in Passeier,31,,13,9,22
054 Moos in Passeier,32,,17,15,32
054 Moos in Passeier,33,,23,14,37
054 Moos in Passeier,34,,10,20,30
054 Moos in Passeier,35,,20,16,36
054 Moos in Passeier,36,,17,16,33
054 Moos in Passeier,37,,20,11,31
054 Moos in Passeier,38,,17,17,34
054 Moos in Passeier,39,,20,17,37
054 Moos in Passeier,40,,23,16,39
054 Moos in Passeier,41,,25,20,45
054 Moos in Passeier,42,,19,9,28
054 Moos in Passeier,43,,23,11,34
054 Moos in Passeier,44,,15,19,34
054 Moos in Passeier,45,,10,20,30
054 Moos in Passeier,46,,9,7,16
054 Moos in Passeier,47,,16,15,31
054 Moos in Passeier,48,,16,13,29
054 Moos in Passeier,49,,13,14,27
054 Moos in Passeier,50,,19,7,26
054 Moos in Passeier,51,,9,8,17
054 Moos in Passeier,52,,8,8,16
054 Moos in Passeier,53,,15,9,24
054 Moos in Passeier,54,,7,9,16
054 Moos in Passeier,55,,8,3,11
054 Moos in Passeier,56,,9,10,19
054 Moos in Passeier,57,,6,10,16
054 Moos in Passeier,58,,14,9,23
054 Moos in Passeier,59,,6,6,12
054 Moos in Passeier,60,,18,10,28
054 Moos in Passeier,61,,9,8,17
054 Moos in Passeier,62,,9,7,16
054 Moos in Passeier,63,,10,7,17
054 Moos in Passeier,64,,13,12,25
054 Moos in Passeier,65,,5,12,17
054 Moos in Passeier,66,,9,15,24
054 Moos in Passeier,67,,9,10,19
054 Moos in Passeier,68,,5,4,9
054 Moos in Passeier,69,,10,7,17
054 Moos in Passeier,70,,5,6,11
054 Moos in Passeier,71,,8,7,15
054 Moos in Passeier,72,,8,6,14
054 Moos in Passeier,73,,13,14,27
054 Moos in Passeier,74,,5,10,15
054 Moos in Passeier,75,,8,3,11
054 Moos in Passeier,76,,9,7,16
054 Moos in Passeier,77,,8,7,15
054 Moos in Passeier,78,,7,12,19
054 Moos in Passeier,79,,3,10,13
054 Moos in Passeier,80,,6,4,10
054 Moos in Passeier,81,,7,2,9
054 Moos in Passeier,82,,5,7,12
054 Moos in Passeier,83,,3,4,7
054 Moos in Passeier,84,,4,3,7
054 Moos in Passeier,85,,-,5,5
054 Moos in Passeier,86,,1,2,3
054 Moos in Passeier,87,,2,1,3
054 Moos in Passeier,88,,1,3,4
054 Moos in Passeier,90,,1,2,3
054 Moos in Passeier,91,,-,2,2
054 Moos in Passeier,93,,-,1,1
054 Moos in Passeier,95,,-,1,1
054 Moos in Passeier,97,,-,1,1
055 Nals,0,,8,8,16
055 Nals,1,,8,3,11
055 Nals,2,,8,11,19
055 Nals,3,,7,7,14
055 Nals,4,,8,6,14
055 Nals,5,,12,12,24
055 Nals,6,,6,8,14
055 Nals,7,,6,13,19
055 Nals,8,,13,8,21
055 Nals,9,,13,8,21
055 Nals,10,,12,6,18
055 Nals,11,,10,11,21
055 Nals,12,,8,6,14
055 Nals,13,,9,8,17
055 Nals,14,,7,12,19
055 Nals,15,,12,9,21
055 Nals,16,,8,11,19
055 Nals,17,,9,7,16
055 Nals,18,,12,8,20
055 Nals,19,,9,12,21
055 Nals,20,,13,10,23
055 Nals,21,,5,3,8
055 Nals,22,,11,5,16
055 Nals,23,,9,11,20
055 Nals,24,,5,11,16
055 Nals,25,,7,7,14
055 Nals,26,,11,10,21
055 Nals,27,,14,9,23
055 Nals,28,,10,11,21
055 Nals,29,,11,9,20
055 Nals,30,,9,7,16
055 Nals,31,,12,15,27
055 Nals,32,,6,11,17
055 Nals,33,,21,11,32
055 Nals,34,,13,6,19
055 Nals,35,,11,16,27
055 Nals,36,,17,13,30
055 Nals,37,,23,11,34
055 Nals,38,,16,16,32
055 Nals,39,,21,15,36
055 Nals,40,,15,15,30
055 Nals,41,,15,12,27
055 Nals,42,,18,13,31
055 Nals,43,,17,20,37
055 Nals,44,,11,20,31
055 Nals,45,,10,14,24
055 Nals,46,,16,14,30
055 Nals,47,,13,10,23
055 Nals,48,,17,15,32
055 Nals,49,,16,16,32
055 Nals,50,,7,7,14
055 Nals,51,,7,9,16
055 Nals,52,,20,15,35
055 Nals,53,,8,7,15
055 Nals,54,,7,7,14
055 Nals,55,,6,6,12
055 Nals,56,,3,10,13
055 Nals,57,,6,11,17
055 Nals,58,,10,9,19
055 Nals,59,,12,12,24
055 Nals,60,,12,5,17
055 Nals,61,,6,12,18
055 Nals,62,,7,12,19
055 Nals,63,,5,13,18
055 Nals,64,,9,6,15
055 Nals,65,,6,8,14
055 Nals,66,,10,6,16
055 Nals,67,,7,12,19
055 Nals,68,,9,10,19
055 Nals,69,,6,8,14
055 Nals,70,,3,13,16
055 Nals,71,,6,4,10
055 Nals,72,,6,6,12
055 Nals,73,,5,6,11
055 Nals,74,,8,10,18
055 Nals,75,,6,5,11
055 Nals,76,,3,6,9
055 Nals,77,,3,5,8
055 Nals,78,,8,7,15
055 Nals,79,,7,7,14
055 Nals,80,,3,6,9
055 Nals,81,,6,6,12
055 Nals,82,,3,4,7
055 Nals,83,,2,-,2
055 Nals,84,,-,6,6
055 Nals,85,,1,6,7
055 Nals,86,,1,8,9
055 Nals,87,,-,1,1
055 Nals,88,,-,3,3
055 Nals,91,,-,1,1
055 Nals,92,,1,-,1
055 Nals,93,,-,3,3
055 Nals,94,,-,1,1
055 Nals,95,,1,-,1
055 Nals,96,,-,1,1
055 Nals,97,,-,1,1
056 Naturns,0,,29,28,57
056 Naturns,1,,35,31,66
056 Naturns,2,,32,21,53
056 Naturns,3,,35,29,64
056 Naturns,4,,39,25,64
056 Naturns,5,,28,28,56
056 Naturns,6,,30,29,59
056 Naturns,7,,30,27,57
056 Naturns,8,,32,28,60
056 Naturns,9,,30,32,62
056 Naturns,10,,23,18,41
056 Naturns,11,,32,35,67
056 Naturns,12,,45,35,80
056 Naturns,13,,33,38,71
056 Naturns,14,,31,36,67
056 Naturns,15,,30,40,70
056 Naturns,16,,44,37,81
056 Naturns,17,,36,32,68
056 Naturns,18,,36,24,60
056 Naturns,19,,41,36,77
056 Naturns,20,,36,19,55
056 Naturns,21,,29,30,59
056 Naturns,22,,39,25,64
056 Naturns,23,,40,21,61
056 Naturns,24,,31,36,67
056 Naturns,25,,36,38,74
056 Naturns,26,,38,47,85
056 Naturns,27,,34,38,72
056 Naturns,28,,44,36,80
056 Naturns,29,,38,42,80
056 Naturns,30,,38,35,73
056 Naturns,31,,34,35,69
056 Naturns,32,,45,37,82
056 Naturns,33,,43,46,89
056 Naturns,34,,50,49,99
056 Naturns,35,,45,43,88
056 Naturns,36,,41,39,80
056 Naturns,37,,50,42,92
056 Naturns,38,,38,46,84
056 Naturns,39,,45,43,88
056 Naturns,40,,51,45,96
056 Naturns,41,,56,46,102
056 Naturns,42,,38,54,92
056 Naturns,43,,47,37,84
056 Naturns,44,,44,50,94
056 Naturns,45,,39,47,86
056 Naturns,46,,38,48,86
056 Naturns,47,,57,39,96
056 Naturns,48,,44,36,80
056 Naturns,49,,31,36,67
056 Naturns,50,,39,33,72
056 Naturns,51,,40,37,77
056 Naturns,52,,29,32,61
056 Naturns,53,,38,31,69
056 Naturns,54,,34,23,57
056 Naturns,55,,32,36,68
056 Naturns,56,,35,34,69
056 Naturns,57,,28,33,61
056 Naturns,58,,25,19,44
056 Naturns,59,,31,24,55
056 Naturns,60,,12,22,34
056 Naturns,61,,21,30,51
056 Naturns,62,,25,18,43
056 Naturns,63,,21,21,42
056 Naturns,64,,25,34,59
056 Naturns,65,,32,34,66
056 Naturns,66,,39,29,68
056 Naturns,67,,22,19,41
056 Naturns,68,,20,21,41
056 Naturns,69,,22,18,40
056 Naturns,70,,23,23,46
056 Naturns,71,,19,21,40
056 Naturns,72,,21,11,32
056 Naturns,73,,15,19,34
056 Naturns,74,,14,13,27
056 Naturns,75,,9,20,29
056 Naturns,76,,10,21,31
056 Naturns,77,,13,23,36
056 Naturns,78,,12,17,29
056 Naturns,79,,15,14,29
056 Naturns,80,,6,14,20
056 Naturns,81,,13,12,25
056 Naturns,82,,11,15,26
056 Naturns,83,,11,13,24
056 Naturns,84,,6,9,15
056 Naturns,85,,3,8,11
056 Naturns,86,,1,11,12
056 Naturns,87,,1,4,5
056 Naturns,88,,-,6,6
056 Naturns,89,,2,2,4
056 Naturns,90,,1,1,2
056 Naturns,91,,1,-,1
056 Naturns,92,,-,2,2
056 Naturns,93,,1,5,6
056 Naturns,94,,3,5,8
056 Naturns,95,,-,1,1
056 Naturns,96,,-,1,1
056 Naturns,97,,2,-,2
056 Naturns,98,,-,3,3
057 Natz-Schabs,0,,14,15,29
057 Natz-Schabs,1,,11,16,27
057 Natz-Schabs,2,,14,13,27
057 Natz-Schabs,3,,12,17,29
057 Natz-Schabs,4,,20,19,39
057 Natz-Schabs,5,,22,17,39
057 Natz-Schabs,6,,12,19,31
057 Natz-Schabs,7,,23,18,41
057 Natz-Schabs,8,,15,20,35
057 Natz-Schabs,9,,23,16,39
057 Natz-Schabs,10,,19,18,37
057 Natz-Schabs,11,,22,17,39
057 Natz-Schabs,12,,14,12,26
057 Natz-Schabs,13,,23,16,39
057 Natz-Schabs,14,,16,18,34
057 Natz-Schabs,15,,17,14,31
057 Natz-Schabs,16,,23,21,44
057 Natz-Schabs,17,,15,26,41
057 Natz-Schabs,18,,14,23,37
057 Natz-Schabs,19,,26,15,41
057 Natz-Schabs,20,,20,21,41
057 Natz-Schabs,21,,18,21,39
057 Natz-Schabs,22,,22,24,46
057 Natz-Schabs,23,,18,20,38
057 Natz-Schabs,24,,22,21,43
057 Natz-Schabs,25,,17,22,39
057 Natz-Schabs,26,,20,21,41
057 Natz-Schabs,27,,27,20,47
057 Natz-Schabs,28,,24,15,39
057 Natz-Schabs,29,,16,24,40
057 Natz-Schabs,30,,19,19,38
057 Natz-Schabs,31,,16,18,34
057 Natz-Schabs,32,,21,26,47
057 Natz-Schabs,33,,20,27,47
057 Natz-Schabs,34,,25,22,47
057 Natz-Schabs,35,,24,20,44
057 Natz-Schabs,36,,24,26,50
057 Natz-Schabs,37,,29,27,56
057 Natz-Schabs,38,,29,24,53
057 Natz-Schabs,39,,31,19,50
057 Natz-Schabs,40,,27,22,49
057 Natz-Schabs,41,,33,21,54
057 Natz-Schabs,42,,35,32,67
057 Natz-Schabs,43,,29,27,56
057 Natz-Schabs,44,,26,27,53
057 Natz-Schabs,45,,18,22,40
057 Natz-Schabs,46,,21,18,39
057 Natz-Schabs,47,,32,22,54
057 Natz-Schabs,48,,22,24,46
057 Natz-Schabs,49,,21,18,39
057 Natz-Schabs,50,,20,21,41
057 Natz-Schabs,51,,16,24,40
057 Natz-Schabs,52,,20,18,38
057 Natz-Schabs,53,,11,15,26
057 Natz-Schabs,54,,21,16,37
057 Natz-Schabs,55,,12,10,22
057 Natz-Schabs,56,,15,12,27
057 Natz-Schabs,57,,17,15,32
057 Natz-Schabs,58,,19,15,34
057 Natz-Schabs,59,,13,13,26
057 Natz-Schabs,60,,15,13,28
057 Natz-Schabs,61,,15,11,26
057 Natz-Schabs,62,,10,6,16
057 Natz-Schabs,63,,13,11,24
057 Natz-Schabs,64,,11,7,18
057 Natz-Schabs,65,,12,7,19
057 Natz-Schabs,66,,13,8,21
057 Natz-Schabs,67,,4,6,10
057 Natz-Schabs,68,,2,5,7
057 Natz-Schabs,69,,6,6,12
057 Natz-Schabs,70,,11,6,17
057 Natz-Schabs,71,,8,4,12
057 Natz-Schabs,72,,6,7,13
057 Natz-Schabs,73,,4,4,8
057 Natz-Schabs,74,,7,9,16
057 Natz-Schabs,75,,4,7,11
057 Natz-Schabs,76,,4,4,8
057 Natz-Schabs,77,,5,7,12
057 Natz-Schabs,78,,9,2,11
057 Natz-Schabs,79,,3,6,9
057 Natz-Schabs,80,,1,4,5
057 Natz-Schabs,81,,2,6,8
057 Natz-Schabs,82,,2,1,3
057 Natz-Schabs,83,,2,5,7
057 Natz-Schabs,84,,-,8,8
057 Natz-Schabs,85,,4,3,7
057 Natz-Schabs,86,,3,3,6
057 Natz-Schabs,87,,2,6,8
057 Natz-Schabs,88,,-,2,2
057 Natz-Schabs,89,,1,2,3
057 Natz-Schabs,90,,-,1,1
057 Natz-Schabs,92,,-,1,1
057 Natz-Schabs,95,,-,1,1
057 Natz-Schabs,96,,-,1,1
057 Natz-Schabs,99,,-,1,1
058 Welschnofen,0,,8,8,16
058 Welschnofen,1,,9,7,16
058 Welschnofen,2,,9,11,20
058 Welschnofen,3,,16,8,24
058 Welschnofen,4,,8,8,16
058 Welschnofen,5,,17,5,22
058 Welschnofen,6,,5,9,14
058 Welschnofen,7,,8,7,15
058 Welschnofen,8,,10,13,23
058 Welschnofen,9,,14,11,25
058 Welschnofen,10,,12,15,27
058 Welschnofen,11,,10,10,20
058 Welschnofen,12,,14,14,28
058 Welschnofen,13,,11,10,21
058 Welschnofen,14,,12,11,23
058 Welschnofen,15,,18,10,28
058 Welschnofen,16,,16,11,27
058 Welschnofen,17,,12,14,26
058 Welschnofen,18,,14,8,22
058 Welschnofen,19,,11,15,26
058 Welschnofen,20,,10,9,19
058 Welschnofen,21,,7,10,17
058 Welschnofen,22,,11,10,21
058 Welschnofen,23,,7,7,14
058 Welschnofen,24,,11,12,23
058 Welschnofen,25,,11,16,27
058 Welschnofen,26,,14,13,27
058 Welschnofen,27,,12,9,21
058 Welschnofen,28,,10,5,15
058 Welschnofen,29,,13,12,25
058 Welschnofen,30,,13,15,28
058 Welschnofen,31,,17,10,27
058 Welschnofen,32,,20,12,32
058 Welschnofen,33,,12,13,25
058 Welschnofen,34,,14,15,29
058 Welschnofen,35,,13,16,29
058 Welschnofen,36,,16,16,32
058 Welschnofen,37,,19,14,33
058 Welschnofen,38,,16,14,30
058 Welschnofen,39,,16,19,35
058 Welschnofen,40,,17,15,32
058 Welschnofen,41,,15,13,28
058 Welschnofen,42,,24,15,39
058 Welschnofen,43,,13,8,21
058 Welschnofen,44,,19,14,33
058 Welschnofen,45,,14,14,28
058 Welschnofen,46,,16,19,35
058 Welschnofen,47,,18,9,27
058 Welschnofen,48,,15,13,28
058 Welschnofen,49,,15,10,25
058 Welschnofen,50,,11,14,25
058 Welschnofen,51,,11,13,24
058 Welschnofen,52,,16,13,29
058 Welschnofen,53,,14,11,25
058 Welschnofen,54,,11,13,24
058 Welschnofen,55,,11,8,19
058 Welschnofen,56,,15,7,22
058 Welschnofen,57,,8,9,17
058 Welschnofen,58,,11,13,24
058 Welschnofen,59,,9,9,18
058 Welschnofen,60,,9,7,16
058 Welschnofen,61,,11,10,21
058 Welschnofen,62,,10,5,15
058 Welschnofen,63,,7,9,16
058 Welschnofen,64,,13,9,22
058 Welschnofen,65,,10,13,23
058 Welschnofen,66,,10,7,17
058 Welschnofen,67,,7,8,15
058 Welschnofen,68,,8,6,14
058 Welschnofen,69,,6,6,12
058 Welschnofen,70,,9,4,13
058 Welschnofen,71,,5,12,17
058 Welschnofen,72,,8,5,13
058 Welschnofen,73,,10,10,20
058 Welschnofen,74,,8,14,22
058 Welschnofen,75,,7,7,14
058 Welschnofen,76,,3,7,10
058 Welschnofen,77,,5,8,13
058 Welschnofen,78,,4,12,16
058 Welschnofen,79,,7,4,11
058 Welschnofen,80,,2,3,5
058 Welschnofen,81,,2,6,8
058 Welschnofen,82,,4,6,10
058 Welschnofen,83,,2,11,13
058 Welschnofen,84,,3,6,9
058 Welschnofen,85,,5,5,10
058 Welschnofen,86,,-,8,8
058 Welschnofen,87,,1,4,5
058 Welschnofen,88,,1,5,6
058 Welschnofen,89,,1,-,1
058 Welschnofen,90,,1,-,1
058 Welschnofen,91,,1,4,5
058 Welschnofen,92,,-,3,3
058 Welschnofen,93,,-,1,1
058 Welschnofen,94,,-,1,1
058 Welschnofen,95,,2,3,5
058 Welschnofen,96,,1,-,1
058 Welschnofen,97,,1,1,2
058 Welschnofen,98,,-,1,1
059 Deutschnofen,0,,17,16,33
059 Deutschnofen,1,,23,25,48
059 Deutschnofen,2,,28,31,59
059 Deutschnofen,3,,22,30,52
059 Deutschnofen,4,,18,29,47
059 Deutschnofen,5,,32,12,44
059 Deutschnofen,6,,23,33,56
059 Deutschnofen,7,,23,26,49
059 Deutschnofen,8,,30,23,53
059 Deutschnofen,9,,32,13,45
059 Deutschnofen,10,,23,28,51
059 Deutschnofen,11,,20,27,47
059 Deutschnofen,12,,26,24,50
059 Deutschnofen,13,,28,15,43
059 Deutschnofen,14,,25,26,51
059 Deutschnofen,15,,35,28,63
059 Deutschnofen,16,,20,21,41
059 Deutschnofen,17,,34,29,63
059 Deutschnofen,18,,24,22,46
059 Deutschnofen,19,,21,34,55
059 Deutschnofen,20,,23,27,50
059 Deutschnofen,21,,30,18,48
059 Deutschnofen,22,,25,21,46
059 Deutschnofen,23,,31,29,60
059 Deutschnofen,24,,26,23,49
059 Deutschnofen,25,,24,38,62
059 Deutschnofen,26,,23,19,42
059 Deutschnofen,27,,28,31,59
059 Deutschnofen,28,,29,26,55
059 Deutschnofen,29,,28,22,50
059 Deutschnofen,30,,33,26,59
059 Deutschnofen,31,,23,21,44
059 Deutschnofen,32,,24,20,44
059 Deutschnofen,33,,30,36,66
059 Deutschnofen,34,,22,29,51
059 Deutschnofen,35,,31,37,68
059 Deutschnofen,36,,29,27,56
059 Deutschnofen,37,,34,29,63
059 Deutschnofen,38,,40,30,70
059 Deutschnofen,39,,25,32,57
059 Deutschnofen,40,,30,30,60
059 Deutschnofen,41,,36,35,71
059 Deutschnofen,42,,37,19,56
059 Deutschnofen,43,,32,28,60
059 Deutschnofen,44,,33,26,59
059 Deutschnofen,45,,26,28,54
059 Deutschnofen,46,,36,21,57
059 Deutschnofen,47,,41,26,67
059 Deutschnofen,48,,28,18,46
059 Deutschnofen,49,,23,30,53
059 Deutschnofen,50,,24,26,50
059 Deutschnofen,51,,31,26,57
059 Deutschnofen,52,,30,22,52
059 Deutschnofen,53,,28,21,49
059 Deutschnofen,54,,22,20,42
059 Deutschnofen,55,,24,21,45
059 Deutschnofen,56,,22,14,36
059 Deutschnofen,57,,17,18,35
059 Deutschnofen,58,,22,14,36
059 Deutschnofen,59,,22,16,38
059 Deutschnofen,60,,13,13,26
059 Deutschnofen,61,,17,22,39
059 Deutschnofen,62,,16,14,30
059 Deutschnofen,63,,16,16,32
059 Deutschnofen,64,,23,21,44
059 Deutschnofen,65,,17,17,34
059 Deutschnofen,66,,18,25,43
059 Deutschnofen,67,,14,19,33
059 Deutschnofen,68,,24,14,38
059 Deutschnofen,69,,15,20,35
059 Deutschnofen,70,,13,7,20
059 Deutschnofen,71,,13,10,23
059 Deutschnofen,72,,8,11,19
059 Deutschnofen,73,,16,9,25
059 Deutschnofen,74,,8,13,21
059 Deutschnofen,75,,14,13,27
059 Deutschnofen,76,,9,9,18
059 Deutschnofen,77,,10,9,19
059 Deutschnofen,78,,6,10,16
059 Deutschnofen,79,,8,19,27
059 Deutschnofen,80,,7,13,20
059 Deutschnofen,81,,10,10,20
059 Deutschnofen,82,,8,19,27
059 Deutschnofen,83,,4,10,14
059 Deutschnofen,84,,4,9,13
059 Deutschnofen,85,,6,13,19
059 Deutschnofen,86,,4,11,15
059 Deutschnofen,87,,1,8,9
059 Deutschnofen,88,,1,3,4
059 Deutschnofen,89,,-,4,4
059 Deutschnofen,90,,-,2,2
059 Deutschnofen,91,,3,2,5
059 Deutschnofen,92,,2,2,4
059 Deutschnofen,93,,-,2,2
059 Deutschnofen,94,,-,3,3
059 Deutschnofen,95,,-,2,2
059 Deutschnofen,96,,-,5,5
059 Deutschnofen,97,,1,-,1
060 Auer,0,,20,15,35
060 Auer,1,,13,11,24
060 Auer,2,,25,23,48
060 Auer,3,,22,17,39
060 Auer,4,,20,15,35
060 Auer,5,,32,18,50
060 Auer,6,,18,25,43
060 Auer,7,,21,24,45
060 Auer,8,,20,25,45
060 Auer,9,,21,25,46
060 Auer,10,,20,20,40
060 Auer,11,,19,22,41
060 Auer,12,,18,17,35
060 Auer,13,,23,22,45
060 Auer,14,,10,24,34
060 Auer,15,,20,20,40
060 Auer,16,,28,16,44
060 Auer,17,,18,19,37
060 Auer,18,,20,25,45
060 Auer,19,,18,22,40
060 Auer,20,,25,20,45
060 Auer,21,,16,14,30
060 Auer,22,,23,19,42
060 Auer,23,,16,15,31
060 Auer,24,,19,16,35
060 Auer,25,,17,25,42
060 Auer,26,,16,21,37
060 Auer,27,,17,18,35
060 Auer,28,,18,19,37
060 Auer,29,,16,14,30
060 Auer,30,,18,29,47
060 Auer,31,,21,31,52
060 Auer,32,,22,19,41
060 Auer,33,,31,29,60
060 Auer,34,,27,24,51
060 Auer,35,,20,26,46
060 Auer,36,,41,28,69
060 Auer,37,,31,30,61
060 Auer,38,,23,34,57
060 Auer,39,,36,37,73
060 Auer,40,,27,29,56
060 Auer,41,,34,38,72
060 Auer,42,,34,26,60
060 Auer,43,,35,25,60
060 Auer,44,,33,40,73
060 Auer,45,,27,23,50
060 Auer,46,,35,33,68
060 Auer,47,,29,35,64
060 Auer,48,,35,30,65
060 Auer,49,,36,21,57
060 Auer,50,,22,25,47
060 Auer,51,,29,29,58
060 Auer,52,,15,21,36
060 Auer,53,,22,13,35
060 Auer,54,,15,24,39
060 Auer,55,,18,20,38
060 Auer,56,,16,20,36
060 Auer,57,,16,22,38
060 Auer,58,,14,13,27
060 Auer,59,,30,14,44
060 Auer,60,,17,19,36
060 Auer,61,,17,25,42
060 Auer,62,,12,12,24
060 Auer,63,,21,16,37
060 Auer,64,,14,18,32
060 Auer,65,,14,19,33
060 Auer,66,,20,14,34
060 Auer,67,,12,10,22
060 Auer,68,,12,19,31
060 Auer,69,,16,19,35
060 Auer,70,,8,11,19
060 Auer,71,,11,9,20
060 Auer,72,,9,16,25
060 Auer,73,,15,13,28
060 Auer,74,,6,8,14
060 Auer,75,,4,14,18
060 Auer,76,,10,12,22
060 Auer,77,,7,8,15
060 Auer,78,,7,14,21
060 Auer,79,,9,6,15
060 Auer,80,,7,13,20
060 Auer,81,,3,16,19
060 Auer,82,,10,11,21
060 Auer,83,,6,10,16
060 Auer,84,,8,11,19
060 Auer,85,,3,13,16
060 Auer,86,,2,8,10
060 Auer,87,,4,9,13
060 Auer,88,,2,3,5
060 Auer,89,,-,5,5
060 Auer,90,,-,2,2
060 Auer,91,,-,1,1
060 Auer,92,,-,2,2
060 Auer,93,,-,3,3
060 Auer,94,,1,4,5
060 Auer,96,,-,1,1
061 St.Ulrich,0,,26,33,59
061 St.Ulrich,1,,32,24,56
061 St.Ulrich,2,,36,19,55
061 St.Ulrich,3,,23,30,53
061 St.Ulrich,4,,23,30,53
061 St.Ulrich,5,,25,36,61
061 St.Ulrich,6,,21,23,44
061 St.Ulrich,7,,27,32,59
061 St.Ulrich,8,,43,30,73
061 St.Ulrich,9,,44,35,79
061 St.Ulrich,10,,31,27,58
061 St.Ulrich,11,,32,23,55
061 St.Ulrich,12,,31,29,60
061 St.Ulrich,13,,29,30,59
061 St.Ulrich,14,,22,27,49
061 St.Ulrich,15,,34,29,63
061 St.Ulrich,16,,31,30,61
061 St.Ulrich,17,,27,20,47
061 St.Ulrich,18,,18,21,39
061 St.Ulrich,19,,18,22,40
061 St.Ulrich,20,,26,20,46
061 St.Ulrich,21,,19,14,33
061 St.Ulrich,22,,22,19,41
061 St.Ulrich,23,,22,19,41
061 St.Ulrich,24,,20,17,37
061 St.Ulrich,25,,23,29,52
061 St.Ulrich,26,,20,33,53
061 St.Ulrich,27,,26,32,58
061 St.Ulrich,28,,31,28,59
061 St.Ulrich,29,,20,27,47
061 St.Ulrich,30,,21,21,42
061 St.Ulrich,31,,32,31,63
061 St.Ulrich,32,,38,28,66
061 St.Ulrich,33,,37,31,68
061 St.Ulrich,34,,37,30,67
061 St.Ulrich,35,,41,35,76
061 St.Ulrich,36,,39,35,74
061 St.Ulrich,37,,38,30,68
061 St.Ulrich,38,,43,45,88
061 St.Ulrich,39,,39,44,83
061 St.Ulrich,40,,37,38,75
061 St.Ulrich,41,,35,38,73
061 St.Ulrich,42,,36,34,70
061 St.Ulrich,43,,41,41,82
061 St.Ulrich,44,,37,34,71
061 St.Ulrich,45,,29,34,63
061 St.Ulrich,46,,28,24,52
061 St.Ulrich,47,,33,26,59
061 St.Ulrich,48,,37,27,64
061 St.Ulrich,49,,23,17,40
061 St.Ulrich,50,,24,30,54
061 St.Ulrich,51,,16,28,44
061 St.Ulrich,52,,25,36,61
061 St.Ulrich,53,,28,32,60
061 St.Ulrich,54,,27,18,45
061 St.Ulrich,55,,11,27,38
061 St.Ulrich,56,,26,23,49
061 St.Ulrich,57,,20,26,46
061 St.Ulrich,58,,17,27,44
061 St.Ulrich,59,,30,30,60
061 St.Ulrich,60,,21,25,46
061 St.Ulrich,61,,32,25,57
061 St.Ulrich,62,,17,18,35
061 St.Ulrich,63,,28,32,60
061 St.Ulrich,64,,39,37,76
061 St.Ulrich,65,,28,37,65
061 St.Ulrich,66,,36,44,80
061 St.Ulrich,67,,32,27,59
061 St.Ulrich,68,,19,19,38
061 St.Ulrich,69,,23,25,48
061 St.Ulrich,70,,22,26,48
061 St.Ulrich,71,,24,17,41
061 St.Ulrich,72,,13,26,39
061 St.Ulrich,73,,17,13,30
061 St.Ulrich,74,,15,13,28
061 St.Ulrich,75,,14,22,36
061 St.Ulrich,76,,18,14,32
061 St.Ulrich,77,,21,9,30
061 St.Ulrich,78,,13,4,17
061 St.Ulrich,79,,14,12,26
061 St.Ulrich,80,,14,14,28
061 St.Ulrich,81,,7,13,20
061 St.Ulrich,82,,9,9,18
061 St.Ulrich,83,,7,16,23
061 St.Ulrich,84,,4,18,22
061 St.Ulrich,85,,3,13,16
061 St.Ulrich,86,,6,12,18
061 St.Ulrich,87,,4,11,15
061 St.Ulrich,88,,4,7,11
061 St.Ulrich,89,,1,6,7
061 St.Ulrich,90,,-,4,4
061 St.Ulrich,91,,2,2,4
061 St.Ulrich,92,,1,5,6
061 St.Ulrich,93,,2,4,6
061 St.Ulrich,94,,2,5,7
061 St.Ulrich,95,,2,1,3
061 St.Ulrich,96,,-,1,1
061 St.Ulrich,97,,-,1,1
061 St.Ulrich,98,,1,-,1
061 St.Ulrich,99,,1,1,2
061 St.Ulrich,100,,-,1,1
062 Partschins,0,,14,18,32
062 Partschins,1,,18,16,34
062 Partschins,2,,17,22,39
062 Partschins,3,,12,23,35
062 Partschins,4,,23,21,44
062 Partschins,5,,27,21,48
062 Partschins,6,,16,16,32
062 Partschins,7,,18,16,34
062 Partschins,8,,15,17,32
062 Partschins,9,,19,13,32
062 Partschins,10,,21,21,42
062 Partschins,11,,14,18,32
062 Partschins,12,,22,16,38
062 Partschins,13,,21,20,41
062 Partschins,14,,24,18,42
062 Partschins,15,,24,16,40
062 Partschins,16,,23,27,50
062 Partschins,17,,23,24,47
062 Partschins,18,,10,24,34
062 Partschins,19,,18,27,45
062 Partschins,20,,17,15,32
062 Partschins,21,,23,19,42
062 Partschins,22,,12,15,27
062 Partschins,23,,19,19,38
062 Partschins,24,,17,25,42
062 Partschins,25,,16,26,42
062 Partschins,26,,21,27,48
062 Partschins,27,,25,25,50
062 Partschins,28,,19,22,41
062 Partschins,29,,20,16,36
062 Partschins,30,,24,22,46
062 Partschins,31,,24,21,45
062 Partschins,32,,28,19,47
062 Partschins,33,,26,19,45
062 Partschins,34,,29,24,53
062 Partschins,35,,28,28,56
062 Partschins,36,,28,32,60
062 Partschins,37,,23,31,54
062 Partschins,38,,37,26,63
062 Partschins,39,,21,32,53
062 Partschins,40,,34,23,57
062 Partschins,41,,36,36,72
062 Partschins,42,,27,28,55
062 Partschins,43,,30,36,66
062 Partschins,44,,37,24,61
062 Partschins,45,,31,26,57
062 Partschins,46,,22,24,46
062 Partschins,47,,27,37,64
062 Partschins,48,,26,18,44
062 Partschins,49,,20,19,39
062 Partschins,50,,25,24,49
062 Partschins,51,,23,21,44
062 Partschins,52,,25,25,50
062 Partschins,53,,12,27,39
062 Partschins,54,,22,16,38
062 Partschins,55,,16,15,31
062 Partschins,56,,19,16,35
062 Partschins,57,,19,21,40
062 Partschins,58,,9,13,22
062 Partschins,59,,19,18,37
062 Partschins,60,,14,18,32
062 Partschins,61,,27,26,53
062 Partschins,62,,13,17,30
062 Partschins,63,,19,16,35
062 Partschins,64,,23,26,49
062 Partschins,65,,14,16,30
062 Partschins,66,,21,29,50
062 Partschins,67,,13,12,25
062 Partschins,68,,11,14,25
062 Partschins,69,,17,14,31
062 Partschins,70,,14,16,30
062 Partschins,71,,12,16,28
062 Partschins,72,,9,11,20
062 Partschins,73,,9,16,25
062 Partschins,74,,11,16,27
062 Partschins,75,,13,10,23
062 Partschins,76,,13,20,33
062 Partschins,77,,10,9,19
062 Partschins,78,,12,8,20
062 Partschins,79,,9,11,20
062 Partschins,80,,11,10,21
062 Partschins,81,,8,8,16
062 Partschins,82,,4,10,14
062 Partschins,83,,3,11,14
062 Partschins,84,,5,7,12
062 Partschins,85,,4,6,10
062 Partschins,86,,10,7,17
062 Partschins,87,,-,4,4
062 Partschins,88,,2,5,7
062 Partschins,89,,1,1,2
062 Partschins,90,,-,2,2
062 Partschins,91,,-,3,3
062 Partschins,92,,-,1,1
062 Partschins,93,,1,2,3
062 Partschins,94,,-,1,1
062 Partschins,95,,-,2,2
063 Percha,0,,9,6,15
063 Percha,1,,3,4,7
063 Percha,2,,5,13,18
063 Percha,3,,10,16,26
063 Percha,4,,8,6,14
063 Percha,5,,10,7,17
063 Percha,6,,4,5,9
063 Percha,7,,10,11,21
063 Percha,8,,5,9,14
063 Percha,9,,8,8,16
063 Percha,10,,10,15,25
063 Percha,11,,9,4,13
063 Percha,12,,9,8,17
063 Percha,13,,9,12,21
063 Percha,14,,7,8,15
063 Percha,15,,12,6,18
063 Percha,16,,10,9,19
063 Percha,17,,8,7,15
063 Percha,18,,6,8,14
063 Percha,19,,6,5,11
063 Percha,20,,9,18,27
063 Percha,21,,7,7,14
063 Percha,22,,8,13,21
063 Percha,23,,16,7,23
063 Percha,24,,14,8,22
063 Percha,25,,5,10,15
063 Percha,26,,9,7,16
063 Percha,27,,12,7,19
063 Percha,28,,6,13,19
063 Percha,29,,14,13,27
063 Percha,30,,9,6,15
063 Percha,31,,15,13,28
063 Percha,32,,10,10,20
063 Percha,33,,10,12,22
063 Percha,34,,12,10,22
063 Percha,35,,13,10,23
063 Percha,36,,17,15,32
063 Percha,37,,9,10,19
063 Percha,38,,18,15,33
063 Percha,39,,17,15,32
063 Percha,40,,8,9,17
063 Percha,41,,16,6,22
063 Percha,42,,14,21,35
063 Percha,43,,15,7,22
063 Percha,44,,11,16,27
063 Percha,45,,14,10,24
063 Percha,46,,9,11,20
063 Percha,47,,11,6,17
063 Percha,48,,6,10,16
063 Percha,49,,10,10,20
063 Percha,50,,10,5,15
063 Percha,51,,7,12,19
063 Percha,52,,9,9,18
063 Percha,53,,4,4,8
063 Percha,54,,8,6,14
063 Percha,55,,4,9,13
063 Percha,56,,7,7,14
063 Percha,57,,7,8,15
063 Percha,58,,9,6,15
063 Percha,59,,4,4,8
063 Percha,60,,5,6,11
063 Percha,61,,6,8,14
063 Percha,62,,8,5,13
063 Percha,63,,13,5,18
063 Percha,64,,8,9,17
063 Percha,65,,8,7,15
063 Percha,66,,7,7,14
063 Percha,67,,5,5,10
063 Percha,68,,6,5,11
063 Percha,69,,5,9,14
063 Percha,70,,2,5,7
063 Percha,71,,3,3,6
063 Percha,72,,4,4,8
063 Percha,73,,8,5,13
063 Percha,74,,4,5,9
063 Percha,75,,5,3,8
063 Percha,76,,6,1,7
063 Percha,77,,9,3,12
063 Percha,78,,1,4,5
063 Percha,79,,2,3,5
063 Percha,80,,4,2,6
063 Percha,81,,2,5,7
063 Percha,82,,3,5,8
063 Percha,83,,-,2,2
063 Percha,84,,1,3,4
063 Percha,85,,1,-,1
063 Percha,86,,-,2,2
063 Percha,87,,-,2,2
063 Percha,93,,-,1,1
064 Plaus,0,,4,4,8
064 Plaus,1,,5,2,7
064 Plaus,2,,6,2,8
064 Plaus,3,,6,1,7
064 Plaus,4,,3,1,4
064 Plaus,5,,4,6,10
064 Plaus,6,,8,4,12
064 Plaus,7,,10,3,13
064 Plaus,8,,11,5,16
064 Plaus,9,,6,7,13
064 Plaus,10,,7,5,12
064 Plaus,11,,4,2,6
064 Plaus,12,,2,2,4
064 Plaus,13,,5,1,6
064 Plaus,14,,9,4,13
064 Plaus,15,,7,6,13
064 Plaus,16,,3,10,13
064 Plaus,17,,4,3,7
064 Plaus,18,,5,7,12
064 Plaus,19,,4,3,7
064 Plaus,20,,4,2,6
064 Plaus,21,,2,3,5
064 Plaus,22,,2,4,6
064 Plaus,23,,5,-,5
064 Plaus,24,,3,6,9
064 Plaus,25,,1,5,6
064 Plaus,26,,2,6,8
064 Plaus,27,,6,4,10
064 Plaus,28,,3,4,7
064 Plaus,29,,4,3,7
064 Plaus,30,,2,7,9
064 Plaus,31,,3,2,5
064 Plaus,32,,10,4,14
064 Plaus,33,,6,9,15
064 Plaus,34,,11,6,17
064 Plaus,35,,7,6,13
064 Plaus,36,,6,7,13
064 Plaus,37,,8,4,12
064 Plaus,38,,7,9,16
064 Plaus,39,,3,9,12
064 Plaus,40,,7,10,17
064 Plaus,41,,5,5,10
064 Plaus,42,,13,2,15
064 Plaus,43,,7,9,16
064 Plaus,44,,3,5,8
064 Plaus,45,,9,5,14
064 Plaus,46,,7,2,9
064 Plaus,47,,3,6,9
064 Plaus,48,,7,2,9
064 Plaus,49,,3,3,6
064 Plaus,50,,1,3,4
064 Plaus,51,,1,1,2
064 Plaus,52,,3,5,8
064 Plaus,53,,1,1,2
064 Plaus,54,,2,5,7
064 Plaus,55,,4,2,6
064 Plaus,56,,5,3,8
064 Plaus,57,,2,2,4
064 Plaus,58,,4,3,7
064 Plaus,59,,1,4,5
064 Plaus,60,,2,4,6
064 Plaus,61,,5,2,7
064 Plaus,62,,4,1,5
064 Plaus,63,,2,3,5
064 Plaus,64,,5,1,6
064 Plaus,65,,1,4,5
064 Plaus,66,,3,2,5
064 Plaus,67,,3,1,4
064 Plaus,68,,3,2,5
064 Plaus,69,,1,1,2
064 Plaus,70,,3,2,5
064 Plaus,71,,-,1,1
064 Plaus,72,,2,2,4
064 Plaus,73,,4,1,5
064 Plaus,74,,1,3,4
064 Plaus,75,,2,3,5
064 Plaus,76,,1,1,2
064 Plaus,78,,1,1,2
064 Plaus,79,,-,1,1
064 Plaus,80,,1,1,2
064 Plaus,81,,1,1,2
064 Plaus,82,,1,-,1
064 Plaus,83,,-,3,3
064 Plaus,84,,-,1,1
064 Plaus,85,,-,1,1
064 Plaus,86,,-,1,1
064 Plaus,88,,-,2,2
064 Plaus,89,,-,1,1
064 Plaus,92,,-,1,1
065 Waidbruck,0,,1,-,1
065 Waidbruck,1,,2,1,3
065 Waidbruck,3,,1,-,1
065 Waidbruck,4,,-,2,2
065 Waidbruck,5,,-,1,1
065 Waidbruck,6,,1,1,2
065 Waidbruck,7,,1,2,3
065 Waidbruck,8,,2,2,4
065 Waidbruck,10,,3,3,6
065 Waidbruck,11,,2,-,2
065 Waidbruck,12,,1,3,4
065 Waidbruck,13,,3,1,4
065 Waidbruck,14,,1,1,2
065 Waidbruck,15,,-,2,2
065 Waidbruck,16,,1,-,1
065 Waidbruck,17,,-,1,1
065 Waidbruck,18,,1,1,2
065 Waidbruck,19,,-,1,1
065 Waidbruck,20,,1,1,2
065 Waidbruck,22,,1,1,2
065 Waidbruck,23,,3,1,4
065 Waidbruck,24,,1,-,1
065 Waidbruck,25,,1,-,1
065 Waidbruck,26,,1,2,3
065 Waidbruck,27,,1,1,2
065 Waidbruck,29,,4,1,5
065 Waidbruck,30,,1,1,2
065 Waidbruck,32,,-,1,1
065 Waidbruck,33,,3,2,5
065 Waidbruck,34,,-,1,1
065 Waidbruck,35,,3,1,4
065 Waidbruck,36,,2,-,2
065 Waidbruck,37,,-,1,1
065 Waidbruck,38,,3,1,4
065 Waidbruck,39,,3,1,4
065 Waidbruck,40,,1,4,5
065 Waidbruck,41,,2,3,5
065 Waidbruck,42,,3,1,4
065 Waidbruck,43,,3,-,3
065 Waidbruck,44,,1,1,2
065 Waidbruck,45,,1,-,1
065 Waidbruck,46,,1,1,2
065 Waidbruck,47,,4,1,5
065 Waidbruck,48,,3,1,4
065 Waidbruck,49,,-,1,1
065 Waidbruck,50,,3,1,4
065 Waidbruck,51,,2,-,2
065 Waidbruck,52,,2,-,2
065 Waidbruck,53,,1,-,1
065 Waidbruck,55,,1,1,2
065 Waidbruck,56,,-,1,1
065 Waidbruck,61,,-,3,3
065 Waidbruck,62,,1,1,2
065 Waidbruck,63,,2,1,3
065 Waidbruck,65,,1,-,1
065 Waidbruck,66,,-,2,2
065 Waidbruck,67,,-,3,3
065 Waidbruck,68,,1,-,1
065 Waidbruck,69,,-,2,2
065 Waidbruck,70,,1,1,2
065 Waidbruck,71,,2,1,3
065 Waidbruck,72,,-,3,3
065 Waidbruck,73,,2,1,3
065 Waidbruck,74,,1,-,1
065 Waidbruck,75,,-,3,3
065 Waidbruck,76,,1,-,1
065 Waidbruck,77,,1,-,1
065 Waidbruck,78,,-,3,3
065 Waidbruck,79,,1,1,2
065 Waidbruck,80,,2,1,3
065 Waidbruck,81,,-,1,1
065 Waidbruck,82,,1,1,2
065 Waidbruck,84,,-,2,2
065 Waidbruck,87,,-,1,1
065 Waidbruck,88,,-,2,2
065 Waidbruck,93,,-,1,1
066 Burgstall,0,,10,4,14
066 Burgstall,1,,9,11,20
066 Burgstall,2,,6,9,15
066 Burgstall,3,,14,5,19
066 Burgstall,4,,8,11,19
066 Burgstall,5,,8,11,19
066 Burgstall,6,,10,8,18
066 Burgstall,7,,13,12,25
066 Burgstall,8,,8,9,17
066 Burgstall,9,,10,10,20
066 Burgstall,10,,8,6,14
066 Burgstall,11,,7,7,14
066 Burgstall,12,,9,8,17
066 Burgstall,13,,6,5,11
066 Burgstall,14,,7,11,18
066 Burgstall,15,,5,5,10
066 Burgstall,16,,6,10,16
066 Burgstall,17,,14,9,23
066 Burgstall,18,,10,3,13
066 Burgstall,19,,8,7,15
066 Burgstall,20,,9,9,18
066 Burgstall,21,,12,4,16
066 Burgstall,22,,9,13,22
066 Burgstall,23,,9,15,24
066 Burgstall,24,,11,12,23
066 Burgstall,25,,11,12,23
066 Burgstall,26,,7,9,16
066 Burgstall,27,,12,10,22
066 Burgstall,28,,11,7,18
066 Burgstall,29,,6,9,15
066 Burgstall,30,,10,16,26
066 Burgstall,31,,9,11,20
066 Burgstall,32,,16,15,31
066 Burgstall,33,,7,13,20
066 Burgstall,34,,13,17,30
066 Burgstall,35,,9,18,27
066 Burgstall,36,,17,11,28
066 Burgstall,37,,16,12,28
066 Burgstall,38,,16,10,26
066 Burgstall,39,,18,15,33
066 Burgstall,40,,10,16,26
066 Burgstall,41,,13,17,30
066 Burgstall,42,,20,19,39
066 Burgstall,43,,15,12,27
066 Burgstall,44,,15,15,30
066 Burgstall,45,,15,11,26
066 Burgstall,46,,11,18,29
066 Burgstall,47,,15,10,25
066 Burgstall,48,,11,9,20
066 Burgstall,49,,15,7,22
066 Burgstall,50,,10,8,18
066 Burgstall,51,,12,10,22
066 Burgstall,52,,7,11,18
066 Burgstall,53,,9,16,25
066 Burgstall,54,,9,9,18
066 Burgstall,55,,12,15,27
066 Burgstall,56,,13,7,20
066 Burgstall,57,,10,9,19
066 Burgstall,58,,10,6,16
066 Burgstall,59,,7,12,19
066 Burgstall,60,,7,10,17
066 Burgstall,61,,12,7,19
066 Burgstall,62,,6,9,15
066 Burgstall,63,,10,10,20
066 Burgstall,64,,11,9,20
066 Burgstall,65,,5,5,10
066 Burgstall,66,,8,4,12
066 Burgstall,67,,5,12,17
066 Burgstall,68,,6,7,13
066 Burgstall,69,,9,14,23
066 Burgstall,70,,5,10,15
066 Burgstall,71,,4,5,9
066 Burgstall,72,,7,3,10
066 Burgstall,73,,8,7,15
066 Burgstall,74,,8,4,12
066 Burgstall,75,,2,7,9
066 Burgstall,76,,6,3,9
066 Burgstall,77,,5,6,11
066 Burgstall,78,,1,4,5
066 Burgstall,79,,3,6,9
066 Burgstall,80,,1,11,12
066 Burgstall,81,,4,8,12
066 Burgstall,82,,5,5,10
066 Burgstall,83,,1,5,6
066 Burgstall,84,,4,3,7
066 Burgstall,85,,3,5,8
066 Burgstall,86,,1,-,1
066 Burgstall,87,,1,2,3
066 Burgstall,88,,1,1,2
066 Burgstall,89,,-,1,1
066 Burgstall,90,,1,-,1
066 Burgstall,91,,-,2,2
066 Burgstall,92,,1,2,3
066 Burgstall,93,,-,1,1
066 Burgstall,97,,-,1,1
067 Prad am Stilfser Joch,0,,15,12,27
067 Prad am Stilfser Joch,1,,18,19,37
067 Prad am Stilfser Joch,2,,21,14,35
067 Prad am Stilfser Joch,3,,20,21,41
067 Prad am Stilfser Joch,4,,15,13,28
067 Prad am Stilfser Joch,5,,10,15,25
067 Prad am Stilfser Joch,6,,24,16,40
067 Prad am Stilfser Joch,7,,17,18,35
067 Prad am Stilfser Joch,8,,19,20,39
067 Prad am Stilfser Joch,9,,22,22,44
067 Prad am Stilfser Joch,10,,25,17,42
067 Prad am Stilfser Joch,11,,23,21,44
067 Prad am Stilfser Joch,12,,21,13,34
067 Prad am Stilfser Joch,13,,23,28,51
067 Prad am Stilfser Joch,14,,22,28,50
067 Prad am Stilfser Joch,15,,18,20,38
067 Prad am Stilfser Joch,16,,20,11,31
067 Prad am Stilfser Joch,17,,21,20,41
067 Prad am Stilfser Joch,18,,20,23,43
067 Prad am Stilfser Joch,19,,30,18,48
067 Prad am Stilfser Joch,20,,13,19,32
067 Prad am Stilfser Joch,21,,28,28,56
067 Prad am Stilfser Joch,22,,27,21,48
067 Prad am Stilfser Joch,23,,31,27,58
067 Prad am Stilfser Joch,24,,28,26,54
067 Prad am Stilfser Joch,25,,27,26,53
067 Prad am Stilfser Joch,26,,23,26,49
067 Prad am Stilfser Joch,27,,28,19,47
067 Prad am Stilfser Joch,28,,17,20,37
067 Prad am Stilfser Joch,29,,21,19,40
067 Prad am Stilfser Joch,30,,19,34,53
067 Prad am Stilfser Joch,31,,25,20,45
067 Prad am Stilfser Joch,32,,21,18,39
067 Prad am Stilfser Joch,33,,31,18,49
067 Prad am Stilfser Joch,34,,23,40,63
067 Prad am Stilfser Joch,35,,26,25,51
067 Prad am Stilfser Joch,36,,29,24,53
067 Prad am Stilfser Joch,37,,28,24,52
067 Prad am Stilfser Joch,38,,31,26,57
067 Prad am Stilfser Joch,39,,31,33,64
067 Prad am Stilfser Joch,40,,24,25,49
067 Prad am Stilfser Joch,41,,36,27,63
067 Prad am Stilfser Joch,42,,34,26,60
067 Prad am Stilfser Joch,43,,26,28,54
067 Prad am Stilfser Joch,44,,27,11,38
067 Prad am Stilfser Joch,45,,27,31,58
067 Prad am Stilfser Joch,46,,22,27,49
067 Prad am Stilfser Joch,47,,20,24,44
067 Prad am Stilfser Joch,48,,34,15,49
067 Prad am Stilfser Joch,49,,19,29,48
067 Prad am Stilfser Joch,50,,26,25,51
067 Prad am Stilfser Joch,51,,24,24,48
067 Prad am Stilfser Joch,52,,25,18,43
067 Prad am Stilfser Joch,53,,29,17,46
067 Prad am Stilfser Joch,54,,25,18,43
067 Prad am Stilfser Joch,55,,16,18,34
067 Prad am Stilfser Joch,56,,19,22,41
067 Prad am Stilfser Joch,57,,19,17,36
067 Prad am Stilfser Joch,58,,21,20,41
067 Prad am Stilfser Joch,59,,19,11,30
067 Prad am Stilfser Joch,60,,15,12,27
067 Prad am Stilfser Joch,61,,17,14,31
067 Prad am Stilfser Joch,62,,15,11,26
067 Prad am Stilfser Joch,63,,10,15,25
067 Prad am Stilfser Joch,64,,24,17,41
067 Prad am Stilfser Joch,65,,15,16,31
067 Prad am Stilfser Joch,66,,24,9,33
067 Prad am Stilfser Joch,67,,7,17,24
067 Prad am Stilfser Joch,68,,13,14,27
067 Prad am Stilfser Joch,69,,17,14,31
067 Prad am Stilfser Joch,70,,9,11,20
067 Prad am Stilfser Joch,71,,10,10,20
067 Prad am Stilfser Joch,72,,15,12,27
067 Prad am Stilfser Joch,73,,7,22,29
067 Prad am Stilfser Joch,74,,12,11,23
067 Prad am Stilfser Joch,75,,11,19,30
067 Prad am Stilfser Joch,76,,6,14,20
067 Prad am Stilfser Joch,77,,12,12,24
067 Prad am Stilfser Joch,78,,9,13,22
067 Prad am Stilfser Joch,79,,6,9,15
067 Prad am Stilfser Joch,80,,5,11,16
067 Prad am Stilfser Joch,81,,8,11,19
067 Prad am Stilfser Joch,82,,7,5,12
067 Prad am Stilfser Joch,83,,2,6,8
067 Prad am Stilfser Joch,84,,2,10,12
067 Prad am Stilfser Joch,85,,4,10,14
067 Prad am Stilfser Joch,86,,3,6,9
067 Prad am Stilfser Joch,87,,3,4,7
067 Prad am Stilfser Joch,88,,3,3,6
067 Prad am Stilfser Joch,89,,-,2,2
067 Prad am Stilfser Joch,90,,-,3,3
067 Prad am Stilfser Joch,91,,-,2,2
067 Prad am Stilfser Joch,92,,1,-,1
067 Prad am Stilfser Joch,93,,-,1,1
067 Prad am Stilfser Joch,95,,2,-,2
067 Prad am Stilfser Joch,97,,-,1,1
068 Prettau,0,,6,2,8
068 Prettau,1,,5,6,11
068 Prettau,2,,2,1,3
068 Prettau,3,,4,5,9
068 Prettau,4,,2,4,6
068 Prettau,5,,1,2,3
068 Prettau,6,,3,5,8
068 Prettau,7,,1,4,5
068 Prettau,8,,6,6,12
068 Prettau,9,,6,4,10
068 Prettau,10,,1,5,6
068 Prettau,11,,1,2,3
068 Prettau,12,,4,4,8
068 Prettau,13,,4,7,11
068 Prettau,14,,3,5,8
068 Prettau,15,,2,3,5
068 Prettau,16,,1,4,5
068 Prettau,17,,1,7,8
068 Prettau,18,,-,3,3
068 Prettau,19,,5,3,8
068 Prettau,20,,5,2,7
068 Prettau,21,,1,2,3
068 Prettau,22,,2,1,3
068 Prettau,23,,3,6,9
068 Prettau,24,,4,2,6
068 Prettau,25,,3,2,5
068 Prettau,26,,2,1,3
068 Prettau,27,,5,4,9
068 Prettau,28,,6,2,8
068 Prettau,29,,1,2,3
068 Prettau,30,,4,2,6
068 Prettau,31,,1,2,3
068 Prettau,32,,4,2,6
068 Prettau,33,,5,-,5
068 Prettau,34,,6,6,12
068 Prettau,35,,9,4,13
068 Prettau,36,,4,6,10
068 Prettau,37,,3,6,9
068 Prettau,38,,7,6,13
068 Prettau,39,,3,3,6
068 Prettau,40,,10,4,14
068 Prettau,41,,7,1,8
068 Prettau,42,,5,9,14
068 Prettau,43,,8,6,14
068 Prettau,44,,5,6,11
068 Prettau,45,,2,5,7
068 Prettau,46,,5,5,10
068 Prettau,47,,7,4,11
068 Prettau,48,,5,2,7
068 Prettau,49,,7,-,7
068 Prettau,50,,4,1,5
068 Prettau,51,,6,5,11
068 Prettau,52,,6,5,11
068 Prettau,53,,5,2,7
068 Prettau,54,,3,3,6
068 Prettau,55,,4,3,7
068 Prettau,56,,3,2,5
068 Prettau,57,,2,2,4
068 Prettau,58,,2,3,5
068 Prettau,59,,2,1,3
068 Prettau,60,,4,5,9
068 Prettau,61,,7,4,11
068 Prettau,62,,1,3,4
068 Prettau,63,,6,5,11
068 Prettau,64,,3,2,5
068 Prettau,65,,3,2,5
068 Prettau,66,,3,2,5
068 Prettau,67,,4,5,9
068 Prettau,68,,4,3,7
068 Prettau,69,,5,6,11
068 Prettau,70,,2,6,8
068 Prettau,71,,3,3,6
068 Prettau,72,,4,2,6
068 Prettau,73,,1,3,4
068 Prettau,74,,3,3,6
068 Prettau,75,,3,-,3
068 Prettau,76,,1,1,2
068 Prettau,77,,5,4,9
068 Prettau,78,,4,5,9
068 Prettau,79,,-,1,1
068 Prettau,80,,2,1,3
068 Prettau,81,,1,6,7
068 Prettau,82,,-,1,1
068 Prettau,83,,1,1,2
068 Prettau,84,,-,1,1
068 Prettau,85,,2,-,2
068 Prettau,86,,-,1,1
068 Prettau,87,,1,-,1
068 Prettau,88,,2,-,2
068 Prettau,89,,1,1,2
068 Prettau,90,,1,-,1
068 Prettau,91,,-,2,2
068 Prettau,94,,-,1,1
069 Proveis,0,,1,1,2
069 Proveis,1,,1,-,1
069 Proveis,2,,-,3,3
069 Proveis,3,,2,2,4
069 Proveis,4,,1,1,2
069 Proveis,5,,4,-,4
069 Proveis,6,,1,1,2
069 Proveis,7,,-,1,1
069 Proveis,8,,4,-,4
069 Proveis,9,,2,2,4
069 Proveis,10,,1,2,3
069 Proveis,11,,1,1,2
069 Proveis,12,,-,5,5
069 Proveis,13,,2,-,2
069 Proveis,14,,2,1,3
069 Proveis,15,,3,1,4
069 Proveis,16,,3,2,5
069 Proveis,17,,-,1,1
069 Proveis,18,,1,1,2
069 Proveis,19,,2,3,5
069 Proveis,20,,2,2,4
069 Proveis,21,,3,1,4
069 Proveis,22,,5,-,5
069 Proveis,23,,4,4,8
069 Proveis,24,,3,3,6
069 Proveis,25,,2,-,2
069 Proveis,26,,3,3,6
069 Proveis,28,,3,1,4
069 Proveis,29,,1,1,2
069 Proveis,30,,2,2,4
069 Proveis,31,,1,2,3
069 Proveis,32,,2,-,2
069 Proveis,33,,3,2,5
069 Proveis,34,,2,-,2
069 Proveis,35,,1,1,2
069 Proveis,36,,-,1,1
069 Proveis,37,,3,3,6
069 Proveis,38,,3,4,7
069 Proveis,39,,4,1,5
069 Proveis,40,,2,2,4
069 Proveis,41,,2,2,4
069 Proveis,42,,1,1,2
069 Proveis,43,,4,-,4
069 Proveis,44,,4,2,6
069 Proveis,45,,4,2,6
069 Proveis,46,,3,1,4
069 Proveis,47,,-,4,4
069 Proveis,48,,4,-,4
069 Proveis,49,,1,3,4
069 Proveis,50,,2,2,4
069 Proveis,51,,4,2,6
069 Proveis,52,,4,4,8
069 Proveis,53,,3,2,5
069 Proveis,54,,1,1,2
069 Proveis,55,,2,3,5
069 Proveis,56,,2,-,2
069 Proveis,57,,1,1,2
069 Proveis,58,,1,-,1
069 Proveis,59,,2,1,3
069 Proveis,60,,2,2,4
069 Proveis,61,,3,-,3
069 Proveis,62,,1,1,2
069 Proveis,63,,2,-,2
069 Proveis,64,,2,1,3
069 Proveis,65,,1,1,2
069 Proveis,66,,1,1,2
069 Proveis,67,,3,-,3
069 Proveis,68,,1,3,4
069 Proveis,69,,-,2,2
069 Proveis,70,,1,1,2
069 Proveis,71,,2,1,3
069 Proveis,72,,1,1,2
069 Proveis,73,,-,1,1
069 Proveis,74,,-,2,2
069 Proveis,75,,-,1,1
069 Proveis,76,,1,1,2
069 Proveis,78,,2,3,5
069 Proveis,79,,3,1,4
069 Proveis,80,,-,1,1
069 Proveis,82,,-,1,1
069 Proveis,83,,1,-,1
069 Proveis,85,,-,1,1
069 Proveis,86,,-,2,2
069 Proveis,87,,-,1,1
070 Ratschings,0,,30,22,52
070 Ratschings,1,,27,27,54
070 Ratschings,2,,25,30,55
070 Ratschings,3,,35,28,63
070 Ratschings,4,,34,25,59
070 Ratschings,5,,17,29,46
070 Ratschings,6,,24,35,59
070 Ratschings,7,,36,24,60
070 Ratschings,8,,28,21,49
070 Ratschings,9,,35,21,56
070 Ratschings,10,,37,34,71
070 Ratschings,11,,30,33,63
070 Ratschings,12,,27,25,52
070 Ratschings,13,,23,27,50
070 Ratschings,14,,25,21,46
070 Ratschings,15,,39,30,69
070 Ratschings,16,,23,22,45
070 Ratschings,17,,31,26,57
070 Ratschings,18,,26,20,46
070 Ratschings,19,,33,28,61
070 Ratschings,20,,29,31,60
070 Ratschings,21,,30,26,56
070 Ratschings,22,,28,32,60
070 Ratschings,23,,24,21,45
070 Ratschings,24,,32,22,54
070 Ratschings,25,,34,33,67
070 Ratschings,26,,29,28,57
070 Ratschings,27,,27,30,57
070 Ratschings,28,,31,28,59
070 Ratschings,29,,35,24,59
070 Ratschings,30,,33,23,56
070 Ratschings,31,,25,25,50
070 Ratschings,32,,36,34,70
070 Ratschings,33,,38,29,67
070 Ratschings,34,,36,34,70
070 Ratschings,35,,40,35,75
070 Ratschings,36,,42,44,86
070 Ratschings,37,,34,42,76
070 Ratschings,38,,37,44,81
070 Ratschings,39,,50,40,90
070 Ratschings,40,,37,39,76
070 Ratschings,41,,42,47,89
070 Ratschings,42,,35,43,78
070 Ratschings,43,,53,37,90
070 Ratschings,44,,46,28,74
070 Ratschings,45,,34,40,74
070 Ratschings,46,,33,28,61
070 Ratschings,47,,40,25,65
070 Ratschings,48,,39,25,64
070 Ratschings,49,,31,24,55
070 Ratschings,50,,32,18,50
070 Ratschings,51,,35,20,55
070 Ratschings,52,,14,33,47
070 Ratschings,53,,28,15,43
070 Ratschings,54,,21,24,45
070 Ratschings,55,,20,18,38
070 Ratschings,56,,18,14,32
070 Ratschings,57,,25,21,46
070 Ratschings,58,,24,24,48
070 Ratschings,59,,28,19,47
070 Ratschings,60,,17,16,33
070 Ratschings,61,,23,8,31
070 Ratschings,62,,19,18,37
070 Ratschings,63,,16,11,27
070 Ratschings,64,,18,12,30
070 Ratschings,65,,19,18,37
070 Ratschings,66,,21,17,38
070 Ratschings,67,,18,16,34
070 Ratschings,68,,14,17,31
070 Ratschings,69,,14,20,34
070 Ratschings,70,,20,9,29
070 Ratschings,71,,12,13,25
070 Ratschings,72,,12,16,28
070 Ratschings,73,,10,8,18
070 Ratschings,74,,14,19,33
070 Ratschings,75,,14,11,25
070 Ratschings,76,,9,11,20
070 Ratschings,77,,10,16,26
070 Ratschings,78,,8,20,28
070 Ratschings,79,,7,11,18
070 Ratschings,80,,10,11,21
070 Ratschings,81,,9,11,20
070 Ratschings,82,,8,6,14
070 Ratschings,83,,5,10,15
070 Ratschings,84,,5,7,12
070 Ratschings,85,,2,6,8
070 Ratschings,86,,1,7,8
070 Ratschings,87,,2,6,8
070 Ratschings,88,,1,2,3
070 Ratschings,89,,-,4,4
070 Ratschings,91,,2,1,3
070 Ratschings,92,,-,1,1
070 Ratschings,93,,-,1,1
070 Ratschings,94,,1,-,1
071 Rasen-Antholz,0,,21,18,39
071 Rasen-Antholz,1,,16,20,36
071 Rasen-Antholz,2,,28,15,43
071 Rasen-Antholz,3,,13,20,33
071 Rasen-Antholz,4,,9,24,33
071 Rasen-Antholz,5,,15,21,36
071 Rasen-Antholz,6,,18,19,37
071 Rasen-Antholz,7,,25,22,47
071 Rasen-Antholz,8,,13,19,32
071 Rasen-Antholz,9,,19,14,33
071 Rasen-Antholz,10,,28,22,50
071 Rasen-Antholz,11,,29,19,48
071 Rasen-Antholz,12,,8,15,23
071 Rasen-Antholz,13,,20,11,31
071 Rasen-Antholz,14,,19,15,34
071 Rasen-Antholz,15,,26,20,46
071 Rasen-Antholz,16,,14,14,28
071 Rasen-Antholz,17,,15,25,40
071 Rasen-Antholz,18,,19,17,36
071 Rasen-Antholz,19,,20,19,39
071 Rasen-Antholz,20,,27,10,37
071 Rasen-Antholz,21,,16,20,36
071 Rasen-Antholz,22,,24,13,37
071 Rasen-Antholz,23,,16,16,32
071 Rasen-Antholz,24,,14,17,31
071 Rasen-Antholz,25,,24,24,48
071 Rasen-Antholz,26,,15,15,30
071 Rasen-Antholz,27,,17,15,32
071 Rasen-Antholz,28,,18,21,39
071 Rasen-Antholz,29,,16,22,38
071 Rasen-Antholz,30,,18,19,37
071 Rasen-Antholz,31,,23,15,38
071 Rasen-Antholz,32,,19,27,46
071 Rasen-Antholz,33,,25,21,46
071 Rasen-Antholz,34,,32,25,57
071 Rasen-Antholz,35,,23,21,44
071 Rasen-Antholz,36,,24,25,49
071 Rasen-Antholz,37,,25,24,49
071 Rasen-Antholz,38,,26,27,53
071 Rasen-Antholz,39,,24,26,50
071 Rasen-Antholz,40,,27,27,54
071 Rasen-Antholz,41,,29,18,47
071 Rasen-Antholz,42,,35,26,61
071 Rasen-Antholz,43,,29,26,55
071 Rasen-Antholz,44,,20,23,43
071 Rasen-Antholz,45,,27,19,46
071 Rasen-Antholz,46,,20,25,45
071 Rasen-Antholz,47,,21,23,44
071 Rasen-Antholz,48,,27,19,46
071 Rasen-Antholz,49,,23,15,38
071 Rasen-Antholz,50,,22,10,32
071 Rasen-Antholz,51,,17,14,31
071 Rasen-Antholz,52,,18,14,32
071 Rasen-Antholz,53,,14,13,27
071 Rasen-Antholz,54,,15,9,24
071 Rasen-Antholz,55,,11,15,26
071 Rasen-Antholz,56,,12,11,23
071 Rasen-Antholz,57,,13,8,21
071 Rasen-Antholz,58,,14,8,22
071 Rasen-Antholz,59,,14,10,24
071 Rasen-Antholz,60,,9,14,23
071 Rasen-Antholz,61,,10,14,24
071 Rasen-Antholz,62,,11,9,20
071 Rasen-Antholz,63,,10,8,18
071 Rasen-Antholz,64,,13,12,25
071 Rasen-Antholz,65,,11,14,25
071 Rasen-Antholz,66,,15,12,27
071 Rasen-Antholz,67,,10,17,27
071 Rasen-Antholz,68,,16,13,29
071 Rasen-Antholz,69,,13,8,21
071 Rasen-Antholz,70,,9,11,20
071 Rasen-Antholz,71,,9,12,21
071 Rasen-Antholz,72,,10,8,18
071 Rasen-Antholz,73,,11,10,21
071 Rasen-Antholz,74,,10,14,24
071 Rasen-Antholz,75,,11,11,22
071 Rasen-Antholz,76,,11,15,26
071 Rasen-Antholz,77,,4,9,13
071 Rasen-Antholz,78,,9,3,12
071 Rasen-Antholz,79,,2,3,5
071 Rasen-Antholz,80,,4,8,12
071 Rasen-Antholz,81,,5,6,11
071 Rasen-Antholz,82,,7,10,17
071 Rasen-Antholz,83,,4,9,13
071 Rasen-Antholz,84,,-,8,8
071 Rasen-Antholz,85,,2,4,6
071 Rasen-Antholz,86,,5,4,9
071 Rasen-Antholz,87,,1,4,5
071 Rasen-Antholz,88,,1,4,5
071 Rasen-Antholz,89,,-,3,3
071 Rasen-Antholz,90,,1,2,3
071 Rasen-Antholz,91,,-,1,1
071 Rasen-Antholz,92,,2,1,3
071 Rasen-Antholz,93,,1,-,1
071 Rasen-Antholz,95,,1,1,2
071 Rasen-Antholz,96,,-,1,1
071 Rasen-Antholz,97,,-,1,1
071 Rasen-Antholz,98,,-,1,1
071 Rasen-Antholz,102,,-,1,1
072 Ritten,0,,45,50,95
072 Ritten,1,,52,50,102
072 Ritten,2,,41,48,89
072 Ritten,3,,48,48,96
072 Ritten,4,,45,39,84
072 Ritten,5,,33,48,81
072 Ritten,6,,52,46,98
072 Ritten,7,,46,45,91
072 Ritten,8,,50,53,103
072 Ritten,9,,42,44,86
072 Ritten,10,,58,54,112
072 Ritten,11,,40,52,92
072 Ritten,12,,55,44,99
072 Ritten,13,,62,46,108
072 Ritten,14,,58,50,108
072 Ritten,15,,46,69,115
072 Ritten,16,,61,51,112
072 Ritten,17,,58,45,103
072 Ritten,18,,54,41,95
072 Ritten,19,,56,50,106
072 Ritten,20,,49,40,89
072 Ritten,21,,49,46,95
072 Ritten,22,,43,51,94
072 Ritten,23,,47,23,70
072 Ritten,24,,52,44,96
072 Ritten,25,,41,56,97
072 Ritten,26,,47,51,98
072 Ritten,27,,46,41,87
072 Ritten,28,,51,43,94
072 Ritten,29,,46,38,84
072 Ritten,30,,64,41,105
072 Ritten,31,,46,47,93
072 Ritten,32,,60,44,104
072 Ritten,33,,58,62,120
072 Ritten,34,,59,46,105
072 Ritten,35,,53,58,111
072 Ritten,36,,52,63,115
072 Ritten,37,,52,75,127
072 Ritten,38,,48,72,120
072 Ritten,39,,69,62,131
072 Ritten,40,,68,48,116
072 Ritten,41,,61,47,108
072 Ritten,42,,79,42,121
072 Ritten,43,,65,62,127
072 Ritten,44,,61,52,113
072 Ritten,45,,56,61,117
072 Ritten,46,,48,57,105
072 Ritten,47,,65,57,122
072 Ritten,48,,70,52,122
072 Ritten,49,,39,46,85
072 Ritten,50,,41,41,82
072 Ritten,51,,49,44,93
072 Ritten,52,,51,42,93
072 Ritten,53,,37,34,71
072 Ritten,54,,51,31,82
072 Ritten,55,,41,44,85
072 Ritten,56,,42,35,77
072 Ritten,57,,36,45,81
072 Ritten,58,,35,46,81
072 Ritten,59,,48,35,83
072 Ritten,60,,33,29,62
072 Ritten,61,,29,37,66
072 Ritten,62,,20,28,48
072 Ritten,63,,34,39,73
072 Ritten,64,,35,38,73
072 Ritten,65,,44,33,77
072 Ritten,66,,38,38,76
072 Ritten,67,,34,24,58
072 Ritten,68,,37,33,70
072 Ritten,69,,33,32,65
072 Ritten,70,,25,25,50
072 Ritten,71,,21,24,45
072 Ritten,72,,23,28,51
072 Ritten,73,,24,27,51
072 Ritten,74,,16,25,41
072 Ritten,75,,17,21,38
072 Ritten,76,,13,27,40
072 Ritten,77,,11,21,32
072 Ritten,78,,20,20,40
072 Ritten,79,,14,11,25
072 Ritten,80,,13,15,28
072 Ritten,81,,11,15,26
072 Ritten,82,,6,31,37
072 Ritten,83,,11,20,31
072 Ritten,84,,16,25,41
072 Ritten,85,,2,17,19
072 Ritten,86,,6,16,22
072 Ritten,87,,5,14,19
072 Ritten,88,,2,8,10
072 Ritten,89,,-,5,5
072 Ritten,90,,1,4,5
072 Ritten,91,,-,2,2
072 Ritten,92,,3,6,9
072 Ritten,93,,1,2,3
072 Ritten,94,,2,2,4
072 Ritten,95,,1,1,2
072 Ritten,96,,2,1,3
072 Ritten,97,,1,1,2
072 Ritten,98,,1,-,1
073 Riffian,0,,10,9,19
073 Riffian,1,,7,8,15
073 Riffian,2,,9,7,16
073 Riffian,3,,7,3,10
073 Riffian,4,,8,6,14
073 Riffian,5,,8,7,15
073 Riffian,6,,11,8,19
073 Riffian,7,,10,7,17
073 Riffian,8,,10,9,19
073 Riffian,9,,10,7,17
073 Riffian,10,,10,7,17
073 Riffian,11,,6,7,13
073 Riffian,12,,6,10,16
073 Riffian,13,,7,8,15
073 Riffian,14,,6,5,11
073 Riffian,15,,8,10,18
073 Riffian,16,,9,14,23
073 Riffian,17,,6,7,13
073 Riffian,18,,13,4,17
073 Riffian,19,,6,11,17
073 Riffian,20,,4,8,12
073 Riffian,21,,7,6,13
073 Riffian,22,,8,3,11
073 Riffian,23,,8,8,16
073 Riffian,24,,10,10,20
073 Riffian,25,,7,10,17
073 Riffian,26,,6,8,14
073 Riffian,27,,5,7,12
073 Riffian,28,,8,9,17
073 Riffian,29,,13,6,19
073 Riffian,30,,15,16,31
073 Riffian,31,,10,1,11
073 Riffian,32,,9,14,23
073 Riffian,33,,11,8,19
073 Riffian,34,,10,8,18
073 Riffian,35,,11,23,34
073 Riffian,36,,13,15,28
073 Riffian,37,,8,8,16
073 Riffian,38,,13,14,27
073 Riffian,39,,9,13,22
073 Riffian,40,,10,12,22
073 Riffian,41,,14,6,20
073 Riffian,42,,10,5,15
073 Riffian,43,,8,7,15
073 Riffian,44,,17,11,28
073 Riffian,45,,12,11,23
073 Riffian,46,,9,8,17
073 Riffian,47,,14,6,20
073 Riffian,48,,8,14,22
073 Riffian,49,,7,6,13
073 Riffian,50,,6,9,15
073 Riffian,51,,11,5,16
073 Riffian,52,,4,8,12
073 Riffian,53,,11,6,17
073 Riffian,54,,7,5,12
073 Riffian,55,,7,4,11
073 Riffian,56,,6,10,16
073 Riffian,57,,4,4,8
073 Riffian,58,,6,7,13
073 Riffian,59,,6,3,9
073 Riffian,60,,3,4,7
073 Riffian,61,,2,7,9
073 Riffian,62,,6,3,9
073 Riffian,63,,8,9,17
073 Riffian,64,,8,7,15
073 Riffian,65,,14,7,21
073 Riffian,66,,7,3,10
073 Riffian,67,,4,3,7
073 Riffian,68,,4,10,14
073 Riffian,69,,8,4,12
073 Riffian,70,,4,5,9
073 Riffian,71,,3,5,8
073 Riffian,72,,-,3,3
073 Riffian,73,,1,3,4
073 Riffian,74,,4,5,9
073 Riffian,75,,1,4,5
073 Riffian,76,,4,8,12
073 Riffian,77,,4,4,8
073 Riffian,78,,1,7,8
073 Riffian,79,,3,5,8
073 Riffian,80,,3,4,7
073 Riffian,81,,4,3,7
073 Riffian,82,,4,2,6
073 Riffian,83,,3,2,5
073 Riffian,84,,3,6,9
073 Riffian,85,,1,-,1
073 Riffian,86,,1,3,4
073 Riffian,87,,-,2,2
073 Riffian,90,,-,2,2
073 Riffian,92,,-,1,1
073 Riffian,93,,1,1,2
073 Riffian,97,,1,-,1
074 Mühlbach,0,,19,18,37
074 Mühlbach,1,,13,8,21
074 Mühlbach,2,,14,11,25
074 Mühlbach,3,,18,19,37
074 Mühlbach,4,,22,11,33
074 Mühlbach,5,,19,18,37
074 Mühlbach,6,,13,19,32
074 Mühlbach,7,,15,20,35
074 Mühlbach,8,,17,13,30
074 Mühlbach,9,,19,17,36
074 Mühlbach,10,,17,17,34
074 Mühlbach,11,,17,18,35
074 Mühlbach,12,,14,15,29
074 Mühlbach,13,,22,13,35
074 Mühlbach,14,,17,20,37
074 Mühlbach,15,,15,24,39
074 Mühlbach,16,,14,20,34
074 Mühlbach,17,,15,15,30
074 Mühlbach,18,,15,21,36
074 Mühlbach,19,,20,16,36
074 Mühlbach,20,,22,11,33
074 Mühlbach,21,,15,10,25
074 Mühlbach,22,,20,21,41
074 Mühlbach,23,,17,25,42
074 Mühlbach,24,,19,21,40
074 Mühlbach,25,,25,30,55
074 Mühlbach,26,,24,17,41
074 Mühlbach,27,,19,17,36
074 Mühlbach,28,,20,16,36
074 Mühlbach,29,,29,28,57
074 Mühlbach,30,,24,22,46
074 Mühlbach,31,,23,26,49
074 Mühlbach,32,,16,21,37
074 Mühlbach,33,,21,18,39
074 Mühlbach,34,,25,17,42
074 Mühlbach,35,,23,19,42
074 Mühlbach,36,,29,24,53
074 Mühlbach,37,,27,12,39
074 Mühlbach,38,,26,34,60
074 Mühlbach,39,,36,16,52
074 Mühlbach,40,,23,19,42
074 Mühlbach,41,,29,19,48
074 Mühlbach,42,,21,24,45
074 Mühlbach,43,,14,23,37
074 Mühlbach,44,,20,22,42
074 Mühlbach,45,,22,16,38
074 Mühlbach,46,,26,22,48
074 Mühlbach,47,,22,15,37
074 Mühlbach,48,,22,17,39
074 Mühlbach,49,,19,13,32
074 Mühlbach,50,,16,22,38
074 Mühlbach,51,,20,23,43
074 Mühlbach,52,,21,17,38
074 Mühlbach,53,,14,22,36
074 Mühlbach,54,,19,17,36
074 Mühlbach,55,,15,21,36
074 Mühlbach,56,,12,20,32
074 Mühlbach,57,,21,18,39
074 Mühlbach,58,,15,13,28
074 Mühlbach,59,,16,13,29
074 Mühlbach,60,,10,18,28
074 Mühlbach,61,,21,12,33
074 Mühlbach,62,,9,8,17
074 Mühlbach,63,,14,12,26
074 Mühlbach,64,,11,10,21
074 Mühlbach,65,,15,13,28
074 Mühlbach,66,,17,16,33
074 Mühlbach,67,,12,11,23
074 Mühlbach,68,,11,17,28
074 Mühlbach,69,,14,8,22
074 Mühlbach,70,,5,11,16
074 Mühlbach,71,,7,7,14
074 Mühlbach,72,,8,10,18
074 Mühlbach,73,,12,13,25
074 Mühlbach,74,,9,9,18
074 Mühlbach,75,,5,7,12
074 Mühlbach,76,,6,10,16
074 Mühlbach,77,,10,7,17
074 Mühlbach,78,,7,2,9
074 Mühlbach,79,,7,16,23
074 Mühlbach,80,,4,7,11
074 Mühlbach,81,,5,7,12
074 Mühlbach,82,,4,6,10
074 Mühlbach,83,,5,5,10
074 Mühlbach,84,,5,5,10
074 Mühlbach,85,,2,10,12
074 Mühlbach,86,,1,3,4
074 Mühlbach,87,,2,7,9
074 Mühlbach,88,,1,4,5
074 Mühlbach,89,,-,1,1
074 Mühlbach,90,,-,1,1
074 Mühlbach,93,,-,1,1
074 Mühlbach,94,,1,2,3
074 Mühlbach,95,,-,1,1
074 Mühlbach,100,,-,1,1
075 Rodeneck,0,,7,6,13
075 Rodeneck,1,,5,3,8
075 Rodeneck,2,,9,6,15
075 Rodeneck,3,,5,4,9
075 Rodeneck,4,,9,7,16
075 Rodeneck,5,,8,3,11
075 Rodeneck,6,,10,3,13
075 Rodeneck,7,,7,15,22
075 Rodeneck,8,,8,9,17
075 Rodeneck,9,,12,7,19
075 Rodeneck,10,,10,7,17
075 Rodeneck,11,,12,8,20
075 Rodeneck,12,,4,9,13
075 Rodeneck,13,,6,10,16
075 Rodeneck,14,,6,7,13
075 Rodeneck,15,,9,10,19
075 Rodeneck,16,,6,8,14
075 Rodeneck,17,,12,8,20
075 Rodeneck,18,,7,5,12
075 Rodeneck,19,,12,8,20
075 Rodeneck,20,,6,5,11
075 Rodeneck,21,,9,12,21
075 Rodeneck,22,,13,8,21
075 Rodeneck,23,,16,10,26
075 Rodeneck,24,,10,8,18
075 Rodeneck,25,,6,5,11
075 Rodeneck,26,,11,5,16
075 Rodeneck,27,,7,12,19
075 Rodeneck,28,,9,3,12
075 Rodeneck,29,,6,9,15
075 Rodeneck,30,,6,7,13
075 Rodeneck,31,,7,8,15
075 Rodeneck,32,,8,8,16
075 Rodeneck,33,,7,5,12
075 Rodeneck,34,,14,9,23
075 Rodeneck,35,,9,8,17
075 Rodeneck,36,,15,5,20
075 Rodeneck,37,,10,11,21
075 Rodeneck,38,,16,11,27
075 Rodeneck,39,,8,11,19
075 Rodeneck,40,,12,10,22
075 Rodeneck,41,,14,8,22
075 Rodeneck,42,,8,9,17
075 Rodeneck,43,,11,12,23
075 Rodeneck,44,,9,8,17
075 Rodeneck,45,,8,11,19
075 Rodeneck,46,,9,12,21
075 Rodeneck,47,,6,10,16
075 Rodeneck,48,,10,6,16
075 Rodeneck,49,,8,5,13
075 Rodeneck,50,,6,7,13
075 Rodeneck,51,,8,4,12
075 Rodeneck,52,,7,6,13
075 Rodeneck,53,,12,3,15
075 Rodeneck,54,,3,1,4
075 Rodeneck,55,,7,4,11
075 Rodeneck,56,,3,2,5
075 Rodeneck,57,,1,7,8
075 Rodeneck,58,,2,5,7
075 Rodeneck,59,,4,7,11
075 Rodeneck,60,,5,4,9
075 Rodeneck,61,,10,7,17
075 Rodeneck,62,,-,5,5
075 Rodeneck,63,,5,5,10
075 Rodeneck,64,,2,2,4
075 Rodeneck,65,,2,6,8
075 Rodeneck,66,,10,3,13
075 Rodeneck,67,,5,4,9
075 Rodeneck,68,,3,9,12
075 Rodeneck,69,,3,3,6
075 Rodeneck,70,,2,4,6
075 Rodeneck,71,,3,4,7
075 Rodeneck,72,,4,2,6
075 Rodeneck,73,,1,10,11
075 Rodeneck,74,,3,-,3
075 Rodeneck,75,,6,5,11
075 Rodeneck,76,,4,2,6
075 Rodeneck,77,,4,5,9
075 Rodeneck,78,,7,2,9
075 Rodeneck,79,,4,4,8
075 Rodeneck,80,,1,5,6
075 Rodeneck,81,,2,4,6
075 Rodeneck,82,,2,5,7
075 Rodeneck,83,,3,4,7
075 Rodeneck,84,,2,1,3
075 Rodeneck,85,,-,1,1
075 Rodeneck,86,,2,-,2
075 Rodeneck,87,,2,-,2
075 Rodeneck,88,,2,-,2
075 Rodeneck,89,,-,2,2
076 Salurn,0,,19,26,45
076 Salurn,1,,23,20,43
076 Salurn,2,,16,27,43
076 Salurn,3,,21,15,36
076 Salurn,4,,27,20,47
076 Salurn,5,,19,15,34
076 Salurn,6,,12,18,30
076 Salurn,7,,22,16,38
076 Salurn,8,,21,12,33
076 Salurn,9,,19,25,44
076 Salurn,10,,15,12,27
076 Salurn,11,,24,23,47
076 Salurn,12,,19,15,34
076 Salurn,13,,22,21,43
076 Salurn,14,,18,18,36
076 Salurn,15,,23,19,42
076 Salurn,16,,14,20,34
076 Salurn,17,,15,17,32
076 Salurn,18,,20,18,38
076 Salurn,19,,22,22,44
076 Salurn,20,,23,17,40
076 Salurn,21,,17,18,35
076 Salurn,22,,17,20,37
076 Salurn,23,,10,21,31
076 Salurn,24,,14,23,37
076 Salurn,25,,21,21,42
076 Salurn,26,,17,25,42
076 Salurn,27,,19,26,45
076 Salurn,28,,14,26,40
076 Salurn,29,,17,19,36
076 Salurn,30,,29,22,51
076 Salurn,31,,24,24,48
076 Salurn,32,,23,27,50
076 Salurn,33,,23,19,42
076 Salurn,34,,22,34,56
076 Salurn,35,,27,26,53
076 Salurn,36,,41,28,69
076 Salurn,37,,28,26,54
076 Salurn,38,,30,27,57
076 Salurn,39,,32,25,57
076 Salurn,40,,26,24,50
076 Salurn,41,,28,25,53
076 Salurn,42,,30,32,62
076 Salurn,43,,31,28,59
076 Salurn,44,,39,25,64
076 Salurn,45,,32,29,61
076 Salurn,46,,29,31,60
076 Salurn,47,,21,31,52
076 Salurn,48,,31,29,60
076 Salurn,49,,28,17,45
076 Salurn,50,,20,23,43
076 Salurn,51,,18,11,29
076 Salurn,52,,19,19,38
076 Salurn,53,,21,17,38
076 Salurn,54,,16,18,34
076 Salurn,55,,28,19,47
076 Salurn,56,,28,20,48
076 Salurn,57,,23,17,40
076 Salurn,58,,27,11,38
076 Salurn,59,,14,21,35
076 Salurn,60,,16,20,36
076 Salurn,61,,23,18,41
076 Salurn,62,,14,10,24
076 Salurn,63,,20,18,38
076 Salurn,64,,19,17,36
076 Salurn,65,,19,16,35
076 Salurn,66,,19,16,35
076 Salurn,67,,14,10,24
076 Salurn,68,,11,9,20
076 Salurn,69,,6,10,16
076 Salurn,70,,13,12,25
076 Salurn,71,,13,20,33
076 Salurn,72,,13,17,30
076 Salurn,73,,10,7,17
076 Salurn,74,,11,7,18
076 Salurn,75,,9,17,26
076 Salurn,76,,6,11,17
076 Salurn,77,,11,11,22
076 Salurn,78,,14,11,25
076 Salurn,79,,8,18,26
076 Salurn,80,,3,16,19
076 Salurn,81,,6,13,19
076 Salurn,82,,6,18,24
076 Salurn,83,,3,14,17
076 Salurn,84,,3,7,10
076 Salurn,85,,4,13,17
076 Salurn,86,,1,11,12
076 Salurn,87,,8,10,18
076 Salurn,88,,5,9,14
076 Salurn,89,,3,3,6
076 Salurn,90,,-,2,2
076 Salurn,91,,1,2,3
076 Salurn,92,,1,2,3
076 Salurn,93,,1,2,3
076 Salurn,94,,-,1,1
076 Salurn,95,,1,1,2
076 Salurn,96,,-,2,2
076 Salurn,97,,-,1,1
076 Salurn,98,,-,1,1
076 Salurn,99,,-,1,1
077 Innichen,0,,14,16,30
077 Innichen,1,,13,14,27
077 Innichen,2,,11,19,30
077 Innichen,3,,12,13,25
077 Innichen,4,,18,16,34
077 Innichen,5,,15,15,30
077 Innichen,6,,24,18,42
077 Innichen,7,,16,16,32
077 Innichen,8,,11,16,27
077 Innichen,9,,20,14,34
077 Innichen,10,,20,16,36
077 Innichen,11,,15,18,33
077 Innichen,12,,23,12,35
077 Innichen,13,,18,16,34
077 Innichen,14,,23,21,44
077 Innichen,15,,22,16,38
077 Innichen,16,,20,25,45
077 Innichen,17,,17,14,31
077 Innichen,18,,18,21,39
077 Innichen,19,,30,19,49
077 Innichen,20,,22,19,41
077 Innichen,21,,20,18,38
077 Innichen,22,,21,21,42
077 Innichen,23,,22,18,40
077 Innichen,24,,21,16,37
077 Innichen,25,,21,22,43
077 Innichen,26,,16,20,36
077 Innichen,27,,24,16,40
077 Innichen,28,,25,23,48
077 Innichen,29,,11,17,28
077 Innichen,30,,17,19,36
077 Innichen,31,,15,28,43
077 Innichen,32,,20,13,33
077 Innichen,33,,26,17,43
077 Innichen,34,,23,19,42
077 Innichen,35,,22,22,44
077 Innichen,36,,22,16,38
077 Innichen,37,,23,31,54
077 Innichen,38,,23,28,51
077 Innichen,39,,24,26,50
077 Innichen,40,,26,27,53
077 Innichen,41,,25,33,58
077 Innichen,42,,37,31,68
077 Innichen,43,,29,30,59
077 Innichen,44,,27,26,53
077 Innichen,45,,29,26,55
077 Innichen,46,,25,27,52
077 Innichen,47,,30,19,49
077 Innichen,48,,26,23,49
077 Innichen,49,,21,26,47
077 Innichen,50,,18,26,44
077 Innichen,51,,27,14,41
077 Innichen,52,,26,20,46
077 Innichen,53,,23,10,33
077 Innichen,54,,24,17,41
077 Innichen,55,,11,26,37
077 Innichen,56,,12,18,30
077 Innichen,57,,18,22,40
077 Innichen,58,,21,17,38
077 Innichen,59,,18,11,29
077 Innichen,60,,10,14,24
077 Innichen,61,,15,15,30
077 Innichen,62,,10,7,17
077 Innichen,63,,8,12,20
077 Innichen,64,,23,9,32
077 Innichen,65,,17,18,35
077 Innichen,66,,15,20,35
077 Innichen,67,,7,24,31
077 Innichen,68,,13,12,25
077 Innichen,69,,7,11,18
077 Innichen,70,,12,10,22
077 Innichen,71,,8,19,27
077 Innichen,72,,6,19,25
077 Innichen,73,,11,12,23
077 Innichen,74,,11,9,20
077 Innichen,75,,10,18,28
077 Innichen,76,,12,20,32
077 Innichen,77,,13,11,24
077 Innichen,78,,11,15,26
077 Innichen,79,,11,16,27
077 Innichen,80,,4,10,14
077 Innichen,81,,13,13,26
077 Innichen,82,,3,18,21
077 Innichen,83,,7,3,10
077 Innichen,84,,3,11,14
077 Innichen,85,,1,11,12
077 Innichen,86,,3,10,13
077 Innichen,87,,3,11,14
077 Innichen,88,,1,3,4
077 Innichen,89,,-,3,3
077 Innichen,90,,1,3,4
077 Innichen,91,,1,2,3
077 Innichen,92,,-,2,2
077 Innichen,93,,1,-,1
077 Innichen,94,,1,1,2
077 Innichen,95,,1,1,2
077 Innichen,98,,1,1,2
077 Innichen,105,,-,1,1
079 Jenesien,0,,21,18,39
079 Jenesien,1,,21,22,43
079 Jenesien,2,,15,16,31
079 Jenesien,3,,19,20,39
079 Jenesien,4,,16,23,39
079 Jenesien,5,,12,17,29
079 Jenesien,6,,18,22,40
079 Jenesien,7,,17,19,36
079 Jenesien,8,,25,23,48
079 Jenesien,9,,17,28,45
079 Jenesien,10,,21,19,40
079 Jenesien,11,,24,11,35
079 Jenesien,12,,25,17,42
079 Jenesien,13,,21,21,42
079 Jenesien,14,,15,19,34
079 Jenesien,15,,29,23,52
079 Jenesien,16,,19,22,41
079 Jenesien,17,,18,15,33
079 Jenesien,18,,18,13,31
079 Jenesien,19,,22,16,38
079 Jenesien,20,,15,22,37
079 Jenesien,21,,17,16,33
079 Jenesien,22,,16,6,22
079 Jenesien,23,,18,16,34
079 Jenesien,24,,18,18,36
079 Jenesien,25,,14,19,33
079 Jenesien,26,,11,18,29
079 Jenesien,27,,17,20,37
079 Jenesien,28,,21,16,37
079 Jenesien,29,,16,15,31
079 Jenesien,30,,19,16,35
079 Jenesien,31,,15,17,32
079 Jenesien,32,,10,20,30
079 Jenesien,33,,23,23,46
079 Jenesien,34,,19,30,49
079 Jenesien,35,,25,27,52
079 Jenesien,36,,29,26,55
079 Jenesien,37,,32,32,64
079 Jenesien,38,,32,20,52
079 Jenesien,39,,19,27,46
079 Jenesien,40,,16,25,41
079 Jenesien,41,,36,30,66
079 Jenesien,42,,37,30,67
079 Jenesien,43,,35,32,67
079 Jenesien,44,,26,24,50
079 Jenesien,45,,27,21,48
079 Jenesien,46,,30,21,51
079 Jenesien,47,,26,12,38
079 Jenesien,48,,24,17,41
079 Jenesien,49,,23,10,33
079 Jenesien,50,,13,17,30
079 Jenesien,51,,15,12,27
079 Jenesien,52,,10,12,22
079 Jenesien,53,,20,13,33
079 Jenesien,54,,13,10,23
079 Jenesien,55,,13,21,34
079 Jenesien,56,,13,9,22
079 Jenesien,57,,12,20,32
079 Jenesien,58,,11,14,25
079 Jenesien,59,,11,7,18
079 Jenesien,60,,14,11,25
079 Jenesien,61,,9,10,19
079 Jenesien,62,,8,14,22
079 Jenesien,63,,13,12,25
079 Jenesien,64,,17,8,25
079 Jenesien,65,,15,11,26
079 Jenesien,66,,13,21,34
079 Jenesien,67,,16,11,27
079 Jenesien,68,,14,18,32
079 Jenesien,69,,17,8,25
079 Jenesien,70,,10,16,26
079 Jenesien,71,,5,18,23
079 Jenesien,72,,6,7,13
079 Jenesien,73,,8,7,15
079 Jenesien,74,,17,11,28
079 Jenesien,75,,6,9,15
079 Jenesien,76,,9,9,18
079 Jenesien,77,,6,13,19
079 Jenesien,78,,4,16,20
079 Jenesien,79,,7,9,16
079 Jenesien,80,,6,10,16
079 Jenesien,81,,8,13,21
079 Jenesien,82,,3,9,12
079 Jenesien,83,,6,7,13
079 Jenesien,84,,4,5,9
079 Jenesien,85,,4,7,11
079 Jenesien,86,,1,3,4
079 Jenesien,87,,3,4,7
079 Jenesien,88,,-,2,2
079 Jenesien,89,,-,1,1
079 Jenesien,91,,1,1,2
079 Jenesien,92,,-,1,1
079 Jenesien,93,,1,-,1
079 Jenesien,94,,-,2,2
079 Jenesien,95,,1,1,2
079 Jenesien,96,,-,1,1
079 Jenesien,97,,-,1,1
079 Jenesien,99,,-,1,1
080 St.Leonhard in Pass.,0,,20,20,40
080 St.Leonhard in Pass.,1,,19,23,42
080 St.Leonhard in Pass.,2,,25,21,46
080 St.Leonhard in Pass.,3,,16,20,36
080 St.Leonhard in Pass.,4,,23,14,37
080 St.Leonhard in Pass.,5,,21,19,40
080 St.Leonhard in Pass.,6,,25,13,38
080 St.Leonhard in Pass.,7,,22,17,39
080 St.Leonhard in Pass.,8,,20,22,42
080 St.Leonhard in Pass.,9,,23,20,43
080 St.Leonhard in Pass.,10,,24,20,44
080 St.Leonhard in Pass.,11,,23,20,43
080 St.Leonhard in Pass.,12,,22,13,35
080 St.Leonhard in Pass.,13,,21,19,40
080 St.Leonhard in Pass.,14,,24,23,47
080 St.Leonhard in Pass.,15,,22,19,41
080 St.Leonhard in Pass.,16,,21,19,40
080 St.Leonhard in Pass.,17,,24,20,44
080 St.Leonhard in Pass.,18,,35,30,65
080 St.Leonhard in Pass.,19,,21,29,50
080 St.Leonhard in Pass.,20,,30,23,53
080 St.Leonhard in Pass.,21,,36,31,67
080 St.Leonhard in Pass.,22,,23,26,49
080 St.Leonhard in Pass.,23,,29,20,49
080 St.Leonhard in Pass.,24,,29,24,53
080 St.Leonhard in Pass.,25,,29,22,51
080 St.Leonhard in Pass.,26,,25,31,56
080 St.Leonhard in Pass.,27,,25,32,57
080 St.Leonhard in Pass.,28,,26,21,47
080 St.Leonhard in Pass.,29,,30,28,58
080 St.Leonhard in Pass.,30,,31,24,55
080 St.Leonhard in Pass.,31,,19,22,41
080 St.Leonhard in Pass.,32,,28,10,38
080 St.Leonhard in Pass.,33,,35,25,60
080 St.Leonhard in Pass.,34,,31,24,55
080 St.Leonhard in Pass.,35,,27,26,53
080 St.Leonhard in Pass.,36,,32,20,52
080 St.Leonhard in Pass.,37,,24,27,51
080 St.Leonhard in Pass.,38,,25,26,51
080 St.Leonhard in Pass.,39,,33,22,55
080 St.Leonhard in Pass.,40,,29,27,56
080 St.Leonhard in Pass.,41,,33,31,64
080 St.Leonhard in Pass.,42,,31,31,62
080 St.Leonhard in Pass.,43,,26,30,56
080 St.Leonhard in Pass.,44,,21,22,43
080 St.Leonhard in Pass.,45,,23,29,52
080 St.Leonhard in Pass.,46,,30,23,53
080 St.Leonhard in Pass.,47,,33,19,52
080 St.Leonhard in Pass.,48,,27,27,54
080 St.Leonhard in Pass.,49,,24,19,43
080 St.Leonhard in Pass.,50,,22,27,49
080 St.Leonhard in Pass.,51,,24,17,41
080 St.Leonhard in Pass.,52,,24,17,41
080 St.Leonhard in Pass.,53,,19,14,33
080 St.Leonhard in Pass.,54,,28,25,53
080 St.Leonhard in Pass.,55,,20,25,45
080 St.Leonhard in Pass.,56,,24,16,40
080 St.Leonhard in Pass.,57,,17,14,31
080 St.Leonhard in Pass.,58,,22,11,33
080 St.Leonhard in Pass.,59,,23,12,35
080 St.Leonhard in Pass.,60,,17,16,33
080 St.Leonhard in Pass.,61,,15,18,33
080 St.Leonhard in Pass.,62,,10,11,21
080 St.Leonhard in Pass.,63,,14,14,28
080 St.Leonhard in Pass.,64,,9,23,32
080 St.Leonhard in Pass.,65,,8,14,22
080 St.Leonhard in Pass.,66,,14,15,29
080 St.Leonhard in Pass.,67,,18,13,31
080 St.Leonhard in Pass.,68,,19,18,37
080 St.Leonhard in Pass.,69,,12,13,25
080 St.Leonhard in Pass.,70,,17,7,24
080 St.Leonhard in Pass.,71,,18,11,29
080 St.Leonhard in Pass.,72,,11,12,23
080 St.Leonhard in Pass.,73,,9,15,24
080 St.Leonhard in Pass.,74,,10,14,24
080 St.Leonhard in Pass.,75,,8,12,20
080 St.Leonhard in Pass.,76,,7,14,21
080 St.Leonhard in Pass.,77,,7,11,18
080 St.Leonhard in Pass.,78,,8,8,16
080 St.Leonhard in Pass.,79,,5,13,18
080 St.Leonhard in Pass.,80,,5,12,17
080 St.Leonhard in Pass.,81,,7,8,15
080 St.Leonhard in Pass.,82,,6,9,15
080 St.Leonhard in Pass.,83,,5,7,12
080 St.Leonhard in Pass.,84,,7,8,15
080 St.Leonhard in Pass.,85,,3,7,10
080 St.Leonhard in Pass.,86,,1,4,5
080 St.Leonhard in Pass.,87,,2,6,8
080 St.Leonhard in Pass.,88,,-,2,2
080 St.Leonhard in Pass.,89,,-,1,1
080 St.Leonhard in Pass.,90,,-,2,2
080 St.Leonhard in Pass.,92,,1,2,3
080 St.Leonhard in Pass.,93,,-,3,3
080 St.Leonhard in Pass.,94,,-,1,1
080 St.Leonhard in Pass.,95,,-,3,3
080 St.Leonhard in Pass.,99,,1,-,1
080 St.Leonhard in Pass.,100,,-,1,1
081 St.Lorenzen,0,,23,20,43
081 St.Lorenzen,1,,13,19,32
081 St.Lorenzen,2,,23,19,42
081 St.Lorenzen,3,,26,23,49
081 St.Lorenzen,4,,24,19,43
081 St.Lorenzen,5,,20,20,40
081 St.Lorenzen,6,,28,21,49
081 St.Lorenzen,7,,20,29,49
081 St.Lorenzen,8,,28,25,53
081 St.Lorenzen,9,,29,27,56
081 St.Lorenzen,10,,15,30,45
081 St.Lorenzen,11,,31,29,60
081 St.Lorenzen,12,,23,14,37
081 St.Lorenzen,13,,30,19,49
081 St.Lorenzen,14,,25,31,56
081 St.Lorenzen,15,,27,21,48
081 St.Lorenzen,16,,20,14,34
081 St.Lorenzen,17,,25,20,45
081 St.Lorenzen,18,,19,18,37
081 St.Lorenzen,19,,18,26,44
081 St.Lorenzen,20,,23,21,44
081 St.Lorenzen,21,,26,19,45
081 St.Lorenzen,22,,25,21,46
081 St.Lorenzen,23,,29,25,54
081 St.Lorenzen,24,,21,17,38
081 St.Lorenzen,25,,32,26,58
081 St.Lorenzen,26,,24,20,44
081 St.Lorenzen,27,,18,22,40
081 St.Lorenzen,28,,28,27,55
081 St.Lorenzen,29,,29,19,48
081 St.Lorenzen,30,,24,23,47
081 St.Lorenzen,31,,23,14,37
081 St.Lorenzen,32,,20,31,51
081 St.Lorenzen,33,,25,32,57
081 St.Lorenzen,34,,34,32,66
081 St.Lorenzen,35,,36,35,71
081 St.Lorenzen,36,,34,27,61
081 St.Lorenzen,37,,28,28,56
081 St.Lorenzen,38,,26,30,56
081 St.Lorenzen,39,,41,38,79
081 St.Lorenzen,40,,34,39,73
081 St.Lorenzen,41,,35,30,65
081 St.Lorenzen,42,,36,25,61
081 St.Lorenzen,43,,31,24,55
081 St.Lorenzen,44,,34,31,65
081 St.Lorenzen,45,,29,37,66
081 St.Lorenzen,46,,24,37,61
081 St.Lorenzen,47,,31,19,50
081 St.Lorenzen,48,,34,27,61
081 St.Lorenzen,49,,31,31,62
081 St.Lorenzen,50,,23,25,48
081 St.Lorenzen,51,,27,29,56
081 St.Lorenzen,52,,16,16,32
081 St.Lorenzen,53,,17,19,36
081 St.Lorenzen,54,,24,17,41
081 St.Lorenzen,55,,17,10,27
081 St.Lorenzen,56,,17,16,33
081 St.Lorenzen,57,,16,19,35
081 St.Lorenzen,58,,12,21,33
081 St.Lorenzen,59,,14,15,29
081 St.Lorenzen,60,,19,8,27
081 St.Lorenzen,61,,19,12,31
081 St.Lorenzen,62,,13,18,31
081 St.Lorenzen,63,,17,15,32
081 St.Lorenzen,64,,15,17,32
081 St.Lorenzen,65,,17,20,37
081 St.Lorenzen,66,,18,17,35
081 St.Lorenzen,67,,15,13,28
081 St.Lorenzen,68,,14,17,31
081 St.Lorenzen,69,,14,13,27
081 St.Lorenzen,70,,18,15,33
081 St.Lorenzen,71,,13,16,29
081 St.Lorenzen,72,,9,14,23
081 St.Lorenzen,73,,15,11,26
081 St.Lorenzen,74,,11,10,21
081 St.Lorenzen,75,,10,10,20
081 St.Lorenzen,76,,9,15,24
081 St.Lorenzen,77,,8,8,16
081 St.Lorenzen,78,,10,16,26
081 St.Lorenzen,79,,8,16,24
081 St.Lorenzen,80,,6,8,14
081 St.Lorenzen,81,,7,10,17
081 St.Lorenzen,82,,4,11,15
081 St.Lorenzen,83,,2,9,11
081 St.Lorenzen,84,,6,12,18
081 St.Lorenzen,85,,2,4,6
081 St.Lorenzen,86,,2,5,7
081 St.Lorenzen,87,,1,5,6
081 St.Lorenzen,88,,2,5,7
081 St.Lorenzen,89,,-,2,2
081 St.Lorenzen,90,,-,1,1
081 St.Lorenzen,91,,1,-,1
081 St.Lorenzen,93,,3,1,4
081 St.Lorenzen,94,,-,1,1
081 St.Lorenzen,95,,1,-,1
081 St.Lorenzen,97,,-,1,1
082 St.Martin in Thurn,0,,2,11,13
082 St.Martin in Thurn,1,,9,15,24
082 St.Martin in Thurn,2,,12,9,21
082 St.Martin in Thurn,3,,18,12,30
082 St.Martin in Thurn,4,,4,6,10
082 St.Martin in Thurn,5,,15,8,23
082 St.Martin in Thurn,6,,9,14,23
082 St.Martin in Thurn,7,,7,9,16
082 St.Martin in Thurn,8,,7,19,26
082 St.Martin in Thurn,9,,11,12,23
082 St.Martin in Thurn,10,,16,11,27
082 St.Martin in Thurn,11,,24,14,38
082 St.Martin in Thurn,12,,15,11,26
082 St.Martin in Thurn,13,,15,9,24
082 St.Martin in Thurn,14,,9,9,18
082 St.Martin in Thurn,15,,18,14,32
082 St.Martin in Thurn,16,,11,11,22
082 St.Martin in Thurn,17,,6,17,23
082 St.Martin in Thurn,18,,15,14,29
082 St.Martin in Thurn,19,,7,6,13
082 St.Martin in Thurn,20,,14,12,26
082 St.Martin in Thurn,21,,13,10,23
082 St.Martin in Thurn,22,,11,15,26
082 St.Martin in Thurn,23,,8,5,13
082 St.Martin in Thurn,24,,15,10,25
082 St.Martin in Thurn,25,,15,14,29
082 St.Martin in Thurn,26,,15,7,22
082 St.Martin in Thurn,27,,10,11,21
082 St.Martin in Thurn,28,,10,10,20
082 St.Martin in Thurn,29,,17,11,28
082 St.Martin in Thurn,30,,13,10,23
082 St.Martin in Thurn,31,,12,10,22
082 St.Martin in Thurn,32,,7,9,16
082 St.Martin in Thurn,33,,6,11,17
082 St.Martin in Thurn,34,,11,11,22
082 St.Martin in Thurn,35,,13,10,23
082 St.Martin in Thurn,36,,16,14,30
082 St.Martin in Thurn,37,,13,12,25
082 St.Martin in Thurn,38,,16,15,31
082 St.Martin in Thurn,39,,17,14,31
082 St.Martin in Thurn,40,,10,10,20
082 St.Martin in Thurn,41,,16,26,42
082 St.Martin in Thurn,42,,18,20,38
082 St.Martin in Thurn,43,,11,16,27
082 St.Martin in Thurn,44,,15,14,29
082 St.Martin in Thurn,45,,16,14,30
082 St.Martin in Thurn,46,,14,19,33
082 St.Martin in Thurn,47,,15,5,20
082 St.Martin in Thurn,48,,12,10,22
082 St.Martin in Thurn,49,,12,8,20
082 St.Martin in Thurn,50,,12,9,21
082 St.Martin in Thurn,51,,8,6,14
082 St.Martin in Thurn,52,,13,9,22
082 St.Martin in Thurn,53,,8,8,16
082 St.Martin in Thurn,54,,5,11,16
082 St.Martin in Thurn,55,,3,4,7
082 St.Martin in Thurn,56,,8,9,17
082 St.Martin in Thurn,57,,10,6,16
082 St.Martin in Thurn,58,,3,7,10
082 St.Martin in Thurn,59,,8,6,14
082 St.Martin in Thurn,60,,9,6,15
082 St.Martin in Thurn,61,,8,7,15
082 St.Martin in Thurn,62,,6,4,10
082 St.Martin in Thurn,63,,11,8,19
082 St.Martin in Thurn,64,,4,8,12
082 St.Martin in Thurn,65,,7,6,13
082 St.Martin in Thurn,66,,7,6,13
082 St.Martin in Thurn,67,,5,5,10
082 St.Martin in Thurn,68,,5,7,12
082 St.Martin in Thurn,69,,8,8,16
082 St.Martin in Thurn,70,,7,13,20
082 St.Martin in Thurn,71,,4,7,11
082 St.Martin in Thurn,72,,6,5,11
082 St.Martin in Thurn,73,,6,4,10
082 St.Martin in Thurn,74,,3,9,12
082 St.Martin in Thurn,75,,8,7,15
082 St.Martin in Thurn,76,,8,8,16
082 St.Martin in Thurn,77,,5,6,11
082 St.Martin in Thurn,78,,7,7,14
082 St.Martin in Thurn,79,,2,3,5
082 St.Martin in Thurn,80,,4,5,9
082 St.Martin in Thurn,81,,7,3,10
082 St.Martin in Thurn,82,,6,4,10
082 St.Martin in Thurn,83,,7,9,16
082 St.Martin in Thurn,84,,3,7,10
082 St.Martin in Thurn,85,,7,5,12
082 St.Martin in Thurn,86,,5,2,7
082 St.Martin in Thurn,87,,5,7,12
082 St.Martin in Thurn,88,,2,4,6
082 St.Martin in Thurn,89,,1,-,1
082 St.Martin in Thurn,90,,-,1,1
082 St.Martin in Thurn,91,,1,1,2
082 St.Martin in Thurn,93,,-,1,1
082 St.Martin in Thurn,94,,-,1,1
082 St.Martin in Thurn,95,,1,-,1
082 St.Martin in Thurn,96,,1,-,1
083 St.Martin in Passeier,0,,17,23,40
083 St.Martin in Passeier,1,,27,23,50
083 St.Martin in Passeier,2,,21,19,40
083 St.Martin in Passeier,3,,22,19,41
083 St.Martin in Passeier,4,,20,17,37
083 St.Martin in Passeier,5,,19,12,31
083 St.Martin in Passeier,6,,20,17,37
083 St.Martin in Passeier,7,,13,22,35
083 St.Martin in Passeier,8,,10,21,31
083 St.Martin in Passeier,9,,18,19,37
083 St.Martin in Passeier,10,,27,23,50
083 St.Martin in Passeier,11,,22,20,42
083 St.Martin in Passeier,12,,19,18,37
083 St.Martin in Passeier,13,,21,24,45
083 St.Martin in Passeier,14,,19,23,42
083 St.Martin in Passeier,15,,22,20,42
083 St.Martin in Passeier,16,,22,23,45
083 St.Martin in Passeier,17,,19,26,45
083 St.Martin in Passeier,18,,19,21,40
083 St.Martin in Passeier,19,,16,16,32
083 St.Martin in Passeier,20,,19,25,44
083 St.Martin in Passeier,21,,20,25,45
083 St.Martin in Passeier,22,,17,21,38
083 St.Martin in Passeier,23,,18,30,48
083 St.Martin in Passeier,24,,20,10,30
083 St.Martin in Passeier,25,,24,21,45
083 St.Martin in Passeier,26,,24,24,48
083 St.Martin in Passeier,27,,20,22,42
083 St.Martin in Passeier,28,,19,11,30
083 St.Martin in Passeier,29,,32,16,48
083 St.Martin in Passeier,30,,22,23,45
083 St.Martin in Passeier,31,,21,23,44
083 St.Martin in Passeier,32,,23,22,45
083 St.Martin in Passeier,33,,20,18,38
083 St.Martin in Passeier,34,,27,30,57
083 St.Martin in Passeier,35,,20,25,45
083 St.Martin in Passeier,36,,29,25,54
083 St.Martin in Passeier,37,,32,25,57
083 St.Martin in Passeier,38,,31,24,55
083 St.Martin in Passeier,39,,26,25,51
083 St.Martin in Passeier,40,,22,26,48
083 St.Martin in Passeier,41,,28,33,61
083 St.Martin in Passeier,42,,32,23,55
083 St.Martin in Passeier,43,,17,18,35
083 St.Martin in Passeier,44,,35,20,55
083 St.Martin in Passeier,45,,22,30,52
083 St.Martin in Passeier,46,,35,22,57
083 St.Martin in Passeier,47,,23,23,46
083 St.Martin in Passeier,48,,25,23,48
083 St.Martin in Passeier,49,,25,20,45
083 St.Martin in Passeier,50,,25,13,38
083 St.Martin in Passeier,51,,22,17,39
083 St.Martin in Passeier,52,,30,13,43
083 St.Martin in Passeier,53,,15,10,25
083 St.Martin in Passeier,54,,22,16,38
083 St.Martin in Passeier,55,,6,18,24
083 St.Martin in Passeier,56,,21,14,35
083 St.Martin in Passeier,57,,11,15,26
083 St.Martin in Passeier,58,,14,10,24
083 St.Martin in Passeier,59,,13,10,23
083 St.Martin in Passeier,60,,15,13,28
083 St.Martin in Passeier,61,,12,10,22
083 St.Martin in Passeier,62,,13,12,25
083 St.Martin in Passeier,63,,18,12,30
083 St.Martin in Passeier,64,,12,12,24
083 St.Martin in Passeier,65,,15,14,29
083 St.Martin in Passeier,66,,11,15,26
083 St.Martin in Passeier,67,,4,12,16
083 St.Martin in Passeier,68,,6,14,20
083 St.Martin in Passeier,69,,12,8,20
083 St.Martin in Passeier,70,,15,20,35
083 St.Martin in Passeier,71,,13,14,27
083 St.Martin in Passeier,72,,7,14,21
083 St.Martin in Passeier,73,,15,8,23
083 St.Martin in Passeier,74,,13,9,22
083 St.Martin in Passeier,75,,6,9,15
083 St.Martin in Passeier,76,,4,12,16
083 St.Martin in Passeier,77,,4,12,16
083 St.Martin in Passeier,78,,11,9,20
083 St.Martin in Passeier,79,,6,7,13
083 St.Martin in Passeier,80,,10,6,16
083 St.Martin in Passeier,81,,3,10,13
083 St.Martin in Passeier,82,,5,6,11
083 St.Martin in Passeier,83,,2,10,12
083 St.Martin in Passeier,84,,1,6,7
083 St.Martin in Passeier,85,,2,5,7
083 St.Martin in Passeier,86,,1,10,11
083 St.Martin in Passeier,87,,1,4,5
083 St.Martin in Passeier,88,,1,2,3
083 St.Martin in Passeier,89,,-,2,2
083 St.Martin in Passeier,90,,-,3,3
083 St.Martin in Passeier,91,,-,1,1
083 St.Martin in Passeier,92,,1,1,2
083 St.Martin in Passeier,93,,-,2,2
083 St.Martin in Passeier,96,,1,-,1
084 St.Pankraz,0,,7,11,18
084 St.Pankraz,1,,9,14,23
084 St.Pankraz,2,,13,8,21
084 St.Pankraz,3,,13,7,20
084 St.Pankraz,4,,13,7,20
084 St.Pankraz,5,,7,3,10
084 St.Pankraz,6,,13,14,27
084 St.Pankraz,7,,11,14,25
084 St.Pankraz,8,,9,4,13
084 St.Pankraz,9,,14,5,19
084 St.Pankraz,10,,8,11,19
084 St.Pankraz,11,,9,8,17
084 St.Pankraz,12,,8,5,13
084 St.Pankraz,13,,8,8,16
084 St.Pankraz,14,,5,11,16
084 St.Pankraz,15,,7,8,15
084 St.Pankraz,16,,11,12,23
084 St.Pankraz,17,,9,4,13
084 St.Pankraz,18,,11,16,27
084 St.Pankraz,19,,14,8,22
084 St.Pankraz,20,,10,6,16
084 St.Pankraz,21,,9,5,14
084 St.Pankraz,22,,10,7,17
084 St.Pankraz,23,,10,3,13
084 St.Pankraz,24,,11,7,18
084 St.Pankraz,25,,11,7,18
084 St.Pankraz,26,,8,12,20
084 St.Pankraz,27,,16,10,26
084 St.Pankraz,28,,3,5,8
084 St.Pankraz,29,,13,9,22
084 St.Pankraz,30,,8,9,17
084 St.Pankraz,31,,5,11,16
084 St.Pankraz,32,,9,11,20
084 St.Pankraz,33,,12,13,25
084 St.Pankraz,34,,11,7,18
084 St.Pankraz,35,,11,19,30
084 St.Pankraz,36,,16,11,27
084 St.Pankraz,37,,13,12,25
084 St.Pankraz,38,,17,10,27
084 St.Pankraz,39,,18,14,32
084 St.Pankraz,40,,10,14,24
084 St.Pankraz,41,,14,7,21
084 St.Pankraz,42,,21,15,36
084 St.Pankraz,43,,14,14,28
084 St.Pankraz,44,,8,10,18
084 St.Pankraz,45,,17,7,24
084 St.Pankraz,46,,14,13,27
084 St.Pankraz,47,,13,5,18
084 St.Pankraz,48,,16,13,29
084 St.Pankraz,49,,7,8,15
084 St.Pankraz,50,,12,9,21
084 St.Pankraz,51,,10,15,25
084 St.Pankraz,52,,6,4,10
084 St.Pankraz,53,,11,8,19
084 St.Pankraz,54,,11,9,20
084 St.Pankraz,55,,14,10,24
084 St.Pankraz,56,,6,2,8
084 St.Pankraz,57,,11,6,17
084 St.Pankraz,58,,8,6,14
084 St.Pankraz,59,,8,3,11
084 St.Pankraz,60,,7,7,14
084 St.Pankraz,61,,4,7,11
084 St.Pankraz,62,,3,6,9
084 St.Pankraz,63,,5,7,12
084 St.Pankraz,64,,11,14,25
084 St.Pankraz,65,,9,15,24
084 St.Pankraz,66,,8,10,18
084 St.Pankraz,67,,8,6,14
084 St.Pankraz,68,,8,7,15
084 St.Pankraz,69,,5,11,16
084 St.Pankraz,70,,8,9,17
084 St.Pankraz,71,,5,5,10
084 St.Pankraz,72,,5,4,9
084 St.Pankraz,73,,6,7,13
084 St.Pankraz,74,,8,3,11
084 St.Pankraz,75,,7,9,16
084 St.Pankraz,76,,8,4,12
084 St.Pankraz,77,,4,5,9
084 St.Pankraz,78,,5,10,15
084 St.Pankraz,79,,7,9,16
084 St.Pankraz,80,,7,3,10
084 St.Pankraz,81,,5,6,11
084 St.Pankraz,82,,5,8,13
084 St.Pankraz,83,,3,7,10
084 St.Pankraz,84,,10,3,13
084 St.Pankraz,85,,5,7,12
084 St.Pankraz,86,,2,6,8
084 St.Pankraz,87,,-,6,6
084 St.Pankraz,88,,1,1,2
084 St.Pankraz,89,,-,1,1
084 St.Pankraz,90,,-,1,1
084 St.Pankraz,91,,1,-,1
084 St.Pankraz,92,,-,2,2
084 St.Pankraz,93,,-,1,1
084 St.Pankraz,94,,1,-,1
084 St.Pankraz,95,,1,-,1
084 St.Pankraz,98,,-,1,1
085 St.Christina in Gröden,0,,11,10,21
085 St.Christina in Gröden,1,,10,9,19
085 St.Christina in Gröden,2,,14,12,26
085 St.Christina in Gröden,3,,14,13,27
085 St.Christina in Gröden,4,,9,9,18
085 St.Christina in Gröden,5,,11,14,25
085 St.Christina in Gröden,6,,9,13,22
085 St.Christina in Gröden,7,,22,12,34
085 St.Christina in Gröden,8,,20,11,31
085 St.Christina in Gröden,9,,12,15,27
085 St.Christina in Gröden,10,,13,12,25
085 St.Christina in Gröden,11,,12,5,17
085 St.Christina in Gröden,12,,16,10,26
085 St.Christina in Gröden,13,,7,15,22
085 St.Christina in Gröden,14,,13,13,26
085 St.Christina in Gröden,15,,14,14,28
085 St.Christina in Gröden,16,,15,17,32
085 St.Christina in Gröden,17,,8,14,22
085 St.Christina in Gröden,18,,5,8,13
085 St.Christina in Gröden,19,,9,10,19
085 St.Christina in Gröden,20,,12,6,18
085 St.Christina in Gröden,21,,13,9,22
085 St.Christina in Gröden,22,,5,12,17
085 St.Christina in Gröden,23,,10,7,17
085 St.Christina in Gröden,24,,18,13,31
085 St.Christina in Gröden,25,,13,7,20
085 St.Christina in Gröden,26,,12,11,23
085 St.Christina in Gröden,27,,11,15,26
085 St.Christina in Gröden,28,,10,9,19
085 St.Christina in Gröden,29,,5,15,20
085 St.Christina in Gröden,30,,6,11,17
085 St.Christina in Gröden,31,,16,10,26
085 St.Christina in Gröden,32,,16,15,31
085 St.Christina in Gröden,33,,11,20,31
085 St.Christina in Gröden,34,,12,14,26
085 St.Christina in Gröden,35,,18,14,32
085 St.Christina in Gröden,36,,11,17,28
085 St.Christina in Gröden,37,,24,22,46
085 St.Christina in Gröden,38,,23,12,35
085 St.Christina in Gröden,39,,25,24,49
085 St.Christina in Gröden,40,,18,14,32
085 St.Christina in Gröden,41,,19,9,28
085 St.Christina in Gröden,42,,14,16,30
085 St.Christina in Gröden,43,,13,23,36
085 St.Christina in Gröden,44,,13,17,30
085 St.Christina in Gröden,45,,23,13,36
085 St.Christina in Gröden,46,,21,16,37
085 St.Christina in Gröden,47,,22,17,39
085 St.Christina in Gröden,48,,11,9,20
085 St.Christina in Gröden,49,,9,11,20
085 St.Christina in Gröden,50,,17,11,28
085 St.Christina in Gröden,51,,11,10,21
085 St.Christina in Gröden,52,,9,9,18
085 St.Christina in Gröden,53,,13,14,27
085 St.Christina in Gröden,54,,9,10,19
085 St.Christina in Gröden,55,,5,7,12
085 St.Christina in Gröden,56,,11,5,16
085 St.Christina in Gröden,57,,6,5,11
085 St.Christina in Gröden,58,,8,11,19
085 St.Christina in Gröden,59,,8,5,13
085 St.Christina in Gröden,60,,5,7,12
085 St.Christina in Gröden,61,,8,10,18
085 St.Christina in Gröden,62,,6,7,13
085 St.Christina in Gröden,63,,5,10,15
085 St.Christina in Gröden,64,,12,14,26
085 St.Christina in Gröden,65,,9,6,15
085 St.Christina in Gröden,66,,12,8,20
085 St.Christina in Gröden,67,,9,11,20
085 St.Christina in Gröden,68,,8,10,18
085 St.Christina in Gröden,69,,7,7,14
085 St.Christina in Gröden,70,,9,4,13
085 St.Christina in Gröden,71,,11,10,21
085 St.Christina in Gröden,72,,12,5,17
085 St.Christina in Gröden,73,,7,12,19
085 St.Christina in Gröden,74,,5,12,17
085 St.Christina in Gröden,75,,7,8,15
085 St.Christina in Gröden,76,,2,6,8
085 St.Christina in Gröden,77,,12,4,16
085 St.Christina in Gröden,78,,2,10,12
085 St.Christina in Gröden,79,,4,4,8
085 St.Christina in Gröden,80,,5,6,11
085 St.Christina in Gröden,81,,7,5,12
085 St.Christina in Gröden,82,,4,7,11
085 St.Christina in Gröden,83,,2,2,4
085 St.Christina in Gröden,84,,2,4,6
085 St.Christina in Gröden,85,,-,10,10
085 St.Christina in Gröden,86,,1,3,4
085 St.Christina in Gröden,87,,1,2,3
085 St.Christina in Gröden,88,,2,1,3
085 St.Christina in Gröden,91,,-,2,2
085 St.Christina in Gröden,92,,2,1,3
085 St.Christina in Gröden,93,,-,1,1
085 St.Christina in Gröden,94,,2,-,2
086 Sarntal,0,,50,41,91
086 Sarntal,1,,44,49,93
086 Sarntal,2,,40,36,76
086 Sarntal,3,,41,38,79
086 Sarntal,4,,46,33,79
086 Sarntal,5,,29,42,71
086 Sarntal,6,,51,28,79
086 Sarntal,7,,38,41,79
086 Sarntal,8,,35,37,72
086 Sarntal,9,,52,41,93
086 Sarntal,10,,44,46,90
086 Sarntal,11,,47,43,90
086 Sarntal,12,,42,42,84
086 Sarntal,13,,33,41,74
086 Sarntal,14,,32,39,71
086 Sarntal,15,,44,37,81
086 Sarntal,16,,42,43,85
086 Sarntal,17,,45,33,78
086 Sarntal,18,,55,36,91
086 Sarntal,19,,44,40,84
086 Sarntal,20,,36,30,66
086 Sarntal,21,,38,41,79
086 Sarntal,22,,43,41,84
086 Sarntal,23,,38,40,78
086 Sarntal,24,,55,41,96
086 Sarntal,25,,62,48,110
086 Sarntal,26,,42,57,99
086 Sarntal,27,,58,44,102
086 Sarntal,28,,62,51,113
086 Sarntal,29,,55,54,109
086 Sarntal,30,,59,43,102
086 Sarntal,31,,48,39,87
086 Sarntal,32,,62,47,109
086 Sarntal,33,,50,61,111
086 Sarntal,34,,62,60,122
086 Sarntal,35,,70,40,110
086 Sarntal,36,,44,48,92
086 Sarntal,37,,65,55,120
086 Sarntal,38,,61,53,114
086 Sarntal,39,,54,46,100
086 Sarntal,40,,57,47,104
086 Sarntal,41,,50,49,99
086 Sarntal,42,,68,54,122
086 Sarntal,43,,58,62,120
086 Sarntal,44,,43,42,85
086 Sarntal,45,,63,35,98
086 Sarntal,46,,41,47,88
086 Sarntal,47,,66,47,113
086 Sarntal,48,,39,43,82
086 Sarntal,49,,54,43,97
086 Sarntal,50,,36,42,78
086 Sarntal,51,,39,29,68
086 Sarntal,52,,41,41,82
086 Sarntal,53,,37,30,67
086 Sarntal,54,,42,30,72
086 Sarntal,55,,35,41,76
086 Sarntal,56,,45,34,79
086 Sarntal,57,,37,34,71
086 Sarntal,58,,50,25,75
086 Sarntal,59,,33,39,72
086 Sarntal,60,,37,29,66
086 Sarntal,61,,33,37,70
086 Sarntal,62,,29,32,61
086 Sarntal,63,,30,30,60
086 Sarntal,64,,37,39,76
086 Sarntal,65,,39,38,77
086 Sarntal,66,,34,29,63
086 Sarntal,67,,29,43,72
086 Sarntal,68,,37,31,68
086 Sarntal,69,,32,28,60
086 Sarntal,70,,23,32,55
086 Sarntal,71,,19,24,43
086 Sarntal,72,,19,24,43
086 Sarntal,73,,23,19,42
086 Sarntal,74,,21,22,43
086 Sarntal,75,,22,24,46
086 Sarntal,76,,15,23,38
086 Sarntal,77,,16,21,37
086 Sarntal,78,,18,30,48
086 Sarntal,79,,17,24,41
086 Sarntal,80,,14,31,45
086 Sarntal,81,,15,14,29
086 Sarntal,82,,17,17,34
086 Sarntal,83,,6,18,24
086 Sarntal,84,,7,17,24
086 Sarntal,85,,6,25,31
086 Sarntal,86,,4,7,11
086 Sarntal,87,,4,14,18
086 Sarntal,88,,3,12,15
086 Sarntal,89,,1,8,9
086 Sarntal,90,,1,5,6
086 Sarntal,91,,-,1,1
086 Sarntal,92,,1,2,3
086 Sarntal,93,,-,1,1
086 Sarntal,94,,4,3,7
086 Sarntal,95,,1,2,3
086 Sarntal,100,,1,1,2
087 Schenna,0,,9,10,19
087 Schenna,1,,23,21,44
087 Schenna,2,,12,10,22
087 Schenna,3,,18,18,36
087 Schenna,4,,11,16,27
087 Schenna,5,,14,18,32
087 Schenna,6,,19,15,34
087 Schenna,7,,19,20,39
087 Schenna,8,,23,18,41
087 Schenna,9,,15,11,26
087 Schenna,10,,13,19,32
087 Schenna,11,,17,18,35
087 Schenna,12,,20,18,38
087 Schenna,13,,20,16,36
087 Schenna,14,,12,8,20
087 Schenna,15,,17,18,35
087 Schenna,16,,11,20,31
087 Schenna,17,,20,17,37
087 Schenna,18,,21,11,32
087 Schenna,19,,21,19,40
087 Schenna,20,,22,17,39
087 Schenna,21,,19,13,32
087 Schenna,22,,16,16,32
087 Schenna,23,,15,15,30
087 Schenna,24,,15,9,24
087 Schenna,25,,13,14,27
087 Schenna,26,,23,12,35
087 Schenna,27,,18,20,38
087 Schenna,28,,24,19,43
087 Schenna,29,,12,19,31
087 Schenna,30,,18,20,38
087 Schenna,31,,20,17,37
087 Schenna,32,,19,27,46
087 Schenna,33,,33,22,55
087 Schenna,34,,24,21,45
087 Schenna,35,,28,16,44
087 Schenna,36,,27,27,54
087 Schenna,37,,19,26,45
087 Schenna,38,,25,18,43
087 Schenna,39,,23,22,45
087 Schenna,40,,31,22,53
087 Schenna,41,,16,19,35
087 Schenna,42,,28,29,57
087 Schenna,43,,21,25,46
087 Schenna,44,,27,19,46
087 Schenna,45,,20,12,32
087 Schenna,46,,29,23,52
087 Schenna,47,,35,24,59
087 Schenna,48,,13,13,26
087 Schenna,49,,23,19,42
087 Schenna,50,,13,19,32
087 Schenna,51,,17,18,35
087 Schenna,52,,11,16,27
087 Schenna,53,,14,17,31
087 Schenna,54,,15,15,30
087 Schenna,55,,14,16,30
087 Schenna,56,,14,12,26
087 Schenna,57,,18,14,32
087 Schenna,58,,20,18,38
087 Schenna,59,,16,15,31
087 Schenna,60,,17,18,35
087 Schenna,61,,17,21,38
087 Schenna,62,,16,13,29
087 Schenna,63,,16,9,25
087 Schenna,64,,20,13,33
087 Schenna,65,,9,19,28
087 Schenna,66,,12,13,25
087 Schenna,67,,10,10,20
087 Schenna,68,,9,13,22
087 Schenna,69,,16,17,33
087 Schenna,70,,7,10,17
087 Schenna,71,,8,11,19
087 Schenna,72,,13,10,23
087 Schenna,73,,12,15,27
087 Schenna,74,,7,9,16
087 Schenna,75,,10,11,21
087 Schenna,76,,11,10,21
087 Schenna,77,,11,6,17
087 Schenna,78,,6,10,16
087 Schenna,79,,7,9,16
087 Schenna,80,,2,12,14
087 Schenna,81,,5,7,12
087 Schenna,82,,1,8,9
087 Schenna,83,,7,6,13
087 Schenna,84,,3,3,6
087 Schenna,85,,7,4,11
087 Schenna,86,,5,7,12
087 Schenna,87,,2,4,6
087 Schenna,88,,1,4,5
087 Schenna,89,,-,1,1
087 Schenna,90,,-,1,1
087 Schenna,91,,1,1,2
087 Schenna,93,,1,-,1
087 Schenna,94,,-,2,2
087 Schenna,95,,1,2,3
087 Schenna,96,,-,1,1
087 Schenna,97,,-,1,1
087 Schenna,101,,1,-,1
088 Mühlwald,0,,10,5,15
088 Mühlwald,1,,5,10,15
088 Mühlwald,2,,7,5,12
088 Mühlwald,3,,9,9,18
088 Mühlwald,4,,15,10,25
088 Mühlwald,5,,9,12,21
088 Mühlwald,6,,9,12,21
088 Mühlwald,7,,8,11,19
088 Mühlwald,8,,13,10,23
088 Mühlwald,9,,12,14,26
088 Mühlwald,10,,11,8,19
088 Mühlwald,11,,14,12,26
088 Mühlwald,12,,13,4,17
088 Mühlwald,13,,9,6,15
088 Mühlwald,14,,14,12,26
088 Mühlwald,15,,5,5,10
088 Mühlwald,16,,11,6,17
088 Mühlwald,17,,9,6,15
088 Mühlwald,18,,16,8,24
088 Mühlwald,19,,7,3,10
088 Mühlwald,20,,9,15,24
088 Mühlwald,21,,6,7,13
088 Mühlwald,22,,11,17,28
088 Mühlwald,23,,11,17,28
088 Mühlwald,24,,11,9,20
088 Mühlwald,25,,7,14,21
088 Mühlwald,26,,15,14,29
088 Mühlwald,27,,20,2,22
088 Mühlwald,28,,7,17,24
088 Mühlwald,29,,12,8,20
088 Mühlwald,30,,8,5,13
088 Mühlwald,31,,13,10,23
088 Mühlwald,32,,11,9,20
088 Mühlwald,33,,10,4,14
088 Mühlwald,34,,15,8,23
088 Mühlwald,35,,9,9,18
088 Mühlwald,36,,18,14,32
088 Mühlwald,37,,7,10,17
088 Mühlwald,38,,14,15,29
088 Mühlwald,39,,16,10,26
088 Mühlwald,40,,17,13,30
088 Mühlwald,41,,13,7,20
088 Mühlwald,42,,17,12,29
088 Mühlwald,43,,17,10,27
088 Mühlwald,44,,10,11,21
088 Mühlwald,45,,8,11,19
088 Mühlwald,46,,6,10,16
088 Mühlwald,47,,14,9,23
088 Mühlwald,48,,14,5,19
088 Mühlwald,49,,9,5,14
088 Mühlwald,50,,13,12,25
088 Mühlwald,51,,7,8,15
088 Mühlwald,52,,7,7,14
088 Mühlwald,53,,9,4,13
088 Mühlwald,54,,10,9,19
088 Mühlwald,55,,10,8,18
088 Mühlwald,56,,10,4,14
088 Mühlwald,57,,5,9,14
088 Mühlwald,58,,9,3,12
088 Mühlwald,59,,12,4,16
088 Mühlwald,60,,10,7,17
088 Mühlwald,61,,8,3,11
088 Mühlwald,62,,4,4,8
088 Mühlwald,63,,8,4,12
088 Mühlwald,64,,10,2,12
088 Mühlwald,65,,6,7,13
088 Mühlwald,66,,4,7,11
088 Mühlwald,67,,4,9,13
088 Mühlwald,68,,6,11,17
088 Mühlwald,69,,8,4,12
088 Mühlwald,70,,11,3,14
088 Mühlwald,71,,4,3,7
088 Mühlwald,72,,5,3,8
088 Mühlwald,73,,4,6,10
088 Mühlwald,74,,3,10,13
088 Mühlwald,75,,1,2,3
088 Mühlwald,76,,5,5,10
088 Mühlwald,77,,3,4,7
088 Mühlwald,78,,6,8,14
088 Mühlwald,79,,4,4,8
088 Mühlwald,80,,5,2,7
088 Mühlwald,81,,2,5,7
088 Mühlwald,82,,3,1,4
088 Mühlwald,83,,6,2,8
088 Mühlwald,84,,-,3,3
088 Mühlwald,85,,-,2,2
088 Mühlwald,86,,-,5,5
088 Mühlwald,87,,1,-,1
088 Mühlwald,88,,-,1,1
088 Mühlwald,89,,-,2,2
088 Mühlwald,90,,2,-,2
088 Mühlwald,92,,-,1,1
088 Mühlwald,94,,-,1,1
088 Mühlwald,99,,1,-,1
089 Wolkenstein in Gröden,0,,16,15,31
089 Wolkenstein in Gröden,1,,10,17,27
089 Wolkenstein in Gröden,2,,14,19,33
089 Wolkenstein in Gröden,3,,13,8,21
089 Wolkenstein in Gröden,4,,16,19,35
089 Wolkenstein in Gröden,5,,25,19,44
089 Wolkenstein in Gröden,6,,20,19,39
089 Wolkenstein in Gröden,7,,20,22,42
089 Wolkenstein in Gröden,8,,13,17,30
089 Wolkenstein in Gröden,9,,14,23,37
089 Wolkenstein in Gröden,10,,21,29,50
089 Wolkenstein in Gröden,11,,15,13,28
089 Wolkenstein in Gröden,12,,17,12,29
089 Wolkenstein in Gröden,13,,15,18,33
089 Wolkenstein in Gröden,14,,14,17,31
089 Wolkenstein in Gröden,15,,23,14,37
089 Wolkenstein in Gröden,16,,18,18,36
089 Wolkenstein in Gröden,17,,12,11,23
089 Wolkenstein in Gröden,18,,15,13,28
089 Wolkenstein in Gröden,19,,17,17,34
089 Wolkenstein in Gröden,20,,11,21,32
089 Wolkenstein in Gröden,21,,15,14,29
089 Wolkenstein in Gröden,22,,17,11,28
089 Wolkenstein in Gröden,23,,13,11,24
089 Wolkenstein in Gröden,24,,15,11,26
089 Wolkenstein in Gröden,25,,10,17,27
089 Wolkenstein in Gröden,26,,16,9,25
089 Wolkenstein in Gröden,27,,17,14,31
089 Wolkenstein in Gröden,28,,8,15,23
089 Wolkenstein in Gröden,29,,7,10,17
089 Wolkenstein in Gröden,30,,11,11,22
089 Wolkenstein in Gröden,31,,15,11,26
089 Wolkenstein in Gröden,32,,23,18,41
089 Wolkenstein in Gröden,33,,13,19,32
089 Wolkenstein in Gröden,34,,25,21,46
089 Wolkenstein in Gröden,35,,19,21,40
089 Wolkenstein in Gröden,36,,20,24,44
089 Wolkenstein in Gröden,37,,24,27,51
089 Wolkenstein in Gröden,38,,28,20,48
089 Wolkenstein in Gröden,39,,26,24,50
089 Wolkenstein in Gröden,40,,30,26,56
089 Wolkenstein in Gröden,41,,25,22,47
089 Wolkenstein in Gröden,42,,22,32,54
089 Wolkenstein in Gröden,43,,28,21,49
089 Wolkenstein in Gröden,44,,23,21,44
089 Wolkenstein in Gröden,45,,22,20,42
089 Wolkenstein in Gröden,46,,26,26,52
089 Wolkenstein in Gröden,47,,24,22,46
089 Wolkenstein in Gröden,48,,14,16,30
089 Wolkenstein in Gröden,49,,17,16,33
089 Wolkenstein in Gröden,50,,20,17,37
089 Wolkenstein in Gröden,51,,11,14,25
089 Wolkenstein in Gröden,52,,14,10,24
089 Wolkenstein in Gröden,53,,15,10,25
089 Wolkenstein in Gröden,54,,8,12,20
089 Wolkenstein in Gröden,55,,11,7,18
089 Wolkenstein in Gröden,56,,13,12,25
089 Wolkenstein in Gröden,57,,6,17,23
089 Wolkenstein in Gröden,58,,17,12,29
089 Wolkenstein in Gröden,59,,13,13,26
089 Wolkenstein in Gröden,60,,9,17,26
089 Wolkenstein in Gröden,61,,17,18,35
089 Wolkenstein in Gröden,62,,5,14,19
089 Wolkenstein in Gröden,63,,12,9,21
089 Wolkenstein in Gröden,64,,21,14,35
089 Wolkenstein in Gröden,65,,11,12,23
089 Wolkenstein in Gröden,66,,14,16,30
089 Wolkenstein in Gröden,67,,14,16,30
089 Wolkenstein in Gröden,68,,18,14,32
089 Wolkenstein in Gröden,69,,19,8,27
089 Wolkenstein in Gröden,70,,10,19,29
089 Wolkenstein in Gröden,71,,9,15,24
089 Wolkenstein in Gröden,72,,14,7,21
089 Wolkenstein in Gröden,73,,16,10,26
089 Wolkenstein in Gröden,74,,6,10,16
089 Wolkenstein in Gröden,75,,5,9,14
089 Wolkenstein in Gröden,76,,8,9,17
089 Wolkenstein in Gröden,77,,7,10,17
089 Wolkenstein in Gröden,78,,7,7,14
089 Wolkenstein in Gröden,79,,5,9,14
089 Wolkenstein in Gröden,80,,9,6,15
089 Wolkenstein in Gröden,81,,6,5,11
089 Wolkenstein in Gröden,82,,4,7,11
089 Wolkenstein in Gröden,83,,3,10,13
089 Wolkenstein in Gröden,84,,4,6,10
089 Wolkenstein in Gröden,85,,5,9,14
089 Wolkenstein in Gröden,86,,1,5,6
089 Wolkenstein in Gröden,87,,3,4,7
089 Wolkenstein in Gröden,88,,1,2,3
089 Wolkenstein in Gröden,90,,1,2,3
089 Wolkenstein in Gröden,93,,1,1,2
089 Wolkenstein in Gröden,95,,-,3,3
089 Wolkenstein in Gröden,96,,-,3,3
089 Wolkenstein in Gröden,98,,-,1,1
091 Schnals,0,,4,5,9
091 Schnals,1,,3,5,8
091 Schnals,2,,6,4,10
091 Schnals,3,,8,6,14
091 Schnals,4,,2,5,7
091 Schnals,5,,12,1,13
091 Schnals,6,,4,4,8
091 Schnals,7,,5,5,10
091 Schnals,8,,6,9,15
091 Schnals,9,,7,16,23
091 Schnals,10,,12,10,22
091 Schnals,11,,7,13,20
091 Schnals,12,,5,8,13
091 Schnals,13,,4,7,11
091 Schnals,14,,11,5,16
091 Schnals,15,,13,10,23
091 Schnals,16,,13,9,22
091 Schnals,17,,5,7,12
091 Schnals,18,,19,9,28
091 Schnals,19,,10,5,15
091 Schnals,20,,12,8,20
091 Schnals,21,,9,10,19
091 Schnals,22,,6,8,14
091 Schnals,23,,14,14,28
091 Schnals,24,,7,7,14
091 Schnals,25,,11,6,17
091 Schnals,26,,16,8,24
091 Schnals,27,,12,10,22
091 Schnals,28,,6,10,16
091 Schnals,29,,11,10,21
091 Schnals,30,,9,7,16
091 Schnals,31,,12,1,13
091 Schnals,32,,4,6,10
091 Schnals,33,,13,8,21
091 Schnals,34,,7,7,14
091 Schnals,35,,8,10,18
091 Schnals,36,,12,11,23
091 Schnals,37,,13,10,23
091 Schnals,38,,13,8,21
091 Schnals,39,,10,10,20
091 Schnals,40,,16,11,27
091 Schnals,41,,14,15,29
091 Schnals,42,,17,7,24
091 Schnals,43,,7,9,16
091 Schnals,44,,10,15,25
091 Schnals,45,,14,10,24
091 Schnals,46,,11,13,24
091 Schnals,47,,11,8,19
091 Schnals,48,,17,13,30
091 Schnals,49,,11,11,22
091 Schnals,50,,13,5,18
091 Schnals,51,,12,5,17
091 Schnals,52,,9,6,15
091 Schnals,53,,10,10,20
091 Schnals,54,,12,8,20
091 Schnals,55,,14,7,21
091 Schnals,56,,12,9,21
091 Schnals,57,,10,7,17
091 Schnals,58,,10,9,19
091 Schnals,59,,3,3,6
091 Schnals,60,,9,8,17
091 Schnals,61,,5,6,11
091 Schnals,62,,6,4,10
091 Schnals,63,,4,7,11
091 Schnals,64,,6,8,14
091 Schnals,65,,4,4,8
091 Schnals,66,,4,4,8
091 Schnals,67,,7,7,14
091 Schnals,68,,7,7,14
091 Schnals,69,,1,11,12
091 Schnals,70,,7,5,12
091 Schnals,71,,5,5,10
091 Schnals,72,,2,5,7
091 Schnals,73,,2,4,6
091 Schnals,74,,4,3,7
091 Schnals,75,,2,10,12
091 Schnals,76,,2,4,6
091 Schnals,77,,-,5,5
091 Schnals,78,,5,6,11
091 Schnals,79,,1,5,6
091 Schnals,80,,3,7,10
091 Schnals,81,,9,3,12
091 Schnals,82,,4,10,14
091 Schnals,83,,-,5,5
091 Schnals,84,,-,2,2
091 Schnals,85,,6,2,8
091 Schnals,86,,-,5,5
091 Schnals,87,,-,2,2
091 Schnals,88,,-,1,1
091 Schnals,89,,3,2,5
091 Schnals,90,,-,2,2
091 Schnals,91,,-,2,2
091 Schnals,92,,-,3,3
091 Schnals,93,,-,1,1
091 Schnals,94,,-,1,1
091 Schnals,95,,1,1,2
091 Schnals,96,,-,1,1
091 Schnals,98,,-,1,1
092 Sexten,0,,5,14,19
092 Sexten,1,,7,8,15
092 Sexten,2,,9,8,17
092 Sexten,3,,12,7,19
092 Sexten,4,,11,10,21
092 Sexten,5,,16,18,34
092 Sexten,6,,16,12,28
092 Sexten,7,,9,15,24
092 Sexten,8,,8,16,24
092 Sexten,9,,12,7,19
092 Sexten,10,,13,9,22
092 Sexten,11,,12,12,24
092 Sexten,12,,15,13,28
092 Sexten,13,,16,11,27
092 Sexten,14,,8,5,13
092 Sexten,15,,14,10,24
092 Sexten,16,,12,12,24
092 Sexten,17,,11,19,30
092 Sexten,18,,9,9,18
092 Sexten,19,,10,5,15
092 Sexten,20,,12,7,19
092 Sexten,21,,6,9,15
092 Sexten,22,,10,11,21
092 Sexten,23,,6,11,17
092 Sexten,24,,10,10,20
092 Sexten,25,,10,16,26
092 Sexten,26,,15,12,27
092 Sexten,27,,15,7,22
092 Sexten,28,,11,22,33
092 Sexten,29,,10,9,19
092 Sexten,30,,8,3,11
092 Sexten,31,,18,12,30
092 Sexten,32,,8,7,15
092 Sexten,33,,9,6,15
092 Sexten,34,,10,9,19
092 Sexten,35,,14,17,31
092 Sexten,36,,14,14,28
092 Sexten,37,,13,18,31
092 Sexten,38,,22,18,40
092 Sexten,39,,16,17,33
092 Sexten,40,,21,19,40
092 Sexten,41,,15,16,31
092 Sexten,42,,17,18,35
092 Sexten,43,,18,19,37
092 Sexten,44,,29,18,47
092 Sexten,45,,13,18,31
092 Sexten,46,,18,14,32
092 Sexten,47,,20,9,29
092 Sexten,48,,15,14,29
092 Sexten,49,,21,15,36
092 Sexten,50,,18,13,31
092 Sexten,51,,13,15,28
092 Sexten,52,,9,12,21
092 Sexten,53,,11,12,23
092 Sexten,54,,5,11,16
092 Sexten,55,,6,11,17
092 Sexten,56,,7,9,16
092 Sexten,57,,11,7,18
092 Sexten,58,,6,4,10
092 Sexten,59,,10,7,17
092 Sexten,60,,10,4,14
092 Sexten,61,,6,9,15
092 Sexten,62,,8,4,12
092 Sexten,63,,6,11,17
092 Sexten,64,,8,6,14
092 Sexten,65,,5,6,11
092 Sexten,66,,9,16,25
092 Sexten,67,,8,12,20
092 Sexten,68,,6,10,16
092 Sexten,69,,13,11,24
092 Sexten,70,,11,8,19
092 Sexten,71,,7,10,17
092 Sexten,72,,9,15,24
092 Sexten,73,,11,7,18
092 Sexten,74,,4,10,14
092 Sexten,75,,5,7,12
092 Sexten,76,,8,13,21
092 Sexten,77,,8,11,19
092 Sexten,78,,6,13,19
092 Sexten,79,,8,10,18
092 Sexten,80,,7,14,21
092 Sexten,81,,5,4,9
092 Sexten,82,,5,10,15
092 Sexten,83,,5,6,11
092 Sexten,84,,4,8,12
092 Sexten,85,,4,7,11
092 Sexten,86,,2,6,8
092 Sexten,87,,1,3,4
092 Sexten,88,,1,3,4
092 Sexten,90,,-,1,1
092 Sexten,91,,-,1,1
092 Sexten,93,,1,-,1
092 Sexten,94,,-,1,1
092 Sexten,95,,-,2,2
093 Schlanders,0,,30,31,61
093 Schlanders,1,,23,21,44
093 Schlanders,2,,28,37,65
093 Schlanders,3,,30,35,65
093 Schlanders,4,,29,23,52
093 Schlanders,5,,28,30,58
093 Schlanders,6,,30,30,60
093 Schlanders,7,,39,40,79
093 Schlanders,8,,24,41,65
093 Schlanders,9,,42,39,81
093 Schlanders,10,,56,48,104
093 Schlanders,11,,43,37,80
093 Schlanders,12,,37,29,66
093 Schlanders,13,,41,40,81
093 Schlanders,14,,45,43,88
093 Schlanders,15,,36,44,80
093 Schlanders,16,,40,39,79
093 Schlanders,17,,51,42,93
093 Schlanders,18,,35,33,68
093 Schlanders,19,,37,42,79
093 Schlanders,20,,37,29,66
093 Schlanders,21,,35,35,70
093 Schlanders,22,,41,38,79
093 Schlanders,23,,39,44,83
093 Schlanders,24,,34,37,71
093 Schlanders,25,,48,40,88
093 Schlanders,26,,47,41,88
093 Schlanders,27,,38,33,71
093 Schlanders,28,,32,43,75
093 Schlanders,29,,46,41,87
093 Schlanders,30,,34,44,78
093 Schlanders,31,,34,29,63
093 Schlanders,32,,39,39,78
093 Schlanders,33,,50,35,85
093 Schlanders,34,,38,49,87
093 Schlanders,35,,53,36,89
093 Schlanders,36,,48,45,93
093 Schlanders,37,,46,55,101
093 Schlanders,38,,59,44,103
093 Schlanders,39,,50,39,89
093 Schlanders,40,,44,55,99
093 Schlanders,41,,44,54,98
093 Schlanders,42,,55,50,105
093 Schlanders,43,,41,44,85
093 Schlanders,44,,54,59,113
093 Schlanders,45,,53,45,98
093 Schlanders,46,,42,57,99
093 Schlanders,47,,45,45,90
093 Schlanders,48,,41,39,80
093 Schlanders,49,,47,54,101
093 Schlanders,50,,42,35,77
093 Schlanders,51,,25,35,60
093 Schlanders,52,,27,36,63
093 Schlanders,53,,31,35,66
093 Schlanders,54,,35,37,72
093 Schlanders,55,,33,23,56
093 Schlanders,56,,28,31,59
093 Schlanders,57,,23,30,53
093 Schlanders,58,,29,37,66
093 Schlanders,59,,37,27,64
093 Schlanders,60,,23,23,46
093 Schlanders,61,,29,20,49
093 Schlanders,62,,31,16,47
093 Schlanders,63,,27,31,58
093 Schlanders,64,,30,33,63
093 Schlanders,65,,35,36,71
093 Schlanders,66,,32,36,68
093 Schlanders,67,,27,29,56
093 Schlanders,68,,30,35,65
093 Schlanders,69,,13,21,34
093 Schlanders,70,,25,24,49
093 Schlanders,71,,18,25,43
093 Schlanders,72,,16,24,40
093 Schlanders,73,,17,19,36
093 Schlanders,74,,19,29,48
093 Schlanders,75,,17,16,33
093 Schlanders,76,,22,18,40
093 Schlanders,77,,14,25,39
093 Schlanders,78,,12,14,26
093 Schlanders,79,,14,22,36
093 Schlanders,80,,13,21,34
093 Schlanders,81,,11,20,31
093 Schlanders,82,,10,18,28
093 Schlanders,83,,10,14,24
093 Schlanders,84,,7,14,21
093 Schlanders,85,,6,12,18
093 Schlanders,86,,5,9,14
093 Schlanders,87,,3,13,16
093 Schlanders,88,,2,9,11
093 Schlanders,89,,3,9,12
093 Schlanders,90,,2,1,3
093 Schlanders,91,,1,2,3
093 Schlanders,92,,2,2,4
093 Schlanders,93,,2,2,4
093 Schlanders,94,,1,2,3
093 Schlanders,95,,-,5,5
093 Schlanders,96,,-,1,1
093 Schlanders,97,,-,3,3
093 Schlanders,98,,-,1,1
093 Schlanders,101,,-,1,1
093 Schlanders,104,,-,1,1
094 Schluderns,0,,13,16,29
094 Schluderns,1,,7,10,17
094 Schluderns,2,,8,7,15
094 Schluderns,3,,6,15,21
094 Schluderns,4,,15,10,25
094 Schluderns,5,,14,9,23
094 Schluderns,6,,13,8,21
094 Schluderns,7,,18,8,26
094 Schluderns,8,,8,14,22
094 Schluderns,9,,6,10,16
094 Schluderns,10,,12,11,23
094 Schluderns,11,,12,16,28
094 Schluderns,12,,10,11,21
094 Schluderns,13,,14,18,32
094 Schluderns,14,,17,7,24
094 Schluderns,15,,8,10,18
094 Schluderns,16,,9,10,19
094 Schluderns,17,,22,7,29
094 Schluderns,18,,15,12,27
094 Schluderns,19,,11,12,23
094 Schluderns,20,,6,10,16
094 Schluderns,21,,13,21,34
094 Schluderns,22,,19,14,33
094 Schluderns,23,,14,13,27
094 Schluderns,24,,12,5,17
094 Schluderns,25,,9,17,26
094 Schluderns,26,,21,15,36
094 Schluderns,27,,7,7,14
094 Schluderns,28,,7,17,24
094 Schluderns,29,,11,12,23
094 Schluderns,30,,13,8,21
094 Schluderns,31,,10,17,27
094 Schluderns,32,,17,9,26
094 Schluderns,33,,18,16,34
094 Schluderns,34,,19,10,29
094 Schluderns,35,,13,13,26
094 Schluderns,36,,10,13,23
094 Schluderns,37,,12,14,26
094 Schluderns,38,,19,9,28
094 Schluderns,39,,17,19,36
094 Schluderns,40,,13,16,29
094 Schluderns,41,,17,17,34
094 Schluderns,42,,26,9,35
094 Schluderns,43,,26,11,37
094 Schluderns,44,,13,19,32
094 Schluderns,45,,11,20,31
094 Schluderns,46,,16,16,32
094 Schluderns,47,,11,5,16
094 Schluderns,48,,13,19,32
094 Schluderns,49,,10,13,23
094 Schluderns,50,,18,7,25
094 Schluderns,51,,10,16,26
094 Schluderns,52,,17,11,28
094 Schluderns,53,,14,7,21
094 Schluderns,54,,13,7,20
094 Schluderns,55,,7,5,12
094 Schluderns,56,,11,3,14
094 Schluderns,57,,9,14,23
094 Schluderns,58,,13,11,24
094 Schluderns,59,,9,9,18
094 Schluderns,60,,7,6,13
094 Schluderns,61,,8,9,17
094 Schluderns,62,,6,3,9
094 Schluderns,63,,4,12,16
094 Schluderns,64,,3,8,11
094 Schluderns,65,,8,7,15
094 Schluderns,66,,10,14,24
094 Schluderns,67,,8,5,13
094 Schluderns,68,,13,8,21
094 Schluderns,69,,9,7,16
094 Schluderns,70,,7,10,17
094 Schluderns,71,,4,6,10
094 Schluderns,72,,5,10,15
094 Schluderns,73,,8,11,19
094 Schluderns,74,,5,9,14
094 Schluderns,75,,10,10,20
094 Schluderns,76,,4,7,11
094 Schluderns,77,,7,9,16
094 Schluderns,78,,4,6,10
094 Schluderns,79,,5,8,13
094 Schluderns,80,,4,1,5
094 Schluderns,81,,2,10,12
094 Schluderns,82,,2,7,9
094 Schluderns,83,,2,2,4
094 Schluderns,84,,1,5,6
094 Schluderns,85,,4,2,6
094 Schluderns,86,,-,5,5
094 Schluderns,87,,-,2,2
094 Schluderns,88,,2,3,5
094 Schluderns,89,,3,3,6
094 Schluderns,90,,1,2,3
094 Schluderns,91,,-,1,1
094 Schluderns,92,,-,2,2
094 Schluderns,93,,1,1,2
094 Schluderns,94,,1,-,1
094 Schluderns,98,,-,1,1
095 Stilfs,0,,3,4,7
095 Stilfs,1,,8,5,13
095 Stilfs,2,,6,5,11
095 Stilfs,3,,7,5,12
095 Stilfs,4,,6,8,14
095 Stilfs,5,,5,3,8
095 Stilfs,6,,5,11,16
095 Stilfs,7,,10,4,14
095 Stilfs,8,,2,7,9
095 Stilfs,9,,7,3,10
095 Stilfs,10,,9,11,20
095 Stilfs,11,,12,1,13
095 Stilfs,12,,7,6,13
095 Stilfs,13,,8,6,14
095 Stilfs,14,,6,15,21
095 Stilfs,15,,3,9,12
095 Stilfs,16,,11,5,16
095 Stilfs,17,,17,7,24
095 Stilfs,18,,10,6,16
095 Stilfs,19,,6,4,10
095 Stilfs,20,,6,8,14
095 Stilfs,21,,9,7,16
095 Stilfs,22,,13,5,18
095 Stilfs,23,,13,6,19
095 Stilfs,24,,8,5,13
095 Stilfs,25,,12,5,17
095 Stilfs,26,,8,3,11
095 Stilfs,27,,7,5,12
095 Stilfs,28,,4,7,11
095 Stilfs,29,,7,8,15
095 Stilfs,30,,10,5,15
095 Stilfs,31,,12,4,16
095 Stilfs,32,,8,8,16
095 Stilfs,33,,5,6,11
095 Stilfs,34,,7,18,25
095 Stilfs,35,,11,10,21
095 Stilfs,36,,12,11,23
095 Stilfs,37,,10,14,24
095 Stilfs,38,,12,10,22
095 Stilfs,39,,7,11,18
095 Stilfs,40,,8,9,17
095 Stilfs,41,,15,8,23
095 Stilfs,42,,12,10,22
095 Stilfs,43,,11,5,16
095 Stilfs,44,,9,5,14
095 Stilfs,45,,9,16,25
095 Stilfs,46,,9,2,11
095 Stilfs,47,,8,7,15
095 Stilfs,48,,9,8,17
095 Stilfs,49,,6,13,19
095 Stilfs,50,,10,6,16
095 Stilfs,51,,5,11,16
095 Stilfs,52,,4,3,7
095 Stilfs,53,,15,9,24
095 Stilfs,54,,10,5,15
095 Stilfs,55,,11,5,16
095 Stilfs,56,,14,9,23
095 Stilfs,57,,2,7,9
095 Stilfs,58,,7,3,10
095 Stilfs,59,,8,9,17
095 Stilfs,60,,6,4,10
095 Stilfs,61,,10,9,19
095 Stilfs,62,,2,4,6
095 Stilfs,63,,13,9,22
095 Stilfs,64,,9,7,16
095 Stilfs,65,,5,12,17
095 Stilfs,66,,7,4,11
095 Stilfs,67,,6,11,17
095 Stilfs,68,,4,9,13
095 Stilfs,69,,3,4,7
095 Stilfs,70,,7,5,12
095 Stilfs,71,,3,9,12
095 Stilfs,72,,3,6,9
095 Stilfs,73,,6,4,10
095 Stilfs,74,,4,6,10
095 Stilfs,75,,3,7,10
095 Stilfs,76,,3,4,7
095 Stilfs,77,,5,6,11
095 Stilfs,78,,5,1,6
095 Stilfs,79,,4,7,11
095 Stilfs,80,,4,6,10
095 Stilfs,81,,3,4,7
095 Stilfs,82,,3,3,6
095 Stilfs,83,,-,6,6
095 Stilfs,84,,-,5,5
095 Stilfs,85,,1,5,6
095 Stilfs,86,,1,5,6
095 Stilfs,87,,-,4,4
095 Stilfs,88,,1,-,1
095 Stilfs,89,,-,1,1
095 Stilfs,90,,-,1,1
095 Stilfs,91,,-,2,2
095 Stilfs,93,,2,1,3
095 Stilfs,94,,-,1,1
095 Stilfs,95,,-,1,1
095 Stilfs,97,,-,1,1
096 Terenten,0,,11,10,21
096 Terenten,1,,14,9,23
096 Terenten,2,,16,9,25
096 Terenten,3,,11,20,31
096 Terenten,4,,9,12,21
096 Terenten,5,,8,8,16
096 Terenten,6,,10,14,24
096 Terenten,7,,9,9,18
096 Terenten,8,,10,17,27
096 Terenten,9,,20,19,39
096 Terenten,10,,8,7,15
096 Terenten,11,,12,11,23
096 Terenten,12,,12,7,19
096 Terenten,13,,14,13,27
096 Terenten,14,,7,12,19
096 Terenten,15,,9,8,17
096 Terenten,16,,6,16,22
096 Terenten,17,,12,16,28
096 Terenten,18,,14,7,21
096 Terenten,19,,10,8,18
096 Terenten,20,,16,7,23
096 Terenten,21,,9,8,17
096 Terenten,22,,10,14,24
096 Terenten,23,,13,11,24
096 Terenten,24,,14,17,31
096 Terenten,25,,12,9,21
096 Terenten,26,,15,8,23
096 Terenten,27,,12,14,26
096 Terenten,28,,9,11,20
096 Terenten,29,,18,17,35
096 Terenten,30,,10,7,17
096 Terenten,31,,17,10,27
096 Terenten,32,,15,11,26
096 Terenten,33,,16,17,33
096 Terenten,34,,7,17,24
096 Terenten,35,,19,10,29
096 Terenten,36,,15,17,32
096 Terenten,37,,20,11,31
096 Terenten,38,,17,14,31
096 Terenten,39,,12,15,27
096 Terenten,40,,17,17,34
096 Terenten,41,,11,18,29
096 Terenten,42,,17,10,27
096 Terenten,43,,17,13,30
096 Terenten,44,,24,13,37
096 Terenten,45,,19,11,30
096 Terenten,46,,10,15,25
096 Terenten,47,,12,9,21
096 Terenten,48,,14,11,25
096 Terenten,49,,13,8,21
096 Terenten,50,,11,9,20
096 Terenten,51,,9,12,21
096 Terenten,52,,12,10,22
096 Terenten,53,,15,10,25
096 Terenten,54,,9,6,15
096 Terenten,55,,7,7,14
096 Terenten,56,,5,6,11
096 Terenten,57,,7,7,14
096 Terenten,58,,8,6,14
096 Terenten,59,,10,8,18
096 Terenten,60,,7,3,10
096 Terenten,61,,8,3,11
096 Terenten,62,,6,3,9
096 Terenten,63,,3,6,9
096 Terenten,64,,8,5,13
096 Terenten,65,,5,5,10
096 Terenten,66,,6,4,10
096 Terenten,67,,8,5,13
096 Terenten,68,,2,6,8
096 Terenten,69,,4,10,14
096 Terenten,70,,6,5,11
096 Terenten,71,,4,9,13
096 Terenten,72,,7,5,12
096 Terenten,73,,1,4,5
096 Terenten,74,,5,3,8
096 Terenten,75,,4,4,8
096 Terenten,76,,5,9,14
096 Terenten,77,,4,5,9
096 Terenten,78,,4,4,8
096 Terenten,79,,4,6,10
096 Terenten,80,,2,3,5
096 Terenten,81,,3,7,10
096 Terenten,82,,6,2,8
096 Terenten,83,,1,5,6
096 Terenten,84,,3,3,6
096 Terenten,85,,1,1,2
096 Terenten,86,,-,2,2
096 Terenten,87,,2,3,5
096 Terenten,88,,1,-,1
096 Terenten,89,,-,2,2
096 Terenten,90,,1,-,1
096 Terenten,91,,-,1,1
096 Terenten,93,,2,-,2
096 Terenten,95,,-,1,1
097 Terlan,0,,21,17,38
097 Terlan,1,,21,28,49
097 Terlan,2,,15,25,40
097 Terlan,3,,27,24,51
097 Terlan,4,,25,24,49
097 Terlan,5,,18,20,38
097 Terlan,6,,21,26,47
097 Terlan,7,,31,28,59
097 Terlan,8,,30,20,50
097 Terlan,9,,21,22,43
097 Terlan,10,,32,29,61
097 Terlan,11,,16,24,40
097 Terlan,12,,27,26,53
097 Terlan,13,,21,19,40
097 Terlan,14,,27,24,51
097 Terlan,15,,23,32,55
097 Terlan,16,,26,20,46
097 Terlan,17,,15,24,39
097 Terlan,18,,23,30,53
097 Terlan,19,,22,20,42
097 Terlan,20,,25,15,40
097 Terlan,21,,16,25,41
097 Terlan,22,,26,18,44
097 Terlan,23,,14,16,30
097 Terlan,24,,20,15,35
097 Terlan,25,,24,20,44
097 Terlan,26,,18,21,39
097 Terlan,27,,33,28,61
097 Terlan,28,,21,31,52
097 Terlan,29,,20,28,48
097 Terlan,30,,32,27,59
097 Terlan,31,,28,37,65
097 Terlan,32,,33,25,58
097 Terlan,33,,23,43,66
097 Terlan,34,,26,36,62
097 Terlan,35,,46,22,68
097 Terlan,36,,31,27,58
097 Terlan,37,,41,44,85
097 Terlan,38,,32,35,67
097 Terlan,39,,37,29,66
097 Terlan,40,,28,41,69
097 Terlan,41,,42,31,73
097 Terlan,42,,33,30,63
097 Terlan,43,,31,29,60
097 Terlan,44,,36,34,70
097 Terlan,45,,33,34,67
097 Terlan,46,,45,27,72
097 Terlan,47,,25,36,61
097 Terlan,48,,18,26,44
097 Terlan,49,,31,23,54
097 Terlan,50,,23,26,49
097 Terlan,51,,33,33,66
097 Terlan,52,,22,21,43
097 Terlan,53,,24,20,44
097 Terlan,54,,14,24,38
097 Terlan,55,,19,26,45
097 Terlan,56,,21,17,38
097 Terlan,57,,23,23,46
097 Terlan,58,,20,15,35
097 Terlan,59,,17,22,39
097 Terlan,60,,16,19,35
097 Terlan,61,,13,23,36
097 Terlan,62,,20,23,43
097 Terlan,63,,20,24,44
097 Terlan,64,,16,27,43
097 Terlan,65,,32,19,51
097 Terlan,66,,21,25,46
097 Terlan,67,,21,15,36
097 Terlan,68,,16,20,36
097 Terlan,69,,20,17,37
097 Terlan,70,,14,16,30
097 Terlan,71,,4,11,15
097 Terlan,72,,14,22,36
097 Terlan,73,,7,23,30
097 Terlan,74,,11,15,26
097 Terlan,75,,13,11,24
097 Terlan,76,,17,14,31
097 Terlan,77,,15,17,32
097 Terlan,78,,10,12,22
097 Terlan,79,,11,11,22
097 Terlan,80,,7,10,17
097 Terlan,81,,9,17,26
097 Terlan,82,,8,12,20
097 Terlan,83,,5,13,18
097 Terlan,84,,5,24,29
097 Terlan,85,,7,10,17
097 Terlan,86,,6,11,17
097 Terlan,87,,-,7,7
097 Terlan,88,,-,6,6
097 Terlan,89,,3,3,6
097 Terlan,90,,-,4,4
097 Terlan,91,,-,4,4
097 Terlan,92,,1,3,4
097 Terlan,93,,-,3,3
097 Terlan,94,,1,1,2
097 Terlan,95,,-,2,2
097 Terlan,96,,-,3,3
097 Terlan,97,,-,2,2
097 Terlan,99,,-,1,1
097 Terlan,100,,-,1,1
098 Tramin a.d. Weinstr.,0,,15,12,27
098 Tramin a.d. Weinstr.,1,,17,12,29
098 Tramin a.d. Weinstr.,2,,18,12,30
098 Tramin a.d. Weinstr.,3,,13,16,29
098 Tramin a.d. Weinstr.,4,,28,15,43
098 Tramin a.d. Weinstr.,5,,13,18,31
098 Tramin a.d. Weinstr.,6,,17,19,36
098 Tramin a.d. Weinstr.,7,,25,14,39
098 Tramin a.d. Weinstr.,8,,18,20,38
098 Tramin a.d. Weinstr.,9,,16,19,35
098 Tramin a.d. Weinstr.,10,,29,14,43
098 Tramin a.d. Weinstr.,11,,20,26,46
098 Tramin a.d. Weinstr.,12,,20,18,38
098 Tramin a.d. Weinstr.,13,,20,22,42
098 Tramin a.d. Weinstr.,14,,17,18,35
098 Tramin a.d. Weinstr.,15,,19,25,44
098 Tramin a.d. Weinstr.,16,,18,9,27
098 Tramin a.d. Weinstr.,17,,23,21,44
098 Tramin a.d. Weinstr.,18,,12,30,42
098 Tramin a.d. Weinstr.,19,,12,25,37
098 Tramin a.d. Weinstr.,20,,19,27,46
098 Tramin a.d. Weinstr.,21,,11,16,27
098 Tramin a.d. Weinstr.,22,,21,19,40
098 Tramin a.d. Weinstr.,23,,24,17,41
098 Tramin a.d. Weinstr.,24,,16,20,36
098 Tramin a.d. Weinstr.,25,,22,21,43
098 Tramin a.d. Weinstr.,26,,31,22,53
098 Tramin a.d. Weinstr.,27,,17,16,33
098 Tramin a.d. Weinstr.,28,,15,16,31
098 Tramin a.d. Weinstr.,29,,10,23,33
098 Tramin a.d. Weinstr.,30,,17,14,31
098 Tramin a.d. Weinstr.,31,,23,13,36
098 Tramin a.d. Weinstr.,32,,23,21,44
098 Tramin a.d. Weinstr.,33,,21,16,37
098 Tramin a.d. Weinstr.,34,,22,12,34
098 Tramin a.d. Weinstr.,35,,19,25,44
098 Tramin a.d. Weinstr.,36,,26,34,60
098 Tramin a.d. Weinstr.,37,,28,21,49
098 Tramin a.d. Weinstr.,38,,32,24,56
098 Tramin a.d. Weinstr.,39,,25,23,48
098 Tramin a.d. Weinstr.,40,,27,31,58
098 Tramin a.d. Weinstr.,41,,28,28,56
098 Tramin a.d. Weinstr.,42,,35,28,63
098 Tramin a.d. Weinstr.,43,,30,27,57
098 Tramin a.d. Weinstr.,44,,23,23,46
098 Tramin a.d. Weinstr.,45,,20,14,34
098 Tramin a.d. Weinstr.,46,,30,27,57
098 Tramin a.d. Weinstr.,47,,27,32,59
098 Tramin a.d. Weinstr.,48,,18,30,48
098 Tramin a.d. Weinstr.,49,,23,25,48
098 Tramin a.d. Weinstr.,50,,20,21,41
098 Tramin a.d. Weinstr.,51,,24,19,43
098 Tramin a.d. Weinstr.,52,,16,19,35
098 Tramin a.d. Weinstr.,53,,20,18,38
098 Tramin a.d. Weinstr.,54,,15,16,31
098 Tramin a.d. Weinstr.,55,,19,17,36
098 Tramin a.d. Weinstr.,56,,12,14,26
098 Tramin a.d. Weinstr.,57,,14,20,34
098 Tramin a.d. Weinstr.,58,,16,15,31
098 Tramin a.d. Weinstr.,59,,17,19,36
098 Tramin a.d. Weinstr.,60,,14,22,36
098 Tramin a.d. Weinstr.,61,,23,17,40
098 Tramin a.d. Weinstr.,62,,7,9,16
098 Tramin a.d. Weinstr.,63,,22,25,47
098 Tramin a.d. Weinstr.,64,,19,22,41
098 Tramin a.d. Weinstr.,65,,22,20,42
098 Tramin a.d. Weinstr.,66,,15,24,39
098 Tramin a.d. Weinstr.,67,,21,16,37
098 Tramin a.d. Weinstr.,68,,13,12,25
098 Tramin a.d. Weinstr.,69,,7,19,26
098 Tramin a.d. Weinstr.,70,,13,14,27
098 Tramin a.d. Weinstr.,71,,13,13,26
098 Tramin a.d. Weinstr.,72,,15,13,28
098 Tramin a.d. Weinstr.,73,,9,12,21
098 Tramin a.d. Weinstr.,74,,9,13,22
098 Tramin a.d. Weinstr.,75,,11,18,29
098 Tramin a.d. Weinstr.,76,,6,17,23
098 Tramin a.d. Weinstr.,77,,18,14,32
098 Tramin a.d. Weinstr.,78,,9,14,23
098 Tramin a.d. Weinstr.,79,,13,15,28
098 Tramin a.d. Weinstr.,80,,15,12,27
098 Tramin a.d. Weinstr.,81,,13,17,30
098 Tramin a.d. Weinstr.,82,,9,17,26
098 Tramin a.d. Weinstr.,83,,6,14,20
098 Tramin a.d. Weinstr.,84,,6,15,21
098 Tramin a.d. Weinstr.,85,,3,7,10
098 Tramin a.d. Weinstr.,86,,7,8,15
098 Tramin a.d. Weinstr.,87,,5,7,12
098 Tramin a.d. Weinstr.,88,,2,9,11
098 Tramin a.d. Weinstr.,89,,2,1,3
098 Tramin a.d. Weinstr.,90,,1,3,4
098 Tramin a.d. Weinstr.,91,,1,-,1
098 Tramin a.d. Weinstr.,92,,-,4,4
098 Tramin a.d. Weinstr.,93,,-,4,4
098 Tramin a.d. Weinstr.,94,,1,-,1
098 Tramin a.d. Weinstr.,95,,1,1,2
098 Tramin a.d. Weinstr.,96,,-,2,2
098 Tramin a.d. Weinstr.,97,,1,1,2
099 Tisens,0,,9,9,18
099 Tisens,1,,8,7,15
099 Tisens,2,,8,14,22
099 Tisens,3,,13,12,25
099 Tisens,4,,10,10,20
099 Tisens,5,,11,9,20
099 Tisens,6,,10,15,25
099 Tisens,7,,10,10,20
099 Tisens,8,,11,8,19
099 Tisens,9,,11,15,26
099 Tisens,10,,4,7,11
099 Tisens,11,,11,7,18
099 Tisens,12,,10,6,16
099 Tisens,13,,11,11,22
099 Tisens,14,,5,8,13
099 Tisens,15,,6,16,22
099 Tisens,16,,17,9,26
099 Tisens,17,,10,14,24
099 Tisens,18,,10,8,18
099 Tisens,19,,7,12,19
099 Tisens,20,,14,8,22
099 Tisens,21,,13,6,19
099 Tisens,22,,9,5,14
099 Tisens,23,,10,13,23
099 Tisens,24,,19,5,24
099 Tisens,25,,11,15,26
099 Tisens,26,,7,20,27
099 Tisens,27,,15,10,25
099 Tisens,28,,11,10,21
099 Tisens,29,,12,14,26
099 Tisens,30,,10,8,18
099 Tisens,31,,10,6,16
099 Tisens,32,,14,10,24
099 Tisens,33,,12,10,22
099 Tisens,34,,9,10,19
099 Tisens,35,,9,16,25
099 Tisens,36,,20,14,34
099 Tisens,37,,15,19,34
099 Tisens,38,,17,15,32
099 Tisens,39,,17,19,36
099 Tisens,40,,19,22,41
099 Tisens,41,,22,11,33
099 Tisens,42,,16,26,42
099 Tisens,43,,16,7,23
099 Tisens,44,,18,14,32
099 Tisens,45,,23,6,29
099 Tisens,46,,12,12,24
099 Tisens,47,,18,6,24
099 Tisens,48,,13,13,26
099 Tisens,49,,10,15,25
099 Tisens,50,,16,18,34
099 Tisens,51,,9,12,21
099 Tisens,52,,18,14,32
099 Tisens,53,,10,8,18
099 Tisens,54,,10,11,21
099 Tisens,55,,7,13,20
099 Tisens,56,,10,10,20
099 Tisens,57,,9,7,16
099 Tisens,58,,5,7,12
099 Tisens,59,,15,8,23
099 Tisens,60,,9,9,18
099 Tisens,61,,8,6,14
099 Tisens,62,,3,7,10
099 Tisens,63,,10,11,21
099 Tisens,64,,11,10,21
099 Tisens,65,,8,10,18
099 Tisens,66,,7,14,21
099 Tisens,67,,7,8,15
099 Tisens,68,,12,9,21
099 Tisens,69,,7,12,19
099 Tisens,70,,6,4,10
099 Tisens,71,,6,8,14
099 Tisens,72,,4,11,15
099 Tisens,73,,7,6,13
099 Tisens,74,,2,10,12
099 Tisens,75,,5,9,14
099 Tisens,76,,6,9,15
099 Tisens,77,,3,15,18
099 Tisens,78,,6,9,15
099 Tisens,79,,7,11,18
099 Tisens,80,,6,9,15
099 Tisens,81,,5,9,14
099 Tisens,82,,4,7,11
099 Tisens,83,,1,3,4
099 Tisens,84,,1,9,10
099 Tisens,85,,4,4,8
099 Tisens,86,,4,6,10
099 Tisens,87,,2,3,5
099 Tisens,88,,2,5,7
099 Tisens,91,,1,2,3
099 Tisens,92,,1,3,4
099 Tisens,93,,1,1,2
099 Tisens,95,,-,2,2
099 Tisens,96,,-,2,2
099 Tisens,99,,-,1,1
100 Tiers,0,,9,4,13
100 Tiers,1,,2,10,12
100 Tiers,2,,2,10,12
100 Tiers,3,,4,3,7
100 Tiers,4,,4,8,12
100 Tiers,5,,6,4,10
100 Tiers,6,,3,8,11
100 Tiers,7,,2,8,10
100 Tiers,8,,4,9,13
100 Tiers,9,,5,10,15
100 Tiers,10,,9,6,15
100 Tiers,11,,7,4,11
100 Tiers,12,,7,10,17
100 Tiers,13,,5,7,12
100 Tiers,14,,4,3,7
100 Tiers,15,,6,3,9
100 Tiers,16,,6,3,9
100 Tiers,17,,7,5,12
100 Tiers,18,,4,7,11
100 Tiers,19,,6,9,15
100 Tiers,20,,6,4,10
100 Tiers,21,,8,7,15
100 Tiers,22,,5,6,11
100 Tiers,23,,4,9,13
100 Tiers,24,,6,6,12
100 Tiers,25,,5,6,11
100 Tiers,26,,5,5,10
100 Tiers,27,,4,5,9
100 Tiers,28,,1,6,7
100 Tiers,29,,9,11,20
100 Tiers,30,,6,3,9
100 Tiers,31,,-,6,6
100 Tiers,32,,9,4,13
100 Tiers,33,,4,10,14
100 Tiers,34,,8,8,16
100 Tiers,35,,9,7,16
100 Tiers,36,,5,7,12
100 Tiers,37,,7,8,15
100 Tiers,38,,14,11,25
100 Tiers,39,,5,4,9
100 Tiers,40,,10,13,23
100 Tiers,41,,10,6,16
100 Tiers,42,,7,6,13
100 Tiers,43,,9,4,13
100 Tiers,44,,7,10,17
100 Tiers,45,,6,7,13
100 Tiers,46,,7,4,11
100 Tiers,47,,4,8,12
100 Tiers,48,,12,5,17
100 Tiers,49,,7,4,11
100 Tiers,50,,6,9,15
100 Tiers,51,,10,8,18
100 Tiers,52,,5,3,8
100 Tiers,53,,7,5,12
100 Tiers,54,,6,4,10
100 Tiers,55,,3,2,5
100 Tiers,56,,1,4,5
100 Tiers,57,,7,4,11
100 Tiers,58,,3,6,9
100 Tiers,59,,4,5,9
100 Tiers,60,,3,3,6
100 Tiers,61,,6,4,10
100 Tiers,62,,8,3,11
100 Tiers,63,,2,5,7
100 Tiers,64,,8,10,18
100 Tiers,65,,2,5,7
100 Tiers,66,,4,6,10
100 Tiers,67,,2,3,5
100 Tiers,68,,5,6,11
100 Tiers,69,,6,5,11
100 Tiers,70,,6,5,11
100 Tiers,71,,4,6,10
100 Tiers,72,,7,2,9
100 Tiers,73,,2,5,7
100 Tiers,74,,5,3,8
100 Tiers,75,,2,5,7
100 Tiers,76,,5,2,7
100 Tiers,77,,3,-,3
100 Tiers,78,,2,2,4
100 Tiers,79,,3,3,6
100 Tiers,80,,4,3,7
100 Tiers,81,,4,2,6
100 Tiers,82,,6,2,8
100 Tiers,83,,1,3,4
100 Tiers,84,,1,2,3
100 Tiers,85,,2,1,3
100 Tiers,86,,1,6,7
100 Tiers,87,,2,2,4
100 Tiers,88,,-,1,1
100 Tiers,89,,-,1,1
100 Tiers,90,,-,1,1
100 Tiers,92,,1,1,2
100 Tiers,94,,-,2,2
100 Tiers,95,,-,2,2
101 Tirol,0,,15,9,24
101 Tirol,1,,7,10,17
101 Tirol,2,,12,5,17
101 Tirol,3,,13,17,30
101 Tirol,4,,12,12,24
101 Tirol,5,,15,10,25
101 Tirol,6,,16,9,25
101 Tirol,7,,20,11,31
101 Tirol,8,,13,16,29
101 Tirol,9,,16,12,28
101 Tirol,10,,19,23,42
101 Tirol,11,,19,16,35
101 Tirol,12,,8,16,24
101 Tirol,13,,14,14,28
101 Tirol,14,,20,9,29
101 Tirol,15,,13,13,26
101 Tirol,16,,8,8,16
101 Tirol,17,,16,12,28
101 Tirol,18,,12,18,30
101 Tirol,19,,12,14,26
101 Tirol,20,,16,9,25
101 Tirol,21,,11,13,24
101 Tirol,22,,10,15,25
101 Tirol,23,,19,11,30
101 Tirol,24,,20,16,36
101 Tirol,25,,13,11,24
101 Tirol,26,,20,21,41
101 Tirol,27,,21,10,31
101 Tirol,28,,17,6,23
101 Tirol,29,,6,11,17
101 Tirol,30,,15,18,33
101 Tirol,31,,14,13,27
101 Tirol,32,,18,14,32
101 Tirol,33,,14,21,35
101 Tirol,34,,24,17,41
101 Tirol,35,,25,16,41
101 Tirol,36,,20,15,35
101 Tirol,37,,18,16,34
101 Tirol,38,,20,17,37
101 Tirol,39,,24,24,48
101 Tirol,40,,23,19,42
101 Tirol,41,,22,18,40
101 Tirol,42,,21,17,38
101 Tirol,43,,30,24,54
101 Tirol,44,,19,13,32
101 Tirol,45,,17,16,33
101 Tirol,46,,17,22,39
101 Tirol,47,,23,13,36
101 Tirol,48,,17,12,29
101 Tirol,49,,12,18,30
101 Tirol,50,,15,18,33
101 Tirol,51,,8,15,23
101 Tirol,52,,14,16,30
101 Tirol,53,,13,17,30
101 Tirol,54,,20,19,39
101 Tirol,55,,14,12,26
101 Tirol,56,,16,18,34
101 Tirol,57,,14,10,24
101 Tirol,58,,17,16,33
101 Tirol,59,,21,15,36
101 Tirol,60,,9,14,23
101 Tirol,61,,14,8,22
101 Tirol,62,,12,14,26
101 Tirol,63,,16,16,32
101 Tirol,64,,12,13,25
101 Tirol,65,,13,17,30
101 Tirol,66,,12,17,29
101 Tirol,67,,9,14,23
101 Tirol,68,,11,11,22
101 Tirol,69,,8,9,17
101 Tirol,70,,9,14,23
101 Tirol,71,,6,11,17
101 Tirol,72,,9,9,18
101 Tirol,73,,13,7,20
101 Tirol,74,,6,10,16
101 Tirol,75,,8,7,15
101 Tirol,76,,7,8,15
101 Tirol,77,,4,7,11
101 Tirol,78,,7,14,21
101 Tirol,79,,6,9,15
101 Tirol,80,,8,7,15
101 Tirol,81,,4,7,11
101 Tirol,82,,6,8,14
101 Tirol,83,,6,9,15
101 Tirol,84,,3,4,7
101 Tirol,85,,3,5,8
101 Tirol,86,,5,4,9
101 Tirol,87,,2,5,7
101 Tirol,88,,2,3,5
101 Tirol,89,,1,2,3
101 Tirol,91,,1,-,1
101 Tirol,93,,1,2,3
101 Tirol,95,,-,1,1
101 Tirol,96,,-,1,1
102 Truden im Naturpark,0,,10,5,15
102 Truden im Naturpark,1,,3,2,5
102 Truden im Naturpark,2,,1,5,6
102 Truden im Naturpark,3,,2,9,11
102 Truden im Naturpark,4,,6,3,9
102 Truden im Naturpark,5,,-,3,3
102 Truden im Naturpark,6,,5,2,7
102 Truden im Naturpark,7,,6,7,13
102 Truden im Naturpark,8,,1,3,4
102 Truden im Naturpark,9,,2,7,9
102 Truden im Naturpark,10,,7,5,12
102 Truden im Naturpark,11,,6,6,12
102 Truden im Naturpark,12,,4,6,10
102 Truden im Naturpark,13,,5,5,10
102 Truden im Naturpark,14,,11,4,15
102 Truden im Naturpark,15,,7,5,12
102 Truden im Naturpark,16,,8,7,15
102 Truden im Naturpark,17,,4,5,9
102 Truden im Naturpark,18,,9,8,17
102 Truden im Naturpark,19,,9,13,22
102 Truden im Naturpark,20,,5,5,10
102 Truden im Naturpark,21,,1,7,8
102 Truden im Naturpark,22,,8,6,14
102 Truden im Naturpark,23,,11,4,15
102 Truden im Naturpark,24,,6,5,11
102 Truden im Naturpark,25,,12,3,15
102 Truden im Naturpark,26,,3,10,13
102 Truden im Naturpark,27,,5,3,8
102 Truden im Naturpark,28,,9,7,16
102 Truden im Naturpark,29,,8,7,15
102 Truden im Naturpark,30,,3,5,8
102 Truden im Naturpark,31,,10,4,14
102 Truden im Naturpark,32,,7,3,10
102 Truden im Naturpark,33,,4,9,13
102 Truden im Naturpark,34,,7,8,15
102 Truden im Naturpark,35,,8,9,17
102 Truden im Naturpark,36,,4,3,7
102 Truden im Naturpark,37,,1,7,8
102 Truden im Naturpark,38,,9,7,16
102 Truden im Naturpark,39,,5,9,14
102 Truden im Naturpark,40,,11,6,17
102 Truden im Naturpark,41,,7,7,14
102 Truden im Naturpark,42,,8,8,16
102 Truden im Naturpark,43,,8,8,16
102 Truden im Naturpark,44,,11,6,17
102 Truden im Naturpark,45,,8,4,12
102 Truden im Naturpark,46,,8,6,14
102 Truden im Naturpark,47,,8,13,21
102 Truden im Naturpark,48,,7,9,16
102 Truden im Naturpark,49,,5,11,16
102 Truden im Naturpark,50,,6,10,16
102 Truden im Naturpark,51,,7,5,12
102 Truden im Naturpark,52,,8,10,18
102 Truden im Naturpark,53,,5,6,11
102 Truden im Naturpark,54,,9,5,14
102 Truden im Naturpark,55,,5,6,11
102 Truden im Naturpark,56,,8,6,14
102 Truden im Naturpark,57,,3,2,5
102 Truden im Naturpark,58,,5,3,8
102 Truden im Naturpark,59,,1,6,7
102 Truden im Naturpark,60,,6,1,7
102 Truden im Naturpark,61,,7,6,13
102 Truden im Naturpark,62,,5,2,7
102 Truden im Naturpark,63,,3,5,8
102 Truden im Naturpark,64,,4,5,9
102 Truden im Naturpark,65,,4,4,8
102 Truden im Naturpark,66,,4,5,9
102 Truden im Naturpark,67,,2,4,6
102 Truden im Naturpark,68,,8,2,10
102 Truden im Naturpark,69,,5,7,12
102 Truden im Naturpark,70,,3,4,7
102 Truden im Naturpark,71,,4,3,7
102 Truden im Naturpark,72,,3,3,6
102 Truden im Naturpark,73,,5,-,5
102 Truden im Naturpark,74,,6,7,13
102 Truden im Naturpark,75,,3,3,6
102 Truden im Naturpark,76,,5,4,9
102 Truden im Naturpark,77,,2,8,10
102 Truden im Naturpark,78,,-,6,6
102 Truden im Naturpark,79,,-,6,6
102 Truden im Naturpark,80,,4,6,10
102 Truden im Naturpark,81,,2,7,9
102 Truden im Naturpark,82,,-,5,5
102 Truden im Naturpark,83,,-,7,7
102 Truden im Naturpark,84,,1,6,7
102 Truden im Naturpark,85,,2,4,6
102 Truden im Naturpark,86,,1,3,4
102 Truden im Naturpark,87,,-,2,2
102 Truden im Naturpark,88,,1,4,5
102 Truden im Naturpark,89,,-,1,1
103 Taufers im Münstertal,0,,6,8,14
103 Taufers im Münstertal,1,,4,7,11
103 Taufers im Münstertal,2,,1,5,6
103 Taufers im Münstertal,3,,6,5,11
103 Taufers im Münstertal,4,,5,3,8
103 Taufers im Münstertal,5,,5,5,10
103 Taufers im Münstertal,6,,5,6,11
103 Taufers im Münstertal,7,,5,4,9
103 Taufers im Münstertal,8,,3,3,6
103 Taufers im Münstertal,9,,7,8,15
103 Taufers im Münstertal,10,,4,4,8
103 Taufers im Münstertal,11,,6,4,10
103 Taufers im Münstertal,12,,9,9,18
103 Taufers im Münstertal,13,,6,8,14
103 Taufers im Münstertal,14,,3,5,8
103 Taufers im Münstertal,15,,9,8,17
103 Taufers im Münstertal,16,,6,10,16
103 Taufers im Münstertal,17,,9,7,16
103 Taufers im Münstertal,18,,8,3,11
103 Taufers im Münstertal,19,,6,8,14
103 Taufers im Münstertal,20,,4,6,10
103 Taufers im Münstertal,21,,6,5,11
103 Taufers im Münstertal,22,,5,4,9
103 Taufers im Münstertal,23,,4,8,12
103 Taufers im Münstertal,24,,5,6,11
103 Taufers im Münstertal,25,,5,9,14
103 Taufers im Münstertal,26,,8,5,13
103 Taufers im Münstertal,27,,11,6,17
103 Taufers im Münstertal,28,,5,4,9
103 Taufers im Münstertal,29,,9,3,12
103 Taufers im Münstertal,30,,5,3,8
103 Taufers im Münstertal,31,,3,6,9
103 Taufers im Münstertal,32,,9,6,15
103 Taufers im Münstertal,33,,5,7,12
103 Taufers im Münstertal,34,,1,6,7
103 Taufers im Münstertal,35,,4,7,11
103 Taufers im Münstertal,36,,6,15,21
103 Taufers im Münstertal,37,,6,8,14
103 Taufers im Münstertal,38,,11,5,16
103 Taufers im Münstertal,39,,11,10,21
103 Taufers im Münstertal,40,,4,4,8
103 Taufers im Münstertal,41,,6,10,16
103 Taufers im Münstertal,42,,11,7,18
103 Taufers im Münstertal,43,,7,13,20
103 Taufers im Münstertal,44,,9,9,18
103 Taufers im Münstertal,45,,10,8,18
103 Taufers im Münstertal,46,,10,7,17
103 Taufers im Münstertal,47,,13,6,19
103 Taufers im Münstertal,48,,6,10,16
103 Taufers im Münstertal,49,,5,6,11
103 Taufers im Münstertal,50,,9,7,16
103 Taufers im Münstertal,51,,10,10,20
103 Taufers im Münstertal,52,,4,3,7
103 Taufers im Münstertal,53,,4,6,10
103 Taufers im Münstertal,54,,7,4,11
103 Taufers im Münstertal,55,,6,2,8
103 Taufers im Münstertal,56,,5,4,9
103 Taufers im Münstertal,57,,7,1,8
103 Taufers im Münstertal,58,,6,1,7
103 Taufers im Münstertal,59,,5,1,6
103 Taufers im Münstertal,60,,3,7,10
103 Taufers im Münstertal,61,,3,3,6
103 Taufers im Münstertal,62,,3,4,7
103 Taufers im Münstertal,63,,1,-,1
103 Taufers im Münstertal,64,,6,5,11
103 Taufers im Münstertal,65,,4,5,9
103 Taufers im Münstertal,66,,3,7,10
103 Taufers im Münstertal,67,,3,3,6
103 Taufers im Münstertal,68,,5,4,9
103 Taufers im Münstertal,69,,7,9,16
103 Taufers im Münstertal,70,,3,4,7
103 Taufers im Münstertal,71,,2,9,11
103 Taufers im Münstertal,72,,4,2,6
103 Taufers im Münstertal,73,,3,8,11
103 Taufers im Münstertal,74,,4,5,9
103 Taufers im Münstertal,75,,5,1,6
103 Taufers im Münstertal,76,,8,3,11
103 Taufers im Münstertal,77,,2,3,5
103 Taufers im Münstertal,78,,4,6,10
103 Taufers im Münstertal,79,,3,3,6
103 Taufers im Münstertal,80,,3,3,6
103 Taufers im Münstertal,81,,2,4,6
103 Taufers im Münstertal,82,,1,5,6
103 Taufers im Münstertal,83,,-,6,6
103 Taufers im Münstertal,84,,3,2,5
103 Taufers im Münstertal,85,,1,2,3
103 Taufers im Münstertal,86,,1,-,1
103 Taufers im Münstertal,87,,3,1,4
103 Taufers im Münstertal,88,,1,-,1
103 Taufers im Münstertal,89,,-,2,2
103 Taufers im Münstertal,90,,1,2,3
103 Taufers im Münstertal,92,,-,1,1
103 Taufers im Münstertal,93,,1,-,1
103 Taufers im Münstertal,94,,-,1,1
103 Taufers im Münstertal,95,,-,2,2
103 Taufers im Münstertal,98,,-,1,1
104 Ulten,0,,8,10,18
104 Ulten,1,,14,10,24
104 Ulten,2,,17,22,39
104 Ulten,3,,16,12,28
104 Ulten,4,,21,19,40
104 Ulten,5,,15,19,34
104 Ulten,6,,19,17,36
104 Ulten,7,,18,16,34
104 Ulten,8,,14,15,29
104 Ulten,9,,16,16,32
104 Ulten,10,,14,19,33
104 Ulten,11,,11,14,25
104 Ulten,12,,12,16,28
104 Ulten,13,,20,15,35
104 Ulten,14,,23,14,37
104 Ulten,15,,17,17,34
104 Ulten,16,,23,31,54
104 Ulten,17,,16,18,34
104 Ulten,18,,17,28,45
104 Ulten,19,,16,20,36
104 Ulten,20,,19,17,36
104 Ulten,21,,21,10,31
104 Ulten,22,,15,16,31
104 Ulten,23,,20,21,41
104 Ulten,24,,22,16,38
104 Ulten,25,,16,20,36
104 Ulten,26,,20,18,38
104 Ulten,27,,18,19,37
104 Ulten,28,,18,15,33
104 Ulten,29,,21,14,35
104 Ulten,30,,22,15,37
104 Ulten,31,,17,18,35
104 Ulten,32,,24,21,45
104 Ulten,33,,19,24,43
104 Ulten,34,,27,13,40
104 Ulten,35,,23,19,42
104 Ulten,36,,27,20,47
104 Ulten,37,,22,24,46
104 Ulten,38,,29,22,51
104 Ulten,39,,28,25,53
104 Ulten,40,,17,21,38
104 Ulten,41,,21,17,38
104 Ulten,42,,28,26,54
104 Ulten,43,,23,20,43
104 Ulten,44,,28,26,54
104 Ulten,45,,30,22,52
104 Ulten,46,,28,17,45
104 Ulten,47,,25,20,45
104 Ulten,48,,23,23,46
104 Ulten,49,,26,16,42
104 Ulten,50,,34,22,56
104 Ulten,51,,17,16,33
104 Ulten,52,,13,12,25
104 Ulten,53,,18,16,34
104 Ulten,54,,24,13,37
104 Ulten,55,,18,13,31
104 Ulten,56,,19,17,36
104 Ulten,57,,19,14,33
104 Ulten,58,,17,10,27
104 Ulten,59,,13,12,25
104 Ulten,60,,16,9,25
104 Ulten,61,,15,15,30
104 Ulten,62,,9,13,22
104 Ulten,63,,14,20,34
104 Ulten,64,,17,16,33
104 Ulten,65,,9,16,25
104 Ulten,66,,12,10,22
104 Ulten,67,,16,9,25
104 Ulten,68,,19,16,35
104 Ulten,69,,6,10,16
104 Ulten,70,,10,10,20
104 Ulten,71,,8,9,17
104 Ulten,72,,10,11,21
104 Ulten,73,,10,13,23
104 Ulten,74,,5,14,19
104 Ulten,75,,11,8,19
104 Ulten,76,,10,8,18
104 Ulten,77,,12,17,29
104 Ulten,78,,4,12,16
104 Ulten,79,,9,14,23
104 Ulten,80,,6,17,23
104 Ulten,81,,5,13,18
104 Ulten,82,,13,12,25
104 Ulten,83,,7,11,18
104 Ulten,84,,7,22,29
104 Ulten,85,,4,7,11
104 Ulten,86,,8,9,17
104 Ulten,87,,6,10,16
104 Ulten,88,,1,11,12
104 Ulten,89,,3,-,3
104 Ulten,90,,1,1,2
104 Ulten,91,,-,1,1
104 Ulten,92,,2,1,3
104 Ulten,93,,-,2,2
104 Ulten,94,,-,1,1
104 Ulten,96,,1,4,5
104 Ulten,97,,-,1,1
104 Ulten,109,,-,1,1
105 Pfatten,0,,8,3,11
105 Pfatten,1,,8,5,13
105 Pfatten,2,,6,13,19
105 Pfatten,3,,2,6,8
105 Pfatten,4,,13,5,18
105 Pfatten,5,,4,6,10
105 Pfatten,6,,4,3,7
105 Pfatten,7,,7,6,13
105 Pfatten,8,,4,6,10
105 Pfatten,9,,10,5,15
105 Pfatten,10,,5,3,8
105 Pfatten,11,,4,8,12
105 Pfatten,12,,5,7,12
105 Pfatten,13,,9,10,19
105 Pfatten,14,,5,5,10
105 Pfatten,15,,6,7,13
105 Pfatten,16,,8,5,13
105 Pfatten,17,,10,7,17
105 Pfatten,18,,6,5,11
105 Pfatten,19,,1,6,7
105 Pfatten,20,,7,4,11
105 Pfatten,21,,5,10,15
105 Pfatten,22,,4,7,11
105 Pfatten,23,,2,7,9
105 Pfatten,24,,3,8,11
105 Pfatten,25,,5,2,7
105 Pfatten,26,,10,3,13
105 Pfatten,27,,2,7,9
105 Pfatten,28,,8,9,17
105 Pfatten,29,,6,9,15
105 Pfatten,30,,8,4,12
105 Pfatten,31,,5,8,13
105 Pfatten,32,,3,13,16
105 Pfatten,33,,13,10,23
105 Pfatten,34,,11,6,17
105 Pfatten,35,,9,11,20
105 Pfatten,36,,12,8,20
105 Pfatten,37,,13,7,20
105 Pfatten,38,,8,5,13
105 Pfatten,39,,10,8,18
105 Pfatten,40,,14,6,20
105 Pfatten,41,,10,8,18
105 Pfatten,42,,12,10,22
105 Pfatten,43,,9,4,13
105 Pfatten,44,,7,10,17
105 Pfatten,45,,10,14,24
105 Pfatten,46,,11,16,27
105 Pfatten,47,,7,8,15
105 Pfatten,48,,6,12,18
105 Pfatten,49,,7,7,14
105 Pfatten,50,,16,5,21
105 Pfatten,51,,10,8,18
105 Pfatten,52,,5,5,10
105 Pfatten,53,,11,2,13
105 Pfatten,54,,6,5,11
105 Pfatten,55,,1,8,9
105 Pfatten,56,,3,5,8
105 Pfatten,57,,6,6,12
105 Pfatten,58,,9,2,11
105 Pfatten,59,,3,2,5
105 Pfatten,60,,7,7,14
105 Pfatten,61,,5,4,9
105 Pfatten,62,,6,3,9
105 Pfatten,63,,5,2,7
105 Pfatten,64,,2,3,5
105 Pfatten,65,,4,3,7
105 Pfatten,66,,5,6,11
105 Pfatten,67,,3,4,7
105 Pfatten,68,,4,3,7
105 Pfatten,69,,2,2,4
105 Pfatten,70,,4,1,5
105 Pfatten,71,,3,4,7
105 Pfatten,72,,7,3,10
105 Pfatten,73,,4,6,10
105 Pfatten,74,,1,2,3
105 Pfatten,75,,-,5,5
105 Pfatten,76,,2,4,6
105 Pfatten,77,,2,2,4
105 Pfatten,78,,-,6,6
105 Pfatten,79,,-,1,1
105 Pfatten,81,,3,2,5
105 Pfatten,82,,1,3,4
105 Pfatten,83,,1,3,4
105 Pfatten,84,,3,1,4
105 Pfatten,85,,2,-,2
105 Pfatten,86,,-,1,1
105 Pfatten,87,,1,1,2
105 Pfatten,88,,1,-,1
105 Pfatten,89,,-,1,1
105 Pfatten,90,,1,1,2
105 Pfatten,91,,-,1,1
105 Pfatten,95,,-,1,1
106 Olang,0,,13,19,32
106 Olang,1,,7,19,26
106 Olang,2,,22,11,33
106 Olang,3,,16,12,28
106 Olang,4,,19,11,30
106 Olang,5,,16,14,30
106 Olang,6,,19,21,40
106 Olang,7,,18,21,39
106 Olang,8,,17,17,34
106 Olang,9,,18,23,41
106 Olang,10,,24,17,41
106 Olang,11,,25,22,47
106 Olang,12,,19,10,29
106 Olang,13,,21,11,32
106 Olang,14,,21,24,45
106 Olang,15,,16,17,33
106 Olang,16,,25,20,45
106 Olang,17,,23,23,46
106 Olang,18,,22,20,42
106 Olang,19,,15,19,34
106 Olang,20,,26,21,47
106 Olang,21,,15,18,33
106 Olang,22,,12,23,35
106 Olang,23,,23,14,37
106 Olang,24,,15,19,34
106 Olang,25,,21,26,47
106 Olang,26,,13,21,34
106 Olang,27,,22,26,48
106 Olang,28,,19,23,42
106 Olang,29,,19,19,38
106 Olang,30,,29,31,60
106 Olang,31,,20,24,44
106 Olang,32,,27,28,55
106 Olang,33,,16,29,45
106 Olang,34,,27,24,51
106 Olang,35,,26,18,44
106 Olang,36,,30,22,52
106 Olang,37,,22,21,43
106 Olang,38,,21,30,51
106 Olang,39,,27,25,52
106 Olang,40,,33,22,55
106 Olang,41,,33,25,58
106 Olang,42,,19,25,44
106 Olang,43,,21,29,50
106 Olang,44,,22,23,45
106 Olang,45,,25,14,39
106 Olang,46,,15,27,42
106 Olang,47,,21,25,46
106 Olang,48,,27,16,43
106 Olang,49,,22,13,35
106 Olang,50,,26,12,38
106 Olang,51,,15,28,43
106 Olang,52,,17,19,36
106 Olang,53,,15,20,35
106 Olang,54,,16,20,36
106 Olang,55,,17,13,30
106 Olang,56,,9,13,22
106 Olang,57,,33,16,49
106 Olang,58,,22,11,33
106 Olang,59,,19,22,41
106 Olang,60,,14,23,37
106 Olang,61,,16,13,29
106 Olang,62,,18,10,28
106 Olang,63,,15,6,21
106 Olang,64,,12,16,28
106 Olang,65,,14,17,31
106 Olang,66,,13,13,26
106 Olang,67,,16,9,25
106 Olang,68,,12,8,20
106 Olang,69,,7,14,21
106 Olang,70,,7,9,16
106 Olang,71,,6,8,14
106 Olang,72,,7,15,22
106 Olang,73,,11,8,19
106 Olang,74,,9,15,24
106 Olang,75,,10,10,20
106 Olang,76,,3,6,9
106 Olang,77,,13,7,20
106 Olang,78,,8,13,21
106 Olang,79,,4,7,11
106 Olang,80,,5,8,13
106 Olang,81,,3,11,14
106 Olang,82,,3,4,7
106 Olang,83,,3,7,10
106 Olang,84,,4,2,6
106 Olang,85,,2,5,7
106 Olang,86,,3,2,5
106 Olang,87,,1,5,6
106 Olang,88,,1,1,2
106 Olang,90,,-,2,2
106 Olang,91,,-,1,1
106 Olang,92,,1,3,4
106 Olang,93,,1,2,3
106 Olang,96,,-,1,1
107 Pfitsch,0,,15,10,25
107 Pfitsch,1,,25,12,37
107 Pfitsch,2,,20,18,38
107 Pfitsch,3,,19,11,30
107 Pfitsch,4,,17,12,29
107 Pfitsch,5,,22,19,41
107 Pfitsch,6,,11,11,22
107 Pfitsch,7,,23,27,50
107 Pfitsch,8,,17,16,33
107 Pfitsch,9,,13,17,30
107 Pfitsch,10,,15,14,29
107 Pfitsch,11,,12,13,25
107 Pfitsch,12,,18,10,28
107 Pfitsch,13,,16,20,36
107 Pfitsch,14,,14,16,30
107 Pfitsch,15,,15,16,31
107 Pfitsch,16,,21,14,35
107 Pfitsch,17,,20,16,36
107 Pfitsch,18,,8,19,27
107 Pfitsch,19,,16,14,30
107 Pfitsch,20,,13,18,31
107 Pfitsch,21,,14,9,23
107 Pfitsch,22,,17,10,27
107 Pfitsch,23,,23,14,37
107 Pfitsch,24,,21,26,47
107 Pfitsch,25,,29,16,45
107 Pfitsch,26,,21,19,40
107 Pfitsch,27,,18,19,37
107 Pfitsch,28,,30,16,46
107 Pfitsch,29,,26,20,46
107 Pfitsch,30,,17,19,36
107 Pfitsch,31,,20,25,45
107 Pfitsch,32,,20,26,46
107 Pfitsch,33,,16,20,36
107 Pfitsch,34,,16,21,37
107 Pfitsch,35,,22,19,41
107 Pfitsch,36,,30,14,44
107 Pfitsch,37,,21,19,40
107 Pfitsch,38,,26,24,50
107 Pfitsch,39,,24,21,45
107 Pfitsch,40,,18,17,35
107 Pfitsch,41,,29,16,45
107 Pfitsch,42,,19,22,41
107 Pfitsch,43,,15,27,42
107 Pfitsch,44,,22,20,42
107 Pfitsch,45,,25,19,44
107 Pfitsch,46,,22,21,43
107 Pfitsch,47,,16,24,40
107 Pfitsch,48,,16,18,34
107 Pfitsch,49,,24,15,39
107 Pfitsch,50,,24,23,47
107 Pfitsch,51,,18,11,29
107 Pfitsch,52,,14,14,28
107 Pfitsch,53,,23,21,44
107 Pfitsch,54,,21,14,35
107 Pfitsch,55,,19,23,42
107 Pfitsch,56,,23,14,37
107 Pfitsch,57,,20,20,40
107 Pfitsch,58,,15,19,34
107 Pfitsch,59,,8,8,16
107 Pfitsch,60,,10,11,21
107 Pfitsch,61,,14,12,26
107 Pfitsch,62,,11,12,23
107 Pfitsch,63,,11,14,25
107 Pfitsch,64,,22,11,33
107 Pfitsch,65,,20,13,33
107 Pfitsch,66,,13,17,30
107 Pfitsch,67,,14,15,29
107 Pfitsch,68,,14,8,22
107 Pfitsch,69,,5,14,19
107 Pfitsch,70,,6,11,17
107 Pfitsch,71,,8,12,20
107 Pfitsch,72,,6,7,13
107 Pfitsch,73,,11,5,16
107 Pfitsch,74,,13,12,25
107 Pfitsch,75,,4,13,17
107 Pfitsch,76,,8,10,18
107 Pfitsch,77,,4,11,15
107 Pfitsch,78,,15,10,25
107 Pfitsch,79,,5,12,17
107 Pfitsch,80,,7,10,17
107 Pfitsch,81,,3,9,12
107 Pfitsch,82,,9,9,18
107 Pfitsch,83,,-,16,16
107 Pfitsch,84,,4,10,14
107 Pfitsch,85,,4,4,8
107 Pfitsch,86,,4,7,11
107 Pfitsch,87,,-,4,4
107 Pfitsch,88,,2,2,4
107 Pfitsch,89,,-,1,1
107 Pfitsch,90,,1,3,4
107 Pfitsch,91,,1,1,2
107 Pfitsch,92,,2,1,3
107 Pfitsch,95,,-,1,1
107 Pfitsch,96,,-,1,1
107 Pfitsch,97,,-,1,1
108 Ahrntal,0,,37,41,78
108 Ahrntal,1,,41,34,75
108 Ahrntal,2,,34,36,70
108 Ahrntal,3,,31,38,69
108 Ahrntal,4,,33,39,72
108 Ahrntal,5,,31,35,66
108 Ahrntal,6,,32,31,63
108 Ahrntal,7,,49,41,90
108 Ahrntal,8,,33,37,70
108 Ahrntal,9,,36,37,73
108 Ahrntal,10,,41,44,85
108 Ahrntal,11,,39,51,90
108 Ahrntal,12,,36,31,67
108 Ahrntal,13,,27,26,53
108 Ahrntal,14,,40,40,80
108 Ahrntal,15,,41,34,75
108 Ahrntal,16,,26,37,63
108 Ahrntal,17,,41,31,72
108 Ahrntal,18,,38,36,74
108 Ahrntal,19,,27,33,60
108 Ahrntal,20,,37,39,76
108 Ahrntal,21,,39,50,89
108 Ahrntal,22,,36,44,80
108 Ahrntal,23,,41,33,74
108 Ahrntal,24,,45,49,94
108 Ahrntal,25,,43,48,91
108 Ahrntal,26,,51,41,92
108 Ahrntal,27,,38,34,72
108 Ahrntal,28,,40,44,84
108 Ahrntal,29,,36,42,78
108 Ahrntal,30,,53,46,99
108 Ahrntal,31,,50,45,95
108 Ahrntal,32,,40,42,82
108 Ahrntal,33,,49,38,87
108 Ahrntal,34,,46,40,86
108 Ahrntal,35,,55,54,109
108 Ahrntal,36,,69,43,112
108 Ahrntal,37,,51,44,95
108 Ahrntal,38,,52,46,98
108 Ahrntal,39,,50,44,94
108 Ahrntal,40,,44,49,93
108 Ahrntal,41,,58,41,99
108 Ahrntal,42,,60,45,105
108 Ahrntal,43,,54,43,97
108 Ahrntal,44,,50,45,95
108 Ahrntal,45,,38,52,90
108 Ahrntal,46,,36,36,72
108 Ahrntal,47,,41,30,71
108 Ahrntal,48,,43,38,81
108 Ahrntal,49,,48,29,77
108 Ahrntal,50,,26,38,64
108 Ahrntal,51,,36,20,56
108 Ahrntal,52,,36,27,63
108 Ahrntal,53,,34,21,55
108 Ahrntal,54,,27,29,56
108 Ahrntal,55,,27,34,61
108 Ahrntal,56,,33,25,58
108 Ahrntal,57,,31,20,51
108 Ahrntal,58,,32,31,63
108 Ahrntal,59,,28,27,55
108 Ahrntal,60,,25,19,44
108 Ahrntal,61,,17,22,39
108 Ahrntal,62,,19,13,32
108 Ahrntal,63,,19,18,37
108 Ahrntal,64,,22,33,55
108 Ahrntal,65,,28,31,59
108 Ahrntal,66,,30,33,63
108 Ahrntal,67,,31,23,54
108 Ahrntal,68,,25,24,49
108 Ahrntal,69,,35,29,64
108 Ahrntal,70,,25,22,47
108 Ahrntal,71,,20,15,35
108 Ahrntal,72,,18,37,55
108 Ahrntal,73,,19,20,39
108 Ahrntal,74,,17,15,32
108 Ahrntal,75,,18,26,44
108 Ahrntal,76,,27,17,44
108 Ahrntal,77,,18,16,34
108 Ahrntal,78,,14,16,30
108 Ahrntal,79,,12,24,36
108 Ahrntal,80,,15,17,32
108 Ahrntal,81,,13,15,28
108 Ahrntal,82,,7,15,22
108 Ahrntal,83,,10,11,21
108 Ahrntal,84,,6,9,15
108 Ahrntal,85,,4,14,18
108 Ahrntal,86,,4,7,11
108 Ahrntal,87,,2,5,7
108 Ahrntal,88,,7,4,11
108 Ahrntal,89,,-,4,4
108 Ahrntal,90,,1,4,5
108 Ahrntal,91,,1,1,2
108 Ahrntal,92,,1,6,7
108 Ahrntal,93,,1,6,7
108 Ahrntal,94,,-,1,1
108 Ahrntal,97,,1,-,1
108 Ahrntal,100,,-,1,1
108 Ahrntal,102,,-,1,1
109 Gsies,0,,17,11,28
109 Gsies,1,,21,17,38
109 Gsies,2,,15,15,30
109 Gsies,3,,9,12,21
109 Gsies,4,,19,17,36
109 Gsies,5,,12,12,24
109 Gsies,6,,14,14,28
109 Gsies,7,,10,13,23
109 Gsies,8,,27,11,38
109 Gsies,9,,18,5,23
109 Gsies,10,,14,16,30
109 Gsies,11,,10,17,27
109 Gsies,12,,15,16,31
109 Gsies,13,,9,17,26
109 Gsies,14,,17,18,35
109 Gsies,15,,17,10,27
109 Gsies,16,,14,25,39
109 Gsies,17,,17,12,29
109 Gsies,18,,10,13,23
109 Gsies,19,,7,16,23
109 Gsies,20,,20,17,37
109 Gsies,21,,13,16,29
109 Gsies,22,,17,14,31
109 Gsies,23,,14,9,23
109 Gsies,24,,18,10,28
109 Gsies,25,,19,18,37
109 Gsies,26,,16,18,34
109 Gsies,27,,23,22,45
109 Gsies,28,,10,15,25
109 Gsies,29,,15,11,26
109 Gsies,30,,13,17,30
109 Gsies,31,,14,15,29
109 Gsies,32,,17,19,36
109 Gsies,33,,20,18,38
109 Gsies,34,,13,12,25
109 Gsies,35,,9,21,30
109 Gsies,36,,21,17,38
109 Gsies,37,,26,13,39
109 Gsies,38,,25,11,36
109 Gsies,39,,16,15,31
109 Gsies,40,,17,13,30
109 Gsies,41,,15,18,33
109 Gsies,42,,19,5,24
109 Gsies,43,,17,18,35
109 Gsies,44,,14,14,28
109 Gsies,45,,17,8,25
109 Gsies,46,,9,14,23
109 Gsies,47,,16,20,36
109 Gsies,48,,12,14,26
109 Gsies,49,,17,16,33
109 Gsies,50,,12,14,26
109 Gsies,51,,16,7,23
109 Gsies,52,,15,10,25
109 Gsies,53,,16,6,22
109 Gsies,54,,19,6,25
109 Gsies,55,,17,13,30
109 Gsies,56,,15,12,27
109 Gsies,57,,8,8,16
109 Gsies,58,,15,16,31
109 Gsies,59,,7,10,17
109 Gsies,60,,22,6,28
109 Gsies,61,,15,10,25
109 Gsies,62,,4,12,16
109 Gsies,63,,7,13,20
109 Gsies,64,,10,9,19
109 Gsies,65,,5,13,18
109 Gsies,66,,6,11,17
109 Gsies,67,,8,11,19
109 Gsies,68,,6,9,15
109 Gsies,69,,9,8,17
109 Gsies,70,,10,7,17
109 Gsies,71,,4,10,14
109 Gsies,72,,4,8,12
109 Gsies,73,,4,9,13
109 Gsies,74,,6,6,12
109 Gsies,75,,8,4,12
109 Gsies,76,,6,8,14
109 Gsies,77,,10,6,16
109 Gsies,78,,3,5,8
109 Gsies,79,,8,9,17
109 Gsies,80,,1,10,11
109 Gsies,81,,3,4,7
109 Gsies,82,,6,5,11
109 Gsies,83,,4,5,9
109 Gsies,84,,5,6,11
109 Gsies,85,,4,7,11
109 Gsies,86,,2,8,10
109 Gsies,87,,3,2,5
109 Gsies,88,,2,1,3
109 Gsies,89,,-,1,1
109 Gsies,90,,1,1,2
109 Gsies,92,,1,-,1
109 Gsies,94,,-,1,1
109 Gsies,96,,-,1,1
110 Vintl,0,,21,19,40
110 Vintl,1,,12,15,27
110 Vintl,2,,22,23,45
110 Vintl,3,,13,13,26
110 Vintl,4,,14,19,33
110 Vintl,5,,14,20,34
110 Vintl,6,,15,20,35
110 Vintl,7,,22,15,37
110 Vintl,8,,21,24,45
110 Vintl,9,,20,27,47
110 Vintl,10,,20,16,36
110 Vintl,11,,22,19,41
110 Vintl,12,,38,24,62
110 Vintl,13,,18,18,36
110 Vintl,14,,25,21,46
110 Vintl,15,,29,21,50
110 Vintl,16,,22,30,52
110 Vintl,17,,30,21,51
110 Vintl,18,,26,16,42
110 Vintl,19,,22,21,43
110 Vintl,20,,20,24,44
110 Vintl,21,,21,19,40
110 Vintl,22,,10,17,27
110 Vintl,23,,26,10,36
110 Vintl,24,,24,20,44
110 Vintl,25,,22,20,42
110 Vintl,26,,17,24,41
110 Vintl,27,,31,22,53
110 Vintl,28,,31,18,49
110 Vintl,29,,23,34,57
110 Vintl,30,,17,24,41
110 Vintl,31,,20,24,44
110 Vintl,32,,24,18,42
110 Vintl,33,,29,26,55
110 Vintl,34,,19,20,39
110 Vintl,35,,27,17,44
110 Vintl,36,,31,27,58
110 Vintl,37,,19,16,35
110 Vintl,38,,27,23,50
110 Vintl,39,,28,23,51
110 Vintl,40,,30,34,64
110 Vintl,41,,31,30,61
110 Vintl,42,,32,31,63
110 Vintl,43,,35,22,57
110 Vintl,44,,32,26,58
110 Vintl,45,,33,22,55
110 Vintl,46,,29,34,63
110 Vintl,47,,17,22,39
110 Vintl,48,,22,21,43
110 Vintl,49,,21,13,34
110 Vintl,50,,23,27,50
110 Vintl,51,,25,17,42
110 Vintl,52,,18,14,32
110 Vintl,53,,16,17,33
110 Vintl,54,,21,9,30
110 Vintl,55,,16,19,35
110 Vintl,56,,22,16,38
110 Vintl,57,,21,19,40
110 Vintl,58,,17,19,36
110 Vintl,59,,14,13,27
110 Vintl,60,,21,14,35
110 Vintl,61,,17,12,29
110 Vintl,62,,15,19,34
110 Vintl,63,,12,5,17
110 Vintl,64,,21,11,32
110 Vintl,65,,11,11,22
110 Vintl,66,,7,16,23
110 Vintl,67,,8,19,27
110 Vintl,68,,16,16,32
110 Vintl,69,,10,5,15
110 Vintl,70,,10,9,19
110 Vintl,71,,15,11,26
110 Vintl,72,,9,11,20
110 Vintl,73,,15,8,23
110 Vintl,74,,4,18,22
110 Vintl,75,,9,13,22
110 Vintl,76,,9,10,19
110 Vintl,77,,7,15,22
110 Vintl,78,,7,14,21
110 Vintl,79,,7,8,15
110 Vintl,80,,7,13,20
110 Vintl,81,,11,5,16
110 Vintl,82,,3,7,10
110 Vintl,83,,2,7,9
110 Vintl,84,,4,7,11
110 Vintl,85,,3,5,8
110 Vintl,86,,3,4,7
110 Vintl,87,,1,7,8
110 Vintl,88,,2,3,5
110 Vintl,89,,-,1,1
110 Vintl,90,,-,2,2
110 Vintl,91,,1,2,3
110 Vintl,92,,1,3,4
110 Vintl,93,,1,2,3
110 Vintl,95,,1,-,1
110 Vintl,96,,-,1,1
111 Vahrn,0,,32,17,49
111 Vahrn,1,,31,33,64
111 Vahrn,2,,30,28,58
111 Vahrn,3,,30,28,58
111 Vahrn,4,,26,16,42
111 Vahrn,5,,31,31,62
111 Vahrn,6,,26,20,46
111 Vahrn,7,,27,23,50
111 Vahrn,8,,27,35,62
111 Vahrn,9,,23,25,48
111 Vahrn,10,,20,25,45
111 Vahrn,11,,38,20,58
111 Vahrn,12,,22,21,43
111 Vahrn,13,,22,24,46
111 Vahrn,14,,22,21,43
111 Vahrn,15,,21,24,45
111 Vahrn,16,,22,23,45
111 Vahrn,17,,15,30,45
111 Vahrn,18,,29,19,48
111 Vahrn,19,,26,18,44
111 Vahrn,20,,19,18,37
111 Vahrn,21,,21,15,36
111 Vahrn,22,,28,32,60
111 Vahrn,23,,19,21,40
111 Vahrn,24,,27,31,58
111 Vahrn,25,,25,31,56
111 Vahrn,26,,33,28,61
111 Vahrn,27,,22,34,56
111 Vahrn,28,,19,29,48
111 Vahrn,29,,31,33,64
111 Vahrn,30,,25,29,54
111 Vahrn,31,,45,26,71
111 Vahrn,32,,38,32,70
111 Vahrn,33,,31,40,71
111 Vahrn,34,,40,41,81
111 Vahrn,35,,39,42,81
111 Vahrn,36,,41,31,72
111 Vahrn,37,,43,43,86
111 Vahrn,38,,46,41,87
111 Vahrn,39,,32,35,67
111 Vahrn,40,,47,31,78
111 Vahrn,41,,42,34,76
111 Vahrn,42,,44,44,88
111 Vahrn,43,,35,38,73
111 Vahrn,44,,35,34,69
111 Vahrn,45,,29,37,66
111 Vahrn,46,,26,21,47
111 Vahrn,47,,36,29,65
111 Vahrn,48,,31,27,58
111 Vahrn,49,,20,21,41
111 Vahrn,50,,31,28,59
111 Vahrn,51,,21,22,43
111 Vahrn,52,,28,30,58
111 Vahrn,53,,18,31,49
111 Vahrn,54,,25,24,49
111 Vahrn,55,,23,16,39
111 Vahrn,56,,21,15,36
111 Vahrn,57,,18,21,39
111 Vahrn,58,,22,28,50
111 Vahrn,59,,18,17,35
111 Vahrn,60,,14,26,40
111 Vahrn,61,,20,23,43
111 Vahrn,62,,11,17,28
111 Vahrn,63,,19,22,41
111 Vahrn,64,,23,24,47
111 Vahrn,65,,18,22,40
111 Vahrn,66,,20,24,44
111 Vahrn,67,,20,16,36
111 Vahrn,68,,19,20,39
111 Vahrn,69,,13,9,22
111 Vahrn,70,,16,19,35
111 Vahrn,71,,11,17,28
111 Vahrn,72,,8,14,22
111 Vahrn,73,,11,14,25
111 Vahrn,74,,8,13,21
111 Vahrn,75,,10,12,22
111 Vahrn,76,,8,12,20
111 Vahrn,77,,15,13,28
111 Vahrn,78,,6,19,25
111 Vahrn,79,,8,12,20
111 Vahrn,80,,4,16,20
111 Vahrn,81,,4,4,8
111 Vahrn,82,,3,13,16
111 Vahrn,83,,5,14,19
111 Vahrn,84,,6,8,14
111 Vahrn,85,,2,9,11
111 Vahrn,86,,3,7,10
111 Vahrn,87,,1,4,5
111 Vahrn,88,,3,2,5
111 Vahrn,89,,1,1,2
111 Vahrn,90,,2,2,4
111 Vahrn,91,,1,-,1
111 Vahrn,93,,-,2,2
111 Vahrn,95,,-,2,2
111 Vahrn,96,,-,1,1
111 Vahrn,97,,-,1,1
112 Vöran,0,,4,5,9
112 Vöran,1,,7,3,10
112 Vöran,2,,2,4,6
112 Vöran,3,,2,4,6
112 Vöran,4,,8,5,13
112 Vöran,5,,5,6,11
112 Vöran,6,,8,4,12
112 Vöran,7,,11,5,16
112 Vöran,8,,5,3,8
112 Vöran,9,,5,4,9
112 Vöran,10,,11,6,17
112 Vöran,11,,9,5,14
112 Vöran,12,,5,9,14
112 Vöran,13,,8,7,15
112 Vöran,14,,8,6,14
112 Vöran,15,,6,3,9
112 Vöran,16,,7,3,10
112 Vöran,17,,5,7,12
112 Vöran,18,,10,5,15
112 Vöran,19,,8,6,14
112 Vöran,20,,11,6,17
112 Vöran,21,,6,6,12
112 Vöran,22,,9,9,18
112 Vöran,23,,9,6,15
112 Vöran,24,,6,5,11
112 Vöran,25,,8,8,16
112 Vöran,26,,10,12,22
112 Vöran,27,,4,4,8
112 Vöran,28,,3,6,9
112 Vöran,29,,9,8,17
112 Vöran,30,,10,6,16
112 Vöran,31,,6,5,11
112 Vöran,32,,9,6,15
112 Vöran,33,,14,8,22
112 Vöran,34,,5,5,10
112 Vöran,35,,9,7,16
112 Vöran,36,,7,10,17
112 Vöran,37,,9,5,14
112 Vöran,38,,6,3,9
112 Vöran,39,,14,4,18
112 Vöran,40,,3,7,10
112 Vöran,41,,9,6,15
112 Vöran,42,,4,3,7
112 Vöran,43,,11,5,16
112 Vöran,44,,8,7,15
112 Vöran,45,,13,14,27
112 Vöran,46,,4,5,9
112 Vöran,47,,6,6,12
112 Vöran,48,,4,7,11
112 Vöran,49,,7,6,13
112 Vöran,50,,4,9,13
112 Vöran,51,,3,1,4
112 Vöran,52,,6,2,8
112 Vöran,53,,5,5,10
112 Vöran,54,,5,4,9
112 Vöran,55,,9,1,10
112 Vöran,56,,4,-,4
112 Vöran,57,,7,4,11
112 Vöran,58,,7,6,13
112 Vöran,59,,2,3,5
112 Vöran,60,,5,3,8
112 Vöran,61,,4,2,6
112 Vöran,62,,-,3,3
112 Vöran,63,,4,3,7
112 Vöran,64,,3,5,8
112 Vöran,65,,6,4,10
112 Vöran,66,,4,6,10
112 Vöran,67,,3,5,8
112 Vöran,68,,2,3,5
112 Vöran,69,,8,3,11
112 Vöran,70,,2,2,4
112 Vöran,71,,3,5,8
112 Vöran,72,,2,-,2
112 Vöran,73,,1,6,7
112 Vöran,74,,6,6,12
112 Vöran,75,,2,4,6
112 Vöran,76,,3,1,4
112 Vöran,77,,5,1,6
112 Vöran,78,,1,2,3
112 Vöran,79,,4,1,5
112 Vöran,80,,-,2,2
112 Vöran,81,,-,3,3
112 Vöran,82,,2,3,5
112 Vöran,83,,-,1,1
112 Vöran,84,,1,1,2
112 Vöran,85,,1,-,1
112 Vöran,86,,1,-,1
112 Vöran,87,,-,1,1
112 Vöran,91,,1,-,1
112 Vöran,96,,-,1,1
113 Niederdorf,0,,9,11,20
113 Niederdorf,1,,8,6,14
113 Niederdorf,2,,15,8,23
113 Niederdorf,3,,11,14,25
113 Niederdorf,4,,9,13,22
113 Niederdorf,5,,5,11,16
113 Niederdorf,6,,9,10,19
113 Niederdorf,7,,12,11,23
113 Niederdorf,8,,5,5,10
113 Niederdorf,9,,7,12,19
113 Niederdorf,10,,9,8,17
113 Niederdorf,11,,7,8,15
113 Niederdorf,12,,6,10,16
113 Niederdorf,13,,13,7,20
113 Niederdorf,14,,9,6,15
113 Niederdorf,15,,8,10,18
113 Niederdorf,16,,8,12,20
113 Niederdorf,17,,12,10,22
113 Niederdorf,18,,9,6,15
113 Niederdorf,19,,8,9,17
113 Niederdorf,20,,2,10,12
113 Niederdorf,21,,4,7,11
113 Niederdorf,22,,8,5,13
113 Niederdorf,23,,9,6,15
113 Niederdorf,24,,9,9,18
113 Niederdorf,25,,4,13,17
113 Niederdorf,26,,9,5,14
113 Niederdorf,27,,9,7,16
113 Niederdorf,28,,11,3,14
113 Niederdorf,29,,3,2,5
113 Niederdorf,30,,9,7,16
113 Niederdorf,31,,11,9,20
113 Niederdorf,32,,6,10,16
113 Niederdorf,33,,11,11,22
113 Niederdorf,34,,15,11,26
113 Niederdorf,35,,16,7,23
113 Niederdorf,36,,8,14,22
113 Niederdorf,37,,8,11,19
113 Niederdorf,38,,22,17,39
113 Niederdorf,39,,15,10,25
113 Niederdorf,40,,14,18,32
113 Niederdorf,41,,24,10,34
113 Niederdorf,42,,9,16,25
113 Niederdorf,43,,20,14,34
113 Niederdorf,44,,10,9,19
113 Niederdorf,45,,21,10,31
113 Niederdorf,46,,13,10,23
113 Niederdorf,47,,8,10,18
113 Niederdorf,48,,10,8,18
113 Niederdorf,49,,6,5,11
113 Niederdorf,50,,9,11,20
113 Niederdorf,51,,9,11,20
113 Niederdorf,52,,11,7,18
113 Niederdorf,53,,12,6,18
113 Niederdorf,54,,6,4,10
113 Niederdorf,55,,8,4,12
113 Niederdorf,56,,1,3,4
113 Niederdorf,57,,5,4,9
113 Niederdorf,58,,9,4,13
113 Niederdorf,59,,5,8,13
113 Niederdorf,60,,6,8,14
113 Niederdorf,61,,7,8,15
113 Niederdorf,62,,2,6,8
113 Niederdorf,63,,7,7,14
113 Niederdorf,64,,5,8,13
113 Niederdorf,65,,5,9,14
113 Niederdorf,66,,5,5,10
113 Niederdorf,67,,5,8,13
113 Niederdorf,68,,1,3,4
113 Niederdorf,69,,7,6,13
113 Niederdorf,70,,5,8,13
113 Niederdorf,71,,5,8,13
113 Niederdorf,72,,7,7,14
113 Niederdorf,73,,2,13,15
113 Niederdorf,74,,6,7,13
113 Niederdorf,75,,8,6,14
113 Niederdorf,76,,7,6,13
113 Niederdorf,77,,6,9,15
113 Niederdorf,78,,5,8,13
113 Niederdorf,79,,4,6,10
113 Niederdorf,80,,7,9,16
113 Niederdorf,81,,3,5,8
113 Niederdorf,82,,-,5,5
113 Niederdorf,83,,3,8,11
113 Niederdorf,84,,2,3,5
113 Niederdorf,85,,2,6,8
113 Niederdorf,86,,5,4,9
113 Niederdorf,87,,-,3,3
113 Niederdorf,89,,-,1,1
113 Niederdorf,90,,1,-,1
113 Niederdorf,91,,-,1,1
113 Niederdorf,92,,-,1,1
113 Niederdorf,93,,-,1,1
113 Niederdorf,96,,-,1,1
113 Niederdorf,97,,-,1,1
113 Niederdorf,102,,-,1,1
114 Villanders,0,,13,12,25
114 Villanders,1,,13,13,26
114 Villanders,2,,18,7,25
114 Villanders,3,,13,13,26
114 Villanders,4,,6,12,18
114 Villanders,5,,7,11,18
114 Villanders,6,,13,11,24
114 Villanders,7,,10,17,27
114 Villanders,8,,13,11,24
114 Villanders,9,,13,8,21
114 Villanders,10,,10,12,22
114 Villanders,11,,14,8,22
114 Villanders,12,,18,5,23
114 Villanders,13,,11,12,23
114 Villanders,14,,7,18,25
114 Villanders,15,,14,8,22
114 Villanders,16,,16,15,31
114 Villanders,17,,16,14,30
114 Villanders,18,,14,10,24
114 Villanders,19,,10,12,22
114 Villanders,20,,7,16,23
114 Villanders,21,,10,11,21
114 Villanders,22,,10,11,21
114 Villanders,23,,13,16,29
114 Villanders,24,,15,4,19
114 Villanders,25,,15,13,28
114 Villanders,26,,21,13,34
114 Villanders,27,,10,17,27
114 Villanders,28,,16,7,23
114 Villanders,29,,14,9,23
114 Villanders,30,,18,15,33
114 Villanders,31,,15,10,25
114 Villanders,32,,10,13,23
114 Villanders,33,,15,19,34
114 Villanders,34,,11,18,29
114 Villanders,35,,15,18,33
114 Villanders,36,,16,17,33
114 Villanders,37,,16,10,26
114 Villanders,38,,27,17,44
114 Villanders,39,,24,10,34
114 Villanders,40,,20,13,33
114 Villanders,41,,21,16,37
114 Villanders,42,,23,18,41
114 Villanders,43,,23,16,39
114 Villanders,44,,15,14,29
114 Villanders,45,,18,11,29
114 Villanders,46,,15,10,25
114 Villanders,47,,19,6,25
114 Villanders,48,,15,11,26
114 Villanders,49,,18,7,25
114 Villanders,50,,11,7,18
114 Villanders,51,,10,11,21
114 Villanders,52,,11,17,28
114 Villanders,53,,8,6,14
114 Villanders,54,,11,10,21
114 Villanders,55,,12,7,19
114 Villanders,56,,10,7,17
114 Villanders,57,,12,8,20
114 Villanders,58,,11,5,16
114 Villanders,59,,7,11,18
114 Villanders,60,,7,7,14
114 Villanders,61,,10,10,20
114 Villanders,62,,6,3,9
114 Villanders,63,,4,9,13
114 Villanders,64,,7,7,14
114 Villanders,65,,10,8,18
114 Villanders,66,,7,9,16
114 Villanders,67,,9,12,21
114 Villanders,68,,7,5,12
114 Villanders,69,,7,6,13
114 Villanders,70,,4,9,13
114 Villanders,71,,6,7,13
114 Villanders,72,,2,8,10
114 Villanders,73,,1,9,10
114 Villanders,74,,8,9,17
114 Villanders,75,,8,9,17
114 Villanders,76,,5,8,13
114 Villanders,77,,6,5,11
114 Villanders,78,,3,8,11
114 Villanders,79,,3,7,10
114 Villanders,80,,6,5,11
114 Villanders,81,,3,4,7
114 Villanders,82,,2,7,9
114 Villanders,83,,4,3,7
114 Villanders,84,,5,3,8
114 Villanders,85,,1,4,5
114 Villanders,86,,1,9,10
114 Villanders,87,,2,3,5
114 Villanders,88,,1,2,3
114 Villanders,92,,-,2,2
114 Villanders,93,,-,2,2
114 Villanders,94,,-,2,2
114 Villanders,95,,1,1,2
115 Sterzing,0,,37,35,72
115 Sterzing,1,,35,27,62
115 Sterzing,2,,30,27,57
115 Sterzing,3,,30,31,61
115 Sterzing,4,,30,40,70
115 Sterzing,5,,33,27,60
115 Sterzing,6,,33,32,65
115 Sterzing,7,,26,31,57
115 Sterzing,8,,31,21,52
115 Sterzing,9,,23,31,54
115 Sterzing,10,,32,33,65
115 Sterzing,11,,28,37,65
115 Sterzing,12,,34,27,61
115 Sterzing,13,,30,22,52
115 Sterzing,14,,33,25,58
115 Sterzing,15,,31,32,63
115 Sterzing,16,,38,31,69
115 Sterzing,17,,25,37,62
115 Sterzing,18,,38,22,60
115 Sterzing,19,,32,26,58
115 Sterzing,20,,30,27,57
115 Sterzing,21,,33,33,66
115 Sterzing,22,,15,31,46
115 Sterzing,23,,35,30,65
115 Sterzing,24,,39,36,75
115 Sterzing,25,,48,44,92
115 Sterzing,26,,71,40,111
115 Sterzing,27,,54,50,104
115 Sterzing,28,,54,46,100
115 Sterzing,29,,55,32,87
115 Sterzing,30,,48,41,89
115 Sterzing,31,,38,42,80
115 Sterzing,32,,55,47,102
115 Sterzing,33,,54,40,94
115 Sterzing,34,,52,60,112
115 Sterzing,35,,53,57,110
115 Sterzing,36,,53,50,103
115 Sterzing,37,,54,55,109
115 Sterzing,38,,44,31,75
115 Sterzing,39,,54,58,112
115 Sterzing,40,,63,50,113
115 Sterzing,41,,49,51,100
115 Sterzing,42,,56,44,100
115 Sterzing,43,,48,44,92
115 Sterzing,44,,49,49,98
115 Sterzing,45,,41,47,88
115 Sterzing,46,,41,37,78
115 Sterzing,47,,45,48,93
115 Sterzing,48,,55,39,94
115 Sterzing,49,,45,40,85
115 Sterzing,50,,35,47,82
115 Sterzing,51,,44,26,70
115 Sterzing,52,,37,45,82
115 Sterzing,53,,32,36,68
115 Sterzing,54,,29,40,69
115 Sterzing,55,,42,37,79
115 Sterzing,56,,36,41,77
115 Sterzing,57,,39,35,74
115 Sterzing,58,,33,48,81
115 Sterzing,59,,38,43,81
115 Sterzing,60,,30,30,60
115 Sterzing,61,,44,44,88
115 Sterzing,62,,36,37,73
115 Sterzing,63,,32,28,60
115 Sterzing,64,,39,49,88
115 Sterzing,65,,27,36,63
115 Sterzing,66,,30,27,57
115 Sterzing,67,,37,29,66
115 Sterzing,68,,23,31,54
115 Sterzing,69,,29,27,56
115 Sterzing,70,,18,37,55
115 Sterzing,71,,20,38,58
115 Sterzing,72,,22,24,46
115 Sterzing,73,,17,24,41
115 Sterzing,74,,24,30,54
115 Sterzing,75,,12,14,26
115 Sterzing,76,,21,31,52
115 Sterzing,77,,8,23,31
115 Sterzing,78,,15,18,33
115 Sterzing,79,,16,25,41
115 Sterzing,80,,13,18,31
115 Sterzing,81,,9,20,29
115 Sterzing,82,,3,14,17
115 Sterzing,83,,9,15,24
115 Sterzing,84,,9,16,25
115 Sterzing,85,,7,20,27
115 Sterzing,86,,2,10,12
115 Sterzing,87,,1,5,6
115 Sterzing,88,,4,4,8
115 Sterzing,89,,2,2,4
115 Sterzing,90,,1,1,2
115 Sterzing,91,,1,2,3
115 Sterzing,92,,1,2,3
115 Sterzing,93,,1,5,6
115 Sterzing,94,,-,2,2
115 Sterzing,95,,-,4,4
115 Sterzing,97,,-,1,1
115 Sterzing,98,,-,1,1
115 Sterzing,106,,-,1,1
116 Feldthurns,0,,25,15,40
116 Feldthurns,1,,28,20,48
116 Feldthurns,2,,23,16,39
116 Feldthurns,3,,21,16,37
116 Feldthurns,4,,14,13,27
116 Feldthurns,5,,22,22,44
116 Feldthurns,6,,17,19,36
116 Feldthurns,7,,25,15,40
116 Feldthurns,8,,18,20,38
116 Feldthurns,9,,22,19,41
116 Feldthurns,10,,22,16,38
116 Feldthurns,11,,16,20,36
116 Feldthurns,12,,18,18,36
116 Feldthurns,13,,15,19,34
116 Feldthurns,14,,26,19,45
116 Feldthurns,15,,19,19,38
116 Feldthurns,16,,14,12,26
116 Feldthurns,17,,13,16,29
116 Feldthurns,18,,21,14,35
116 Feldthurns,19,,14,19,33
116 Feldthurns,20,,23,11,34
116 Feldthurns,21,,18,20,38
116 Feldthurns,22,,14,19,33
116 Feldthurns,23,,16,21,37
116 Feldthurns,24,,23,23,46
116 Feldthurns,25,,15,20,35
116 Feldthurns,26,,21,19,40
116 Feldthurns,27,,12,21,33
116 Feldthurns,28,,13,18,31
116 Feldthurns,29,,31,24,55
116 Feldthurns,30,,21,13,34
116 Feldthurns,31,,22,21,43
116 Feldthurns,32,,20,18,38
116 Feldthurns,33,,24,30,54
116 Feldthurns,34,,19,19,38
116 Feldthurns,35,,33,23,56
116 Feldthurns,36,,18,23,41
116 Feldthurns,37,,19,20,39
116 Feldthurns,38,,22,28,50
116 Feldthurns,39,,19,27,46
116 Feldthurns,40,,23,22,45
116 Feldthurns,41,,20,21,41
116 Feldthurns,42,,25,26,51
116 Feldthurns,43,,24,19,43
116 Feldthurns,44,,29,18,47
116 Feldthurns,45,,14,19,33
116 Feldthurns,46,,18,17,35
116 Feldthurns,47,,17,14,31
116 Feldthurns,48,,16,16,32
116 Feldthurns,49,,14,19,33
116 Feldthurns,50,,14,12,26
116 Feldthurns,51,,11,18,29
116 Feldthurns,52,,12,12,24
116 Feldthurns,53,,14,14,28
116 Feldthurns,54,,19,13,32
116 Feldthurns,55,,22,15,37
116 Feldthurns,56,,13,14,27
116 Feldthurns,57,,14,14,28
116 Feldthurns,58,,7,14,21
116 Feldthurns,59,,13,11,24
116 Feldthurns,60,,15,9,24
116 Feldthurns,61,,11,10,21
116 Feldthurns,62,,13,12,25
116 Feldthurns,63,,19,11,30
116 Feldthurns,64,,11,12,23
116 Feldthurns,65,,9,7,16
116 Feldthurns,66,,6,4,10
116 Feldthurns,67,,10,6,16
116 Feldthurns,68,,7,11,18
116 Feldthurns,69,,11,8,19
116 Feldthurns,70,,4,10,14
116 Feldthurns,71,,7,10,17
116 Feldthurns,72,,10,11,21
116 Feldthurns,73,,2,5,7
116 Feldthurns,74,,6,4,10
116 Feldthurns,75,,6,10,16
116 Feldthurns,76,,4,6,10
116 Feldthurns,77,,4,14,18
116 Feldthurns,78,,4,10,14
116 Feldthurns,79,,8,4,12
116 Feldthurns,80,,4,4,8
116 Feldthurns,81,,2,7,9
116 Feldthurns,82,,5,7,12
116 Feldthurns,83,,4,8,12
116 Feldthurns,84,,6,6,12
116 Feldthurns,85,,2,6,8
116 Feldthurns,86,,1,7,8
116 Feldthurns,87,,5,7,12
116 Feldthurns,88,,3,5,8
116 Feldthurns,89,,3,-,3
116 Feldthurns,90,,-,2,2
116 Feldthurns,91,,-,2,2
116 Feldthurns,92,,-,5,5
116 Feldthurns,93,,1,-,1
116 Feldthurns,94,,-,1,1
116 Feldthurns,95,,-,1,1
116 Feldthurns,96,,-,1,1
117 Wengen,0,,10,10,20
117 Wengen,1,,6,9,15
117 Wengen,2,,10,4,14
117 Wengen,3,,7,8,15
117 Wengen,4,,5,7,12
117 Wengen,5,,11,4,15
117 Wengen,6,,5,10,15
117 Wengen,7,,10,6,16
117 Wengen,8,,9,5,14
117 Wengen,9,,7,8,15
117 Wengen,10,,12,7,19
117 Wengen,11,,9,8,17
117 Wengen,12,,11,9,20
117 Wengen,13,,12,7,19
117 Wengen,14,,10,7,17
117 Wengen,15,,10,7,17
117 Wengen,16,,17,7,24
117 Wengen,17,,12,7,19
117 Wengen,18,,6,6,12
117 Wengen,19,,6,9,15
117 Wengen,20,,11,5,16
117 Wengen,21,,8,8,16
117 Wengen,22,,10,6,16
117 Wengen,23,,14,7,21
117 Wengen,24,,13,4,17
117 Wengen,25,,11,5,16
117 Wengen,26,,6,8,14
117 Wengen,27,,9,12,21
117 Wengen,28,,12,6,18
117 Wengen,29,,7,6,13
117 Wengen,30,,11,9,20
117 Wengen,31,,6,5,11
117 Wengen,32,,17,10,27
117 Wengen,33,,12,7,19
117 Wengen,34,,18,10,28
117 Wengen,35,,11,11,22
117 Wengen,36,,12,13,25
117 Wengen,37,,11,14,25
117 Wengen,38,,9,10,19
117 Wengen,39,,18,10,28
117 Wengen,40,,10,12,22
117 Wengen,41,,14,6,20
117 Wengen,42,,9,11,20
117 Wengen,43,,11,6,17
117 Wengen,44,,12,12,24
117 Wengen,45,,14,7,21
117 Wengen,46,,7,9,16
117 Wengen,47,,10,12,22
117 Wengen,48,,7,6,13
117 Wengen,49,,6,7,13
117 Wengen,50,,6,11,17
117 Wengen,51,,4,6,10
117 Wengen,52,,7,6,13
117 Wengen,53,,9,4,13
117 Wengen,54,,6,2,8
117 Wengen,55,,6,7,13
117 Wengen,56,,9,6,15
117 Wengen,57,,3,6,9
117 Wengen,58,,4,8,12
117 Wengen,59,,2,11,13
117 Wengen,60,,6,3,9
117 Wengen,61,,5,3,8
117 Wengen,62,,6,3,9
117 Wengen,63,,9,7,16
117 Wengen,64,,3,7,10
117 Wengen,65,,7,6,13
117 Wengen,66,,4,4,8
117 Wengen,67,,6,9,15
117 Wengen,68,,6,3,9
117 Wengen,69,,5,4,9
117 Wengen,70,,6,7,13
117 Wengen,71,,2,1,3
117 Wengen,72,,2,7,9
117 Wengen,73,,2,9,11
117 Wengen,74,,3,2,5
117 Wengen,75,,2,7,9
117 Wengen,76,,5,2,7
117 Wengen,77,,4,2,6
117 Wengen,78,,2,7,9
117 Wengen,79,,2,3,5
117 Wengen,80,,2,4,6
117 Wengen,81,,1,3,4
117 Wengen,82,,3,4,7
117 Wengen,83,,-,6,6
117 Wengen,84,,2,4,6
117 Wengen,85,,3,4,7
117 Wengen,86,,3,7,10
117 Wengen,87,,1,1,2
117 Wengen,90,,2,-,2
117 Wengen,92,,1,-,1
117 Wengen,95,,1,-,1
118 U.L.Frau i.W.-St.Felix,0,,5,-,5
118 U.L.Frau i.W.-St.Felix,1,,3,2,5
118 U.L.Frau i.W.-St.Felix,2,,6,7,13
118 U.L.Frau i.W.-St.Felix,3,,6,3,9
118 U.L.Frau i.W.-St.Felix,4,,9,7,16
118 U.L.Frau i.W.-St.Felix,5,,7,3,10
118 U.L.Frau i.W.-St.Felix,6,,9,5,14
118 U.L.Frau i.W.-St.Felix,7,,3,2,5
118 U.L.Frau i.W.-St.Felix,8,,5,5,10
118 U.L.Frau i.W.-St.Felix,9,,6,9,15
118 U.L.Frau i.W.-St.Felix,10,,5,5,10
118 U.L.Frau i.W.-St.Felix,11,,8,5,13
118 U.L.Frau i.W.-St.Felix,12,,3,10,13
118 U.L.Frau i.W.-St.Felix,13,,7,8,15
118 U.L.Frau i.W.-St.Felix,14,,9,5,14
118 U.L.Frau i.W.-St.Felix,15,,7,4,11
118 U.L.Frau i.W.-St.Felix,16,,10,8,18
118 U.L.Frau i.W.-St.Felix,17,,6,4,10
118 U.L.Frau i.W.-St.Felix,18,,8,6,14
118 U.L.Frau i.W.-St.Felix,19,,8,5,13
118 U.L.Frau i.W.-St.Felix,20,,4,6,10
118 U.L.Frau i.W.-St.Felix,21,,7,4,11
118 U.L.Frau i.W.-St.Felix,22,,7,6,13
118 U.L.Frau i.W.-St.Felix,23,,8,4,12
118 U.L.Frau i.W.-St.Felix,24,,2,11,13
118 U.L.Frau i.W.-St.Felix,25,,3,6,9
118 U.L.Frau i.W.-St.Felix,26,,7,4,11
118 U.L.Frau i.W.-St.Felix,27,,3,6,9
118 U.L.Frau i.W.-St.Felix,28,,1,2,3
118 U.L.Frau i.W.-St.Felix,29,,-,4,4
118 U.L.Frau i.W.-St.Felix,30,,5,3,8
118 U.L.Frau i.W.-St.Felix,31,,4,8,12
118 U.L.Frau i.W.-St.Felix,32,,8,2,10
118 U.L.Frau i.W.-St.Felix,33,,5,6,11
118 U.L.Frau i.W.-St.Felix,34,,2,3,5
118 U.L.Frau i.W.-St.Felix,35,,7,5,12
118 U.L.Frau i.W.-St.Felix,36,,2,4,6
118 U.L.Frau i.W.-St.Felix,37,,5,9,14
118 U.L.Frau i.W.-St.Felix,38,,7,4,11
118 U.L.Frau i.W.-St.Felix,39,,4,9,13
118 U.L.Frau i.W.-St.Felix,40,,3,4,7
118 U.L.Frau i.W.-St.Felix,41,,8,7,15
118 U.L.Frau i.W.-St.Felix,42,,10,6,16
118 U.L.Frau i.W.-St.Felix,43,,6,8,14
118 U.L.Frau i.W.-St.Felix,44,,16,8,24
118 U.L.Frau i.W.-St.Felix,45,,8,9,17
118 U.L.Frau i.W.-St.Felix,46,,4,4,8
118 U.L.Frau i.W.-St.Felix,47,,8,9,17
118 U.L.Frau i.W.-St.Felix,48,,5,5,10
118 U.L.Frau i.W.-St.Felix,49,,4,2,6
118 U.L.Frau i.W.-St.Felix,50,,3,6,9
118 U.L.Frau i.W.-St.Felix,51,,5,6,11
118 U.L.Frau i.W.-St.Felix,52,,3,4,7
118 U.L.Frau i.W.-St.Felix,53,,6,3,9
118 U.L.Frau i.W.-St.Felix,54,,3,3,6
118 U.L.Frau i.W.-St.Felix,55,,6,3,9
118 U.L.Frau i.W.-St.Felix,56,,7,3,10
118 U.L.Frau i.W.-St.Felix,57,,3,4,7
118 U.L.Frau i.W.-St.Felix,58,,5,-,5
118 U.L.Frau i.W.-St.Felix,59,,4,1,5
118 U.L.Frau i.W.-St.Felix,60,,1,7,8
118 U.L.Frau i.W.-St.Felix,61,,1,4,5
118 U.L.Frau i.W.-St.Felix,62,,3,1,4
118 U.L.Frau i.W.-St.Felix,63,,5,1,6
118 U.L.Frau i.W.-St.Felix,64,,6,4,10
118 U.L.Frau i.W.-St.Felix,65,,2,4,6
118 U.L.Frau i.W.-St.Felix,66,,5,8,13
118 U.L.Frau i.W.-St.Felix,67,,3,1,4
118 U.L.Frau i.W.-St.Felix,68,,1,4,5
118 U.L.Frau i.W.-St.Felix,69,,4,4,8
118 U.L.Frau i.W.-St.Felix,70,,3,-,3
118 U.L.Frau i.W.-St.Felix,71,,4,2,6
118 U.L.Frau i.W.-St.Felix,72,,3,3,6
118 U.L.Frau i.W.-St.Felix,73,,3,3,6
118 U.L.Frau i.W.-St.Felix,74,,5,4,9
118 U.L.Frau i.W.-St.Felix,75,,7,1,8
118 U.L.Frau i.W.-St.Felix,76,,3,1,4
118 U.L.Frau i.W.-St.Felix,77,,4,5,9
118 U.L.Frau i.W.-St.Felix,78,,1,3,4
118 U.L.Frau i.W.-St.Felix,79,,3,4,7
118 U.L.Frau i.W.-St.Felix,80,,3,4,7
118 U.L.Frau i.W.-St.Felix,81,,2,3,5
118 U.L.Frau i.W.-St.Felix,82,,3,5,8
118 U.L.Frau i.W.-St.Felix,83,,2,1,3
118 U.L.Frau i.W.-St.Felix,84,,2,4,6
118 U.L.Frau i.W.-St.Felix,85,,1,-,1
118 U.L.Frau i.W.-St.Felix,86,,-,3,3
118 U.L.Frau i.W.-St.Felix,87,,-,1,1
118 U.L.Frau i.W.-St.Felix,88,,-,1,1
118 U.L.Frau i.W.-St.Felix,94,,1,-,1
118 U.L.Frau i.W.-St.Felix,95,,1,-,1

