Gemeinde,Altersklassen,Geschlecht,Männer,Frauen,Insgesamt
001 Aldein,0,,7,13,20
001 Aldein,1,,8,11,19
001 Aldein,2,,7,15,22
001 Aldein,3,,10,8,18
001 Aldein,4,,18,9,27
001 Aldein,5,,14,9,23
001 Aldein,6,,11,9,20
001 Aldein,7,,16,8,24
001 Aldein,8,,12,4,16
001 Aldein,9,,16,14,30
001 Aldein,10,,10,16,26
001 Aldein,11,,15,8,23
001 Aldein,12,,7,8,15
001 Aldein,13,,8,12,20
001 Aldein,14,,14,7,21
001 Aldein,15,,13,12,25
001 Aldein,16,,9,13,22
001 Aldein,17,,7,8,15
001 Aldein,18,,7,6,13
001 Aldein,19,,9,16,25
001 Aldein,20,,11,9,20
001 Aldein,21,,11,8,19
001 Aldein,22,,10,8,18
001 Aldein,23,,15,16,31
001 Aldein,24,,10,8,18
001 Aldein,25,,11,13,24
001 Aldein,26,,13,4,17
001 Aldein,27,,10,12,22
001 Aldein,28,,9,14,23
001 Aldein,29,,9,14,23
001 Aldein,30,,11,8,19
001 Aldein,31,,9,18,27
001 Aldein,32,,10,13,23
001 Aldein,33,,17,14,31
001 Aldein,34,,13,14,27
001 Aldein,35,,14,10,24
001 Aldein,36,,19,9,28
001 Aldein,37,,15,14,29
001 Aldein,38,,13,15,28
001 Aldein,39,,21,7,28
001 Aldein,40,,12,16,28
001 Aldein,41,,6,14,20
001 Aldein,42,,6,19,25
001 Aldein,43,,16,9,25
001 Aldein,44,,14,11,25
001 Aldein,45,,13,6,19
001 Aldein,46,,8,17,25
001 Aldein,47,,17,14,31
001 Aldein,48,,15,9,24
001 Aldein,49,,11,13,24
001 Aldein,50,,7,5,12
001 Aldein,51,,9,10,19
001 Aldein,52,,9,8,17
001 Aldein,53,,9,9,18
001 Aldein,54,,9,6,15
001 Aldein,55,,9,9,18
001 Aldein,56,,6,5,11
001 Aldein,57,,16,10,26
001 Aldein,58,,5,12,17
001 Aldein,59,,9,6,15
001 Aldein,60,,9,9,18
001 Aldein,61,,5,10,15
001 Aldein,62,,7,12,19
001 Aldein,63,,10,5,15
001 Aldein,64,,5,7,12
001 Aldein,65,,11,10,21
001 Aldein,66,,7,12,19
001 Aldein,67,,5,12,17
001 Aldein,68,,6,8,14
001 Aldein,69,,5,8,13
001 Aldein,70,,7,7,14
001 Aldein,71,,5,10,15
001 Aldein,72,,8,6,14
001 Aldein,73,,4,4,8
001 Aldein,74,,14,3,17
001 Aldein,75,,7,4,11
001 Aldein,76,,3,7,10
001 Aldein,77,,6,4,10
001 Aldein,78,,4,5,9
001 Aldein,79,,6,7,13
001 Aldein,80,,5,1,6
001 Aldein,81,,5,4,9
001 Aldein,82,,-,4,4
001 Aldein,83,,1,4,5
001 Aldein,84,,-,7,7
001 Aldein,85,,2,4,6
001 Aldein,86,,1,8,9
001 Aldein,87,,1,8,9
001 Aldein,88,,2,1,3
001 Aldein,89,,-,2,2
001 Aldein,92,,1,-,1
001 Aldein,95,,-,2,2
001 Aldein,96,,-,1,1
001 Aldein,101,,-,1,1
001 Aldein,Insgesamt,,827,839,1.666
002 Andrian,0,,6,6,12
002 Andrian,1,,3,7,10
002 Andrian,2,,8,4,12
002 Andrian,3,,7,6,13
002 Andrian,4,,10,3,13
002 Andrian,5,,7,11,18
002 Andrian,6,,3,3,6
002 Andrian,7,,3,5,8
002 Andrian,8,,6,5,11
002 Andrian,9,,4,5,9
002 Andrian,10,,8,3,11
002 Andrian,11,,8,6,14
002 Andrian,12,,3,10,13
002 Andrian,13,,8,4,12
002 Andrian,14,,7,7,14
002 Andrian,15,,5,4,9
002 Andrian,16,,6,6,12
002 Andrian,17,,5,8,13
002 Andrian,18,,5,5,10
002 Andrian,19,,5,4,9
002 Andrian,20,,11,6,17
002 Andrian,21,,6,8,14
002 Andrian,22,,8,5,13
002 Andrian,23,,1,3,4
002 Andrian,24,,10,5,15
002 Andrian,25,,7,3,10
002 Andrian,26,,10,9,19
002 Andrian,27,,4,7,11
002 Andrian,28,,8,5,13
002 Andrian,29,,6,8,14
002 Andrian,30,,7,3,10
002 Andrian,31,,7,7,14
002 Andrian,32,,11,8,19
002 Andrian,33,,10,4,14
002 Andrian,34,,7,10,17
002 Andrian,35,,13,11,24
002 Andrian,36,,8,11,19
002 Andrian,37,,10,12,22
002 Andrian,38,,13,6,19
002 Andrian,39,,6,9,15
002 Andrian,40,,9,9,18
002 Andrian,41,,10,9,19
002 Andrian,42,,9,9,18
002 Andrian,43,,12,12,24
002 Andrian,44,,8,8,16
002 Andrian,45,,7,13,20
002 Andrian,46,,11,7,18
002 Andrian,47,,8,3,11
002 Andrian,48,,7,5,12
002 Andrian,49,,8,4,12
002 Andrian,50,,8,8,16
002 Andrian,51,,8,7,15
002 Andrian,52,,4,9,13
002 Andrian,53,,2,4,6
002 Andrian,54,,6,3,9
002 Andrian,55,,6,9,15
002 Andrian,56,,3,3,6
002 Andrian,57,,4,3,7
002 Andrian,58,,6,6,12
002 Andrian,59,,4,2,6
002 Andrian,60,,5,4,9
002 Andrian,61,,5,4,9
002 Andrian,62,,7,8,15
002 Andrian,63,,1,2,3
002 Andrian,64,,1,4,5
002 Andrian,65,,6,7,13
002 Andrian,66,,3,5,8
002 Andrian,67,,6,4,10
002 Andrian,68,,3,7,10
002 Andrian,69,,1,7,8
002 Andrian,70,,4,3,7
002 Andrian,71,,5,4,9
002 Andrian,72,,2,3,5
002 Andrian,73,,4,2,6
002 Andrian,74,,5,3,8
002 Andrian,75,,3,4,7
002 Andrian,76,,7,4,11
002 Andrian,77,,3,4,7
002 Andrian,78,,4,2,6
002 Andrian,79,,2,1,3
002 Andrian,80,,1,4,5
002 Andrian,81,,-,2,2
002 Andrian,82,,3,4,7
002 Andrian,83,,1,1,2
002 Andrian,84,,1,4,5
002 Andrian,85,,-,1,1
002 Andrian,86,,1,2,3
002 Andrian,87,,1,3,4
002 Andrian,88,,1,-,1
002 Andrian,89,,1,1,2
002 Andrian,90,,-,1,1
002 Andrian,93,,-,1,1
002 Andrian,94,,1,1,2
002 Andrian,96,,-,1,1
002 Andrian,97,,-,1,1
002 Andrian,101,,-,1,1
002 Andrian,Insgesamt,,508,495,1.003
003 Altrei,0,,1,3,4
003 Altrei,1,,6,4,10
003 Altrei,2,,2,-,2
003 Altrei,3,,3,1,4
003 Altrei,4,,1,1,2
003 Altrei,5,,-,1,1
003 Altrei,6,,3,1,4
003 Altrei,7,,4,1,5
003 Altrei,8,,1,1,2
003 Altrei,9,,3,-,3
003 Altrei,10,,3,1,4
003 Altrei,11,,-,1,1
003 Altrei,12,,-,2,2
003 Altrei,13,,1,2,3
003 Altrei,14,,3,2,5
003 Altrei,15,,3,-,3
003 Altrei,16,,6,3,9
003 Altrei,17,,1,-,1
003 Altrei,18,,3,2,5
003 Altrei,19,,1,2,3
003 Altrei,20,,4,5,9
003 Altrei,21,,2,1,3
003 Altrei,22,,3,2,5
003 Altrei,23,,3,1,4
003 Altrei,24,,3,-,3
003 Altrei,25,,4,1,5
003 Altrei,26,,3,3,6
003 Altrei,27,,3,2,5
003 Altrei,28,,2,3,5
003 Altrei,29,,1,2,3
003 Altrei,30,,2,4,6
003 Altrei,31,,-,2,2
003 Altrei,32,,2,3,5
003 Altrei,33,,4,1,5
003 Altrei,34,,1,-,1
003 Altrei,35,,2,3,5
003 Altrei,36,,4,-,4
003 Altrei,37,,4,3,7
003 Altrei,38,,1,3,4
003 Altrei,39,,3,5,8
003 Altrei,40,,1,4,5
003 Altrei,41,,3,1,4
003 Altrei,42,,3,4,7
003 Altrei,43,,2,5,7
003 Altrei,44,,3,6,9
003 Altrei,45,,2,2,4
003 Altrei,46,,10,2,12
003 Altrei,47,,2,3,5
003 Altrei,48,,5,2,7
003 Altrei,49,,5,4,9
003 Altrei,50,,2,3,5
003 Altrei,51,,1,2,3
003 Altrei,52,,5,1,6
003 Altrei,53,,2,3,5
003 Altrei,54,,1,1,2
003 Altrei,55,,3,2,5
003 Altrei,56,,6,3,9
003 Altrei,57,,5,3,8
003 Altrei,58,,1,3,4
003 Altrei,59,,1,-,1
003 Altrei,60,,3,2,5
003 Altrei,61,,3,2,5
003 Altrei,62,,2,3,5
003 Altrei,63,,3,1,4
003 Altrei,64,,2,3,5
003 Altrei,65,,1,3,4
003 Altrei,66,,3,1,4
003 Altrei,67,,1,3,4
003 Altrei,68,,2,4,6
003 Altrei,69,,2,3,5
003 Altrei,70,,1,1,2
003 Altrei,71,,3,1,4
003 Altrei,72,,3,1,4
003 Altrei,73,,3,2,5
003 Altrei,74,,-,2,2
003 Altrei,75,,3,2,5
003 Altrei,76,,-,3,3
003 Altrei,77,,-,2,2
003 Altrei,78,,2,2,4
003 Altrei,79,,2,2,4
003 Altrei,80,,-,2,2
003 Altrei,81,,2,3,5
003 Altrei,82,,1,4,5
003 Altrei,84,,-,2,2
003 Altrei,85,,-,1,1
003 Altrei,86,,1,1,2
003 Altrei,87,,-,1,1
003 Altrei,91,,-,2,2
003 Altrei,93,,-,1,1
003 Altrei,94,,-,1,1
003 Altrei,95,,1,-,1
003 Altrei,97,,-,1,1
003 Altrei,Insgesamt,,203,188,391
004 Eppan a.d. Weinstr.,0,,82,94,176
004 Eppan a.d. Weinstr.,1,,70,66,136
004 Eppan a.d. Weinstr.,2,,104,77,181
004 Eppan a.d. Weinstr.,3,,74,104,178
004 Eppan a.d. Weinstr.,4,,84,64,148
004 Eppan a.d. Weinstr.,5,,82,67,149
004 Eppan a.d. Weinstr.,6,,81,76,157
004 Eppan a.d. Weinstr.,7,,77,75,152
004 Eppan a.d. Weinstr.,8,,72,76,148
004 Eppan a.d. Weinstr.,9,,88,57,145
004 Eppan a.d. Weinstr.,10,,86,85,171
004 Eppan a.d. Weinstr.,11,,72,68,140
004 Eppan a.d. Weinstr.,12,,76,73,149
004 Eppan a.d. Weinstr.,13,,71,68,139
004 Eppan a.d. Weinstr.,14,,75,79,154
004 Eppan a.d. Weinstr.,15,,84,85,169
004 Eppan a.d. Weinstr.,16,,70,70,140
004 Eppan a.d. Weinstr.,17,,84,61,145
004 Eppan a.d. Weinstr.,18,,84,59,143
004 Eppan a.d. Weinstr.,19,,79,65,144
004 Eppan a.d. Weinstr.,20,,80,83,163
004 Eppan a.d. Weinstr.,21,,77,64,141
004 Eppan a.d. Weinstr.,22,,89,76,165
004 Eppan a.d. Weinstr.,23,,82,58,140
004 Eppan a.d. Weinstr.,24,,84,79,163
004 Eppan a.d. Weinstr.,25,,81,89,170
004 Eppan a.d. Weinstr.,26,,78,84,162
004 Eppan a.d. Weinstr.,27,,68,87,155
004 Eppan a.d. Weinstr.,28,,93,93,186
004 Eppan a.d. Weinstr.,29,,82,86,168
004 Eppan a.d. Weinstr.,30,,95,91,186
004 Eppan a.d. Weinstr.,31,,92,81,173
004 Eppan a.d. Weinstr.,32,,86,95,181
004 Eppan a.d. Weinstr.,33,,91,104,195
004 Eppan a.d. Weinstr.,34,,98,103,201
004 Eppan a.d. Weinstr.,35,,103,99,202
004 Eppan a.d. Weinstr.,36,,110,135,245
004 Eppan a.d. Weinstr.,37,,115,103,218
004 Eppan a.d. Weinstr.,38,,135,120,255
004 Eppan a.d. Weinstr.,39,,142,125,267
004 Eppan a.d. Weinstr.,40,,121,116,237
004 Eppan a.d. Weinstr.,41,,128,126,254
004 Eppan a.d. Weinstr.,42,,128,139,267
004 Eppan a.d. Weinstr.,43,,107,113,220
004 Eppan a.d. Weinstr.,44,,138,115,253
004 Eppan a.d. Weinstr.,45,,112,124,236
004 Eppan a.d. Weinstr.,46,,128,117,245
004 Eppan a.d. Weinstr.,47,,130,107,237
004 Eppan a.d. Weinstr.,48,,111,116,227
004 Eppan a.d. Weinstr.,49,,111,111,222
004 Eppan a.d. Weinstr.,50,,104,104,208
004 Eppan a.d. Weinstr.,51,,94,92,186
004 Eppan a.d. Weinstr.,52,,93,76,169
004 Eppan a.d. Weinstr.,53,,86,86,172
004 Eppan a.d. Weinstr.,54,,75,86,161
004 Eppan a.d. Weinstr.,55,,87,79,166
004 Eppan a.d. Weinstr.,56,,68,85,153
004 Eppan a.d. Weinstr.,57,,84,68,152
004 Eppan a.d. Weinstr.,58,,56,78,134
004 Eppan a.d. Weinstr.,59,,62,61,123
004 Eppan a.d. Weinstr.,60,,78,71,149
004 Eppan a.d. Weinstr.,61,,63,82,145
004 Eppan a.d. Weinstr.,62,,82,70,152
004 Eppan a.d. Weinstr.,63,,57,50,107
004 Eppan a.d. Weinstr.,64,,70,82,152
004 Eppan a.d. Weinstr.,65,,94,82,176
004 Eppan a.d. Weinstr.,66,,88,79,167
004 Eppan a.d. Weinstr.,67,,62,104,166
004 Eppan a.d. Weinstr.,68,,70,55,125
004 Eppan a.d. Weinstr.,69,,59,79,138
004 Eppan a.d. Weinstr.,70,,54,51,105
004 Eppan a.d. Weinstr.,71,,43,57,100
004 Eppan a.d. Weinstr.,72,,44,48,92
004 Eppan a.d. Weinstr.,73,,33,46,79
004 Eppan a.d. Weinstr.,74,,30,48,78
004 Eppan a.d. Weinstr.,75,,50,50,100
004 Eppan a.d. Weinstr.,76,,39,49,88
004 Eppan a.d. Weinstr.,77,,31,55,86
004 Eppan a.d. Weinstr.,78,,44,57,101
004 Eppan a.d. Weinstr.,79,,34,50,84
004 Eppan a.d. Weinstr.,80,,33,37,70
004 Eppan a.d. Weinstr.,81,,26,42,68
004 Eppan a.d. Weinstr.,82,,27,45,72
004 Eppan a.d. Weinstr.,83,,26,45,71
004 Eppan a.d. Weinstr.,84,,11,49,60
004 Eppan a.d. Weinstr.,85,,14,31,45
004 Eppan a.d. Weinstr.,86,,9,34,43
004 Eppan a.d. Weinstr.,87,,14,26,40
004 Eppan a.d. Weinstr.,88,,9,19,28
004 Eppan a.d. Weinstr.,89,,6,13,19
004 Eppan a.d. Weinstr.,90,,6,9,15
004 Eppan a.d. Weinstr.,91,,5,5,10
004 Eppan a.d. Weinstr.,92,,4,6,10
004 Eppan a.d. Weinstr.,93,,1,3,4
004 Eppan a.d. Weinstr.,94,,3,7,10
004 Eppan a.d. Weinstr.,95,,1,4,5
004 Eppan a.d. Weinstr.,96,,-,8,8
004 Eppan a.d. Weinstr.,97,,1,10,11
004 Eppan a.d. Weinstr.,98,,-,2,2
004 Eppan a.d. Weinstr.,99,,3,3,6
004 Eppan a.d. Weinstr.,100,,-,1,1
004 Eppan a.d. Weinstr.,Insgesamt,,6.823,6.987,13.810
005 Hafling,0,,5,6,11
005 Hafling,1,,2,2,4
005 Hafling,2,,5,5,10
005 Hafling,3,,5,4,9
005 Hafling,4,,3,8,11
005 Hafling,5,,2,5,7
005 Hafling,6,,4,4,8
005 Hafling,7,,4,2,6
005 Hafling,8,,5,10,15
005 Hafling,9,,4,3,7
005 Hafling,10,,4,7,11
005 Hafling,11,,3,9,12
005 Hafling,12,,11,4,15
005 Hafling,13,,6,4,10
005 Hafling,14,,4,5,9
005 Hafling,15,,2,7,9
005 Hafling,16,,3,4,7
005 Hafling,17,,8,3,11
005 Hafling,18,,4,6,10
005 Hafling,19,,4,2,6
005 Hafling,20,,2,5,7
005 Hafling,21,,4,4,8
005 Hafling,22,,5,2,7
005 Hafling,23,,4,6,10
005 Hafling,24,,4,7,11
005 Hafling,25,,2,-,2
005 Hafling,26,,7,3,10
005 Hafling,27,,4,6,10
005 Hafling,28,,4,8,12
005 Hafling,29,,5,4,9
005 Hafling,30,,4,7,11
005 Hafling,31,,5,5,10
005 Hafling,32,,5,5,10
005 Hafling,33,,6,6,12
005 Hafling,34,,6,9,15
005 Hafling,35,,9,1,10
005 Hafling,36,,9,2,11
005 Hafling,37,,11,5,16
005 Hafling,38,,8,6,14
005 Hafling,39,,7,11,18
005 Hafling,40,,2,9,11
005 Hafling,41,,4,1,5
005 Hafling,42,,10,7,17
005 Hafling,43,,7,13,20
005 Hafling,44,,3,2,5
005 Hafling,45,,6,3,9
005 Hafling,46,,6,2,8
005 Hafling,47,,6,3,9
005 Hafling,48,,9,7,16
005 Hafling,49,,6,5,11
005 Hafling,50,,3,4,7
005 Hafling,51,,2,4,6
005 Hafling,52,,3,8,11
005 Hafling,53,,6,3,9
005 Hafling,54,,3,1,4
005 Hafling,55,,2,3,5
005 Hafling,56,,7,2,9
005 Hafling,57,,2,3,5
005 Hafling,58,,5,3,8
005 Hafling,59,,5,4,9
005 Hafling,60,,6,2,8
005 Hafling,61,,2,4,6
005 Hafling,62,,-,4,4
005 Hafling,63,,3,3,6
005 Hafling,64,,1,2,3
005 Hafling,65,,5,5,10
005 Hafling,66,,6,3,9
005 Hafling,67,,3,4,7
005 Hafling,68,,2,1,3
005 Hafling,69,,4,5,9
005 Hafling,70,,3,3,6
005 Hafling,71,,3,1,4
005 Hafling,72,,1,1,2
005 Hafling,73,,2,1,3
005 Hafling,74,,-,2,2
005 Hafling,75,,4,3,7
005 Hafling,76,,3,4,7
005 Hafling,77,,3,6,9
005 Hafling,78,,1,4,5
005 Hafling,79,,3,1,4
005 Hafling,80,,-,3,3
005 Hafling,81,,3,3,6
005 Hafling,82,,-,2,2
005 Hafling,83,,1,-,1
005 Hafling,84,,1,-,1
005 Hafling,85,,1,-,1
005 Hafling,86,,-,2,2
005 Hafling,87,,-,3,3
005 Hafling,88,,3,1,4
005 Hafling,89,,-,1,1
005 Hafling,91,,-,1,1
005 Hafling,92,,-,1,1
005 Hafling,Insgesamt,,360,365,725
006 Abtei,0,,24,18,42
006 Abtei,1,,28,23,51
006 Abtei,2,,29,22,51
006 Abtei,3,,21,28,49
006 Abtei,4,,26,15,41
006 Abtei,5,,21,19,40
006 Abtei,6,,13,31,44
006 Abtei,7,,25,23,48
006 Abtei,8,,23,32,55
006 Abtei,9,,21,26,47
006 Abtei,10,,14,14,28
006 Abtei,11,,26,23,49
006 Abtei,12,,28,15,43
006 Abtei,13,,24,30,54
006 Abtei,14,,19,16,35
006 Abtei,15,,16,18,34
006 Abtei,16,,24,14,38
006 Abtei,17,,21,13,34
006 Abtei,18,,23,17,40
006 Abtei,19,,15,16,31
006 Abtei,20,,15,11,26
006 Abtei,21,,19,12,31
006 Abtei,22,,17,17,34
006 Abtei,23,,11,11,22
006 Abtei,24,,13,19,32
006 Abtei,25,,14,13,27
006 Abtei,26,,19,19,38
006 Abtei,27,,19,19,38
006 Abtei,28,,26,21,47
006 Abtei,29,,15,24,39
006 Abtei,30,,23,31,54
006 Abtei,31,,21,32,53
006 Abtei,32,,28,24,52
006 Abtei,33,,17,31,48
006 Abtei,34,,20,31,51
006 Abtei,35,,27,24,51
006 Abtei,36,,44,34,78
006 Abtei,37,,17,33,50
006 Abtei,38,,29,32,61
006 Abtei,39,,29,35,64
006 Abtei,40,,28,34,62
006 Abtei,41,,34,33,67
006 Abtei,42,,22,31,53
006 Abtei,43,,37,25,62
006 Abtei,44,,25,31,56
006 Abtei,45,,31,26,57
006 Abtei,46,,25,31,56
006 Abtei,47,,25,27,52
006 Abtei,48,,27,24,51
006 Abtei,49,,26,23,49
006 Abtei,50,,19,22,41
006 Abtei,51,,19,15,34
006 Abtei,52,,19,18,37
006 Abtei,53,,16,15,31
006 Abtei,54,,11,15,26
006 Abtei,55,,14,19,33
006 Abtei,56,,13,13,26
006 Abtei,57,,12,13,25
006 Abtei,58,,15,19,34
006 Abtei,59,,10,19,29
006 Abtei,60,,24,17,41
006 Abtei,61,,15,16,31
006 Abtei,62,,23,19,42
006 Abtei,63,,15,20,35
006 Abtei,64,,13,17,30
006 Abtei,65,,12,11,23
006 Abtei,66,,21,12,33
006 Abtei,67,,15,23,38
006 Abtei,68,,16,17,33
006 Abtei,69,,14,13,27
006 Abtei,70,,15,17,32
006 Abtei,71,,6,18,24
006 Abtei,72,,16,9,25
006 Abtei,73,,12,17,29
006 Abtei,74,,13,15,28
006 Abtei,75,,8,15,23
006 Abtei,76,,7,5,12
006 Abtei,77,,9,11,20
006 Abtei,78,,13,10,23
006 Abtei,79,,5,7,12
006 Abtei,80,,5,12,17
006 Abtei,81,,6,8,14
006 Abtei,82,,4,5,9
006 Abtei,83,,6,4,10
006 Abtei,84,,5,8,13
006 Abtei,85,,4,8,12
006 Abtei,86,,4,4,8
006 Abtei,87,,2,2,4
006 Abtei,88,,2,7,9
006 Abtei,89,,1,3,4
006 Abtei,90,,1,1,2
006 Abtei,92,,1,2,3
006 Abtei,93,,-,2,2
006 Abtei,94,,-,1,1
006 Abtei,95,,1,-,1
006 Abtei,96,,-,2,2
006 Abtei,98,,1,-,1
006 Abtei,Insgesamt,,1.607,1.697,3.304
007 Barbian,0,,12,4,16
007 Barbian,1,,9,11,20
007 Barbian,2,,5,2,7
007 Barbian,3,,15,6,21
007 Barbian,4,,7,4,11
007 Barbian,5,,8,14,22
007 Barbian,6,,7,6,13
007 Barbian,7,,11,14,25
007 Barbian,8,,14,5,19
007 Barbian,9,,11,10,21
007 Barbian,10,,16,8,24
007 Barbian,11,,8,8,16
007 Barbian,12,,12,10,22
007 Barbian,13,,12,8,20
007 Barbian,14,,9,5,14
007 Barbian,15,,10,12,22
007 Barbian,16,,12,7,19
007 Barbian,17,,12,12,24
007 Barbian,18,,15,14,29
007 Barbian,19,,7,13,20
007 Barbian,20,,12,6,18
007 Barbian,21,,8,6,14
007 Barbian,22,,14,8,22
007 Barbian,23,,7,8,15
007 Barbian,24,,10,6,16
007 Barbian,25,,11,11,22
007 Barbian,26,,9,8,17
007 Barbian,27,,12,14,26
007 Barbian,28,,11,5,16
007 Barbian,29,,17,11,28
007 Barbian,30,,10,10,20
007 Barbian,31,,9,15,24
007 Barbian,32,,8,12,20
007 Barbian,33,,9,11,20
007 Barbian,34,,12,10,22
007 Barbian,35,,9,18,27
007 Barbian,36,,18,14,32
007 Barbian,37,,17,10,27
007 Barbian,38,,11,12,23
007 Barbian,39,,15,7,22
007 Barbian,40,,14,10,24
007 Barbian,41,,9,8,17
007 Barbian,42,,12,13,25
007 Barbian,43,,8,13,21
007 Barbian,44,,16,15,31
007 Barbian,45,,15,13,28
007 Barbian,46,,15,16,31
007 Barbian,47,,18,11,29
007 Barbian,48,,13,15,28
007 Barbian,49,,12,9,21
007 Barbian,50,,7,9,16
007 Barbian,51,,15,7,22
007 Barbian,52,,4,9,13
007 Barbian,53,,7,6,13
007 Barbian,54,,7,14,21
007 Barbian,55,,8,10,18
007 Barbian,56,,9,5,14
007 Barbian,57,,7,10,17
007 Barbian,58,,10,11,21
007 Barbian,59,,5,5,10
007 Barbian,60,,3,5,8
007 Barbian,61,,5,11,16
007 Barbian,62,,17,6,23
007 Barbian,63,,6,4,10
007 Barbian,64,,10,10,20
007 Barbian,65,,8,7,15
007 Barbian,66,,11,11,22
007 Barbian,67,,8,12,20
007 Barbian,68,,9,3,12
007 Barbian,69,,6,4,10
007 Barbian,70,,5,10,15
007 Barbian,71,,8,8,16
007 Barbian,72,,3,5,8
007 Barbian,73,,3,6,9
007 Barbian,74,,5,5,10
007 Barbian,75,,7,4,11
007 Barbian,76,,6,6,12
007 Barbian,77,,4,7,11
007 Barbian,78,,5,4,9
007 Barbian,79,,7,7,14
007 Barbian,80,,4,6,10
007 Barbian,81,,4,1,5
007 Barbian,82,,3,2,5
007 Barbian,83,,3,2,5
007 Barbian,84,,1,3,4
007 Barbian,85,,-,4,4
007 Barbian,86,,2,3,5
007 Barbian,87,,1,1,2
007 Barbian,88,,-,1,1
007 Barbian,89,,-,1,1
007 Barbian,90,,1,-,1
007 Barbian,92,,-,1,1
007 Barbian,97,,1,-,1
007 Barbian,Insgesamt,,808,744,1.552
008 Bozen,0,,499,477,976
008 Bozen,1,,541,463,1.004
008 Bozen,2,,466,484,950
008 Bozen,3,,529,479,1.008
008 Bozen,4,,525,474,999
008 Bozen,5,,518,509,1.027
008 Bozen,6,,502,449,951
008 Bozen,7,,499,457,956
008 Bozen,8,,456,474,930
008 Bozen,9,,491,471,962
008 Bozen,10,,475,461,936
008 Bozen,11,,481,415,896
008 Bozen,12,,449,486,935
008 Bozen,13,,447,405,852
008 Bozen,14,,481,452,933
008 Bozen,15,,420,449,869
008 Bozen,16,,454,402,856
008 Bozen,17,,489,420,909
008 Bozen,18,,480,427,907
008 Bozen,19,,471,446,917
008 Bozen,20,,475,433,908
008 Bozen,21,,387,426,813
008 Bozen,22,,453,419,872
008 Bozen,23,,473,444,917
008 Bozen,24,,473,480,953
008 Bozen,25,,551,455,1.006
008 Bozen,26,,540,479,1.019
008 Bozen,27,,555,509,1.064
008 Bozen,28,,651,518,1.169
008 Bozen,29,,560,559,1.119
008 Bozen,30,,603,574,1.177
008 Bozen,31,,617,594,1.211
008 Bozen,32,,655,665,1.320
008 Bozen,33,,696,696,1.392
008 Bozen,34,,767,761,1.528
008 Bozen,35,,713,817,1.530
008 Bozen,36,,825,811,1.636
008 Bozen,37,,865,874,1.739
008 Bozen,38,,839,813,1.652
008 Bozen,39,,912,865,1.777
008 Bozen,40,,826,797,1.623
008 Bozen,41,,807,858,1.665
008 Bozen,42,,903,886,1.789
008 Bozen,43,,933,891,1.824
008 Bozen,44,,908,916,1.824
008 Bozen,45,,758,865,1.623
008 Bozen,46,,764,803,1.567
008 Bozen,47,,766,742,1.508
008 Bozen,48,,714,740,1.454
008 Bozen,49,,705,701,1.406
008 Bozen,50,,701,714,1.415
008 Bozen,51,,615,731,1.346
008 Bozen,52,,630,671,1.301
008 Bozen,53,,604,645,1.249
008 Bozen,54,,607,617,1.224
008 Bozen,55,,537,630,1.167
008 Bozen,56,,525,649,1.174
008 Bozen,57,,528,632,1.160
008 Bozen,58,,581,676,1.257
008 Bozen,59,,581,641,1.222
008 Bozen,60,,616,733,1.349
008 Bozen,61,,604,800,1.404
008 Bozen,62,,693,873,1.566
008 Bozen,63,,519,578,1.097
008 Bozen,64,,564,706,1.270
008 Bozen,65,,612,715,1.327
008 Bozen,66,,626,700,1.326
008 Bozen,67,,666,735,1.401
008 Bozen,68,,629,713,1.342
008 Bozen,69,,557,707,1.264
008 Bozen,70,,586,653,1.239
008 Bozen,71,,509,565,1.074
008 Bozen,72,,458,549,1.007
008 Bozen,73,,442,559,1.001
008 Bozen,74,,448,538,986
008 Bozen,75,,379,540,919
008 Bozen,76,,394,538,932
008 Bozen,77,,389,533,922
008 Bozen,78,,374,515,889
008 Bozen,79,,260,476,736
008 Bozen,80,,301,458,759
008 Bozen,81,,263,439,702
008 Bozen,82,,297,416,713
008 Bozen,83,,223,447,670
008 Bozen,84,,202,378,580
008 Bozen,85,,178,393,571
008 Bozen,86,,153,396,549
008 Bozen,87,,149,329,478
008 Bozen,88,,107,294,401
008 Bozen,89,,53,177,230
008 Bozen,90,,27,94,121
008 Bozen,91,,27,79,106
008 Bozen,92,,30,90,120
008 Bozen,93,,22,99,121
008 Bozen,94,,32,85,117
008 Bozen,95,,17,71,88
008 Bozen,96,,14,52,66
008 Bozen,97,,6,35,41
008 Bozen,98,,5,23,28
008 Bozen,99,,5,17,22
008 Bozen,100,,1,11,12
008 Bozen,101,,-,7,7
008 Bozen,102,,-,2,2
008 Bozen,103,,-,1,1
008 Bozen,107,,-,1,1
008 Bozen,Insgesamt,,48.713,53.217,101.930
009 Prags,0,,4,5,9
009 Prags,1,,3,6,9
009 Prags,2,,4,3,7
009 Prags,3,,3,1,4
009 Prags,4,,3,3,6
009 Prags,5,,2,5,7
009 Prags,6,,2,6,8
009 Prags,7,,6,6,12
009 Prags,8,,2,3,5
009 Prags,9,,5,9,14
009 Prags,10,,1,4,5
009 Prags,11,,3,5,8
009 Prags,12,,2,7,9
009 Prags,13,,3,1,4
009 Prags,14,,5,6,11
009 Prags,15,,7,3,10
009 Prags,16,,6,2,8
009 Prags,17,,8,1,9
009 Prags,18,,6,2,8
009 Prags,19,,8,3,11
009 Prags,20,,2,4,6
009 Prags,21,,3,3,6
009 Prags,22,,7,4,11
009 Prags,23,,8,2,10
009 Prags,24,,5,3,8
009 Prags,25,,3,5,8
009 Prags,26,,3,7,10
009 Prags,27,,2,5,7
009 Prags,28,,5,-,5
009 Prags,29,,2,1,3
009 Prags,30,,6,5,11
009 Prags,31,,2,4,6
009 Prags,32,,6,4,10
009 Prags,33,,3,5,8
009 Prags,34,,2,4,6
009 Prags,35,,7,3,10
009 Prags,36,,3,3,6
009 Prags,37,,5,5,10
009 Prags,38,,5,7,12
009 Prags,39,,9,5,14
009 Prags,40,,8,8,16
009 Prags,41,,7,6,13
009 Prags,42,,7,6,13
009 Prags,43,,8,7,15
009 Prags,44,,6,4,10
009 Prags,45,,6,5,11
009 Prags,46,,3,4,7
009 Prags,47,,5,12,17
009 Prags,48,,5,3,8
009 Prags,49,,11,5,16
009 Prags,50,,6,2,8
009 Prags,51,,6,4,10
009 Prags,52,,1,5,6
009 Prags,53,,4,5,9
009 Prags,54,,6,4,10
009 Prags,55,,4,2,6
009 Prags,56,,2,5,7
009 Prags,57,,3,1,4
009 Prags,58,,5,1,6
009 Prags,59,,1,1,2
009 Prags,60,,4,1,5
009 Prags,61,,1,-,1
009 Prags,62,,2,4,6
009 Prags,63,,2,2,4
009 Prags,64,,4,4,8
009 Prags,65,,1,3,4
009 Prags,66,,4,4,8
009 Prags,67,,5,2,7
009 Prags,68,,1,3,4
009 Prags,69,,3,5,8
009 Prags,70,,3,2,5
009 Prags,71,,-,2,2
009 Prags,72,,2,3,5
009 Prags,73,,1,3,4
009 Prags,74,,3,2,5
009 Prags,75,,3,2,5
009 Prags,76,,4,5,9
009 Prags,77,,1,3,4
009 Prags,78,,1,1,2
009 Prags,79,,1,2,3
009 Prags,80,,3,2,5
009 Prags,81,,2,5,7
009 Prags,82,,2,4,6
009 Prags,83,,1,4,5
009 Prags,84,,3,2,5
009 Prags,85,,-,4,4
009 Prags,86,,2,1,3
009 Prags,87,,1,2,3
009 Prags,88,,1,-,1
009 Prags,89,,-,2,2
009 Prags,93,,-,1,1
009 Prags,Insgesamt,,336,330,666
010 Brenner,0,,9,14,23
010 Brenner,1,,10,11,21
010 Brenner,2,,6,15,21
010 Brenner,3,,11,9,20
010 Brenner,4,,9,18,27
010 Brenner,5,,11,9,20
010 Brenner,6,,14,12,26
010 Brenner,7,,5,7,12
010 Brenner,8,,17,12,29
010 Brenner,9,,11,15,26
010 Brenner,10,,16,5,21
010 Brenner,11,,16,7,23
010 Brenner,12,,5,11,16
010 Brenner,13,,6,10,16
010 Brenner,14,,21,12,33
010 Brenner,15,,16,6,22
010 Brenner,16,,12,10,22
010 Brenner,17,,8,16,24
010 Brenner,18,,11,7,18
010 Brenner,19,,14,6,20
010 Brenner,20,,11,5,16
010 Brenner,21,,8,9,17
010 Brenner,22,,12,11,23
010 Brenner,23,,23,8,31
010 Brenner,24,,19,16,35
010 Brenner,25,,17,19,36
010 Brenner,26,,17,10,27
010 Brenner,27,,14,20,34
010 Brenner,28,,18,15,33
010 Brenner,29,,14,11,25
010 Brenner,30,,16,16,32
010 Brenner,31,,23,9,32
010 Brenner,32,,15,10,25
010 Brenner,33,,17,19,36
010 Brenner,34,,17,10,27
010 Brenner,35,,15,6,21
010 Brenner,36,,21,24,45
010 Brenner,37,,26,15,41
010 Brenner,38,,21,18,39
010 Brenner,39,,10,18,28
010 Brenner,40,,12,16,28
010 Brenner,41,,17,15,32
010 Brenner,42,,20,17,37
010 Brenner,43,,23,18,41
010 Brenner,44,,21,16,37
010 Brenner,45,,11,20,31
010 Brenner,46,,17,12,29
010 Brenner,47,,19,12,31
010 Brenner,48,,22,12,34
010 Brenner,49,,15,13,28
010 Brenner,50,,18,10,28
010 Brenner,51,,15,20,35
010 Brenner,52,,17,12,29
010 Brenner,53,,14,9,23
010 Brenner,54,,10,14,24
010 Brenner,55,,9,15,24
010 Brenner,56,,20,9,29
010 Brenner,57,,15,12,27
010 Brenner,58,,10,12,22
010 Brenner,59,,16,15,31
010 Brenner,60,,7,8,15
010 Brenner,61,,20,13,33
010 Brenner,62,,8,16,24
010 Brenner,63,,5,8,13
010 Brenner,64,,17,13,30
010 Brenner,65,,16,12,28
010 Brenner,66,,5,9,14
010 Brenner,67,,11,12,23
010 Brenner,68,,8,12,20
010 Brenner,69,,7,9,16
010 Brenner,70,,10,15,25
010 Brenner,71,,8,13,21
010 Brenner,72,,12,8,20
010 Brenner,73,,4,6,10
010 Brenner,74,,7,7,14
010 Brenner,75,,6,6,12
010 Brenner,76,,2,4,6
010 Brenner,77,,6,9,15
010 Brenner,78,,8,12,20
010 Brenner,79,,9,9,18
010 Brenner,80,,7,6,13
010 Brenner,81,,5,2,7
010 Brenner,82,,5,9,14
010 Brenner,83,,2,7,9
010 Brenner,84,,2,6,8
010 Brenner,85,,2,8,10
010 Brenner,86,,-,5,5
010 Brenner,87,,1,1,2
010 Brenner,88,,1,5,6
010 Brenner,89,,1,2,3
010 Brenner,90,,1,-,1
010 Brenner,93,,-,1,1
010 Brenner,94,,1,1,2
010 Brenner,97,,1,-,1
010 Brenner,Insgesamt,,1.088,1.014,2.102
011 Brixen,0,,105,101,206
011 Brixen,1,,121,100,221
011 Brixen,2,,117,101,218
011 Brixen,3,,129,114,243
011 Brixen,4,,115,114,229
011 Brixen,5,,111,109,220
011 Brixen,6,,113,113,226
011 Brixen,7,,121,126,247
011 Brixen,8,,116,108,224
011 Brixen,9,,137,122,259
011 Brixen,10,,113,137,250
011 Brixen,11,,124,108,232
011 Brixen,12,,120,112,232
011 Brixen,13,,117,124,241
011 Brixen,14,,123,119,242
011 Brixen,15,,118,104,222
011 Brixen,16,,112,124,236
011 Brixen,17,,120,107,227
011 Brixen,18,,107,109,216
011 Brixen,19,,123,102,225
011 Brixen,20,,121,96,217
011 Brixen,21,,105,110,215
011 Brixen,22,,107,121,228
011 Brixen,23,,116,92,208
011 Brixen,24,,119,94,213
011 Brixen,25,,128,136,264
011 Brixen,26,,128,125,253
011 Brixen,27,,139,123,262
011 Brixen,28,,115,120,235
011 Brixen,29,,139,137,276
011 Brixen,30,,112,134,246
011 Brixen,31,,135,129,264
011 Brixen,32,,138,151,289
011 Brixen,33,,128,127,255
011 Brixen,34,,141,151,292
011 Brixen,35,,160,159,319
011 Brixen,36,,162,166,328
011 Brixen,37,,166,173,339
011 Brixen,38,,171,158,329
011 Brixen,39,,199,184,383
011 Brixen,40,,179,206,385
011 Brixen,41,,169,167,336
011 Brixen,42,,176,191,367
011 Brixen,43,,183,158,341
011 Brixen,44,,183,184,367
011 Brixen,45,,155,168,323
011 Brixen,46,,169,162,331
011 Brixen,47,,145,168,313
011 Brixen,48,,140,150,290
011 Brixen,49,,149,139,288
011 Brixen,50,,153,124,277
011 Brixen,51,,135,149,284
011 Brixen,52,,114,139,253
011 Brixen,53,,123,101,224
011 Brixen,54,,97,116,213
011 Brixen,55,,92,106,198
011 Brixen,56,,101,103,204
011 Brixen,57,,98,109,207
011 Brixen,58,,112,101,213
011 Brixen,59,,81,125,206
011 Brixen,60,,107,119,226
011 Brixen,61,,92,114,206
011 Brixen,62,,99,106,205
011 Brixen,63,,66,102,168
011 Brixen,64,,112,113,225
011 Brixen,65,,128,120,248
011 Brixen,66,,90,98,188
011 Brixen,67,,103,123,226
011 Brixen,68,,83,115,198
011 Brixen,69,,90,107,197
011 Brixen,70,,88,94,182
011 Brixen,71,,85,90,175
011 Brixen,72,,65,93,158
011 Brixen,73,,77,83,160
011 Brixen,74,,64,90,154
011 Brixen,75,,69,64,133
011 Brixen,76,,72,75,147
011 Brixen,77,,61,78,139
011 Brixen,78,,54,90,144
011 Brixen,79,,43,82,125
011 Brixen,80,,49,67,116
011 Brixen,81,,29,79,108
011 Brixen,82,,38,61,99
011 Brixen,83,,37,66,103
011 Brixen,84,,26,68,94
011 Brixen,85,,33,51,84
011 Brixen,86,,20,56,76
011 Brixen,87,,19,53,72
011 Brixen,88,,15,42,57
011 Brixen,89,,9,24,33
011 Brixen,90,,5,18,23
011 Brixen,91,,10,21,31
011 Brixen,92,,2,11,13
011 Brixen,93,,1,12,13
011 Brixen,94,,5,13,18
011 Brixen,95,,2,7,9
011 Brixen,96,,2,14,16
011 Brixen,97,,-,11,11
011 Brixen,98,,-,6,6
011 Brixen,99,,1,2,3
011 Brixen,100,,-,2,2
011 Brixen,101,,-,2,2
011 Brixen,Insgesamt,,9.796,10.448,20.244
012 Branzoll,0,,14,15,29
012 Branzoll,1,,13,20,33
012 Branzoll,2,,13,9,22
012 Branzoll,3,,8,10,18
012 Branzoll,4,,17,16,33
012 Branzoll,5,,17,23,40
012 Branzoll,6,,15,14,29
012 Branzoll,7,,12,11,23
012 Branzoll,8,,20,7,27
012 Branzoll,9,,9,13,22
012 Branzoll,10,,14,7,21
012 Branzoll,11,,13,21,34
012 Branzoll,12,,16,8,24
012 Branzoll,13,,13,11,24
012 Branzoll,14,,16,9,25
012 Branzoll,15,,21,13,34
012 Branzoll,16,,15,14,29
012 Branzoll,17,,16,16,32
012 Branzoll,18,,14,17,31
012 Branzoll,19,,10,12,22
012 Branzoll,20,,16,16,32
012 Branzoll,21,,12,6,18
012 Branzoll,22,,9,13,22
012 Branzoll,23,,14,17,31
012 Branzoll,24,,19,14,33
012 Branzoll,25,,13,11,24
012 Branzoll,26,,19,14,33
012 Branzoll,27,,14,16,30
012 Branzoll,28,,10,18,28
012 Branzoll,29,,12,10,22
012 Branzoll,30,,15,23,38
012 Branzoll,31,,14,25,39
012 Branzoll,32,,14,16,30
012 Branzoll,33,,20,16,36
012 Branzoll,34,,23,27,50
012 Branzoll,35,,23,15,38
012 Branzoll,36,,22,15,37
012 Branzoll,37,,26,29,55
012 Branzoll,38,,19,24,43
012 Branzoll,39,,27,24,51
012 Branzoll,40,,22,26,48
012 Branzoll,41,,21,23,44
012 Branzoll,42,,22,18,40
012 Branzoll,43,,24,21,45
012 Branzoll,44,,30,25,55
012 Branzoll,45,,21,17,38
012 Branzoll,46,,16,18,34
012 Branzoll,47,,28,27,55
012 Branzoll,48,,27,20,47
012 Branzoll,49,,20,25,45
012 Branzoll,50,,19,17,36
012 Branzoll,51,,21,14,35
012 Branzoll,52,,13,19,32
012 Branzoll,53,,18,17,35
012 Branzoll,54,,21,17,38
012 Branzoll,55,,11,21,32
012 Branzoll,56,,15,21,36
012 Branzoll,57,,16,14,30
012 Branzoll,58,,17,15,32
012 Branzoll,59,,17,16,33
012 Branzoll,60,,15,16,31
012 Branzoll,61,,15,17,32
012 Branzoll,62,,15,20,35
012 Branzoll,63,,14,9,23
012 Branzoll,64,,12,11,23
012 Branzoll,65,,14,11,25
012 Branzoll,66,,19,11,30
012 Branzoll,67,,19,12,31
012 Branzoll,68,,11,13,24
012 Branzoll,69,,15,12,27
012 Branzoll,70,,9,10,19
012 Branzoll,71,,3,7,10
012 Branzoll,72,,7,8,15
012 Branzoll,73,,8,8,16
012 Branzoll,74,,4,10,14
012 Branzoll,75,,19,10,29
012 Branzoll,76,,8,10,18
012 Branzoll,77,,2,10,12
012 Branzoll,78,,6,15,21
012 Branzoll,79,,4,10,14
012 Branzoll,80,,4,10,14
012 Branzoll,81,,4,6,10
012 Branzoll,82,,4,9,13
012 Branzoll,83,,3,4,7
012 Branzoll,84,,1,6,7
012 Branzoll,85,,5,10,15
012 Branzoll,86,,-,3,3
012 Branzoll,87,,3,6,9
012 Branzoll,88,,1,4,5
012 Branzoll,89,,1,4,5
012 Branzoll,90,,2,3,5
012 Branzoll,94,,-,2,2
012 Branzoll,96,,-,2,2
012 Branzoll,97,,1,-,1
012 Branzoll,Insgesamt,,1.274,1.305,2.579
013 Bruneck,0,,80,64,144
013 Bruneck,1,,86,65,151
013 Bruneck,2,,111,73,184
013 Bruneck,3,,77,83,160
013 Bruneck,4,,88,95,183
013 Bruneck,5,,98,73,171
013 Bruneck,6,,73,92,165
013 Bruneck,7,,97,73,170
013 Bruneck,8,,87,89,176
013 Bruneck,9,,95,92,187
013 Bruneck,10,,97,91,188
013 Bruneck,11,,109,72,181
013 Bruneck,12,,76,88,164
013 Bruneck,13,,63,79,142
013 Bruneck,14,,87,75,162
013 Bruneck,15,,83,69,152
013 Bruneck,16,,92,73,165
013 Bruneck,17,,88,61,149
013 Bruneck,18,,89,72,161
013 Bruneck,19,,79,85,164
013 Bruneck,20,,75,75,150
013 Bruneck,21,,62,61,123
013 Bruneck,22,,110,89,199
013 Bruneck,23,,82,76,158
013 Bruneck,24,,88,87,175
013 Bruneck,25,,96,84,180
013 Bruneck,26,,96,96,192
013 Bruneck,27,,103,116,219
013 Bruneck,28,,104,102,206
013 Bruneck,29,,105,100,205
013 Bruneck,30,,119,113,232
013 Bruneck,31,,122,97,219
013 Bruneck,32,,113,119,232
013 Bruneck,33,,118,117,235
013 Bruneck,34,,128,108,236
013 Bruneck,35,,134,115,249
013 Bruneck,36,,121,121,242
013 Bruneck,37,,138,113,251
013 Bruneck,38,,123,134,257
013 Bruneck,39,,138,124,262
013 Bruneck,40,,125,147,272
013 Bruneck,41,,141,129,270
013 Bruneck,42,,129,123,252
013 Bruneck,43,,149,144,293
013 Bruneck,44,,133,135,268
013 Bruneck,45,,129,116,245
013 Bruneck,46,,125,116,241
013 Bruneck,47,,115,100,215
013 Bruneck,48,,103,114,217
013 Bruneck,49,,112,99,211
013 Bruneck,50,,107,109,216
013 Bruneck,51,,83,98,181
013 Bruneck,52,,87,92,179
013 Bruneck,53,,77,80,157
013 Bruneck,54,,91,86,177
013 Bruneck,55,,75,97,172
013 Bruneck,56,,85,97,182
013 Bruneck,57,,71,98,169
013 Bruneck,58,,78,94,172
013 Bruneck,59,,83,95,178
013 Bruneck,60,,74,107,181
013 Bruneck,61,,94,69,163
013 Bruneck,62,,102,85,187
013 Bruneck,63,,62,68,130
013 Bruneck,64,,86,95,181
013 Bruneck,65,,92,84,176
013 Bruneck,66,,84,86,170
013 Bruneck,67,,76,97,173
013 Bruneck,68,,71,85,156
013 Bruneck,69,,81,92,173
013 Bruneck,70,,57,50,107
013 Bruneck,71,,50,54,104
013 Bruneck,72,,53,55,108
013 Bruneck,73,,45,47,92
013 Bruneck,74,,38,49,87
013 Bruneck,75,,46,59,105
013 Bruneck,76,,48,52,100
013 Bruneck,77,,33,46,79
013 Bruneck,78,,29,54,83
013 Bruneck,79,,25,58,83
013 Bruneck,80,,33,54,87
013 Bruneck,81,,25,40,65
013 Bruneck,82,,20,33,53
013 Bruneck,83,,21,42,63
013 Bruneck,84,,11,51,62
013 Bruneck,85,,21,35,56
013 Bruneck,86,,17,25,42
013 Bruneck,87,,11,20,31
013 Bruneck,88,,7,20,27
013 Bruneck,89,,7,13,20
013 Bruneck,90,,2,8,10
013 Bruneck,91,,4,14,18
013 Bruneck,92,,2,12,14
013 Bruneck,93,,2,8,10
013 Bruneck,94,,3,9,12
013 Bruneck,95,,-,6,6
013 Bruneck,96,,4,3,7
013 Bruneck,97,,-,4,4
013 Bruneck,98,,-,1,1
013 Bruneck,99,,-,2,2
013 Bruneck,100,,-,1,1
013 Bruneck,Insgesamt,,7.464,7.573,15.037
014 Kuens,0,,2,3,5
014 Kuens,1,,1,5,6
014 Kuens,2,,2,1,3
014 Kuens,3,,6,2,8
014 Kuens,4,,1,3,4
014 Kuens,5,,4,4,8
014 Kuens,6,,2,1,3
014 Kuens,7,,5,3,8
014 Kuens,8,,2,6,8
014 Kuens,9,,2,3,5
014 Kuens,10,,3,5,8
014 Kuens,11,,2,1,3
014 Kuens,12,,5,2,7
014 Kuens,13,,2,3,5
014 Kuens,14,,1,4,5
014 Kuens,15,,3,2,5
014 Kuens,16,,4,2,6
014 Kuens,17,,2,3,5
014 Kuens,18,,4,2,6
014 Kuens,19,,3,2,5
014 Kuens,20,,1,3,4
014 Kuens,21,,2,-,2
014 Kuens,22,,1,-,1
014 Kuens,24,,-,2,2
014 Kuens,25,,2,-,2
014 Kuens,26,,2,1,3
014 Kuens,27,,2,3,5
014 Kuens,28,,3,4,7
014 Kuens,29,,1,2,3
014 Kuens,30,,2,1,3
014 Kuens,31,,2,-,2
014 Kuens,32,,3,2,5
014 Kuens,33,,4,6,10
014 Kuens,34,,3,7,10
014 Kuens,35,,-,4,4
014 Kuens,36,,4,1,5
014 Kuens,37,,2,5,7
014 Kuens,38,,7,3,10
014 Kuens,39,,4,1,5
014 Kuens,40,,4,4,8
014 Kuens,41,,6,11,17
014 Kuens,42,,1,6,7
014 Kuens,43,,7,1,8
014 Kuens,44,,7,5,12
014 Kuens,45,,8,2,10
014 Kuens,46,,5,1,6
014 Kuens,47,,-,5,5
014 Kuens,49,,1,-,1
014 Kuens,50,,1,4,5
014 Kuens,51,,3,-,3
014 Kuens,52,,3,-,3
014 Kuens,53,,-,3,3
014 Kuens,54,,-,1,1
014 Kuens,55,,1,2,3
014 Kuens,56,,1,3,4
014 Kuens,57,,1,-,1
014 Kuens,58,,-,3,3
014 Kuens,59,,-,2,2
014 Kuens,60,,3,1,4
014 Kuens,61,,1,2,3
014 Kuens,62,,1,2,3
014 Kuens,63,,3,1,4
014 Kuens,65,,-,2,2
014 Kuens,66,,-,3,3
014 Kuens,67,,-,2,2
014 Kuens,68,,-,1,1
014 Kuens,69,,5,2,7
014 Kuens,70,,3,2,5
014 Kuens,71,,1,3,4
014 Kuens,72,,2,2,4
014 Kuens,73,,1,3,4
014 Kuens,74,,-,1,1
014 Kuens,75,,1,1,2
014 Kuens,76,,4,2,6
014 Kuens,77,,2,2,4
014 Kuens,78,,2,2,4
014 Kuens,79,,1,-,1
014 Kuens,80,,1,-,1
014 Kuens,81,,1,-,1
014 Kuens,82,,1,1,2
014 Kuens,86,,-,2,2
014 Kuens,89,,-,2,2
014 Kuens,92,,-,1,1
014 Kuens,93,,1,-,1
014 Kuens,96,,1,-,1
014 Kuens,Insgesamt,,185,195,380
015 Kaltern a.d. Weinstr.,0,,39,38,77
015 Kaltern a.d. Weinstr.,1,,48,47,95
015 Kaltern a.d. Weinstr.,2,,46,40,86
015 Kaltern a.d. Weinstr.,3,,48,43,91
015 Kaltern a.d. Weinstr.,4,,44,48,92
015 Kaltern a.d. Weinstr.,5,,47,37,84
015 Kaltern a.d. Weinstr.,6,,42,39,81
015 Kaltern a.d. Weinstr.,7,,32,49,81
015 Kaltern a.d. Weinstr.,8,,39,38,77
015 Kaltern a.d. Weinstr.,9,,44,37,81
015 Kaltern a.d. Weinstr.,10,,38,46,84
015 Kaltern a.d. Weinstr.,11,,46,45,91
015 Kaltern a.d. Weinstr.,12,,42,45,87
015 Kaltern a.d. Weinstr.,13,,43,35,78
015 Kaltern a.d. Weinstr.,14,,36,37,73
015 Kaltern a.d. Weinstr.,15,,31,39,70
015 Kaltern a.d. Weinstr.,16,,38,39,77
015 Kaltern a.d. Weinstr.,17,,36,43,79
015 Kaltern a.d. Weinstr.,18,,39,35,74
015 Kaltern a.d. Weinstr.,19,,54,27,81
015 Kaltern a.d. Weinstr.,20,,43,36,79
015 Kaltern a.d. Weinstr.,21,,38,33,71
015 Kaltern a.d. Weinstr.,22,,55,39,94
015 Kaltern a.d. Weinstr.,23,,49,42,91
015 Kaltern a.d. Weinstr.,24,,38,34,72
015 Kaltern a.d. Weinstr.,25,,43,40,83
015 Kaltern a.d. Weinstr.,26,,46,54,100
015 Kaltern a.d. Weinstr.,27,,42,37,79
015 Kaltern a.d. Weinstr.,28,,43,59,102
015 Kaltern a.d. Weinstr.,29,,50,43,93
015 Kaltern a.d. Weinstr.,30,,50,50,100
015 Kaltern a.d. Weinstr.,31,,38,58,96
015 Kaltern a.d. Weinstr.,32,,44,55,99
015 Kaltern a.d. Weinstr.,33,,44,69,113
015 Kaltern a.d. Weinstr.,34,,47,54,101
015 Kaltern a.d. Weinstr.,35,,45,61,106
015 Kaltern a.d. Weinstr.,36,,64,69,133
015 Kaltern a.d. Weinstr.,37,,64,58,122
015 Kaltern a.d. Weinstr.,38,,64,61,125
015 Kaltern a.d. Weinstr.,39,,64,67,131
015 Kaltern a.d. Weinstr.,40,,80,71,151
015 Kaltern a.d. Weinstr.,41,,66,63,129
015 Kaltern a.d. Weinstr.,42,,63,71,134
015 Kaltern a.d. Weinstr.,43,,58,60,118
015 Kaltern a.d. Weinstr.,44,,82,53,135
015 Kaltern a.d. Weinstr.,45,,54,56,110
015 Kaltern a.d. Weinstr.,46,,61,61,122
015 Kaltern a.d. Weinstr.,47,,65,63,128
015 Kaltern a.d. Weinstr.,48,,53,65,118
015 Kaltern a.d. Weinstr.,49,,54,54,108
015 Kaltern a.d. Weinstr.,50,,55,61,116
015 Kaltern a.d. Weinstr.,51,,54,61,115
015 Kaltern a.d. Weinstr.,52,,64,42,106
015 Kaltern a.d. Weinstr.,53,,55,41,96
015 Kaltern a.d. Weinstr.,54,,36,51,87
015 Kaltern a.d. Weinstr.,55,,38,41,79
015 Kaltern a.d. Weinstr.,56,,41,58,99
015 Kaltern a.d. Weinstr.,57,,33,35,68
015 Kaltern a.d. Weinstr.,58,,45,36,81
015 Kaltern a.d. Weinstr.,59,,29,40,69
015 Kaltern a.d. Weinstr.,60,,38,36,74
015 Kaltern a.d. Weinstr.,61,,36,54,90
015 Kaltern a.d. Weinstr.,62,,48,46,94
015 Kaltern a.d. Weinstr.,63,,39,38,77
015 Kaltern a.d. Weinstr.,64,,36,39,75
015 Kaltern a.d. Weinstr.,65,,34,39,73
015 Kaltern a.d. Weinstr.,66,,43,40,83
015 Kaltern a.d. Weinstr.,67,,43,43,86
015 Kaltern a.d. Weinstr.,68,,28,44,72
015 Kaltern a.d. Weinstr.,69,,25,36,61
015 Kaltern a.d. Weinstr.,70,,35,39,74
015 Kaltern a.d. Weinstr.,71,,29,30,59
015 Kaltern a.d. Weinstr.,72,,24,21,45
015 Kaltern a.d. Weinstr.,73,,27,25,52
015 Kaltern a.d. Weinstr.,74,,23,25,48
015 Kaltern a.d. Weinstr.,75,,25,36,61
015 Kaltern a.d. Weinstr.,76,,27,31,58
015 Kaltern a.d. Weinstr.,77,,20,31,51
015 Kaltern a.d. Weinstr.,78,,23,37,60
015 Kaltern a.d. Weinstr.,79,,18,32,50
015 Kaltern a.d. Weinstr.,80,,18,28,46
015 Kaltern a.d. Weinstr.,81,,13,30,43
015 Kaltern a.d. Weinstr.,82,,11,26,37
015 Kaltern a.d. Weinstr.,83,,17,30,47
015 Kaltern a.d. Weinstr.,84,,10,20,30
015 Kaltern a.d. Weinstr.,85,,4,21,25
015 Kaltern a.d. Weinstr.,86,,6,26,32
015 Kaltern a.d. Weinstr.,87,,6,23,29
015 Kaltern a.d. Weinstr.,88,,4,20,24
015 Kaltern a.d. Weinstr.,89,,3,13,16
015 Kaltern a.d. Weinstr.,90,,2,7,9
015 Kaltern a.d. Weinstr.,91,,2,5,7
015 Kaltern a.d. Weinstr.,92,,1,-,1
015 Kaltern a.d. Weinstr.,93,,1,4,5
015 Kaltern a.d. Weinstr.,94,,1,8,9
015 Kaltern a.d. Weinstr.,95,,2,4,6
015 Kaltern a.d. Weinstr.,96,,-,7,7
015 Kaltern a.d. Weinstr.,97,,1,2,3
015 Kaltern a.d. Weinstr.,Insgesamt,,3.612,3.905,7.517
016 Freienfeld,0,,12,13,25
016 Freienfeld,1,,24,13,37
016 Freienfeld,2,,15,15,30
016 Freienfeld,3,,16,18,34
016 Freienfeld,4,,16,9,25
016 Freienfeld,5,,20,15,35
016 Freienfeld,6,,19,20,39
016 Freienfeld,7,,18,21,39
016 Freienfeld,8,,16,14,30
016 Freienfeld,9,,16,19,35
016 Freienfeld,10,,14,19,33
016 Freienfeld,11,,19,17,36
016 Freienfeld,12,,23,13,36
016 Freienfeld,13,,16,17,33
016 Freienfeld,14,,15,12,27
016 Freienfeld,15,,14,13,27
016 Freienfeld,16,,17,22,39
016 Freienfeld,17,,11,12,23
016 Freienfeld,18,,20,18,38
016 Freienfeld,19,,28,19,47
016 Freienfeld,20,,19,17,36
016 Freienfeld,21,,16,17,33
016 Freienfeld,22,,16,13,29
016 Freienfeld,23,,15,14,29
016 Freienfeld,24,,25,16,41
016 Freienfeld,25,,25,19,44
016 Freienfeld,26,,15,16,31
016 Freienfeld,27,,21,21,42
016 Freienfeld,28,,21,13,34
016 Freienfeld,29,,19,19,38
016 Freienfeld,30,,15,15,30
016 Freienfeld,31,,18,21,39
016 Freienfeld,32,,18,17,35
016 Freienfeld,33,,24,15,39
016 Freienfeld,34,,24,17,41
016 Freienfeld,35,,22,21,43
016 Freienfeld,36,,16,24,40
016 Freienfeld,37,,23,22,45
016 Freienfeld,38,,23,20,43
016 Freienfeld,39,,27,26,53
016 Freienfeld,40,,25,20,45
016 Freienfeld,41,,21,31,52
016 Freienfeld,42,,28,20,48
016 Freienfeld,43,,28,21,49
016 Freienfeld,44,,26,18,44
016 Freienfeld,45,,20,18,38
016 Freienfeld,46,,25,26,51
016 Freienfeld,47,,24,19,43
016 Freienfeld,48,,26,23,49
016 Freienfeld,49,,24,14,38
016 Freienfeld,50,,16,20,36
016 Freienfeld,51,,14,19,33
016 Freienfeld,52,,22,18,40
016 Freienfeld,53,,21,9,30
016 Freienfeld,54,,16,18,34
016 Freienfeld,55,,17,10,27
016 Freienfeld,56,,15,18,33
016 Freienfeld,57,,13,11,24
016 Freienfeld,58,,20,9,29
016 Freienfeld,59,,16,13,29
016 Freienfeld,60,,19,13,32
016 Freienfeld,61,,4,10,14
016 Freienfeld,62,,12,16,28
016 Freienfeld,63,,11,2,13
016 Freienfeld,64,,10,5,15
016 Freienfeld,65,,12,8,20
016 Freienfeld,66,,12,9,21
016 Freienfeld,67,,12,12,24
016 Freienfeld,68,,10,4,14
016 Freienfeld,69,,10,9,19
016 Freienfeld,70,,13,12,25
016 Freienfeld,71,,6,11,17
016 Freienfeld,72,,8,11,19
016 Freienfeld,73,,6,12,18
016 Freienfeld,74,,4,5,9
016 Freienfeld,75,,6,8,14
016 Freienfeld,76,,8,9,17
016 Freienfeld,77,,7,8,15
016 Freienfeld,78,,6,5,11
016 Freienfeld,79,,4,5,9
016 Freienfeld,80,,5,5,10
016 Freienfeld,81,,4,7,11
016 Freienfeld,82,,6,11,17
016 Freienfeld,83,,5,8,13
016 Freienfeld,84,,1,2,3
016 Freienfeld,85,,1,10,11
016 Freienfeld,86,,1,6,7
016 Freienfeld,87,,-,1,1
016 Freienfeld,88,,3,2,5
016 Freienfeld,89,,1,1,2
016 Freienfeld,90,,-,1,1
016 Freienfeld,92,,-,1,1
016 Freienfeld,93,,-,1,1
016 Freienfeld,94,,-,1,1
016 Freienfeld,95,,-,1,1
016 Freienfeld,97,,-,1,1
016 Freienfeld,98,,1,-,1
016 Freienfeld,Insgesamt,,1.376,1.270,2.646
017 Sand in Taufers,0,,31,35,66
017 Sand in Taufers,1,,52,40,92
017 Sand in Taufers,2,,35,23,58
017 Sand in Taufers,3,,35,30,65
017 Sand in Taufers,4,,35,20,55
017 Sand in Taufers,5,,35,26,61
017 Sand in Taufers,6,,27,32,59
017 Sand in Taufers,7,,32,37,69
017 Sand in Taufers,8,,43,20,63
017 Sand in Taufers,9,,36,36,72
017 Sand in Taufers,10,,26,34,60
017 Sand in Taufers,11,,34,36,70
017 Sand in Taufers,12,,29,30,59
017 Sand in Taufers,13,,28,27,55
017 Sand in Taufers,14,,39,34,73
017 Sand in Taufers,15,,23,36,59
017 Sand in Taufers,16,,33,36,69
017 Sand in Taufers,17,,27,31,58
017 Sand in Taufers,18,,24,32,56
017 Sand in Taufers,19,,30,30,60
017 Sand in Taufers,20,,29,31,60
017 Sand in Taufers,21,,22,23,45
017 Sand in Taufers,22,,25,17,42
017 Sand in Taufers,23,,25,27,52
017 Sand in Taufers,24,,33,27,60
017 Sand in Taufers,25,,35,32,67
017 Sand in Taufers,26,,26,36,62
017 Sand in Taufers,27,,33,36,69
017 Sand in Taufers,28,,41,39,80
017 Sand in Taufers,29,,31,39,70
017 Sand in Taufers,30,,42,36,78
017 Sand in Taufers,31,,34,37,71
017 Sand in Taufers,32,,39,36,75
017 Sand in Taufers,33,,43,35,78
017 Sand in Taufers,34,,56,47,103
017 Sand in Taufers,35,,57,45,102
017 Sand in Taufers,36,,48,50,98
017 Sand in Taufers,37,,47,47,94
017 Sand in Taufers,38,,43,59,102
017 Sand in Taufers,39,,54,43,97
017 Sand in Taufers,40,,53,38,91
017 Sand in Taufers,41,,32,44,76
017 Sand in Taufers,42,,53,34,87
017 Sand in Taufers,43,,50,39,89
017 Sand in Taufers,44,,48,42,90
017 Sand in Taufers,45,,47,43,90
017 Sand in Taufers,46,,37,41,78
017 Sand in Taufers,47,,45,42,87
017 Sand in Taufers,48,,39,32,71
017 Sand in Taufers,49,,33,33,66
017 Sand in Taufers,50,,31,21,52
017 Sand in Taufers,51,,25,38,63
017 Sand in Taufers,52,,24,35,59
017 Sand in Taufers,53,,23,22,45
017 Sand in Taufers,54,,29,30,59
017 Sand in Taufers,55,,31,24,55
017 Sand in Taufers,56,,17,28,45
017 Sand in Taufers,57,,25,22,47
017 Sand in Taufers,58,,34,32,66
017 Sand in Taufers,59,,31,22,53
017 Sand in Taufers,60,,22,25,47
017 Sand in Taufers,61,,25,28,53
017 Sand in Taufers,62,,26,25,51
017 Sand in Taufers,63,,27,8,35
017 Sand in Taufers,64,,15,30,45
017 Sand in Taufers,65,,29,28,57
017 Sand in Taufers,66,,28,32,60
017 Sand in Taufers,67,,25,31,56
017 Sand in Taufers,68,,23,18,41
017 Sand in Taufers,69,,26,29,55
017 Sand in Taufers,70,,16,26,42
017 Sand in Taufers,71,,26,12,38
017 Sand in Taufers,72,,15,25,40
017 Sand in Taufers,73,,27,16,43
017 Sand in Taufers,74,,13,11,24
017 Sand in Taufers,75,,12,17,29
017 Sand in Taufers,76,,10,17,27
017 Sand in Taufers,77,,11,11,22
017 Sand in Taufers,78,,11,19,30
017 Sand in Taufers,79,,12,12,24
017 Sand in Taufers,80,,8,12,20
017 Sand in Taufers,81,,7,8,15
017 Sand in Taufers,82,,7,16,23
017 Sand in Taufers,83,,7,9,16
017 Sand in Taufers,84,,4,13,17
017 Sand in Taufers,85,,8,8,16
017 Sand in Taufers,86,,3,15,18
017 Sand in Taufers,87,,3,13,16
017 Sand in Taufers,88,,4,7,11
017 Sand in Taufers,89,,3,6,9
017 Sand in Taufers,90,,2,2,4
017 Sand in Taufers,91,,-,2,2
017 Sand in Taufers,92,,-,1,1
017 Sand in Taufers,93,,2,5,7
017 Sand in Taufers,94,,1,3,4
017 Sand in Taufers,95,,-,2,2
017 Sand in Taufers,96,,-,1,1
017 Sand in Taufers,97,,-,2,2
017 Sand in Taufers,99,,1,1,2
017 Sand in Taufers,Insgesamt,,2.583,2.575,5.158
018 Kastelbell-Tschars,0,,12,6,18
018 Kastelbell-Tschars,1,,12,8,20
018 Kastelbell-Tschars,2,,15,8,23
018 Kastelbell-Tschars,3,,9,9,18
018 Kastelbell-Tschars,4,,12,11,23
018 Kastelbell-Tschars,5,,12,9,21
018 Kastelbell-Tschars,6,,7,9,16
018 Kastelbell-Tschars,7,,16,15,31
018 Kastelbell-Tschars,8,,12,8,20
018 Kastelbell-Tschars,9,,24,12,36
018 Kastelbell-Tschars,10,,16,9,25
018 Kastelbell-Tschars,11,,10,12,22
018 Kastelbell-Tschars,12,,15,17,32
018 Kastelbell-Tschars,13,,15,10,25
018 Kastelbell-Tschars,14,,14,16,30
018 Kastelbell-Tschars,15,,13,15,28
018 Kastelbell-Tschars,16,,14,14,28
018 Kastelbell-Tschars,17,,19,14,33
018 Kastelbell-Tschars,18,,14,10,24
018 Kastelbell-Tschars,19,,17,9,26
018 Kastelbell-Tschars,20,,19,8,27
018 Kastelbell-Tschars,21,,18,16,34
018 Kastelbell-Tschars,22,,16,22,38
018 Kastelbell-Tschars,23,,21,20,41
018 Kastelbell-Tschars,24,,9,13,22
018 Kastelbell-Tschars,25,,15,19,34
018 Kastelbell-Tschars,26,,26,15,41
018 Kastelbell-Tschars,27,,14,13,27
018 Kastelbell-Tschars,28,,15,15,30
018 Kastelbell-Tschars,29,,15,15,30
018 Kastelbell-Tschars,30,,16,17,33
018 Kastelbell-Tschars,31,,11,17,28
018 Kastelbell-Tschars,32,,25,19,44
018 Kastelbell-Tschars,33,,17,12,29
018 Kastelbell-Tschars,34,,19,10,29
018 Kastelbell-Tschars,35,,17,25,42
018 Kastelbell-Tschars,36,,10,22,32
018 Kastelbell-Tschars,37,,16,15,31
018 Kastelbell-Tschars,38,,14,15,29
018 Kastelbell-Tschars,39,,26,26,52
018 Kastelbell-Tschars,40,,16,17,33
018 Kastelbell-Tschars,41,,12,20,32
018 Kastelbell-Tschars,42,,18,12,30
018 Kastelbell-Tschars,43,,20,13,33
018 Kastelbell-Tschars,44,,22,14,36
018 Kastelbell-Tschars,45,,25,20,45
018 Kastelbell-Tschars,46,,7,22,29
018 Kastelbell-Tschars,47,,23,19,42
018 Kastelbell-Tschars,48,,24,19,43
018 Kastelbell-Tschars,49,,22,19,41
018 Kastelbell-Tschars,50,,19,14,33
018 Kastelbell-Tschars,51,,16,10,26
018 Kastelbell-Tschars,52,,14,16,30
018 Kastelbell-Tschars,53,,22,18,40
018 Kastelbell-Tschars,54,,9,13,22
018 Kastelbell-Tschars,55,,9,16,25
018 Kastelbell-Tschars,56,,14,15,29
018 Kastelbell-Tschars,57,,16,12,28
018 Kastelbell-Tschars,58,,11,13,24
018 Kastelbell-Tschars,59,,15,8,23
018 Kastelbell-Tschars,60,,11,12,23
018 Kastelbell-Tschars,61,,9,8,17
018 Kastelbell-Tschars,62,,12,13,25
018 Kastelbell-Tschars,63,,10,4,14
018 Kastelbell-Tschars,64,,11,6,17
018 Kastelbell-Tschars,65,,8,7,15
018 Kastelbell-Tschars,66,,12,12,24
018 Kastelbell-Tschars,67,,10,8,18
018 Kastelbell-Tschars,68,,8,9,17
018 Kastelbell-Tschars,69,,12,12,24
018 Kastelbell-Tschars,70,,7,15,22
018 Kastelbell-Tschars,71,,11,11,22
018 Kastelbell-Tschars,72,,10,15,25
018 Kastelbell-Tschars,73,,10,9,19
018 Kastelbell-Tschars,74,,5,14,19
018 Kastelbell-Tschars,75,,16,13,29
018 Kastelbell-Tschars,76,,7,13,20
018 Kastelbell-Tschars,77,,9,14,23
018 Kastelbell-Tschars,78,,16,15,31
018 Kastelbell-Tschars,79,,10,11,21
018 Kastelbell-Tschars,80,,6,10,16
018 Kastelbell-Tschars,81,,6,7,13
018 Kastelbell-Tschars,82,,8,13,21
018 Kastelbell-Tschars,83,,10,10,20
018 Kastelbell-Tschars,84,,2,8,10
018 Kastelbell-Tschars,85,,4,7,11
018 Kastelbell-Tschars,86,,1,6,7
018 Kastelbell-Tschars,87,,2,5,7
018 Kastelbell-Tschars,88,,3,4,7
018 Kastelbell-Tschars,89,,-,2,2
018 Kastelbell-Tschars,90,,-,3,3
018 Kastelbell-Tschars,91,,1,2,3
018 Kastelbell-Tschars,92,,-,1,1
018 Kastelbell-Tschars,94,,-,1,1
018 Kastelbell-Tschars,97,,-,1,1
018 Kastelbell-Tschars,98,,-,1,1
018 Kastelbell-Tschars,99,,1,-,1
018 Kastelbell-Tschars,Insgesamt,,1.199,1.167,2.366
019 Kastelruth,0,,53,35,88
019 Kastelruth,1,,43,39,82
019 Kastelruth,2,,47,37,84
019 Kastelruth,3,,46,35,81
019 Kastelruth,4,,43,37,80
019 Kastelruth,5,,43,40,83
019 Kastelruth,6,,39,33,72
019 Kastelruth,7,,42,33,75
019 Kastelruth,8,,35,28,63
019 Kastelruth,9,,34,41,75
019 Kastelruth,10,,51,45,96
019 Kastelruth,11,,46,46,92
019 Kastelruth,12,,43,37,80
019 Kastelruth,13,,50,41,91
019 Kastelruth,14,,34,33,67
019 Kastelruth,15,,37,36,73
019 Kastelruth,16,,35,55,90
019 Kastelruth,17,,35,39,74
019 Kastelruth,18,,39,39,78
019 Kastelruth,19,,47,39,86
019 Kastelruth,20,,26,23,49
019 Kastelruth,21,,36,40,76
019 Kastelruth,22,,37,26,63
019 Kastelruth,23,,28,33,61
019 Kastelruth,24,,33,33,66
019 Kastelruth,25,,34,39,73
019 Kastelruth,26,,48,42,90
019 Kastelruth,27,,42,40,82
019 Kastelruth,28,,45,36,81
019 Kastelruth,29,,37,39,76
019 Kastelruth,30,,33,37,70
019 Kastelruth,31,,35,36,71
019 Kastelruth,32,,38,65,103
019 Kastelruth,33,,54,43,97
019 Kastelruth,34,,61,43,104
019 Kastelruth,35,,41,61,102
019 Kastelruth,36,,63,42,105
019 Kastelruth,37,,59,44,103
019 Kastelruth,38,,52,54,106
019 Kastelruth,39,,61,44,105
019 Kastelruth,40,,61,60,121
019 Kastelruth,41,,68,53,121
019 Kastelruth,42,,74,50,124
019 Kastelruth,43,,45,75,120
019 Kastelruth,44,,55,39,94
019 Kastelruth,45,,51,34,85
019 Kastelruth,46,,37,52,89
019 Kastelruth,47,,55,44,99
019 Kastelruth,48,,47,44,91
019 Kastelruth,49,,46,44,90
019 Kastelruth,50,,51,40,91
019 Kastelruth,51,,40,41,81
019 Kastelruth,52,,36,31,67
019 Kastelruth,53,,39,37,76
019 Kastelruth,54,,36,30,66
019 Kastelruth,55,,29,29,58
019 Kastelruth,56,,38,26,64
019 Kastelruth,57,,30,25,55
019 Kastelruth,58,,45,24,69
019 Kastelruth,59,,19,36,55
019 Kastelruth,60,,27,40,67
019 Kastelruth,61,,36,29,65
019 Kastelruth,62,,23,38,61
019 Kastelruth,63,,25,21,46
019 Kastelruth,64,,20,46,66
019 Kastelruth,65,,40,40,80
019 Kastelruth,66,,33,29,62
019 Kastelruth,67,,30,44,74
019 Kastelruth,68,,28,34,62
019 Kastelruth,69,,28,28,56
019 Kastelruth,70,,25,25,50
019 Kastelruth,71,,27,25,52
019 Kastelruth,72,,29,19,48
019 Kastelruth,73,,25,28,53
019 Kastelruth,74,,21,23,44
019 Kastelruth,75,,32,28,60
019 Kastelruth,76,,17,36,53
019 Kastelruth,77,,33,24,57
019 Kastelruth,78,,11,24,35
019 Kastelruth,79,,19,26,45
019 Kastelruth,80,,9,14,23
019 Kastelruth,81,,17,27,44
019 Kastelruth,82,,11,17,28
019 Kastelruth,83,,9,16,25
019 Kastelruth,84,,10,19,29
019 Kastelruth,85,,6,17,23
019 Kastelruth,86,,9,12,21
019 Kastelruth,87,,5,12,17
019 Kastelruth,88,,3,9,12
019 Kastelruth,89,,5,4,9
019 Kastelruth,90,,1,3,4
019 Kastelruth,91,,1,2,3
019 Kastelruth,92,,-,3,3
019 Kastelruth,93,,1,6,7
019 Kastelruth,94,,-,5,5
019 Kastelruth,95,,2,3,5
019 Kastelruth,96,,1,4,5
019 Kastelruth,97,,-,1,1
019 Kastelruth,100,,1,-,1
019 Kastelruth,103,,-,1,1
019 Kastelruth,Insgesamt,,3.227,3.184,6.411
020 Tscherms,0,,4,14,18
020 Tscherms,1,,6,9,15
020 Tscherms,2,,8,9,17
020 Tscherms,3,,2,9,11
020 Tscherms,4,,8,5,13
020 Tscherms,5,,9,7,16
020 Tscherms,6,,7,9,16
020 Tscherms,7,,6,9,15
020 Tscherms,8,,9,5,14
020 Tscherms,9,,8,8,16
020 Tscherms,10,,4,8,12
020 Tscherms,11,,8,9,17
020 Tscherms,12,,6,3,9
020 Tscherms,13,,14,10,24
020 Tscherms,14,,9,18,27
020 Tscherms,15,,8,11,19
020 Tscherms,16,,13,7,20
020 Tscherms,17,,6,8,14
020 Tscherms,18,,9,7,16
020 Tscherms,19,,6,5,11
020 Tscherms,20,,5,15,20
020 Tscherms,21,,7,8,15
020 Tscherms,22,,12,9,21
020 Tscherms,23,,14,10,24
020 Tscherms,24,,13,7,20
020 Tscherms,25,,11,13,24
020 Tscherms,26,,9,7,16
020 Tscherms,27,,7,6,13
020 Tscherms,28,,9,10,19
020 Tscherms,29,,8,9,17
020 Tscherms,30,,6,10,16
020 Tscherms,31,,11,4,15
020 Tscherms,32,,6,9,15
020 Tscherms,33,,10,8,18
020 Tscherms,34,,9,7,16
020 Tscherms,35,,11,15,26
020 Tscherms,36,,11,10,21
020 Tscherms,37,,8,13,21
020 Tscherms,38,,10,8,18
020 Tscherms,39,,14,16,30
020 Tscherms,40,,14,11,25
020 Tscherms,41,,11,15,26
020 Tscherms,42,,17,5,22
020 Tscherms,43,,18,16,34
020 Tscherms,44,,12,15,27
020 Tscherms,45,,15,15,30
020 Tscherms,46,,18,13,31
020 Tscherms,47,,11,11,22
020 Tscherms,48,,10,15,25
020 Tscherms,49,,8,16,24
020 Tscherms,50,,8,7,15
020 Tscherms,51,,9,10,19
020 Tscherms,52,,9,6,15
020 Tscherms,53,,10,8,18
020 Tscherms,54,,10,9,19
020 Tscherms,55,,10,8,18
020 Tscherms,56,,11,8,19
020 Tscherms,57,,5,10,15
020 Tscherms,58,,9,6,15
020 Tscherms,59,,3,3,6
020 Tscherms,60,,6,5,11
020 Tscherms,61,,7,7,14
020 Tscherms,62,,5,7,12
020 Tscherms,63,,4,6,10
020 Tscherms,64,,4,9,13
020 Tscherms,65,,5,3,8
020 Tscherms,66,,7,4,11
020 Tscherms,67,,10,9,19
020 Tscherms,68,,5,5,10
020 Tscherms,69,,5,5,10
020 Tscherms,70,,8,2,10
020 Tscherms,71,,5,8,13
020 Tscherms,72,,6,7,13
020 Tscherms,73,,3,4,7
020 Tscherms,74,,2,8,10
020 Tscherms,75,,4,3,7
020 Tscherms,76,,4,5,9
020 Tscherms,77,,2,3,5
020 Tscherms,78,,3,5,8
020 Tscherms,79,,2,2,4
020 Tscherms,80,,4,5,9
020 Tscherms,81,,4,4,8
020 Tscherms,82,,3,2,5
020 Tscherms,83,,3,4,7
020 Tscherms,84,,3,5,8
020 Tscherms,85,,1,3,4
020 Tscherms,86,,1,4,5
020 Tscherms,87,,-,2,2
020 Tscherms,88,,3,3,6
020 Tscherms,89,,-,1,1
020 Tscherms,90,,-,1,1
020 Tscherms,91,,-,1,1
020 Tscherms,92,,-,1,1
020 Tscherms,93,,1,-,1
020 Tscherms,94,,-,1,1
020 Tscherms,96,,1,-,1
020 Tscherms,98,,-,1,1
020 Tscherms,Insgesamt,,680,716,1.396
021 Kiens,0,,17,7,24
021 Kiens,1,,13,11,24
021 Kiens,2,,12,11,23
021 Kiens,3,,14,20,34
021 Kiens,4,,15,12,27
021 Kiens,5,,14,18,32
021 Kiens,6,,10,13,23
021 Kiens,7,,21,21,42
021 Kiens,8,,9,20,29
021 Kiens,9,,15,17,32
021 Kiens,10,,22,8,30
021 Kiens,11,,17,13,30
021 Kiens,12,,15,18,33
021 Kiens,13,,14,20,34
021 Kiens,14,,19,17,36
021 Kiens,15,,18,18,36
021 Kiens,16,,26,19,45
021 Kiens,17,,12,26,38
021 Kiens,18,,16,22,38
021 Kiens,19,,12,20,32
021 Kiens,20,,12,15,27
021 Kiens,21,,12,16,28
021 Kiens,22,,20,10,30
021 Kiens,23,,19,14,33
021 Kiens,24,,18,12,30
021 Kiens,25,,15,19,34
021 Kiens,26,,21,17,38
021 Kiens,27,,14,16,30
021 Kiens,28,,20,21,41
021 Kiens,29,,12,16,28
021 Kiens,30,,25,17,42
021 Kiens,31,,19,17,36
021 Kiens,32,,23,21,44
021 Kiens,33,,19,18,37
021 Kiens,34,,17,22,39
021 Kiens,35,,28,23,51
021 Kiens,36,,21,20,41
021 Kiens,37,,27,23,50
021 Kiens,38,,26,28,54
021 Kiens,39,,34,23,57
021 Kiens,40,,36,18,54
021 Kiens,41,,21,24,45
021 Kiens,42,,30,25,55
021 Kiens,43,,21,22,43
021 Kiens,44,,31,23,54
021 Kiens,45,,18,22,40
021 Kiens,46,,30,18,48
021 Kiens,47,,21,23,44
021 Kiens,48,,23,18,41
021 Kiens,49,,24,16,40
021 Kiens,50,,14,13,27
021 Kiens,51,,12,18,30
021 Kiens,52,,19,13,32
021 Kiens,53,,13,8,21
021 Kiens,54,,11,16,27
021 Kiens,55,,14,22,36
021 Kiens,56,,12,9,21
021 Kiens,57,,13,12,25
021 Kiens,58,,16,10,26
021 Kiens,59,,10,13,23
021 Kiens,60,,14,18,32
021 Kiens,61,,13,15,28
021 Kiens,62,,21,13,34
021 Kiens,63,,8,11,19
021 Kiens,64,,10,14,24
021 Kiens,65,,19,10,29
021 Kiens,66,,16,10,26
021 Kiens,67,,14,11,25
021 Kiens,68,,11,16,27
021 Kiens,69,,11,9,20
021 Kiens,70,,12,12,24
021 Kiens,71,,10,11,21
021 Kiens,72,,9,10,19
021 Kiens,73,,4,17,21
021 Kiens,74,,9,10,19
021 Kiens,75,,11,7,18
021 Kiens,76,,12,11,23
021 Kiens,77,,11,8,19
021 Kiens,78,,6,11,17
021 Kiens,79,,4,9,13
021 Kiens,80,,2,3,5
021 Kiens,81,,3,5,8
021 Kiens,82,,2,4,6
021 Kiens,83,,3,3,6
021 Kiens,84,,2,6,8
021 Kiens,85,,3,4,7
021 Kiens,86,,3,2,5
021 Kiens,87,,-,4,4
021 Kiens,88,,1,2,3
021 Kiens,89,,-,1,1
021 Kiens,90,,-,1,1
021 Kiens,91,,-,1,1
021 Kiens,93,,1,1,2
021 Kiens,94,,1,1,2
021 Kiens,95,,1,2,3
021 Kiens,96,,-,2,2
021 Kiens,Insgesamt,,1.349,1.317,2.666
022 Klausen,0,,29,24,53
022 Klausen,1,,33,28,61
022 Klausen,2,,41,40,81
022 Klausen,3,,38,32,70
022 Klausen,4,,36,38,74
022 Klausen,5,,29,31,60
022 Klausen,6,,43,27,70
022 Klausen,7,,30,30,60
022 Klausen,8,,30,31,61
022 Klausen,9,,29,30,59
022 Klausen,10,,23,29,52
022 Klausen,11,,41,35,76
022 Klausen,12,,30,28,58
022 Klausen,13,,32,27,59
022 Klausen,14,,16,34,50
022 Klausen,15,,32,27,59
022 Klausen,16,,44,26,70
022 Klausen,17,,34,36,70
022 Klausen,18,,38,25,63
022 Klausen,19,,27,30,57
022 Klausen,20,,35,31,66
022 Klausen,21,,24,36,60
022 Klausen,22,,35,31,66
022 Klausen,23,,37,37,74
022 Klausen,24,,31,27,58
022 Klausen,25,,24,38,62
022 Klausen,26,,40,35,75
022 Klausen,27,,41,32,73
022 Klausen,28,,32,42,74
022 Klausen,29,,38,29,67
022 Klausen,30,,40,45,85
022 Klausen,31,,37,37,74
022 Klausen,32,,42,31,73
022 Klausen,33,,40,42,82
022 Klausen,34,,42,32,74
022 Klausen,35,,42,33,75
022 Klausen,36,,36,40,76
022 Klausen,37,,43,44,87
022 Klausen,38,,42,46,88
022 Klausen,39,,48,50,98
022 Klausen,40,,50,45,95
022 Klausen,41,,53,42,95
022 Klausen,42,,59,43,102
022 Klausen,43,,41,50,91
022 Klausen,44,,43,48,91
022 Klausen,45,,38,38,76
022 Klausen,46,,35,38,73
022 Klausen,47,,50,43,93
022 Klausen,48,,41,26,67
022 Klausen,49,,34,38,72
022 Klausen,50,,26,30,56
022 Klausen,51,,32,25,57
022 Klausen,52,,30,23,53
022 Klausen,53,,29,33,62
022 Klausen,54,,33,41,74
022 Klausen,55,,20,30,50
022 Klausen,56,,25,16,41
022 Klausen,57,,33,26,59
022 Klausen,58,,28,24,52
022 Klausen,59,,30,24,54
022 Klausen,60,,27,26,53
022 Klausen,61,,24,20,44
022 Klausen,62,,30,20,50
022 Klausen,63,,12,16,28
022 Klausen,64,,23,18,41
022 Klausen,65,,18,29,47
022 Klausen,66,,21,25,46
022 Klausen,67,,28,20,48
022 Klausen,68,,22,22,44
022 Klausen,69,,23,18,41
022 Klausen,70,,15,20,35
022 Klausen,71,,18,17,35
022 Klausen,72,,16,22,38
022 Klausen,73,,10,17,27
022 Klausen,74,,18,15,33
022 Klausen,75,,23,16,39
022 Klausen,76,,10,18,28
022 Klausen,77,,12,13,25
022 Klausen,78,,10,17,27
022 Klausen,79,,16,18,34
022 Klausen,80,,4,16,20
022 Klausen,81,,3,15,18
022 Klausen,82,,9,9,18
022 Klausen,83,,9,8,17
022 Klausen,84,,6,11,17
022 Klausen,85,,2,9,11
022 Klausen,86,,3,7,10
022 Klausen,87,,-,5,5
022 Klausen,88,,2,8,10
022 Klausen,89,,2,6,8
022 Klausen,90,,1,5,6
022 Klausen,91,,1,5,6
022 Klausen,92,,-,1,1
022 Klausen,94,,2,1,3
022 Klausen,95,,-,3,3
022 Klausen,97,,1,-,1
022 Klausen,98,,-,1,1
022 Klausen,99,,-,1,1
022 Klausen,Insgesamt,,2.555,2.527,5.082
023 Karneid,0,,30,15,45
023 Karneid,1,,23,20,43
023 Karneid,2,,20,13,33
023 Karneid,3,,22,20,42
023 Karneid,4,,20,22,42
023 Karneid,5,,24,18,42
023 Karneid,6,,16,13,29
023 Karneid,7,,23,19,42
023 Karneid,8,,15,19,34
023 Karneid,9,,24,25,49
023 Karneid,10,,20,19,39
023 Karneid,11,,29,18,47
023 Karneid,12,,20,24,44
023 Karneid,13,,26,20,46
023 Karneid,14,,22,22,44
023 Karneid,15,,22,20,42
023 Karneid,16,,24,19,43
023 Karneid,17,,16,21,37
023 Karneid,18,,23,17,40
023 Karneid,19,,15,20,35
023 Karneid,20,,16,18,34
023 Karneid,21,,14,22,36
023 Karneid,22,,20,21,41
023 Karneid,23,,20,15,35
023 Karneid,24,,26,18,44
023 Karneid,25,,17,11,28
023 Karneid,26,,19,14,33
023 Karneid,27,,30,34,64
023 Karneid,28,,20,20,40
023 Karneid,29,,27,34,61
023 Karneid,30,,23,11,34
023 Karneid,31,,16,24,40
023 Karneid,32,,27,26,53
023 Karneid,33,,19,19,38
023 Karneid,34,,26,24,50
023 Karneid,35,,30,30,60
023 Karneid,36,,30,24,54
023 Karneid,37,,34,37,71
023 Karneid,38,,37,21,58
023 Karneid,39,,22,27,49
023 Karneid,40,,38,31,69
023 Karneid,41,,34,31,65
023 Karneid,42,,34,35,69
023 Karneid,43,,32,24,56
023 Karneid,44,,32,25,57
023 Karneid,45,,39,24,63
023 Karneid,46,,27,39,66
023 Karneid,47,,27,21,48
023 Karneid,48,,32,26,58
023 Karneid,49,,27,19,46
023 Karneid,50,,23,18,41
023 Karneid,51,,17,15,32
023 Karneid,52,,22,20,42
023 Karneid,53,,16,11,27
023 Karneid,54,,15,14,29
023 Karneid,55,,19,13,32
023 Karneid,56,,13,21,34
023 Karneid,57,,18,11,29
023 Karneid,58,,24,18,42
023 Karneid,59,,9,15,24
023 Karneid,60,,16,26,42
023 Karneid,61,,9,15,24
023 Karneid,62,,12,20,32
023 Karneid,63,,11,14,25
023 Karneid,64,,11,14,25
023 Karneid,65,,19,14,33
023 Karneid,66,,16,24,40
023 Karneid,67,,19,15,34
023 Karneid,68,,13,14,27
023 Karneid,69,,17,14,31
023 Karneid,70,,21,12,33
023 Karneid,71,,9,8,17
023 Karneid,72,,12,11,23
023 Karneid,73,,9,11,20
023 Karneid,74,,10,15,25
023 Karneid,75,,8,14,22
023 Karneid,76,,12,4,16
023 Karneid,77,,15,11,26
023 Karneid,78,,7,8,15
023 Karneid,79,,9,11,20
023 Karneid,80,,8,7,15
023 Karneid,81,,2,8,10
023 Karneid,82,,5,9,14
023 Karneid,83,,1,7,8
023 Karneid,84,,6,7,13
023 Karneid,85,,3,1,4
023 Karneid,86,,1,5,6
023 Karneid,87,,-,5,5
023 Karneid,88,,2,6,8
023 Karneid,89,,4,1,5
023 Karneid,90,,-,2,2
023 Karneid,91,,-,1,1
023 Karneid,92,,-,1,1
023 Karneid,95,,-,1,1
023 Karneid,96,,-,3,3
023 Karneid,98,,1,-,1
023 Karneid,Insgesamt,,1.693,1.604,3.297
024 Kurtatsch a.d.Weinstr.,0,,17,7,24
024 Kurtatsch a.d.Weinstr.,1,,7,6,13
024 Kurtatsch a.d.Weinstr.,2,,7,16,23
024 Kurtatsch a.d.Weinstr.,3,,12,15,27
024 Kurtatsch a.d.Weinstr.,4,,11,12,23
024 Kurtatsch a.d.Weinstr.,5,,11,12,23
024 Kurtatsch a.d.Weinstr.,6,,11,17,28
024 Kurtatsch a.d.Weinstr.,7,,21,13,34
024 Kurtatsch a.d.Weinstr.,8,,18,14,32
024 Kurtatsch a.d.Weinstr.,9,,18,12,30
024 Kurtatsch a.d.Weinstr.,10,,17,15,32
024 Kurtatsch a.d.Weinstr.,11,,13,15,28
024 Kurtatsch a.d.Weinstr.,12,,23,18,41
024 Kurtatsch a.d.Weinstr.,13,,20,11,31
024 Kurtatsch a.d.Weinstr.,14,,14,6,20
024 Kurtatsch a.d.Weinstr.,15,,23,19,42
024 Kurtatsch a.d.Weinstr.,16,,20,11,31
024 Kurtatsch a.d.Weinstr.,17,,16,17,33
024 Kurtatsch a.d.Weinstr.,18,,12,8,20
024 Kurtatsch a.d.Weinstr.,19,,10,16,26
024 Kurtatsch a.d.Weinstr.,20,,7,14,21
024 Kurtatsch a.d.Weinstr.,21,,12,12,24
024 Kurtatsch a.d.Weinstr.,22,,10,10,20
024 Kurtatsch a.d.Weinstr.,23,,13,12,25
024 Kurtatsch a.d.Weinstr.,24,,14,10,24
024 Kurtatsch a.d.Weinstr.,25,,15,8,23
024 Kurtatsch a.d.Weinstr.,26,,11,20,31
024 Kurtatsch a.d.Weinstr.,27,,12,12,24
024 Kurtatsch a.d.Weinstr.,28,,10,14,24
024 Kurtatsch a.d.Weinstr.,29,,9,12,21
024 Kurtatsch a.d.Weinstr.,30,,12,10,22
024 Kurtatsch a.d.Weinstr.,31,,9,16,25
024 Kurtatsch a.d.Weinstr.,32,,13,12,25
024 Kurtatsch a.d.Weinstr.,33,,11,11,22
024 Kurtatsch a.d.Weinstr.,34,,15,19,34
024 Kurtatsch a.d.Weinstr.,35,,16,20,36
024 Kurtatsch a.d.Weinstr.,36,,12,16,28
024 Kurtatsch a.d.Weinstr.,37,,16,20,36
024 Kurtatsch a.d.Weinstr.,38,,14,26,40
024 Kurtatsch a.d.Weinstr.,39,,28,23,51
024 Kurtatsch a.d.Weinstr.,40,,29,15,44
024 Kurtatsch a.d.Weinstr.,41,,20,20,40
024 Kurtatsch a.d.Weinstr.,42,,29,16,45
024 Kurtatsch a.d.Weinstr.,43,,25,27,52
024 Kurtatsch a.d.Weinstr.,44,,15,25,40
024 Kurtatsch a.d.Weinstr.,45,,23,20,43
024 Kurtatsch a.d.Weinstr.,46,,24,10,34
024 Kurtatsch a.d.Weinstr.,47,,19,15,34
024 Kurtatsch a.d.Weinstr.,48,,18,22,40
024 Kurtatsch a.d.Weinstr.,49,,20,10,30
024 Kurtatsch a.d.Weinstr.,50,,15,15,30
024 Kurtatsch a.d.Weinstr.,51,,10,11,21
024 Kurtatsch a.d.Weinstr.,52,,9,9,18
024 Kurtatsch a.d.Weinstr.,53,,14,19,33
024 Kurtatsch a.d.Weinstr.,54,,15,8,23
024 Kurtatsch a.d.Weinstr.,55,,18,20,38
024 Kurtatsch a.d.Weinstr.,56,,11,8,19
024 Kurtatsch a.d.Weinstr.,57,,8,14,22
024 Kurtatsch a.d.Weinstr.,58,,14,5,19
024 Kurtatsch a.d.Weinstr.,59,,11,9,20
024 Kurtatsch a.d.Weinstr.,60,,11,9,20
024 Kurtatsch a.d.Weinstr.,61,,11,8,19
024 Kurtatsch a.d.Weinstr.,62,,12,8,20
024 Kurtatsch a.d.Weinstr.,63,,7,8,15
024 Kurtatsch a.d.Weinstr.,64,,5,9,14
024 Kurtatsch a.d.Weinstr.,65,,10,7,17
024 Kurtatsch a.d.Weinstr.,66,,10,12,22
024 Kurtatsch a.d.Weinstr.,67,,9,12,21
024 Kurtatsch a.d.Weinstr.,68,,11,11,22
024 Kurtatsch a.d.Weinstr.,69,,3,15,18
024 Kurtatsch a.d.Weinstr.,70,,12,11,23
024 Kurtatsch a.d.Weinstr.,71,,4,10,14
024 Kurtatsch a.d.Weinstr.,72,,8,7,15
024 Kurtatsch a.d.Weinstr.,73,,4,7,11
024 Kurtatsch a.d.Weinstr.,74,,4,9,13
024 Kurtatsch a.d.Weinstr.,75,,8,7,15
024 Kurtatsch a.d.Weinstr.,76,,11,15,26
024 Kurtatsch a.d.Weinstr.,77,,7,9,16
024 Kurtatsch a.d.Weinstr.,78,,9,14,23
024 Kurtatsch a.d.Weinstr.,79,,7,7,14
024 Kurtatsch a.d.Weinstr.,80,,7,9,16
024 Kurtatsch a.d.Weinstr.,81,,8,6,14
024 Kurtatsch a.d.Weinstr.,82,,2,4,6
024 Kurtatsch a.d.Weinstr.,83,,4,7,11
024 Kurtatsch a.d.Weinstr.,84,,3,7,10
024 Kurtatsch a.d.Weinstr.,85,,5,15,20
024 Kurtatsch a.d.Weinstr.,86,,-,2,2
024 Kurtatsch a.d.Weinstr.,87,,-,7,7
024 Kurtatsch a.d.Weinstr.,88,,3,3,6
024 Kurtatsch a.d.Weinstr.,89,,1,-,1
024 Kurtatsch a.d.Weinstr.,91,,-,2,2
024 Kurtatsch a.d.Weinstr.,93,,1,-,1
024 Kurtatsch a.d.Weinstr.,96,,2,-,2
024 Kurtatsch a.d.Weinstr.,97,,-,2,2
024 Kurtatsch a.d.Weinstr.,Insgesamt,,1.106,1.114,2.220
025 Kurtinig a.d. Weinstr.,0,,5,-,5
025 Kurtinig a.d. Weinstr.,1,,5,3,8
025 Kurtinig a.d. Weinstr.,2,,3,1,4
025 Kurtinig a.d. Weinstr.,3,,-,4,4
025 Kurtinig a.d. Weinstr.,4,,1,2,3
025 Kurtinig a.d. Weinstr.,5,,5,3,8
025 Kurtinig a.d. Weinstr.,6,,3,3,6
025 Kurtinig a.d. Weinstr.,7,,1,8,9
025 Kurtinig a.d. Weinstr.,8,,4,5,9
025 Kurtinig a.d. Weinstr.,9,,3,2,5
025 Kurtinig a.d. Weinstr.,10,,3,6,9
025 Kurtinig a.d. Weinstr.,11,,3,5,8
025 Kurtinig a.d. Weinstr.,12,,1,2,3
025 Kurtinig a.d. Weinstr.,13,,6,2,8
025 Kurtinig a.d. Weinstr.,14,,3,3,6
025 Kurtinig a.d. Weinstr.,15,,4,4,8
025 Kurtinig a.d. Weinstr.,16,,2,3,5
025 Kurtinig a.d. Weinstr.,17,,6,1,7
025 Kurtinig a.d. Weinstr.,18,,3,2,5
025 Kurtinig a.d. Weinstr.,19,,6,4,10
025 Kurtinig a.d. Weinstr.,20,,6,4,10
025 Kurtinig a.d. Weinstr.,21,,6,4,10
025 Kurtinig a.d. Weinstr.,22,,4,4,8
025 Kurtinig a.d. Weinstr.,23,,2,3,5
025 Kurtinig a.d. Weinstr.,24,,3,6,9
025 Kurtinig a.d. Weinstr.,25,,4,3,7
025 Kurtinig a.d. Weinstr.,26,,5,5,10
025 Kurtinig a.d. Weinstr.,27,,8,4,12
025 Kurtinig a.d. Weinstr.,28,,8,5,13
025 Kurtinig a.d. Weinstr.,29,,4,6,10
025 Kurtinig a.d. Weinstr.,30,,3,2,5
025 Kurtinig a.d. Weinstr.,31,,2,3,5
025 Kurtinig a.d. Weinstr.,32,,1,1,2
025 Kurtinig a.d. Weinstr.,33,,2,8,10
025 Kurtinig a.d. Weinstr.,34,,4,2,6
025 Kurtinig a.d. Weinstr.,35,,4,4,8
025 Kurtinig a.d. Weinstr.,36,,4,6,10
025 Kurtinig a.d. Weinstr.,37,,4,3,7
025 Kurtinig a.d. Weinstr.,38,,6,3,9
025 Kurtinig a.d. Weinstr.,39,,7,6,13
025 Kurtinig a.d. Weinstr.,40,,5,3,8
025 Kurtinig a.d. Weinstr.,41,,6,4,10
025 Kurtinig a.d. Weinstr.,42,,1,5,6
025 Kurtinig a.d. Weinstr.,43,,5,4,9
025 Kurtinig a.d. Weinstr.,44,,6,5,11
025 Kurtinig a.d. Weinstr.,45,,8,5,13
025 Kurtinig a.d. Weinstr.,46,,5,4,9
025 Kurtinig a.d. Weinstr.,47,,7,10,17
025 Kurtinig a.d. Weinstr.,48,,6,4,10
025 Kurtinig a.d. Weinstr.,49,,11,6,17
025 Kurtinig a.d. Weinstr.,50,,3,8,11
025 Kurtinig a.d. Weinstr.,51,,7,7,14
025 Kurtinig a.d. Weinstr.,52,,4,1,5
025 Kurtinig a.d. Weinstr.,53,,3,1,4
025 Kurtinig a.d. Weinstr.,54,,7,3,10
025 Kurtinig a.d. Weinstr.,55,,4,6,10
025 Kurtinig a.d. Weinstr.,56,,2,4,6
025 Kurtinig a.d. Weinstr.,57,,2,4,6
025 Kurtinig a.d. Weinstr.,58,,2,3,5
025 Kurtinig a.d. Weinstr.,59,,3,3,6
025 Kurtinig a.d. Weinstr.,60,,5,4,9
025 Kurtinig a.d. Weinstr.,61,,5,2,7
025 Kurtinig a.d. Weinstr.,62,,-,5,5
025 Kurtinig a.d. Weinstr.,63,,3,3,6
025 Kurtinig a.d. Weinstr.,64,,3,2,5
025 Kurtinig a.d. Weinstr.,65,,4,2,6
025 Kurtinig a.d. Weinstr.,66,,2,2,4
025 Kurtinig a.d. Weinstr.,67,,4,2,6
025 Kurtinig a.d. Weinstr.,68,,2,2,4
025 Kurtinig a.d. Weinstr.,69,,5,3,8
025 Kurtinig a.d. Weinstr.,70,,2,2,4
025 Kurtinig a.d. Weinstr.,71,,2,3,5
025 Kurtinig a.d. Weinstr.,72,,4,3,7
025 Kurtinig a.d. Weinstr.,73,,-,6,6
025 Kurtinig a.d. Weinstr.,74,,2,4,6
025 Kurtinig a.d. Weinstr.,75,,1,2,3
025 Kurtinig a.d. Weinstr.,76,,3,4,7
025 Kurtinig a.d. Weinstr.,77,,2,2,4
025 Kurtinig a.d. Weinstr.,78,,4,3,7
025 Kurtinig a.d. Weinstr.,79,,1,3,4
025 Kurtinig a.d. Weinstr.,80,,2,3,5
025 Kurtinig a.d. Weinstr.,81,,2,2,4
025 Kurtinig a.d. Weinstr.,82,,2,1,3
025 Kurtinig a.d. Weinstr.,83,,-,5,5
025 Kurtinig a.d. Weinstr.,84,,-,3,3
025 Kurtinig a.d. Weinstr.,85,,-,1,1
025 Kurtinig a.d. Weinstr.,86,,-,2,2
025 Kurtinig a.d. Weinstr.,87,,1,1,2
025 Kurtinig a.d. Weinstr.,89,,-,2,2
025 Kurtinig a.d. Weinstr.,90,,-,1,1
025 Kurtinig a.d. Weinstr.,93,,-,1,1
025 Kurtinig a.d. Weinstr.,94,,-,2,2
025 Kurtinig a.d. Weinstr.,96,,-,1,1
025 Kurtinig a.d. Weinstr.,Insgesamt,,312,319,631
026 Corvara,0,,6,8,14
026 Corvara,1,,5,9,14
026 Corvara,2,,10,4,14
026 Corvara,3,,8,5,13
026 Corvara,4,,7,3,10
026 Corvara,5,,12,5,17
026 Corvara,6,,4,4,8
026 Corvara,7,,5,8,13
026 Corvara,8,,7,3,10
026 Corvara,9,,8,7,15
026 Corvara,10,,10,9,19
026 Corvara,11,,3,5,8
026 Corvara,12,,10,4,14
026 Corvara,13,,7,7,14
026 Corvara,14,,8,5,13
026 Corvara,15,,6,3,9
026 Corvara,16,,6,10,16
026 Corvara,17,,3,5,8
026 Corvara,18,,9,8,17
026 Corvara,19,,5,5,10
026 Corvara,20,,5,3,8
026 Corvara,21,,8,7,15
026 Corvara,22,,4,-,4
026 Corvara,23,,6,8,14
026 Corvara,24,,7,3,10
026 Corvara,25,,7,9,16
026 Corvara,26,,9,12,21
026 Corvara,27,,14,4,18
026 Corvara,28,,10,6,16
026 Corvara,29,,10,9,19
026 Corvara,30,,11,2,13
026 Corvara,31,,16,11,27
026 Corvara,32,,11,6,17
026 Corvara,33,,9,22,31
026 Corvara,34,,8,16,24
026 Corvara,35,,10,8,18
026 Corvara,36,,7,8,15
026 Corvara,37,,11,6,17
026 Corvara,38,,9,12,21
026 Corvara,39,,18,13,31
026 Corvara,40,,8,15,23
026 Corvara,41,,15,20,35
026 Corvara,42,,12,17,29
026 Corvara,43,,16,19,35
026 Corvara,44,,8,8,16
026 Corvara,45,,13,10,23
026 Corvara,46,,13,12,25
026 Corvara,47,,8,8,16
026 Corvara,48,,17,13,30
026 Corvara,49,,8,7,15
026 Corvara,50,,11,6,17
026 Corvara,51,,8,5,13
026 Corvara,52,,4,7,11
026 Corvara,53,,11,7,18
026 Corvara,54,,10,8,18
026 Corvara,55,,6,12,18
026 Corvara,56,,5,8,13
026 Corvara,57,,5,8,13
026 Corvara,58,,7,8,15
026 Corvara,59,,3,9,12
026 Corvara,60,,4,5,9
026 Corvara,61,,4,10,14
026 Corvara,62,,12,11,23
026 Corvara,63,,5,5,10
026 Corvara,64,,6,8,14
026 Corvara,65,,5,10,15
026 Corvara,66,,6,8,14
026 Corvara,67,,11,11,22
026 Corvara,68,,8,6,14
026 Corvara,69,,6,5,11
026 Corvara,70,,4,7,11
026 Corvara,71,,6,8,14
026 Corvara,72,,5,6,11
026 Corvara,73,,7,4,11
026 Corvara,74,,6,8,14
026 Corvara,75,,3,4,7
026 Corvara,76,,4,4,8
026 Corvara,77,,7,9,16
026 Corvara,78,,5,3,8
026 Corvara,79,,4,5,9
026 Corvara,80,,1,2,3
026 Corvara,81,,5,2,7
026 Corvara,82,,3,1,4
026 Corvara,83,,1,3,4
026 Corvara,84,,2,-,2
026 Corvara,85,,5,2,7
026 Corvara,86,,3,3,6
026 Corvara,87,,2,1,3
026 Corvara,88,,2,1,3
026 Corvara,89,,1,2,3
026 Corvara,90,,-,1,1
026 Corvara,91,,1,1,2
026 Corvara,94,,-,2,2
026 Corvara,96,,-,1,1
026 Corvara,Insgesamt,,661,648,1.309
027 Graun im Vinschgau,0,,13,7,20
027 Graun im Vinschgau,1,,21,14,35
027 Graun im Vinschgau,2,,13,21,34
027 Graun im Vinschgau,3,,13,14,27
027 Graun im Vinschgau,4,,11,16,27
027 Graun im Vinschgau,5,,9,12,21
027 Graun im Vinschgau,6,,12,13,25
027 Graun im Vinschgau,7,,16,13,29
027 Graun im Vinschgau,8,,18,16,34
027 Graun im Vinschgau,9,,15,10,25
027 Graun im Vinschgau,10,,9,14,23
027 Graun im Vinschgau,11,,19,17,36
027 Graun im Vinschgau,12,,21,18,39
027 Graun im Vinschgau,13,,19,16,35
027 Graun im Vinschgau,14,,19,12,31
027 Graun im Vinschgau,15,,20,13,33
027 Graun im Vinschgau,16,,17,15,32
027 Graun im Vinschgau,17,,10,12,22
027 Graun im Vinschgau,18,,19,19,38
027 Graun im Vinschgau,19,,25,17,42
027 Graun im Vinschgau,20,,19,11,30
027 Graun im Vinschgau,21,,16,10,26
027 Graun im Vinschgau,22,,7,7,14
027 Graun im Vinschgau,23,,18,10,28
027 Graun im Vinschgau,24,,18,15,33
027 Graun im Vinschgau,25,,6,17,23
027 Graun im Vinschgau,26,,18,13,31
027 Graun im Vinschgau,27,,20,20,40
027 Graun im Vinschgau,28,,20,14,34
027 Graun im Vinschgau,29,,14,21,35
027 Graun im Vinschgau,30,,14,19,33
027 Graun im Vinschgau,31,,14,19,33
027 Graun im Vinschgau,32,,14,19,33
027 Graun im Vinschgau,33,,22,16,38
027 Graun im Vinschgau,34,,19,12,31
027 Graun im Vinschgau,35,,19,20,39
027 Graun im Vinschgau,36,,21,17,38
027 Graun im Vinschgau,37,,20,13,33
027 Graun im Vinschgau,38,,21,16,37
027 Graun im Vinschgau,39,,28,19,47
027 Graun im Vinschgau,40,,15,21,36
027 Graun im Vinschgau,41,,24,22,46
027 Graun im Vinschgau,42,,18,24,42
027 Graun im Vinschgau,43,,18,20,38
027 Graun im Vinschgau,44,,22,22,44
027 Graun im Vinschgau,45,,24,18,42
027 Graun im Vinschgau,46,,22,24,46
027 Graun im Vinschgau,47,,19,12,31
027 Graun im Vinschgau,48,,22,19,41
027 Graun im Vinschgau,49,,21,11,32
027 Graun im Vinschgau,50,,19,15,34
027 Graun im Vinschgau,51,,12,13,25
027 Graun im Vinschgau,52,,15,10,25
027 Graun im Vinschgau,53,,13,9,22
027 Graun im Vinschgau,54,,16,15,31
027 Graun im Vinschgau,55,,13,6,19
027 Graun im Vinschgau,56,,17,11,28
027 Graun im Vinschgau,57,,11,16,27
027 Graun im Vinschgau,58,,12,12,24
027 Graun im Vinschgau,59,,7,21,28
027 Graun im Vinschgau,60,,14,12,26
027 Graun im Vinschgau,61,,5,9,14
027 Graun im Vinschgau,62,,10,8,18
027 Graun im Vinschgau,63,,7,8,15
027 Graun im Vinschgau,64,,10,9,19
027 Graun im Vinschgau,65,,9,11,20
027 Graun im Vinschgau,66,,9,12,21
027 Graun im Vinschgau,67,,15,10,25
027 Graun im Vinschgau,68,,11,9,20
027 Graun im Vinschgau,69,,10,11,21
027 Graun im Vinschgau,70,,9,11,20
027 Graun im Vinschgau,71,,12,3,15
027 Graun im Vinschgau,72,,14,14,28
027 Graun im Vinschgau,73,,8,7,15
027 Graun im Vinschgau,74,,12,9,21
027 Graun im Vinschgau,75,,7,7,14
027 Graun im Vinschgau,76,,9,7,16
027 Graun im Vinschgau,77,,9,10,19
027 Graun im Vinschgau,78,,3,5,8
027 Graun im Vinschgau,79,,10,12,22
027 Graun im Vinschgau,80,,6,10,16
027 Graun im Vinschgau,81,,5,7,12
027 Graun im Vinschgau,82,,6,11,17
027 Graun im Vinschgau,83,,2,4,6
027 Graun im Vinschgau,84,,4,7,11
027 Graun im Vinschgau,85,,4,10,14
027 Graun im Vinschgau,86,,6,6,12
027 Graun im Vinschgau,87,,5,7,12
027 Graun im Vinschgau,88,,1,1,2
027 Graun im Vinschgau,89,,-,3,3
027 Graun im Vinschgau,90,,1,1,2
027 Graun im Vinschgau,93,,-,1,1
027 Graun im Vinschgau,94,,-,1,1
027 Graun im Vinschgau,97,,-,1,1
027 Graun im Vinschgau,100,,-,1,1
027 Graun im Vinschgau,Insgesamt,,1.240,1.173,2.413
028 Toblach,0,,24,19,43
028 Toblach,1,,24,13,37
028 Toblach,2,,19,10,29
028 Toblach,3,,12,17,29
028 Toblach,4,,18,21,39
028 Toblach,5,,20,27,47
028 Toblach,6,,13,20,33
028 Toblach,7,,26,17,43
028 Toblach,8,,21,15,36
028 Toblach,9,,15,23,38
028 Toblach,10,,17,12,29
028 Toblach,11,,23,17,40
028 Toblach,12,,27,22,49
028 Toblach,13,,17,9,26
028 Toblach,14,,21,18,39
028 Toblach,15,,20,21,41
028 Toblach,16,,14,17,31
028 Toblach,17,,17,28,45
028 Toblach,18,,16,23,39
028 Toblach,19,,9,14,23
028 Toblach,20,,14,23,37
028 Toblach,21,,30,16,46
028 Toblach,22,,15,21,36
028 Toblach,23,,24,21,45
028 Toblach,24,,22,28,50
028 Toblach,25,,18,19,37
028 Toblach,26,,28,22,50
028 Toblach,27,,25,22,47
028 Toblach,28,,21,17,38
028 Toblach,29,,27,25,52
028 Toblach,30,,21,21,42
028 Toblach,31,,14,24,38
028 Toblach,32,,23,32,55
028 Toblach,33,,20,21,41
028 Toblach,34,,29,19,48
028 Toblach,35,,28,23,51
028 Toblach,36,,29,29,58
028 Toblach,37,,30,21,51
028 Toblach,38,,18,23,41
028 Toblach,39,,38,26,64
028 Toblach,40,,33,27,60
028 Toblach,41,,25,19,44
028 Toblach,42,,30,29,59
028 Toblach,43,,32,25,57
028 Toblach,44,,34,29,63
028 Toblach,45,,30,25,55
028 Toblach,46,,35,29,64
028 Toblach,47,,21,32,53
028 Toblach,48,,21,18,39
028 Toblach,49,,34,27,61
028 Toblach,50,,20,16,36
028 Toblach,51,,27,23,50
028 Toblach,52,,17,24,41
028 Toblach,53,,17,26,43
028 Toblach,54,,19,20,39
028 Toblach,55,,20,24,44
028 Toblach,56,,20,16,36
028 Toblach,57,,25,12,37
028 Toblach,58,,14,16,30
028 Toblach,59,,20,15,35
028 Toblach,60,,15,24,39
028 Toblach,61,,19,15,34
028 Toblach,62,,12,14,26
028 Toblach,63,,9,18,27
028 Toblach,64,,18,10,28
028 Toblach,65,,13,18,31
028 Toblach,66,,15,19,34
028 Toblach,67,,19,12,31
028 Toblach,68,,12,13,25
028 Toblach,69,,13,12,25
028 Toblach,70,,14,7,21
028 Toblach,71,,4,10,14
028 Toblach,72,,7,15,22
028 Toblach,73,,7,16,23
028 Toblach,74,,14,15,29
028 Toblach,75,,8,9,17
028 Toblach,76,,10,13,23
028 Toblach,77,,12,10,22
028 Toblach,78,,9,11,20
028 Toblach,79,,9,10,19
028 Toblach,80,,10,8,18
028 Toblach,81,,7,11,18
028 Toblach,82,,7,11,18
028 Toblach,83,,8,6,14
028 Toblach,84,,5,7,12
028 Toblach,85,,5,3,8
028 Toblach,86,,4,6,10
028 Toblach,87,,1,5,6
028 Toblach,88,,3,2,5
028 Toblach,89,,3,5,8
028 Toblach,90,,1,1,2
028 Toblach,91,,1,1,2
028 Toblach,93,,1,3,4
028 Toblach,95,,-,2,2
028 Toblach,96,,-,1,1
028 Toblach,101,,1,-,1
028 Toblach,Insgesamt,,1.637,1.611,3.248
029 Neumarkt,0,,21,23,44
029 Neumarkt,1,,32,18,50
029 Neumarkt,2,,22,33,55
029 Neumarkt,3,,30,33,63
029 Neumarkt,4,,23,18,41
029 Neumarkt,5,,36,29,65
029 Neumarkt,6,,28,21,49
029 Neumarkt,7,,34,33,67
029 Neumarkt,8,,31,19,50
029 Neumarkt,9,,26,28,54
029 Neumarkt,10,,20,41,61
029 Neumarkt,11,,22,18,40
029 Neumarkt,12,,22,24,46
029 Neumarkt,13,,25,25,50
029 Neumarkt,14,,23,22,45
029 Neumarkt,15,,23,38,61
029 Neumarkt,16,,26,27,53
029 Neumarkt,17,,23,22,45
029 Neumarkt,18,,25,26,51
029 Neumarkt,19,,25,32,57
029 Neumarkt,20,,21,27,48
029 Neumarkt,21,,24,27,51
029 Neumarkt,22,,25,22,47
029 Neumarkt,23,,23,19,42
029 Neumarkt,24,,18,22,40
029 Neumarkt,25,,19,29,48
029 Neumarkt,26,,26,29,55
029 Neumarkt,27,,30,23,53
029 Neumarkt,28,,21,39,60
029 Neumarkt,29,,31,27,58
029 Neumarkt,30,,38,34,72
029 Neumarkt,31,,26,25,51
029 Neumarkt,32,,27,36,63
029 Neumarkt,33,,41,40,81
029 Neumarkt,34,,37,40,77
029 Neumarkt,35,,33,34,67
029 Neumarkt,36,,40,34,74
029 Neumarkt,37,,34,50,84
029 Neumarkt,38,,33,38,71
029 Neumarkt,39,,37,36,73
029 Neumarkt,40,,27,49,76
029 Neumarkt,41,,47,49,96
029 Neumarkt,42,,52,47,99
029 Neumarkt,43,,52,41,93
029 Neumarkt,44,,48,48,96
029 Neumarkt,45,,51,48,99
029 Neumarkt,46,,50,36,86
029 Neumarkt,47,,39,43,82
029 Neumarkt,48,,50,41,91
029 Neumarkt,49,,43,32,75
029 Neumarkt,50,,31,34,65
029 Neumarkt,51,,40,32,72
029 Neumarkt,52,,31,28,59
029 Neumarkt,53,,42,43,85
029 Neumarkt,54,,35,28,63
029 Neumarkt,55,,17,17,34
029 Neumarkt,56,,29,21,50
029 Neumarkt,57,,24,26,50
029 Neumarkt,58,,21,24,45
029 Neumarkt,59,,13,24,37
029 Neumarkt,60,,19,23,42
029 Neumarkt,61,,27,30,57
029 Neumarkt,62,,32,33,65
029 Neumarkt,63,,22,21,43
029 Neumarkt,64,,19,18,37
029 Neumarkt,65,,22,22,44
029 Neumarkt,66,,24,23,47
029 Neumarkt,67,,36,26,62
029 Neumarkt,68,,26,31,57
029 Neumarkt,69,,18,28,46
029 Neumarkt,70,,21,16,37
029 Neumarkt,71,,20,14,34
029 Neumarkt,72,,19,18,37
029 Neumarkt,73,,17,23,40
029 Neumarkt,74,,14,21,35
029 Neumarkt,75,,18,16,34
029 Neumarkt,76,,14,19,33
029 Neumarkt,77,,19,29,48
029 Neumarkt,78,,14,21,35
029 Neumarkt,79,,12,15,27
029 Neumarkt,80,,4,17,21
029 Neumarkt,81,,11,16,27
029 Neumarkt,82,,10,17,27
029 Neumarkt,83,,9,18,27
029 Neumarkt,84,,5,15,20
029 Neumarkt,85,,11,17,28
029 Neumarkt,86,,5,7,12
029 Neumarkt,87,,4,16,20
029 Neumarkt,88,,1,12,13
029 Neumarkt,89,,2,3,5
029 Neumarkt,90,,1,1,2
029 Neumarkt,91,,-,3,3
029 Neumarkt,92,,-,2,2
029 Neumarkt,94,,1,3,4
029 Neumarkt,95,,1,-,1
029 Neumarkt,96,,-,3,3
029 Neumarkt,97,,-,1,1
029 Neumarkt,98,,-,1,1
029 Neumarkt,Insgesamt,,2.321,2.471,4.792
030 Pfalzen,0,,14,20,34
030 Pfalzen,1,,13,10,23
030 Pfalzen,2,,18,16,34
030 Pfalzen,3,,20,14,34
030 Pfalzen,4,,14,20,34
030 Pfalzen,5,,21,14,35
030 Pfalzen,6,,14,16,30
030 Pfalzen,7,,18,15,33
030 Pfalzen,8,,15,17,32
030 Pfalzen,9,,20,20,40
030 Pfalzen,10,,17,14,31
030 Pfalzen,11,,13,18,31
030 Pfalzen,12,,15,14,29
030 Pfalzen,13,,23,18,41
030 Pfalzen,14,,12,18,30
030 Pfalzen,15,,11,18,29
030 Pfalzen,16,,14,23,37
030 Pfalzen,17,,14,18,32
030 Pfalzen,18,,18,13,31
030 Pfalzen,19,,17,21,38
030 Pfalzen,20,,13,8,21
030 Pfalzen,21,,12,23,35
030 Pfalzen,22,,18,18,36
030 Pfalzen,23,,24,13,37
030 Pfalzen,24,,16,12,28
030 Pfalzen,25,,11,11,22
030 Pfalzen,26,,20,20,40
030 Pfalzen,27,,17,20,37
030 Pfalzen,28,,20,22,42
030 Pfalzen,29,,17,21,38
030 Pfalzen,30,,19,21,40
030 Pfalzen,31,,19,20,39
030 Pfalzen,32,,20,13,33
030 Pfalzen,33,,13,17,30
030 Pfalzen,34,,22,16,38
030 Pfalzen,35,,19,25,44
030 Pfalzen,36,,21,21,42
030 Pfalzen,37,,29,27,56
030 Pfalzen,38,,23,25,48
030 Pfalzen,39,,28,11,39
030 Pfalzen,40,,21,37,58
030 Pfalzen,41,,19,21,40
030 Pfalzen,42,,23,21,44
030 Pfalzen,43,,23,27,50
030 Pfalzen,44,,19,21,40
030 Pfalzen,45,,31,19,50
030 Pfalzen,46,,22,31,53
030 Pfalzen,47,,25,20,45
030 Pfalzen,48,,22,14,36
030 Pfalzen,49,,14,13,27
030 Pfalzen,50,,16,20,36
030 Pfalzen,51,,24,19,43
030 Pfalzen,52,,16,15,31
030 Pfalzen,53,,17,10,27
030 Pfalzen,54,,13,11,24
030 Pfalzen,55,,14,11,25
030 Pfalzen,56,,10,10,20
030 Pfalzen,57,,15,18,33
030 Pfalzen,58,,10,11,21
030 Pfalzen,59,,16,6,22
030 Pfalzen,60,,9,10,19
030 Pfalzen,61,,11,3,14
030 Pfalzen,62,,8,10,18
030 Pfalzen,63,,7,8,15
030 Pfalzen,64,,8,6,14
030 Pfalzen,65,,8,11,19
030 Pfalzen,66,,7,12,19
030 Pfalzen,67,,11,8,19
030 Pfalzen,68,,13,9,22
030 Pfalzen,69,,9,5,14
030 Pfalzen,70,,12,9,21
030 Pfalzen,71,,5,5,10
030 Pfalzen,72,,2,10,12
030 Pfalzen,73,,6,6,12
030 Pfalzen,74,,8,11,19
030 Pfalzen,75,,7,8,15
030 Pfalzen,76,,7,5,12
030 Pfalzen,77,,9,6,15
030 Pfalzen,78,,7,9,16
030 Pfalzen,79,,8,5,13
030 Pfalzen,80,,2,4,6
030 Pfalzen,81,,4,5,9
030 Pfalzen,82,,4,2,6
030 Pfalzen,83,,4,3,7
030 Pfalzen,84,,2,8,10
030 Pfalzen,85,,5,3,8
030 Pfalzen,86,,2,2,4
030 Pfalzen,87,,-,4,4
030 Pfalzen,88,,-,4,4
030 Pfalzen,89,,2,1,3
030 Pfalzen,90,,1,1,2
030 Pfalzen,91,,-,1,1
030 Pfalzen,92,,-,2,2
030 Pfalzen,94,,-,2,2
030 Pfalzen,95,,1,1,2
030 Pfalzen,Insgesamt,,1.261,1.255,2.516
031 Völs am Schlern,0,,18,38,56
031 Völs am Schlern,1,,19,21,40
031 Völs am Schlern,2,,24,25,49
031 Völs am Schlern,3,,34,13,47
031 Völs am Schlern,4,,20,16,36
031 Völs am Schlern,5,,14,23,37
031 Völs am Schlern,6,,17,30,47
031 Völs am Schlern,7,,20,25,45
031 Völs am Schlern,8,,23,28,51
031 Völs am Schlern,9,,19,20,39
031 Völs am Schlern,10,,24,29,53
031 Völs am Schlern,11,,17,25,42
031 Völs am Schlern,12,,13,20,33
031 Völs am Schlern,13,,23,23,46
031 Völs am Schlern,14,,20,11,31
031 Völs am Schlern,15,,16,16,32
031 Völs am Schlern,16,,20,18,38
031 Völs am Schlern,17,,13,20,33
031 Völs am Schlern,18,,21,18,39
031 Völs am Schlern,19,,20,17,37
031 Völs am Schlern,20,,17,15,32
031 Völs am Schlern,21,,19,14,33
031 Völs am Schlern,22,,23,17,40
031 Völs am Schlern,23,,15,18,33
031 Völs am Schlern,24,,18,8,26
031 Völs am Schlern,25,,13,27,40
031 Völs am Schlern,26,,21,26,47
031 Völs am Schlern,27,,27,19,46
031 Völs am Schlern,28,,28,14,42
031 Völs am Schlern,29,,26,24,50
031 Völs am Schlern,30,,30,28,58
031 Völs am Schlern,31,,25,25,50
031 Völs am Schlern,32,,32,24,56
031 Völs am Schlern,33,,24,22,46
031 Völs am Schlern,34,,19,27,46
031 Völs am Schlern,35,,30,32,62
031 Völs am Schlern,36,,42,25,67
031 Völs am Schlern,37,,38,39,77
031 Völs am Schlern,38,,28,33,61
031 Völs am Schlern,39,,37,31,68
031 Völs am Schlern,40,,35,35,70
031 Völs am Schlern,41,,30,27,57
031 Völs am Schlern,42,,37,32,69
031 Völs am Schlern,43,,30,29,59
031 Völs am Schlern,44,,32,24,56
031 Völs am Schlern,45,,32,23,55
031 Völs am Schlern,46,,27,19,46
031 Völs am Schlern,47,,25,21,46
031 Völs am Schlern,48,,21,17,38
031 Völs am Schlern,49,,21,14,35
031 Völs am Schlern,50,,22,16,38
031 Völs am Schlern,51,,20,18,38
031 Völs am Schlern,52,,16,21,37
031 Völs am Schlern,53,,17,16,33
031 Völs am Schlern,54,,16,25,41
031 Völs am Schlern,55,,17,24,41
031 Völs am Schlern,56,,17,18,35
031 Völs am Schlern,57,,19,21,40
031 Völs am Schlern,58,,20,18,38
031 Völs am Schlern,59,,16,9,25
031 Völs am Schlern,60,,17,13,30
031 Völs am Schlern,61,,14,21,35
031 Völs am Schlern,62,,18,12,30
031 Völs am Schlern,63,,8,13,21
031 Völs am Schlern,64,,14,9,23
031 Völs am Schlern,65,,14,21,35
031 Völs am Schlern,66,,15,16,31
031 Völs am Schlern,67,,18,20,38
031 Völs am Schlern,68,,11,21,32
031 Völs am Schlern,69,,13,11,24
031 Völs am Schlern,70,,11,14,25
031 Völs am Schlern,71,,10,10,20
031 Völs am Schlern,72,,8,19,27
031 Völs am Schlern,73,,14,12,26
031 Völs am Schlern,74,,12,8,20
031 Völs am Schlern,75,,6,14,20
031 Völs am Schlern,76,,14,8,22
031 Völs am Schlern,77,,11,15,26
031 Völs am Schlern,78,,3,11,14
031 Völs am Schlern,79,,4,10,14
031 Völs am Schlern,80,,5,14,19
031 Völs am Schlern,81,,6,10,16
031 Völs am Schlern,82,,4,6,10
031 Völs am Schlern,83,,6,9,15
031 Völs am Schlern,84,,7,9,16
031 Völs am Schlern,85,,2,3,5
031 Völs am Schlern,86,,1,5,6
031 Völs am Schlern,87,,1,8,9
031 Völs am Schlern,88,,2,4,6
031 Völs am Schlern,89,,1,2,3
031 Völs am Schlern,90,,1,3,4
031 Völs am Schlern,91,,1,2,3
031 Völs am Schlern,93,,2,1,3
031 Völs am Schlern,94,,2,2,4
031 Völs am Schlern,98,,1,-,1
031 Völs am Schlern,99,,1,-,1
031 Völs am Schlern,Insgesamt,,1.655,1.687,3.342
032 Franzensfeste,0,,5,7,12
032 Franzensfeste,1,,8,5,13
032 Franzensfeste,2,,4,6,10
032 Franzensfeste,3,,5,6,11
032 Franzensfeste,4,,6,6,12
032 Franzensfeste,5,,7,4,11
032 Franzensfeste,6,,11,2,13
032 Franzensfeste,7,,4,6,10
032 Franzensfeste,8,,3,5,8
032 Franzensfeste,9,,6,5,11
032 Franzensfeste,10,,6,6,12
032 Franzensfeste,11,,5,3,8
032 Franzensfeste,12,,6,5,11
032 Franzensfeste,13,,5,1,6
032 Franzensfeste,14,,7,7,14
032 Franzensfeste,15,,6,5,11
032 Franzensfeste,16,,6,6,12
032 Franzensfeste,17,,4,5,9
032 Franzensfeste,18,,1,6,7
032 Franzensfeste,19,,5,4,9
032 Franzensfeste,20,,2,3,5
032 Franzensfeste,21,,4,-,4
032 Franzensfeste,22,,7,3,10
032 Franzensfeste,23,,4,7,11
032 Franzensfeste,24,,3,11,14
032 Franzensfeste,25,,10,7,17
032 Franzensfeste,26,,3,8,11
032 Franzensfeste,27,,11,5,16
032 Franzensfeste,28,,5,9,14
032 Franzensfeste,29,,11,4,15
032 Franzensfeste,30,,7,6,13
032 Franzensfeste,31,,6,5,11
032 Franzensfeste,32,,4,4,8
032 Franzensfeste,33,,10,12,22
032 Franzensfeste,34,,10,8,18
032 Franzensfeste,35,,3,7,10
032 Franzensfeste,36,,6,11,17
032 Franzensfeste,37,,5,3,8
032 Franzensfeste,38,,9,6,15
032 Franzensfeste,39,,10,8,18
032 Franzensfeste,40,,11,10,21
032 Franzensfeste,41,,8,5,13
032 Franzensfeste,42,,11,5,16
032 Franzensfeste,43,,10,9,19
032 Franzensfeste,44,,14,7,21
032 Franzensfeste,45,,7,10,17
032 Franzensfeste,46,,12,3,15
032 Franzensfeste,47,,4,9,13
032 Franzensfeste,48,,4,8,12
032 Franzensfeste,49,,8,9,17
032 Franzensfeste,50,,13,2,15
032 Franzensfeste,51,,6,5,11
032 Franzensfeste,52,,5,7,12
032 Franzensfeste,53,,8,6,14
032 Franzensfeste,54,,6,8,14
032 Franzensfeste,55,,6,6,12
032 Franzensfeste,56,,5,4,9
032 Franzensfeste,57,,7,1,8
032 Franzensfeste,58,,11,3,14
032 Franzensfeste,59,,3,4,7
032 Franzensfeste,60,,4,4,8
032 Franzensfeste,61,,2,3,5
032 Franzensfeste,62,,8,6,14
032 Franzensfeste,63,,5,7,12
032 Franzensfeste,64,,4,9,13
032 Franzensfeste,65,,3,3,6
032 Franzensfeste,66,,4,-,4
032 Franzensfeste,67,,5,2,7
032 Franzensfeste,68,,3,4,7
032 Franzensfeste,69,,5,3,8
032 Franzensfeste,70,,1,3,4
032 Franzensfeste,71,,7,5,12
032 Franzensfeste,72,,3,2,5
032 Franzensfeste,73,,1,2,3
032 Franzensfeste,74,,3,3,6
032 Franzensfeste,75,,1,6,7
032 Franzensfeste,76,,3,4,7
032 Franzensfeste,77,,2,7,9
032 Franzensfeste,78,,6,4,10
032 Franzensfeste,79,,3,6,9
032 Franzensfeste,80,,2,3,5
032 Franzensfeste,81,,3,3,6
032 Franzensfeste,82,,2,7,9
032 Franzensfeste,83,,2,1,3
032 Franzensfeste,84,,4,4,8
032 Franzensfeste,85,,2,6,8
032 Franzensfeste,86,,2,2,4
032 Franzensfeste,87,,-,3,3
032 Franzensfeste,88,,-,1,1
032 Franzensfeste,90,,-,2,2
032 Franzensfeste,93,,1,-,1
032 Franzensfeste,96,,-,1,1
032 Franzensfeste,Insgesamt,,490,464,954
033 Villnöss,0,,18,9,27
033 Villnöss,1,,15,15,30
033 Villnöss,2,,12,22,34
033 Villnöss,3,,19,21,40
033 Villnöss,4,,13,17,30
033 Villnöss,5,,16,15,31
033 Villnöss,6,,21,13,34
033 Villnöss,7,,15,22,37
033 Villnöss,8,,18,14,32
033 Villnöss,9,,16,30,46
033 Villnöss,10,,22,19,41
033 Villnöss,11,,17,23,40
033 Villnöss,12,,20,17,37
033 Villnöss,13,,17,13,30
033 Villnöss,14,,14,12,26
033 Villnöss,15,,17,12,29
033 Villnöss,16,,11,14,25
033 Villnöss,17,,21,16,37
033 Villnöss,18,,15,11,26
033 Villnöss,19,,13,9,22
033 Villnöss,20,,16,23,39
033 Villnöss,21,,17,22,39
033 Villnöss,22,,11,15,26
033 Villnöss,23,,15,14,29
033 Villnöss,24,,15,15,30
033 Villnöss,25,,14,11,25
033 Villnöss,26,,13,17,30
033 Villnöss,27,,14,18,32
033 Villnöss,28,,21,10,31
033 Villnöss,29,,9,11,20
033 Villnöss,30,,18,14,32
033 Villnöss,31,,16,13,29
033 Villnöss,32,,15,14,29
033 Villnöss,33,,21,16,37
033 Villnöss,34,,20,18,38
033 Villnöss,35,,9,17,26
033 Villnöss,36,,16,24,40
033 Villnöss,37,,23,26,49
033 Villnöss,38,,16,26,42
033 Villnöss,39,,27,24,51
033 Villnöss,40,,29,19,48
033 Villnöss,41,,18,17,35
033 Villnöss,42,,27,19,46
033 Villnöss,43,,26,21,47
033 Villnöss,44,,31,28,59
033 Villnöss,45,,30,20,50
033 Villnöss,46,,29,21,50
033 Villnöss,47,,23,14,37
033 Villnöss,48,,20,12,32
033 Villnöss,49,,10,10,20
033 Villnöss,50,,11,15,26
033 Villnöss,51,,13,11,24
033 Villnöss,52,,15,16,31
033 Villnöss,53,,12,3,15
033 Villnöss,54,,17,13,30
033 Villnöss,55,,13,15,28
033 Villnöss,56,,13,11,24
033 Villnöss,57,,12,9,21
033 Villnöss,58,,7,9,16
033 Villnöss,59,,7,14,21
033 Villnöss,60,,10,10,20
033 Villnöss,61,,12,11,23
033 Villnöss,62,,10,5,15
033 Villnöss,63,,8,4,12
033 Villnöss,64,,6,13,19
033 Villnöss,65,,11,10,21
033 Villnöss,66,,12,19,31
033 Villnöss,67,,11,9,20
033 Villnöss,68,,7,17,24
033 Villnöss,69,,12,13,25
033 Villnöss,70,,12,9,21
033 Villnöss,71,,8,15,23
033 Villnöss,72,,3,16,19
033 Villnöss,73,,4,9,13
033 Villnöss,74,,9,9,18
033 Villnöss,75,,7,11,18
033 Villnöss,76,,12,12,24
033 Villnöss,77,,10,11,21
033 Villnöss,78,,10,10,20
033 Villnöss,79,,7,10,17
033 Villnöss,80,,14,7,21
033 Villnöss,81,,6,8,14
033 Villnöss,82,,2,9,11
033 Villnöss,83,,5,6,11
033 Villnöss,84,,2,7,9
033 Villnöss,85,,5,11,16
033 Villnöss,86,,3,5,8
033 Villnöss,87,,1,3,4
033 Villnöss,88,,-,4,4
033 Villnöss,89,,2,2,4
033 Villnöss,90,,-,1,1
033 Villnöss,91,,-,2,2
033 Villnöss,93,,-,1,1
033 Villnöss,95,,-,1,1
033 Villnöss,Insgesamt,,1.240,1.259,2.499
034 Gais,0,,13,17,30
034 Gais,1,,15,19,34
034 Gais,2,,24,14,38
034 Gais,3,,28,18,46
034 Gais,4,,13,28,41
034 Gais,5,,21,17,38
034 Gais,6,,21,23,44
034 Gais,7,,22,15,37
034 Gais,8,,21,16,37
034 Gais,9,,21,27,48
034 Gais,10,,22,21,43
034 Gais,11,,29,12,41
034 Gais,12,,10,17,27
034 Gais,13,,28,19,47
034 Gais,14,,22,24,46
034 Gais,15,,13,20,33
034 Gais,16,,21,30,51
034 Gais,17,,24,30,54
034 Gais,18,,14,20,34
034 Gais,19,,17,13,30
034 Gais,20,,15,17,32
034 Gais,21,,18,19,37
034 Gais,22,,15,18,33
034 Gais,23,,20,18,38
034 Gais,24,,23,17,40
034 Gais,25,,21,22,43
034 Gais,26,,18,15,33
034 Gais,27,,23,18,41
034 Gais,28,,26,28,54
034 Gais,29,,29,14,43
034 Gais,30,,20,20,40
034 Gais,31,,23,26,49
034 Gais,32,,23,25,48
034 Gais,33,,26,21,47
034 Gais,34,,30,31,61
034 Gais,35,,24,25,49
034 Gais,36,,31,39,70
034 Gais,37,,39,26,65
034 Gais,38,,29,27,56
034 Gais,39,,41,33,74
034 Gais,40,,24,21,45
034 Gais,41,,25,31,56
034 Gais,42,,33,20,53
034 Gais,43,,24,25,49
034 Gais,44,,32,31,63
034 Gais,45,,17,16,33
034 Gais,46,,29,20,49
034 Gais,47,,24,31,55
034 Gais,48,,18,11,29
034 Gais,49,,18,20,38
034 Gais,50,,23,18,41
034 Gais,51,,13,16,29
034 Gais,52,,24,18,42
034 Gais,53,,22,11,33
034 Gais,54,,15,14,29
034 Gais,55,,13,13,26
034 Gais,56,,15,17,32
034 Gais,57,,14,20,34
034 Gais,58,,22,22,44
034 Gais,59,,15,11,26
034 Gais,60,,23,13,36
034 Gais,61,,20,11,31
034 Gais,62,,16,16,32
034 Gais,63,,14,9,23
034 Gais,64,,13,13,26
034 Gais,65,,10,17,27
034 Gais,66,,12,13,25
034 Gais,67,,21,12,33
034 Gais,68,,17,13,30
034 Gais,69,,12,15,27
034 Gais,70,,14,13,27
034 Gais,71,,17,16,33
034 Gais,72,,10,13,23
034 Gais,73,,12,12,24
034 Gais,74,,6,6,12
034 Gais,75,,5,10,15
034 Gais,76,,5,7,12
034 Gais,77,,8,7,15
034 Gais,78,,4,10,14
034 Gais,79,,3,3,6
034 Gais,80,,9,8,17
034 Gais,81,,6,7,13
034 Gais,82,,7,6,13
034 Gais,83,,3,4,7
034 Gais,84,,3,3,6
034 Gais,85,,2,8,10
034 Gais,86,,2,3,5
034 Gais,87,,2,4,6
034 Gais,88,,2,1,3
034 Gais,89,,-,1,1
034 Gais,90,,1,1,2
034 Gais,91,,1,-,1
034 Gais,92,,-,1,1
034 Gais,93,,-,1,1
034 Gais,95,,2,-,2
034 Gais,97,,-,1,1
034 Gais,Insgesamt,,1.595,1.523,3.118
035 Gargazon,0,,12,6,18
035 Gargazon,1,,8,5,13
035 Gargazon,2,,10,14,24
035 Gargazon,3,,6,7,13
035 Gargazon,4,,8,6,14
035 Gargazon,5,,7,12,19
035 Gargazon,6,,6,12,18
035 Gargazon,7,,4,7,11
035 Gargazon,8,,10,5,15
035 Gargazon,9,,14,9,23
035 Gargazon,10,,15,9,24
035 Gargazon,11,,5,13,18
035 Gargazon,12,,11,7,18
035 Gargazon,13,,12,4,16
035 Gargazon,14,,4,7,11
035 Gargazon,15,,9,8,17
035 Gargazon,16,,14,9,23
035 Gargazon,17,,18,10,28
035 Gargazon,18,,7,11,18
035 Gargazon,19,,8,7,15
035 Gargazon,20,,9,4,13
035 Gargazon,21,,7,9,16
035 Gargazon,22,,4,12,16
035 Gargazon,23,,12,4,16
035 Gargazon,24,,10,5,15
035 Gargazon,25,,6,9,15
035 Gargazon,26,,5,7,12
035 Gargazon,27,,10,8,18
035 Gargazon,28,,9,15,24
035 Gargazon,29,,10,5,15
035 Gargazon,30,,4,11,15
035 Gargazon,31,,10,11,21
035 Gargazon,32,,6,11,17
035 Gargazon,33,,8,11,19
035 Gargazon,34,,17,15,32
035 Gargazon,35,,14,10,24
035 Gargazon,36,,10,17,27
035 Gargazon,37,,18,15,33
035 Gargazon,38,,16,10,26
035 Gargazon,39,,18,16,34
035 Gargazon,40,,16,18,34
035 Gargazon,41,,11,14,25
035 Gargazon,42,,14,15,29
035 Gargazon,43,,13,9,22
035 Gargazon,44,,16,16,32
035 Gargazon,45,,18,20,38
035 Gargazon,46,,13,13,26
035 Gargazon,47,,10,13,23
035 Gargazon,48,,13,11,24
035 Gargazon,49,,19,13,32
035 Gargazon,50,,6,8,14
035 Gargazon,51,,14,12,26
035 Gargazon,52,,14,6,20
035 Gargazon,53,,8,3,11
035 Gargazon,54,,10,10,20
035 Gargazon,55,,15,9,24
035 Gargazon,56,,4,9,13
035 Gargazon,57,,10,8,18
035 Gargazon,58,,9,7,16
035 Gargazon,59,,6,9,15
035 Gargazon,60,,7,8,15
035 Gargazon,61,,5,7,12
035 Gargazon,62,,10,14,24
035 Gargazon,63,,9,5,14
035 Gargazon,64,,3,4,7
035 Gargazon,65,,6,9,15
035 Gargazon,66,,6,9,15
035 Gargazon,67,,9,8,17
035 Gargazon,68,,5,16,21
035 Gargazon,69,,9,7,16
035 Gargazon,70,,8,7,15
035 Gargazon,71,,7,13,20
035 Gargazon,72,,5,4,9
035 Gargazon,73,,12,2,14
035 Gargazon,74,,5,6,11
035 Gargazon,75,,1,10,11
035 Gargazon,76,,5,2,7
035 Gargazon,77,,3,7,10
035 Gargazon,78,,3,4,7
035 Gargazon,79,,2,5,7
035 Gargazon,80,,2,2,4
035 Gargazon,81,,2,5,7
035 Gargazon,82,,3,3,6
035 Gargazon,83,,2,4,6
035 Gargazon,84,,-,3,3
035 Gargazon,85,,4,3,7
035 Gargazon,86,,2,6,8
035 Gargazon,87,,1,3,4
035 Gargazon,89,,-,1,1
035 Gargazon,92,,-,1,1
035 Gargazon,93,,1,3,4
035 Gargazon,94,,1,-,1
035 Gargazon,95,,1,3,4
035 Gargazon,96,,1,-,1
035 Gargazon,Insgesamt,,770,780,1.550
036 Glurns,0,,9,3,12
036 Glurns,1,,6,2,8
036 Glurns,2,,4,7,11
036 Glurns,3,,6,5,11
036 Glurns,4,,3,5,8
036 Glurns,5,,6,6,12
036 Glurns,6,,3,5,8
036 Glurns,7,,5,-,5
036 Glurns,8,,4,4,8
036 Glurns,9,,3,2,5
036 Glurns,10,,10,3,13
036 Glurns,11,,4,7,11
036 Glurns,12,,7,4,11
036 Glurns,13,,7,4,11
036 Glurns,14,,2,3,5
036 Glurns,15,,7,7,14
036 Glurns,16,,5,8,13
036 Glurns,17,,6,2,8
036 Glurns,18,,8,6,14
036 Glurns,19,,4,3,7
036 Glurns,20,,6,8,14
036 Glurns,21,,5,6,11
036 Glurns,22,,6,6,12
036 Glurns,23,,3,1,4
036 Glurns,24,,6,6,12
036 Glurns,25,,10,7,17
036 Glurns,26,,10,9,19
036 Glurns,27,,5,4,9
036 Glurns,28,,12,3,15
036 Glurns,29,,5,8,13
036 Glurns,30,,7,6,13
036 Glurns,31,,2,5,7
036 Glurns,32,,12,5,17
036 Glurns,33,,8,10,18
036 Glurns,34,,10,11,21
036 Glurns,35,,3,3,6
036 Glurns,36,,5,7,12
036 Glurns,37,,5,5,10
036 Glurns,38,,5,1,6
036 Glurns,39,,3,7,10
036 Glurns,40,,8,4,12
036 Glurns,41,,6,9,15
036 Glurns,42,,6,8,14
036 Glurns,43,,1,5,6
036 Glurns,44,,9,5,14
036 Glurns,45,,5,9,14
036 Glurns,46,,5,5,10
036 Glurns,47,,5,5,10
036 Glurns,48,,7,9,16
036 Glurns,49,,12,6,18
036 Glurns,50,,4,9,13
036 Glurns,51,,7,12,19
036 Glurns,52,,6,6,12
036 Glurns,53,,8,7,15
036 Glurns,54,,12,4,16
036 Glurns,55,,9,9,18
036 Glurns,56,,5,8,13
036 Glurns,57,,8,10,18
036 Glurns,58,,6,5,11
036 Glurns,59,,6,3,9
036 Glurns,60,,7,5,12
036 Glurns,61,,10,7,17
036 Glurns,62,,8,2,10
036 Glurns,63,,6,1,7
036 Glurns,64,,5,4,9
036 Glurns,65,,1,4,5
036 Glurns,66,,4,6,10
036 Glurns,67,,4,2,6
036 Glurns,68,,6,1,7
036 Glurns,69,,1,3,4
036 Glurns,70,,4,3,7
036 Glurns,71,,4,4,8
036 Glurns,72,,-,1,1
036 Glurns,73,,2,4,6
036 Glurns,74,,1,5,6
036 Glurns,75,,1,1,2
036 Glurns,76,,6,3,9
036 Glurns,77,,4,1,5
036 Glurns,78,,2,2,4
036 Glurns,79,,2,7,9
036 Glurns,80,,-,2,2
036 Glurns,81,,1,3,4
036 Glurns,82,,-,2,2
036 Glurns,83,,1,6,7
036 Glurns,84,,1,2,3
036 Glurns,85,,-,1,1
036 Glurns,87,,1,-,1
036 Glurns,89,,1,1,2
036 Glurns,91,,-,1,1
036 Glurns,93,,-,1,1
036 Glurns,Insgesamt,,455,427,882
037 Latsch,0,,26,22,48
037 Latsch,1,,26,32,58
037 Latsch,2,,29,27,56
037 Latsch,3,,22,28,50
037 Latsch,4,,31,25,56
037 Latsch,5,,22,23,45
037 Latsch,6,,28,25,53
037 Latsch,7,,33,22,55
037 Latsch,8,,33,32,65
037 Latsch,9,,31,21,52
037 Latsch,10,,26,19,45
037 Latsch,11,,36,39,75
037 Latsch,12,,37,34,71
037 Latsch,13,,46,34,80
037 Latsch,14,,41,22,63
037 Latsch,15,,34,35,69
037 Latsch,16,,33,36,69
037 Latsch,17,,30,37,67
037 Latsch,18,,37,48,85
037 Latsch,19,,35,32,67
037 Latsch,20,,41,33,74
037 Latsch,21,,33,39,72
037 Latsch,22,,37,32,69
037 Latsch,23,,32,38,70
037 Latsch,24,,38,36,74
037 Latsch,25,,28,35,63
037 Latsch,26,,35,44,79
037 Latsch,27,,27,46,73
037 Latsch,28,,35,38,73
037 Latsch,29,,40,35,75
037 Latsch,30,,38,21,59
037 Latsch,31,,34,35,69
037 Latsch,32,,28,27,55
037 Latsch,33,,35,35,70
037 Latsch,34,,26,29,55
037 Latsch,35,,34,31,65
037 Latsch,36,,33,37,70
037 Latsch,37,,46,42,88
037 Latsch,38,,35,35,70
037 Latsch,39,,38,41,79
037 Latsch,40,,50,51,101
037 Latsch,41,,54,48,102
037 Latsch,42,,32,49,81
037 Latsch,43,,55,46,101
037 Latsch,44,,57,49,106
037 Latsch,45,,54,47,101
037 Latsch,46,,41,45,86
037 Latsch,47,,45,41,86
037 Latsch,48,,37,52,89
037 Latsch,49,,45,46,91
037 Latsch,50,,39,30,69
037 Latsch,51,,31,34,65
037 Latsch,52,,32,33,65
037 Latsch,53,,36,25,61
037 Latsch,54,,29,18,47
037 Latsch,55,,25,24,49
037 Latsch,56,,37,21,58
037 Latsch,57,,21,33,54
037 Latsch,58,,31,15,46
037 Latsch,59,,16,21,37
037 Latsch,60,,16,21,37
037 Latsch,61,,17,15,32
037 Latsch,62,,20,21,41
037 Latsch,63,,17,20,37
037 Latsch,64,,24,11,35
037 Latsch,65,,23,21,44
037 Latsch,66,,23,25,48
037 Latsch,67,,16,23,39
037 Latsch,68,,20,24,44
037 Latsch,69,,18,17,35
037 Latsch,70,,15,26,41
037 Latsch,71,,11,24,35
037 Latsch,72,,17,12,29
037 Latsch,73,,27,14,41
037 Latsch,74,,17,26,43
037 Latsch,75,,14,23,37
037 Latsch,76,,23,19,42
037 Latsch,77,,15,17,32
037 Latsch,78,,18,17,35
037 Latsch,79,,15,15,30
037 Latsch,80,,16,17,33
037 Latsch,81,,12,23,35
037 Latsch,82,,14,17,31
037 Latsch,83,,12,14,26
037 Latsch,84,,6,10,16
037 Latsch,85,,5,12,17
037 Latsch,86,,5,11,16
037 Latsch,87,,11,7,18
037 Latsch,88,,4,4,8
037 Latsch,89,,2,5,7
037 Latsch,90,,2,3,5
037 Latsch,91,,1,1,2
037 Latsch,92,,1,1,2
037 Latsch,93,,-,2,2
037 Latsch,94,,1,2,3
037 Latsch,95,,1,1,2
037 Latsch,96,,1,1,2
037 Latsch,99,,-,1,1
037 Latsch,Insgesamt,,2.556,2.553,5.109
038 Algund,0,,15,22,37
038 Algund,1,,22,26,48
038 Algund,2,,24,18,42
038 Algund,3,,21,23,44
038 Algund,4,,21,20,41
038 Algund,5,,29,22,51
038 Algund,6,,20,30,50
038 Algund,7,,33,25,58
038 Algund,8,,22,31,53
038 Algund,9,,38,28,66
038 Algund,10,,24,24,48
038 Algund,11,,23,17,40
038 Algund,12,,19,20,39
038 Algund,13,,31,23,54
038 Algund,14,,26,22,48
038 Algund,15,,27,17,44
038 Algund,16,,33,21,54
038 Algund,17,,27,21,48
038 Algund,18,,33,23,56
038 Algund,19,,25,28,53
038 Algund,20,,18,25,43
038 Algund,21,,27,26,53
038 Algund,22,,23,37,60
038 Algund,23,,26,20,46
038 Algund,24,,24,25,49
038 Algund,25,,29,35,64
038 Algund,26,,27,20,47
038 Algund,27,,31,33,64
038 Algund,28,,31,29,60
038 Algund,29,,23,31,54
038 Algund,30,,21,28,49
038 Algund,31,,29,34,63
038 Algund,32,,28,37,65
038 Algund,33,,36,33,69
038 Algund,34,,29,40,69
038 Algund,35,,35,29,64
038 Algund,36,,44,35,79
038 Algund,37,,35,41,76
038 Algund,38,,51,37,88
038 Algund,39,,44,45,89
038 Algund,40,,42,34,76
038 Algund,41,,39,41,80
038 Algund,42,,40,38,78
038 Algund,43,,38,45,83
038 Algund,44,,53,25,78
038 Algund,45,,35,37,72
038 Algund,46,,37,44,81
038 Algund,47,,30,50,80
038 Algund,48,,36,39,75
038 Algund,49,,39,36,75
038 Algund,50,,43,30,73
038 Algund,51,,25,37,62
038 Algund,52,,35,31,66
038 Algund,53,,27,28,55
038 Algund,54,,37,23,60
038 Algund,55,,17,29,46
038 Algund,56,,27,25,52
038 Algund,57,,26,28,54
038 Algund,58,,21,29,50
038 Algund,59,,23,25,48
038 Algund,60,,27,23,50
038 Algund,61,,19,20,39
038 Algund,62,,30,30,60
038 Algund,63,,25,24,49
038 Algund,64,,25,27,52
038 Algund,65,,20,20,40
038 Algund,66,,15,35,50
038 Algund,67,,17,21,38
038 Algund,68,,18,24,42
038 Algund,69,,22,29,51
038 Algund,70,,19,22,41
038 Algund,71,,17,14,31
038 Algund,72,,16,26,42
038 Algund,73,,13,17,30
038 Algund,74,,22,26,48
038 Algund,75,,19,22,41
038 Algund,76,,14,19,33
038 Algund,77,,12,24,36
038 Algund,78,,12,21,33
038 Algund,79,,7,22,29
038 Algund,80,,8,18,26
038 Algund,81,,11,15,26
038 Algund,82,,11,13,24
038 Algund,83,,9,13,22
038 Algund,84,,4,13,17
038 Algund,85,,2,9,11
038 Algund,86,,5,14,19
038 Algund,87,,3,8,11
038 Algund,88,,4,4,8
038 Algund,89,,1,7,8
038 Algund,90,,2,3,5
038 Algund,91,,-,4,4
038 Algund,92,,2,2,4
038 Algund,93,,-,2,2
038 Algund,94,,-,2,2
038 Algund,95,,1,1,2
038 Algund,96,,1,4,5
038 Algund,97,,-,4,4
038 Algund,98,,-,1,1
038 Algund,100,,-,2,2
038 Algund,Insgesamt,,2.227,2.380,4.607
039 Lajen,0,,19,18,37
039 Lajen,1,,19,15,34
039 Lajen,2,,15,19,34
039 Lajen,3,,17,15,32
039 Lajen,4,,16,24,40
039 Lajen,5,,20,22,42
039 Lajen,6,,22,7,29
039 Lajen,7,,22,19,41
039 Lajen,8,,27,17,44
039 Lajen,9,,19,16,35
039 Lajen,10,,18,16,34
039 Lajen,11,,14,23,37
039 Lajen,12,,15,11,26
039 Lajen,13,,7,11,18
039 Lajen,14,,12,16,28
039 Lajen,15,,14,13,27
039 Lajen,16,,16,9,25
039 Lajen,17,,22,17,39
039 Lajen,18,,8,9,17
039 Lajen,19,,16,14,30
039 Lajen,20,,11,13,24
039 Lajen,21,,13,5,18
039 Lajen,22,,17,16,33
039 Lajen,23,,18,14,32
039 Lajen,24,,11,15,26
039 Lajen,25,,11,23,34
039 Lajen,26,,18,18,36
039 Lajen,27,,10,18,28
039 Lajen,28,,21,18,39
039 Lajen,29,,21,19,40
039 Lajen,30,,26,24,50
039 Lajen,31,,22,18,40
039 Lajen,32,,25,21,46
039 Lajen,33,,19,20,39
039 Lajen,34,,31,21,52
039 Lajen,35,,21,25,46
039 Lajen,36,,20,24,44
039 Lajen,37,,18,22,40
039 Lajen,38,,23,26,49
039 Lajen,39,,34,23,57
039 Lajen,40,,21,23,44
039 Lajen,41,,27,25,52
039 Lajen,42,,25,16,41
039 Lajen,43,,26,19,45
039 Lajen,44,,23,18,41
039 Lajen,45,,16,13,29
039 Lajen,46,,29,18,47
039 Lajen,47,,11,17,28
039 Lajen,48,,16,10,26
039 Lajen,49,,17,25,42
039 Lajen,50,,24,13,37
039 Lajen,51,,13,11,24
039 Lajen,52,,10,13,23
039 Lajen,53,,12,14,26
039 Lajen,54,,5,14,19
039 Lajen,55,,10,7,17
039 Lajen,56,,7,10,17
039 Lajen,57,,9,12,21
039 Lajen,58,,14,11,25
039 Lajen,59,,5,13,18
039 Lajen,60,,9,17,26
039 Lajen,61,,16,8,24
039 Lajen,62,,14,14,28
039 Lajen,63,,9,11,20
039 Lajen,64,,14,8,22
039 Lajen,65,,12,13,25
039 Lajen,66,,17,13,30
039 Lajen,67,,18,17,35
039 Lajen,68,,16,9,25
039 Lajen,69,,14,9,23
039 Lajen,70,,6,16,22
039 Lajen,71,,7,9,16
039 Lajen,72,,7,8,15
039 Lajen,73,,6,7,13
039 Lajen,74,,7,6,13
039 Lajen,75,,5,11,16
039 Lajen,76,,9,4,13
039 Lajen,77,,1,8,9
039 Lajen,78,,6,4,10
039 Lajen,79,,7,6,13
039 Lajen,80,,7,6,13
039 Lajen,81,,7,7,14
039 Lajen,82,,7,6,13
039 Lajen,83,,2,6,8
039 Lajen,84,,1,8,9
039 Lajen,85,,-,8,8
039 Lajen,86,,2,2,4
039 Lajen,87,,2,4,6
039 Lajen,88,,-,2,2
039 Lajen,89,,1,1,2
039 Lajen,90,,-,1,1
039 Lajen,93,,1,-,1
039 Lajen,95,,1,1,2
039 Lajen,96,,-,1,1
039 Lajen,Insgesamt,,1.279,1.247,2.526
040 Leifers,0,,104,86,190
040 Leifers,1,,91,87,178
040 Leifers,2,,80,88,168
040 Leifers,3,,92,71,163
040 Leifers,4,,83,79,162
040 Leifers,5,,97,81,178
040 Leifers,6,,87,90,177
040 Leifers,7,,87,78,165
040 Leifers,8,,97,90,187
040 Leifers,9,,93,85,178
040 Leifers,10,,77,105,182
040 Leifers,11,,109,80,189
040 Leifers,12,,106,85,191
040 Leifers,13,,98,92,190
040 Leifers,14,,91,101,192
040 Leifers,15,,88,74,162
040 Leifers,16,,89,80,169
040 Leifers,17,,90,85,175
040 Leifers,18,,94,86,180
040 Leifers,19,,69,83,152
040 Leifers,20,,78,83,161
040 Leifers,21,,78,77,155
040 Leifers,22,,79,90,169
040 Leifers,23,,92,70,162
040 Leifers,24,,87,85,172
040 Leifers,25,,95,104,199
040 Leifers,26,,99,92,191
040 Leifers,27,,93,77,170
040 Leifers,28,,89,95,184
040 Leifers,29,,91,115,206
040 Leifers,30,,111,96,207
040 Leifers,31,,126,122,248
040 Leifers,32,,133,112,245
040 Leifers,33,,153,134,287
040 Leifers,34,,155,141,296
040 Leifers,35,,156,148,304
040 Leifers,36,,158,151,309
040 Leifers,37,,135,140,275
040 Leifers,38,,164,140,304
040 Leifers,39,,161,136,297
040 Leifers,40,,153,161,314
040 Leifers,41,,152,128,280
040 Leifers,42,,147,144,291
040 Leifers,43,,148,131,279
040 Leifers,44,,170,153,323
040 Leifers,45,,154,137,291
040 Leifers,46,,136,134,270
040 Leifers,47,,138,141,279
040 Leifers,48,,140,117,257
040 Leifers,49,,122,107,229
040 Leifers,50,,94,114,208
040 Leifers,51,,100,113,213
040 Leifers,52,,139,130,269
040 Leifers,53,,111,126,237
040 Leifers,54,,88,109,197
040 Leifers,55,,107,117,224
040 Leifers,56,,100,97,197
040 Leifers,57,,96,99,195
040 Leifers,58,,96,85,181
040 Leifers,59,,91,98,189
040 Leifers,60,,108,101,209
040 Leifers,61,,98,97,195
040 Leifers,62,,114,152,266
040 Leifers,63,,76,79,155
040 Leifers,64,,87,89,176
040 Leifers,65,,90,96,186
040 Leifers,66,,91,94,185
040 Leifers,67,,86,80,166
040 Leifers,68,,93,87,180
040 Leifers,69,,90,91,181
040 Leifers,70,,84,74,158
040 Leifers,71,,53,75,128
040 Leifers,72,,50,62,112
040 Leifers,73,,49,64,113
040 Leifers,74,,57,61,118
040 Leifers,75,,39,62,101
040 Leifers,76,,59,72,131
040 Leifers,77,,46,56,102
040 Leifers,78,,39,59,98
040 Leifers,79,,33,48,81
040 Leifers,80,,35,36,71
040 Leifers,81,,24,49,73
040 Leifers,82,,18,44,62
040 Leifers,83,,20,43,63
040 Leifers,84,,16,35,51
040 Leifers,85,,11,29,40
040 Leifers,86,,15,30,45
040 Leifers,87,,9,23,32
040 Leifers,88,,9,18,27
040 Leifers,89,,4,27,31
040 Leifers,90,,1,5,6
040 Leifers,91,,1,6,7
040 Leifers,92,,2,10,12
040 Leifers,93,,-,12,12
040 Leifers,94,,1,5,6
040 Leifers,95,,1,9,10
040 Leifers,96,,1,6,7
040 Leifers,97,,1,2,3
040 Leifers,98,,-,4,4
040 Leifers,99,,-,1,1
040 Leifers,Insgesamt,,8.248,8.348,16.596
041 Lana,0,,67,66,133
041 Lana,1,,71,58,129
041 Lana,2,,66,56,122
041 Lana,3,,78,63,141
041 Lana,4,,79,56,135
041 Lana,5,,61,60,121
041 Lana,6,,58,55,113
041 Lana,7,,71,53,124
041 Lana,8,,72,72,144
041 Lana,9,,73,57,130
041 Lana,10,,62,60,122
041 Lana,11,,60,66,126
041 Lana,12,,70,79,149
041 Lana,13,,68,63,131
041 Lana,14,,67,74,141
041 Lana,15,,60,59,119
041 Lana,16,,61,59,120
041 Lana,17,,61,57,118
041 Lana,18,,54,66,120
041 Lana,19,,49,75,124
041 Lana,20,,60,51,111
041 Lana,21,,75,47,122
041 Lana,22,,59,58,117
041 Lana,23,,58,68,126
041 Lana,24,,61,64,125
041 Lana,25,,73,69,142
041 Lana,26,,77,59,136
041 Lana,27,,57,84,141
041 Lana,28,,59,64,123
041 Lana,29,,65,93,158
041 Lana,30,,86,76,162
041 Lana,31,,81,71,152
041 Lana,32,,75,92,167
041 Lana,33,,63,88,151
041 Lana,34,,91,81,172
041 Lana,35,,83,88,171
041 Lana,36,,104,93,197
041 Lana,37,,93,107,200
041 Lana,38,,97,106,203
041 Lana,39,,125,82,207
041 Lana,40,,93,103,196
041 Lana,41,,94,95,189
041 Lana,42,,93,111,204
041 Lana,43,,95,89,184
041 Lana,44,,103,107,210
041 Lana,45,,104,84,188
041 Lana,46,,89,81,170
041 Lana,47,,86,84,170
041 Lana,48,,76,80,156
041 Lana,49,,84,79,163
041 Lana,50,,79,89,168
041 Lana,51,,74,76,150
041 Lana,52,,57,61,118
041 Lana,53,,64,73,137
041 Lana,54,,62,64,126
041 Lana,55,,54,59,113
041 Lana,56,,52,60,112
041 Lana,57,,54,64,118
041 Lana,58,,53,56,109
041 Lana,59,,55,52,107
041 Lana,60,,55,65,120
041 Lana,61,,57,45,102
041 Lana,62,,61,62,123
041 Lana,63,,39,50,89
041 Lana,64,,50,62,112
041 Lana,65,,58,58,116
041 Lana,66,,51,69,120
041 Lana,67,,49,46,95
041 Lana,68,,42,49,91
041 Lana,69,,50,52,102
041 Lana,70,,40,57,97
041 Lana,71,,35,37,72
041 Lana,72,,39,48,87
041 Lana,73,,32,34,66
041 Lana,74,,32,41,73
041 Lana,75,,25,43,68
041 Lana,76,,28,30,58
041 Lana,77,,22,42,64
041 Lana,78,,24,38,62
041 Lana,79,,16,34,50
041 Lana,80,,27,23,50
041 Lana,81,,24,29,53
041 Lana,82,,18,34,52
041 Lana,83,,18,35,53
041 Lana,84,,4,19,23
041 Lana,85,,13,21,34
041 Lana,86,,15,22,37
041 Lana,87,,9,26,35
041 Lana,88,,8,22,30
041 Lana,89,,4,13,17
041 Lana,90,,3,6,9
041 Lana,91,,3,9,12
041 Lana,92,,1,3,4
041 Lana,93,,2,7,9
041 Lana,94,,5,5,10
041 Lana,95,,-,5,5
041 Lana,96,,1,4,5
041 Lana,97,,-,2,2
041 Lana,98,,-,5,5
041 Lana,99,,-,1,1
041 Lana,100,,-,1,1
041 Lana,104,,-,1,1
041 Lana,Insgesamt,,5.331,5.617,10.948
042 Laas,0,,23,24,47
042 Laas,1,,31,10,41
042 Laas,2,,19,31,50
042 Laas,3,,35,17,52
042 Laas,4,,23,20,43
042 Laas,5,,23,18,41
042 Laas,6,,27,17,44
042 Laas,7,,17,21,38
042 Laas,8,,26,24,50
042 Laas,9,,18,12,30
042 Laas,10,,26,33,59
042 Laas,11,,27,24,51
042 Laas,12,,29,33,62
042 Laas,13,,32,24,56
042 Laas,14,,23,24,47
042 Laas,15,,23,21,44
042 Laas,16,,16,26,42
042 Laas,17,,22,22,44
042 Laas,18,,19,24,43
042 Laas,19,,22,25,47
042 Laas,20,,21,20,41
042 Laas,21,,30,23,53
042 Laas,22,,34,18,52
042 Laas,23,,29,26,55
042 Laas,24,,28,25,53
042 Laas,25,,21,39,60
042 Laas,26,,35,26,61
042 Laas,27,,27,28,55
042 Laas,28,,22,25,47
042 Laas,29,,28,28,56
042 Laas,30,,25,33,58
042 Laas,31,,25,14,39
042 Laas,32,,30,31,61
042 Laas,33,,27,19,46
042 Laas,34,,43,32,75
042 Laas,35,,34,30,64
042 Laas,36,,29,25,54
042 Laas,37,,24,26,50
042 Laas,38,,37,24,61
042 Laas,39,,33,41,74
042 Laas,40,,40,26,66
042 Laas,41,,34,22,56
042 Laas,42,,33,26,59
042 Laas,43,,35,33,68
042 Laas,44,,28,30,58
042 Laas,45,,28,29,57
042 Laas,46,,34,26,60
042 Laas,47,,25,29,54
042 Laas,48,,37,24,61
042 Laas,49,,33,26,59
042 Laas,50,,27,26,53
042 Laas,51,,19,27,46
042 Laas,52,,22,15,37
042 Laas,53,,16,14,30
042 Laas,54,,16,24,40
042 Laas,55,,22,13,35
042 Laas,56,,28,25,53
042 Laas,57,,13,16,29
042 Laas,58,,20,25,45
042 Laas,59,,18,19,37
042 Laas,60,,16,21,37
042 Laas,61,,27,11,38
042 Laas,62,,13,14,27
042 Laas,63,,14,12,26
042 Laas,64,,11,15,26
042 Laas,65,,13,16,29
042 Laas,66,,16,19,35
042 Laas,67,,14,23,37
042 Laas,68,,17,23,40
042 Laas,69,,12,25,37
042 Laas,70,,18,12,30
042 Laas,71,,11,14,25
042 Laas,72,,19,11,30
042 Laas,73,,19,22,41
042 Laas,74,,12,18,30
042 Laas,75,,16,11,27
042 Laas,76,,11,14,25
042 Laas,77,,13,21,34
042 Laas,78,,13,14,27
042 Laas,79,,11,8,19
042 Laas,80,,11,11,22
042 Laas,81,,10,12,22
042 Laas,82,,11,11,22
042 Laas,83,,6,9,15
042 Laas,84,,5,19,24
042 Laas,85,,8,6,14
042 Laas,86,,3,13,16
042 Laas,87,,2,3,5
042 Laas,88,,4,8,12
042 Laas,89,,2,5,7
042 Laas,90,,4,-,4
042 Laas,91,,-,2,2
042 Laas,92,,1,3,4
042 Laas,93,,-,1,1
042 Laas,94,,1,2,3
042 Laas,95,,-,3,3
042 Laas,96,,-,3,3
042 Laas,97,,-,1,1
042 Laas,98,,1,1,2
042 Laas,Insgesamt,,1.956,1.895,3.851
043 Laurein,0,,2,2,4
043 Laurein,1,,1,-,1
043 Laurein,2,,9,-,9
043 Laurein,3,,3,5,8
043 Laurein,4,,3,1,4
043 Laurein,5,,3,4,7
043 Laurein,6,,2,3,5
043 Laurein,7,,7,1,8
043 Laurein,8,,3,8,11
043 Laurein,9,,3,2,5
043 Laurein,10,,4,3,7
043 Laurein,11,,3,6,9
043 Laurein,12,,1,2,3
043 Laurein,13,,2,2,4
043 Laurein,14,,2,4,6
043 Laurein,15,,1,5,6
043 Laurein,16,,1,1,2
043 Laurein,17,,1,1,2
043 Laurein,18,,4,-,4
043 Laurein,19,,3,2,5
043 Laurein,20,,1,-,1
043 Laurein,21,,2,2,4
043 Laurein,22,,4,2,6
043 Laurein,23,,2,2,4
043 Laurein,24,,1,2,3
043 Laurein,26,,2,1,3
043 Laurein,27,,3,-,3
043 Laurein,28,,2,-,2
043 Laurein,29,,2,-,2
043 Laurein,30,,3,5,8
043 Laurein,31,,1,3,4
043 Laurein,32,,5,2,7
043 Laurein,33,,-,4,4
043 Laurein,34,,1,1,2
043 Laurein,35,,5,2,7
043 Laurein,36,,1,2,3
043 Laurein,37,,6,6,12
043 Laurein,38,,4,4,8
043 Laurein,39,,6,4,10
043 Laurein,40,,-,2,2
043 Laurein,41,,4,6,10
043 Laurein,42,,5,3,8
043 Laurein,43,,5,1,6
043 Laurein,44,,4,2,6
043 Laurein,45,,-,2,2
043 Laurein,46,,1,2,3
043 Laurein,47,,5,4,9
043 Laurein,48,,1,1,2
043 Laurein,49,,3,4,7
043 Laurein,50,,2,2,4
043 Laurein,51,,7,-,7
043 Laurein,53,,2,-,2
043 Laurein,54,,3,1,4
043 Laurein,55,,2,1,3
043 Laurein,56,,2,-,2
043 Laurein,58,,2,1,3
043 Laurein,59,,3,2,5
043 Laurein,60,,2,-,2
043 Laurein,61,,2,3,5
043 Laurein,62,,-,1,1
043 Laurein,63,,-,1,1
043 Laurein,64,,-,1,1
043 Laurein,65,,1,-,1
043 Laurein,66,,1,-,1
043 Laurein,68,,2,2,4
043 Laurein,69,,1,3,4
043 Laurein,70,,1,1,2
043 Laurein,71,,2,1,3
043 Laurein,72,,1,2,3
043 Laurein,73,,1,3,4
043 Laurein,74,,1,5,6
043 Laurein,75,,1,2,3
043 Laurein,76,,2,2,4
043 Laurein,77,,-,3,3
043 Laurein,78,,1,5,6
043 Laurein,79,,3,-,3
043 Laurein,80,,4,-,4
043 Laurein,81,,4,1,5
043 Laurein,82,,1,1,2
043 Laurein,83,,1,1,2
043 Laurein,84,,-,1,1
043 Laurein,86,,-,2,2
043 Laurein,88,,1,1,2
043 Laurein,92,,1,-,1
043 Laurein,95,,-,1,1
043 Laurein,Insgesamt,,194,171,365
044 Lüsen,0,,7,9,16
044 Lüsen,1,,12,11,23
044 Lüsen,2,,9,14,23
044 Lüsen,3,,9,9,18
044 Lüsen,4,,10,11,21
044 Lüsen,5,,11,8,19
044 Lüsen,6,,11,8,19
044 Lüsen,7,,10,11,21
044 Lüsen,8,,15,9,24
044 Lüsen,9,,5,10,15
044 Lüsen,10,,11,11,22
044 Lüsen,11,,16,6,22
044 Lüsen,12,,8,13,21
044 Lüsen,13,,10,12,22
044 Lüsen,14,,14,13,27
044 Lüsen,15,,9,8,17
044 Lüsen,16,,12,9,21
044 Lüsen,17,,9,9,18
044 Lüsen,18,,6,12,18
044 Lüsen,19,,15,8,23
044 Lüsen,20,,9,9,18
044 Lüsen,21,,6,8,14
044 Lüsen,22,,10,10,20
044 Lüsen,23,,4,3,7
044 Lüsen,24,,8,16,24
044 Lüsen,25,,6,8,14
044 Lüsen,26,,14,11,25
044 Lüsen,27,,10,13,23
044 Lüsen,28,,12,11,23
044 Lüsen,29,,8,7,15
044 Lüsen,30,,14,16,30
044 Lüsen,31,,8,14,22
044 Lüsen,32,,16,13,29
044 Lüsen,33,,13,13,26
044 Lüsen,34,,14,14,28
044 Lüsen,35,,9,7,16
044 Lüsen,36,,9,10,19
044 Lüsen,37,,15,8,23
044 Lüsen,38,,18,14,32
044 Lüsen,39,,8,9,17
044 Lüsen,40,,14,16,30
044 Lüsen,41,,10,19,29
044 Lüsen,42,,16,13,29
044 Lüsen,43,,18,13,31
044 Lüsen,44,,13,9,22
044 Lüsen,45,,15,12,27
044 Lüsen,46,,8,12,20
044 Lüsen,47,,13,10,23
044 Lüsen,48,,8,12,20
044 Lüsen,49,,8,6,14
044 Lüsen,50,,11,11,22
044 Lüsen,51,,10,10,20
044 Lüsen,52,,9,10,19
044 Lüsen,53,,6,6,12
044 Lüsen,54,,13,5,18
044 Lüsen,55,,6,10,16
044 Lüsen,56,,11,4,15
044 Lüsen,57,,5,7,12
044 Lüsen,58,,6,7,13
044 Lüsen,59,,8,10,18
044 Lüsen,60,,7,1,8
044 Lüsen,61,,5,5,10
044 Lüsen,62,,10,6,16
044 Lüsen,63,,3,9,12
044 Lüsen,64,,5,4,9
044 Lüsen,65,,8,7,15
044 Lüsen,66,,2,6,8
044 Lüsen,67,,6,3,9
044 Lüsen,68,,4,10,14
044 Lüsen,69,,8,7,15
044 Lüsen,70,,6,5,11
044 Lüsen,71,,7,5,12
044 Lüsen,72,,6,9,15
044 Lüsen,73,,5,4,9
044 Lüsen,74,,3,4,7
044 Lüsen,75,,7,3,10
044 Lüsen,76,,2,10,12
044 Lüsen,77,,6,5,11
044 Lüsen,78,,3,5,8
044 Lüsen,79,,3,5,8
044 Lüsen,80,,3,6,9
044 Lüsen,81,,3,4,7
044 Lüsen,82,,2,5,7
044 Lüsen,83,,1,3,4
044 Lüsen,84,,1,2,3
044 Lüsen,85,,1,4,5
044 Lüsen,86,,1,2,3
044 Lüsen,87,,2,5,7
044 Lüsen,88,,-,2,2
044 Lüsen,89,,1,-,1
044 Lüsen,91,,-,1,1
044 Lüsen,92,,-,1,1
044 Lüsen,95,,-,1,1
044 Lüsen,Insgesamt,,749,766,1.515
045 Margreid a.d. Weinstr.,0,,7,10,17
045 Margreid a.d. Weinstr.,1,,6,2,8
045 Margreid a.d. Weinstr.,2,,8,5,13
045 Margreid a.d. Weinstr.,3,,8,9,17
045 Margreid a.d. Weinstr.,4,,10,8,18
045 Margreid a.d. Weinstr.,5,,3,4,7
045 Margreid a.d. Weinstr.,6,,11,7,18
045 Margreid a.d. Weinstr.,7,,12,9,21
045 Margreid a.d. Weinstr.,8,,7,8,15
045 Margreid a.d. Weinstr.,9,,7,9,16
045 Margreid a.d. Weinstr.,10,,2,11,13
045 Margreid a.d. Weinstr.,11,,10,12,22
045 Margreid a.d. Weinstr.,12,,5,2,7
045 Margreid a.d. Weinstr.,13,,2,6,8
045 Margreid a.d. Weinstr.,14,,5,7,12
045 Margreid a.d. Weinstr.,15,,4,12,16
045 Margreid a.d. Weinstr.,16,,2,3,5
045 Margreid a.d. Weinstr.,17,,5,5,10
045 Margreid a.d. Weinstr.,18,,7,9,16
045 Margreid a.d. Weinstr.,19,,8,5,13
045 Margreid a.d. Weinstr.,20,,7,7,14
045 Margreid a.d. Weinstr.,21,,9,5,14
045 Margreid a.d. Weinstr.,22,,6,10,16
045 Margreid a.d. Weinstr.,23,,12,-,12
045 Margreid a.d. Weinstr.,24,,6,12,18
045 Margreid a.d. Weinstr.,25,,5,11,16
045 Margreid a.d. Weinstr.,26,,14,13,27
045 Margreid a.d. Weinstr.,27,,18,6,24
045 Margreid a.d. Weinstr.,28,,5,9,14
045 Margreid a.d. Weinstr.,29,,12,7,19
045 Margreid a.d. Weinstr.,30,,9,9,18
045 Margreid a.d. Weinstr.,31,,10,9,19
045 Margreid a.d. Weinstr.,32,,14,17,31
045 Margreid a.d. Weinstr.,33,,8,7,15
045 Margreid a.d. Weinstr.,34,,7,6,13
045 Margreid a.d. Weinstr.,35,,9,10,19
045 Margreid a.d. Weinstr.,36,,4,5,9
045 Margreid a.d. Weinstr.,37,,9,12,21
045 Margreid a.d. Weinstr.,38,,10,10,20
045 Margreid a.d. Weinstr.,39,,10,9,19
045 Margreid a.d. Weinstr.,40,,23,16,39
045 Margreid a.d. Weinstr.,41,,11,17,28
045 Margreid a.d. Weinstr.,42,,20,12,32
045 Margreid a.d. Weinstr.,43,,12,6,18
045 Margreid a.d. Weinstr.,44,,8,6,14
045 Margreid a.d. Weinstr.,45,,12,11,23
045 Margreid a.d. Weinstr.,46,,8,17,25
045 Margreid a.d. Weinstr.,47,,15,13,28
045 Margreid a.d. Weinstr.,48,,15,11,26
045 Margreid a.d. Weinstr.,49,,8,12,20
045 Margreid a.d. Weinstr.,50,,5,8,13
045 Margreid a.d. Weinstr.,51,,8,6,14
045 Margreid a.d. Weinstr.,52,,16,7,23
045 Margreid a.d. Weinstr.,53,,9,8,17
045 Margreid a.d. Weinstr.,54,,4,6,10
045 Margreid a.d. Weinstr.,55,,7,8,15
045 Margreid a.d. Weinstr.,56,,5,9,14
045 Margreid a.d. Weinstr.,57,,4,8,12
045 Margreid a.d. Weinstr.,58,,7,6,13
045 Margreid a.d. Weinstr.,59,,7,4,11
045 Margreid a.d. Weinstr.,60,,5,8,13
045 Margreid a.d. Weinstr.,61,,7,8,15
045 Margreid a.d. Weinstr.,62,,2,4,6
045 Margreid a.d. Weinstr.,63,,6,7,13
045 Margreid a.d. Weinstr.,64,,3,6,9
045 Margreid a.d. Weinstr.,65,,6,4,10
045 Margreid a.d. Weinstr.,66,,10,4,14
045 Margreid a.d. Weinstr.,67,,7,5,12
045 Margreid a.d. Weinstr.,68,,5,3,8
045 Margreid a.d. Weinstr.,69,,3,7,10
045 Margreid a.d. Weinstr.,70,,4,9,13
045 Margreid a.d. Weinstr.,71,,5,3,8
045 Margreid a.d. Weinstr.,72,,6,4,10
045 Margreid a.d. Weinstr.,73,,1,6,7
045 Margreid a.d. Weinstr.,74,,5,4,9
045 Margreid a.d. Weinstr.,75,,3,4,7
045 Margreid a.d. Weinstr.,76,,5,6,11
045 Margreid a.d. Weinstr.,77,,3,5,8
045 Margreid a.d. Weinstr.,78,,6,2,8
045 Margreid a.d. Weinstr.,79,,1,4,5
045 Margreid a.d. Weinstr.,80,,5,2,7
045 Margreid a.d. Weinstr.,81,,1,4,5
045 Margreid a.d. Weinstr.,82,,2,7,9
045 Margreid a.d. Weinstr.,83,,3,2,5
045 Margreid a.d. Weinstr.,84,,1,4,5
045 Margreid a.d. Weinstr.,85,,1,3,4
045 Margreid a.d. Weinstr.,86,,1,1,2
045 Margreid a.d. Weinstr.,87,,-,1,1
045 Margreid a.d. Weinstr.,88,,-,1,1
045 Margreid a.d. Weinstr.,89,,1,4,5
045 Margreid a.d. Weinstr.,90,,1,-,1
045 Margreid a.d. Weinstr.,92,,1,2,3
045 Margreid a.d. Weinstr.,Insgesamt,,627,642,1.269
046 Mals,0,,25,20,45
046 Mals,1,,23,29,52
046 Mals,2,,33,37,70
046 Mals,3,,28,32,60
046 Mals,4,,30,24,54
046 Mals,5,,31,20,51
046 Mals,6,,22,27,49
046 Mals,7,,31,30,61
046 Mals,8,,32,35,67
046 Mals,9,,41,30,71
046 Mals,10,,36,33,69
046 Mals,11,,31,32,63
046 Mals,12,,35,25,60
046 Mals,13,,34,42,76
046 Mals,14,,37,31,68
046 Mals,15,,36,33,69
046 Mals,16,,31,33,64
046 Mals,17,,34,34,68
046 Mals,18,,34,29,63
046 Mals,19,,40,35,75
046 Mals,20,,33,24,57
046 Mals,21,,32,28,60
046 Mals,22,,27,37,64
046 Mals,23,,36,35,71
046 Mals,24,,38,34,72
046 Mals,25,,33,29,62
046 Mals,26,,37,29,66
046 Mals,27,,38,38,76
046 Mals,28,,42,33,75
046 Mals,29,,34,29,63
046 Mals,30,,47,31,78
046 Mals,31,,33,32,65
046 Mals,32,,35,27,62
046 Mals,33,,39,32,71
046 Mals,34,,47,25,72
046 Mals,35,,34,38,72
046 Mals,36,,31,48,79
046 Mals,37,,37,47,84
046 Mals,38,,43,49,92
046 Mals,39,,44,42,86
046 Mals,40,,55,38,93
046 Mals,41,,49,31,80
046 Mals,42,,53,52,105
046 Mals,43,,52,39,91
046 Mals,44,,50,42,92
046 Mals,45,,49,54,103
046 Mals,46,,36,27,63
046 Mals,47,,48,37,85
046 Mals,48,,33,41,74
046 Mals,49,,33,33,66
046 Mals,50,,34,23,57
046 Mals,51,,36,33,69
046 Mals,52,,33,27,60
046 Mals,53,,32,23,55
046 Mals,54,,20,21,41
046 Mals,55,,34,31,65
046 Mals,56,,28,22,50
046 Mals,57,,32,22,54
046 Mals,58,,31,21,52
046 Mals,59,,18,23,41
046 Mals,60,,27,15,42
046 Mals,61,,23,20,43
046 Mals,62,,21,29,50
046 Mals,63,,10,20,30
046 Mals,64,,28,14,42
046 Mals,65,,24,20,44
046 Mals,66,,22,23,45
046 Mals,67,,16,18,34
046 Mals,68,,20,28,48
046 Mals,69,,23,27,50
046 Mals,70,,19,20,39
046 Mals,71,,12,28,40
046 Mals,72,,20,18,38
046 Mals,73,,14,19,33
046 Mals,74,,11,17,28
046 Mals,75,,11,21,32
046 Mals,76,,16,11,27
046 Mals,77,,9,17,26
046 Mals,78,,20,14,34
046 Mals,79,,14,14,28
046 Mals,80,,15,13,28
046 Mals,81,,9,13,22
046 Mals,82,,7,17,24
046 Mals,83,,5,15,20
046 Mals,84,,6,11,17
046 Mals,85,,1,9,10
046 Mals,86,,9,12,21
046 Mals,87,,6,8,14
046 Mals,88,,2,10,12
046 Mals,89,,1,14,15
046 Mals,90,,1,1,2
046 Mals,91,,3,2,5
046 Mals,92,,-,1,1
046 Mals,93,,1,3,4
046 Mals,94,,1,3,4
046 Mals,95,,1,4,5
046 Mals,98,,-,1,1
046 Mals,99,,-,1,1
046 Mals,Insgesamt,,2.568,2.469,5.037
047 Enneberg,0,,16,17,33
047 Enneberg,1,,16,16,32
047 Enneberg,2,,25,19,44
047 Enneberg,3,,22,18,40
047 Enneberg,4,,14,17,31
047 Enneberg,5,,22,27,49
047 Enneberg,6,,19,13,32
047 Enneberg,7,,27,17,44
047 Enneberg,8,,18,20,38
047 Enneberg,9,,27,17,44
047 Enneberg,10,,18,10,28
047 Enneberg,11,,23,15,38
047 Enneberg,12,,17,13,30
047 Enneberg,13,,20,8,28
047 Enneberg,14,,21,15,36
047 Enneberg,15,,20,17,37
047 Enneberg,16,,15,15,30
047 Enneberg,17,,17,22,39
047 Enneberg,18,,15,17,32
047 Enneberg,19,,20,17,37
047 Enneberg,20,,20,15,35
047 Enneberg,21,,18,13,31
047 Enneberg,22,,19,12,31
047 Enneberg,23,,26,18,44
047 Enneberg,24,,20,18,38
047 Enneberg,25,,15,16,31
047 Enneberg,26,,26,20,46
047 Enneberg,27,,23,24,47
047 Enneberg,28,,25,17,42
047 Enneberg,29,,11,17,28
047 Enneberg,30,,16,22,38
047 Enneberg,31,,22,18,40
047 Enneberg,32,,13,19,32
047 Enneberg,33,,13,30,43
047 Enneberg,34,,29,32,61
047 Enneberg,35,,22,23,45
047 Enneberg,36,,22,28,50
047 Enneberg,37,,29,33,62
047 Enneberg,38,,27,20,47
047 Enneberg,39,,27,20,47
047 Enneberg,40,,24,21,45
047 Enneberg,41,,25,20,45
047 Enneberg,42,,18,22,40
047 Enneberg,43,,29,21,50
047 Enneberg,44,,23,22,45
047 Enneberg,45,,22,19,41
047 Enneberg,46,,17,17,34
047 Enneberg,47,,21,16,37
047 Enneberg,48,,15,17,32
047 Enneberg,49,,24,13,37
047 Enneberg,50,,20,9,29
047 Enneberg,51,,16,15,31
047 Enneberg,52,,15,19,34
047 Enneberg,53,,13,13,26
047 Enneberg,54,,14,11,25
047 Enneberg,55,,18,20,38
047 Enneberg,56,,14,16,30
047 Enneberg,57,,17,10,27
047 Enneberg,58,,11,15,26
047 Enneberg,59,,19,8,27
047 Enneberg,60,,16,13,29
047 Enneberg,61,,8,13,21
047 Enneberg,62,,13,17,30
047 Enneberg,63,,5,12,17
047 Enneberg,64,,20,17,37
047 Enneberg,65,,16,10,26
047 Enneberg,66,,12,20,32
047 Enneberg,67,,13,11,24
047 Enneberg,68,,10,7,17
047 Enneberg,69,,15,9,24
047 Enneberg,70,,12,18,30
047 Enneberg,71,,14,12,26
047 Enneberg,72,,11,12,23
047 Enneberg,73,,12,15,27
047 Enneberg,74,,7,10,17
047 Enneberg,75,,10,8,18
047 Enneberg,76,,7,16,23
047 Enneberg,77,,9,9,18
047 Enneberg,78,,12,13,25
047 Enneberg,79,,5,7,12
047 Enneberg,80,,9,11,20
047 Enneberg,81,,5,5,10
047 Enneberg,82,,5,8,13
047 Enneberg,83,,9,8,17
047 Enneberg,84,,2,5,7
047 Enneberg,85,,1,10,11
047 Enneberg,86,,7,5,12
047 Enneberg,87,,1,6,7
047 Enneberg,88,,5,2,7
047 Enneberg,89,,-,2,2
047 Enneberg,90,,1,3,4
047 Enneberg,91,,-,2,2
047 Enneberg,92,,1,6,7
047 Enneberg,93,,-,2,2
047 Enneberg,94,,1,3,4
047 Enneberg,96,,-,1,1
047 Enneberg,103,,-,1,1
047 Enneberg,Insgesamt,,1.464,1.398,2.862
048 Marling,0,,8,10,18
048 Marling,1,,16,11,27
048 Marling,2,,12,17,29
048 Marling,3,,24,14,38
048 Marling,4,,15,12,27
048 Marling,5,,12,9,21
048 Marling,6,,17,13,30
048 Marling,7,,9,16,25
048 Marling,8,,15,15,30
048 Marling,9,,14,8,22
048 Marling,10,,11,11,22
048 Marling,11,,14,9,23
048 Marling,12,,14,13,27
048 Marling,13,,18,12,30
048 Marling,14,,10,7,17
048 Marling,15,,17,8,25
048 Marling,16,,16,14,30
048 Marling,17,,11,15,26
048 Marling,18,,10,19,29
048 Marling,19,,11,16,27
048 Marling,20,,13,13,26
048 Marling,21,,6,12,18
048 Marling,22,,13,12,25
048 Marling,23,,8,18,26
048 Marling,24,,14,9,23
048 Marling,25,,12,15,27
048 Marling,26,,13,11,24
048 Marling,27,,18,11,29
048 Marling,28,,16,12,28
048 Marling,29,,19,28,47
048 Marling,30,,20,16,36
048 Marling,31,,12,15,27
048 Marling,32,,18,28,46
048 Marling,33,,22,15,37
048 Marling,34,,16,8,24
048 Marling,35,,14,22,36
048 Marling,36,,17,21,38
048 Marling,37,,26,14,40
048 Marling,38,,19,19,38
048 Marling,39,,22,17,39
048 Marling,40,,28,20,48
048 Marling,41,,20,19,39
048 Marling,42,,22,26,48
048 Marling,43,,25,19,44
048 Marling,44,,29,21,50
048 Marling,45,,26,31,57
048 Marling,46,,21,19,40
048 Marling,47,,23,12,35
048 Marling,48,,17,21,38
048 Marling,49,,18,16,34
048 Marling,50,,18,14,32
048 Marling,51,,15,9,24
048 Marling,52,,10,13,23
048 Marling,53,,11,8,19
048 Marling,54,,17,12,29
048 Marling,55,,12,17,29
048 Marling,56,,16,15,31
048 Marling,57,,7,15,22
048 Marling,58,,14,14,28
048 Marling,59,,18,18,36
048 Marling,60,,6,14,20
048 Marling,61,,16,13,29
048 Marling,62,,12,15,27
048 Marling,63,,21,14,35
048 Marling,64,,15,16,31
048 Marling,65,,9,17,26
048 Marling,66,,10,11,21
048 Marling,67,,20,19,39
048 Marling,68,,12,13,25
048 Marling,69,,14,16,30
048 Marling,70,,8,12,20
048 Marling,71,,11,16,27
048 Marling,72,,16,8,24
048 Marling,73,,3,16,19
048 Marling,74,,12,9,21
048 Marling,75,,7,13,20
048 Marling,76,,8,10,18
048 Marling,77,,8,7,15
048 Marling,78,,3,8,11
048 Marling,79,,7,5,12
048 Marling,80,,7,2,9
048 Marling,81,,8,7,15
048 Marling,82,,3,8,11
048 Marling,83,,2,12,14
048 Marling,84,,-,5,5
048 Marling,85,,3,6,9
048 Marling,86,,2,3,5
048 Marling,87,,4,4,8
048 Marling,88,,-,1,1
048 Marling,89,,2,2,4
048 Marling,90,,1,1,2
048 Marling,92,,-,2,2
048 Marling,93,,1,1,2
048 Marling,94,,2,1,3
048 Marling,95,,-,2,2
048 Marling,96,,1,-,1
048 Marling,99,,1,-,1
048 Marling,Insgesamt,,1.214,1.213,2.427
049 Martell,0,,6,1,7
049 Martell,1,,7,-,7
049 Martell,2,,5,5,10
049 Martell,3,,7,2,9
049 Martell,4,,7,2,9
049 Martell,5,,5,5,10
049 Martell,6,,3,5,8
049 Martell,7,,4,7,11
049 Martell,8,,6,4,10
049 Martell,9,,3,7,10
049 Martell,10,,6,7,13
049 Martell,11,,4,9,13
049 Martell,12,,4,6,10
049 Martell,13,,6,8,14
049 Martell,14,,6,8,14
049 Martell,15,,6,5,11
049 Martell,16,,4,7,11
049 Martell,17,,7,5,12
049 Martell,18,,6,5,11
049 Martell,19,,9,4,13
049 Martell,20,,4,1,5
049 Martell,21,,6,3,9
049 Martell,22,,-,3,3
049 Martell,23,,4,6,10
049 Martell,24,,4,-,4
049 Martell,25,,6,4,10
049 Martell,26,,5,8,13
049 Martell,27,,7,5,12
049 Martell,28,,9,3,12
049 Martell,29,,8,6,14
049 Martell,30,,4,6,10
049 Martell,31,,7,4,11
049 Martell,32,,5,5,10
049 Martell,33,,1,7,8
049 Martell,34,,6,9,15
049 Martell,35,,9,5,14
049 Martell,36,,4,8,12
049 Martell,37,,9,4,13
049 Martell,38,,7,3,10
049 Martell,39,,6,13,19
049 Martell,40,,8,6,14
049 Martell,41,,5,8,13
049 Martell,42,,16,7,23
049 Martell,43,,17,11,28
049 Martell,44,,8,9,17
049 Martell,45,,13,1,14
049 Martell,46,,10,7,17
049 Martell,47,,7,5,12
049 Martell,48,,9,3,12
049 Martell,49,,8,6,14
049 Martell,50,,8,6,14
049 Martell,51,,7,3,10
049 Martell,52,,5,3,8
049 Martell,53,,7,2,9
049 Martell,54,,5,6,11
049 Martell,55,,4,4,8
049 Martell,56,,4,3,7
049 Martell,57,,6,7,13
049 Martell,58,,2,4,6
049 Martell,59,,3,1,4
049 Martell,60,,5,4,9
049 Martell,61,,3,3,6
049 Martell,62,,3,-,3
049 Martell,63,,4,1,5
049 Martell,64,,1,3,4
049 Martell,65,,2,4,6
049 Martell,66,,6,5,11
049 Martell,67,,3,4,7
049 Martell,68,,6,2,8
049 Martell,69,,2,4,6
049 Martell,70,,2,6,8
049 Martell,71,,2,4,6
049 Martell,72,,3,4,7
049 Martell,73,,4,8,12
049 Martell,74,,7,1,8
049 Martell,75,,4,6,10
049 Martell,76,,2,3,5
049 Martell,77,,5,-,5
049 Martell,78,,7,4,11
049 Martell,79,,4,3,7
049 Martell,80,,2,2,4
049 Martell,81,,2,3,5
049 Martell,82,,1,8,9
049 Martell,83,,2,1,3
049 Martell,84,,3,5,8
049 Martell,85,,-,6,6
049 Martell,86,,1,1,2
049 Martell,90,,1,1,2
049 Martell,93,,-,1,1
049 Martell,94,,-,1,1
049 Martell,95,,1,-,1
049 Martell,97,,2,-,2
049 Martell,Insgesamt,,464,405,869
050 Mölten,0,,8,14,22
050 Mölten,1,,14,13,27
050 Mölten,2,,8,8,16
050 Mölten,3,,9,11,20
050 Mölten,4,,10,9,19
050 Mölten,5,,10,9,19
050 Mölten,6,,16,11,27
050 Mölten,7,,15,16,31
050 Mölten,8,,14,14,28
050 Mölten,9,,12,18,30
050 Mölten,10,,8,16,24
050 Mölten,11,,10,7,17
050 Mölten,12,,16,13,29
050 Mölten,13,,11,10,21
050 Mölten,14,,13,5,18
050 Mölten,15,,12,11,23
050 Mölten,16,,6,12,18
050 Mölten,17,,10,6,16
050 Mölten,18,,12,6,18
050 Mölten,19,,13,5,18
050 Mölten,20,,7,9,16
050 Mölten,21,,9,8,17
050 Mölten,22,,10,7,17
050 Mölten,23,,7,14,21
050 Mölten,24,,7,3,10
050 Mölten,25,,6,12,18
050 Mölten,26,,9,10,19
050 Mölten,27,,13,12,25
050 Mölten,28,,16,9,25
050 Mölten,29,,14,14,28
050 Mölten,30,,11,7,18
050 Mölten,31,,9,12,21
050 Mölten,32,,12,19,31
050 Mölten,33,,21,14,35
050 Mölten,34,,14,10,24
050 Mölten,35,,14,16,30
050 Mölten,36,,10,9,19
050 Mölten,37,,18,13,31
050 Mölten,38,,15,12,27
050 Mölten,39,,15,14,29
050 Mölten,40,,15,16,31
050 Mölten,41,,18,14,32
050 Mölten,42,,14,13,27
050 Mölten,43,,10,16,26
050 Mölten,44,,19,16,35
050 Mölten,45,,20,6,26
050 Mölten,46,,14,9,23
050 Mölten,47,,16,10,26
050 Mölten,48,,10,9,19
050 Mölten,49,,15,6,21
050 Mölten,50,,2,10,12
050 Mölten,51,,7,3,10
050 Mölten,52,,5,9,14
050 Mölten,53,,12,7,19
050 Mölten,54,,6,7,13
050 Mölten,55,,7,6,13
050 Mölten,56,,8,6,14
050 Mölten,57,,5,6,11
050 Mölten,58,,10,9,19
050 Mölten,59,,8,6,14
050 Mölten,60,,6,4,10
050 Mölten,61,,3,8,11
050 Mölten,62,,8,3,11
050 Mölten,63,,6,5,11
050 Mölten,64,,2,6,8
050 Mölten,65,,13,8,21
050 Mölten,66,,6,10,16
050 Mölten,67,,10,4,14
050 Mölten,68,,5,7,12
050 Mölten,69,,5,7,12
050 Mölten,70,,2,3,5
050 Mölten,71,,4,7,11
050 Mölten,72,,3,4,7
050 Mölten,73,,8,6,14
050 Mölten,74,,8,5,13
050 Mölten,75,,7,8,15
050 Mölten,76,,3,5,8
050 Mölten,77,,8,3,11
050 Mölten,78,,6,2,8
050 Mölten,79,,1,6,7
050 Mölten,80,,1,4,5
050 Mölten,81,,2,3,5
050 Mölten,82,,2,4,6
050 Mölten,83,,2,4,6
050 Mölten,84,,1,1,2
050 Mölten,85,,6,5,11
050 Mölten,86,,1,2,3
050 Mölten,87,,-,2,2
050 Mölten,88,,-,5,5
050 Mölten,89,,-,5,5
050 Mölten,90,,-,1,1
050 Mölten,92,,-,1,1
050 Mölten,93,,-,1,1
050 Mölten,94,,-,1,1
050 Mölten,Insgesamt,,814,772,1.586
051 Meran,0,,179,151,330
051 Meran,1,,218,177,395
051 Meran,2,,192,198,390
051 Meran,3,,181,159,340
051 Meran,4,,221,164,385
051 Meran,5,,178,176,354
051 Meran,6,,186,161,347
051 Meran,7,,182,181,363
051 Meran,8,,190,154,344
051 Meran,9,,179,191,370
051 Meran,10,,160,149,309
051 Meran,11,,193,171,364
051 Meran,12,,203,166,369
051 Meran,13,,170,157,327
051 Meran,14,,176,185,361
051 Meran,15,,138,158,296
051 Meran,16,,173,149,322
051 Meran,17,,164,184,348
051 Meran,18,,167,155,322
051 Meran,19,,193,165,358
051 Meran,20,,178,137,315
051 Meran,21,,182,157,339
051 Meran,22,,172,147,319
051 Meran,23,,148,210,358
051 Meran,24,,188,179,367
051 Meran,25,,178,203,381
051 Meran,26,,199,214,413
051 Meran,27,,222,207,429
051 Meran,28,,223,202,425
051 Meran,29,,196,196,392
051 Meran,30,,241,217,458
051 Meran,31,,223,247,470
051 Meran,32,,228,262,490
051 Meran,33,,244,269,513
051 Meran,34,,274,310,584
051 Meran,35,,275,286,561
051 Meran,36,,300,291,591
051 Meran,37,,298,280,578
051 Meran,38,,309,308,617
051 Meran,39,,328,324,652
051 Meran,40,,348,335,683
051 Meran,41,,352,340,692
051 Meran,42,,314,301,615
051 Meran,43,,334,326,660
051 Meran,44,,340,301,641
051 Meran,45,,339,286,625
051 Meran,46,,272,291,563
051 Meran,47,,296,299,595
051 Meran,48,,296,277,573
051 Meran,49,,273,249,522
051 Meran,50,,249,241,490
051 Meran,51,,229,258,487
051 Meran,52,,227,223,450
051 Meran,53,,200,222,422
051 Meran,54,,180,233,413
051 Meran,55,,178,231,409
051 Meran,56,,200,222,422
051 Meran,57,,201,212,413
051 Meran,58,,195,222,417
051 Meran,59,,223,249,472
051 Meran,60,,212,260,472
051 Meran,61,,216,280,496
051 Meran,62,,241,293,534
051 Meran,63,,203,215,418
051 Meran,64,,205,226,431
051 Meran,65,,253,241,494
051 Meran,66,,254,299,553
051 Meran,67,,225,281,506
051 Meran,68,,186,223,409
051 Meran,69,,185,247,432
051 Meran,70,,171,222,393
051 Meran,71,,173,222,395
051 Meran,72,,162,195,357
051 Meran,73,,155,200,355
051 Meran,74,,144,175,319
051 Meran,75,,139,171,310
051 Meran,76,,123,185,308
051 Meran,77,,108,163,271
051 Meran,78,,113,177,290
051 Meran,79,,92,134,226
051 Meran,80,,86,161,247
051 Meran,81,,88,132,220
051 Meran,82,,80,157,237
051 Meran,83,,57,141,198
051 Meran,84,,68,130,198
051 Meran,85,,49,130,179
051 Meran,86,,54,131,185
051 Meran,87,,28,125,153
051 Meran,88,,33,103,136
051 Meran,89,,24,64,88
051 Meran,90,,7,42,49
051 Meran,91,,17,39,56
051 Meran,92,,10,24,34
051 Meran,93,,10,33,43
051 Meran,94,,12,36,48
051 Meran,95,,6,20,26
051 Meran,96,,8,22,30
051 Meran,97,,3,5,8
051 Meran,98,,2,10,12
051 Meran,99,,1,8,9
051 Meran,100,,2,5,7
051 Meran,101,,-,2,2
051 Meran,102,,-,2,2
051 Meran,Insgesamt,,17.700,19.246,36.946
052 Welsberg-Taisten,0,,20,21,41
052 Welsberg-Taisten,1,,21,21,42
052 Welsberg-Taisten,2,,9,28,37
052 Welsberg-Taisten,3,,19,23,42
052 Welsberg-Taisten,4,,14,19,33
052 Welsberg-Taisten,5,,19,16,35
052 Welsberg-Taisten,6,,21,22,43
052 Welsberg-Taisten,7,,30,18,48
052 Welsberg-Taisten,8,,18,14,32
052 Welsberg-Taisten,9,,20,20,40
052 Welsberg-Taisten,10,,22,11,33
052 Welsberg-Taisten,11,,19,19,38
052 Welsberg-Taisten,12,,15,17,32
052 Welsberg-Taisten,13,,19,15,34
052 Welsberg-Taisten,14,,13,16,29
052 Welsberg-Taisten,15,,15,21,36
052 Welsberg-Taisten,16,,10,10,20
052 Welsberg-Taisten,17,,21,18,39
052 Welsberg-Taisten,18,,10,19,29
052 Welsberg-Taisten,19,,4,18,22
052 Welsberg-Taisten,20,,12,17,29
052 Welsberg-Taisten,21,,13,14,27
052 Welsberg-Taisten,22,,11,10,21
052 Welsberg-Taisten,23,,8,17,25
052 Welsberg-Taisten,24,,28,16,44
052 Welsberg-Taisten,25,,22,18,40
052 Welsberg-Taisten,26,,18,18,36
052 Welsberg-Taisten,27,,12,17,29
052 Welsberg-Taisten,28,,18,17,35
052 Welsberg-Taisten,29,,25,16,41
052 Welsberg-Taisten,30,,18,19,37
052 Welsberg-Taisten,31,,13,24,37
052 Welsberg-Taisten,32,,18,9,27
052 Welsberg-Taisten,33,,16,25,41
052 Welsberg-Taisten,34,,26,21,47
052 Welsberg-Taisten,35,,28,12,40
052 Welsberg-Taisten,36,,16,29,45
052 Welsberg-Taisten,37,,32,21,53
052 Welsberg-Taisten,38,,27,23,50
052 Welsberg-Taisten,39,,22,20,42
052 Welsberg-Taisten,40,,29,18,47
052 Welsberg-Taisten,41,,30,22,52
052 Welsberg-Taisten,42,,31,21,52
052 Welsberg-Taisten,43,,20,16,36
052 Welsberg-Taisten,44,,35,20,55
052 Welsberg-Taisten,45,,28,24,52
052 Welsberg-Taisten,46,,19,22,41
052 Welsberg-Taisten,47,,18,16,34
052 Welsberg-Taisten,48,,11,17,28
052 Welsberg-Taisten,49,,19,21,40
052 Welsberg-Taisten,50,,26,17,43
052 Welsberg-Taisten,51,,11,19,30
052 Welsberg-Taisten,52,,20,19,39
052 Welsberg-Taisten,53,,15,11,26
052 Welsberg-Taisten,54,,15,14,29
052 Welsberg-Taisten,55,,19,12,31
052 Welsberg-Taisten,56,,17,11,28
052 Welsberg-Taisten,57,,19,11,30
052 Welsberg-Taisten,58,,14,14,28
052 Welsberg-Taisten,59,,14,11,25
052 Welsberg-Taisten,60,,16,18,34
052 Welsberg-Taisten,61,,10,12,22
052 Welsberg-Taisten,62,,14,14,28
052 Welsberg-Taisten,63,,10,13,23
052 Welsberg-Taisten,64,,14,11,25
052 Welsberg-Taisten,65,,10,15,25
052 Welsberg-Taisten,66,,11,14,25
052 Welsberg-Taisten,67,,18,17,35
052 Welsberg-Taisten,68,,6,12,18
052 Welsberg-Taisten,69,,11,12,23
052 Welsberg-Taisten,70,,11,12,23
052 Welsberg-Taisten,71,,10,8,18
052 Welsberg-Taisten,72,,10,10,20
052 Welsberg-Taisten,73,,3,16,19
052 Welsberg-Taisten,74,,17,15,32
052 Welsberg-Taisten,75,,9,10,19
052 Welsberg-Taisten,76,,10,10,20
052 Welsberg-Taisten,77,,6,12,18
052 Welsberg-Taisten,78,,8,7,15
052 Welsberg-Taisten,79,,6,10,16
052 Welsberg-Taisten,80,,5,16,21
052 Welsberg-Taisten,81,,2,12,14
052 Welsberg-Taisten,82,,6,5,11
052 Welsberg-Taisten,83,,-,7,7
052 Welsberg-Taisten,84,,1,7,8
052 Welsberg-Taisten,85,,3,6,9
052 Welsberg-Taisten,86,,3,3,6
052 Welsberg-Taisten,87,,3,4,7
052 Welsberg-Taisten,88,,2,3,5
052 Welsberg-Taisten,89,,1,4,5
052 Welsberg-Taisten,90,,1,-,1
052 Welsberg-Taisten,91,,1,1,2
052 Welsberg-Taisten,92,,1,-,1
052 Welsberg-Taisten,93,,1,2,3
052 Welsberg-Taisten,95,,-,1,1
052 Welsberg-Taisten,96,,-,2,2
052 Welsberg-Taisten,97,,-,1,1
052 Welsberg-Taisten,98,,-,2,2
052 Welsberg-Taisten,100,,-,2,2
052 Welsberg-Taisten,101,,-,1,1
052 Welsberg-Taisten,Insgesamt,,1.372,1.392,2.764
053 Montan,0,,10,8,18
053 Montan,1,,5,5,10
053 Montan,2,,8,6,14
053 Montan,3,,10,8,18
053 Montan,4,,6,9,15
053 Montan,5,,8,9,17
053 Montan,6,,5,4,9
053 Montan,7,,11,4,15
053 Montan,8,,9,6,15
053 Montan,9,,6,11,17
053 Montan,10,,9,12,21
053 Montan,11,,8,9,17
053 Montan,12,,14,10,24
053 Montan,13,,16,16,32
053 Montan,14,,13,6,19
053 Montan,15,,5,9,14
053 Montan,16,,7,10,17
053 Montan,17,,14,9,23
053 Montan,18,,10,7,17
053 Montan,19,,10,11,21
053 Montan,20,,12,15,27
053 Montan,21,,11,17,28
053 Montan,22,,13,6,19
053 Montan,23,,10,10,20
053 Montan,24,,8,2,10
053 Montan,25,,11,8,19
053 Montan,26,,8,8,16
053 Montan,27,,11,11,22
053 Montan,28,,5,5,10
053 Montan,29,,11,5,16
053 Montan,30,,9,3,12
053 Montan,31,,6,6,12
053 Montan,32,,8,8,16
053 Montan,33,,8,12,20
053 Montan,34,,9,14,23
053 Montan,35,,13,3,16
053 Montan,36,,7,9,16
053 Montan,37,,12,7,19
053 Montan,38,,14,13,27
053 Montan,39,,14,17,31
053 Montan,40,,15,18,33
053 Montan,41,,11,13,24
053 Montan,42,,13,16,29
053 Montan,43,,26,16,42
053 Montan,44,,17,11,28
053 Montan,45,,11,16,27
053 Montan,46,,15,18,33
053 Montan,47,,19,12,31
053 Montan,48,,13,12,25
053 Montan,49,,14,8,22
053 Montan,50,,13,10,23
053 Montan,51,,15,10,25
053 Montan,52,,7,15,22
053 Montan,53,,8,13,21
053 Montan,54,,14,11,25
053 Montan,55,,11,7,18
053 Montan,56,,12,4,16
053 Montan,57,,9,8,17
053 Montan,58,,4,5,9
053 Montan,59,,8,3,11
053 Montan,60,,5,6,11
053 Montan,61,,8,11,19
053 Montan,62,,4,2,6
053 Montan,63,,5,3,8
053 Montan,64,,2,6,8
053 Montan,65,,5,6,11
053 Montan,66,,7,6,13
053 Montan,67,,6,5,11
053 Montan,68,,9,7,16
053 Montan,69,,4,10,14
053 Montan,70,,6,9,15
053 Montan,71,,2,6,8
053 Montan,72,,7,10,17
053 Montan,73,,1,8,9
053 Montan,74,,2,6,8
053 Montan,75,,14,5,19
053 Montan,76,,5,7,12
053 Montan,77,,7,10,17
053 Montan,78,,8,12,20
053 Montan,79,,6,9,15
053 Montan,80,,6,3,9
053 Montan,81,,3,4,7
053 Montan,82,,6,7,13
053 Montan,83,,2,8,10
053 Montan,84,,1,5,6
053 Montan,85,,-,8,8
053 Montan,86,,3,5,8
053 Montan,87,,1,2,3
053 Montan,88,,1,4,5
053 Montan,89,,-,3,3
053 Montan,90,,-,2,2
053 Montan,92,,-,1,1
053 Montan,93,,-,2,2
053 Montan,94,,1,-,1
053 Montan,95,,-,1,1
053 Montan,97,,-,1,1
053 Montan,99,,-,1,1
053 Montan,Insgesamt,,776,775,1.551
054 Moos in Passeier,0,,15,11,26
054 Moos in Passeier,1,,16,7,23
054 Moos in Passeier,2,,16,8,24
054 Moos in Passeier,3,,17,13,30
054 Moos in Passeier,4,,18,21,39
054 Moos in Passeier,5,,14,11,25
054 Moos in Passeier,6,,21,18,39
054 Moos in Passeier,7,,14,12,26
054 Moos in Passeier,8,,12,18,30
054 Moos in Passeier,9,,25,9,34
054 Moos in Passeier,10,,15,14,29
054 Moos in Passeier,11,,12,17,29
054 Moos in Passeier,12,,18,19,37
054 Moos in Passeier,13,,8,11,19
054 Moos in Passeier,14,,17,20,37
054 Moos in Passeier,15,,17,13,30
054 Moos in Passeier,16,,18,17,35
054 Moos in Passeier,17,,16,20,36
054 Moos in Passeier,18,,15,13,28
054 Moos in Passeier,19,,17,18,35
054 Moos in Passeier,20,,16,13,29
054 Moos in Passeier,21,,15,14,29
054 Moos in Passeier,22,,17,13,30
054 Moos in Passeier,23,,19,10,29
054 Moos in Passeier,24,,21,19,40
054 Moos in Passeier,25,,12,11,23
054 Moos in Passeier,26,,14,19,33
054 Moos in Passeier,27,,15,15,30
054 Moos in Passeier,28,,16,16,32
054 Moos in Passeier,29,,18,13,31
054 Moos in Passeier,30,,20,13,33
054 Moos in Passeier,31,,20,18,38
054 Moos in Passeier,32,,13,9,22
054 Moos in Passeier,33,,17,14,31
054 Moos in Passeier,34,,23,15,38
054 Moos in Passeier,35,,9,21,30
054 Moos in Passeier,36,,19,16,35
054 Moos in Passeier,37,,16,17,33
054 Moos in Passeier,38,,20,11,31
054 Moos in Passeier,39,,16,18,34
054 Moos in Passeier,40,,19,17,36
054 Moos in Passeier,41,,22,15,37
054 Moos in Passeier,42,,23,20,43
054 Moos in Passeier,43,,20,8,28
054 Moos in Passeier,44,,23,11,34
054 Moos in Passeier,45,,15,19,34
054 Moos in Passeier,46,,10,20,30
054 Moos in Passeier,47,,9,7,16
054 Moos in Passeier,48,,16,15,31
054 Moos in Passeier,49,,16,14,30
054 Moos in Passeier,50,,13,14,27
054 Moos in Passeier,51,,19,6,25
054 Moos in Passeier,52,,9,8,17
054 Moos in Passeier,53,,8,8,16
054 Moos in Passeier,54,,15,9,24
054 Moos in Passeier,55,,7,9,16
054 Moos in Passeier,56,,8,3,11
054 Moos in Passeier,57,,9,10,19
054 Moos in Passeier,58,,6,10,16
054 Moos in Passeier,59,,14,9,23
054 Moos in Passeier,60,,6,6,12
054 Moos in Passeier,61,,18,10,28
054 Moos in Passeier,62,,9,8,17
054 Moos in Passeier,63,,9,7,16
054 Moos in Passeier,64,,11,7,18
054 Moos in Passeier,65,,13,12,25
054 Moos in Passeier,66,,5,12,17
054 Moos in Passeier,67,,8,13,21
054 Moos in Passeier,68,,8,9,17
054 Moos in Passeier,69,,5,4,9
054 Moos in Passeier,70,,10,7,17
054 Moos in Passeier,71,,5,6,11
054 Moos in Passeier,72,,8,7,15
054 Moos in Passeier,73,,8,5,13
054 Moos in Passeier,74,,12,14,26
054 Moos in Passeier,75,,5,10,15
054 Moos in Passeier,76,,8,3,11
054 Moos in Passeier,77,,9,6,15
054 Moos in Passeier,78,,8,7,15
054 Moos in Passeier,79,,7,12,19
054 Moos in Passeier,80,,3,10,13
054 Moos in Passeier,81,,5,4,9
054 Moos in Passeier,82,,7,2,9
054 Moos in Passeier,83,,5,7,12
054 Moos in Passeier,84,,3,4,7
054 Moos in Passeier,85,,3,3,6
054 Moos in Passeier,86,,-,5,5
054 Moos in Passeier,87,,1,2,3
054 Moos in Passeier,88,,2,1,3
054 Moos in Passeier,89,,1,2,3
054 Moos in Passeier,91,,1,1,2
054 Moos in Passeier,92,,-,2,2
054 Moos in Passeier,94,,-,1,1
054 Moos in Passeier,96,,-,1,1
054 Moos in Passeier,98,,-,1,1
054 Moos in Passeier,Insgesamt,,1.141,1.028,2.169
055 Nals,0,,11,6,17
055 Nals,1,,7,8,15
055 Nals,2,,11,3,14
055 Nals,3,,8,12,20
055 Nals,4,,7,7,14
055 Nals,5,,8,5,13
055 Nals,6,,11,11,22
055 Nals,7,,7,8,15
055 Nals,8,,6,13,19
055 Nals,9,,13,8,21
055 Nals,10,,13,8,21
055 Nals,11,,12,6,18
055 Nals,12,,11,11,22
055 Nals,13,,7,6,13
055 Nals,14,,9,8,17
055 Nals,15,,7,12,19
055 Nals,16,,12,9,21
055 Nals,17,,8,11,19
055 Nals,18,,9,7,16
055 Nals,19,,12,8,20
055 Nals,20,,10,13,23
055 Nals,21,,14,10,24
055 Nals,22,,6,4,10
055 Nals,23,,12,6,18
055 Nals,24,,9,12,21
055 Nals,25,,6,10,16
055 Nals,26,,7,8,15
055 Nals,27,,12,10,22
055 Nals,28,,14,13,27
055 Nals,29,,10,10,20
055 Nals,30,,11,12,23
055 Nals,31,,8,8,16
055 Nals,32,,12,12,24
055 Nals,33,,8,14,22
055 Nals,34,,20,11,31
055 Nals,35,,14,6,20
055 Nals,36,,13,15,28
055 Nals,37,,19,15,34
055 Nals,38,,24,14,38
055 Nals,39,,17,16,33
055 Nals,40,,22,15,37
055 Nals,41,,15,15,30
055 Nals,42,,15,14,29
055 Nals,43,,18,13,31
055 Nals,44,,18,19,37
055 Nals,45,,11,21,32
055 Nals,46,,14,13,27
055 Nals,47,,16,14,30
055 Nals,48,,13,9,22
055 Nals,49,,16,15,31
055 Nals,50,,15,17,32
055 Nals,51,,7,7,14
055 Nals,52,,7,9,16
055 Nals,53,,21,15,36
055 Nals,54,,8,7,15
055 Nals,55,,8,7,15
055 Nals,56,,7,6,13
055 Nals,57,,3,10,13
055 Nals,58,,6,11,17
055 Nals,59,,10,9,19
055 Nals,60,,12,12,24
055 Nals,61,,12,5,17
055 Nals,62,,6,13,19
055 Nals,63,,7,11,18
055 Nals,64,,5,12,17
055 Nals,65,,9,6,15
055 Nals,66,,6,8,14
055 Nals,67,,10,6,16
055 Nals,68,,8,12,20
055 Nals,69,,9,10,19
055 Nals,70,,5,9,14
055 Nals,71,,3,13,16
055 Nals,72,,6,4,10
055 Nals,73,,5,6,11
055 Nals,74,,5,5,10
055 Nals,75,,8,10,18
055 Nals,76,,5,5,10
055 Nals,77,,3,6,9
055 Nals,78,,2,5,7
055 Nals,79,,8,7,15
055 Nals,80,,6,7,13
055 Nals,81,,3,6,9
055 Nals,82,,6,4,10
055 Nals,83,,3,4,7
055 Nals,84,,2,-,2
055 Nals,85,,-,4,4
055 Nals,86,,1,4,5
055 Nals,87,,-,8,8
055 Nals,88,,-,1,1
055 Nals,89,,-,3,3
055 Nals,92,,-,1,1
055 Nals,93,,-,1,1
055 Nals,94,,-,2,2
055 Nals,95,,-,1,1
055 Nals,96,,1,-,1
055 Nals,97,,-,1,1
055 Nals,98,,-,1,1
055 Nals,Insgesamt,,841,845,1.686
056 Naturns,0,,27,22,49
056 Naturns,1,,31,30,61
056 Naturns,2,,34,30,64
056 Naturns,3,,33,21,54
056 Naturns,4,,35,30,65
056 Naturns,5,,38,24,62
056 Naturns,6,,28,28,56
056 Naturns,7,,30,29,59
056 Naturns,8,,30,28,58
056 Naturns,9,,33,28,61
056 Naturns,10,,30,32,62
056 Naturns,11,,23,18,41
056 Naturns,12,,32,34,66
056 Naturns,13,,44,35,79
056 Naturns,14,,33,38,71
056 Naturns,15,,32,37,69
056 Naturns,16,,30,40,70
056 Naturns,17,,43,37,80
056 Naturns,18,,34,32,66
056 Naturns,19,,37,22,59
056 Naturns,20,,42,36,78
056 Naturns,21,,36,21,57
056 Naturns,22,,29,31,60
056 Naturns,23,,37,26,63
056 Naturns,24,,39,20,59
056 Naturns,25,,32,37,69
056 Naturns,26,,40,39,79
056 Naturns,27,,40,50,90
056 Naturns,28,,37,39,76
056 Naturns,29,,46,36,82
056 Naturns,30,,38,42,80
056 Naturns,31,,38,37,75
056 Naturns,32,,36,33,69
056 Naturns,33,,46,38,84
056 Naturns,34,,42,48,90
056 Naturns,35,,47,49,96
056 Naturns,36,,47,46,93
056 Naturns,37,,42,39,81
056 Naturns,38,,52,42,94
056 Naturns,39,,38,45,83
056 Naturns,40,,44,44,88
056 Naturns,41,,51,45,96
056 Naturns,42,,57,46,103
056 Naturns,43,,39,54,93
056 Naturns,44,,49,38,87
056 Naturns,45,,44,49,93
056 Naturns,46,,40,47,87
056 Naturns,47,,38,48,86
056 Naturns,48,,57,39,96
056 Naturns,49,,44,38,82
056 Naturns,50,,31,36,67
056 Naturns,51,,38,33,71
056 Naturns,52,,41,38,79
056 Naturns,53,,29,32,61
056 Naturns,54,,38,31,69
056 Naturns,55,,34,23,57
056 Naturns,56,,31,36,67
056 Naturns,57,,35,34,69
056 Naturns,58,,27,32,59
056 Naturns,59,,25,20,45
056 Naturns,60,,30,25,55
056 Naturns,61,,11,23,34
056 Naturns,62,,22,30,52
056 Naturns,63,,25,18,43
056 Naturns,64,,19,21,40
056 Naturns,65,,25,34,59
056 Naturns,66,,31,34,65
056 Naturns,67,,38,30,68
056 Naturns,68,,23,19,42
056 Naturns,69,,19,21,40
056 Naturns,70,,23,17,40
056 Naturns,71,,23,23,46
056 Naturns,72,,19,22,41
056 Naturns,73,,20,13,33
056 Naturns,74,,15,19,34
056 Naturns,75,,14,13,27
056 Naturns,76,,9,19,28
056 Naturns,77,,10,20,30
056 Naturns,78,,12,23,35
056 Naturns,79,,11,17,28
056 Naturns,80,,14,13,27
056 Naturns,81,,5,14,19
056 Naturns,82,,12,11,23
056 Naturns,83,,10,16,26
056 Naturns,84,,11,12,23
056 Naturns,85,,5,9,14
056 Naturns,86,,2,7,9
056 Naturns,87,,1,10,11
056 Naturns,88,,1,4,5
056 Naturns,89,,-,5,5
056 Naturns,90,,2,2,4
056 Naturns,91,,1,-,1
056 Naturns,92,,1,-,1
056 Naturns,93,,-,1,1
056 Naturns,94,,-,5,5
056 Naturns,95,,3,2,5
056 Naturns,96,,-,1,1
056 Naturns,97,,-,1,1
056 Naturns,98,,1,-,1
056 Naturns,99,,-,3,3
056 Naturns,Insgesamt,,2.721,2.669,5.390
057 Natz-Schabs,0,,19,20,39
057 Natz-Schabs,1,,15,15,30
057 Natz-Schabs,2,,13,17,30
057 Natz-Schabs,3,,14,14,28
057 Natz-Schabs,4,,14,17,31
057 Natz-Schabs,5,,19,20,39
057 Natz-Schabs,6,,23,17,40
057 Natz-Schabs,7,,14,16,30
057 Natz-Schabs,8,,22,18,40
057 Natz-Schabs,9,,15,20,35
057 Natz-Schabs,10,,22,16,38
057 Natz-Schabs,11,,19,18,37
057 Natz-Schabs,12,,22,16,38
057 Natz-Schabs,13,,13,13,26
057 Natz-Schabs,14,,23,16,39
057 Natz-Schabs,15,,18,18,36
057 Natz-Schabs,16,,17,14,31
057 Natz-Schabs,17,,23,21,44
057 Natz-Schabs,18,,15,26,41
057 Natz-Schabs,19,,15,24,39
057 Natz-Schabs,20,,27,15,42
057 Natz-Schabs,21,,20,21,41
057 Natz-Schabs,22,,17,19,36
057 Natz-Schabs,23,,22,25,47
057 Natz-Schabs,24,,19,19,38
057 Natz-Schabs,25,,23,24,47
057 Natz-Schabs,26,,18,23,41
057 Natz-Schabs,27,,23,22,45
057 Natz-Schabs,28,,32,18,50
057 Natz-Schabs,29,,26,16,42
057 Natz-Schabs,30,,15,26,41
057 Natz-Schabs,31,,19,19,38
057 Natz-Schabs,32,,15,18,33
057 Natz-Schabs,33,,21,25,46
057 Natz-Schabs,34,,23,28,51
057 Natz-Schabs,35,,27,25,52
057 Natz-Schabs,36,,22,23,45
057 Natz-Schabs,37,,27,25,52
057 Natz-Schabs,38,,31,27,58
057 Natz-Schabs,39,,31,24,55
057 Natz-Schabs,40,,33,19,52
057 Natz-Schabs,41,,29,23,52
057 Natz-Schabs,42,,33,21,54
057 Natz-Schabs,43,,37,33,70
057 Natz-Schabs,44,,30,29,59
057 Natz-Schabs,45,,30,27,57
057 Natz-Schabs,46,,18,23,41
057 Natz-Schabs,47,,18,18,36
057 Natz-Schabs,48,,31,22,53
057 Natz-Schabs,49,,21,22,43
057 Natz-Schabs,50,,21,18,39
057 Natz-Schabs,51,,20,22,42
057 Natz-Schabs,52,,15,23,38
057 Natz-Schabs,53,,20,18,38
057 Natz-Schabs,54,,11,15,26
057 Natz-Schabs,55,,22,14,36
057 Natz-Schabs,56,,12,10,22
057 Natz-Schabs,57,,15,12,27
057 Natz-Schabs,58,,16,14,30
057 Natz-Schabs,59,,19,15,34
057 Natz-Schabs,60,,14,13,27
057 Natz-Schabs,61,,14,12,26
057 Natz-Schabs,62,,15,11,26
057 Natz-Schabs,63,,11,6,17
057 Natz-Schabs,64,,14,12,26
057 Natz-Schabs,65,,11,7,18
057 Natz-Schabs,66,,12,7,19
057 Natz-Schabs,67,,13,8,21
057 Natz-Schabs,68,,4,6,10
057 Natz-Schabs,69,,2,5,7
057 Natz-Schabs,70,,7,5,12
057 Natz-Schabs,71,,10,6,16
057 Natz-Schabs,72,,6,3,9
057 Natz-Schabs,73,,6,7,13
057 Natz-Schabs,74,,3,4,7
057 Natz-Schabs,75,,6,9,15
057 Natz-Schabs,76,,4,7,11
057 Natz-Schabs,77,,4,4,8
057 Natz-Schabs,78,,4,7,11
057 Natz-Schabs,79,,8,3,11
057 Natz-Schabs,80,,3,6,9
057 Natz-Schabs,81,,1,4,5
057 Natz-Schabs,82,,2,6,8
057 Natz-Schabs,83,,2,1,3
057 Natz-Schabs,84,,1,5,6
057 Natz-Schabs,85,,-,8,8
057 Natz-Schabs,86,,4,3,7
057 Natz-Schabs,87,,3,3,6
057 Natz-Schabs,88,,2,5,7
057 Natz-Schabs,89,,-,2,2
057 Natz-Schabs,90,,-,2,2
057 Natz-Schabs,91,,-,1,1
057 Natz-Schabs,93,,-,1,1
057 Natz-Schabs,96,,-,1,1
057 Natz-Schabs,99,,1,-,1
057 Natz-Schabs,100,,-,1,1
057 Natz-Schabs,Insgesamt,,1.451,1.387,2.838
058 Welschnofen,0,,10,7,17
058 Welschnofen,1,,7,8,15
058 Welschnofen,2,,8,7,15
058 Welschnofen,3,,9,12,21
058 Welschnofen,4,,15,6,21
058 Welschnofen,5,,8,8,16
058 Welschnofen,6,,18,5,23
058 Welschnofen,7,,6,9,15
058 Welschnofen,8,,8,7,15
058 Welschnofen,9,,10,14,24
058 Welschnofen,10,,14,11,25
058 Welschnofen,11,,14,15,29
058 Welschnofen,12,,10,10,20
058 Welschnofen,13,,14,14,28
058 Welschnofen,14,,12,10,22
058 Welschnofen,15,,12,11,23
058 Welschnofen,16,,18,10,28
058 Welschnofen,17,,16,11,27
058 Welschnofen,18,,11,15,26
058 Welschnofen,19,,12,8,20
058 Welschnofen,20,,11,14,25
058 Welschnofen,21,,10,9,19
058 Welschnofen,22,,8,8,16
058 Welschnofen,23,,11,10,21
058 Welschnofen,24,,7,7,14
058 Welschnofen,25,,11,15,26
058 Welschnofen,26,,11,14,25
058 Welschnofen,27,,14,14,28
058 Welschnofen,28,,12,9,21
058 Welschnofen,29,,10,4,14
058 Welschnofen,30,,13,12,25
058 Welschnofen,31,,14,14,28
058 Welschnofen,32,,17,10,27
058 Welschnofen,33,,18,13,31
058 Welschnofen,34,,15,14,29
058 Welschnofen,35,,16,16,32
058 Welschnofen,36,,13,15,28
058 Welschnofen,37,,16,18,34
058 Welschnofen,38,,19,14,33
058 Welschnofen,39,,17,16,33
058 Welschnofen,40,,17,18,35
058 Welschnofen,41,,16,15,31
058 Welschnofen,42,,16,12,28
058 Welschnofen,43,,24,13,37
058 Welschnofen,44,,13,8,21
058 Welschnofen,45,,19,14,33
058 Welschnofen,46,,14,15,29
058 Welschnofen,47,,16,19,35
058 Welschnofen,48,,18,9,27
058 Welschnofen,49,,15,12,27
058 Welschnofen,50,,15,10,25
058 Welschnofen,51,,10,16,26
058 Welschnofen,52,,10,12,22
058 Welschnofen,53,,16,13,29
058 Welschnofen,54,,14,11,25
058 Welschnofen,55,,11,12,23
058 Welschnofen,56,,11,8,19
058 Welschnofen,57,,15,7,22
058 Welschnofen,58,,8,8,16
058 Welschnofen,59,,11,14,25
058 Welschnofen,60,,9,9,18
058 Welschnofen,61,,9,7,16
058 Welschnofen,62,,11,10,21
058 Welschnofen,63,,10,5,15
058 Welschnofen,64,,7,9,16
058 Welschnofen,65,,13,9,22
058 Welschnofen,66,,10,12,22
058 Welschnofen,67,,10,7,17
058 Welschnofen,68,,7,8,15
058 Welschnofen,69,,8,6,14
058 Welschnofen,70,,6,6,12
058 Welschnofen,71,,8,4,12
058 Welschnofen,72,,5,12,17
058 Welschnofen,73,,8,6,14
058 Welschnofen,74,,10,11,21
058 Welschnofen,75,,8,14,22
058 Welschnofen,76,,7,7,14
058 Welschnofen,77,,3,7,10
058 Welschnofen,78,,5,8,13
058 Welschnofen,79,,4,12,16
058 Welschnofen,80,,7,4,11
058 Welschnofen,81,,2,3,5
058 Welschnofen,82,,2,6,8
058 Welschnofen,83,,4,6,10
058 Welschnofen,84,,2,11,13
058 Welschnofen,85,,3,6,9
058 Welschnofen,86,,4,5,9
058 Welschnofen,87,,-,8,8
058 Welschnofen,88,,1,3,4
058 Welschnofen,89,,1,5,6
058 Welschnofen,90,,1,-,1
058 Welschnofen,91,,1,-,1
058 Welschnofen,92,,1,2,3
058 Welschnofen,93,,-,3,3
058 Welschnofen,94,,-,1,1
058 Welschnofen,95,,-,1,1
058 Welschnofen,96,,-,2,2
058 Welschnofen,97,,1,-,1
058 Welschnofen,98,,1,1,2
058 Welschnofen,99,,-,1,1
058 Welschnofen,Insgesamt,,973,927,1.900
059 Deutschnofen,0,,18,19,37
059 Deutschnofen,1,,17,15,32
059 Deutschnofen,2,,23,25,48
059 Deutschnofen,3,,26,32,58
059 Deutschnofen,4,,22,28,50
059 Deutschnofen,5,,18,32,50
059 Deutschnofen,6,,32,12,44
059 Deutschnofen,7,,22,33,55
059 Deutschnofen,8,,23,26,49
059 Deutschnofen,9,,30,23,53
059 Deutschnofen,10,,32,13,45
059 Deutschnofen,11,,23,29,52
059 Deutschnofen,12,,20,28,48
059 Deutschnofen,13,,26,24,50
059 Deutschnofen,14,,28,14,42
059 Deutschnofen,15,,26,26,52
059 Deutschnofen,16,,35,28,63
059 Deutschnofen,17,,20,21,41
059 Deutschnofen,18,,35,28,63
059 Deutschnofen,19,,24,22,46
059 Deutschnofen,20,,21,34,55
059 Deutschnofen,21,,22,29,51
059 Deutschnofen,22,,30,18,48
059 Deutschnofen,23,,27,20,47
059 Deutschnofen,24,,32,27,59
059 Deutschnofen,25,,25,24,49
059 Deutschnofen,26,,21,37,58
059 Deutschnofen,27,,24,19,43
059 Deutschnofen,28,,29,25,54
059 Deutschnofen,29,,27,26,53
059 Deutschnofen,30,,27,22,49
059 Deutschnofen,31,,36,23,59
059 Deutschnofen,32,,22,22,44
059 Deutschnofen,33,,21,21,42
059 Deutschnofen,34,,30,34,64
059 Deutschnofen,35,,21,28,49
059 Deutschnofen,36,,30,37,67
059 Deutschnofen,37,,27,26,53
059 Deutschnofen,38,,32,29,61
059 Deutschnofen,39,,40,31,71
059 Deutschnofen,40,,24,31,55
059 Deutschnofen,41,,32,30,62
059 Deutschnofen,42,,35,34,69
059 Deutschnofen,43,,38,20,58
059 Deutschnofen,44,,32,28,60
059 Deutschnofen,45,,33,25,58
059 Deutschnofen,46,,25,28,53
059 Deutschnofen,47,,37,20,57
059 Deutschnofen,48,,41,26,67
059 Deutschnofen,49,,30,18,48
059 Deutschnofen,50,,23,30,53
059 Deutschnofen,51,,22,27,49
059 Deutschnofen,52,,31,26,57
059 Deutschnofen,53,,30,22,52
059 Deutschnofen,54,,28,21,49
059 Deutschnofen,55,,23,20,43
059 Deutschnofen,56,,24,20,44
059 Deutschnofen,57,,22,14,36
059 Deutschnofen,58,,17,19,36
059 Deutschnofen,59,,22,14,36
059 Deutschnofen,60,,22,16,38
059 Deutschnofen,61,,13,12,25
059 Deutschnofen,62,,17,22,39
059 Deutschnofen,63,,16,14,30
059 Deutschnofen,64,,16,16,32
059 Deutschnofen,65,,23,21,44
059 Deutschnofen,66,,17,17,34
059 Deutschnofen,67,,18,25,43
059 Deutschnofen,68,,14,18,32
059 Deutschnofen,69,,24,15,39
059 Deutschnofen,70,,15,19,34
059 Deutschnofen,71,,12,7,19
059 Deutschnofen,72,,14,10,24
059 Deutschnofen,73,,8,11,19
059 Deutschnofen,74,,16,9,25
059 Deutschnofen,75,,7,13,20
059 Deutschnofen,76,,13,13,26
059 Deutschnofen,77,,8,9,17
059 Deutschnofen,78,,9,9,18
059 Deutschnofen,79,,7,9,16
059 Deutschnofen,80,,7,19,26
059 Deutschnofen,81,,6,13,19
059 Deutschnofen,82,,9,9,18
059 Deutschnofen,83,,5,18,23
059 Deutschnofen,84,,3,9,12
059 Deutschnofen,85,,3,7,10
059 Deutschnofen,86,,6,12,18
059 Deutschnofen,87,,3,11,14
059 Deutschnofen,88,,1,4,5
059 Deutschnofen,89,,1,3,4
059 Deutschnofen,90,,-,3,3
059 Deutschnofen,91,,-,2,2
059 Deutschnofen,92,,2,1,3
059 Deutschnofen,93,,2,2,4
059 Deutschnofen,94,,-,2,2
059 Deutschnofen,95,,-,3,3
059 Deutschnofen,96,,-,1,1
059 Deutschnofen,97,,-,3,3
059 Deutschnofen,98,,1,-,1
059 Deutschnofen,Insgesamt,,1.951,1.890,3.841
060 Auer,0,,14,22,36
060 Auer,1,,19,15,34
060 Auer,2,,15,11,26
060 Auer,3,,29,24,53
060 Auer,4,,19,17,36
060 Auer,5,,21,15,36
060 Auer,6,,31,17,48
060 Auer,7,,18,26,44
060 Auer,8,,21,24,45
060 Auer,9,,19,25,44
060 Auer,10,,20,25,45
060 Auer,11,,20,17,37
060 Auer,12,,18,22,40
060 Auer,13,,17,17,34
060 Auer,14,,23,23,46
060 Auer,15,,10,23,33
060 Auer,16,,19,20,39
060 Auer,17,,27,15,42
060 Auer,18,,16,19,35
060 Auer,19,,20,24,44
060 Auer,20,,19,26,45
060 Auer,21,,25,19,44
060 Auer,22,,17,18,35
060 Auer,23,,23,21,44
060 Auer,24,,19,16,35
060 Auer,25,,17,16,33
060 Auer,26,,18,27,45
060 Auer,27,,20,19,39
060 Auer,28,,20,20,40
060 Auer,29,,23,18,41
060 Auer,30,,17,17,34
060 Auer,31,,19,32,51
060 Auer,32,,21,30,51
060 Auer,33,,22,21,43
060 Auer,34,,32,33,65
060 Auer,35,,27,28,55
060 Auer,36,,19,27,46
060 Auer,37,,44,28,72
060 Auer,38,,32,28,60
060 Auer,39,,23,33,56
060 Auer,40,,33,38,71
060 Auer,41,,27,28,55
060 Auer,42,,37,39,76
060 Auer,43,,35,26,61
060 Auer,44,,32,23,55
060 Auer,45,,30,39,69
060 Auer,46,,26,22,48
060 Auer,47,,33,31,64
060 Auer,48,,28,35,63
060 Auer,49,,37,30,67
060 Auer,50,,35,22,57
060 Auer,51,,22,25,47
060 Auer,52,,28,29,57
060 Auer,53,,13,22,35
060 Auer,54,,22,13,35
060 Auer,55,,15,23,38
060 Auer,56,,18,21,39
060 Auer,57,,14,18,32
060 Auer,58,,16,22,38
060 Auer,59,,14,13,27
060 Auer,60,,30,15,45
060 Auer,61,,16,19,35
060 Auer,62,,16,25,41
060 Auer,63,,12,13,25
060 Auer,64,,22,16,38
060 Auer,65,,13,18,31
060 Auer,66,,14,19,33
060 Auer,67,,20,14,34
060 Auer,68,,12,10,22
060 Auer,69,,12,20,32
060 Auer,70,,16,18,34
060 Auer,71,,8,11,19
060 Auer,72,,11,9,20
060 Auer,73,,9,16,25
060 Auer,74,,15,12,27
060 Auer,75,,5,8,13
060 Auer,76,,4,14,18
060 Auer,77,,10,12,22
060 Auer,78,,7,7,14
060 Auer,79,,7,14,21
060 Auer,80,,9,6,15
060 Auer,81,,7,13,20
060 Auer,82,,2,16,18
060 Auer,83,,10,11,21
060 Auer,84,,6,10,16
060 Auer,85,,8,10,18
060 Auer,86,,2,12,14
060 Auer,87,,2,8,10
060 Auer,88,,3,8,11
060 Auer,89,,2,2,4
060 Auer,90,,-,5,5
060 Auer,91,,-,1,1
060 Auer,92,,-,1,1
060 Auer,93,,-,1,1
060 Auer,94,,-,3,3
060 Auer,95,,1,4,5
060 Auer,97,,-,1,1
060 Auer,Insgesamt,,1.679,1.799,3.478
061 St.Ulrich,0,,34,21,55
061 St.Ulrich,1,,28,32,60
061 St.Ulrich,2,,35,26,61
061 St.Ulrich,3,,36,19,55
061 St.Ulrich,4,,24,33,57
061 St.Ulrich,5,,23,32,55
061 St.Ulrich,6,,26,35,61
061 St.Ulrich,7,,21,22,43
061 St.Ulrich,8,,27,33,60
061 St.Ulrich,9,,44,31,75
061 St.Ulrich,10,,44,35,79
061 St.Ulrich,11,,31,27,58
061 St.Ulrich,12,,32,23,55
061 St.Ulrich,13,,31,29,60
061 St.Ulrich,14,,28,28,56
061 St.Ulrich,15,,22,28,50
061 St.Ulrich,16,,34,28,62
061 St.Ulrich,17,,31,30,61
061 St.Ulrich,18,,26,22,48
061 St.Ulrich,19,,18,21,39
061 St.Ulrich,20,,19,22,41
061 St.Ulrich,21,,26,20,46
061 St.Ulrich,22,,20,15,35
061 St.Ulrich,23,,21,20,41
061 St.Ulrich,24,,21,19,40
061 St.Ulrich,25,,20,18,38
061 St.Ulrich,26,,24,30,54
061 St.Ulrich,27,,21,34,55
061 St.Ulrich,28,,25,32,57
061 St.Ulrich,29,,32,29,61
061 St.Ulrich,30,,22,28,50
061 St.Ulrich,31,,21,20,41
061 St.Ulrich,32,,31,34,65
061 St.Ulrich,33,,37,27,64
061 St.Ulrich,34,,36,33,69
061 St.Ulrich,35,,38,29,67
061 St.Ulrich,36,,40,34,74
061 St.Ulrich,37,,37,37,74
061 St.Ulrich,38,,37,31,68
061 St.Ulrich,39,,43,45,88
061 St.Ulrich,40,,41,43,84
061 St.Ulrich,41,,37,38,75
061 St.Ulrich,42,,35,38,73
061 St.Ulrich,43,,35,33,68
061 St.Ulrich,44,,38,41,79
061 St.Ulrich,45,,36,34,70
061 St.Ulrich,46,,28,35,63
061 St.Ulrich,47,,28,23,51
061 St.Ulrich,48,,33,27,60
061 St.Ulrich,49,,38,27,65
061 St.Ulrich,50,,23,17,40
061 St.Ulrich,51,,24,30,54
061 St.Ulrich,52,,18,28,46
061 St.Ulrich,53,,25,36,61
061 St.Ulrich,54,,27,32,59
061 St.Ulrich,55,,28,19,47
061 St.Ulrich,56,,12,29,41
061 St.Ulrich,57,,26,23,49
061 St.Ulrich,58,,19,26,45
061 St.Ulrich,59,,17,29,46
061 St.Ulrich,60,,29,30,59
061 St.Ulrich,61,,22,25,47
061 St.Ulrich,62,,30,25,55
061 St.Ulrich,63,,17,18,35
061 St.Ulrich,64,,28,32,60
061 St.Ulrich,65,,38,37,75
061 St.Ulrich,66,,29,35,64
061 St.Ulrich,67,,36,45,81
061 St.Ulrich,68,,31,28,59
061 St.Ulrich,69,,19,19,38
061 St.Ulrich,70,,23,23,46
061 St.Ulrich,71,,22,26,48
061 St.Ulrich,72,,22,17,39
061 St.Ulrich,73,,13,26,39
061 St.Ulrich,74,,17,12,29
061 St.Ulrich,75,,14,12,26
061 St.Ulrich,76,,13,21,34
061 St.Ulrich,77,,18,13,31
061 St.Ulrich,78,,20,9,29
061 St.Ulrich,79,,13,4,17
061 St.Ulrich,80,,14,11,25
061 St.Ulrich,81,,14,13,27
061 St.Ulrich,82,,7,12,19
061 St.Ulrich,83,,9,9,18
061 St.Ulrich,84,,5,14,19
061 St.Ulrich,85,,3,14,17
061 St.Ulrich,86,,3,12,15
061 St.Ulrich,87,,6,12,18
061 St.Ulrich,88,,4,11,15
061 St.Ulrich,89,,3,7,10
061 St.Ulrich,90,,1,6,7
061 St.Ulrich,91,,-,3,3
061 St.Ulrich,92,,2,1,3
061 St.Ulrich,93,,1,4,5
061 St.Ulrich,94,,1,4,5
061 St.Ulrich,95,,2,5,7
061 St.Ulrich,96,,-,1,1
061 St.Ulrich,97,,-,1,1
061 St.Ulrich,98,,-,1,1
061 St.Ulrich,100,,1,-,1
061 St.Ulrich,Insgesamt,,2.264,2.318,4.582
062 Partschins,0,,22,10,32
062 Partschins,1,,16,16,32
062 Partschins,2,,17,17,34
062 Partschins,3,,17,24,41
062 Partschins,4,,12,22,34
062 Partschins,5,,24,20,44
062 Partschins,6,,27,20,47
062 Partschins,7,,16,16,32
062 Partschins,8,,20,16,36
062 Partschins,9,,14,17,31
062 Partschins,10,,19,13,32
062 Partschins,11,,22,22,44
062 Partschins,12,,14,18,32
062 Partschins,13,,24,17,41
062 Partschins,14,,21,20,41
062 Partschins,15,,24,19,43
062 Partschins,16,,25,16,41
062 Partschins,17,,24,28,52
062 Partschins,18,,24,23,47
062 Partschins,19,,10,24,34
062 Partschins,20,,17,29,46
062 Partschins,21,,17,14,31
062 Partschins,22,,23,19,42
062 Partschins,23,,13,13,26
062 Partschins,24,,21,24,45
062 Partschins,25,,16,24,40
062 Partschins,26,,16,25,41
062 Partschins,27,,20,27,47
062 Partschins,28,,27,26,53
062 Partschins,29,,20,21,41
062 Partschins,30,,21,16,37
062 Partschins,31,,24,21,45
062 Partschins,32,,23,20,43
062 Partschins,33,,28,20,48
062 Partschins,34,,27,20,47
062 Partschins,35,,29,24,53
062 Partschins,36,,27,27,54
062 Partschins,37,,27,31,58
062 Partschins,38,,21,34,55
062 Partschins,39,,39,26,65
062 Partschins,40,,23,33,56
062 Partschins,41,,34,24,58
062 Partschins,42,,37,35,72
062 Partschins,43,,27,28,55
062 Partschins,44,,30,37,67
062 Partschins,45,,36,24,60
062 Partschins,46,,32,26,58
062 Partschins,47,,21,24,45
062 Partschins,48,,26,37,63
062 Partschins,49,,26,21,47
062 Partschins,50,,20,19,39
062 Partschins,51,,26,25,51
062 Partschins,52,,23,21,44
062 Partschins,53,,27,24,51
062 Partschins,54,,12,27,39
062 Partschins,55,,22,17,39
062 Partschins,56,,16,15,31
062 Partschins,57,,19,16,35
062 Partschins,58,,19,21,40
062 Partschins,59,,10,13,23
062 Partschins,60,,19,17,36
062 Partschins,61,,15,18,33
062 Partschins,62,,25,27,52
062 Partschins,63,,13,17,30
062 Partschins,64,,18,16,34
062 Partschins,65,,23,26,49
062 Partschins,66,,14,17,31
062 Partschins,67,,21,29,50
062 Partschins,68,,13,13,26
062 Partschins,69,,12,14,26
062 Partschins,70,,17,14,31
062 Partschins,71,,14,16,30
062 Partschins,72,,13,16,29
062 Partschins,73,,9,11,20
062 Partschins,74,,9,17,26
062 Partschins,75,,11,16,27
062 Partschins,76,,13,10,23
062 Partschins,77,,13,20,33
062 Partschins,78,,9,8,17
062 Partschins,79,,12,8,20
062 Partschins,80,,9,10,19
062 Partschins,81,,10,10,20
062 Partschins,82,,7,8,15
062 Partschins,83,,4,9,13
062 Partschins,84,,3,11,14
062 Partschins,85,,5,7,12
062 Partschins,86,,4,5,9
062 Partschins,87,,10,7,17
062 Partschins,88,,-,4,4
062 Partschins,89,,2,5,7
062 Partschins,90,,1,-,1
062 Partschins,91,,-,2,2
062 Partschins,92,,-,3,3
062 Partschins,93,,-,1,1
062 Partschins,94,,-,2,2
062 Partschins,95,,-,1,1
062 Partschins,Insgesamt,,1.682,1.741,3.423
063 Percha,0,,10,5,15
063 Percha,1,,10,6,16
063 Percha,2,,4,3,7
063 Percha,3,,5,12,17
063 Percha,4,,9,15,24
063 Percha,5,,8,6,14
063 Percha,6,,10,6,16
063 Percha,7,,4,5,9
063 Percha,8,,10,9,19
063 Percha,9,,5,9,14
063 Percha,10,,8,8,16
063 Percha,11,,12,15,27
063 Percha,12,,9,4,13
063 Percha,13,,9,8,17
063 Percha,14,,9,12,21
063 Percha,15,,7,8,15
063 Percha,16,,12,6,18
063 Percha,17,,10,10,20
063 Percha,18,,8,7,15
063 Percha,19,,6,9,15
063 Percha,20,,6,5,11
063 Percha,21,,9,18,27
063 Percha,22,,6,7,13
063 Percha,23,,7,13,20
063 Percha,24,,15,6,21
063 Percha,25,,13,8,21
063 Percha,26,,7,11,18
063 Percha,27,,8,7,15
063 Percha,28,,12,6,18
063 Percha,29,,4,13,17
063 Percha,30,,13,15,28
063 Percha,31,,9,6,15
063 Percha,32,,15,15,30
063 Percha,33,,10,10,20
063 Percha,34,,9,13,22
063 Percha,35,,13,9,22
063 Percha,36,,13,9,22
063 Percha,37,,17,16,33
063 Percha,38,,8,10,18
063 Percha,39,,19,15,34
063 Percha,40,,17,14,31
063 Percha,41,,9,9,18
063 Percha,42,,17,6,23
063 Percha,43,,14,21,35
063 Percha,44,,15,7,22
063 Percha,45,,11,15,26
063 Percha,46,,15,10,25
063 Percha,47,,9,11,20
063 Percha,48,,11,6,17
063 Percha,49,,6,10,16
063 Percha,50,,9,10,19
063 Percha,51,,10,6,16
063 Percha,52,,7,12,19
063 Percha,53,,9,9,18
063 Percha,54,,4,4,8
063 Percha,55,,8,6,14
063 Percha,56,,5,9,14
063 Percha,57,,7,8,15
063 Percha,58,,6,8,14
063 Percha,59,,9,6,15
063 Percha,60,,4,4,8
063 Percha,61,,5,7,12
063 Percha,62,,6,8,14
063 Percha,63,,8,5,13
063 Percha,64,,12,4,16
063 Percha,65,,8,8,16
063 Percha,66,,8,7,15
063 Percha,67,,7,7,14
063 Percha,68,,5,5,10
063 Percha,69,,6,5,11
063 Percha,70,,5,9,14
063 Percha,71,,2,5,7
063 Percha,72,,3,2,5
063 Percha,73,,4,4,8
063 Percha,74,,8,5,13
063 Percha,75,,4,5,9
063 Percha,76,,5,3,8
063 Percha,77,,5,1,6
063 Percha,78,,9,3,12
063 Percha,79,,1,4,5
063 Percha,80,,2,3,5
063 Percha,81,,4,2,6
063 Percha,82,,2,5,7
063 Percha,83,,2,5,7
063 Percha,84,,-,1,1
063 Percha,85,,1,3,4
063 Percha,86,,1,-,1
063 Percha,87,,-,2,2
063 Percha,88,,-,2,2
063 Percha,94,,-,1,1
063 Percha,Insgesamt,,703,687,1.390
064 Plaus,0,,4,4,8
064 Plaus,1,,4,4,8
064 Plaus,2,,4,1,5
064 Plaus,3,,5,2,7
064 Plaus,4,,6,4,10
064 Plaus,5,,3,3,6
064 Plaus,6,,4,6,10
064 Plaus,7,,8,5,13
064 Plaus,8,,10,4,14
064 Plaus,9,,12,5,17
064 Plaus,10,,6,7,13
064 Plaus,11,,7,5,12
064 Plaus,12,,4,2,6
064 Plaus,13,,2,2,4
064 Plaus,14,,5,1,6
064 Plaus,15,,9,4,13
064 Plaus,16,,6,6,12
064 Plaus,17,,3,9,12
064 Plaus,18,,4,2,6
064 Plaus,19,,5,6,11
064 Plaus,20,,4,2,6
064 Plaus,21,,5,2,7
064 Plaus,22,,1,4,5
064 Plaus,23,,1,4,5
064 Plaus,24,,4,1,5
064 Plaus,25,,2,6,8
064 Plaus,26,,1,4,5
064 Plaus,27,,2,6,8
064 Plaus,28,,6,4,10
064 Plaus,29,,3,4,7
064 Plaus,30,,5,4,9
064 Plaus,31,,2,8,10
064 Plaus,32,,5,2,7
064 Plaus,33,,11,3,14
064 Plaus,34,,6,9,15
064 Plaus,35,,12,5,17
064 Plaus,36,,7,8,15
064 Plaus,37,,6,8,14
064 Plaus,38,,9,4,13
064 Plaus,39,,7,9,16
064 Plaus,40,,4,8,12
064 Plaus,41,,7,9,16
064 Plaus,42,,5,5,10
064 Plaus,43,,13,2,15
064 Plaus,44,,6,9,15
064 Plaus,45,,3,4,7
064 Plaus,46,,9,5,14
064 Plaus,47,,7,2,9
064 Plaus,48,,2,6,8
064 Plaus,49,,7,2,9
064 Plaus,50,,3,3,6
064 Plaus,51,,1,3,4
064 Plaus,52,,1,2,3
064 Plaus,53,,3,5,8
064 Plaus,54,,1,1,2
064 Plaus,55,,3,5,8
064 Plaus,56,,4,2,6
064 Plaus,57,,5,3,8
064 Plaus,58,,2,2,4
064 Plaus,59,,5,3,8
064 Plaus,60,,-,4,4
064 Plaus,61,,2,4,6
064 Plaus,62,,5,2,7
064 Plaus,63,,4,1,5
064 Plaus,64,,2,3,5
064 Plaus,65,,5,1,6
064 Plaus,66,,1,4,5
064 Plaus,67,,3,2,5
064 Plaus,68,,3,1,4
064 Plaus,69,,3,2,5
064 Plaus,70,,1,1,2
064 Plaus,71,,3,2,5
064 Plaus,72,,-,2,2
064 Plaus,73,,2,2,4
064 Plaus,74,,4,1,5
064 Plaus,75,,2,3,5
064 Plaus,76,,2,3,5
064 Plaus,77,,1,1,2
064 Plaus,79,,1,1,2
064 Plaus,80,,-,1,1
064 Plaus,81,,1,1,2
064 Plaus,82,,1,1,2
064 Plaus,83,,1,-,1
064 Plaus,84,,-,3,3
064 Plaus,85,,-,1,1
064 Plaus,87,,-,1,1
064 Plaus,89,,-,2,2
064 Plaus,90,,-,1,1
064 Plaus,93,,-,1,1
064 Plaus,Insgesamt,,348,312,660
065 Waidbruck,1,,1,-,1
065 Waidbruck,2,,2,-,2
065 Waidbruck,4,,1,-,1
065 Waidbruck,5,,-,2,2
065 Waidbruck,6,,-,1,1
065 Waidbruck,7,,1,-,1
065 Waidbruck,8,,1,2,3
065 Waidbruck,9,,2,1,3
065 Waidbruck,11,,4,3,7
065 Waidbruck,12,,2,1,3
065 Waidbruck,13,,1,2,3
065 Waidbruck,14,,3,1,4
065 Waidbruck,15,,1,1,2
065 Waidbruck,16,,-,2,2
065 Waidbruck,17,,1,-,1
065 Waidbruck,18,,1,1,2
065 Waidbruck,19,,2,1,3
065 Waidbruck,20,,-,1,1
065 Waidbruck,21,,1,-,1
065 Waidbruck,23,,1,2,3
065 Waidbruck,24,,3,1,4
065 Waidbruck,25,,2,-,2
065 Waidbruck,26,,1,-,1
065 Waidbruck,27,,3,2,5
065 Waidbruck,28,,1,1,2
065 Waidbruck,30,,4,-,4
065 Waidbruck,31,,-,1,1
065 Waidbruck,33,,-,1,1
065 Waidbruck,34,,4,2,6
065 Waidbruck,35,,-,1,1
065 Waidbruck,36,,1,1,2
065 Waidbruck,37,,2,-,2
065 Waidbruck,38,,-,1,1
065 Waidbruck,39,,3,1,4
065 Waidbruck,40,,3,1,4
065 Waidbruck,41,,1,4,5
065 Waidbruck,42,,3,3,6
065 Waidbruck,43,,2,2,4
065 Waidbruck,44,,4,-,4
065 Waidbruck,45,,1,1,2
065 Waidbruck,47,,1,1,2
065 Waidbruck,48,,4,1,5
065 Waidbruck,49,,3,1,4
065 Waidbruck,50,,-,1,1
065 Waidbruck,51,,3,1,4
065 Waidbruck,52,,2,-,2
065 Waidbruck,53,,2,-,2
065 Waidbruck,56,,1,1,2
065 Waidbruck,57,,-,1,1
065 Waidbruck,62,,-,3,3
065 Waidbruck,63,,1,1,2
065 Waidbruck,64,,2,1,3
065 Waidbruck,66,,1,1,2
065 Waidbruck,67,,-,2,2
065 Waidbruck,68,,-,3,3
065 Waidbruck,69,,1,-,1
065 Waidbruck,70,,-,2,2
065 Waidbruck,71,,1,1,2
065 Waidbruck,72,,2,1,3
065 Waidbruck,73,,-,3,3
065 Waidbruck,74,,2,1,3
065 Waidbruck,75,,1,-,1
065 Waidbruck,76,,-,3,3
065 Waidbruck,77,,1,-,1
065 Waidbruck,78,,1,-,1
065 Waidbruck,79,,-,2,2
065 Waidbruck,80,,1,1,2
065 Waidbruck,81,,2,1,3
065 Waidbruck,82,,-,1,1
065 Waidbruck,83,,1,1,2
065 Waidbruck,85,,-,2,2
065 Waidbruck,88,,-,1,1
065 Waidbruck,89,,-,2,2
065 Waidbruck,94,,-,1,1
065 Waidbruck,Insgesamt,,96,85,181
066 Burgstall,0,,10,14,24
066 Burgstall,1,,14,5,19
066 Burgstall,2,,9,12,21
066 Burgstall,3,,7,9,16
066 Burgstall,4,,13,6,19
066 Burgstall,5,,8,10,18
066 Burgstall,6,,8,12,20
066 Burgstall,7,,10,8,18
066 Burgstall,8,,13,12,25
066 Burgstall,9,,9,9,18
066 Burgstall,10,,10,10,20
066 Burgstall,11,,8,6,14
066 Burgstall,12,,7,7,14
066 Burgstall,13,,10,7,17
066 Burgstall,14,,6,4,10
066 Burgstall,15,,7,10,17
066 Burgstall,16,,4,5,9
066 Burgstall,17,,6,10,16
066 Burgstall,18,,14,9,23
066 Burgstall,19,,11,5,16
066 Burgstall,20,,7,9,16
066 Burgstall,21,,8,10,18
066 Burgstall,22,,10,4,14
066 Burgstall,23,,8,11,19
066 Burgstall,24,,9,16,25
066 Burgstall,25,,13,13,26
066 Burgstall,26,,10,12,22
066 Burgstall,27,,7,12,19
066 Burgstall,28,,13,10,23
066 Burgstall,29,,12,7,19
066 Burgstall,30,,8,9,17
066 Burgstall,31,,10,18,28
066 Burgstall,32,,9,11,20
066 Burgstall,33,,18,15,33
066 Burgstall,34,,9,12,21
066 Burgstall,35,,14,17,31
066 Burgstall,36,,11,21,32
066 Burgstall,37,,17,15,32
066 Burgstall,38,,19,15,34
066 Burgstall,39,,17,12,29
066 Burgstall,40,,19,16,35
066 Burgstall,41,,10,16,26
066 Burgstall,42,,14,18,32
066 Burgstall,43,,20,18,38
066 Burgstall,44,,15,12,27
066 Burgstall,45,,17,16,33
066 Burgstall,46,,16,11,27
066 Burgstall,47,,11,19,30
066 Burgstall,48,,17,12,29
066 Burgstall,49,,10,9,19
066 Burgstall,50,,16,9,25
066 Burgstall,51,,9,8,17
066 Burgstall,52,,12,9,21
066 Burgstall,53,,8,11,19
066 Burgstall,54,,9,16,25
066 Burgstall,55,,10,11,21
066 Burgstall,56,,12,14,26
066 Burgstall,57,,13,7,20
066 Burgstall,58,,11,11,22
066 Burgstall,59,,10,7,17
066 Burgstall,60,,9,11,20
066 Burgstall,61,,7,10,17
066 Burgstall,62,,13,8,21
066 Burgstall,63,,7,9,16
066 Burgstall,64,,8,10,18
066 Burgstall,65,,11,8,19
066 Burgstall,66,,5,5,10
066 Burgstall,67,,8,4,12
066 Burgstall,68,,5,12,17
066 Burgstall,69,,6,7,13
066 Burgstall,70,,9,14,23
066 Burgstall,71,,5,10,15
066 Burgstall,72,,5,6,11
066 Burgstall,73,,7,3,10
066 Burgstall,74,,6,8,14
066 Burgstall,75,,8,4,12
066 Burgstall,76,,2,7,9
066 Burgstall,77,,6,3,9
066 Burgstall,78,,5,6,11
066 Burgstall,79,,1,4,5
066 Burgstall,80,,3,6,9
066 Burgstall,81,,1,11,12
066 Burgstall,82,,4,7,11
066 Burgstall,83,,4,5,9
066 Burgstall,84,,1,5,6
066 Burgstall,85,,4,2,6
066 Burgstall,86,,1,5,6
066 Burgstall,88,,1,1,2
066 Burgstall,89,,-,1,1
066 Burgstall,90,,-,1,1
066 Burgstall,91,,1,-,1
066 Burgstall,92,,-,2,2
066 Burgstall,93,,1,1,2
066 Burgstall,Insgesamt,,826,865,1.691
067 Prad am Stilfser Joch,0,,14,15,29
067 Prad am Stilfser Joch,1,,15,13,28
067 Prad am Stilfser Joch,2,,17,19,36
067 Prad am Stilfser Joch,3,,22,15,37
067 Prad am Stilfser Joch,4,,20,20,40
067 Prad am Stilfser Joch,5,,14,14,28
067 Prad am Stilfser Joch,6,,11,17,28
067 Prad am Stilfser Joch,7,,24,16,40
067 Prad am Stilfser Joch,8,,17,18,35
067 Prad am Stilfser Joch,9,,19,20,39
067 Prad am Stilfser Joch,10,,22,22,44
067 Prad am Stilfser Joch,11,,27,17,44
067 Prad am Stilfser Joch,12,,22,21,43
067 Prad am Stilfser Joch,13,,21,13,34
067 Prad am Stilfser Joch,14,,23,30,53
067 Prad am Stilfser Joch,15,,22,28,50
067 Prad am Stilfser Joch,16,,18,20,38
067 Prad am Stilfser Joch,17,,21,11,32
067 Prad am Stilfser Joch,18,,21,21,42
067 Prad am Stilfser Joch,19,,20,24,44
067 Prad am Stilfser Joch,20,,28,18,46
067 Prad am Stilfser Joch,21,,12,19,31
067 Prad am Stilfser Joch,22,,27,28,55
067 Prad am Stilfser Joch,23,,29,24,53
067 Prad am Stilfser Joch,24,,31,25,56
067 Prad am Stilfser Joch,25,,28,28,56
067 Prad am Stilfser Joch,26,,26,25,51
067 Prad am Stilfser Joch,27,,25,25,50
067 Prad am Stilfser Joch,28,,27,21,48
067 Prad am Stilfser Joch,29,,18,19,37
067 Prad am Stilfser Joch,30,,22,20,42
067 Prad am Stilfser Joch,31,,21,33,54
067 Prad am Stilfser Joch,32,,25,21,46
067 Prad am Stilfser Joch,33,,20,19,39
067 Prad am Stilfser Joch,34,,32,17,49
067 Prad am Stilfser Joch,35,,22,44,66
067 Prad am Stilfser Joch,36,,26,25,51
067 Prad am Stilfser Joch,37,,27,26,53
067 Prad am Stilfser Joch,38,,27,23,50
067 Prad am Stilfser Joch,39,,29,27,56
067 Prad am Stilfser Joch,40,,30,34,64
067 Prad am Stilfser Joch,41,,26,24,50
067 Prad am Stilfser Joch,42,,36,27,63
067 Prad am Stilfser Joch,43,,34,26,60
067 Prad am Stilfser Joch,44,,26,27,53
067 Prad am Stilfser Joch,45,,27,11,38
067 Prad am Stilfser Joch,46,,28,32,60
067 Prad am Stilfser Joch,47,,22,27,49
067 Prad am Stilfser Joch,48,,18,24,42
067 Prad am Stilfser Joch,49,,34,15,49
067 Prad am Stilfser Joch,50,,18,28,46
067 Prad am Stilfser Joch,51,,26,26,52
067 Prad am Stilfser Joch,52,,24,24,48
067 Prad am Stilfser Joch,53,,24,18,42
067 Prad am Stilfser Joch,54,,28,17,45
067 Prad am Stilfser Joch,55,,26,18,44
067 Prad am Stilfser Joch,56,,15,20,35
067 Prad am Stilfser Joch,57,,18,22,40
067 Prad am Stilfser Joch,58,,19,17,36
067 Prad am Stilfser Joch,59,,21,20,41
067 Prad am Stilfser Joch,60,,19,11,30
067 Prad am Stilfser Joch,61,,15,12,27
067 Prad am Stilfser Joch,62,,17,14,31
067 Prad am Stilfser Joch,63,,15,11,26
067 Prad am Stilfser Joch,64,,10,15,25
067 Prad am Stilfser Joch,65,,23,16,39
067 Prad am Stilfser Joch,66,,15,16,31
067 Prad am Stilfser Joch,67,,24,9,33
067 Prad am Stilfser Joch,68,,7,17,24
067 Prad am Stilfser Joch,69,,13,14,27
067 Prad am Stilfser Joch,70,,16,15,31
067 Prad am Stilfser Joch,71,,8,11,19
067 Prad am Stilfser Joch,72,,9,10,19
067 Prad am Stilfser Joch,73,,15,12,27
067 Prad am Stilfser Joch,74,,7,22,29
067 Prad am Stilfser Joch,75,,12,10,22
067 Prad am Stilfser Joch,76,,9,18,27
067 Prad am Stilfser Joch,77,,6,14,20
067 Prad am Stilfser Joch,78,,11,11,22
067 Prad am Stilfser Joch,79,,9,13,22
067 Prad am Stilfser Joch,80,,6,9,15
067 Prad am Stilfser Joch,81,,5,11,16
067 Prad am Stilfser Joch,82,,6,9,15
067 Prad am Stilfser Joch,83,,7,5,12
067 Prad am Stilfser Joch,84,,2,7,9
067 Prad am Stilfser Joch,85,,2,9,11
067 Prad am Stilfser Joch,86,,2,9,11
067 Prad am Stilfser Joch,87,,3,6,9
067 Prad am Stilfser Joch,88,,2,5,7
067 Prad am Stilfser Joch,89,,3,2,5
067 Prad am Stilfser Joch,90,,-,2,2
067 Prad am Stilfser Joch,91,,-,2,2
067 Prad am Stilfser Joch,92,,-,1,1
067 Prad am Stilfser Joch,93,,1,-,1
067 Prad am Stilfser Joch,94,,-,1,1
067 Prad am Stilfser Joch,96,,2,-,2
067 Prad am Stilfser Joch,Insgesamt,,1.693,1.667,3.360
068 Prettau,0,,6,3,9
068 Prettau,1,,6,2,8
068 Prettau,2,,6,5,11
068 Prettau,3,,2,1,3
068 Prettau,4,,4,5,9
068 Prettau,5,,2,4,6
068 Prettau,6,,1,2,3
068 Prettau,7,,3,5,8
068 Prettau,8,,1,4,5
068 Prettau,9,,6,6,12
068 Prettau,10,,6,4,10
068 Prettau,11,,1,5,6
068 Prettau,12,,1,2,3
068 Prettau,13,,4,4,8
068 Prettau,14,,4,7,11
068 Prettau,15,,3,5,8
068 Prettau,16,,2,3,5
068 Prettau,17,,1,4,5
068 Prettau,18,,1,7,8
068 Prettau,19,,-,3,3
068 Prettau,20,,4,3,7
068 Prettau,21,,5,2,7
068 Prettau,22,,1,2,3
068 Prettau,23,,2,1,3
068 Prettau,24,,3,6,9
068 Prettau,25,,4,2,6
068 Prettau,26,,3,2,5
068 Prettau,27,,2,1,3
068 Prettau,28,,4,4,8
068 Prettau,29,,6,3,9
068 Prettau,30,,1,2,3
068 Prettau,31,,4,2,6
068 Prettau,32,,1,2,3
068 Prettau,33,,4,2,6
068 Prettau,34,,5,-,5
068 Prettau,35,,5,6,11
068 Prettau,36,,9,4,13
068 Prettau,37,,4,6,10
068 Prettau,38,,3,6,9
068 Prettau,39,,6,6,12
068 Prettau,40,,3,2,5
068 Prettau,41,,10,3,13
068 Prettau,42,,7,1,8
068 Prettau,43,,5,8,13
068 Prettau,44,,8,6,14
068 Prettau,45,,5,6,11
068 Prettau,46,,2,5,7
068 Prettau,47,,5,5,10
068 Prettau,48,,7,4,11
068 Prettau,49,,5,2,7
068 Prettau,50,,7,-,7
068 Prettau,51,,4,1,5
068 Prettau,52,,6,5,11
068 Prettau,53,,6,5,11
068 Prettau,54,,5,2,7
068 Prettau,55,,3,3,6
068 Prettau,56,,4,3,7
068 Prettau,57,,3,2,5
068 Prettau,58,,2,2,4
068 Prettau,59,,2,3,5
068 Prettau,60,,2,1,3
068 Prettau,61,,4,5,9
068 Prettau,62,,7,4,11
068 Prettau,63,,1,3,4
068 Prettau,64,,6,5,11
068 Prettau,65,,3,2,5
068 Prettau,66,,3,2,5
068 Prettau,67,,3,2,5
068 Prettau,68,,4,5,9
068 Prettau,69,,4,3,7
068 Prettau,70,,5,6,11
068 Prettau,71,,2,6,8
068 Prettau,72,,3,3,6
068 Prettau,73,,3,2,5
068 Prettau,74,,1,3,4
068 Prettau,75,,3,3,6
068 Prettau,76,,3,-,3
068 Prettau,77,,1,1,2
068 Prettau,78,,4,4,8
068 Prettau,79,,4,5,9
068 Prettau,80,,-,1,1
068 Prettau,81,,3,1,4
068 Prettau,82,,1,5,6
068 Prettau,83,,-,1,1
068 Prettau,84,,1,-,1
068 Prettau,85,,-,1,1
068 Prettau,86,,2,-,2
068 Prettau,87,,-,1,1
068 Prettau,88,,1,-,1
068 Prettau,89,,2,-,2
068 Prettau,90,,1,1,2
068 Prettau,92,,-,2,2
068 Prettau,95,,-,1,1
068 Prettau,Insgesamt,,312,290,602
069 Proveis,0,,1,1,2
069 Proveis,1,,1,1,2
069 Proveis,2,,1,-,1
069 Proveis,3,,-,3,3
069 Proveis,4,,2,2,4
069 Proveis,5,,1,1,2
069 Proveis,6,,4,-,4
069 Proveis,7,,1,1,2
069 Proveis,8,,-,1,1
069 Proveis,9,,4,-,4
069 Proveis,10,,2,2,4
069 Proveis,11,,1,2,3
069 Proveis,12,,1,1,2
069 Proveis,13,,-,5,5
069 Proveis,14,,2,-,2
069 Proveis,15,,2,1,3
069 Proveis,16,,3,1,4
069 Proveis,17,,3,2,5
069 Proveis,18,,-,1,1
069 Proveis,19,,1,1,2
069 Proveis,20,,2,3,5
069 Proveis,21,,2,2,4
069 Proveis,22,,3,1,4
069 Proveis,23,,5,-,5
069 Proveis,24,,4,4,8
069 Proveis,25,,3,3,6
069 Proveis,26,,3,-,3
069 Proveis,27,,3,3,6
069 Proveis,29,,3,1,4
069 Proveis,30,,1,1,2
069 Proveis,31,,2,2,4
069 Proveis,32,,1,2,3
069 Proveis,33,,2,-,2
069 Proveis,34,,3,2,5
069 Proveis,35,,2,-,2
069 Proveis,36,,1,1,2
069 Proveis,37,,-,1,1
069 Proveis,38,,3,2,5
069 Proveis,39,,3,4,7
069 Proveis,40,,3,1,4
069 Proveis,41,,2,2,4
069 Proveis,42,,2,2,4
069 Proveis,43,,1,1,2
069 Proveis,44,,3,-,3
069 Proveis,45,,4,2,6
069 Proveis,46,,4,2,6
069 Proveis,47,,3,1,4
069 Proveis,48,,-,4,4
069 Proveis,49,,4,-,4
069 Proveis,50,,1,3,4
069 Proveis,51,,2,2,4
069 Proveis,52,,4,2,6
069 Proveis,53,,4,4,8
069 Proveis,54,,3,2,5
069 Proveis,55,,1,1,2
069 Proveis,56,,2,3,5
069 Proveis,57,,2,-,2
069 Proveis,58,,1,1,2
069 Proveis,59,,1,-,1
069 Proveis,60,,2,1,3
069 Proveis,61,,2,2,4
069 Proveis,62,,3,-,3
069 Proveis,63,,1,-,1
069 Proveis,64,,2,-,2
069 Proveis,65,,2,1,3
069 Proveis,66,,1,1,2
069 Proveis,67,,1,1,2
069 Proveis,68,,2,-,2
069 Proveis,69,,1,3,4
069 Proveis,70,,-,2,2
069 Proveis,71,,1,1,2
069 Proveis,72,,2,1,3
069 Proveis,73,,1,1,2
069 Proveis,74,,-,1,1
069 Proveis,75,,-,2,2
069 Proveis,76,,-,1,1
069 Proveis,77,,1,1,2
069 Proveis,79,,2,3,5
069 Proveis,80,,3,1,4
069 Proveis,81,,-,1,1
069 Proveis,83,,-,1,1
069 Proveis,84,,1,-,1
069 Proveis,86,,-,1,1
069 Proveis,87,,-,1,1
069 Proveis,88,,-,1,1
069 Proveis,Insgesamt,,151,119,270
070 Ratschings,0,,19,20,39
070 Ratschings,1,,31,23,54
070 Ratschings,2,,27,26,53
070 Ratschings,3,,25,30,55
070 Ratschings,4,,34,27,61
070 Ratschings,5,,34,24,58
070 Ratschings,6,,16,29,45
070 Ratschings,7,,24,35,59
070 Ratschings,8,,35,25,60
070 Ratschings,9,,28,21,49
070 Ratschings,10,,33,21,54
070 Ratschings,11,,36,33,69
070 Ratschings,12,,29,33,62
070 Ratschings,13,,29,25,54
070 Ratschings,14,,23,27,50
070 Ratschings,15,,25,21,46
070 Ratschings,16,,40,30,70
070 Ratschings,17,,23,22,45
070 Ratschings,18,,32,26,58
070 Ratschings,19,,25,19,44
070 Ratschings,20,,34,28,62
070 Ratschings,21,,29,29,58
070 Ratschings,22,,29,27,56
070 Ratschings,23,,30,31,61
070 Ratschings,24,,23,20,43
070 Ratschings,25,,32,23,55
070 Ratschings,26,,33,30,63
070 Ratschings,27,,28,28,56
070 Ratschings,28,,26,33,59
070 Ratschings,29,,33,28,61
070 Ratschings,30,,33,22,55
070 Ratschings,31,,33,23,56
070 Ratschings,32,,24,23,47
070 Ratschings,33,,36,34,70
070 Ratschings,34,,37,29,66
070 Ratschings,35,,34,34,68
070 Ratschings,36,,42,36,78
070 Ratschings,37,,42,45,87
070 Ratschings,38,,36,40,76
070 Ratschings,39,,37,43,80
070 Ratschings,40,,49,41,90
070 Ratschings,41,,36,40,76
070 Ratschings,42,,42,47,89
070 Ratschings,43,,36,43,79
070 Ratschings,44,,53,37,90
070 Ratschings,45,,47,27,74
070 Ratschings,46,,34,41,75
070 Ratschings,47,,34,28,62
070 Ratschings,48,,40,25,65
070 Ratschings,49,,39,25,64
070 Ratschings,50,,31,27,58
070 Ratschings,51,,33,19,52
070 Ratschings,52,,36,21,57
070 Ratschings,53,,14,33,47
070 Ratschings,54,,27,15,42
070 Ratschings,55,,21,24,45
070 Ratschings,56,,19,18,37
070 Ratschings,57,,19,14,33
070 Ratschings,58,,25,20,45
070 Ratschings,59,,23,24,47
070 Ratschings,60,,28,19,47
070 Ratschings,61,,17,17,34
070 Ratschings,62,,22,6,28
070 Ratschings,63,,19,18,37
070 Ratschings,64,,16,11,27
070 Ratschings,65,,17,12,29
070 Ratschings,66,,19,18,37
070 Ratschings,67,,19,18,37
070 Ratschings,68,,17,16,33
070 Ratschings,69,,14,16,30
070 Ratschings,70,,14,20,34
070 Ratschings,71,,17,9,26
070 Ratschings,72,,12,10,22
070 Ratschings,73,,12,15,27
070 Ratschings,74,,9,9,18
070 Ratschings,75,,14,18,32
070 Ratschings,76,,13,11,24
070 Ratschings,77,,9,11,20
070 Ratschings,78,,8,16,24
070 Ratschings,79,,8,19,27
070 Ratschings,80,,6,12,18
070 Ratschings,81,,8,10,18
070 Ratschings,82,,9,10,19
070 Ratschings,83,,8,6,14
070 Ratschings,84,,5,10,15
070 Ratschings,85,,3,7,10
070 Ratschings,86,,2,4,6
070 Ratschings,87,,1,7,8
070 Ratschings,88,,2,6,8
070 Ratschings,89,,1,1,2
070 Ratschings,90,,-,4,4
070 Ratschings,93,,-,1,1
070 Ratschings,94,,-,1,1
070 Ratschings,95,,1,-,1
070 Ratschings,Insgesamt,,2.227,2.060,4.287
071 Rasen-Antholz,0,,17,7,24
071 Rasen-Antholz,1,,19,17,36
071 Rasen-Antholz,2,,15,21,36
071 Rasen-Antholz,3,,27,14,41
071 Rasen-Antholz,4,,13,20,33
071 Rasen-Antholz,5,,9,23,32
071 Rasen-Antholz,6,,14,21,35
071 Rasen-Antholz,7,,19,21,40
071 Rasen-Antholz,8,,26,21,47
071 Rasen-Antholz,9,,14,19,33
071 Rasen-Antholz,10,,19,14,33
071 Rasen-Antholz,11,,27,22,49
071 Rasen-Antholz,12,,28,19,47
071 Rasen-Antholz,13,,8,15,23
071 Rasen-Antholz,14,,20,11,31
071 Rasen-Antholz,15,,19,15,34
071 Rasen-Antholz,16,,26,20,46
071 Rasen-Antholz,17,,15,14,29
071 Rasen-Antholz,18,,14,25,39
071 Rasen-Antholz,19,,19,17,36
071 Rasen-Antholz,20,,19,20,39
071 Rasen-Antholz,21,,27,10,37
071 Rasen-Antholz,22,,16,20,36
071 Rasen-Antholz,23,,24,13,37
071 Rasen-Antholz,24,,17,20,37
071 Rasen-Antholz,25,,15,17,32
071 Rasen-Antholz,26,,23,21,44
071 Rasen-Antholz,27,,15,17,32
071 Rasen-Antholz,28,,17,13,30
071 Rasen-Antholz,29,,18,20,38
071 Rasen-Antholz,30,,16,22,38
071 Rasen-Antholz,31,,17,18,35
071 Rasen-Antholz,32,,22,14,36
071 Rasen-Antholz,33,,18,25,43
071 Rasen-Antholz,34,,26,20,46
071 Rasen-Antholz,35,,30,25,55
071 Rasen-Antholz,36,,23,20,43
071 Rasen-Antholz,37,,25,23,48
071 Rasen-Antholz,38,,25,24,49
071 Rasen-Antholz,39,,26,25,51
071 Rasen-Antholz,40,,24,27,51
071 Rasen-Antholz,41,,27,27,54
071 Rasen-Antholz,42,,29,19,48
071 Rasen-Antholz,43,,33,26,59
071 Rasen-Antholz,44,,30,25,55
071 Rasen-Antholz,45,,18,22,40
071 Rasen-Antholz,46,,27,19,46
071 Rasen-Antholz,47,,22,25,47
071 Rasen-Antholz,48,,21,23,44
071 Rasen-Antholz,49,,28,18,46
071 Rasen-Antholz,50,,24,15,39
071 Rasen-Antholz,51,,22,10,32
071 Rasen-Antholz,52,,18,14,32
071 Rasen-Antholz,53,,18,14,32
071 Rasen-Antholz,54,,14,13,27
071 Rasen-Antholz,55,,14,9,23
071 Rasen-Antholz,56,,11,15,26
071 Rasen-Antholz,57,,12,11,23
071 Rasen-Antholz,58,,13,8,21
071 Rasen-Antholz,59,,14,8,22
071 Rasen-Antholz,60,,14,10,24
071 Rasen-Antholz,61,,9,14,23
071 Rasen-Antholz,62,,10,14,24
071 Rasen-Antholz,63,,11,8,19
071 Rasen-Antholz,64,,10,8,18
071 Rasen-Antholz,65,,13,12,25
071 Rasen-Antholz,66,,11,14,25
071 Rasen-Antholz,67,,15,12,27
071 Rasen-Antholz,68,,10,17,27
071 Rasen-Antholz,69,,16,13,29
071 Rasen-Antholz,70,,13,8,21
071 Rasen-Antholz,71,,9,11,20
071 Rasen-Antholz,72,,9,12,21
071 Rasen-Antholz,73,,9,8,17
071 Rasen-Antholz,74,,11,10,21
071 Rasen-Antholz,75,,10,14,24
071 Rasen-Antholz,76,,11,11,22
071 Rasen-Antholz,77,,11,15,26
071 Rasen-Antholz,78,,4,9,13
071 Rasen-Antholz,79,,9,3,12
071 Rasen-Antholz,80,,2,3,5
071 Rasen-Antholz,81,,4,7,11
071 Rasen-Antholz,82,,5,6,11
071 Rasen-Antholz,83,,7,10,17
071 Rasen-Antholz,84,,4,10,14
071 Rasen-Antholz,85,,-,8,8
071 Rasen-Antholz,86,,2,4,6
071 Rasen-Antholz,87,,5,2,7
071 Rasen-Antholz,88,,1,3,4
071 Rasen-Antholz,89,,1,4,5
071 Rasen-Antholz,90,,-,3,3
071 Rasen-Antholz,91,,1,2,3
071 Rasen-Antholz,92,,-,1,1
071 Rasen-Antholz,93,,2,-,2
071 Rasen-Antholz,94,,1,-,1
071 Rasen-Antholz,99,,-,1,1
071 Rasen-Antholz,103,,-,1,1
071 Rasen-Antholz,Insgesamt,,1.456,1.379,2.835
072 Ritten,0,,33,52,85
072 Ritten,1,,45,53,98
072 Ritten,2,,53,48,101
072 Ritten,3,,41,50,91
072 Ritten,4,,49,51,100
072 Ritten,5,,47,40,87
072 Ritten,6,,35,49,84
072 Ritten,7,,52,45,97
072 Ritten,8,,45,45,90
072 Ritten,9,,51,53,104
072 Ritten,10,,41,43,84
072 Ritten,11,,58,55,113
072 Ritten,12,,40,52,92
072 Ritten,13,,54,44,98
072 Ritten,14,,61,44,105
072 Ritten,15,,59,49,108
072 Ritten,16,,46,69,115
072 Ritten,17,,62,50,112
072 Ritten,18,,61,46,107
072 Ritten,19,,53,42,95
072 Ritten,20,,56,50,106
072 Ritten,21,,49,40,89
072 Ritten,22,,48,46,94
072 Ritten,23,,43,54,97
072 Ritten,24,,46,23,69
072 Ritten,25,,49,47,96
072 Ritten,26,,43,52,95
072 Ritten,27,,46,51,97
072 Ritten,28,,46,44,90
072 Ritten,29,,53,47,100
072 Ritten,30,,47,38,85
072 Ritten,31,,62,36,98
072 Ritten,32,,47,48,95
072 Ritten,33,,59,45,104
072 Ritten,34,,58,62,120
072 Ritten,35,,60,48,108
072 Ritten,36,,53,60,113
072 Ritten,37,,53,63,116
072 Ritten,38,,49,72,121
072 Ritten,39,,48,75,123
072 Ritten,40,,71,61,132
072 Ritten,41,,71,48,119
072 Ritten,42,,60,47,107
072 Ritten,43,,79,42,121
072 Ritten,44,,66,61,127
072 Ritten,45,,61,50,111
072 Ritten,46,,56,60,116
072 Ritten,47,,47,57,104
072 Ritten,48,,65,56,121
072 Ritten,49,,69,52,121
072 Ritten,50,,36,46,82
072 Ritten,51,,40,41,81
072 Ritten,52,,50,45,95
072 Ritten,53,,52,41,93
072 Ritten,54,,37,35,72
072 Ritten,55,,48,31,79
072 Ritten,56,,42,43,85
072 Ritten,57,,43,34,77
072 Ritten,58,,35,43,78
072 Ritten,59,,35,47,82
072 Ritten,60,,48,34,82
072 Ritten,61,,34,29,63
072 Ritten,62,,29,36,65
072 Ritten,63,,20,28,48
072 Ritten,64,,33,40,73
072 Ritten,65,,34,37,71
072 Ritten,66,,42,33,75
072 Ritten,67,,37,38,75
072 Ritten,68,,33,23,56
072 Ritten,69,,37,33,70
072 Ritten,70,,32,32,64
072 Ritten,71,,25,24,49
072 Ritten,72,,21,24,45
072 Ritten,73,,22,28,50
072 Ritten,74,,24,28,52
072 Ritten,75,,14,26,40
072 Ritten,76,,17,21,38
072 Ritten,77,,11,28,39
072 Ritten,78,,10,20,30
072 Ritten,79,,19,18,37
072 Ritten,80,,11,12,23
072 Ritten,81,,13,13,26
072 Ritten,82,,11,15,26
072 Ritten,83,,6,29,35
072 Ritten,84,,11,18,29
072 Ritten,85,,14,23,37
072 Ritten,86,,2,17,19
072 Ritten,87,,6,16,22
072 Ritten,88,,5,13,18
072 Ritten,89,,2,8,10
072 Ritten,90,,-,5,5
072 Ritten,91,,1,4,5
072 Ritten,92,,-,2,2
072 Ritten,93,,3,5,8
072 Ritten,94,,1,3,4
072 Ritten,95,,1,1,2
072 Ritten,96,,1,-,1
072 Ritten,97,,1,1,2
072 Ritten,98,,-,1,1
072 Ritten,99,,1,-,1
072 Ritten,Insgesamt,,3.696,3.687,7.383
073 Riffian,0,,11,6,17
073 Riffian,1,,10,9,19
073 Riffian,2,,6,7,13
073 Riffian,3,,9,8,17
073 Riffian,4,,7,3,10
073 Riffian,5,,8,8,16
073 Riffian,6,,8,7,15
073 Riffian,7,,11,8,19
073 Riffian,8,,10,7,17
073 Riffian,9,,9,9,18
073 Riffian,10,,10,6,16
073 Riffian,11,,10,7,17
073 Riffian,12,,6,7,13
073 Riffian,13,,6,10,16
073 Riffian,14,,6,8,14
073 Riffian,15,,6,6,12
073 Riffian,16,,8,9,17
073 Riffian,17,,9,14,23
073 Riffian,18,,7,7,14
073 Riffian,19,,12,4,16
073 Riffian,20,,6,10,16
073 Riffian,21,,5,8,13
073 Riffian,22,,7,5,12
073 Riffian,23,,9,3,12
073 Riffian,24,,7,7,14
073 Riffian,25,,9,9,18
073 Riffian,26,,7,10,17
073 Riffian,27,,5,7,12
073 Riffian,28,,5,8,13
073 Riffian,29,,8,9,17
073 Riffian,30,,13,7,20
073 Riffian,31,,14,14,28
073 Riffian,32,,10,1,11
073 Riffian,33,,9,13,22
073 Riffian,34,,11,8,19
073 Riffian,35,,8,10,18
073 Riffian,36,,12,24,36
073 Riffian,37,,13,15,28
073 Riffian,38,,7,8,15
073 Riffian,39,,13,15,28
073 Riffian,40,,8,13,21
073 Riffian,41,,10,14,24
073 Riffian,42,,13,5,18
073 Riffian,43,,9,5,14
073 Riffian,44,,9,7,16
073 Riffian,45,,17,11,28
073 Riffian,46,,11,12,23
073 Riffian,47,,9,8,17
073 Riffian,48,,13,6,19
073 Riffian,49,,8,14,22
073 Riffian,50,,8,7,15
073 Riffian,51,,6,9,15
073 Riffian,52,,10,5,15
073 Riffian,53,,3,7,10
073 Riffian,54,,11,6,17
073 Riffian,55,,7,5,12
073 Riffian,56,,7,4,11
073 Riffian,57,,6,10,16
073 Riffian,58,,4,3,7
073 Riffian,59,,6,6,12
073 Riffian,60,,6,3,9
073 Riffian,61,,3,4,7
073 Riffian,62,,2,7,9
073 Riffian,63,,6,3,9
073 Riffian,64,,8,8,16
073 Riffian,65,,7,7,14
073 Riffian,66,,14,7,21
073 Riffian,67,,7,3,10
073 Riffian,68,,4,3,7
073 Riffian,69,,4,9,13
073 Riffian,70,,8,4,12
073 Riffian,71,,4,5,9
073 Riffian,72,,3,5,8
073 Riffian,73,,-,3,3
073 Riffian,74,,-,3,3
073 Riffian,75,,4,5,9
073 Riffian,76,,1,4,5
073 Riffian,77,,4,8,12
073 Riffian,78,,4,4,8
073 Riffian,79,,1,7,8
073 Riffian,80,,2,5,7
073 Riffian,81,,3,4,7
073 Riffian,82,,4,3,7
073 Riffian,83,,3,1,4
073 Riffian,84,,3,2,5
073 Riffian,85,,3,5,8
073 Riffian,86,,1,-,1
073 Riffian,87,,-,3,3
073 Riffian,88,,-,2,2
073 Riffian,91,,-,2,2
073 Riffian,93,,-,1,1
073 Riffian,94,,-,1,1
073 Riffian,Insgesamt,,631,629,1.260
074 Mühlbach,0,,17,18,35
074 Mühlbach,1,,20,18,38
074 Mühlbach,2,,14,8,22
074 Mühlbach,3,,14,10,24
074 Mühlbach,4,,15,21,36
074 Mühlbach,5,,21,10,31
074 Mühlbach,6,,19,17,36
074 Mühlbach,7,,13,18,31
074 Mühlbach,8,,15,19,34
074 Mühlbach,9,,17,13,30
074 Mühlbach,10,,19,20,39
074 Mühlbach,11,,17,16,33
074 Mühlbach,12,,18,18,36
074 Mühlbach,13,,13,14,27
074 Mühlbach,14,,23,14,37
074 Mühlbach,15,,16,20,36
074 Mühlbach,16,,15,24,39
074 Mühlbach,17,,14,20,34
074 Mühlbach,18,,13,15,28
074 Mühlbach,19,,15,19,34
074 Mühlbach,20,,20,16,36
074 Mühlbach,21,,21,12,33
074 Mühlbach,22,,15,9,24
074 Mühlbach,23,,19,22,41
074 Mühlbach,24,,18,23,41
074 Mühlbach,25,,19,18,37
074 Mühlbach,26,,27,31,58
074 Mühlbach,27,,25,18,43
074 Mühlbach,28,,18,17,35
074 Mühlbach,29,,21,16,37
074 Mühlbach,30,,27,29,56
074 Mühlbach,31,,24,18,42
074 Mühlbach,32,,21,25,46
074 Mühlbach,33,,18,20,38
074 Mühlbach,34,,22,18,40
074 Mühlbach,35,,23,18,41
074 Mühlbach,36,,23,20,43
074 Mühlbach,37,,31,25,56
074 Mühlbach,38,,26,13,39
074 Mühlbach,39,,25,33,58
074 Mühlbach,40,,37,16,53
074 Mühlbach,41,,23,19,42
074 Mühlbach,42,,29,16,45
074 Mühlbach,43,,23,23,46
074 Mühlbach,44,,14,23,37
074 Mühlbach,45,,20,19,39
074 Mühlbach,46,,22,17,39
074 Mühlbach,47,,25,22,47
074 Mühlbach,48,,22,15,37
074 Mühlbach,49,,21,18,39
074 Mühlbach,50,,18,12,30
074 Mühlbach,51,,16,20,36
074 Mühlbach,52,,20,23,43
074 Mühlbach,53,,21,16,37
074 Mühlbach,54,,14,21,35
074 Mühlbach,55,,19,17,36
074 Mühlbach,56,,15,21,36
074 Mühlbach,57,,13,20,33
074 Mühlbach,58,,21,17,38
074 Mühlbach,59,,14,13,27
074 Mühlbach,60,,16,13,29
074 Mühlbach,61,,10,19,29
074 Mühlbach,62,,21,11,32
074 Mühlbach,63,,9,8,17
074 Mühlbach,64,,14,12,26
074 Mühlbach,65,,11,10,21
074 Mühlbach,66,,15,13,28
074 Mühlbach,67,,17,17,34
074 Mühlbach,68,,12,11,23
074 Mühlbach,69,,11,17,28
074 Mühlbach,70,,13,8,21
074 Mühlbach,71,,5,11,16
074 Mühlbach,72,,7,7,14
074 Mühlbach,73,,7,10,17
074 Mühlbach,74,,10,13,23
074 Mühlbach,75,,9,9,18
074 Mühlbach,76,,5,8,13
074 Mühlbach,77,,6,10,16
074 Mühlbach,78,,10,7,17
074 Mühlbach,79,,7,2,9
074 Mühlbach,80,,5,16,21
074 Mühlbach,81,,4,6,10
074 Mühlbach,82,,5,7,12
074 Mühlbach,83,,4,6,10
074 Mühlbach,84,,4,5,9
074 Mühlbach,85,,5,4,9
074 Mühlbach,86,,1,9,10
074 Mühlbach,87,,1,3,4
074 Mühlbach,88,,2,7,9
074 Mühlbach,89,,1,4,5
074 Mühlbach,90,,-,1,1
074 Mühlbach,91,,-,1,1
074 Mühlbach,94,,-,1,1
074 Mühlbach,95,,1,2,3
074 Mühlbach,96,,-,1,1
074 Mühlbach,Insgesamt,,1.426,1.390,2.816
075 Rodeneck,0,,5,9,14
075 Rodeneck,1,,7,6,13
075 Rodeneck,2,,5,3,8
075 Rodeneck,3,,9,6,15
075 Rodeneck,4,,5,4,9
075 Rodeneck,5,,9,7,16
075 Rodeneck,6,,8,3,11
075 Rodeneck,7,,10,3,13
075 Rodeneck,8,,7,15,22
075 Rodeneck,9,,8,10,18
075 Rodeneck,10,,12,7,19
075 Rodeneck,11,,10,8,18
075 Rodeneck,12,,12,8,20
075 Rodeneck,13,,4,9,13
075 Rodeneck,14,,6,10,16
075 Rodeneck,15,,6,7,13
075 Rodeneck,16,,11,10,21
075 Rodeneck,17,,6,8,14
075 Rodeneck,18,,13,8,21
075 Rodeneck,19,,7,6,13
075 Rodeneck,20,,12,8,20
075 Rodeneck,21,,7,6,13
075 Rodeneck,22,,8,12,20
075 Rodeneck,23,,14,9,23
075 Rodeneck,24,,15,10,25
075 Rodeneck,25,,10,9,19
075 Rodeneck,26,,6,5,11
075 Rodeneck,27,,11,5,16
075 Rodeneck,28,,8,12,20
075 Rodeneck,29,,9,3,12
075 Rodeneck,30,,6,9,15
075 Rodeneck,31,,6,7,13
075 Rodeneck,32,,7,7,14
075 Rodeneck,33,,8,8,16
075 Rodeneck,34,,6,5,11
075 Rodeneck,35,,14,9,23
075 Rodeneck,36,,8,8,16
075 Rodeneck,37,,15,5,20
075 Rodeneck,38,,10,11,21
075 Rodeneck,39,,15,12,27
075 Rodeneck,40,,8,11,19
075 Rodeneck,41,,11,10,21
075 Rodeneck,42,,14,8,22
075 Rodeneck,43,,8,9,17
075 Rodeneck,44,,12,12,24
075 Rodeneck,45,,9,10,19
075 Rodeneck,46,,8,11,19
075 Rodeneck,47,,9,12,21
075 Rodeneck,48,,6,10,16
075 Rodeneck,49,,10,6,16
075 Rodeneck,50,,8,5,13
075 Rodeneck,51,,6,7,13
075 Rodeneck,52,,8,4,12
075 Rodeneck,53,,7,6,13
075 Rodeneck,54,,12,3,15
075 Rodeneck,55,,3,1,4
075 Rodeneck,56,,7,4,11
075 Rodeneck,57,,3,3,6
075 Rodeneck,58,,1,7,8
075 Rodeneck,59,,2,6,8
075 Rodeneck,60,,4,7,11
075 Rodeneck,61,,5,4,9
075 Rodeneck,62,,10,7,17
075 Rodeneck,63,,1,5,6
075 Rodeneck,64,,4,5,9
075 Rodeneck,65,,2,2,4
075 Rodeneck,66,,2,6,8
075 Rodeneck,67,,10,3,13
075 Rodeneck,68,,5,4,9
075 Rodeneck,69,,3,9,12
075 Rodeneck,70,,3,3,6
075 Rodeneck,71,,2,4,6
075 Rodeneck,72,,3,4,7
075 Rodeneck,73,,3,2,5
075 Rodeneck,74,,1,10,11
075 Rodeneck,75,,3,-,3
075 Rodeneck,76,,6,5,11
075 Rodeneck,77,,4,2,6
075 Rodeneck,78,,4,5,9
075 Rodeneck,79,,7,1,8
075 Rodeneck,80,,3,4,7
075 Rodeneck,81,,1,4,5
075 Rodeneck,82,,2,4,6
075 Rodeneck,83,,2,5,7
075 Rodeneck,84,,3,3,6
075 Rodeneck,85,,2,1,3
075 Rodeneck,86,,-,2,2
075 Rodeneck,87,,2,-,2
075 Rodeneck,88,,2,-,2
075 Rodeneck,89,,2,-,2
075 Rodeneck,90,,-,2,2
075 Rodeneck,Insgesamt,,608,565,1.173
076 Salurn,0,,27,21,48
076 Salurn,1,,23,27,50
076 Salurn,2,,25,20,45
076 Salurn,3,,15,24,39
076 Salurn,4,,20,15,35
076 Salurn,5,,26,18,44
076 Salurn,6,,18,15,33
076 Salurn,7,,11,18,29
076 Salurn,8,,21,17,38
076 Salurn,9,,20,13,33
076 Salurn,10,,19,24,43
076 Salurn,11,,13,12,25
076 Salurn,12,,26,24,50
076 Salurn,13,,21,16,37
076 Salurn,14,,22,20,42
076 Salurn,15,,20,18,38
076 Salurn,16,,23,19,42
076 Salurn,17,,13,20,33
076 Salurn,18,,15,17,32
076 Salurn,19,,21,18,39
076 Salurn,20,,22,24,46
076 Salurn,21,,24,21,45
076 Salurn,22,,17,18,35
076 Salurn,23,,17,22,39
076 Salurn,24,,12,23,35
076 Salurn,25,,16,24,40
076 Salurn,26,,20,18,38
076 Salurn,27,,17,28,45
076 Salurn,28,,22,25,47
076 Salurn,29,,15,24,39
076 Salurn,30,,22,19,41
076 Salurn,31,,31,24,55
076 Salurn,32,,24,21,45
076 Salurn,33,,27,27,54
076 Salurn,34,,26,20,46
076 Salurn,35,,25,32,57
076 Salurn,36,,29,26,55
076 Salurn,37,,42,27,69
076 Salurn,38,,25,28,53
076 Salurn,39,,27,28,55
076 Salurn,40,,33,26,59
076 Salurn,41,,26,22,48
076 Salurn,42,,29,25,54
076 Salurn,43,,29,32,61
076 Salurn,44,,32,30,62
076 Salurn,45,,41,28,69
076 Salurn,46,,32,29,61
076 Salurn,47,,29,31,60
076 Salurn,48,,20,32,52
076 Salurn,49,,29,28,57
076 Salurn,50,,28,18,46
076 Salurn,51,,22,23,45
076 Salurn,52,,18,13,31
076 Salurn,53,,19,19,38
076 Salurn,54,,22,18,40
076 Salurn,55,,17,19,36
076 Salurn,56,,28,19,47
076 Salurn,57,,28,22,50
076 Salurn,58,,22,17,39
076 Salurn,59,,28,11,39
076 Salurn,60,,14,21,35
076 Salurn,61,,16,21,37
076 Salurn,62,,22,20,42
076 Salurn,63,,13,10,23
076 Salurn,64,,20,18,38
076 Salurn,65,,20,17,37
076 Salurn,66,,19,16,35
076 Salurn,67,,17,16,33
076 Salurn,68,,14,10,24
076 Salurn,69,,12,8,20
076 Salurn,70,,6,10,16
076 Salurn,71,,12,12,24
076 Salurn,72,,13,20,33
076 Salurn,73,,13,17,30
076 Salurn,74,,10,8,18
076 Salurn,75,,10,7,17
076 Salurn,76,,8,17,25
076 Salurn,77,,6,11,17
076 Salurn,78,,11,11,22
076 Salurn,79,,14,10,24
076 Salurn,80,,8,18,26
076 Salurn,81,,3,17,20
076 Salurn,82,,6,13,19
076 Salurn,83,,6,16,22
076 Salurn,84,,3,13,16
076 Salurn,85,,3,6,9
076 Salurn,86,,5,12,17
076 Salurn,87,,1,10,11
076 Salurn,88,,6,9,15
076 Salurn,89,,2,8,10
076 Salurn,90,,1,3,4
076 Salurn,91,,-,2,2
076 Salurn,92,,-,1,1
076 Salurn,93,,1,2,3
076 Salurn,94,,-,2,2
076 Salurn,95,,-,1,1
076 Salurn,96,,1,1,2
076 Salurn,97,,-,2,2
076 Salurn,99,,-,1,1
076 Salurn,Insgesamt,,1.707,1.734,3.441
077 Innichen,0,,22,11,33
077 Innichen,1,,14,17,31
077 Innichen,2,,12,15,27
077 Innichen,3,,13,20,33
077 Innichen,4,,12,13,25
077 Innichen,5,,17,16,33
077 Innichen,6,,16,16,32
077 Innichen,7,,24,17,41
077 Innichen,8,,16,16,32
077 Innichen,9,,11,17,28
077 Innichen,10,,20,14,34
077 Innichen,11,,20,16,36
077 Innichen,12,,15,18,33
077 Innichen,13,,23,12,35
077 Innichen,14,,18,16,34
077 Innichen,15,,23,21,44
077 Innichen,16,,21,16,37
077 Innichen,17,,20,25,45
077 Innichen,18,,17,14,31
077 Innichen,19,,18,22,40
077 Innichen,20,,28,17,45
077 Innichen,21,,23,22,45
077 Innichen,22,,20,18,38
077 Innichen,23,,21,19,40
077 Innichen,24,,23,18,41
077 Innichen,25,,23,20,43
077 Innichen,26,,23,22,45
077 Innichen,27,,15,19,34
077 Innichen,28,,26,20,46
077 Innichen,29,,28,24,52
077 Innichen,30,,12,19,31
077 Innichen,31,,18,21,39
077 Innichen,32,,16,26,42
077 Innichen,33,,22,13,35
077 Innichen,34,,25,17,42
077 Innichen,35,,23,18,41
077 Innichen,36,,20,23,43
077 Innichen,37,,22,17,39
077 Innichen,38,,24,30,54
077 Innichen,39,,22,29,51
077 Innichen,40,,24,24,48
077 Innichen,41,,25,28,53
077 Innichen,42,,26,31,57
077 Innichen,43,,36,30,66
077 Innichen,44,,29,31,60
077 Innichen,45,,27,26,53
077 Innichen,46,,29,24,53
077 Innichen,47,,25,27,52
077 Innichen,48,,30,18,48
077 Innichen,49,,25,22,47
077 Innichen,50,,21,24,45
077 Innichen,51,,18,26,44
077 Innichen,52,,24,15,39
077 Innichen,53,,25,20,45
077 Innichen,54,,23,10,33
077 Innichen,55,,24,17,41
077 Innichen,56,,11,25,36
077 Innichen,57,,12,18,30
077 Innichen,58,,17,20,37
077 Innichen,59,,21,16,37
077 Innichen,60,,18,12,30
077 Innichen,61,,11,14,25
077 Innichen,62,,13,16,29
077 Innichen,63,,10,8,18
077 Innichen,64,,8,13,21
077 Innichen,65,,24,9,33
077 Innichen,66,,17,20,37
077 Innichen,67,,15,20,35
077 Innichen,68,,7,23,30
077 Innichen,69,,12,12,24
077 Innichen,70,,7,12,19
077 Innichen,71,,11,11,22
077 Innichen,72,,8,19,27
077 Innichen,73,,6,19,25
077 Innichen,74,,11,13,24
077 Innichen,75,,10,9,19
077 Innichen,76,,10,19,29
077 Innichen,77,,12,20,32
077 Innichen,78,,14,11,25
077 Innichen,79,,11,14,25
077 Innichen,80,,11,16,27
077 Innichen,81,,3,11,14
077 Innichen,82,,11,13,24
077 Innichen,83,,3,16,19
077 Innichen,84,,6,2,8
077 Innichen,85,,3,13,16
077 Innichen,86,,1,9,10
077 Innichen,87,,3,10,13
077 Innichen,88,,2,11,13
077 Innichen,89,,2,2,4
077 Innichen,90,,-,2,2
077 Innichen,91,,2,2,4
077 Innichen,92,,1,2,3
077 Innichen,93,,-,3,3
077 Innichen,94,,1,-,1
077 Innichen,95,,-,1,1
077 Innichen,96,,-,1,1
077 Innichen,99,,-,1,1
077 Innichen,Insgesamt,,1.542,1.605,3.147
079 Jenesien,0,,20,24,44
079 Jenesien,1,,21,19,40
079 Jenesien,2,,21,22,43
079 Jenesien,3,,15,18,33
079 Jenesien,4,,18,19,37
079 Jenesien,5,,17,22,39
079 Jenesien,6,,12,17,29
079 Jenesien,7,,17,22,39
079 Jenesien,8,,18,19,37
079 Jenesien,9,,25,23,48
079 Jenesien,10,,18,28,46
079 Jenesien,11,,20,19,39
079 Jenesien,12,,24,11,35
079 Jenesien,13,,25,17,42
079 Jenesien,14,,22,21,43
079 Jenesien,15,,15,18,33
079 Jenesien,16,,29,23,52
079 Jenesien,17,,19,22,41
079 Jenesien,18,,18,15,33
079 Jenesien,19,,18,13,31
079 Jenesien,20,,22,16,38
079 Jenesien,21,,15,22,37
079 Jenesien,22,,17,16,33
079 Jenesien,23,,16,6,22
079 Jenesien,24,,17,16,33
079 Jenesien,25,,18,18,36
079 Jenesien,26,,14,19,33
079 Jenesien,27,,13,20,33
079 Jenesien,28,,18,19,37
079 Jenesien,29,,21,17,38
079 Jenesien,30,,14,15,29
079 Jenesien,31,,19,17,36
079 Jenesien,32,,17,17,34
079 Jenesien,33,,10,18,28
079 Jenesien,34,,22,26,48
079 Jenesien,35,,19,32,51
079 Jenesien,36,,25,26,51
079 Jenesien,37,,30,26,56
079 Jenesien,38,,32,33,65
079 Jenesien,39,,32,20,52
079 Jenesien,40,,19,27,46
079 Jenesien,41,,17,25,42
079 Jenesien,42,,37,29,66
079 Jenesien,43,,34,29,63
079 Jenesien,44,,35,33,68
079 Jenesien,45,,26,24,50
079 Jenesien,46,,28,21,49
079 Jenesien,47,,30,21,51
079 Jenesien,48,,25,12,37
079 Jenesien,49,,24,16,40
079 Jenesien,50,,22,10,32
079 Jenesien,51,,13,17,30
079 Jenesien,52,,15,12,27
079 Jenesien,53,,10,12,22
079 Jenesien,54,,20,13,33
079 Jenesien,55,,13,9,22
079 Jenesien,56,,12,20,32
079 Jenesien,57,,13,9,22
079 Jenesien,58,,12,20,32
079 Jenesien,59,,11,13,24
079 Jenesien,60,,11,7,18
079 Jenesien,61,,14,11,25
079 Jenesien,62,,9,10,19
079 Jenesien,63,,8,14,22
079 Jenesien,64,,13,12,25
079 Jenesien,65,,17,9,26
079 Jenesien,66,,15,11,26
079 Jenesien,67,,14,21,35
079 Jenesien,68,,16,10,26
079 Jenesien,69,,14,18,32
079 Jenesien,70,,17,9,26
079 Jenesien,71,,10,16,26
079 Jenesien,72,,5,18,23
079 Jenesien,73,,6,8,14
079 Jenesien,74,,8,7,15
079 Jenesien,75,,16,11,27
079 Jenesien,76,,6,9,15
079 Jenesien,77,,8,9,17
079 Jenesien,78,,6,12,18
079 Jenesien,79,,4,15,19
079 Jenesien,80,,8,8,16
079 Jenesien,81,,4,10,14
079 Jenesien,82,,7,12,19
079 Jenesien,83,,3,8,11
079 Jenesien,84,,6,6,12
079 Jenesien,85,,4,4,8
079 Jenesien,86,,4,6,10
079 Jenesien,87,,1,3,4
079 Jenesien,88,,3,4,7
079 Jenesien,89,,-,2,2
079 Jenesien,90,,-,1,1
079 Jenesien,92,,-,1,1
079 Jenesien,93,,-,1,1
079 Jenesien,94,,1,-,1
079 Jenesien,95,,-,2,2
079 Jenesien,96,,1,1,2
079 Jenesien,98,,-,1,1
079 Jenesien,100,,-,1,1
079 Jenesien,Insgesamt,,1.458,1.471,2.929
080 St.Leonhard in Pass.,0,,22,21,43
080 St.Leonhard in Pass.,1,,21,22,43
080 St.Leonhard in Pass.,2,,18,23,41
080 St.Leonhard in Pass.,3,,26,21,47
080 St.Leonhard in Pass.,4,,16,21,37
080 St.Leonhard in Pass.,5,,25,14,39
080 St.Leonhard in Pass.,6,,20,19,39
080 St.Leonhard in Pass.,7,,26,13,39
080 St.Leonhard in Pass.,8,,22,17,39
080 St.Leonhard in Pass.,9,,20,22,42
080 St.Leonhard in Pass.,10,,23,22,45
080 St.Leonhard in Pass.,11,,23,20,43
080 St.Leonhard in Pass.,12,,23,20,43
080 St.Leonhard in Pass.,13,,22,13,35
080 St.Leonhard in Pass.,14,,21,19,40
080 St.Leonhard in Pass.,15,,25,23,48
080 St.Leonhard in Pass.,16,,21,19,40
080 St.Leonhard in Pass.,17,,21,19,40
080 St.Leonhard in Pass.,18,,24,20,44
080 St.Leonhard in Pass.,19,,35,30,65
080 St.Leonhard in Pass.,20,,21,27,48
080 St.Leonhard in Pass.,21,,29,21,50
080 St.Leonhard in Pass.,22,,36,32,68
080 St.Leonhard in Pass.,23,,21,24,45
080 St.Leonhard in Pass.,24,,29,21,50
080 St.Leonhard in Pass.,25,,29,24,53
080 St.Leonhard in Pass.,26,,28,25,53
080 St.Leonhard in Pass.,27,,23,30,53
080 St.Leonhard in Pass.,28,,23,32,55
080 St.Leonhard in Pass.,29,,27,24,51
080 St.Leonhard in Pass.,30,,32,27,59
080 St.Leonhard in Pass.,31,,30,24,54
080 St.Leonhard in Pass.,32,,14,24,38
080 St.Leonhard in Pass.,33,,30,12,42
080 St.Leonhard in Pass.,34,,35,24,59
080 St.Leonhard in Pass.,35,,30,26,56
080 St.Leonhard in Pass.,36,,27,26,53
080 St.Leonhard in Pass.,37,,33,21,54
080 St.Leonhard in Pass.,38,,24,27,51
080 St.Leonhard in Pass.,39,,26,26,52
080 St.Leonhard in Pass.,40,,34,21,55
080 St.Leonhard in Pass.,41,,29,26,55
080 St.Leonhard in Pass.,42,,33,30,63
080 St.Leonhard in Pass.,43,,31,32,63
080 St.Leonhard in Pass.,44,,26,30,56
080 St.Leonhard in Pass.,45,,21,23,44
080 St.Leonhard in Pass.,46,,23,29,52
080 St.Leonhard in Pass.,47,,29,23,52
080 St.Leonhard in Pass.,48,,33,19,52
080 St.Leonhard in Pass.,49,,27,27,54
080 St.Leonhard in Pass.,50,,25,19,44
080 St.Leonhard in Pass.,51,,21,27,48
080 St.Leonhard in Pass.,52,,24,16,40
080 St.Leonhard in Pass.,53,,22,17,39
080 St.Leonhard in Pass.,54,,18,14,32
080 St.Leonhard in Pass.,55,,29,25,54
080 St.Leonhard in Pass.,56,,20,25,45
080 St.Leonhard in Pass.,57,,24,16,40
080 St.Leonhard in Pass.,58,,17,14,31
080 St.Leonhard in Pass.,59,,22,10,32
080 St.Leonhard in Pass.,60,,23,12,35
080 St.Leonhard in Pass.,61,,17,16,33
080 St.Leonhard in Pass.,62,,15,18,33
080 St.Leonhard in Pass.,63,,9,10,19
080 St.Leonhard in Pass.,64,,14,14,28
080 St.Leonhard in Pass.,65,,9,23,32
080 St.Leonhard in Pass.,66,,8,14,22
080 St.Leonhard in Pass.,67,,15,15,30
080 St.Leonhard in Pass.,68,,18,13,31
080 St.Leonhard in Pass.,69,,19,18,37
080 St.Leonhard in Pass.,70,,12,13,25
080 St.Leonhard in Pass.,71,,17,7,24
080 St.Leonhard in Pass.,72,,18,11,29
080 St.Leonhard in Pass.,73,,10,12,22
080 St.Leonhard in Pass.,74,,9,16,25
080 St.Leonhard in Pass.,75,,10,14,24
080 St.Leonhard in Pass.,76,,8,12,20
080 St.Leonhard in Pass.,77,,6,13,19
080 St.Leonhard in Pass.,78,,6,10,16
080 St.Leonhard in Pass.,79,,8,7,15
080 St.Leonhard in Pass.,80,,5,13,18
080 St.Leonhard in Pass.,81,,4,13,17
080 St.Leonhard in Pass.,82,,5,8,13
080 St.Leonhard in Pass.,83,,5,9,14
080 St.Leonhard in Pass.,84,,5,7,12
080 St.Leonhard in Pass.,85,,6,8,14
080 St.Leonhard in Pass.,86,,2,7,9
080 St.Leonhard in Pass.,87,,1,4,5
080 St.Leonhard in Pass.,88,,2,3,5
080 St.Leonhard in Pass.,89,,-,2,2
080 St.Leonhard in Pass.,90,,-,1,1
080 St.Leonhard in Pass.,91,,-,2,2
080 St.Leonhard in Pass.,93,,1,1,2
080 St.Leonhard in Pass.,94,,-,3,3
080 St.Leonhard in Pass.,95,,-,1,1
080 St.Leonhard in Pass.,96,,-,2,2
080 St.Leonhard in Pass.,101,,-,1,1
080 St.Leonhard in Pass.,Insgesamt,,1.796,1.691,3.487
081 St.Lorenzen,0,,23,15,38
081 St.Lorenzen,1,,23,20,43
081 St.Lorenzen,2,,13,18,31
081 St.Lorenzen,3,,27,18,45
081 St.Lorenzen,4,,25,23,48
081 St.Lorenzen,5,,24,18,42
081 St.Lorenzen,6,,20,19,39
081 St.Lorenzen,7,,28,20,48
081 St.Lorenzen,8,,20,29,49
081 St.Lorenzen,9,,29,26,55
081 St.Lorenzen,10,,30,27,57
081 St.Lorenzen,11,,16,30,46
081 St.Lorenzen,12,,31,29,60
081 St.Lorenzen,13,,23,14,37
081 St.Lorenzen,14,,31,19,50
081 St.Lorenzen,15,,25,31,56
081 St.Lorenzen,16,,27,20,47
081 St.Lorenzen,17,,22,14,36
081 St.Lorenzen,18,,25,21,46
081 St.Lorenzen,19,,18,19,37
081 St.Lorenzen,20,,18,25,43
081 St.Lorenzen,21,,23,24,47
081 St.Lorenzen,22,,26,21,47
081 St.Lorenzen,23,,24,22,46
081 St.Lorenzen,24,,29,22,51
081 St.Lorenzen,25,,22,19,41
081 St.Lorenzen,26,,35,23,58
081 St.Lorenzen,27,,25,18,43
081 St.Lorenzen,28,,18,21,39
081 St.Lorenzen,29,,29,31,60
081 St.Lorenzen,30,,29,20,49
081 St.Lorenzen,31,,24,25,49
081 St.Lorenzen,32,,23,14,37
081 St.Lorenzen,33,,21,31,52
081 St.Lorenzen,34,,25,30,55
081 St.Lorenzen,35,,34,31,65
081 St.Lorenzen,36,,35,35,70
081 St.Lorenzen,37,,32,28,60
081 St.Lorenzen,38,,27,31,58
081 St.Lorenzen,39,,23,30,53
081 St.Lorenzen,40,,43,37,80
081 St.Lorenzen,41,,33,39,72
081 St.Lorenzen,42,,35,31,66
081 St.Lorenzen,43,,36,25,61
081 St.Lorenzen,44,,31,23,54
081 St.Lorenzen,45,,34,31,65
081 St.Lorenzen,46,,29,37,66
081 St.Lorenzen,47,,25,38,63
081 St.Lorenzen,48,,31,19,50
081 St.Lorenzen,49,,32,27,59
081 St.Lorenzen,50,,31,31,62
081 St.Lorenzen,51,,23,25,48
081 St.Lorenzen,52,,25,28,53
081 St.Lorenzen,53,,17,16,33
081 St.Lorenzen,54,,15,19,34
081 St.Lorenzen,55,,24,17,41
081 St.Lorenzen,56,,17,10,27
081 St.Lorenzen,57,,17,15,32
081 St.Lorenzen,58,,16,19,35
081 St.Lorenzen,59,,12,21,33
081 St.Lorenzen,60,,14,14,28
081 St.Lorenzen,61,,19,8,27
081 St.Lorenzen,62,,17,11,28
081 St.Lorenzen,63,,12,18,30
081 St.Lorenzen,64,,18,15,33
081 St.Lorenzen,65,,14,17,31
081 St.Lorenzen,66,,17,20,37
081 St.Lorenzen,67,,18,17,35
081 St.Lorenzen,68,,15,13,28
081 St.Lorenzen,69,,13,17,30
081 St.Lorenzen,70,,12,13,25
081 St.Lorenzen,71,,18,15,33
081 St.Lorenzen,72,,13,15,28
081 St.Lorenzen,73,,9,14,23
081 St.Lorenzen,74,,15,11,26
081 St.Lorenzen,75,,11,9,20
081 St.Lorenzen,76,,9,10,19
081 St.Lorenzen,77,,9,14,23
081 St.Lorenzen,78,,8,6,14
081 St.Lorenzen,79,,10,16,26
081 St.Lorenzen,80,,8,15,23
081 St.Lorenzen,81,,5,8,13
081 St.Lorenzen,82,,7,7,14
081 St.Lorenzen,83,,3,11,14
081 St.Lorenzen,84,,2,9,11
081 St.Lorenzen,85,,6,10,16
081 St.Lorenzen,86,,2,4,6
081 St.Lorenzen,87,,2,5,7
081 St.Lorenzen,88,,-,4,4
081 St.Lorenzen,89,,2,4,6
081 St.Lorenzen,90,,-,2,2
081 St.Lorenzen,91,,-,1,1
081 St.Lorenzen,94,,2,1,3
081 St.Lorenzen,98,,-,1,1
081 St.Lorenzen,Insgesamt,,1.838,1.794,3.632
082 St.Martin in Thurn,0,,7,3,10
082 St.Martin in Thurn,1,,2,11,13
082 St.Martin in Thurn,2,,9,14,23
082 St.Martin in Thurn,3,,11,9,20
082 St.Martin in Thurn,4,,18,13,31
082 St.Martin in Thurn,5,,5,6,11
082 St.Martin in Thurn,6,,15,8,23
082 St.Martin in Thurn,7,,9,14,23
082 St.Martin in Thurn,8,,7,9,16
082 St.Martin in Thurn,9,,8,19,27
082 St.Martin in Thurn,10,,11,11,22
082 St.Martin in Thurn,11,,16,11,27
082 St.Martin in Thurn,12,,24,14,38
082 St.Martin in Thurn,13,,15,11,26
082 St.Martin in Thurn,14,,15,8,23
082 St.Martin in Thurn,15,,9,9,18
082 St.Martin in Thurn,16,,17,14,31
082 St.Martin in Thurn,17,,11,11,22
082 St.Martin in Thurn,18,,6,17,23
082 St.Martin in Thurn,19,,15,13,28
082 St.Martin in Thurn,20,,7,6,13
082 St.Martin in Thurn,21,,14,11,25
082 St.Martin in Thurn,22,,13,10,23
082 St.Martin in Thurn,23,,12,15,27
082 St.Martin in Thurn,24,,8,5,13
082 St.Martin in Thurn,25,,15,9,24
082 St.Martin in Thurn,26,,16,14,30
082 St.Martin in Thurn,27,,14,6,20
082 St.Martin in Thurn,28,,10,11,21
082 St.Martin in Thurn,29,,10,10,20
082 St.Martin in Thurn,30,,17,12,29
082 St.Martin in Thurn,31,,14,10,24
082 St.Martin in Thurn,32,,12,9,21
082 St.Martin in Thurn,33,,7,9,16
082 St.Martin in Thurn,34,,6,12,18
082 St.Martin in Thurn,35,,11,10,21
082 St.Martin in Thurn,36,,13,11,24
082 St.Martin in Thurn,37,,16,13,29
082 St.Martin in Thurn,38,,13,14,27
082 St.Martin in Thurn,39,,15,16,31
082 St.Martin in Thurn,40,,18,14,32
082 St.Martin in Thurn,41,,10,10,20
082 St.Martin in Thurn,42,,16,26,42
082 St.Martin in Thurn,43,,17,20,37
082 St.Martin in Thurn,44,,11,16,27
082 St.Martin in Thurn,45,,16,14,30
082 St.Martin in Thurn,46,,15,14,29
082 St.Martin in Thurn,47,,14,18,32
082 St.Martin in Thurn,48,,15,5,20
082 St.Martin in Thurn,49,,12,10,22
082 St.Martin in Thurn,50,,12,8,20
082 St.Martin in Thurn,51,,12,9,21
082 St.Martin in Thurn,52,,8,6,14
082 St.Martin in Thurn,53,,13,9,22
082 St.Martin in Thurn,54,,8,8,16
082 St.Martin in Thurn,55,,5,10,15
082 St.Martin in Thurn,56,,3,4,7
082 St.Martin in Thurn,57,,8,8,16
082 St.Martin in Thurn,58,,10,6,16
082 St.Martin in Thurn,59,,3,7,10
082 St.Martin in Thurn,60,,8,6,14
082 St.Martin in Thurn,61,,9,6,15
082 St.Martin in Thurn,62,,8,7,15
082 St.Martin in Thurn,63,,6,4,10
082 St.Martin in Thurn,64,,11,8,19
082 St.Martin in Thurn,65,,4,8,12
082 St.Martin in Thurn,66,,7,6,13
082 St.Martin in Thurn,67,,7,6,13
082 St.Martin in Thurn,68,,5,5,10
082 St.Martin in Thurn,69,,5,7,12
082 St.Martin in Thurn,70,,8,8,16
082 St.Martin in Thurn,71,,5,13,18
082 St.Martin in Thurn,72,,4,7,11
082 St.Martin in Thurn,73,,6,6,12
082 St.Martin in Thurn,74,,6,4,10
082 St.Martin in Thurn,75,,3,9,12
082 St.Martin in Thurn,76,,6,7,13
082 St.Martin in Thurn,77,,8,8,16
082 St.Martin in Thurn,78,,5,6,11
082 St.Martin in Thurn,79,,7,7,14
082 St.Martin in Thurn,80,,2,1,3
082 St.Martin in Thurn,81,,4,5,9
082 St.Martin in Thurn,82,,6,3,9
082 St.Martin in Thurn,83,,6,4,10
082 St.Martin in Thurn,84,,6,9,15
082 St.Martin in Thurn,85,,2,7,9
082 St.Martin in Thurn,86,,7,5,12
082 St.Martin in Thurn,87,,5,2,7
082 St.Martin in Thurn,88,,4,7,11
082 St.Martin in Thurn,89,,2,4,6
082 St.Martin in Thurn,91,,-,2,2
082 St.Martin in Thurn,92,,1,-,1
082 St.Martin in Thurn,94,,-,1,1
082 St.Martin in Thurn,95,,-,1,1
082 St.Martin in Thurn,96,,1,-,1
082 St.Martin in Thurn,Insgesamt,,873,849,1.722
083 St.Martin in Passeier,0,,22,25,47
083 St.Martin in Passeier,1,,16,23,39
083 St.Martin in Passeier,2,,24,23,47
083 St.Martin in Passeier,3,,20,18,38
083 St.Martin in Passeier,4,,21,19,40
083 St.Martin in Passeier,5,,19,17,36
083 St.Martin in Passeier,6,,19,12,31
083 St.Martin in Passeier,7,,20,17,37
083 St.Martin in Passeier,8,,13,22,35
083 St.Martin in Passeier,9,,10,21,31
083 St.Martin in Passeier,10,,18,19,37
083 St.Martin in Passeier,11,,26,24,50
083 St.Martin in Passeier,12,,22,20,42
083 St.Martin in Passeier,13,,19,18,37
083 St.Martin in Passeier,14,,21,24,45
083 St.Martin in Passeier,15,,19,23,42
083 St.Martin in Passeier,16,,23,18,41
083 St.Martin in Passeier,17,,23,23,46
083 St.Martin in Passeier,18,,20,25,45
083 St.Martin in Passeier,19,,18,22,40
083 St.Martin in Passeier,20,,16,18,34
083 St.Martin in Passeier,21,,19,28,47
083 St.Martin in Passeier,22,,21,23,44
083 St.Martin in Passeier,23,,19,23,42
083 St.Martin in Passeier,24,,18,29,47
083 St.Martin in Passeier,25,,21,12,33
083 St.Martin in Passeier,26,,24,19,43
083 St.Martin in Passeier,27,,27,25,52
083 St.Martin in Passeier,28,,18,22,40
083 St.Martin in Passeier,29,,21,10,31
083 St.Martin in Passeier,30,,32,16,48
083 St.Martin in Passeier,31,,20,21,41
083 St.Martin in Passeier,32,,20,22,42
083 St.Martin in Passeier,33,,21,20,41
083 St.Martin in Passeier,34,,22,17,39
083 St.Martin in Passeier,35,,25,29,54
083 St.Martin in Passeier,36,,21,23,44
083 St.Martin in Passeier,37,,29,25,54
083 St.Martin in Passeier,38,,32,24,56
083 St.Martin in Passeier,39,,31,24,55
083 St.Martin in Passeier,40,,27,25,52
083 St.Martin in Passeier,41,,22,25,47
083 St.Martin in Passeier,42,,28,32,60
083 St.Martin in Passeier,43,,33,23,56
083 St.Martin in Passeier,44,,16,18,34
083 St.Martin in Passeier,45,,35,20,55
083 St.Martin in Passeier,46,,22,29,51
083 St.Martin in Passeier,47,,35,23,58
083 St.Martin in Passeier,48,,24,23,47
083 St.Martin in Passeier,49,,25,22,47
083 St.Martin in Passeier,50,,25,20,45
083 St.Martin in Passeier,51,,25,13,38
083 St.Martin in Passeier,52,,22,17,39
083 St.Martin in Passeier,53,,30,13,43
083 St.Martin in Passeier,54,,14,11,25
083 St.Martin in Passeier,55,,21,15,36
083 St.Martin in Passeier,56,,6,18,24
083 St.Martin in Passeier,57,,21,13,34
083 St.Martin in Passeier,58,,10,15,25
083 St.Martin in Passeier,59,,14,10,24
083 St.Martin in Passeier,60,,11,11,22
083 St.Martin in Passeier,61,,15,13,28
083 St.Martin in Passeier,62,,12,9,21
083 St.Martin in Passeier,63,,13,12,25
083 St.Martin in Passeier,64,,18,12,30
083 St.Martin in Passeier,65,,12,12,24
083 St.Martin in Passeier,66,,15,14,29
083 St.Martin in Passeier,67,,10,15,25
083 St.Martin in Passeier,68,,4,12,16
083 St.Martin in Passeier,69,,6,14,20
083 St.Martin in Passeier,70,,12,8,20
083 St.Martin in Passeier,71,,15,20,35
083 St.Martin in Passeier,72,,13,14,27
083 St.Martin in Passeier,73,,7,14,21
083 St.Martin in Passeier,74,,15,8,23
083 St.Martin in Passeier,75,,13,9,22
083 St.Martin in Passeier,76,,5,9,14
083 St.Martin in Passeier,77,,4,12,16
083 St.Martin in Passeier,78,,4,11,15
083 St.Martin in Passeier,79,,11,10,21
083 St.Martin in Passeier,80,,6,7,13
083 St.Martin in Passeier,81,,10,6,16
083 St.Martin in Passeier,82,,3,10,13
083 St.Martin in Passeier,83,,4,5,9
083 St.Martin in Passeier,84,,2,10,12
083 St.Martin in Passeier,85,,1,5,6
083 St.Martin in Passeier,86,,2,5,7
083 St.Martin in Passeier,87,,1,10,11
083 St.Martin in Passeier,88,,1,4,5
083 St.Martin in Passeier,89,,1,2,3
083 St.Martin in Passeier,90,,-,2,2
083 St.Martin in Passeier,91,,-,2,2
083 St.Martin in Passeier,92,,-,1,1
083 St.Martin in Passeier,93,,1,-,1
083 St.Martin in Passeier,94,,-,2,2
083 St.Martin in Passeier,97,,1,-,1
083 St.Martin in Passeier,Insgesamt,,1.553,1.538,3.091
084 St.Pankraz,0,,7,11,18
084 St.Pankraz,1,,9,11,20
084 St.Pankraz,2,,9,14,23
084 St.Pankraz,3,,13,9,22
084 St.Pankraz,4,,13,9,22
084 St.Pankraz,5,,12,7,19
084 St.Pankraz,6,,8,3,11
084 St.Pankraz,7,,14,14,28
084 St.Pankraz,8,,11,13,24
084 St.Pankraz,9,,8,4,12
084 St.Pankraz,10,,13,6,19
084 St.Pankraz,11,,8,11,19
084 St.Pankraz,12,,10,8,18
084 St.Pankraz,13,,8,5,13
084 St.Pankraz,14,,8,9,17
084 St.Pankraz,15,,5,11,16
084 St.Pankraz,16,,7,9,16
084 St.Pankraz,17,,11,12,23
084 St.Pankraz,18,,9,3,12
084 St.Pankraz,19,,11,16,27
084 St.Pankraz,20,,14,8,22
084 St.Pankraz,21,,8,7,15
084 St.Pankraz,22,,9,5,14
084 St.Pankraz,23,,10,7,17
084 St.Pankraz,24,,10,4,14
084 St.Pankraz,25,,11,7,18
084 St.Pankraz,26,,10,7,17
084 St.Pankraz,27,,7,12,19
084 St.Pankraz,28,,16,10,26
084 St.Pankraz,29,,3,6,9
084 St.Pankraz,30,,14,9,23
084 St.Pankraz,31,,9,9,18
084 St.Pankraz,32,,5,11,16
084 St.Pankraz,33,,9,11,20
084 St.Pankraz,34,,13,12,25
084 St.Pankraz,35,,11,7,18
084 St.Pankraz,36,,11,20,31
084 St.Pankraz,37,,15,12,27
084 St.Pankraz,38,,13,12,25
084 St.Pankraz,39,,17,10,27
084 St.Pankraz,40,,18,14,32
084 St.Pankraz,41,,10,14,24
084 St.Pankraz,42,,14,6,20
084 St.Pankraz,43,,22,14,36
084 St.Pankraz,44,,14,14,28
084 St.Pankraz,45,,8,10,18
084 St.Pankraz,46,,17,8,25
084 St.Pankraz,47,,14,13,27
084 St.Pankraz,48,,13,4,17
084 St.Pankraz,49,,15,13,28
084 St.Pankraz,50,,6,8,14
084 St.Pankraz,51,,11,9,20
084 St.Pankraz,52,,10,16,26
084 St.Pankraz,53,,6,4,10
084 St.Pankraz,54,,11,8,19
084 St.Pankraz,55,,10,9,19
084 St.Pankraz,56,,14,10,24
084 St.Pankraz,57,,6,2,8
084 St.Pankraz,58,,11,6,17
084 St.Pankraz,59,,8,6,14
084 St.Pankraz,60,,8,3,11
084 St.Pankraz,61,,7,6,13
084 St.Pankraz,62,,4,7,11
084 St.Pankraz,63,,3,6,9
084 St.Pankraz,64,,5,7,12
084 St.Pankraz,65,,12,14,26
084 St.Pankraz,66,,9,14,23
084 St.Pankraz,67,,8,10,18
084 St.Pankraz,68,,8,6,14
084 St.Pankraz,69,,8,7,15
084 St.Pankraz,70,,5,11,16
084 St.Pankraz,71,,9,8,17
084 St.Pankraz,72,,5,5,10
084 St.Pankraz,73,,5,3,8
084 St.Pankraz,74,,6,7,13
084 St.Pankraz,75,,8,2,10
084 St.Pankraz,76,,6,10,16
084 St.Pankraz,77,,7,4,11
084 St.Pankraz,78,,3,5,8
084 St.Pankraz,79,,5,10,15
084 St.Pankraz,80,,7,9,16
084 St.Pankraz,81,,7,3,10
084 St.Pankraz,82,,4,6,10
084 St.Pankraz,83,,4,8,12
084 St.Pankraz,84,,3,7,10
084 St.Pankraz,85,,9,3,12
084 St.Pankraz,86,,5,7,12
084 St.Pankraz,87,,2,6,8
084 St.Pankraz,88,,-,6,6
084 St.Pankraz,89,,-,1,1
084 St.Pankraz,90,,-,1,1
084 St.Pankraz,91,,-,1,1
084 St.Pankraz,93,,-,2,2
084 St.Pankraz,94,,-,1,1
084 St.Pankraz,96,,1,-,1
084 St.Pankraz,99,,-,1,1
084 St.Pankraz,Insgesamt,,820,766,1.586
085 St.Christina in Gröden,0,,11,10,21
085 St.Christina in Gröden,1,,10,10,20
085 St.Christina in Gröden,2,,9,9,18
085 St.Christina in Gröden,3,,14,13,27
085 St.Christina in Gröden,4,,15,12,27
085 St.Christina in Gröden,5,,10,7,17
085 St.Christina in Gröden,6,,11,16,27
085 St.Christina in Gröden,7,,9,13,22
085 St.Christina in Gröden,8,,22,12,34
085 St.Christina in Gröden,9,,20,11,31
085 St.Christina in Gröden,10,,12,15,27
085 St.Christina in Gröden,11,,13,12,25
085 St.Christina in Gröden,12,,12,5,17
085 St.Christina in Gröden,13,,16,10,26
085 St.Christina in Gröden,14,,8,15,23
085 St.Christina in Gröden,15,,14,13,27
085 St.Christina in Gröden,16,,14,14,28
085 St.Christina in Gröden,17,,15,18,33
085 St.Christina in Gröden,18,,8,13,21
085 St.Christina in Gröden,19,,5,9,14
085 St.Christina in Gröden,20,,9,8,17
085 St.Christina in Gröden,21,,12,5,17
085 St.Christina in Gröden,22,,13,9,22
085 St.Christina in Gröden,23,,5,11,16
085 St.Christina in Gröden,24,,10,7,17
085 St.Christina in Gröden,25,,18,12,30
085 St.Christina in Gröden,26,,11,7,18
085 St.Christina in Gröden,27,,12,11,23
085 St.Christina in Gröden,28,,11,16,27
085 St.Christina in Gröden,29,,10,9,19
085 St.Christina in Gröden,30,,4,16,20
085 St.Christina in Gröden,31,,6,10,16
085 St.Christina in Gröden,32,,14,9,23
085 St.Christina in Gröden,33,,15,18,33
085 St.Christina in Gröden,34,,10,20,30
085 St.Christina in Gröden,35,,12,13,25
085 St.Christina in Gröden,36,,16,14,30
085 St.Christina in Gröden,37,,11,16,27
085 St.Christina in Gröden,38,,24,22,46
085 St.Christina in Gröden,39,,23,14,37
085 St.Christina in Gröden,40,,26,25,51
085 St.Christina in Gröden,41,,18,14,32
085 St.Christina in Gröden,42,,20,7,27
085 St.Christina in Gröden,43,,14,14,28
085 St.Christina in Gröden,44,,13,25,38
085 St.Christina in Gröden,45,,13,17,30
085 St.Christina in Gröden,46,,21,13,34
085 St.Christina in Gröden,47,,20,15,35
085 St.Christina in Gröden,48,,21,16,37
085 St.Christina in Gröden,49,,11,9,20
085 St.Christina in Gröden,50,,9,11,20
085 St.Christina in Gröden,51,,17,11,28
085 St.Christina in Gröden,52,,11,10,21
085 St.Christina in Gröden,53,,9,9,18
085 St.Christina in Gröden,54,,13,13,26
085 St.Christina in Gröden,55,,9,10,19
085 St.Christina in Gröden,56,,5,7,12
085 St.Christina in Gröden,57,,11,5,16
085 St.Christina in Gröden,58,,7,5,12
085 St.Christina in Gröden,59,,8,10,18
085 St.Christina in Gröden,60,,8,5,13
085 St.Christina in Gröden,61,,6,7,13
085 St.Christina in Gröden,62,,8,10,18
085 St.Christina in Gröden,63,,6,7,13
085 St.Christina in Gröden,64,,6,11,17
085 St.Christina in Gröden,65,,12,14,26
085 St.Christina in Gröden,66,,9,6,15
085 St.Christina in Gröden,67,,12,8,20
085 St.Christina in Gröden,68,,9,11,20
085 St.Christina in Gröden,69,,9,10,19
085 St.Christina in Gröden,70,,7,7,14
085 St.Christina in Gröden,71,,9,4,13
085 St.Christina in Gröden,72,,11,10,21
085 St.Christina in Gröden,73,,12,4,16
085 St.Christina in Gröden,74,,7,13,20
085 St.Christina in Gröden,75,,5,12,17
085 St.Christina in Gröden,76,,7,8,15
085 St.Christina in Gröden,77,,2,6,8
085 St.Christina in Gröden,78,,12,4,16
085 St.Christina in Gröden,79,,2,10,12
085 St.Christina in Gröden,80,,3,4,7
085 St.Christina in Gröden,81,,5,6,11
085 St.Christina in Gröden,82,,7,5,12
085 St.Christina in Gröden,83,,4,7,11
085 St.Christina in Gröden,84,,1,2,3
085 St.Christina in Gröden,85,,1,4,5
085 St.Christina in Gröden,86,,-,9,9
085 St.Christina in Gröden,87,,2,3,5
085 St.Christina in Gröden,88,,1,2,3
085 St.Christina in Gröden,89,,1,1,2
085 St.Christina in Gröden,92,,-,2,2
085 St.Christina in Gröden,93,,2,1,3
085 St.Christina in Gröden,94,,-,1,1
085 St.Christina in Gröden,95,,2,-,2
085 St.Christina in Gröden,Insgesamt,,958,944,1.902
086 Sarntal,0,,46,54,100
086 Sarntal,1,,53,39,92
086 Sarntal,2,,44,50,94
086 Sarntal,3,,43,36,79
086 Sarntal,4,,40,39,79
086 Sarntal,5,,46,33,79
086 Sarntal,6,,30,42,72
086 Sarntal,7,,51,29,80
086 Sarntal,8,,38,41,79
086 Sarntal,9,,36,37,73
086 Sarntal,10,,52,42,94
086 Sarntal,11,,44,46,90
086 Sarntal,12,,48,43,91
086 Sarntal,13,,42,42,84
086 Sarntal,14,,33,41,74
086 Sarntal,15,,32,39,71
086 Sarntal,16,,43,38,81
086 Sarntal,17,,43,43,86
086 Sarntal,18,,46,33,79
086 Sarntal,19,,55,36,91
086 Sarntal,20,,43,44,87
086 Sarntal,21,,36,30,66
086 Sarntal,22,,38,43,81
086 Sarntal,23,,40,43,83
086 Sarntal,24,,38,42,80
086 Sarntal,25,,54,42,96
086 Sarntal,26,,63,48,111
086 Sarntal,27,,40,59,99
086 Sarntal,28,,57,47,104
086 Sarntal,29,,58,51,109
086 Sarntal,30,,54,55,109
086 Sarntal,31,,59,46,105
086 Sarntal,32,,46,38,84
086 Sarntal,33,,60,47,107
086 Sarntal,34,,49,58,107
086 Sarntal,35,,61,61,122
086 Sarntal,36,,70,41,111
086 Sarntal,37,,45,47,92
086 Sarntal,38,,66,55,121
086 Sarntal,39,,62,54,116
086 Sarntal,40,,55,45,100
086 Sarntal,41,,56,47,103
086 Sarntal,42,,49,49,98
086 Sarntal,43,,66,55,121
086 Sarntal,44,,58,62,120
086 Sarntal,45,,43,44,87
086 Sarntal,46,,61,35,96
086 Sarntal,47,,42,46,88
086 Sarntal,48,,65,46,111
086 Sarntal,49,,40,43,83
086 Sarntal,50,,55,43,98
086 Sarntal,51,,36,42,78
086 Sarntal,52,,39,29,68
086 Sarntal,53,,41,41,82
086 Sarntal,54,,36,30,66
086 Sarntal,55,,43,30,73
086 Sarntal,56,,35,42,77
086 Sarntal,57,,45,34,79
086 Sarntal,58,,37,34,71
086 Sarntal,59,,50,26,76
086 Sarntal,60,,32,38,70
086 Sarntal,61,,36,28,64
086 Sarntal,62,,34,37,71
086 Sarntal,63,,29,32,61
086 Sarntal,64,,30,30,60
086 Sarntal,65,,36,38,74
086 Sarntal,66,,40,37,77
086 Sarntal,67,,34,28,62
086 Sarntal,68,,29,43,72
086 Sarntal,69,,37,31,68
086 Sarntal,70,,31,29,60
086 Sarntal,71,,23,32,55
086 Sarntal,72,,18,24,42
086 Sarntal,73,,17,24,41
086 Sarntal,74,,23,19,42
086 Sarntal,75,,21,21,42
086 Sarntal,76,,21,24,45
086 Sarntal,77,,14,23,37
086 Sarntal,78,,15,20,35
086 Sarntal,79,,16,28,44
086 Sarntal,80,,17,23,40
086 Sarntal,81,,14,30,44
086 Sarntal,82,,13,13,26
086 Sarntal,83,,17,17,34
086 Sarntal,84,,3,18,21
086 Sarntal,85,,7,16,23
086 Sarntal,86,,5,22,27
086 Sarntal,87,,4,7,11
086 Sarntal,88,,2,12,14
086 Sarntal,89,,2,11,13
086 Sarntal,90,,1,7,8
086 Sarntal,91,,1,3,4
086 Sarntal,92,,-,1,1
086 Sarntal,93,,-,2,2
086 Sarntal,95,,4,3,7
086 Sarntal,96,,-,1,1
086 Sarntal,101,,1,1,2
086 Sarntal,Insgesamt,,3.483,3.350,6.833
087 Schenna,0,,18,18,36
087 Schenna,1,,10,12,22
087 Schenna,2,,23,21,44
087 Schenna,3,,11,10,21
087 Schenna,4,,18,19,37
087 Schenna,5,,12,15,27
087 Schenna,6,,16,18,34
087 Schenna,7,,17,14,31
087 Schenna,8,,19,19,38
087 Schenna,9,,23,18,41
087 Schenna,10,,16,10,26
087 Schenna,11,,13,19,32
087 Schenna,12,,16,18,34
087 Schenna,13,,20,18,38
087 Schenna,14,,19,16,35
087 Schenna,15,,12,8,20
087 Schenna,16,,17,17,34
087 Schenna,17,,11,20,31
087 Schenna,18,,19,16,35
087 Schenna,19,,22,11,33
087 Schenna,20,,21,19,40
087 Schenna,21,,21,17,38
087 Schenna,22,,19,12,31
087 Schenna,23,,16,17,33
087 Schenna,24,,16,13,29
087 Schenna,25,,14,8,22
087 Schenna,26,,12,14,26
087 Schenna,27,,23,11,34
087 Schenna,28,,19,21,40
087 Schenna,29,,23,20,43
087 Schenna,30,,11,21,32
087 Schenna,31,,19,23,42
087 Schenna,32,,23,15,38
087 Schenna,33,,20,27,47
087 Schenna,34,,33,23,56
087 Schenna,35,,22,20,42
087 Schenna,36,,26,17,43
087 Schenna,37,,26,26,52
087 Schenna,38,,21,25,46
087 Schenna,39,,27,20,47
087 Schenna,40,,24,19,43
087 Schenna,41,,28,20,48
087 Schenna,42,,17,19,36
087 Schenna,43,,27,30,57
087 Schenna,44,,20,25,45
087 Schenna,45,,26,19,45
087 Schenna,46,,20,12,32
087 Schenna,47,,29,22,51
087 Schenna,48,,35,24,59
087 Schenna,49,,13,13,26
087 Schenna,50,,23,19,42
087 Schenna,51,,13,19,32
087 Schenna,52,,17,18,35
087 Schenna,53,,11,16,27
087 Schenna,54,,14,17,31
087 Schenna,55,,16,15,31
087 Schenna,56,,11,16,27
087 Schenna,57,,13,12,25
087 Schenna,58,,18,14,32
087 Schenna,59,,20,18,38
087 Schenna,60,,15,16,31
087 Schenna,61,,17,18,35
087 Schenna,62,,17,21,38
087 Schenna,63,,16,14,30
087 Schenna,64,,16,9,25
087 Schenna,65,,19,13,32
087 Schenna,66,,9,19,28
087 Schenna,67,,12,13,25
087 Schenna,68,,10,9,19
087 Schenna,69,,9,13,22
087 Schenna,70,,16,16,32
087 Schenna,71,,7,10,17
087 Schenna,72,,8,12,20
087 Schenna,73,,13,9,22
087 Schenna,74,,12,15,27
087 Schenna,75,,7,9,16
087 Schenna,76,,9,11,20
087 Schenna,77,,9,10,19
087 Schenna,78,,11,6,17
087 Schenna,79,,6,9,15
087 Schenna,80,,7,8,15
087 Schenna,81,,2,12,14
087 Schenna,82,,5,7,12
087 Schenna,83,,2,7,9
087 Schenna,84,,7,6,13
087 Schenna,85,,3,3,6
087 Schenna,86,,4,4,8
087 Schenna,87,,4,7,11
087 Schenna,88,,2,3,5
087 Schenna,89,,-,3,3
087 Schenna,92,,1,1,2
087 Schenna,94,,1,-,1
087 Schenna,95,,-,2,2
087 Schenna,96,,-,1,1
087 Schenna,98,,-,1,1
087 Schenna,102,,1,-,1
087 Schenna,Insgesamt,,1.416,1.370,2.786
088 Mühlwald,0,,9,7,16
088 Mühlwald,1,,10,8,18
088 Mühlwald,2,,4,12,16
088 Mühlwald,3,,7,5,12
088 Mühlwald,4,,10,10,20
088 Mühlwald,5,,16,10,26
088 Mühlwald,6,,9,13,22
088 Mühlwald,7,,10,14,24
088 Mühlwald,8,,8,11,19
088 Mühlwald,9,,13,10,23
088 Mühlwald,10,,13,14,27
088 Mühlwald,11,,11,8,19
088 Mühlwald,12,,14,13,27
088 Mühlwald,13,,13,4,17
088 Mühlwald,14,,9,6,15
088 Mühlwald,15,,14,12,26
088 Mühlwald,16,,5,5,10
088 Mühlwald,17,,11,6,17
088 Mühlwald,18,,9,6,15
088 Mühlwald,19,,16,8,24
088 Mühlwald,20,,7,4,11
088 Mühlwald,21,,9,15,24
088 Mühlwald,22,,6,7,13
088 Mühlwald,23,,11,17,28
088 Mühlwald,24,,11,15,26
088 Mühlwald,25,,10,7,17
088 Mühlwald,26,,7,12,19
088 Mühlwald,27,,14,13,27
088 Mühlwald,28,,18,2,20
088 Mühlwald,29,,7,15,22
088 Mühlwald,30,,12,8,20
088 Mühlwald,31,,8,6,14
088 Mühlwald,32,,13,10,23
088 Mühlwald,33,,11,8,19
088 Mühlwald,34,,9,6,15
088 Mühlwald,35,,15,10,25
088 Mühlwald,36,,9,9,18
088 Mühlwald,37,,18,14,32
088 Mühlwald,38,,8,9,17
088 Mühlwald,39,,14,16,30
088 Mühlwald,40,,16,10,26
088 Mühlwald,41,,18,13,31
088 Mühlwald,42,,13,7,20
088 Mühlwald,43,,17,12,29
088 Mühlwald,44,,17,10,27
088 Mühlwald,45,,10,11,21
088 Mühlwald,46,,8,11,19
088 Mühlwald,47,,6,10,16
088 Mühlwald,48,,14,9,23
088 Mühlwald,49,,13,5,18
088 Mühlwald,50,,9,5,14
088 Mühlwald,51,,13,12,25
088 Mühlwald,52,,7,8,15
088 Mühlwald,53,,7,7,14
088 Mühlwald,54,,9,4,13
088 Mühlwald,55,,10,9,19
088 Mühlwald,56,,9,8,17
088 Mühlwald,57,,10,4,14
088 Mühlwald,58,,5,9,14
088 Mühlwald,59,,9,3,12
088 Mühlwald,60,,12,4,16
088 Mühlwald,61,,10,8,18
088 Mühlwald,62,,8,3,11
088 Mühlwald,63,,4,4,8
088 Mühlwald,64,,8,4,12
088 Mühlwald,65,,10,2,12
088 Mühlwald,66,,6,7,13
088 Mühlwald,67,,4,7,11
088 Mühlwald,68,,4,9,13
088 Mühlwald,69,,6,11,17
088 Mühlwald,70,,8,4,12
088 Mühlwald,71,,11,3,14
088 Mühlwald,72,,4,3,7
088 Mühlwald,73,,4,3,7
088 Mühlwald,74,,4,6,10
088 Mühlwald,75,,3,10,13
088 Mühlwald,76,,1,2,3
088 Mühlwald,77,,5,5,10
088 Mühlwald,78,,3,5,8
088 Mühlwald,79,,6,7,13
088 Mühlwald,80,,4,4,8
088 Mühlwald,81,,5,2,7
088 Mühlwald,82,,2,5,7
088 Mühlwald,83,,3,1,4
088 Mühlwald,84,,4,2,6
088 Mühlwald,85,,-,3,3
088 Mühlwald,86,,-,2,2
088 Mühlwald,87,,-,5,5
088 Mühlwald,88,,1,-,1
088 Mühlwald,89,,-,1,1
088 Mühlwald,91,,2,-,2
088 Mühlwald,93,,-,1,1
088 Mühlwald,95,,-,1,1
088 Mühlwald,100,,1,-,1
088 Mühlwald,Insgesamt,,791,686,1.477
089 Wolkenstein in Gröden,0,,17,10,27
089 Wolkenstein in Gröden,1,,17,14,31
089 Wolkenstein in Gröden,2,,11,16,27
089 Wolkenstein in Gröden,3,,14,19,33
089 Wolkenstein in Gröden,4,,13,8,21
089 Wolkenstein in Gröden,5,,16,19,35
089 Wolkenstein in Gröden,6,,25,19,44
089 Wolkenstein in Gröden,7,,20,19,39
089 Wolkenstein in Gröden,8,,19,22,41
089 Wolkenstein in Gröden,9,,13,17,30
089 Wolkenstein in Gröden,10,,14,23,37
089 Wolkenstein in Gröden,11,,21,29,50
089 Wolkenstein in Gröden,12,,15,12,27
089 Wolkenstein in Gröden,13,,17,12,29
089 Wolkenstein in Gröden,14,,15,17,32
089 Wolkenstein in Gröden,15,,14,17,31
089 Wolkenstein in Gröden,16,,22,15,37
089 Wolkenstein in Gröden,17,,18,18,36
089 Wolkenstein in Gröden,18,,13,10,23
089 Wolkenstein in Gröden,19,,15,13,28
089 Wolkenstein in Gröden,20,,17,17,34
089 Wolkenstein in Gröden,21,,11,21,32
089 Wolkenstein in Gröden,22,,15,13,28
089 Wolkenstein in Gröden,23,,17,10,27
089 Wolkenstein in Gröden,24,,13,11,24
089 Wolkenstein in Gröden,25,,15,11,26
089 Wolkenstein in Gröden,26,,10,14,24
089 Wolkenstein in Gröden,27,,15,9,24
089 Wolkenstein in Gröden,28,,17,14,31
089 Wolkenstein in Gröden,29,,7,16,23
089 Wolkenstein in Gröden,30,,8,10,18
089 Wolkenstein in Gröden,31,,12,12,24
089 Wolkenstein in Gröden,32,,16,11,27
089 Wolkenstein in Gröden,33,,23,17,40
089 Wolkenstein in Gröden,34,,11,19,30
089 Wolkenstein in Gröden,35,,24,23,47
089 Wolkenstein in Gröden,36,,20,23,43
089 Wolkenstein in Gröden,37,,21,24,45
089 Wolkenstein in Gröden,38,,23,26,49
089 Wolkenstein in Gröden,39,,28,22,50
089 Wolkenstein in Gröden,40,,26,24,50
089 Wolkenstein in Gröden,41,,31,27,58
089 Wolkenstein in Gröden,42,,25,23,48
089 Wolkenstein in Gröden,43,,23,33,56
089 Wolkenstein in Gröden,44,,29,21,50
089 Wolkenstein in Gröden,45,,23,21,44
089 Wolkenstein in Gröden,46,,22,20,42
089 Wolkenstein in Gröden,47,,26,25,51
089 Wolkenstein in Gröden,48,,24,23,47
089 Wolkenstein in Gröden,49,,12,16,28
089 Wolkenstein in Gröden,50,,17,16,33
089 Wolkenstein in Gröden,51,,20,16,36
089 Wolkenstein in Gröden,52,,10,14,24
089 Wolkenstein in Gröden,53,,12,10,22
089 Wolkenstein in Gröden,54,,13,10,23
089 Wolkenstein in Gröden,55,,8,12,20
089 Wolkenstein in Gröden,56,,11,7,18
089 Wolkenstein in Gröden,57,,13,12,25
089 Wolkenstein in Gröden,58,,6,17,23
089 Wolkenstein in Gröden,59,,16,11,27
089 Wolkenstein in Gröden,60,,13,13,26
089 Wolkenstein in Gröden,61,,9,17,26
089 Wolkenstein in Gröden,62,,17,18,35
089 Wolkenstein in Gröden,63,,5,14,19
089 Wolkenstein in Gröden,64,,12,9,21
089 Wolkenstein in Gröden,65,,21,14,35
089 Wolkenstein in Gröden,66,,11,12,23
089 Wolkenstein in Gröden,67,,14,16,30
089 Wolkenstein in Gröden,68,,14,16,30
089 Wolkenstein in Gröden,69,,18,14,32
089 Wolkenstein in Gröden,70,,19,8,27
089 Wolkenstein in Gröden,71,,10,19,29
089 Wolkenstein in Gröden,72,,9,15,24
089 Wolkenstein in Gröden,73,,14,6,20
089 Wolkenstein in Gröden,74,,15,10,25
089 Wolkenstein in Gröden,75,,6,10,16
089 Wolkenstein in Gröden,76,,5,9,14
089 Wolkenstein in Gröden,77,,8,9,17
089 Wolkenstein in Gröden,78,,7,10,17
089 Wolkenstein in Gröden,79,,7,7,14
089 Wolkenstein in Gröden,80,,5,9,14
089 Wolkenstein in Gröden,81,,8,5,13
089 Wolkenstein in Gröden,82,,7,4,11
089 Wolkenstein in Gröden,83,,4,7,11
089 Wolkenstein in Gröden,84,,2,10,12
089 Wolkenstein in Gröden,85,,4,5,9
089 Wolkenstein in Gröden,86,,5,9,14
089 Wolkenstein in Gröden,87,,1,4,5
089 Wolkenstein in Gröden,88,,3,4,7
089 Wolkenstein in Gröden,89,,1,2,3
089 Wolkenstein in Gröden,91,,1,2,3
089 Wolkenstein in Gröden,93,,-,1,1
089 Wolkenstein in Gröden,94,,-,1,1
089 Wolkenstein in Gröden,96,,-,1,1
089 Wolkenstein in Gröden,97,,-,2,2
089 Wolkenstein in Gröden,99,,-,1,1
089 Wolkenstein in Gröden,Insgesamt,,1.294,1.323,2.617
091 Schnals,0,,9,4,13
091 Schnals,1,,4,6,10
091 Schnals,2,,3,3,6
091 Schnals,3,,4,4,8
091 Schnals,4,,7,5,12
091 Schnals,5,,2,5,7
091 Schnals,6,,12,1,13
091 Schnals,7,,4,4,8
091 Schnals,8,,5,5,10
091 Schnals,9,,6,9,15
091 Schnals,10,,7,16,23
091 Schnals,11,,12,10,22
091 Schnals,12,,7,13,20
091 Schnals,13,,5,8,13
091 Schnals,14,,4,7,11
091 Schnals,15,,11,5,16
091 Schnals,16,,13,10,23
091 Schnals,17,,13,9,22
091 Schnals,18,,5,7,12
091 Schnals,19,,19,9,28
091 Schnals,20,,10,5,15
091 Schnals,21,,11,8,19
091 Schnals,22,,9,10,19
091 Schnals,23,,6,8,14
091 Schnals,24,,13,13,26
091 Schnals,25,,7,7,14
091 Schnals,26,,10,6,16
091 Schnals,27,,17,8,25
091 Schnals,28,,11,11,22
091 Schnals,29,,5,11,16
091 Schnals,30,,11,8,19
091 Schnals,31,,9,6,15
091 Schnals,32,,11,1,12
091 Schnals,33,,4,6,10
091 Schnals,34,,13,7,20
091 Schnals,35,,8,7,15
091 Schnals,36,,8,10,18
091 Schnals,37,,11,12,23
091 Schnals,38,,12,8,20
091 Schnals,39,,13,8,21
091 Schnals,40,,10,10,20
091 Schnals,41,,17,11,28
091 Schnals,42,,14,15,29
091 Schnals,43,,17,8,25
091 Schnals,44,,7,9,16
091 Schnals,45,,10,15,25
091 Schnals,46,,13,10,23
091 Schnals,47,,11,13,24
091 Schnals,48,,10,8,18
091 Schnals,49,,17,13,30
091 Schnals,50,,11,11,22
091 Schnals,51,,13,5,18
091 Schnals,52,,12,5,17
091 Schnals,53,,9,6,15
091 Schnals,54,,10,10,20
091 Schnals,55,,12,8,20
091 Schnals,56,,14,7,21
091 Schnals,57,,12,9,21
091 Schnals,58,,10,7,17
091 Schnals,59,,10,9,19
091 Schnals,60,,3,3,6
091 Schnals,61,,9,8,17
091 Schnals,62,,5,6,11
091 Schnals,63,,6,4,10
091 Schnals,64,,4,7,11
091 Schnals,65,,6,8,14
091 Schnals,66,,4,4,8
091 Schnals,67,,3,4,7
091 Schnals,68,,7,7,14
091 Schnals,69,,6,7,13
091 Schnals,70,,1,11,12
091 Schnals,71,,7,5,12
091 Schnals,72,,5,5,10
091 Schnals,73,,2,5,7
091 Schnals,74,,2,4,6
091 Schnals,75,,4,3,7
091 Schnals,76,,2,10,12
091 Schnals,77,,2,4,6
091 Schnals,78,,-,5,5
091 Schnals,79,,5,6,11
091 Schnals,80,,1,5,6
091 Schnals,81,,1,7,8
091 Schnals,82,,9,3,12
091 Schnals,83,,4,10,14
091 Schnals,84,,-,5,5
091 Schnals,85,,-,2,2
091 Schnals,86,,4,2,6
091 Schnals,87,,-,4,4
091 Schnals,88,,-,2,2
091 Schnals,89,,-,1,1
091 Schnals,90,,2,2,4
091 Schnals,91,,-,2,2
091 Schnals,92,,-,2,2
091 Schnals,93,,-,2,2
091 Schnals,94,,-,1,1
091 Schnals,95,,-,1,1
091 Schnals,96,,1,-,1
091 Schnals,97,,-,1,1
091 Schnals,99,,-,1,1
091 Schnals,Insgesamt,,695,658,1.353
092 Sexten,0,,4,6,10
092 Sexten,1,,6,17,23
092 Sexten,2,,7,8,15
092 Sexten,3,,9,8,17
092 Sexten,4,,12,7,19
092 Sexten,5,,11,9,20
092 Sexten,6,,17,18,35
092 Sexten,7,,16,12,28
092 Sexten,8,,9,15,24
092 Sexten,9,,8,15,23
092 Sexten,10,,13,7,20
092 Sexten,11,,13,10,23
092 Sexten,12,,14,12,26
092 Sexten,13,,15,13,28
092 Sexten,14,,16,11,27
092 Sexten,15,,9,5,14
092 Sexten,16,,14,10,24
092 Sexten,17,,12,13,25
092 Sexten,18,,11,19,30
092 Sexten,19,,9,9,18
092 Sexten,20,,10,5,15
092 Sexten,21,,13,7,20
092 Sexten,22,,6,9,15
092 Sexten,23,,10,11,21
092 Sexten,24,,6,9,15
092 Sexten,25,,10,9,19
092 Sexten,26,,10,15,25
092 Sexten,27,,15,12,27
092 Sexten,28,,15,7,22
092 Sexten,29,,12,21,33
092 Sexten,30,,10,9,19
092 Sexten,31,,8,3,11
092 Sexten,32,,18,13,31
092 Sexten,33,,8,8,16
092 Sexten,34,,9,5,14
092 Sexten,35,,10,9,19
092 Sexten,36,,14,19,33
092 Sexten,37,,15,15,30
092 Sexten,38,,12,18,30
092 Sexten,39,,22,18,40
092 Sexten,40,,14,18,32
092 Sexten,41,,21,18,39
092 Sexten,42,,15,17,32
092 Sexten,43,,17,18,35
092 Sexten,44,,18,19,37
092 Sexten,45,,28,19,47
092 Sexten,46,,13,18,31
092 Sexten,47,,18,13,31
092 Sexten,48,,21,9,30
092 Sexten,49,,15,14,29
092 Sexten,50,,22,15,37
092 Sexten,51,,18,13,31
092 Sexten,52,,14,14,28
092 Sexten,53,,9,12,21
092 Sexten,54,,11,13,24
092 Sexten,55,,5,11,16
092 Sexten,56,,6,11,17
092 Sexten,57,,7,9,16
092 Sexten,58,,11,7,18
092 Sexten,59,,6,4,10
092 Sexten,60,,10,7,17
092 Sexten,61,,10,4,14
092 Sexten,62,,5,9,14
092 Sexten,63,,7,4,11
092 Sexten,64,,6,12,18
092 Sexten,65,,8,6,14
092 Sexten,66,,5,6,11
092 Sexten,67,,9,16,25
092 Sexten,68,,8,12,20
092 Sexten,69,,6,10,16
092 Sexten,70,,13,11,24
092 Sexten,71,,11,8,19
092 Sexten,72,,7,10,17
092 Sexten,73,,9,15,24
092 Sexten,74,,11,7,18
092 Sexten,75,,3,10,13
092 Sexten,76,,5,7,12
092 Sexten,77,,8,13,21
092 Sexten,78,,7,11,18
092 Sexten,79,,6,13,19
092 Sexten,80,,7,11,18
092 Sexten,81,,6,15,21
092 Sexten,82,,5,4,9
092 Sexten,83,,3,9,12
092 Sexten,84,,5,6,11
092 Sexten,85,,3,7,10
092 Sexten,86,,3,7,10
092 Sexten,87,,2,6,8
092 Sexten,88,,1,3,4
092 Sexten,89,,-,3,3
092 Sexten,91,,-,1,1
092 Sexten,92,,-,1,1
092 Sexten,94,,1,-,1
092 Sexten,95,,-,1,1
092 Sexten,96,,-,1,1
092 Sexten,Insgesamt,,937,984,1.921
093 Schlanders,0,,28,27,55
093 Schlanders,1,,28,32,60
093 Schlanders,2,,28,21,49
093 Schlanders,3,,28,35,63
093 Schlanders,4,,28,35,63
093 Schlanders,5,,27,23,50
093 Schlanders,6,,27,32,59
093 Schlanders,7,,30,31,61
093 Schlanders,8,,38,38,76
093 Schlanders,9,,24,40,64
093 Schlanders,10,,42,40,82
093 Schlanders,11,,56,47,103
093 Schlanders,12,,42,36,78
093 Schlanders,13,,37,28,65
093 Schlanders,14,,41,40,81
093 Schlanders,15,,45,43,88
093 Schlanders,16,,36,45,81
093 Schlanders,17,,41,40,81
093 Schlanders,18,,53,43,96
093 Schlanders,19,,36,35,71
093 Schlanders,20,,37,41,78
093 Schlanders,21,,36,30,66
093 Schlanders,22,,35,34,69
093 Schlanders,23,,40,37,77
093 Schlanders,24,,39,47,86
093 Schlanders,25,,35,39,74
093 Schlanders,26,,48,45,93
093 Schlanders,27,,45,46,91
093 Schlanders,28,,39,35,74
093 Schlanders,29,,30,39,69
093 Schlanders,30,,42,39,81
093 Schlanders,31,,36,42,78
093 Schlanders,32,,33,26,59
093 Schlanders,33,,38,38,76
093 Schlanders,34,,47,35,82
093 Schlanders,35,,37,50,87
093 Schlanders,36,,56,36,92
093 Schlanders,37,,47,46,93
093 Schlanders,38,,47,53,100
093 Schlanders,39,,62,41,103
093 Schlanders,40,,49,39,88
093 Schlanders,41,,46,57,103
093 Schlanders,42,,43,56,99
093 Schlanders,43,,55,51,106
093 Schlanders,44,,41,43,84
093 Schlanders,45,,56,59,115
093 Schlanders,46,,54,46,100
093 Schlanders,47,,41,57,98
093 Schlanders,48,,45,44,89
093 Schlanders,49,,38,40,78
093 Schlanders,50,,47,55,102
093 Schlanders,51,,41,36,77
093 Schlanders,52,,25,35,60
093 Schlanders,53,,26,37,63
093 Schlanders,54,,32,33,65
093 Schlanders,55,,34,37,71
093 Schlanders,56,,32,23,55
093 Schlanders,57,,27,31,58
093 Schlanders,58,,24,30,54
093 Schlanders,59,,29,37,66
093 Schlanders,60,,37,27,64
093 Schlanders,61,,22,22,44
093 Schlanders,62,,28,20,48
093 Schlanders,63,,31,16,47
093 Schlanders,64,,27,31,58
093 Schlanders,65,,30,33,63
093 Schlanders,66,,35,35,70
093 Schlanders,67,,32,36,68
093 Schlanders,68,,26,29,55
093 Schlanders,69,,29,34,63
093 Schlanders,70,,14,19,33
093 Schlanders,71,,25,24,49
093 Schlanders,72,,17,26,43
093 Schlanders,73,,15,23,38
093 Schlanders,74,,17,21,38
093 Schlanders,75,,19,30,49
093 Schlanders,76,,17,16,33
093 Schlanders,77,,20,17,37
093 Schlanders,78,,15,25,40
093 Schlanders,79,,12,14,26
093 Schlanders,80,,14,21,35
093 Schlanders,81,,12,21,33
093 Schlanders,82,,10,19,29
093 Schlanders,83,,9,17,26
093 Schlanders,84,,9,15,24
093 Schlanders,85,,7,14,21
093 Schlanders,86,,3,12,15
093 Schlanders,87,,4,9,13
093 Schlanders,88,,1,13,14
093 Schlanders,89,,2,8,10
093 Schlanders,90,,3,9,12
093 Schlanders,91,,2,1,3
093 Schlanders,92,,-,1,1
093 Schlanders,93,,2,2,4
093 Schlanders,94,,2,2,4
093 Schlanders,95,,-,1,1
093 Schlanders,96,,-,2,2
093 Schlanders,97,,-,1,1
093 Schlanders,98,,-,2,2
093 Schlanders,99,,-,1,1
093 Schlanders,Insgesamt,,2.877,3.025,5.902
094 Schluderns,0,,9,2,11
094 Schluderns,1,,13,14,27
094 Schluderns,2,,7,10,17
094 Schluderns,3,,6,6,12
094 Schluderns,4,,6,13,19
094 Schluderns,5,,14,9,23
094 Schluderns,6,,14,8,22
094 Schluderns,7,,12,8,20
094 Schluderns,8,,19,8,27
094 Schluderns,9,,8,14,22
094 Schluderns,10,,7,10,17
094 Schluderns,11,,12,11,23
094 Schluderns,12,,12,16,28
094 Schluderns,13,,10,11,21
094 Schluderns,14,,14,18,32
094 Schluderns,15,,16,6,22
094 Schluderns,16,,9,10,19
094 Schluderns,17,,9,9,18
094 Schluderns,18,,22,7,29
094 Schluderns,19,,15,12,27
094 Schluderns,20,,11,12,23
094 Schluderns,21,,6,10,16
094 Schluderns,22,,13,21,34
094 Schluderns,23,,19,12,31
094 Schluderns,24,,14,13,27
094 Schluderns,25,,11,4,15
094 Schluderns,26,,9,17,26
094 Schluderns,27,,21,14,35
094 Schluderns,28,,6,10,16
094 Schluderns,29,,6,15,21
094 Schluderns,30,,12,12,24
094 Schluderns,31,,13,9,22
094 Schluderns,32,,10,19,29
094 Schluderns,33,,17,10,27
094 Schluderns,34,,18,15,33
094 Schluderns,35,,19,10,29
094 Schluderns,36,,13,12,25
094 Schluderns,37,,10,12,22
094 Schluderns,38,,13,12,25
094 Schluderns,39,,17,11,28
094 Schluderns,40,,17,19,36
094 Schluderns,41,,14,16,30
094 Schluderns,42,,17,16,33
094 Schluderns,43,,25,10,35
094 Schluderns,44,,26,12,38
094 Schluderns,45,,13,18,31
094 Schluderns,46,,11,20,31
094 Schluderns,47,,15,15,30
094 Schluderns,48,,12,6,18
094 Schluderns,49,,13,19,32
094 Schluderns,50,,10,13,23
094 Schluderns,51,,16,7,23
094 Schluderns,52,,10,16,26
094 Schluderns,53,,17,11,28
094 Schluderns,54,,14,7,21
094 Schluderns,55,,13,8,21
094 Schluderns,56,,7,6,13
094 Schluderns,57,,11,3,14
094 Schluderns,58,,9,14,23
094 Schluderns,59,,13,10,23
094 Schluderns,60,,9,10,19
094 Schluderns,61,,7,6,13
094 Schluderns,62,,8,9,17
094 Schluderns,63,,7,3,10
094 Schluderns,64,,4,12,16
094 Schluderns,65,,3,8,11
094 Schluderns,66,,8,7,15
094 Schluderns,67,,10,14,24
094 Schluderns,68,,8,4,12
094 Schluderns,69,,13,8,21
094 Schluderns,70,,8,8,16
094 Schluderns,71,,5,9,14
094 Schluderns,72,,4,6,10
094 Schluderns,73,,5,10,15
094 Schluderns,74,,8,11,19
094 Schluderns,75,,5,9,14
094 Schluderns,76,,10,10,20
094 Schluderns,77,,4,7,11
094 Schluderns,78,,6,9,15
094 Schluderns,79,,4,6,10
094 Schluderns,80,,5,8,13
094 Schluderns,81,,3,1,4
094 Schluderns,82,,2,10,12
094 Schluderns,83,,2,6,8
094 Schluderns,84,,2,2,4
094 Schluderns,85,,1,5,6
094 Schluderns,86,,4,2,6
094 Schluderns,87,,-,4,4
094 Schluderns,88,,-,1,1
094 Schluderns,89,,2,2,4
094 Schluderns,90,,2,2,4
094 Schluderns,91,,1,2,3
094 Schluderns,93,,-,2,2
094 Schluderns,94,,1,1,2
094 Schluderns,95,,1,-,1
094 Schluderns,99,,-,1,1
094 Schluderns,Insgesamt,,937,913,1.850
095 Stilfs,0,,6,6,12
095 Stilfs,1,,2,5,7
095 Stilfs,2,,7,4,11
095 Stilfs,3,,5,5,10
095 Stilfs,4,,7,5,12
095 Stilfs,5,,6,6,12
095 Stilfs,6,,5,3,8
095 Stilfs,7,,5,11,16
095 Stilfs,8,,10,5,15
095 Stilfs,9,,2,7,9
095 Stilfs,10,,7,3,10
095 Stilfs,11,,9,11,20
095 Stilfs,12,,12,1,13
095 Stilfs,13,,7,6,13
095 Stilfs,14,,8,6,14
095 Stilfs,15,,6,15,21
095 Stilfs,16,,3,8,11
095 Stilfs,17,,10,5,15
095 Stilfs,18,,17,8,25
095 Stilfs,19,,9,6,15
095 Stilfs,20,,6,5,11
095 Stilfs,21,,6,8,14
095 Stilfs,22,,9,8,17
095 Stilfs,23,,13,5,18
095 Stilfs,24,,13,8,21
095 Stilfs,25,,9,4,13
095 Stilfs,26,,12,4,16
095 Stilfs,27,,8,6,14
095 Stilfs,28,,6,5,11
095 Stilfs,29,,6,7,13
095 Stilfs,30,,6,10,16
095 Stilfs,31,,8,3,11
095 Stilfs,32,,14,2,16
095 Stilfs,33,,8,8,16
095 Stilfs,34,,6,6,12
095 Stilfs,35,,9,18,27
095 Stilfs,36,,11,10,21
095 Stilfs,37,,13,11,24
095 Stilfs,38,,10,12,22
095 Stilfs,39,,12,11,23
095 Stilfs,40,,8,10,18
095 Stilfs,41,,8,9,17
095 Stilfs,42,,15,9,24
095 Stilfs,43,,12,11,23
095 Stilfs,44,,11,5,16
095 Stilfs,45,,10,6,16
095 Stilfs,46,,8,13,21
095 Stilfs,47,,9,2,11
095 Stilfs,48,,8,7,15
095 Stilfs,49,,9,8,17
095 Stilfs,50,,6,13,19
095 Stilfs,51,,10,6,16
095 Stilfs,52,,5,11,16
095 Stilfs,53,,4,3,7
095 Stilfs,54,,15,9,24
095 Stilfs,55,,10,4,14
095 Stilfs,56,,11,5,16
095 Stilfs,57,,14,9,23
095 Stilfs,58,,2,6,8
095 Stilfs,59,,6,3,9
095 Stilfs,60,,8,9,17
095 Stilfs,61,,6,4,10
095 Stilfs,62,,10,9,19
095 Stilfs,63,,2,4,6
095 Stilfs,64,,13,8,21
095 Stilfs,65,,9,7,16
095 Stilfs,66,,5,12,17
095 Stilfs,67,,7,4,11
095 Stilfs,68,,7,10,17
095 Stilfs,69,,4,9,13
095 Stilfs,70,,4,4,8
095 Stilfs,71,,7,5,12
095 Stilfs,72,,3,9,12
095 Stilfs,73,,3,6,9
095 Stilfs,74,,4,4,8
095 Stilfs,75,,3,6,9
095 Stilfs,76,,3,6,9
095 Stilfs,77,,2,4,6
095 Stilfs,78,,5,5,10
095 Stilfs,79,,4,1,5
095 Stilfs,80,,4,7,11
095 Stilfs,81,,4,6,10
095 Stilfs,82,,2,5,7
095 Stilfs,83,,3,3,6
095 Stilfs,84,,-,6,6
095 Stilfs,85,,-,4,4
095 Stilfs,86,,1,5,6
095 Stilfs,87,,1,5,6
095 Stilfs,88,,-,4,4
095 Stilfs,89,,1,-,1
095 Stilfs,90,,-,1,1
095 Stilfs,91,,-,1,1
095 Stilfs,92,,-,1,1
095 Stilfs,94,,1,-,1
095 Stilfs,96,,-,1,1
095 Stilfs,Insgesamt,,635,601,1.236
096 Terenten,0,,9,6,15
096 Terenten,1,,11,11,22
096 Terenten,2,,13,9,22
096 Terenten,3,,16,10,26
096 Terenten,4,,11,17,28
096 Terenten,5,,9,12,21
096 Terenten,6,,8,8,16
096 Terenten,7,,11,14,25
096 Terenten,8,,9,10,19
096 Terenten,9,,10,17,27
096 Terenten,10,,20,19,39
096 Terenten,11,,9,7,16
096 Terenten,12,,13,11,24
096 Terenten,13,,12,7,19
096 Terenten,14,,13,13,26
096 Terenten,15,,7,12,19
096 Terenten,16,,9,8,17
096 Terenten,17,,6,16,22
096 Terenten,18,,12,15,27
096 Terenten,19,,14,7,21
096 Terenten,20,,10,7,17
096 Terenten,21,,16,7,23
096 Terenten,22,,9,8,17
096 Terenten,23,,10,14,24
096 Terenten,24,,12,11,23
096 Terenten,25,,14,17,31
096 Terenten,26,,12,9,21
096 Terenten,27,,14,10,24
096 Terenten,28,,12,14,26
096 Terenten,29,,9,11,20
096 Terenten,30,,17,15,32
096 Terenten,31,,11,5,16
096 Terenten,32,,16,10,26
096 Terenten,33,,15,10,25
096 Terenten,34,,16,15,31
096 Terenten,35,,7,17,24
096 Terenten,36,,17,10,27
096 Terenten,37,,15,17,32
096 Terenten,38,,21,11,32
096 Terenten,39,,17,14,31
096 Terenten,40,,13,14,27
096 Terenten,41,,17,18,35
096 Terenten,42,,12,18,30
096 Terenten,43,,17,10,27
096 Terenten,44,,17,13,30
096 Terenten,45,,24,13,37
096 Terenten,46,,19,11,30
096 Terenten,47,,10,15,25
096 Terenten,48,,12,9,21
096 Terenten,49,,15,11,26
096 Terenten,50,,13,9,22
096 Terenten,51,,11,9,20
096 Terenten,52,,9,12,21
096 Terenten,53,,12,10,22
096 Terenten,54,,15,10,25
096 Terenten,55,,9,6,15
096 Terenten,56,,7,7,14
096 Terenten,57,,5,6,11
096 Terenten,58,,7,7,14
096 Terenten,59,,8,6,14
096 Terenten,60,,10,8,18
096 Terenten,61,,7,3,10
096 Terenten,62,,8,3,11
096 Terenten,63,,6,3,9
096 Terenten,64,,3,6,9
096 Terenten,65,,8,5,13
096 Terenten,66,,5,5,10
096 Terenten,67,,5,4,9
096 Terenten,68,,8,5,13
096 Terenten,69,,2,6,8
096 Terenten,70,,4,10,14
096 Terenten,71,,6,5,11
096 Terenten,72,,4,9,13
096 Terenten,73,,6,5,11
096 Terenten,74,,1,4,5
096 Terenten,75,,5,3,8
096 Terenten,76,,4,4,8
096 Terenten,77,,4,9,13
096 Terenten,78,,4,5,9
096 Terenten,79,,4,4,8
096 Terenten,80,,4,5,9
096 Terenten,81,,1,3,4
096 Terenten,82,,3,7,10
096 Terenten,83,,5,2,7
096 Terenten,84,,1,4,5
096 Terenten,85,,3,3,6
096 Terenten,86,,1,-,1
096 Terenten,87,,-,2,2
096 Terenten,88,,2,3,5
096 Terenten,89,,1,-,1
096 Terenten,90,,-,1,1
096 Terenten,91,,1,-,1
096 Terenten,92,,-,1,1
096 Terenten,94,,1,-,1
096 Terenten,Insgesamt,,871,812,1.683
097 Terlan,0,,26,27,53
097 Terlan,1,,23,17,40
097 Terlan,2,,24,30,54
097 Terlan,3,,17,25,42
097 Terlan,4,,29,22,51
097 Terlan,5,,24,23,47
097 Terlan,6,,20,19,39
097 Terlan,7,,21,27,48
097 Terlan,8,,31,26,57
097 Terlan,9,,32,20,52
097 Terlan,10,,22,22,44
097 Terlan,11,,34,30,64
097 Terlan,12,,16,26,42
097 Terlan,13,,26,28,54
097 Terlan,14,,22,19,41
097 Terlan,15,,27,25,52
097 Terlan,16,,23,31,54
097 Terlan,17,,26,20,46
097 Terlan,18,,15,23,38
097 Terlan,19,,24,30,54
097 Terlan,20,,24,18,42
097 Terlan,21,,28,13,41
097 Terlan,22,,17,26,43
097 Terlan,23,,25,18,43
097 Terlan,24,,15,17,32
097 Terlan,25,,24,15,39
097 Terlan,26,,22,24,46
097 Terlan,27,,19,19,38
097 Terlan,28,,33,29,62
097 Terlan,29,,19,32,51
097 Terlan,30,,22,34,56
097 Terlan,31,,33,29,62
097 Terlan,32,,30,35,65
097 Terlan,33,,30,29,59
097 Terlan,34,,27,47,74
097 Terlan,35,,26,39,65
097 Terlan,36,,47,22,69
097 Terlan,37,,34,24,58
097 Terlan,38,,41,41,82
097 Terlan,39,,34,36,70
097 Terlan,40,,37,31,68
097 Terlan,41,,28,40,68
097 Terlan,42,,44,33,77
097 Terlan,43,,36,29,65
097 Terlan,44,,31,30,61
097 Terlan,45,,36,32,68
097 Terlan,46,,32,36,68
097 Terlan,47,,44,27,71
097 Terlan,48,,25,38,63
097 Terlan,49,,20,26,46
097 Terlan,50,,32,22,54
097 Terlan,51,,23,26,49
097 Terlan,52,,32,34,66
097 Terlan,53,,22,20,42
097 Terlan,54,,25,19,44
097 Terlan,55,,12,22,34
097 Terlan,56,,17,26,43
097 Terlan,57,,22,18,40
097 Terlan,58,,24,24,48
097 Terlan,59,,19,15,34
097 Terlan,60,,17,22,39
097 Terlan,61,,16,19,35
097 Terlan,62,,14,23,37
097 Terlan,63,,21,22,43
097 Terlan,64,,23,23,46
097 Terlan,65,,15,27,42
097 Terlan,66,,32,19,51
097 Terlan,67,,22,26,48
097 Terlan,68,,21,15,36
097 Terlan,69,,16,19,35
097 Terlan,70,,20,16,36
097 Terlan,71,,12,16,28
097 Terlan,72,,4,12,16
097 Terlan,73,,14,23,37
097 Terlan,74,,8,23,31
097 Terlan,75,,11,15,26
097 Terlan,76,,13,11,24
097 Terlan,77,,17,14,31
097 Terlan,78,,14,17,31
097 Terlan,79,,11,11,22
097 Terlan,80,,11,11,22
097 Terlan,81,,7,10,17
097 Terlan,82,,8,17,25
097 Terlan,83,,6,12,18
097 Terlan,84,,4,12,16
097 Terlan,85,,5,24,29
097 Terlan,86,,5,11,16
097 Terlan,87,,4,11,15
097 Terlan,88,,-,7,7
097 Terlan,89,,-,6,6
097 Terlan,90,,3,3,6
097 Terlan,91,,-,3,3
097 Terlan,92,,-,4,4
097 Terlan,93,,1,3,4
097 Terlan,94,,-,3,3
097 Terlan,95,,1,2,3
097 Terlan,97,,-,2,2
097 Terlan,98,,-,2,2
097 Terlan,101,,-,1,1
097 Terlan,Insgesamt,,1.969,2.102,4.071
098 Tramin a.d. Weinstr.,0,,19,8,27
098 Tramin a.d. Weinstr.,1,,15,12,27
098 Tramin a.d. Weinstr.,2,,16,13,29
098 Tramin a.d. Weinstr.,3,,19,12,31
098 Tramin a.d. Weinstr.,4,,14,16,30
098 Tramin a.d. Weinstr.,5,,27,15,42
098 Tramin a.d. Weinstr.,6,,13,19,32
098 Tramin a.d. Weinstr.,7,,18,19,37
098 Tramin a.d. Weinstr.,8,,25,14,39
098 Tramin a.d. Weinstr.,9,,18,20,38
098 Tramin a.d. Weinstr.,10,,16,19,35
098 Tramin a.d. Weinstr.,11,,28,14,42
098 Tramin a.d. Weinstr.,12,,20,26,46
098 Tramin a.d. Weinstr.,13,,19,19,38
098 Tramin a.d. Weinstr.,14,,20,21,41
098 Tramin a.d. Weinstr.,15,,17,18,35
098 Tramin a.d. Weinstr.,16,,19,25,44
098 Tramin a.d. Weinstr.,17,,19,9,28
098 Tramin a.d. Weinstr.,18,,23,21,44
098 Tramin a.d. Weinstr.,19,,13,29,42
098 Tramin a.d. Weinstr.,20,,14,23,37
098 Tramin a.d. Weinstr.,21,,22,26,48
098 Tramin a.d. Weinstr.,22,,12,17,29
098 Tramin a.d. Weinstr.,23,,22,20,42
098 Tramin a.d. Weinstr.,24,,23,17,40
098 Tramin a.d. Weinstr.,25,,16,20,36
098 Tramin a.d. Weinstr.,26,,21,18,39
098 Tramin a.d. Weinstr.,27,,32,19,51
098 Tramin a.d. Weinstr.,28,,19,16,35
098 Tramin a.d. Weinstr.,29,,15,14,29
098 Tramin a.d. Weinstr.,30,,11,22,33
098 Tramin a.d. Weinstr.,31,,18,16,34
098 Tramin a.d. Weinstr.,32,,24,12,36
098 Tramin a.d. Weinstr.,33,,21,20,41
098 Tramin a.d. Weinstr.,34,,21,18,39
098 Tramin a.d. Weinstr.,35,,21,14,35
098 Tramin a.d. Weinstr.,36,,20,26,46
098 Tramin a.d. Weinstr.,37,,26,36,62
098 Tramin a.d. Weinstr.,38,,30,20,50
098 Tramin a.d. Weinstr.,39,,31,26,57
098 Tramin a.d. Weinstr.,40,,26,21,47
098 Tramin a.d. Weinstr.,41,,27,31,58
098 Tramin a.d. Weinstr.,42,,30,27,57
098 Tramin a.d. Weinstr.,43,,36,28,64
098 Tramin a.d. Weinstr.,44,,29,27,56
098 Tramin a.d. Weinstr.,45,,23,23,46
098 Tramin a.d. Weinstr.,46,,23,14,37
098 Tramin a.d. Weinstr.,47,,30,27,57
098 Tramin a.d. Weinstr.,48,,26,32,58
098 Tramin a.d. Weinstr.,49,,17,31,48
098 Tramin a.d. Weinstr.,50,,25,24,49
098 Tramin a.d. Weinstr.,51,,21,21,42
098 Tramin a.d. Weinstr.,52,,24,20,44
098 Tramin a.d. Weinstr.,53,,15,19,34
098 Tramin a.d. Weinstr.,54,,20,18,38
098 Tramin a.d. Weinstr.,55,,15,16,31
098 Tramin a.d. Weinstr.,56,,18,17,35
098 Tramin a.d. Weinstr.,57,,12,15,27
098 Tramin a.d. Weinstr.,58,,14,21,35
098 Tramin a.d. Weinstr.,59,,16,15,31
098 Tramin a.d. Weinstr.,60,,17,18,35
098 Tramin a.d. Weinstr.,61,,14,22,36
098 Tramin a.d. Weinstr.,62,,21,18,39
098 Tramin a.d. Weinstr.,63,,7,9,16
098 Tramin a.d. Weinstr.,64,,22,25,47
098 Tramin a.d. Weinstr.,65,,19,21,40
098 Tramin a.d. Weinstr.,66,,21,20,41
098 Tramin a.d. Weinstr.,67,,15,24,39
098 Tramin a.d. Weinstr.,68,,21,16,37
098 Tramin a.d. Weinstr.,69,,13,12,25
098 Tramin a.d. Weinstr.,70,,7,18,25
098 Tramin a.d. Weinstr.,71,,12,14,26
098 Tramin a.d. Weinstr.,72,,14,13,27
098 Tramin a.d. Weinstr.,73,,15,13,28
098 Tramin a.d. Weinstr.,74,,9,13,22
098 Tramin a.d. Weinstr.,75,,7,13,20
098 Tramin a.d. Weinstr.,76,,10,17,27
098 Tramin a.d. Weinstr.,77,,6,17,23
098 Tramin a.d. Weinstr.,78,,17,13,30
098 Tramin a.d. Weinstr.,79,,8,13,21
098 Tramin a.d. Weinstr.,80,,13,15,28
098 Tramin a.d. Weinstr.,81,,15,12,27
098 Tramin a.d. Weinstr.,82,,13,16,29
098 Tramin a.d. Weinstr.,83,,9,16,25
098 Tramin a.d. Weinstr.,84,,6,12,18
098 Tramin a.d. Weinstr.,85,,4,14,18
098 Tramin a.d. Weinstr.,86,,1,7,8
098 Tramin a.d. Weinstr.,87,,6,9,15
098 Tramin a.d. Weinstr.,88,,5,7,12
098 Tramin a.d. Weinstr.,89,,2,8,10
098 Tramin a.d. Weinstr.,90,,1,1,2
098 Tramin a.d. Weinstr.,91,,-,2,2
098 Tramin a.d. Weinstr.,92,,1,-,1
098 Tramin a.d. Weinstr.,93,,-,4,4
098 Tramin a.d. Weinstr.,94,,-,3,3
098 Tramin a.d. Weinstr.,96,,1,1,2
098 Tramin a.d. Weinstr.,97,,-,2,2
098 Tramin a.d. Weinstr.,98,,1,1,2
098 Tramin a.d. Weinstr.,Insgesamt,,1.597,1.655,3.252
099 Tisens,0,,12,7,19
099 Tisens,1,,10,9,19
099 Tisens,2,,7,7,14
099 Tisens,3,,10,13,23
099 Tisens,4,,12,12,24
099 Tisens,5,,10,10,20
099 Tisens,6,,11,9,20
099 Tisens,7,,10,15,25
099 Tisens,8,,9,10,19
099 Tisens,9,,10,8,18
099 Tisens,10,,13,15,28
099 Tisens,11,,4,6,10
099 Tisens,12,,11,7,18
099 Tisens,13,,10,6,16
099 Tisens,14,,11,11,22
099 Tisens,15,,5,9,14
099 Tisens,16,,6,16,22
099 Tisens,17,,17,9,26
099 Tisens,18,,10,14,24
099 Tisens,19,,11,7,18
099 Tisens,20,,8,12,20
099 Tisens,21,,14,7,21
099 Tisens,22,,14,6,20
099 Tisens,23,,9,5,14
099 Tisens,24,,8,13,21
099 Tisens,25,,20,5,25
099 Tisens,26,,14,17,31
099 Tisens,27,,7,19,26
099 Tisens,28,,15,11,26
099 Tisens,29,,11,9,20
099 Tisens,30,,12,16,28
099 Tisens,31,,10,8,18
099 Tisens,32,,9,7,16
099 Tisens,33,,15,11,26
099 Tisens,34,,11,9,20
099 Tisens,35,,9,10,19
099 Tisens,36,,9,15,24
099 Tisens,37,,18,13,31
099 Tisens,38,,15,18,33
099 Tisens,39,,18,15,33
099 Tisens,40,,17,21,38
099 Tisens,41,,21,22,43
099 Tisens,42,,23,11,34
099 Tisens,43,,16,25,41
099 Tisens,44,,16,9,25
099 Tisens,45,,19,14,33
099 Tisens,46,,22,6,28
099 Tisens,47,,13,14,27
099 Tisens,48,,18,6,24
099 Tisens,49,,13,13,26
099 Tisens,50,,10,14,24
099 Tisens,51,,16,19,35
099 Tisens,52,,9,12,21
099 Tisens,53,,18,13,31
099 Tisens,54,,9,8,17
099 Tisens,55,,11,11,22
099 Tisens,56,,7,12,19
099 Tisens,57,,11,10,21
099 Tisens,58,,9,7,16
099 Tisens,59,,5,7,12
099 Tisens,60,,15,7,22
099 Tisens,61,,9,9,18
099 Tisens,62,,7,6,13
099 Tisens,63,,3,7,10
099 Tisens,64,,10,11,21
099 Tisens,65,,11,9,20
099 Tisens,66,,8,10,18
099 Tisens,67,,7,14,21
099 Tisens,68,,6,8,14
099 Tisens,69,,12,9,21
099 Tisens,70,,7,12,19
099 Tisens,71,,6,4,10
099 Tisens,72,,6,8,14
099 Tisens,73,,4,11,15
099 Tisens,74,,7,6,13
099 Tisens,75,,2,10,12
099 Tisens,76,,5,9,14
099 Tisens,77,,5,9,14
099 Tisens,78,,3,15,18
099 Tisens,79,,6,9,15
099 Tisens,80,,6,11,17
099 Tisens,81,,6,9,15
099 Tisens,82,,5,9,14
099 Tisens,83,,3,7,10
099 Tisens,84,,1,3,4
099 Tisens,85,,1,8,9
099 Tisens,86,,3,4,7
099 Tisens,87,,4,6,10
099 Tisens,88,,2,2,4
099 Tisens,89,,2,4,6
099 Tisens,92,,-,2,2
099 Tisens,93,,1,1,2
099 Tisens,94,,1,1,2
099 Tisens,96,,-,2,2
099 Tisens,97,,-,2,2
099 Tisens,Insgesamt,,902,934,1.836
100 Tiers,0,,9,9,18
100 Tiers,1,,9,4,13
100 Tiers,2,,2,11,13
100 Tiers,3,,2,10,12
100 Tiers,4,,4,3,7
100 Tiers,5,,4,8,12
100 Tiers,6,,6,4,10
100 Tiers,7,,3,8,11
100 Tiers,8,,2,8,10
100 Tiers,9,,4,9,13
100 Tiers,10,,4,10,14
100 Tiers,11,,9,6,15
100 Tiers,12,,7,4,11
100 Tiers,13,,7,10,17
100 Tiers,14,,5,7,12
100 Tiers,15,,4,2,6
100 Tiers,16,,6,3,9
100 Tiers,17,,6,3,9
100 Tiers,18,,7,6,13
100 Tiers,19,,4,7,11
100 Tiers,20,,6,9,15
100 Tiers,21,,6,4,10
100 Tiers,22,,8,7,15
100 Tiers,23,,5,6,11
100 Tiers,24,,4,9,13
100 Tiers,25,,6,5,11
100 Tiers,26,,5,6,11
100 Tiers,27,,5,4,9
100 Tiers,28,,4,5,9
100 Tiers,29,,1,5,6
100 Tiers,30,,9,12,21
100 Tiers,31,,6,2,8
100 Tiers,32,,1,5,6
100 Tiers,33,,11,4,15
100 Tiers,34,,4,12,16
100 Tiers,35,,8,10,18
100 Tiers,36,,10,7,17
100 Tiers,37,,5,7,12
100 Tiers,38,,7,7,14
100 Tiers,39,,16,11,27
100 Tiers,40,,5,4,9
100 Tiers,41,,10,11,21
100 Tiers,42,,10,6,16
100 Tiers,43,,7,6,13
100 Tiers,44,,9,4,13
100 Tiers,45,,7,10,17
100 Tiers,46,,6,7,13
100 Tiers,47,,7,4,11
100 Tiers,48,,4,8,12
100 Tiers,49,,11,5,16
100 Tiers,50,,7,4,11
100 Tiers,51,,5,9,14
100 Tiers,52,,10,8,18
100 Tiers,53,,5,3,8
100 Tiers,54,,7,4,11
100 Tiers,55,,6,4,10
100 Tiers,56,,3,2,5
100 Tiers,57,,1,4,5
100 Tiers,58,,7,4,11
100 Tiers,59,,3,6,9
100 Tiers,60,,4,5,9
100 Tiers,61,,3,3,6
100 Tiers,62,,6,4,10
100 Tiers,63,,8,3,11
100 Tiers,64,,2,5,7
100 Tiers,65,,8,10,18
100 Tiers,66,,2,5,7
100 Tiers,67,,4,6,10
100 Tiers,68,,2,3,5
100 Tiers,69,,5,6,11
100 Tiers,70,,6,5,11
100 Tiers,71,,6,5,11
100 Tiers,72,,4,6,10
100 Tiers,73,,6,2,8
100 Tiers,74,,2,5,7
100 Tiers,75,,5,3,8
100 Tiers,76,,2,5,7
100 Tiers,77,,4,2,6
100 Tiers,78,,2,-,2
100 Tiers,79,,2,2,4
100 Tiers,80,,2,2,4
100 Tiers,81,,4,3,7
100 Tiers,82,,3,2,5
100 Tiers,83,,6,2,8
100 Tiers,84,,1,4,5
100 Tiers,85,,1,2,3
100 Tiers,86,,2,1,3
100 Tiers,87,,1,5,6
100 Tiers,88,,2,2,4
100 Tiers,89,,-,1,1
100 Tiers,90,,1,1,2
100 Tiers,91,,-,1,1
100 Tiers,93,,1,1,2
100 Tiers,95,,-,1,1
100 Tiers,96,,-,2,2
100 Tiers,Insgesamt,,468,497,965
101 Tirol,0,,12,11,23
101 Tirol,1,,15,9,24
101 Tirol,2,,8,10,18
101 Tirol,3,,13,6,19
101 Tirol,4,,13,17,30
101 Tirol,5,,12,12,24
101 Tirol,6,,16,10,26
101 Tirol,7,,17,9,26
101 Tirol,8,,20,12,32
101 Tirol,9,,12,16,28
101 Tirol,10,,16,14,30
101 Tirol,11,,19,23,42
101 Tirol,12,,19,16,35
101 Tirol,13,,8,17,25
101 Tirol,14,,14,15,29
101 Tirol,15,,21,9,30
101 Tirol,16,,14,13,27
101 Tirol,17,,9,8,17
101 Tirol,18,,15,11,26
101 Tirol,19,,12,18,30
101 Tirol,20,,13,14,27
101 Tirol,21,,15,9,24
101 Tirol,22,,11,12,23
101 Tirol,23,,10,17,27
101 Tirol,24,,19,12,31
101 Tirol,25,,19,15,34
101 Tirol,26,,12,11,23
101 Tirol,27,,19,21,40
101 Tirol,28,,22,10,32
101 Tirol,29,,17,8,25
101 Tirol,30,,7,11,18
101 Tirol,31,,15,17,32
101 Tirol,32,,16,12,28
101 Tirol,33,,16,14,30
101 Tirol,34,,14,19,33
101 Tirol,35,,22,16,38
101 Tirol,36,,24,16,40
101 Tirol,37,,22,17,39
101 Tirol,38,,18,17,35
101 Tirol,39,,20,18,38
101 Tirol,40,,24,25,49
101 Tirol,41,,22,19,41
101 Tirol,42,,23,19,42
101 Tirol,43,,20,17,37
101 Tirol,44,,29,24,53
101 Tirol,45,,20,13,33
101 Tirol,46,,17,17,34
101 Tirol,47,,18,22,40
101 Tirol,48,,23,13,36
101 Tirol,49,,16,13,29
101 Tirol,50,,11,16,27
101 Tirol,51,,15,20,35
101 Tirol,52,,8,15,23
101 Tirol,53,,14,16,30
101 Tirol,54,,14,17,31
101 Tirol,55,,19,19,38
101 Tirol,56,,14,12,26
101 Tirol,57,,16,18,34
101 Tirol,58,,14,10,24
101 Tirol,59,,17,16,33
101 Tirol,60,,22,15,37
101 Tirol,61,,10,14,24
101 Tirol,62,,14,8,22
101 Tirol,63,,12,14,26
101 Tirol,64,,16,16,32
101 Tirol,65,,11,13,24
101 Tirol,66,,13,17,30
101 Tirol,67,,11,16,27
101 Tirol,68,,9,14,23
101 Tirol,69,,10,11,21
101 Tirol,70,,8,9,17
101 Tirol,71,,9,14,23
101 Tirol,72,,6,10,16
101 Tirol,73,,9,9,18
101 Tirol,74,,13,8,21
101 Tirol,75,,6,10,16
101 Tirol,76,,8,7,15
101 Tirol,77,,7,8,15
101 Tirol,78,,4,7,11
101 Tirol,79,,7,12,19
101 Tirol,80,,6,9,15
101 Tirol,81,,8,7,15
101 Tirol,82,,4,7,11
101 Tirol,83,,6,8,14
101 Tirol,84,,4,9,13
101 Tirol,85,,2,4,6
101 Tirol,86,,3,4,7
101 Tirol,87,,5,4,9
101 Tirol,88,,2,4,6
101 Tirol,89,,2,3,5
101 Tirol,90,,1,2,3
101 Tirol,92,,1,1,2
101 Tirol,94,,-,1,1
101 Tirol,97,,-,1,1
101 Tirol,Insgesamt,,1.219,1.179,2.398
102 Truden im Naturpark,0,,4,7,11
102 Truden im Naturpark,1,,10,6,16
102 Truden im Naturpark,2,,4,1,5
102 Truden im Naturpark,3,,1,5,6
102 Truden im Naturpark,4,,3,9,12
102 Truden im Naturpark,5,,6,3,9
102 Truden im Naturpark,6,,2,3,5
102 Truden im Naturpark,7,,5,2,7
102 Truden im Naturpark,8,,7,7,14
102 Truden im Naturpark,9,,1,3,4
102 Truden im Naturpark,10,,3,7,10
102 Truden im Naturpark,11,,7,6,13
102 Truden im Naturpark,12,,6,6,12
102 Truden im Naturpark,13,,5,6,11
102 Truden im Naturpark,14,,6,5,11
102 Truden im Naturpark,15,,11,5,16
102 Truden im Naturpark,16,,7,5,12
102 Truden im Naturpark,17,,8,7,15
102 Truden im Naturpark,18,,4,5,9
102 Truden im Naturpark,19,,9,9,18
102 Truden im Naturpark,20,,8,15,23
102 Truden im Naturpark,21,,7,4,11
102 Truden im Naturpark,22,,1,7,8
102 Truden im Naturpark,23,,8,6,14
102 Truden im Naturpark,24,,11,4,15
102 Truden im Naturpark,25,,5,5,10
102 Truden im Naturpark,26,,12,4,16
102 Truden im Naturpark,27,,3,11,14
102 Truden im Naturpark,28,,5,2,7
102 Truden im Naturpark,29,,9,5,14
102 Truden im Naturpark,30,,8,7,15
102 Truden im Naturpark,31,,3,5,8
102 Truden im Naturpark,32,,10,5,15
102 Truden im Naturpark,33,,7,4,11
102 Truden im Naturpark,34,,4,9,13
102 Truden im Naturpark,35,,8,9,17
102 Truden im Naturpark,36,,9,9,18
102 Truden im Naturpark,37,,3,3,6
102 Truden im Naturpark,38,,1,7,8
102 Truden im Naturpark,39,,9,10,19
102 Truden im Naturpark,40,,6,10,16
102 Truden im Naturpark,41,,12,6,18
102 Truden im Naturpark,42,,8,7,15
102 Truden im Naturpark,43,,8,8,16
102 Truden im Naturpark,44,,9,8,17
102 Truden im Naturpark,45,,11,6,17
102 Truden im Naturpark,46,,8,3,11
102 Truden im Naturpark,47,,8,6,14
102 Truden im Naturpark,48,,8,13,21
102 Truden im Naturpark,49,,7,10,17
102 Truden im Naturpark,50,,5,11,16
102 Truden im Naturpark,51,,6,10,16
102 Truden im Naturpark,52,,7,5,12
102 Truden im Naturpark,53,,7,10,17
102 Truden im Naturpark,54,,5,6,11
102 Truden im Naturpark,55,,9,6,15
102 Truden im Naturpark,56,,5,6,11
102 Truden im Naturpark,57,,8,5,13
102 Truden im Naturpark,58,,3,2,5
102 Truden im Naturpark,59,,6,3,9
102 Truden im Naturpark,60,,1,6,7
102 Truden im Naturpark,61,,6,1,7
102 Truden im Naturpark,62,,7,6,13
102 Truden im Naturpark,63,,5,2,7
102 Truden im Naturpark,64,,3,5,8
102 Truden im Naturpark,65,,4,5,9
102 Truden im Naturpark,66,,4,4,8
102 Truden im Naturpark,67,,4,5,9
102 Truden im Naturpark,68,,2,4,6
102 Truden im Naturpark,69,,8,2,10
102 Truden im Naturpark,70,,5,7,12
102 Truden im Naturpark,71,,3,4,7
102 Truden im Naturpark,72,,4,3,7
102 Truden im Naturpark,73,,3,3,6
102 Truden im Naturpark,74,,5,1,6
102 Truden im Naturpark,75,,5,7,12
102 Truden im Naturpark,76,,4,3,7
102 Truden im Naturpark,77,,5,4,9
102 Truden im Naturpark,78,,2,7,9
102 Truden im Naturpark,79,,-,6,6
102 Truden im Naturpark,80,,-,6,6
102 Truden im Naturpark,81,,3,6,9
102 Truden im Naturpark,82,,1,7,8
102 Truden im Naturpark,83,,-,5,5
102 Truden im Naturpark,84,,-,7,7
102 Truden im Naturpark,85,,1,6,7
102 Truden im Naturpark,86,,2,4,6
102 Truden im Naturpark,87,,1,3,4
102 Truden im Naturpark,88,,-,2,2
102 Truden im Naturpark,89,,1,4,5
102 Truden im Naturpark,90,,-,1,1
102 Truden im Naturpark,Insgesamt,,475,515,990
103 Taufers im Münstertal,0,,6,5,11
103 Taufers im Münstertal,1,,6,8,14
103 Taufers im Münstertal,2,,4,7,11
103 Taufers im Münstertal,3,,1,5,6
103 Taufers im Münstertal,4,,8,6,14
103 Taufers im Münstertal,5,,4,2,6
103 Taufers im Münstertal,6,,4,5,9
103 Taufers im Münstertal,7,,5,6,11
103 Taufers im Münstertal,8,,4,4,8
103 Taufers im Münstertal,9,,3,3,6
103 Taufers im Münstertal,10,,6,8,14
103 Taufers im Münstertal,11,,4,4,8
103 Taufers im Münstertal,12,,6,3,9
103 Taufers im Münstertal,13,,9,9,18
103 Taufers im Münstertal,14,,6,8,14
103 Taufers im Münstertal,15,,3,5,8
103 Taufers im Münstertal,16,,8,8,16
103 Taufers im Münstertal,17,,6,10,16
103 Taufers im Münstertal,18,,8,7,15
103 Taufers im Münstertal,19,,8,3,11
103 Taufers im Münstertal,20,,6,9,15
103 Taufers im Münstertal,21,,3,6,9
103 Taufers im Münstertal,22,,6,5,11
103 Taufers im Münstertal,23,,5,4,9
103 Taufers im Münstertal,24,,4,7,11
103 Taufers im Münstertal,25,,4,6,10
103 Taufers im Münstertal,26,,5,10,15
103 Taufers im Münstertal,27,,8,5,13
103 Taufers im Münstertal,28,,11,5,16
103 Taufers im Münstertal,29,,5,3,8
103 Taufers im Münstertal,30,,9,3,12
103 Taufers im Münstertal,31,,4,3,7
103 Taufers im Münstertal,32,,3,6,9
103 Taufers im Münstertal,33,,10,4,14
103 Taufers im Münstertal,34,,5,8,13
103 Taufers im Münstertal,35,,1,6,7
103 Taufers im Münstertal,36,,4,7,11
103 Taufers im Münstertal,37,,7,14,21
103 Taufers im Münstertal,38,,6,8,14
103 Taufers im Münstertal,39,,9,5,14
103 Taufers im Münstertal,40,,10,11,21
103 Taufers im Münstertal,41,,3,5,8
103 Taufers im Münstertal,42,,5,10,15
103 Taufers im Münstertal,43,,12,6,18
103 Taufers im Münstertal,44,,7,13,20
103 Taufers im Münstertal,45,,9,9,18
103 Taufers im Münstertal,46,,12,8,20
103 Taufers im Münstertal,47,,10,7,17
103 Taufers im Münstertal,48,,12,6,18
103 Taufers im Münstertal,49,,6,10,16
103 Taufers im Münstertal,50,,5,6,11
103 Taufers im Münstertal,51,,9,7,16
103 Taufers im Münstertal,52,,11,10,21
103 Taufers im Münstertal,53,,4,3,7
103 Taufers im Münstertal,54,,4,6,10
103 Taufers im Münstertal,55,,7,4,11
103 Taufers im Münstertal,56,,6,2,8
103 Taufers im Münstertal,57,,5,4,9
103 Taufers im Münstertal,58,,7,1,8
103 Taufers im Münstertal,59,,6,1,7
103 Taufers im Münstertal,60,,5,1,6
103 Taufers im Münstertal,61,,3,7,10
103 Taufers im Münstertal,62,,3,3,6
103 Taufers im Münstertal,63,,3,4,7
103 Taufers im Münstertal,64,,1,-,1
103 Taufers im Münstertal,65,,6,4,10
103 Taufers im Münstertal,66,,4,5,9
103 Taufers im Münstertal,67,,3,7,10
103 Taufers im Münstertal,68,,2,3,5
103 Taufers im Münstertal,69,,5,4,9
103 Taufers im Münstertal,70,,7,9,16
103 Taufers im Münstertal,71,,3,4,7
103 Taufers im Münstertal,72,,2,9,11
103 Taufers im Münstertal,73,,4,2,6
103 Taufers im Münstertal,74,,3,7,10
103 Taufers im Münstertal,75,,4,5,9
103 Taufers im Münstertal,76,,5,1,6
103 Taufers im Münstertal,77,,8,3,11
103 Taufers im Münstertal,78,,2,3,5
103 Taufers im Münstertal,79,,4,6,10
103 Taufers im Münstertal,80,,3,4,7
103 Taufers im Münstertal,81,,3,3,6
103 Taufers im Münstertal,82,,1,4,5
103 Taufers im Münstertal,83,,1,5,6
103 Taufers im Münstertal,84,,-,5,5
103 Taufers im Münstertal,85,,3,1,4
103 Taufers im Münstertal,86,,1,2,3
103 Taufers im Münstertal,87,,1,-,1
103 Taufers im Münstertal,88,,3,1,4
103 Taufers im Münstertal,89,,1,-,1
103 Taufers im Münstertal,90,,-,2,2
103 Taufers im Münstertal,91,,1,1,2
103 Taufers im Münstertal,94,,1,-,1
103 Taufers im Münstertal,95,,-,1,1
103 Taufers im Münstertal,96,,-,2,2
103 Taufers im Münstertal,99,,-,1,1
103 Taufers im Münstertal,Insgesamt,,470,488,958
104 Ulten,0,,18,10,28
104 Ulten,1,,8,10,18
104 Ulten,2,,13,10,23
104 Ulten,3,,17,22,39
104 Ulten,4,,17,13,30
104 Ulten,5,,22,19,41
104 Ulten,6,,16,19,35
104 Ulten,7,,19,16,35
104 Ulten,8,,17,16,33
104 Ulten,9,,14,15,29
104 Ulten,10,,16,16,32
104 Ulten,11,,14,19,33
104 Ulten,12,,11,14,25
104 Ulten,13,,12,16,28
104 Ulten,14,,19,15,34
104 Ulten,15,,23,14,37
104 Ulten,16,,17,17,34
104 Ulten,17,,23,31,54
104 Ulten,18,,16,18,34
104 Ulten,19,,17,28,45
104 Ulten,20,,16,20,36
104 Ulten,21,,19,17,36
104 Ulten,22,,21,9,30
104 Ulten,23,,17,16,33
104 Ulten,24,,20,19,39
104 Ulten,25,,22,15,37
104 Ulten,26,,15,20,35
104 Ulten,27,,21,17,38
104 Ulten,28,,18,18,36
104 Ulten,29,,17,16,33
104 Ulten,30,,22,14,36
104 Ulten,31,,20,15,35
104 Ulten,32,,16,18,34
104 Ulten,33,,24,22,46
104 Ulten,34,,18,24,42
104 Ulten,35,,27,13,40
104 Ulten,36,,21,19,40
104 Ulten,37,,26,21,47
104 Ulten,38,,21,24,45
104 Ulten,39,,29,22,51
104 Ulten,40,,28,25,53
104 Ulten,41,,16,19,35
104 Ulten,42,,21,17,38
104 Ulten,43,,28,27,55
104 Ulten,44,,23,20,43
104 Ulten,45,,28,26,54
104 Ulten,46,,30,21,51
104 Ulten,47,,28,17,45
104 Ulten,48,,25,20,45
104 Ulten,49,,23,23,46
104 Ulten,50,,26,16,42
104 Ulten,51,,34,22,56
104 Ulten,52,,17,16,33
104 Ulten,53,,13,12,25
104 Ulten,54,,18,16,34
104 Ulten,55,,24,13,37
104 Ulten,56,,18,13,31
104 Ulten,57,,19,17,36
104 Ulten,58,,19,14,33
104 Ulten,59,,17,10,27
104 Ulten,60,,13,12,25
104 Ulten,61,,16,9,25
104 Ulten,62,,15,15,30
104 Ulten,63,,9,13,22
104 Ulten,64,,14,20,34
104 Ulten,65,,17,16,33
104 Ulten,66,,9,15,24
104 Ulten,67,,12,10,22
104 Ulten,68,,16,9,25
104 Ulten,69,,19,16,35
104 Ulten,70,,6,10,16
104 Ulten,71,,10,10,20
104 Ulten,72,,8,9,17
104 Ulten,73,,10,12,22
104 Ulten,74,,10,13,23
104 Ulten,75,,5,13,18
104 Ulten,76,,11,8,19
104 Ulten,77,,10,8,18
104 Ulten,78,,12,15,27
104 Ulten,79,,4,13,17
104 Ulten,80,,9,13,22
104 Ulten,81,,6,17,23
104 Ulten,82,,5,13,18
104 Ulten,83,,13,12,25
104 Ulten,84,,6,11,17
104 Ulten,85,,7,22,29
104 Ulten,86,,4,7,11
104 Ulten,87,,8,8,16
104 Ulten,88,,5,9,14
104 Ulten,89,,1,10,11
104 Ulten,90,,2,-,2
104 Ulten,91,,1,1,2
104 Ulten,92,,-,1,1
104 Ulten,93,,2,-,2
104 Ulten,94,,-,2,2
104 Ulten,97,,-,3,3
104 Ulten,98,,-,1,1
104 Ulten,110,,-,1,1
104 Ulten,Insgesamt,,1.489,1.438,2.927
105 Pfatten,0,,7,6,13
105 Pfatten,1,,7,4,11
105 Pfatten,2,,8,5,13
105 Pfatten,3,,5,12,17
105 Pfatten,4,,2,6,8
105 Pfatten,5,,13,6,19
105 Pfatten,6,,3,6,9
105 Pfatten,7,,4,3,7
105 Pfatten,8,,6,6,12
105 Pfatten,9,,4,7,11
105 Pfatten,10,,10,5,15
105 Pfatten,11,,5,3,8
105 Pfatten,12,,4,8,12
105 Pfatten,13,,5,7,12
105 Pfatten,14,,8,10,18
105 Pfatten,15,,4,5,9
105 Pfatten,16,,6,7,13
105 Pfatten,17,,8,5,13
105 Pfatten,18,,10,7,17
105 Pfatten,19,,7,5,12
105 Pfatten,20,,2,6,8
105 Pfatten,21,,7,4,11
105 Pfatten,22,,5,9,14
105 Pfatten,23,,4,7,11
105 Pfatten,24,,2,8,10
105 Pfatten,25,,3,9,12
105 Pfatten,26,,5,3,8
105 Pfatten,27,,10,4,14
105 Pfatten,28,,2,6,8
105 Pfatten,29,,7,11,18
105 Pfatten,30,,5,10,15
105 Pfatten,31,,8,5,13
105 Pfatten,32,,7,10,17
105 Pfatten,33,,3,11,14
105 Pfatten,34,,15,10,25
105 Pfatten,35,,11,6,17
105 Pfatten,36,,10,9,19
105 Pfatten,37,,11,8,19
105 Pfatten,38,,13,6,19
105 Pfatten,39,,8,5,13
105 Pfatten,40,,9,7,16
105 Pfatten,41,,12,7,19
105 Pfatten,42,,10,8,18
105 Pfatten,43,,11,11,22
105 Pfatten,44,,9,3,12
105 Pfatten,45,,7,10,17
105 Pfatten,46,,9,14,23
105 Pfatten,47,,11,16,27
105 Pfatten,48,,7,8,15
105 Pfatten,49,,6,13,19
105 Pfatten,50,,7,6,13
105 Pfatten,51,,16,5,21
105 Pfatten,52,,9,8,17
105 Pfatten,53,,6,5,11
105 Pfatten,54,,12,2,14
105 Pfatten,55,,6,5,11
105 Pfatten,56,,1,7,8
105 Pfatten,57,,3,5,8
105 Pfatten,58,,6,6,12
105 Pfatten,59,,9,2,11
105 Pfatten,60,,3,2,5
105 Pfatten,61,,7,7,14
105 Pfatten,62,,5,4,9
105 Pfatten,63,,6,3,9
105 Pfatten,64,,5,2,7
105 Pfatten,65,,2,3,5
105 Pfatten,66,,4,3,7
105 Pfatten,67,,5,6,11
105 Pfatten,68,,3,3,6
105 Pfatten,69,,4,2,6
105 Pfatten,70,,1,2,3
105 Pfatten,71,,4,1,5
105 Pfatten,72,,3,3,6
105 Pfatten,73,,6,3,9
105 Pfatten,74,,4,6,10
105 Pfatten,75,,1,2,3
105 Pfatten,76,,-,5,5
105 Pfatten,77,,2,4,6
105 Pfatten,78,,2,2,4
105 Pfatten,79,,-,5,5
105 Pfatten,80,,-,1,1
105 Pfatten,82,,2,2,4
105 Pfatten,83,,1,3,4
105 Pfatten,84,,1,3,4
105 Pfatten,85,,2,-,2
105 Pfatten,86,,1,-,1
105 Pfatten,87,,-,1,1
105 Pfatten,88,,-,1,1
105 Pfatten,90,,-,1,1
105 Pfatten,91,,1,1,2
105 Pfatten,92,,-,1,1
105 Pfatten,Insgesamt,,505,500,1.005
106 Olang,0,,21,18,39
106 Olang,1,,12,20,32
106 Olang,2,,6,18,24
106 Olang,3,,23,11,34
106 Olang,4,,16,12,28
106 Olang,5,,20,11,31
106 Olang,6,,16,14,30
106 Olang,7,,19,21,40
106 Olang,8,,18,23,41
106 Olang,9,,17,17,34
106 Olang,10,,18,23,41
106 Olang,11,,24,18,42
106 Olang,12,,27,23,50
106 Olang,13,,19,10,29
106 Olang,14,,21,11,32
106 Olang,15,,21,24,45
106 Olang,16,,16,17,33
106 Olang,17,,26,19,45
106 Olang,18,,25,23,48
106 Olang,19,,22,19,41
106 Olang,20,,16,19,35
106 Olang,21,,26,21,47
106 Olang,22,,16,18,34
106 Olang,23,,13,26,39
106 Olang,24,,26,13,39
106 Olang,25,,16,19,35
106 Olang,26,,22,26,48
106 Olang,27,,12,21,33
106 Olang,28,,22,22,44
106 Olang,29,,18,24,42
106 Olang,30,,21,19,40
106 Olang,31,,31,29,60
106 Olang,32,,22,23,45
106 Olang,33,,27,27,54
106 Olang,34,,15,28,43
106 Olang,35,,28,27,55
106 Olang,36,,26,18,44
106 Olang,37,,32,21,53
106 Olang,38,,23,21,44
106 Olang,39,,21,32,53
106 Olang,40,,28,25,53
106 Olang,41,,33,23,56
106 Olang,42,,33,25,58
106 Olang,43,,19,25,44
106 Olang,44,,21,28,49
106 Olang,45,,24,23,47
106 Olang,46,,26,13,39
106 Olang,47,,15,27,42
106 Olang,48,,21,26,47
106 Olang,49,,27,16,43
106 Olang,50,,23,13,36
106 Olang,51,,26,12,38
106 Olang,52,,15,28,43
106 Olang,53,,17,18,35
106 Olang,54,,15,19,34
106 Olang,55,,16,21,37
106 Olang,56,,16,13,29
106 Olang,57,,8,13,21
106 Olang,58,,32,16,48
106 Olang,59,,22,11,33
106 Olang,60,,19,22,41
106 Olang,61,,14,23,37
106 Olang,62,,15,13,28
106 Olang,63,,18,11,29
106 Olang,64,,15,6,21
106 Olang,65,,12,16,28
106 Olang,66,,14,17,31
106 Olang,67,,13,13,26
106 Olang,68,,16,9,25
106 Olang,69,,12,8,20
106 Olang,70,,8,14,22
106 Olang,71,,7,9,16
106 Olang,72,,6,8,14
106 Olang,73,,7,15,22
106 Olang,74,,11,9,20
106 Olang,75,,9,15,24
106 Olang,76,,10,10,20
106 Olang,77,,3,6,9
106 Olang,78,,13,7,20
106 Olang,79,,8,13,21
106 Olang,80,,4,7,11
106 Olang,81,,5,8,13
106 Olang,82,,2,10,12
106 Olang,83,,3,4,7
106 Olang,84,,3,7,10
106 Olang,85,,3,2,5
106 Olang,86,,2,5,7
106 Olang,87,,3,2,5
106 Olang,88,,1,5,6
106 Olang,89,,1,1,2
106 Olang,91,,-,1,1
106 Olang,92,,-,1,1
106 Olang,93,,1,3,4
106 Olang,94,,-,2,2
106 Olang,Insgesamt,,1.515,1.503,3.018
107 Pfitsch,0,,12,22,34
107 Pfitsch,1,,14,9,23
107 Pfitsch,2,,22,12,34
107 Pfitsch,3,,18,17,35
107 Pfitsch,4,,21,11,32
107 Pfitsch,5,,16,11,27
107 Pfitsch,6,,22,20,42
107 Pfitsch,7,,11,10,21
107 Pfitsch,8,,22,25,47
107 Pfitsch,9,,17,18,35
107 Pfitsch,10,,12,17,29
107 Pfitsch,11,,14,14,28
107 Pfitsch,12,,12,14,26
107 Pfitsch,13,,16,10,26
107 Pfitsch,14,,16,20,36
107 Pfitsch,15,,13,14,27
107 Pfitsch,16,,15,15,30
107 Pfitsch,17,,19,14,33
107 Pfitsch,18,,17,16,33
107 Pfitsch,19,,8,18,26
107 Pfitsch,20,,15,15,30
107 Pfitsch,21,,12,17,29
107 Pfitsch,22,,14,8,22
107 Pfitsch,23,,17,11,28
107 Pfitsch,24,,24,12,36
107 Pfitsch,25,,21,27,48
107 Pfitsch,26,,29,16,45
107 Pfitsch,27,,20,19,39
107 Pfitsch,28,,21,17,38
107 Pfitsch,29,,30,17,47
107 Pfitsch,30,,26,19,45
107 Pfitsch,31,,16,17,33
107 Pfitsch,32,,19,24,43
107 Pfitsch,33,,17,27,44
107 Pfitsch,34,,17,20,37
107 Pfitsch,35,,20,20,40
107 Pfitsch,36,,21,20,41
107 Pfitsch,37,,26,15,41
107 Pfitsch,38,,19,21,40
107 Pfitsch,39,,25,20,45
107 Pfitsch,40,,23,21,44
107 Pfitsch,41,,20,16,36
107 Pfitsch,42,,28,17,45
107 Pfitsch,43,,20,21,41
107 Pfitsch,44,,16,27,43
107 Pfitsch,45,,21,18,39
107 Pfitsch,46,,26,18,44
107 Pfitsch,47,,22,21,43
107 Pfitsch,48,,15,24,39
107 Pfitsch,49,,14,17,31
107 Pfitsch,50,,24,15,39
107 Pfitsch,51,,23,23,46
107 Pfitsch,52,,18,12,30
107 Pfitsch,53,,14,14,28
107 Pfitsch,54,,21,21,42
107 Pfitsch,55,,21,14,35
107 Pfitsch,56,,19,23,42
107 Pfitsch,57,,24,14,38
107 Pfitsch,58,,20,20,40
107 Pfitsch,59,,13,19,32
107 Pfitsch,60,,8,8,16
107 Pfitsch,61,,10,11,21
107 Pfitsch,62,,14,13,27
107 Pfitsch,63,,11,12,23
107 Pfitsch,64,,11,14,25
107 Pfitsch,65,,22,11,33
107 Pfitsch,66,,20,13,33
107 Pfitsch,67,,13,17,30
107 Pfitsch,68,,13,15,28
107 Pfitsch,69,,14,8,22
107 Pfitsch,70,,4,14,18
107 Pfitsch,71,,6,11,17
107 Pfitsch,72,,8,12,20
107 Pfitsch,73,,5,7,12
107 Pfitsch,74,,11,5,16
107 Pfitsch,75,,13,11,24
107 Pfitsch,76,,4,13,17
107 Pfitsch,77,,8,9,17
107 Pfitsch,78,,4,12,16
107 Pfitsch,79,,11,10,21
107 Pfitsch,80,,5,12,17
107 Pfitsch,81,,7,9,16
107 Pfitsch,82,,3,9,12
107 Pfitsch,83,,7,8,15
107 Pfitsch,84,,-,13,13
107 Pfitsch,85,,3,8,11
107 Pfitsch,86,,4,4,8
107 Pfitsch,87,,3,7,10
107 Pfitsch,88,,-,4,4
107 Pfitsch,89,,2,2,4
107 Pfitsch,90,,-,1,1
107 Pfitsch,91,,1,2,3
107 Pfitsch,92,,1,1,2
107 Pfitsch,93,,1,1,2
107 Pfitsch,96,,-,1,1
107 Pfitsch,97,,-,1,1
107 Pfitsch,98,,-,1,1
107 Pfitsch,Insgesamt,,1.375,1.354,2.729
108 Ahrntal,0,,27,49,76
108 Ahrntal,1,,39,41,80
108 Ahrntal,2,,39,35,74
108 Ahrntal,3,,34,36,70
108 Ahrntal,4,,30,37,67
108 Ahrntal,5,,31,38,69
108 Ahrntal,6,,30,33,63
108 Ahrntal,7,,33,31,64
108 Ahrntal,8,,49,41,90
108 Ahrntal,9,,33,37,70
108 Ahrntal,10,,36,36,72
108 Ahrntal,11,,41,44,85
108 Ahrntal,12,,39,51,90
108 Ahrntal,13,,36,31,67
108 Ahrntal,14,,27,26,53
108 Ahrntal,15,,39,40,79
108 Ahrntal,16,,41,34,75
108 Ahrntal,17,,27,36,63
108 Ahrntal,18,,41,31,72
108 Ahrntal,19,,39,35,74
108 Ahrntal,20,,28,32,60
108 Ahrntal,21,,37,38,75
108 Ahrntal,22,,37,50,87
108 Ahrntal,23,,38,43,81
108 Ahrntal,24,,42,31,73
108 Ahrntal,25,,46,48,94
108 Ahrntal,26,,43,46,89
108 Ahrntal,27,,53,38,91
108 Ahrntal,28,,38,36,74
108 Ahrntal,29,,39,44,83
108 Ahrntal,30,,35,42,77
108 Ahrntal,31,,50,44,94
108 Ahrntal,32,,51,42,93
108 Ahrntal,33,,41,40,81
108 Ahrntal,34,,50,39,89
108 Ahrntal,35,,48,38,86
108 Ahrntal,36,,57,54,111
108 Ahrntal,37,,67,43,110
108 Ahrntal,38,,53,44,97
108 Ahrntal,39,,52,44,96
108 Ahrntal,40,,52,42,94
108 Ahrntal,41,,42,49,91
108 Ahrntal,42,,59,42,101
108 Ahrntal,43,,59,45,104
108 Ahrntal,44,,53,43,96
108 Ahrntal,45,,51,44,95
108 Ahrntal,46,,37,51,88
108 Ahrntal,47,,34,37,71
108 Ahrntal,48,,40,30,70
108 Ahrntal,49,,42,39,81
108 Ahrntal,50,,47,29,76
108 Ahrntal,51,,26,38,64
108 Ahrntal,52,,36,19,55
108 Ahrntal,53,,36,26,62
108 Ahrntal,54,,35,21,56
108 Ahrntal,55,,27,29,56
108 Ahrntal,56,,27,34,61
108 Ahrntal,57,,33,25,58
108 Ahrntal,58,,31,20,51
108 Ahrntal,59,,32,31,63
108 Ahrntal,60,,28,27,55
108 Ahrntal,61,,25,18,43
108 Ahrntal,62,,17,22,39
108 Ahrntal,63,,20,13,33
108 Ahrntal,64,,19,18,37
108 Ahrntal,65,,23,33,56
108 Ahrntal,66,,28,31,59
108 Ahrntal,67,,30,33,63
108 Ahrntal,68,,31,23,54
108 Ahrntal,69,,24,24,48
108 Ahrntal,70,,34,29,63
108 Ahrntal,71,,25,22,47
108 Ahrntal,72,,20,15,35
108 Ahrntal,73,,18,37,55
108 Ahrntal,74,,19,20,39
108 Ahrntal,75,,17,17,34
108 Ahrntal,76,,17,26,43
108 Ahrntal,77,,25,17,42
108 Ahrntal,78,,18,17,35
108 Ahrntal,79,,14,16,30
108 Ahrntal,80,,12,24,36
108 Ahrntal,81,,12,17,29
108 Ahrntal,82,,13,15,28
108 Ahrntal,83,,7,15,22
108 Ahrntal,84,,9,11,20
108 Ahrntal,85,,6,9,15
108 Ahrntal,86,,5,12,17
108 Ahrntal,87,,4,6,10
108 Ahrntal,88,,2,5,7
108 Ahrntal,89,,6,4,10
108 Ahrntal,90,,-,4,4
108 Ahrntal,91,,1,4,5
108 Ahrntal,92,,1,1,2
108 Ahrntal,93,,1,5,6
108 Ahrntal,94,,1,6,7
108 Ahrntal,98,,1,-,1
108 Ahrntal,101,,-,1,1
108 Ahrntal,Insgesamt,,2.948,2.869,5.817
109 Gsies,0,,14,10,24
109 Gsies,1,,18,11,29
109 Gsies,2,,22,18,40
109 Gsies,3,,16,15,31
109 Gsies,4,,9,13,22
109 Gsies,5,,19,17,36
109 Gsies,6,,13,12,25
109 Gsies,7,,14,14,28
109 Gsies,8,,10,12,22
109 Gsies,9,,27,10,37
109 Gsies,10,,18,5,23
109 Gsies,11,,14,16,30
109 Gsies,12,,10,17,27
109 Gsies,13,,15,17,32
109 Gsies,14,,9,17,26
109 Gsies,15,,17,18,35
109 Gsies,16,,17,10,27
109 Gsies,17,,14,24,38
109 Gsies,18,,17,12,29
109 Gsies,19,,10,13,23
109 Gsies,20,,7,17,24
109 Gsies,21,,20,17,37
109 Gsies,22,,12,16,28
109 Gsies,23,,17,14,31
109 Gsies,24,,14,9,23
109 Gsies,25,,17,10,27
109 Gsies,26,,18,19,37
109 Gsies,27,,16,16,32
109 Gsies,28,,21,22,43
109 Gsies,29,,9,14,23
109 Gsies,30,,15,11,26
109 Gsies,31,,13,17,30
109 Gsies,32,,12,17,29
109 Gsies,33,,17,20,37
109 Gsies,34,,18,17,35
109 Gsies,35,,13,11,24
109 Gsies,36,,9,21,30
109 Gsies,37,,20,17,37
109 Gsies,38,,26,13,39
109 Gsies,39,,25,11,36
109 Gsies,40,,16,15,31
109 Gsies,41,,17,13,30
109 Gsies,42,,15,19,34
109 Gsies,43,,19,5,24
109 Gsies,44,,16,18,34
109 Gsies,45,,14,14,28
109 Gsies,46,,16,8,24
109 Gsies,47,,9,14,23
109 Gsies,48,,16,20,36
109 Gsies,49,,12,14,26
109 Gsies,50,,16,16,32
109 Gsies,51,,12,14,26
109 Gsies,52,,16,6,22
109 Gsies,53,,15,10,25
109 Gsies,54,,16,6,22
109 Gsies,55,,19,6,25
109 Gsies,56,,17,14,31
109 Gsies,57,,15,12,27
109 Gsies,58,,10,8,18
109 Gsies,59,,15,16,31
109 Gsies,60,,7,10,17
109 Gsies,61,,22,6,28
109 Gsies,62,,15,11,26
109 Gsies,63,,4,12,16
109 Gsies,64,,7,13,20
109 Gsies,65,,9,9,18
109 Gsies,66,,5,13,18
109 Gsies,67,,6,11,17
109 Gsies,68,,8,11,19
109 Gsies,69,,6,9,15
109 Gsies,70,,9,8,17
109 Gsies,71,,10,7,17
109 Gsies,72,,4,10,14
109 Gsies,73,,4,8,12
109 Gsies,74,,3,8,11
109 Gsies,75,,6,6,12
109 Gsies,76,,7,4,11
109 Gsies,77,,6,8,14
109 Gsies,78,,10,6,16
109 Gsies,79,,3,5,8
109 Gsies,80,,8,9,17
109 Gsies,81,,1,9,10
109 Gsies,82,,3,4,7
109 Gsies,83,,5,5,10
109 Gsies,84,,3,5,8
109 Gsies,85,,5,6,11
109 Gsies,86,,4,6,10
109 Gsies,87,,2,7,9
109 Gsies,88,,3,2,5
109 Gsies,89,,1,1,2
109 Gsies,90,,-,1,1
109 Gsies,91,,1,-,1
109 Gsies,93,,1,-,1
109 Gsies,97,,-,1,1
109 Gsies,Insgesamt,,1.111,1.069,2.180
110 Vintl,0,,20,17,37
110 Vintl,1,,23,19,42
110 Vintl,2,,11,16,27
110 Vintl,3,,21,23,44
110 Vintl,4,,12,13,25
110 Vintl,5,,15,18,33
110 Vintl,6,,14,20,34
110 Vintl,7,,17,20,37
110 Vintl,8,,22,17,39
110 Vintl,9,,21,25,46
110 Vintl,10,,20,28,48
110 Vintl,11,,20,16,36
110 Vintl,12,,21,19,40
110 Vintl,13,,38,25,63
110 Vintl,14,,18,18,36
110 Vintl,15,,25,20,45
110 Vintl,16,,29,21,50
110 Vintl,17,,22,30,52
110 Vintl,18,,30,22,52
110 Vintl,19,,26,16,42
110 Vintl,20,,22,22,44
110 Vintl,21,,20,25,45
110 Vintl,22,,22,22,44
110 Vintl,23,,9,17,26
110 Vintl,24,,25,11,36
110 Vintl,25,,23,20,43
110 Vintl,26,,23,24,47
110 Vintl,27,,17,21,38
110 Vintl,28,,32,21,53
110 Vintl,29,,31,18,49
110 Vintl,30,,23,34,57
110 Vintl,31,,18,24,42
110 Vintl,32,,23,24,47
110 Vintl,33,,25,17,42
110 Vintl,34,,29,26,55
110 Vintl,35,,18,20,38
110 Vintl,36,,28,17,45
110 Vintl,37,,29,26,55
110 Vintl,38,,17,19,36
110 Vintl,39,,28,26,54
110 Vintl,40,,28,23,51
110 Vintl,41,,30,34,64
110 Vintl,42,,31,28,59
110 Vintl,43,,32,30,62
110 Vintl,44,,35,21,56
110 Vintl,45,,32,27,59
110 Vintl,46,,33,22,55
110 Vintl,47,,27,34,61
110 Vintl,48,,17,22,39
110 Vintl,49,,21,20,41
110 Vintl,50,,21,13,34
110 Vintl,51,,23,27,50
110 Vintl,52,,26,17,43
110 Vintl,53,,20,14,34
110 Vintl,54,,16,18,34
110 Vintl,55,,21,9,30
110 Vintl,56,,16,17,33
110 Vintl,57,,22,16,38
110 Vintl,58,,21,19,40
110 Vintl,59,,18,20,38
110 Vintl,60,,14,13,27
110 Vintl,61,,21,14,35
110 Vintl,62,,17,12,29
110 Vintl,63,,14,19,33
110 Vintl,64,,11,5,16
110 Vintl,65,,21,11,32
110 Vintl,66,,11,10,21
110 Vintl,67,,7,16,23
110 Vintl,68,,8,19,27
110 Vintl,69,,16,15,31
110 Vintl,70,,10,5,15
110 Vintl,71,,9,9,18
110 Vintl,72,,14,11,25
110 Vintl,73,,9,10,19
110 Vintl,74,,15,9,24
110 Vintl,75,,4,18,22
110 Vintl,76,,9,14,23
110 Vintl,77,,9,10,19
110 Vintl,78,,7,14,21
110 Vintl,79,,6,14,20
110 Vintl,80,,7,8,15
110 Vintl,81,,7,12,19
110 Vintl,82,,11,5,16
110 Vintl,83,,3,7,10
110 Vintl,84,,2,7,9
110 Vintl,85,,3,6,9
110 Vintl,86,,3,6,9
110 Vintl,87,,3,3,6
110 Vintl,88,,-,7,7
110 Vintl,89,,1,3,4
110 Vintl,90,,-,1,1
110 Vintl,91,,-,2,2
110 Vintl,92,,-,2,2
110 Vintl,93,,1,2,3
110 Vintl,94,,-,2,2
110 Vintl,96,,1,-,1
110 Vintl,97,,-,1,1
110 Vintl,Insgesamt,,1.651,1.590,3.241
111 Vahrn,0,,17,30,47
111 Vahrn,1,,35,19,54
111 Vahrn,2,,35,29,64
111 Vahrn,3,,31,31,62
111 Vahrn,4,,28,29,57
111 Vahrn,5,,27,14,41
111 Vahrn,6,,30,31,61
111 Vahrn,7,,26,20,46
111 Vahrn,8,,28,22,50
111 Vahrn,9,,26,36,62
111 Vahrn,10,,22,22,44
111 Vahrn,11,,19,24,43
111 Vahrn,12,,37,21,58
111 Vahrn,13,,23,21,44
111 Vahrn,14,,22,24,46
111 Vahrn,15,,22,22,44
111 Vahrn,16,,21,24,45
111 Vahrn,17,,22,23,45
111 Vahrn,18,,15,28,43
111 Vahrn,19,,28,20,48
111 Vahrn,20,,25,19,44
111 Vahrn,21,,19,20,39
111 Vahrn,22,,22,15,37
111 Vahrn,23,,27,29,56
111 Vahrn,24,,20,19,39
111 Vahrn,25,,25,28,53
111 Vahrn,26,,27,32,59
111 Vahrn,27,,31,27,58
111 Vahrn,28,,23,34,57
111 Vahrn,29,,20,32,52
111 Vahrn,30,,31,35,66
111 Vahrn,31,,25,27,52
111 Vahrn,32,,45,27,72
111 Vahrn,33,,37,33,70
111 Vahrn,34,,35,42,77
111 Vahrn,35,,41,41,82
111 Vahrn,36,,38,42,80
111 Vahrn,37,,41,30,71
111 Vahrn,38,,45,40,85
111 Vahrn,39,,46,44,90
111 Vahrn,40,,29,34,63
111 Vahrn,41,,47,32,79
111 Vahrn,42,,41,33,74
111 Vahrn,43,,45,42,87
111 Vahrn,44,,38,38,76
111 Vahrn,45,,35,33,68
111 Vahrn,46,,28,35,63
111 Vahrn,47,,26,21,47
111 Vahrn,48,,36,30,66
111 Vahrn,49,,31,27,58
111 Vahrn,50,,21,21,42
111 Vahrn,51,,30,28,58
111 Vahrn,52,,22,22,44
111 Vahrn,53,,28,30,58
111 Vahrn,54,,18,32,50
111 Vahrn,55,,25,24,49
111 Vahrn,56,,23,16,39
111 Vahrn,57,,22,15,37
111 Vahrn,58,,18,21,39
111 Vahrn,59,,22,31,53
111 Vahrn,60,,19,18,37
111 Vahrn,61,,15,26,41
111 Vahrn,62,,20,23,43
111 Vahrn,63,,12,17,29
111 Vahrn,64,,19,21,40
111 Vahrn,65,,23,24,47
111 Vahrn,66,,17,22,39
111 Vahrn,67,,19,22,41
111 Vahrn,68,,20,17,37
111 Vahrn,69,,20,21,41
111 Vahrn,70,,13,9,22
111 Vahrn,71,,16,19,35
111 Vahrn,72,,10,17,27
111 Vahrn,73,,8,14,22
111 Vahrn,74,,12,14,26
111 Vahrn,75,,9,13,22
111 Vahrn,76,,9,12,21
111 Vahrn,77,,8,12,20
111 Vahrn,78,,13,13,26
111 Vahrn,79,,6,19,25
111 Vahrn,80,,7,12,19
111 Vahrn,81,,3,16,19
111 Vahrn,82,,4,3,7
111 Vahrn,83,,2,11,13
111 Vahrn,84,,5,12,17
111 Vahrn,85,,5,8,13
111 Vahrn,86,,2,9,11
111 Vahrn,87,,3,6,9
111 Vahrn,88,,1,4,5
111 Vahrn,89,,3,1,4
111 Vahrn,90,,-,1,1
111 Vahrn,91,,2,2,4
111 Vahrn,92,,1,-,1
111 Vahrn,94,,-,2,2
111 Vahrn,96,,-,1,1
111 Vahrn,97,,-,1,1
111 Vahrn,98,,-,1,1
111 Vahrn,Insgesamt,,2.048,2.114,4.162
112 Vöran,0,,5,3,8
112 Vöran,1,,6,3,9
112 Vöran,2,,8,2,10
112 Vöran,3,,2,4,6
112 Vöran,4,,2,5,7
112 Vöran,5,,8,6,14
112 Vöran,6,,5,5,10
112 Vöran,7,,8,4,12
112 Vöran,8,,11,5,16
112 Vöran,9,,5,3,8
112 Vöran,10,,5,4,9
112 Vöran,11,,11,6,17
112 Vöran,12,,10,5,15
112 Vöran,13,,5,9,14
112 Vöran,14,,7,7,14
112 Vöran,15,,8,6,14
112 Vöran,16,,6,3,9
112 Vöran,17,,7,3,10
112 Vöran,18,,5,7,12
112 Vöran,19,,10,5,15
112 Vöran,20,,8,9,17
112 Vöran,21,,11,6,17
112 Vöran,22,,6,6,12
112 Vöran,23,,9,9,18
112 Vöran,24,,9,5,14
112 Vöran,25,,6,5,11
112 Vöran,26,,7,8,15
112 Vöran,27,,10,10,20
112 Vöran,28,,4,5,9
112 Vöran,29,,3,7,10
112 Vöran,30,,9,9,18
112 Vöran,31,,10,6,16
112 Vöran,32,,6,5,11
112 Vöran,33,,8,5,13
112 Vöran,34,,14,8,22
112 Vöran,35,,5,5,10
112 Vöran,36,,9,7,16
112 Vöran,37,,8,11,19
112 Vöran,38,,8,5,13
112 Vöran,39,,6,4,10
112 Vöran,40,,14,3,17
112 Vöran,41,,3,7,10
112 Vöran,42,,10,6,16
112 Vöran,43,,4,3,7
112 Vöran,44,,11,4,15
112 Vöran,45,,8,7,15
112 Vöran,46,,13,14,27
112 Vöran,47,,4,5,9
112 Vöran,48,,6,6,12
112 Vöran,49,,3,7,10
112 Vöran,50,,7,6,13
112 Vöran,51,,4,9,13
112 Vöran,52,,2,1,3
112 Vöran,53,,6,2,8
112 Vöran,54,,5,5,10
112 Vöran,55,,5,4,9
112 Vöran,56,,9,1,10
112 Vöran,57,,4,1,5
112 Vöran,58,,7,4,11
112 Vöran,59,,7,6,13
112 Vöran,60,,2,3,5
112 Vöran,61,,5,3,8
112 Vöran,62,,4,2,6
112 Vöran,63,,-,4,4
112 Vöran,64,,4,3,7
112 Vöran,65,,3,5,8
112 Vöran,66,,6,4,10
112 Vöran,67,,4,6,10
112 Vöran,68,,3,5,8
112 Vöran,69,,2,3,5
112 Vöran,70,,8,3,11
112 Vöran,71,,2,2,4
112 Vöran,72,,3,5,8
112 Vöran,73,,2,-,2
112 Vöran,74,,1,6,7
112 Vöran,75,,6,6,12
112 Vöran,76,,2,4,6
112 Vöran,77,,3,-,3
112 Vöran,78,,5,1,6
112 Vöran,79,,1,2,3
112 Vöran,80,,4,1,5
112 Vöran,81,,-,2,2
112 Vöran,82,,-,3,3
112 Vöran,83,,2,3,5
112 Vöran,84,,-,1,1
112 Vöran,85,,1,1,2
112 Vöran,86,,1,-,1
112 Vöran,87,,1,-,1
112 Vöran,88,,-,1,1
112 Vöran,97,,-,1,1
112 Vöran,Insgesamt,,497,411,908
113 Niederdorf,0,,10,7,17
113 Niederdorf,1,,8,11,19
113 Niederdorf,2,,8,8,16
113 Niederdorf,3,,15,8,23
113 Niederdorf,4,,10,14,24
113 Niederdorf,5,,9,13,22
113 Niederdorf,6,,5,11,16
113 Niederdorf,7,,9,10,19
113 Niederdorf,8,,12,11,23
113 Niederdorf,9,,4,5,9
113 Niederdorf,10,,7,12,19
113 Niederdorf,11,,9,9,18
113 Niederdorf,12,,7,7,14
113 Niederdorf,13,,6,10,16
113 Niederdorf,14,,13,8,21
113 Niederdorf,15,,9,6,15
113 Niederdorf,16,,8,10,18
113 Niederdorf,17,,8,12,20
113 Niederdorf,18,,12,11,23
113 Niederdorf,19,,9,6,15
113 Niederdorf,20,,8,9,17
113 Niederdorf,21,,2,10,12
113 Niederdorf,22,,4,8,12
113 Niederdorf,23,,8,6,14
113 Niederdorf,24,,8,6,14
113 Niederdorf,25,,8,9,17
113 Niederdorf,26,,4,15,19
113 Niederdorf,27,,8,6,14
113 Niederdorf,28,,9,6,15
113 Niederdorf,29,,10,5,15
113 Niederdorf,30,,5,1,6
113 Niederdorf,31,,8,7,15
113 Niederdorf,32,,12,9,21
113 Niederdorf,33,,6,11,17
113 Niederdorf,34,,11,12,23
113 Niederdorf,35,,15,12,27
113 Niederdorf,36,,17,7,24
113 Niederdorf,37,,7,14,21
113 Niederdorf,38,,10,11,21
113 Niederdorf,39,,21,16,37
113 Niederdorf,40,,15,9,24
113 Niederdorf,41,,14,17,31
113 Niederdorf,42,,24,10,34
113 Niederdorf,43,,9,17,26
113 Niederdorf,44,,19,14,33
113 Niederdorf,45,,9,9,18
113 Niederdorf,46,,22,9,31
113 Niederdorf,47,,13,10,23
113 Niederdorf,48,,8,10,18
113 Niederdorf,49,,11,9,20
113 Niederdorf,50,,6,5,11
113 Niederdorf,51,,10,11,21
113 Niederdorf,52,,9,12,21
113 Niederdorf,53,,10,7,17
113 Niederdorf,54,,11,6,17
113 Niederdorf,55,,6,4,10
113 Niederdorf,56,,8,4,12
113 Niederdorf,57,,2,2,4
113 Niederdorf,58,,5,4,9
113 Niederdorf,59,,9,4,13
113 Niederdorf,60,,5,8,13
113 Niederdorf,61,,6,7,13
113 Niederdorf,62,,6,7,13
113 Niederdorf,63,,2,6,8
113 Niederdorf,64,,6,7,13
113 Niederdorf,65,,5,8,13
113 Niederdorf,66,,5,9,14
113 Niederdorf,67,,4,5,9
113 Niederdorf,68,,5,8,13
113 Niederdorf,69,,1,4,5
113 Niederdorf,70,,7,6,13
113 Niederdorf,71,,5,8,13
113 Niederdorf,72,,5,8,13
113 Niederdorf,73,,7,7,14
113 Niederdorf,74,,1,13,14
113 Niederdorf,75,,6,7,13
113 Niederdorf,76,,8,6,14
113 Niederdorf,77,,7,6,13
113 Niederdorf,78,,6,9,15
113 Niederdorf,79,,5,8,13
113 Niederdorf,80,,4,6,10
113 Niederdorf,81,,5,9,14
113 Niederdorf,82,,3,5,8
113 Niederdorf,83,,-,5,5
113 Niederdorf,84,,3,8,11
113 Niederdorf,85,,2,2,4
113 Niederdorf,86,,1,6,7
113 Niederdorf,87,,5,5,10
113 Niederdorf,88,,-,3,3
113 Niederdorf,90,,-,1,1
113 Niederdorf,91,,1,-,1
113 Niederdorf,92,,-,1,1
113 Niederdorf,93,,-,2,2
113 Niederdorf,94,,-,1,1
113 Niederdorf,97,,-,1,1
113 Niederdorf,98,,-,1,1
113 Niederdorf,103,,-,1,1
113 Niederdorf,Insgesamt,,705,746,1.451
114 Villanders,0,,7,8,15
114 Villanders,1,,12,13,25
114 Villanders,2,,13,14,27
114 Villanders,3,,17,7,24
114 Villanders,4,,13,14,27
114 Villanders,5,,6,12,18
114 Villanders,6,,7,10,17
114 Villanders,7,,13,11,24
114 Villanders,8,,10,17,27
114 Villanders,9,,13,11,24
114 Villanders,10,,13,8,21
114 Villanders,11,,10,12,22
114 Villanders,12,,14,8,22
114 Villanders,13,,17,6,23
114 Villanders,14,,11,12,23
114 Villanders,15,,7,18,25
114 Villanders,16,,14,8,22
114 Villanders,17,,16,14,30
114 Villanders,18,,16,14,30
114 Villanders,19,,14,10,24
114 Villanders,20,,11,13,24
114 Villanders,21,,7,16,23
114 Villanders,22,,10,10,20
114 Villanders,23,,10,12,22
114 Villanders,24,,13,15,28
114 Villanders,25,,15,3,18
114 Villanders,26,,16,12,28
114 Villanders,27,,22,10,32
114 Villanders,28,,10,17,27
114 Villanders,29,,17,6,23
114 Villanders,30,,10,10,20
114 Villanders,31,,19,13,32
114 Villanders,32,,15,10,25
114 Villanders,33,,10,12,22
114 Villanders,34,,15,17,32
114 Villanders,35,,11,18,29
114 Villanders,36,,16,20,36
114 Villanders,37,,16,17,33
114 Villanders,38,,16,10,26
114 Villanders,39,,26,19,45
114 Villanders,40,,24,11,35
114 Villanders,41,,19,13,32
114 Villanders,42,,21,17,38
114 Villanders,43,,23,18,41
114 Villanders,44,,19,16,35
114 Villanders,45,,15,12,27
114 Villanders,46,,18,11,29
114 Villanders,47,,15,11,26
114 Villanders,48,,18,6,24
114 Villanders,49,,15,11,26
114 Villanders,50,,17,7,24
114 Villanders,51,,11,7,18
114 Villanders,52,,10,9,19
114 Villanders,53,,11,17,28
114 Villanders,54,,8,6,14
114 Villanders,55,,11,11,22
114 Villanders,56,,12,7,19
114 Villanders,57,,10,7,17
114 Villanders,58,,12,8,20
114 Villanders,59,,11,5,16
114 Villanders,60,,8,11,19
114 Villanders,61,,6,8,14
114 Villanders,62,,10,10,20
114 Villanders,63,,6,3,9
114 Villanders,64,,3,9,12
114 Villanders,65,,7,7,14
114 Villanders,66,,10,8,18
114 Villanders,67,,7,9,16
114 Villanders,68,,9,12,21
114 Villanders,69,,7,5,12
114 Villanders,70,,7,6,13
114 Villanders,71,,3,9,12
114 Villanders,72,,6,7,13
114 Villanders,73,,2,7,9
114 Villanders,74,,1,9,10
114 Villanders,75,,8,9,17
114 Villanders,76,,8,9,17
114 Villanders,77,,5,8,13
114 Villanders,78,,6,5,11
114 Villanders,79,,3,8,11
114 Villanders,80,,3,7,10
114 Villanders,81,,4,5,9
114 Villanders,82,,3,4,7
114 Villanders,83,,2,8,10
114 Villanders,84,,3,3,6
114 Villanders,85,,5,3,8
114 Villanders,86,,1,4,5
114 Villanders,87,,1,8,9
114 Villanders,88,,1,4,5
114 Villanders,89,,1,4,5
114 Villanders,93,,-,2,2
114 Villanders,95,,-,2,2
114 Villanders,96,,1,1,2
114 Villanders,97,,-,1,1
114 Villanders,Insgesamt,,975,912,1.887
115 Sterzing,0,,41,31,72
115 Sterzing,1,,34,33,67
115 Sterzing,2,,37,27,64
115 Sterzing,3,,32,27,59
115 Sterzing,4,,28,32,60
115 Sterzing,5,,31,37,68
115 Sterzing,6,,33,27,60
115 Sterzing,7,,33,33,66
115 Sterzing,8,,27,33,60
115 Sterzing,9,,32,21,53
115 Sterzing,10,,25,31,56
115 Sterzing,11,,34,33,67
115 Sterzing,12,,30,37,67
115 Sterzing,13,,35,27,62
115 Sterzing,14,,31,22,53
115 Sterzing,15,,33,27,60
115 Sterzing,16,,32,35,67
115 Sterzing,17,,35,31,66
115 Sterzing,18,,27,37,64
115 Sterzing,19,,38,24,62
115 Sterzing,20,,34,25,59
115 Sterzing,21,,28,27,55
115 Sterzing,22,,40,32,72
115 Sterzing,23,,21,34,55
115 Sterzing,24,,38,37,75
115 Sterzing,25,,52,37,89
115 Sterzing,26,,63,47,110
115 Sterzing,27,,83,42,125
115 Sterzing,28,,47,50,97
115 Sterzing,29,,49,50,99
115 Sterzing,30,,56,35,91
115 Sterzing,31,,45,41,86
115 Sterzing,32,,37,42,79
115 Sterzing,33,,55,46,101
115 Sterzing,34,,50,43,93
115 Sterzing,35,,47,62,109
115 Sterzing,36,,55,54,109
115 Sterzing,37,,49,50,99
115 Sterzing,38,,57,56,113
115 Sterzing,39,,48,36,84
115 Sterzing,40,,55,60,115
115 Sterzing,41,,65,44,109
115 Sterzing,42,,51,52,103
115 Sterzing,43,,56,45,101
115 Sterzing,44,,50,43,93
115 Sterzing,45,,49,52,101
115 Sterzing,46,,41,51,92
115 Sterzing,47,,43,39,82
115 Sterzing,48,,43,46,89
115 Sterzing,49,,55,40,95
115 Sterzing,50,,43,40,83
115 Sterzing,51,,34,46,80
115 Sterzing,52,,42,27,69
115 Sterzing,53,,37,45,82
115 Sterzing,54,,34,36,70
115 Sterzing,55,,29,41,70
115 Sterzing,56,,42,36,78
115 Sterzing,57,,35,41,76
115 Sterzing,58,,39,35,74
115 Sterzing,59,,35,47,82
115 Sterzing,60,,39,43,82
115 Sterzing,61,,28,30,58
115 Sterzing,62,,43,43,86
115 Sterzing,63,,36,37,73
115 Sterzing,64,,32,29,61
115 Sterzing,65,,39,49,88
115 Sterzing,66,,25,36,61
115 Sterzing,67,,29,27,56
115 Sterzing,68,,37,30,67
115 Sterzing,69,,23,32,55
115 Sterzing,70,,29,28,57
115 Sterzing,71,,17,36,53
115 Sterzing,72,,20,40,60
115 Sterzing,73,,22,25,47
115 Sterzing,74,,16,23,39
115 Sterzing,75,,25,30,55
115 Sterzing,76,,12,14,26
115 Sterzing,77,,21,32,53
115 Sterzing,78,,7,23,30
115 Sterzing,79,,14,18,32
115 Sterzing,80,,17,24,41
115 Sterzing,81,,13,18,31
115 Sterzing,82,,8,18,26
115 Sterzing,83,,3,14,17
115 Sterzing,84,,8,13,21
115 Sterzing,85,,6,14,20
115 Sterzing,86,,7,19,26
115 Sterzing,87,,2,11,13
115 Sterzing,88,,1,5,6
115 Sterzing,89,,3,4,7
115 Sterzing,90,,1,2,3
115 Sterzing,91,,1,1,2
115 Sterzing,92,,-,1,1
115 Sterzing,93,,1,2,3
115 Sterzing,94,,1,3,4
115 Sterzing,95,,-,1,1
115 Sterzing,96,,-,3,3
115 Sterzing,99,,-,1,1
115 Sterzing,Insgesamt,,3.066,3.096,6.162
116 Feldthurns,0,,19,17,36
116 Feldthurns,1,,25,16,41
116 Feldthurns,2,,27,22,49
116 Feldthurns,3,,23,17,40
116 Feldthurns,4,,20,16,36
116 Feldthurns,5,,12,13,25
116 Feldthurns,6,,22,20,42
116 Feldthurns,7,,17,19,36
116 Feldthurns,8,,24,14,38
116 Feldthurns,9,,19,20,39
116 Feldthurns,10,,21,19,40
116 Feldthurns,11,,22,16,38
116 Feldthurns,12,,15,20,35
116 Feldthurns,13,,18,19,37
116 Feldthurns,14,,15,19,34
116 Feldthurns,15,,26,19,45
116 Feldthurns,16,,19,19,38
116 Feldthurns,17,,14,12,26
116 Feldthurns,18,,13,16,29
116 Feldthurns,19,,22,14,36
116 Feldthurns,20,,14,19,33
116 Feldthurns,21,,23,11,34
116 Feldthurns,22,,18,22,40
116 Feldthurns,23,,14,20,34
116 Feldthurns,24,,16,22,38
116 Feldthurns,25,,22,23,45
116 Feldthurns,26,,15,18,33
116 Feldthurns,27,,21,19,40
116 Feldthurns,28,,12,22,34
116 Feldthurns,29,,12,19,31
116 Feldthurns,30,,29,19,48
116 Feldthurns,31,,20,14,34
116 Feldthurns,32,,22,21,43
116 Feldthurns,33,,20,19,39
116 Feldthurns,34,,23,26,49
116 Feldthurns,35,,20,18,38
116 Feldthurns,36,,30,24,54
116 Feldthurns,37,,19,23,42
116 Feldthurns,38,,20,20,40
116 Feldthurns,39,,23,27,50
116 Feldthurns,40,,19,26,45
116 Feldthurns,41,,22,23,45
116 Feldthurns,42,,22,21,43
116 Feldthurns,43,,26,26,52
116 Feldthurns,44,,25,19,44
116 Feldthurns,45,,29,18,47
116 Feldthurns,46,,14,19,33
116 Feldthurns,47,,18,18,36
116 Feldthurns,48,,17,14,31
116 Feldthurns,49,,16,16,32
116 Feldthurns,50,,15,19,34
116 Feldthurns,51,,14,13,27
116 Feldthurns,52,,11,18,29
116 Feldthurns,53,,12,12,24
116 Feldthurns,54,,14,14,28
116 Feldthurns,55,,19,13,32
116 Feldthurns,56,,22,15,37
116 Feldthurns,57,,13,12,25
116 Feldthurns,58,,14,14,28
116 Feldthurns,59,,7,14,21
116 Feldthurns,60,,13,11,24
116 Feldthurns,61,,15,9,24
116 Feldthurns,62,,11,10,21
116 Feldthurns,63,,13,12,25
116 Feldthurns,64,,18,11,29
116 Feldthurns,65,,10,12,22
116 Feldthurns,66,,9,7,16
116 Feldthurns,67,,6,4,10
116 Feldthurns,68,,10,6,16
116 Feldthurns,69,,7,11,18
116 Feldthurns,70,,11,8,19
116 Feldthurns,71,,4,9,13
116 Feldthurns,72,,7,10,17
116 Feldthurns,73,,10,11,21
116 Feldthurns,74,,2,5,7
116 Feldthurns,75,,6,4,10
116 Feldthurns,76,,6,10,16
116 Feldthurns,77,,4,7,11
116 Feldthurns,78,,4,14,18
116 Feldthurns,79,,3,10,13
116 Feldthurns,80,,8,4,12
116 Feldthurns,81,,3,4,7
116 Feldthurns,82,,2,7,9
116 Feldthurns,83,,5,7,12
116 Feldthurns,84,,4,8,12
116 Feldthurns,85,,5,6,11
116 Feldthurns,86,,2,6,8
116 Feldthurns,87,,1,7,8
116 Feldthurns,88,,3,7,10
116 Feldthurns,89,,2,2,4
116 Feldthurns,90,,3,-,3
116 Feldthurns,91,,-,1,1
116 Feldthurns,92,,-,2,2
116 Feldthurns,93,,-,4,4
116 Feldthurns,96,,-,1,1
116 Feldthurns,97,,-,1,1
116 Feldthurns,Insgesamt,,1.342,1.345,2.687
117 Wengen,0,,6,9,15
117 Wengen,1,,10,11,21
117 Wengen,2,,6,9,15
117 Wengen,3,,9,4,13
117 Wengen,4,,6,8,14
117 Wengen,5,,4,7,11
117 Wengen,6,,11,4,15
117 Wengen,7,,5,10,15
117 Wengen,8,,10,6,16
117 Wengen,9,,9,5,14
117 Wengen,10,,7,8,15
117 Wengen,11,,12,8,20
117 Wengen,12,,9,8,17
117 Wengen,13,,11,9,20
117 Wengen,14,,12,7,19
117 Wengen,15,,10,7,17
117 Wengen,16,,10,7,17
117 Wengen,17,,17,8,25
117 Wengen,18,,12,7,19
117 Wengen,19,,6,6,12
117 Wengen,20,,6,9,15
117 Wengen,21,,11,5,16
117 Wengen,22,,8,8,16
117 Wengen,23,,9,6,15
117 Wengen,24,,14,8,22
117 Wengen,25,,13,4,17
117 Wengen,26,,11,5,16
117 Wengen,27,,6,8,14
117 Wengen,28,,8,11,19
117 Wengen,29,,12,6,18
117 Wengen,30,,7,6,13
117 Wengen,31,,11,9,20
117 Wengen,32,,6,5,11
117 Wengen,33,,17,10,27
117 Wengen,34,,11,7,18
117 Wengen,35,,18,11,29
117 Wengen,36,,12,11,23
117 Wengen,37,,12,14,26
117 Wengen,38,,11,14,25
117 Wengen,39,,8,10,18
117 Wengen,40,,19,10,29
117 Wengen,41,,10,12,22
117 Wengen,42,,14,6,20
117 Wengen,43,,9,11,20
117 Wengen,44,,11,6,17
117 Wengen,45,,12,12,24
117 Wengen,46,,14,7,21
117 Wengen,47,,7,9,16
117 Wengen,48,,10,12,22
117 Wengen,49,,7,6,13
117 Wengen,50,,5,7,12
117 Wengen,51,,6,11,17
117 Wengen,52,,4,6,10
117 Wengen,53,,7,6,13
117 Wengen,54,,9,4,13
117 Wengen,55,,6,2,8
117 Wengen,56,,6,6,12
117 Wengen,57,,9,6,15
117 Wengen,58,,3,5,8
117 Wengen,59,,4,8,12
117 Wengen,60,,2,11,13
117 Wengen,61,,6,3,9
117 Wengen,62,,5,3,8
117 Wengen,63,,6,3,9
117 Wengen,64,,9,8,17
117 Wengen,65,,3,7,10
117 Wengen,66,,7,6,13
117 Wengen,67,,4,4,8
117 Wengen,68,,6,9,15
117 Wengen,69,,6,3,9
117 Wengen,70,,5,4,9
117 Wengen,71,,6,7,13
117 Wengen,72,,2,1,3
117 Wengen,73,,2,7,9
117 Wengen,74,,2,8,10
117 Wengen,75,,3,2,5
117 Wengen,76,,2,7,9
117 Wengen,77,,5,2,7
117 Wengen,78,,4,2,6
117 Wengen,79,,2,7,9
117 Wengen,80,,1,3,4
117 Wengen,81,,2,3,5
117 Wengen,82,,1,3,4
117 Wengen,83,,2,3,5
117 Wengen,84,,-,4,4
117 Wengen,85,,2,4,6
117 Wengen,86,,3,3,6
117 Wengen,87,,3,7,10
117 Wengen,88,,1,1,2
117 Wengen,91,,2,-,2
117 Wengen,93,,1,-,1
117 Wengen,96,,1,-,1
117 Wengen,Insgesamt,,671,602,1.273
118 U.L.Frau i.W.-St.Felix,0,,1,8,9
118 U.L.Frau i.W.-St.Felix,1,,3,-,3
118 U.L.Frau i.W.-St.Felix,2,,3,2,5
118 U.L.Frau i.W.-St.Felix,3,,5,7,12
118 U.L.Frau i.W.-St.Felix,4,,5,3,8
118 U.L.Frau i.W.-St.Felix,5,,8,7,15
118 U.L.Frau i.W.-St.Felix,6,,7,3,10
118 U.L.Frau i.W.-St.Felix,7,,9,5,14
118 U.L.Frau i.W.-St.Felix,8,,3,2,5
118 U.L.Frau i.W.-St.Felix,9,,5,5,10
118 U.L.Frau i.W.-St.Felix,10,,6,9,15
118 U.L.Frau i.W.-St.Felix,11,,5,4,9
118 U.L.Frau i.W.-St.Felix,12,,8,5,13
118 U.L.Frau i.W.-St.Felix,13,,3,10,13
118 U.L.Frau i.W.-St.Felix,14,,7,7,14
118 U.L.Frau i.W.-St.Felix,15,,9,5,14
118 U.L.Frau i.W.-St.Felix,16,,7,4,11
118 U.L.Frau i.W.-St.Felix,17,,10,7,17
118 U.L.Frau i.W.-St.Felix,18,,6,3,9
118 U.L.Frau i.W.-St.Felix,19,,8,6,14
118 U.L.Frau i.W.-St.Felix,20,,8,5,13
118 U.L.Frau i.W.-St.Felix,21,,4,7,11
118 U.L.Frau i.W.-St.Felix,22,,7,3,10
118 U.L.Frau i.W.-St.Felix,23,,7,6,13
118 U.L.Frau i.W.-St.Felix,24,,7,4,11
118 U.L.Frau i.W.-St.Felix,25,,1,10,11
118 U.L.Frau i.W.-St.Felix,26,,3,6,9
118 U.L.Frau i.W.-St.Felix,27,,8,3,11
118 U.L.Frau i.W.-St.Felix,28,,3,6,9
118 U.L.Frau i.W.-St.Felix,29,,1,2,3
118 U.L.Frau i.W.-St.Felix,30,,-,3,3
118 U.L.Frau i.W.-St.Felix,31,,5,3,8
118 U.L.Frau i.W.-St.Felix,32,,4,7,11
118 U.L.Frau i.W.-St.Felix,33,,8,2,10
118 U.L.Frau i.W.-St.Felix,34,,5,6,11
118 U.L.Frau i.W.-St.Felix,35,,2,3,5
118 U.L.Frau i.W.-St.Felix,36,,7,5,12
118 U.L.Frau i.W.-St.Felix,37,,3,4,7
118 U.L.Frau i.W.-St.Felix,38,,5,9,14
118 U.L.Frau i.W.-St.Felix,39,,7,4,11
118 U.L.Frau i.W.-St.Felix,40,,4,9,13
118 U.L.Frau i.W.-St.Felix,41,,3,4,7
118 U.L.Frau i.W.-St.Felix,42,,8,7,15
118 U.L.Frau i.W.-St.Felix,43,,10,6,16
118 U.L.Frau i.W.-St.Felix,44,,6,8,14
118 U.L.Frau i.W.-St.Felix,45,,16,8,24
118 U.L.Frau i.W.-St.Felix,46,,8,9,17
118 U.L.Frau i.W.-St.Felix,47,,4,4,8
118 U.L.Frau i.W.-St.Felix,48,,8,9,17
118 U.L.Frau i.W.-St.Felix,49,,5,4,9
118 U.L.Frau i.W.-St.Felix,50,,4,2,6
118 U.L.Frau i.W.-St.Felix,51,,3,6,9
118 U.L.Frau i.W.-St.Felix,52,,5,6,11
118 U.L.Frau i.W.-St.Felix,53,,3,4,7
118 U.L.Frau i.W.-St.Felix,54,,6,3,9
118 U.L.Frau i.W.-St.Felix,55,,3,3,6
118 U.L.Frau i.W.-St.Felix,56,,6,3,9
118 U.L.Frau i.W.-St.Felix,57,,6,3,9
118 U.L.Frau i.W.-St.Felix,58,,3,4,7
118 U.L.Frau i.W.-St.Felix,59,,4,-,4
118 U.L.Frau i.W.-St.Felix,60,,4,1,5
118 U.L.Frau i.W.-St.Felix,61,,1,7,8
118 U.L.Frau i.W.-St.Felix,62,,1,4,5
118 U.L.Frau i.W.-St.Felix,63,,3,1,4
118 U.L.Frau i.W.-St.Felix,64,,5,1,6
118 U.L.Frau i.W.-St.Felix,65,,6,4,10
118 U.L.Frau i.W.-St.Felix,66,,2,3,5
118 U.L.Frau i.W.-St.Felix,67,,5,8,13
118 U.L.Frau i.W.-St.Felix,68,,2,-,2
118 U.L.Frau i.W.-St.Felix,69,,1,3,4
118 U.L.Frau i.W.-St.Felix,70,,3,4,7
118 U.L.Frau i.W.-St.Felix,71,,3,-,3
118 U.L.Frau i.W.-St.Felix,72,,4,2,6
118 U.L.Frau i.W.-St.Felix,73,,3,4,7
118 U.L.Frau i.W.-St.Felix,74,,3,3,6
118 U.L.Frau i.W.-St.Felix,75,,5,4,9
118 U.L.Frau i.W.-St.Felix,76,,6,1,7
118 U.L.Frau i.W.-St.Felix,77,,2,1,3
118 U.L.Frau i.W.-St.Felix,78,,4,5,9
118 U.L.Frau i.W.-St.Felix,79,,1,3,4
118 U.L.Frau i.W.-St.Felix,80,,3,4,7
118 U.L.Frau i.W.-St.Felix,81,,2,4,6
118 U.L.Frau i.W.-St.Felix,82,,2,3,5
118 U.L.Frau i.W.-St.Felix,83,,3,5,8
118 U.L.Frau i.W.-St.Felix,84,,1,1,2
118 U.L.Frau i.W.-St.Felix,85,,2,4,6
118 U.L.Frau i.W.-St.Felix,86,,1,-,1
118 U.L.Frau i.W.-St.Felix,87,,-,2,2
118 U.L.Frau i.W.-St.Felix,88,,-,1,1
118 U.L.Frau i.W.-St.Felix,91,,-,1,1
118 U.L.Frau i.W.-St.Felix,95,,1,-,1
118 U.L.Frau i.W.-St.Felix,96,,1,-,1
118 U.L.Frau i.W.-St.Felix,Insgesamt,,408,386,794
Insgesamt,,,245.311,251.440,496.751
