Gemeinde,Altersklassen,Geschlecht,Männer,Frauen,Insgesamt
001 Aldein,0,,5,10,15
001 Aldein,1,,7,13,20
001 Aldein,2,,8,11,19
001 Aldein,3,,7,15,22
001 Aldein,4,,10,8,18
001 Aldein,5,,17,9,26
001 Aldein,6,,14,9,23
001 Aldein,7,,11,9,20
001 Aldein,8,,16,8,24
001 Aldein,9,,12,4,16
001 Aldein,10,,16,14,30
001 Aldein,11,,10,16,26
001 Aldein,12,,15,8,23
001 Aldein,13,,7,8,15
001 Aldein,14,,8,12,20
001 Aldein,15,,14,7,21
001 Aldein,16,,13,11,24
001 Aldein,17,,9,13,22
001 Aldein,18,,7,7,14
001 Aldein,19,,7,6,13
001 Aldein,20,,9,16,25
001 Aldein,21,,11,9,20
001 Aldein,22,,11,8,19
001 Aldein,23,,12,8,20
001 Aldein,24,,14,14,28
001 Aldein,25,,10,7,17
001 Aldein,26,,11,12,23
001 Aldein,27,,14,4,18
001 Aldein,28,,10,11,21
001 Aldein,29,,9,14,23
001 Aldein,30,,9,12,21
001 Aldein,31,,10,8,18
001 Aldein,32,,9,18,27
001 Aldein,33,,9,15,24
001 Aldein,34,,17,14,31
001 Aldein,35,,13,11,24
001 Aldein,36,,14,10,24
001 Aldein,37,,19,9,28
001 Aldein,38,,14,14,28
001 Aldein,39,,13,15,28
001 Aldein,40,,21,7,28
001 Aldein,41,,12,16,28
001 Aldein,42,,6,14,20
001 Aldein,43,,6,19,25
001 Aldein,44,,16,9,25
001 Aldein,45,,13,11,24
001 Aldein,46,,13,6,19
001 Aldein,47,,8,16,24
001 Aldein,48,,17,14,31
001 Aldein,49,,15,9,24
001 Aldein,50,,11,13,24
001 Aldein,51,,7,5,12
001 Aldein,52,,9,10,19
001 Aldein,53,,9,8,17
001 Aldein,54,,9,9,18
001 Aldein,55,,9,6,15
001 Aldein,56,,9,9,18
001 Aldein,57,,7,4,11
001 Aldein,58,,16,10,26
001 Aldein,59,,5,13,18
001 Aldein,60,,9,6,15
001 Aldein,61,,9,9,18
001 Aldein,62,,5,10,15
001 Aldein,63,,6,11,17
001 Aldein,64,,10,5,15
001 Aldein,65,,5,7,12
001 Aldein,66,,10,10,20
001 Aldein,67,,6,12,18
001 Aldein,68,,5,12,17
001 Aldein,69,,6,8,14
001 Aldein,70,,5,9,14
001 Aldein,71,,7,7,14
001 Aldein,72,,5,10,15
001 Aldein,73,,5,6,11
001 Aldein,74,,4,4,8
001 Aldein,75,,13,4,17
001 Aldein,76,,7,4,11
001 Aldein,77,,3,7,10
001 Aldein,78,,6,4,10
001 Aldein,79,,3,5,8
001 Aldein,80,,6,7,13
001 Aldein,81,,5,1,6
001 Aldein,82,,5,4,9
001 Aldein,83,,-,2,2
001 Aldein,84,,1,4,5
001 Aldein,85,,-,7,7
001 Aldein,86,,2,4,6
001 Aldein,87,,1,9,10
001 Aldein,88,,1,8,9
001 Aldein,89,,2,1,3
001 Aldein,90,,-,2,2
001 Aldein,93,,1,-,1
001 Aldein,96,,-,1,1
001 Aldein,97,,-,1,1
002 Andrian,0,,9,10,19
002 Andrian,1,,8,5,13
002 Andrian,2,,3,6,9
002 Andrian,3,,9,4,13
002 Andrian,4,,6,6,12
002 Andrian,5,,10,4,14
002 Andrian,6,,7,10,17
002 Andrian,7,,3,3,6
002 Andrian,8,,3,4,7
002 Andrian,9,,6,5,11
002 Andrian,10,,4,5,9
002 Andrian,11,,8,3,11
002 Andrian,12,,8,7,15
002 Andrian,13,,3,10,13
002 Andrian,14,,8,4,12
002 Andrian,15,,7,7,14
002 Andrian,16,,5,4,9
002 Andrian,17,,6,6,12
002 Andrian,18,,5,8,13
002 Andrian,19,,5,5,10
002 Andrian,20,,5,4,9
002 Andrian,21,,11,6,17
002 Andrian,22,,6,8,14
002 Andrian,23,,10,6,16
002 Andrian,24,,1,3,4
002 Andrian,25,,10,5,15
002 Andrian,26,,8,3,11
002 Andrian,27,,10,9,19
002 Andrian,28,,4,6,10
002 Andrian,29,,8,5,13
002 Andrian,30,,6,10,16
002 Andrian,31,,7,4,11
002 Andrian,32,,8,8,16
002 Andrian,33,,10,10,20
002 Andrian,34,,9,4,13
002 Andrian,35,,7,10,17
002 Andrian,36,,14,9,23
002 Andrian,37,,8,11,19
002 Andrian,38,,11,11,22
002 Andrian,39,,12,6,18
002 Andrian,40,,6,8,14
002 Andrian,41,,8,9,17
002 Andrian,42,,10,9,19
002 Andrian,43,,10,9,19
002 Andrian,44,,12,12,24
002 Andrian,45,,8,9,17
002 Andrian,46,,7,13,20
002 Andrian,47,,11,7,18
002 Andrian,48,,8,3,11
002 Andrian,49,,7,6,13
002 Andrian,50,,9,5,14
002 Andrian,51,,8,8,16
002 Andrian,52,,9,7,16
002 Andrian,53,,4,9,13
002 Andrian,54,,2,5,7
002 Andrian,55,,6,3,9
002 Andrian,56,,6,8,14
002 Andrian,57,,3,3,6
002 Andrian,58,,3,3,6
002 Andrian,59,,6,5,11
002 Andrian,60,,4,2,6
002 Andrian,61,,5,4,9
002 Andrian,62,,5,4,9
002 Andrian,63,,7,8,15
002 Andrian,64,,1,2,3
002 Andrian,65,,1,4,5
002 Andrian,66,,6,7,13
002 Andrian,67,,3,5,8
002 Andrian,68,,6,4,10
002 Andrian,69,,3,7,10
002 Andrian,70,,1,7,8
002 Andrian,71,,4,3,7
002 Andrian,72,,5,4,9
002 Andrian,73,,2,3,5
002 Andrian,74,,4,2,6
002 Andrian,75,,5,2,7
002 Andrian,76,,3,4,7
002 Andrian,77,,7,4,11
002 Andrian,78,,3,4,7
002 Andrian,79,,4,2,6
002 Andrian,80,,2,1,3
002 Andrian,81,,1,3,4
002 Andrian,82,,-,2,2
002 Andrian,83,,3,4,7
002 Andrian,84,,1,1,2
002 Andrian,85,,1,4,5
002 Andrian,86,,-,1,1
002 Andrian,87,,1,2,3
002 Andrian,88,,1,3,4
002 Andrian,89,,1,-,1
002 Andrian,90,,1,1,2
002 Andrian,91,,-,1,1
002 Andrian,94,,-,1,1
002 Andrian,95,,1,1,2
003 Altrei,0,,2,2,4
003 Altrei,1,,1,3,4
003 Altrei,2,,6,4,10
003 Altrei,3,,2,-,2
003 Altrei,4,,3,1,4
003 Altrei,5,,1,1,2
003 Altrei,6,,-,1,1
003 Altrei,7,,2,1,3
003 Altrei,8,,4,1,5
003 Altrei,9,,1,1,2
003 Altrei,10,,3,-,3
003 Altrei,11,,3,1,4
003 Altrei,12,,-,1,1
003 Altrei,13,,-,2,2
003 Altrei,14,,1,2,3
003 Altrei,15,,3,2,5
003 Altrei,16,,3,-,3
003 Altrei,17,,6,3,9
003 Altrei,18,,1,-,1
003 Altrei,19,,3,2,5
003 Altrei,20,,1,2,3
003 Altrei,21,,4,6,10
003 Altrei,22,,2,1,3
003 Altrei,23,,3,2,5
003 Altrei,24,,3,2,5
003 Altrei,25,,3,-,3
003 Altrei,26,,4,1,5
003 Altrei,27,,3,3,6
003 Altrei,28,,3,2,5
003 Altrei,29,,2,2,4
003 Altrei,30,,1,2,3
003 Altrei,31,,2,4,6
003 Altrei,32,,-,2,2
003 Altrei,33,,2,3,5
003 Altrei,34,,4,1,5
003 Altrei,35,,1,-,1
003 Altrei,36,,2,3,5
003 Altrei,37,,4,-,4
003 Altrei,38,,4,3,7
003 Altrei,39,,1,3,4
003 Altrei,40,,3,5,8
003 Altrei,41,,1,4,5
003 Altrei,42,,3,1,4
003 Altrei,43,,2,4,6
003 Altrei,44,,2,5,7
003 Altrei,45,,3,6,9
003 Altrei,46,,2,2,4
003 Altrei,47,,10,2,12
003 Altrei,48,,2,3,5
003 Altrei,49,,5,2,7
003 Altrei,50,,5,4,9
003 Altrei,51,,2,3,5
003 Altrei,52,,1,2,3
003 Altrei,53,,5,1,6
003 Altrei,54,,2,3,5
003 Altrei,55,,1,1,2
003 Altrei,56,,3,2,5
003 Altrei,57,,6,3,9
003 Altrei,58,,5,3,8
003 Altrei,59,,1,3,4
003 Altrei,60,,1,-,1
003 Altrei,61,,3,2,5
003 Altrei,62,,3,2,5
003 Altrei,63,,2,3,5
003 Altrei,64,,3,1,4
003 Altrei,65,,2,3,5
003 Altrei,66,,1,3,4
003 Altrei,67,,3,1,4
003 Altrei,68,,1,3,4
003 Altrei,69,,2,4,6
003 Altrei,70,,2,3,5
003 Altrei,71,,1,1,2
003 Altrei,72,,3,1,4
003 Altrei,73,,3,1,4
003 Altrei,74,,3,2,5
003 Altrei,75,,-,2,2
003 Altrei,76,,2,2,4
003 Altrei,77,,-,3,3
003 Altrei,78,,-,2,2
003 Altrei,79,,1,1,2
003 Altrei,80,,2,2,4
003 Altrei,81,,-,2,2
003 Altrei,82,,2,3,5
003 Altrei,83,,1,4,5
003 Altrei,85,,-,2,2
003 Altrei,86,,-,1,1
003 Altrei,87,,-,1,1
003 Altrei,88,,-,1,1
003 Altrei,92,,-,2,2
003 Altrei,94,,-,1,1
003 Altrei,95,,-,1,1
003 Altrei,98,,-,1,1
004 Eppan a.d. Weinstr.,0,,76,66,142
004 Eppan a.d. Weinstr.,1,,86,96,182
004 Eppan a.d. Weinstr.,2,,73,66,139
004 Eppan a.d. Weinstr.,3,,107,79,186
004 Eppan a.d. Weinstr.,4,,73,105,178
004 Eppan a.d. Weinstr.,5,,85,68,153
004 Eppan a.d. Weinstr.,6,,81,65,146
004 Eppan a.d. Weinstr.,7,,78,76,154
004 Eppan a.d. Weinstr.,8,,76,74,150
004 Eppan a.d. Weinstr.,9,,71,76,147
004 Eppan a.d. Weinstr.,10,,89,57,146
004 Eppan a.d. Weinstr.,11,,86,83,169
004 Eppan a.d. Weinstr.,12,,71,68,139
004 Eppan a.d. Weinstr.,13,,76,75,151
004 Eppan a.d. Weinstr.,14,,70,70,140
004 Eppan a.d. Weinstr.,15,,76,78,154
004 Eppan a.d. Weinstr.,16,,83,87,170
004 Eppan a.d. Weinstr.,17,,70,68,138
004 Eppan a.d. Weinstr.,18,,84,64,148
004 Eppan a.d. Weinstr.,19,,85,63,148
004 Eppan a.d. Weinstr.,20,,81,68,149
004 Eppan a.d. Weinstr.,21,,81,87,168
004 Eppan a.d. Weinstr.,22,,77,65,142
004 Eppan a.d. Weinstr.,23,,90,80,170
004 Eppan a.d. Weinstr.,24,,85,62,147
004 Eppan a.d. Weinstr.,25,,85,77,162
004 Eppan a.d. Weinstr.,26,,76,87,163
004 Eppan a.d. Weinstr.,27,,82,94,176
004 Eppan a.d. Weinstr.,28,,74,96,170
004 Eppan a.d. Weinstr.,29,,92,95,187
004 Eppan a.d. Weinstr.,30,,87,83,170
004 Eppan a.d. Weinstr.,31,,99,94,193
004 Eppan a.d. Weinstr.,32,,89,89,178
004 Eppan a.d. Weinstr.,33,,88,91,179
004 Eppan a.d. Weinstr.,34,,94,109,203
004 Eppan a.d. Weinstr.,35,,96,108,204
004 Eppan a.d. Weinstr.,36,,108,104,212
004 Eppan a.d. Weinstr.,37,,111,134,245
004 Eppan a.d. Weinstr.,38,,116,102,218
004 Eppan a.d. Weinstr.,39,,133,118,251
004 Eppan a.d. Weinstr.,40,,143,128,271
004 Eppan a.d. Weinstr.,41,,122,119,241
004 Eppan a.d. Weinstr.,42,,130,126,256
004 Eppan a.d. Weinstr.,43,,128,141,269
004 Eppan a.d. Weinstr.,44,,109,113,222
004 Eppan a.d. Weinstr.,45,,137,111,248
004 Eppan a.d. Weinstr.,46,,112,123,235
004 Eppan a.d. Weinstr.,47,,128,116,244
004 Eppan a.d. Weinstr.,48,,127,107,234
004 Eppan a.d. Weinstr.,49,,111,119,230
004 Eppan a.d. Weinstr.,50,,114,110,224
004 Eppan a.d. Weinstr.,51,,103,101,204
004 Eppan a.d. Weinstr.,52,,98,91,189
004 Eppan a.d. Weinstr.,53,,92,78,170
004 Eppan a.d. Weinstr.,54,,86,86,172
004 Eppan a.d. Weinstr.,55,,75,87,162
004 Eppan a.d. Weinstr.,56,,89,81,170
004 Eppan a.d. Weinstr.,57,,70,84,154
004 Eppan a.d. Weinstr.,58,,84,67,151
004 Eppan a.d. Weinstr.,59,,59,82,141
004 Eppan a.d. Weinstr.,60,,64,59,123
004 Eppan a.d. Weinstr.,61,,79,72,151
004 Eppan a.d. Weinstr.,62,,60,83,143
004 Eppan a.d. Weinstr.,63,,82,71,153
004 Eppan a.d. Weinstr.,64,,55,49,104
004 Eppan a.d. Weinstr.,65,,71,82,153
004 Eppan a.d. Weinstr.,66,,93,82,175
004 Eppan a.d. Weinstr.,67,,89,78,167
004 Eppan a.d. Weinstr.,68,,62,105,167
004 Eppan a.d. Weinstr.,69,,70,56,126
004 Eppan a.d. Weinstr.,70,,59,78,137
004 Eppan a.d. Weinstr.,71,,52,50,102
004 Eppan a.d. Weinstr.,72,,43,56,99
004 Eppan a.d. Weinstr.,73,,44,48,92
004 Eppan a.d. Weinstr.,74,,32,46,78
004 Eppan a.d. Weinstr.,75,,31,48,79
004 Eppan a.d. Weinstr.,76,,48,51,99
004 Eppan a.d. Weinstr.,77,,39,48,87
004 Eppan a.d. Weinstr.,78,,29,55,84
004 Eppan a.d. Weinstr.,79,,40,55,95
004 Eppan a.d. Weinstr.,80,,32,50,82
004 Eppan a.d. Weinstr.,81,,31,37,68
004 Eppan a.d. Weinstr.,82,,25,43,68
004 Eppan a.d. Weinstr.,83,,25,46,71
004 Eppan a.d. Weinstr.,84,,22,43,65
004 Eppan a.d. Weinstr.,85,,11,46,57
004 Eppan a.d. Weinstr.,86,,14,32,46
004 Eppan a.d. Weinstr.,87,,9,35,44
004 Eppan a.d. Weinstr.,88,,13,25,38
004 Eppan a.d. Weinstr.,89,,7,19,26
004 Eppan a.d. Weinstr.,90,,4,10,14
004 Eppan a.d. Weinstr.,91,,6,9,15
004 Eppan a.d. Weinstr.,92,,4,5,9
004 Eppan a.d. Weinstr.,93,,3,3,6
004 Eppan a.d. Weinstr.,94,,1,3,4
004 Eppan a.d. Weinstr.,95,,1,5,6
004 Eppan a.d. Weinstr.,96,,1,3,4
004 Eppan a.d. Weinstr.,97,,-,6,6
004 Eppan a.d. Weinstr.,98,,1,6,7
004 Eppan a.d. Weinstr.,99,,-,2,2
004 Eppan a.d. Weinstr.,100,,3,2,5
004 Eppan a.d. Weinstr.,101,,-,1,1
005 Hafling,0,,2,5,7
005 Hafling,1,,4,5,9
005 Hafling,2,,2,2,4
005 Hafling,3,,6,5,11
005 Hafling,4,,5,4,9
005 Hafling,5,,2,6,8
005 Hafling,6,,2,5,7
005 Hafling,7,,4,3,7
005 Hafling,8,,4,2,6
005 Hafling,9,,5,8,13
005 Hafling,10,,4,3,7
005 Hafling,11,,4,7,11
005 Hafling,12,,3,9,12
005 Hafling,13,,11,4,15
005 Hafling,14,,6,4,10
005 Hafling,15,,4,5,9
005 Hafling,16,,2,7,9
005 Hafling,17,,3,4,7
005 Hafling,18,,8,3,11
005 Hafling,19,,4,6,10
005 Hafling,20,,4,2,6
005 Hafling,21,,2,5,7
005 Hafling,22,,4,4,8
005 Hafling,23,,5,2,7
005 Hafling,24,,4,6,10
005 Hafling,25,,4,8,12
005 Hafling,26,,3,1,4
005 Hafling,27,,7,4,11
005 Hafling,28,,4,7,11
005 Hafling,29,,4,11,15
005 Hafling,30,,5,4,9
005 Hafling,31,,4,7,11
005 Hafling,32,,6,5,11
005 Hafling,33,,6,5,11
005 Hafling,34,,6,4,10
005 Hafling,35,,6,6,12
005 Hafling,36,,9,1,10
005 Hafling,37,,9,1,10
005 Hafling,38,,11,5,16
005 Hafling,39,,9,6,15
005 Hafling,40,,7,12,19
005 Hafling,41,,2,10,12
005 Hafling,42,,3,1,4
005 Hafling,43,,10,7,17
005 Hafling,44,,7,14,21
005 Hafling,45,,3,2,5
005 Hafling,46,,6,3,9
005 Hafling,47,,6,2,8
005 Hafling,48,,8,4,12
005 Hafling,49,,9,7,16
005 Hafling,50,,6,5,11
005 Hafling,51,,3,4,7
005 Hafling,52,,2,4,6
005 Hafling,53,,3,8,11
005 Hafling,54,,6,3,9
005 Hafling,55,,3,1,4
005 Hafling,56,,2,3,5
005 Hafling,57,,7,2,9
005 Hafling,58,,2,3,5
005 Hafling,59,,5,3,8
005 Hafling,60,,5,4,9
005 Hafling,61,,6,2,8
005 Hafling,62,,3,4,7
005 Hafling,63,,-,4,4
005 Hafling,64,,3,3,6
005 Hafling,65,,2,2,4
005 Hafling,66,,4,5,9
005 Hafling,67,,6,3,9
005 Hafling,68,,3,4,7
005 Hafling,69,,2,1,3
005 Hafling,70,,4,5,9
005 Hafling,71,,3,3,6
005 Hafling,72,,2,1,3
005 Hafling,73,,1,1,2
005 Hafling,74,,2,2,4
005 Hafling,75,,-,2,2
005 Hafling,76,,4,3,7
005 Hafling,77,,3,4,7
005 Hafling,78,,3,6,9
005 Hafling,79,,1,4,5
005 Hafling,80,,2,1,3
005 Hafling,81,,-,2,2
005 Hafling,82,,3,3,6
005 Hafling,83,,-,2,2
005 Hafling,84,,1,-,1
005 Hafling,85,,1,-,1
005 Hafling,86,,1,-,1
005 Hafling,87,,-,2,2
005 Hafling,88,,-,1,1
005 Hafling,89,,3,1,4
005 Hafling,90,,-,1,1
005 Hafling,92,,-,1,1
005 Hafling,93,,-,1,1
006 Abtei,0,,21,19,40
006 Abtei,1,,24,18,42
006 Abtei,2,,28,23,51
006 Abtei,3,,29,23,52
006 Abtei,4,,21,29,50
006 Abtei,5,,26,15,41
006 Abtei,6,,21,19,40
006 Abtei,7,,13,31,44
006 Abtei,8,,25,24,49
006 Abtei,9,,23,32,55
006 Abtei,10,,21,26,47
006 Abtei,11,,14,14,28
006 Abtei,12,,26,23,49
006 Abtei,13,,28,15,43
006 Abtei,14,,24,29,53
006 Abtei,15,,19,16,35
006 Abtei,16,,16,18,34
006 Abtei,17,,24,14,38
006 Abtei,18,,21,13,34
006 Abtei,19,,23,16,39
006 Abtei,20,,15,16,31
006 Abtei,21,,16,11,27
006 Abtei,22,,19,12,31
006 Abtei,23,,17,18,35
006 Abtei,24,,11,10,21
006 Abtei,25,,14,19,33
006 Abtei,26,,14,14,28
006 Abtei,27,,20,20,40
006 Abtei,28,,19,16,35
006 Abtei,29,,25,20,45
006 Abtei,30,,16,23,39
006 Abtei,31,,22,33,55
006 Abtei,32,,22,35,57
006 Abtei,33,,27,24,51
006 Abtei,34,,18,33,51
006 Abtei,35,,20,33,53
006 Abtei,36,,28,24,52
006 Abtei,37,,44,34,78
006 Abtei,38,,19,32,51
006 Abtei,39,,29,33,62
006 Abtei,40,,29,34,63
006 Abtei,41,,27,35,62
006 Abtei,42,,36,32,68
006 Abtei,43,,22,30,52
006 Abtei,44,,37,25,62
006 Abtei,45,,26,31,57
006 Abtei,46,,31,26,57
006 Abtei,47,,26,30,56
006 Abtei,48,,25,27,52
006 Abtei,49,,27,24,51
006 Abtei,50,,26,23,49
006 Abtei,51,,19,21,40
006 Abtei,52,,19,15,34
006 Abtei,53,,19,18,37
006 Abtei,54,,17,16,33
006 Abtei,55,,11,15,26
006 Abtei,56,,14,19,33
006 Abtei,57,,13,13,26
006 Abtei,58,,12,13,25
006 Abtei,59,,15,19,34
006 Abtei,60,,10,19,29
006 Abtei,61,,24,17,41
006 Abtei,62,,15,16,31
006 Abtei,63,,23,19,42
006 Abtei,64,,15,20,35
006 Abtei,65,,13,17,30
006 Abtei,66,,12,11,23
006 Abtei,67,,20,12,32
006 Abtei,68,,14,23,37
006 Abtei,69,,16,16,32
006 Abtei,70,,14,14,28
006 Abtei,71,,15,17,32
006 Abtei,72,,6,18,24
006 Abtei,73,,16,9,25
006 Abtei,74,,11,17,28
006 Abtei,75,,12,15,27
006 Abtei,76,,8,15,23
006 Abtei,77,,6,5,11
006 Abtei,78,,9,11,20
006 Abtei,79,,13,11,24
006 Abtei,80,,5,7,12
006 Abtei,81,,5,11,16
006 Abtei,82,,6,7,13
006 Abtei,83,,4,5,9
006 Abtei,84,,6,4,10
006 Abtei,85,,4,8,12
006 Abtei,86,,4,7,11
006 Abtei,87,,4,4,8
006 Abtei,88,,2,1,3
006 Abtei,89,,2,7,9
006 Abtei,90,,1,3,4
006 Abtei,91,,1,1,2
006 Abtei,93,,1,2,3
006 Abtei,94,,-,2,2
006 Abtei,95,,-,1,1
006 Abtei,96,,1,-,1
006 Abtei,97,,-,2,2
006 Abtei,99,,1,-,1
007 Barbian,0,,7,14,21
007 Barbian,1,,13,4,17
007 Barbian,2,,9,11,20
007 Barbian,3,,5,2,7
007 Barbian,4,,16,6,22
007 Barbian,5,,7,4,11
007 Barbian,6,,8,14,22
007 Barbian,7,,7,7,14
007 Barbian,8,,12,14,26
007 Barbian,9,,14,5,19
007 Barbian,10,,11,10,21
007 Barbian,11,,16,8,24
007 Barbian,12,,8,8,16
007 Barbian,13,,12,10,22
007 Barbian,14,,12,8,20
007 Barbian,15,,9,5,14
007 Barbian,16,,10,12,22
007 Barbian,17,,12,7,19
007 Barbian,18,,12,12,24
007 Barbian,19,,15,13,28
007 Barbian,20,,7,13,20
007 Barbian,21,,12,6,18
007 Barbian,22,,8,6,14
007 Barbian,23,,14,7,21
007 Barbian,24,,6,7,13
007 Barbian,25,,10,6,16
007 Barbian,26,,11,11,22
007 Barbian,27,,9,9,18
007 Barbian,28,,12,14,26
007 Barbian,29,,12,4,16
007 Barbian,30,,17,13,30
007 Barbian,31,,10,10,20
007 Barbian,32,,9,17,26
007 Barbian,33,,7,12,19
007 Barbian,34,,9,11,20
007 Barbian,35,,12,10,22
007 Barbian,36,,11,18,29
007 Barbian,37,,19,15,34
007 Barbian,38,,18,9,27
007 Barbian,39,,11,12,23
007 Barbian,40,,15,7,22
007 Barbian,41,,16,10,26
007 Barbian,42,,10,8,18
007 Barbian,43,,14,12,26
007 Barbian,44,,7,13,20
007 Barbian,45,,15,15,30
007 Barbian,46,,15,14,29
007 Barbian,47,,15,15,30
007 Barbian,48,,18,11,29
007 Barbian,49,,13,15,28
007 Barbian,50,,13,9,22
007 Barbian,51,,7,9,16
007 Barbian,52,,14,7,21
007 Barbian,53,,5,9,14
007 Barbian,54,,7,6,13
007 Barbian,55,,7,14,21
007 Barbian,56,,8,10,18
007 Barbian,57,,9,4,13
007 Barbian,58,,8,10,18
007 Barbian,59,,10,11,21
007 Barbian,60,,5,6,11
007 Barbian,61,,3,5,8
007 Barbian,62,,5,11,16
007 Barbian,63,,17,6,23
007 Barbian,64,,5,5,10
007 Barbian,65,,10,9,19
007 Barbian,66,,8,7,15
007 Barbian,67,,11,10,21
007 Barbian,68,,8,12,20
007 Barbian,69,,9,3,12
007 Barbian,70,,6,4,10
007 Barbian,71,,5,11,16
007 Barbian,72,,8,9,17
007 Barbian,73,,3,5,8
007 Barbian,74,,3,6,9
007 Barbian,75,,5,5,10
007 Barbian,76,,7,4,11
007 Barbian,77,,7,6,13
007 Barbian,78,,3,7,10
007 Barbian,79,,5,4,9
007 Barbian,80,,6,7,13
007 Barbian,81,,4,6,10
007 Barbian,82,,3,1,4
007 Barbian,83,,3,1,4
007 Barbian,84,,3,2,5
007 Barbian,85,,1,3,4
007 Barbian,86,,-,4,4
007 Barbian,87,,2,3,5
007 Barbian,88,,1,1,2
007 Barbian,89,,-,1,1
007 Barbian,90,,-,1,1
007 Barbian,91,,1,-,1
007 Barbian,93,,-,1,1
008 Bozen,0,,480,445,925
008 Bozen,1,,516,488,1.004
008 Bozen,2,,555,472,1.027
008 Bozen,3,,465,488,953
008 Bozen,4,,535,485,1.020
008 Bozen,5,,527,483,1.010
008 Bozen,6,,531,508,1.039
008 Bozen,7,,514,459,973
008 Bozen,8,,505,462,967
008 Bozen,9,,464,488,952
008 Bozen,10,,500,477,977
008 Bozen,11,,487,468,955
008 Bozen,12,,485,424,909
008 Bozen,13,,452,495,947
008 Bozen,14,,454,412,866
008 Bozen,15,,485,463,948
008 Bozen,16,,428,454,882
008 Bozen,17,,465,414,879
008 Bozen,18,,508,429,937
008 Bozen,19,,492,444,936
008 Bozen,20,,489,459,948
008 Bozen,21,,495,442,937
008 Bozen,22,,399,446,845
008 Bozen,23,,456,445,901
008 Bozen,24,,496,466,962
008 Bozen,25,,487,504,991
008 Bozen,26,,575,483,1.058
008 Bozen,27,,560,521,1.081
008 Bozen,28,,586,541,1.127
008 Bozen,29,,663,538,1.201
008 Bozen,30,,572,581,1.153
008 Bozen,31,,608,593,1.201
008 Bozen,32,,625,624,1.249
008 Bozen,33,,675,684,1.359
008 Bozen,34,,701,708,1.409
008 Bozen,35,,762,765,1.527
008 Bozen,36,,722,822,1.544
008 Bozen,37,,839,830,1.669
008 Bozen,38,,876,892,1.768
008 Bozen,39,,845,817,1.662
008 Bozen,40,,913,869,1.782
008 Bozen,41,,831,805,1.636
008 Bozen,42,,810,868,1.678
008 Bozen,43,,903,881,1.784
008 Bozen,44,,919,898,1.817
008 Bozen,45,,906,921,1.827
008 Bozen,46,,763,872,1.635
008 Bozen,47,,770,811,1.581
008 Bozen,48,,768,750,1.518
008 Bozen,49,,715,746,1.461
008 Bozen,50,,710,704,1.414
008 Bozen,51,,708,726,1.434
008 Bozen,52,,620,731,1.351
008 Bozen,53,,635,681,1.316
008 Bozen,54,,601,648,1.249
008 Bozen,55,,601,619,1.220
008 Bozen,56,,535,632,1.167
008 Bozen,57,,526,651,1.177
008 Bozen,58,,531,626,1.157
008 Bozen,59,,571,676,1.247
008 Bozen,60,,573,634,1.207
008 Bozen,61,,614,731,1.345
008 Bozen,62,,590,798,1.388
008 Bozen,63,,686,864,1.550
008 Bozen,64,,509,580,1.089
008 Bozen,65,,556,703,1.259
008 Bozen,66,,607,712,1.319
008 Bozen,67,,625,699,1.324
008 Bozen,68,,664,730,1.394
008 Bozen,69,,624,708,1.332
008 Bozen,70,,552,699,1.251
008 Bozen,71,,578,646,1.224
008 Bozen,72,,496,559,1.055
008 Bozen,73,,448,548,996
008 Bozen,74,,427,555,982
008 Bozen,75,,432,534,966
008 Bozen,76,,368,533,901
008 Bozen,77,,381,537,918
008 Bozen,78,,372,522,894
008 Bozen,79,,365,502,867
008 Bozen,80,,245,455,700
008 Bozen,81,,294,445,739
008 Bozen,82,,247,423,670
008 Bozen,83,,271,396,667
008 Bozen,84,,211,424,635
008 Bozen,85,,189,352,541
008 Bozen,86,,162,362,524
008 Bozen,87,,137,363,500
008 Bozen,88,,131,298,429
008 Bozen,89,,92,263,355
008 Bozen,90,,46,162,208
008 Bozen,91,,22,84,106
008 Bozen,92,,17,67,84
008 Bozen,93,,24,79,103
008 Bozen,94,,13,83,96
008 Bozen,95,,24,70,94
008 Bozen,96,,13,50,63
008 Bozen,97,,12,41,53
008 Bozen,98,,6,33,39
008 Bozen,99,,2,15,17
008 Bozen,100,,2,8,10
008 Bozen,101,,-,9,9
008 Bozen,102,,-,4,4
008 Bozen,103,,-,1,1
008 Bozen,104,,-,1,1
009 Prags,0,,1,1,2
009 Prags,1,,4,5,9
009 Prags,2,,4,6,10
009 Prags,3,,4,3,7
009 Prags,4,,3,1,4
009 Prags,5,,3,3,6
009 Prags,6,,2,5,7
009 Prags,7,,2,6,8
009 Prags,8,,6,6,12
009 Prags,9,,2,3,5
009 Prags,10,,5,9,14
009 Prags,11,,1,4,5
009 Prags,12,,3,5,8
009 Prags,13,,2,6,8
009 Prags,14,,3,1,4
009 Prags,15,,4,5,9
009 Prags,16,,7,2,9
009 Prags,17,,6,2,8
009 Prags,18,,9,1,10
009 Prags,19,,5,2,7
009 Prags,20,,8,2,10
009 Prags,21,,2,4,6
009 Prags,22,,3,3,6
009 Prags,23,,7,4,11
009 Prags,24,,8,2,10
009 Prags,25,,5,3,8
009 Prags,26,,3,4,7
009 Prags,27,,3,7,10
009 Prags,28,,2,5,7
009 Prags,29,,5,-,5
009 Prags,30,,2,2,4
009 Prags,31,,6,7,13
009 Prags,32,,2,4,6
009 Prags,33,,5,4,9
009 Prags,34,,3,5,8
009 Prags,35,,2,4,6
009 Prags,36,,7,3,10
009 Prags,37,,3,3,6
009 Prags,38,,6,4,10
009 Prags,39,,4,6,10
009 Prags,40,,9,5,14
009 Prags,41,,8,8,16
009 Prags,42,,7,6,13
009 Prags,43,,7,5,12
009 Prags,44,,7,7,14
009 Prags,45,,6,4,10
009 Prags,46,,6,5,11
009 Prags,47,,3,4,7
009 Prags,48,,5,12,17
009 Prags,49,,5,4,9
009 Prags,50,,11,5,16
009 Prags,51,,6,2,8
009 Prags,52,,6,4,10
009 Prags,53,,1,6,7
009 Prags,54,,4,5,9
009 Prags,55,,6,4,10
009 Prags,56,,4,1,5
009 Prags,57,,2,5,7
009 Prags,58,,3,1,4
009 Prags,59,,4,1,5
009 Prags,60,,1,1,2
009 Prags,61,,4,1,5
009 Prags,62,,1,-,1
009 Prags,63,,2,4,6
009 Prags,64,,2,2,4
009 Prags,65,,4,4,8
009 Prags,66,,1,3,4
009 Prags,67,,4,4,8
009 Prags,68,,5,2,7
009 Prags,69,,1,3,4
009 Prags,70,,3,5,8
009 Prags,71,,3,2,5
009 Prags,72,,-,2,2
009 Prags,73,,2,3,5
009 Prags,74,,1,3,4
009 Prags,75,,3,2,5
009 Prags,76,,3,2,5
009 Prags,77,,3,5,8
009 Prags,78,,1,3,4
009 Prags,79,,1,1,2
009 Prags,80,,1,2,3
009 Prags,81,,3,2,5
009 Prags,82,,2,5,7
009 Prags,83,,2,4,6
009 Prags,84,,1,4,5
009 Prags,85,,3,2,5
009 Prags,86,,-,4,4
009 Prags,87,,2,1,3
009 Prags,88,,1,2,3
009 Prags,89,,1,-,1
009 Prags,90,,-,2,2
009 Prags,94,,-,1,1
010 Brenner,0,,12,9,21
010 Brenner,1,,8,15,23
010 Brenner,2,,13,11,24
010 Brenner,3,,6,15,21
010 Brenner,4,,12,9,21
010 Brenner,5,,11,19,30
010 Brenner,6,,11,9,20
010 Brenner,7,,15,13,28
010 Brenner,8,,5,7,12
010 Brenner,9,,17,13,30
010 Brenner,10,,12,17,29
010 Brenner,11,,14,5,19
010 Brenner,12,,17,9,26
010 Brenner,13,,6,11,17
010 Brenner,14,,6,10,16
010 Brenner,15,,21,11,32
010 Brenner,16,,16,5,21
010 Brenner,17,,12,9,21
010 Brenner,18,,10,16,26
010 Brenner,19,,10,7,17
010 Brenner,20,,13,8,21
010 Brenner,21,,13,6,19
010 Brenner,22,,8,10,18
010 Brenner,23,,11,13,24
010 Brenner,24,,23,9,32
010 Brenner,25,,20,14,34
010 Brenner,26,,19,15,34
010 Brenner,27,,16,10,26
010 Brenner,28,,16,21,37
010 Brenner,29,,16,17,33
010 Brenner,30,,17,15,32
010 Brenner,31,,15,16,31
010 Brenner,32,,22,11,33
010 Brenner,33,,12,11,23
010 Brenner,34,,18,21,39
010 Brenner,35,,18,9,27
010 Brenner,36,,15,6,21
010 Brenner,37,,22,25,47
010 Brenner,38,,29,14,43
010 Brenner,39,,20,16,36
010 Brenner,40,,10,17,27
010 Brenner,41,,13,16,29
010 Brenner,42,,17,15,32
010 Brenner,43,,20,17,37
010 Brenner,44,,23,18,41
010 Brenner,45,,21,16,37
010 Brenner,46,,12,19,31
010 Brenner,47,,16,12,28
010 Brenner,48,,19,11,30
010 Brenner,49,,19,12,31
010 Brenner,50,,14,12,26
010 Brenner,51,,16,10,26
010 Brenner,52,,14,20,34
010 Brenner,53,,17,13,30
010 Brenner,54,,13,10,23
010 Brenner,55,,9,14,23
010 Brenner,56,,9,15,24
010 Brenner,57,,20,8,28
010 Brenner,58,,14,12,26
010 Brenner,59,,10,12,22
010 Brenner,60,,15,13,28
010 Brenner,61,,7,8,15
010 Brenner,62,,20,13,33
010 Brenner,63,,8,16,24
010 Brenner,64,,5,8,13
010 Brenner,65,,17,13,30
010 Brenner,66,,15,12,27
010 Brenner,67,,6,9,15
010 Brenner,68,,11,12,23
010 Brenner,69,,8,12,20
010 Brenner,70,,7,9,16
010 Brenner,71,,10,15,25
010 Brenner,72,,8,13,21
010 Brenner,73,,12,7,19
010 Brenner,74,,4,6,10
010 Brenner,75,,8,7,15
010 Brenner,76,,5,5,10
010 Brenner,77,,-,4,4
010 Brenner,78,,5,8,13
010 Brenner,79,,8,11,19
010 Brenner,80,,7,9,16
010 Brenner,81,,7,5,12
010 Brenner,82,,5,2,7
010 Brenner,83,,4,6,10
010 Brenner,84,,2,5,7
010 Brenner,85,,2,6,8
010 Brenner,86,,2,7,9
010 Brenner,87,,-,5,5
010 Brenner,88,,-,1,1
010 Brenner,89,,1,5,6
010 Brenner,90,,1,2,3
010 Brenner,91,,1,-,1
010 Brenner,94,,-,1,1
010 Brenner,95,,1,1,2
010 Brenner,98,,1,-,1
011 Brixen,0,,117,106,223
011 Brixen,1,,110,102,212
011 Brixen,2,,124,101,225
011 Brixen,3,,126,104,230
011 Brixen,4,,125,119,244
011 Brixen,5,,119,116,235
011 Brixen,6,,110,110,220
011 Brixen,7,,114,117,231
011 Brixen,8,,122,125,247
011 Brixen,9,,116,111,227
011 Brixen,10,,138,120,258
011 Brixen,11,,112,136,248
011 Brixen,12,,123,108,231
011 Brixen,13,,120,115,235
011 Brixen,14,,116,126,242
011 Brixen,15,,126,121,247
011 Brixen,16,,117,106,223
011 Brixen,17,,114,126,240
011 Brixen,18,,124,110,234
011 Brixen,19,,103,110,213
011 Brixen,20,,125,102,227
011 Brixen,21,,123,99,222
011 Brixen,22,,108,109,217
011 Brixen,23,,109,124,233
011 Brixen,24,,117,95,212
011 Brixen,25,,120,100,220
011 Brixen,26,,127,137,264
011 Brixen,27,,130,125,255
011 Brixen,28,,139,125,264
011 Brixen,29,,111,120,231
011 Brixen,30,,139,137,276
011 Brixen,31,,111,138,249
011 Brixen,32,,138,136,274
011 Brixen,33,,139,154,293
011 Brixen,34,,126,126,252
011 Brixen,35,,143,154,297
011 Brixen,36,,162,161,323
011 Brixen,37,,164,167,331
011 Brixen,38,,165,173,338
011 Brixen,39,,174,161,335
011 Brixen,40,,194,186,380
011 Brixen,41,,182,207,389
011 Brixen,42,,170,170,340
011 Brixen,43,,179,192,371
011 Brixen,44,,187,162,349
011 Brixen,45,,189,183,372
011 Brixen,46,,156,169,325
011 Brixen,47,,168,162,330
011 Brixen,48,,144,168,312
011 Brixen,49,,141,149,290
011 Brixen,50,,148,141,289
011 Brixen,51,,153,126,279
011 Brixen,52,,136,148,284
011 Brixen,53,,116,142,258
011 Brixen,54,,125,103,228
011 Brixen,55,,97,116,213
011 Brixen,56,,95,110,205
011 Brixen,57,,101,106,207
011 Brixen,58,,99,112,211
011 Brixen,59,,115,103,218
011 Brixen,60,,82,127,209
011 Brixen,61,,108,116,224
011 Brixen,62,,92,116,208
011 Brixen,63,,101,105,206
011 Brixen,64,,66,101,167
011 Brixen,65,,112,112,224
011 Brixen,66,,123,120,243
011 Brixen,67,,87,97,184
011 Brixen,68,,103,123,226
011 Brixen,69,,85,115,200
011 Brixen,70,,90,104,194
011 Brixen,71,,85,92,177
011 Brixen,72,,85,90,175
011 Brixen,73,,63,95,158
011 Brixen,74,,77,83,160
011 Brixen,75,,64,87,151
011 Brixen,76,,67,64,131
011 Brixen,77,,71,75,146
011 Brixen,78,,60,77,137
011 Brixen,79,,51,88,139
011 Brixen,80,,40,80,120
011 Brixen,81,,47,63,110
011 Brixen,82,,28,79,107
011 Brixen,83,,36,62,98
011 Brixen,84,,34,63,97
011 Brixen,85,,24,59,83
011 Brixen,86,,28,48,76
011 Brixen,87,,18,53,71
011 Brixen,88,,17,53,70
011 Brixen,89,,14,38,52
011 Brixen,90,,7,23,30
011 Brixen,91,,4,16,20
011 Brixen,92,,8,21,29
011 Brixen,93,,2,10,12
011 Brixen,94,,1,9,10
011 Brixen,95,,3,10,13
011 Brixen,96,,1,5,6
011 Brixen,97,,2,9,11
011 Brixen,98,,-,9,9
011 Brixen,99,,-,3,3
011 Brixen,101,,-,2,2
011 Brixen,102,,-,2,2
012 Branzoll,0,,15,18,33
012 Branzoll,1,,13,14,27
012 Branzoll,2,,13,16,29
012 Branzoll,3,,14,10,24
012 Branzoll,4,,8,10,18
012 Branzoll,5,,17,15,32
012 Branzoll,6,,17,22,39
012 Branzoll,7,,14,13,27
012 Branzoll,8,,12,12,24
012 Branzoll,9,,22,8,30
012 Branzoll,10,,10,14,24
012 Branzoll,11,,15,7,22
012 Branzoll,12,,13,23,36
012 Branzoll,13,,16,8,24
012 Branzoll,14,,14,13,27
012 Branzoll,15,,17,9,26
012 Branzoll,16,,20,13,33
012 Branzoll,17,,15,14,29
012 Branzoll,18,,14,17,31
012 Branzoll,19,,14,18,32
012 Branzoll,20,,10,11,21
012 Branzoll,21,,18,17,35
012 Branzoll,22,,11,8,19
012 Branzoll,23,,10,14,24
012 Branzoll,24,,16,19,35
012 Branzoll,25,,17,13,30
012 Branzoll,26,,13,12,25
012 Branzoll,27,,19,14,33
012 Branzoll,28,,14,18,32
012 Branzoll,29,,11,20,31
012 Branzoll,30,,13,11,24
012 Branzoll,31,,14,21,35
012 Branzoll,32,,15,24,39
012 Branzoll,33,,13,17,30
012 Branzoll,34,,20,17,37
012 Branzoll,35,,23,27,50
012 Branzoll,36,,26,15,41
012 Branzoll,37,,21,16,37
012 Branzoll,38,,26,28,54
012 Branzoll,39,,21,23,44
012 Branzoll,40,,29,26,55
012 Branzoll,41,,22,26,48
012 Branzoll,42,,21,24,45
012 Branzoll,43,,19,20,39
012 Branzoll,44,,24,21,45
012 Branzoll,45,,29,25,54
012 Branzoll,46,,21,18,39
012 Branzoll,47,,17,18,35
012 Branzoll,48,,29,27,56
012 Branzoll,49,,29,20,49
012 Branzoll,50,,20,25,45
012 Branzoll,51,,19,19,38
012 Branzoll,52,,20,15,35
012 Branzoll,53,,13,19,32
012 Branzoll,54,,19,18,37
012 Branzoll,55,,21,17,38
012 Branzoll,56,,11,21,32
012 Branzoll,57,,15,21,36
012 Branzoll,58,,16,14,30
012 Branzoll,59,,17,14,31
012 Branzoll,60,,17,15,32
012 Branzoll,61,,16,16,32
012 Branzoll,62,,15,17,32
012 Branzoll,63,,14,21,35
012 Branzoll,64,,14,9,23
012 Branzoll,65,,12,11,23
012 Branzoll,66,,14,10,24
012 Branzoll,67,,19,11,30
012 Branzoll,68,,20,13,33
012 Branzoll,69,,11,13,24
012 Branzoll,70,,15,12,27
012 Branzoll,71,,9,10,19
012 Branzoll,72,,3,7,10
012 Branzoll,73,,7,8,15
012 Branzoll,74,,9,9,18
012 Branzoll,75,,4,10,14
012 Branzoll,76,,19,10,29
012 Branzoll,77,,8,11,19
012 Branzoll,78,,2,10,12
012 Branzoll,79,,6,15,21
012 Branzoll,80,,4,10,14
012 Branzoll,81,,3,10,13
012 Branzoll,82,,3,5,8
012 Branzoll,83,,4,9,13
012 Branzoll,84,,2,4,6
012 Branzoll,85,,1,6,7
012 Branzoll,86,,6,10,16
012 Branzoll,87,,-,2,2
012 Branzoll,88,,3,5,8
012 Branzoll,89,,1,4,5
012 Branzoll,90,,1,3,4
012 Branzoll,91,,2,2,4
012 Branzoll,95,,-,2,2
012 Branzoll,97,,-,2,2
012 Branzoll,98,,1,1,2
013 Bruneck,0,,89,60,149
013 Bruneck,1,,81,68,149
013 Bruneck,2,,88,65,153
013 Bruneck,3,,111,73,184
013 Bruneck,4,,76,83,159
013 Bruneck,5,,90,97,187
013 Bruneck,6,,98,75,173
013 Bruneck,7,,75,92,167
013 Bruneck,8,,96,72,168
013 Bruneck,9,,89,84,173
013 Bruneck,10,,95,94,189
013 Bruneck,11,,95,92,187
013 Bruneck,12,,111,72,183
013 Bruneck,13,,80,94,174
013 Bruneck,14,,64,83,147
013 Bruneck,15,,89,75,164
013 Bruneck,16,,88,69,157
013 Bruneck,17,,93,75,168
013 Bruneck,18,,87,62,149
013 Bruneck,19,,93,70,163
013 Bruneck,20,,85,88,173
013 Bruneck,21,,76,76,152
013 Bruneck,22,,62,66,128
013 Bruneck,23,,111,89,200
013 Bruneck,24,,86,82,168
013 Bruneck,25,,94,92,186
013 Bruneck,26,,101,95,196
013 Bruneck,27,,100,103,203
013 Bruneck,28,,109,117,226
013 Bruneck,29,,106,107,213
013 Bruneck,30,,106,103,209
013 Bruneck,31,,127,119,246
013 Bruneck,32,,121,102,223
013 Bruneck,33,,119,123,242
013 Bruneck,34,,122,119,241
013 Bruneck,35,,132,112,244
013 Bruneck,36,,135,120,255
013 Bruneck,37,,121,121,242
013 Bruneck,38,,141,118,259
013 Bruneck,39,,123,139,262
013 Bruneck,40,,142,121,263
013 Bruneck,41,,126,146,272
013 Bruneck,42,,143,133,276
013 Bruneck,43,,131,123,254
013 Bruneck,44,,155,147,302
013 Bruneck,45,,134,136,270
013 Bruneck,46,,131,117,248
013 Bruneck,47,,127,117,244
013 Bruneck,48,,117,99,216
013 Bruneck,49,,102,117,219
013 Bruneck,50,,114,101,215
013 Bruneck,51,,106,112,218
013 Bruneck,52,,87,103,190
013 Bruneck,53,,88,93,181
013 Bruneck,54,,77,83,160
013 Bruneck,55,,92,85,177
013 Bruneck,56,,76,97,173
013 Bruneck,57,,89,99,188
013 Bruneck,58,,70,99,169
013 Bruneck,59,,79,95,174
013 Bruneck,60,,81,94,175
013 Bruneck,61,,78,110,188
013 Bruneck,62,,95,69,164
013 Bruneck,63,,103,85,188
013 Bruneck,64,,62,67,129
013 Bruneck,65,,87,95,182
013 Bruneck,66,,94,84,178
013 Bruneck,67,,82,87,169
013 Bruneck,68,,75,96,171
013 Bruneck,69,,72,86,158
013 Bruneck,70,,78,91,169
013 Bruneck,71,,54,50,104
013 Bruneck,72,,50,54,104
013 Bruneck,73,,49,55,104
013 Bruneck,74,,43,47,90
013 Bruneck,75,,36,49,85
013 Bruneck,76,,45,60,105
013 Bruneck,77,,45,51,96
013 Bruneck,78,,34,46,80
013 Bruneck,79,,28,54,82
013 Bruneck,80,,23,55,78
013 Bruneck,81,,32,53,85
013 Bruneck,82,,24,39,63
013 Bruneck,83,,18,32,50
013 Bruneck,84,,18,42,60
013 Bruneck,85,,9,49,58
013 Bruneck,86,,20,31,51
013 Bruneck,87,,15,22,37
013 Bruneck,88,,8,18,26
013 Bruneck,89,,8,19,27
013 Bruneck,90,,7,11,18
013 Bruneck,91,,2,6,8
013 Bruneck,92,,3,12,15
013 Bruneck,93,,2,12,14
013 Bruneck,94,,2,6,8
013 Bruneck,95,,3,8,11
013 Bruneck,96,,-,7,7
013 Bruneck,97,,4,2,6
013 Bruneck,98,,-,4,4
013 Bruneck,99,,-,1,1
013 Bruneck,100,,-,2,2
013 Bruneck,101,,-,1,1
014 Kuens,0,,2,3,5
014 Kuens,1,,5,4,9
014 Kuens,2,,2,6,8
014 Kuens,3,,2,1,3
014 Kuens,4,,6,2,8
014 Kuens,5,,1,3,4
014 Kuens,6,,5,4,9
014 Kuens,7,,2,1,3
014 Kuens,8,,5,3,8
014 Kuens,9,,2,6,8
014 Kuens,10,,2,3,5
014 Kuens,11,,3,5,8
014 Kuens,12,,2,1,3
014 Kuens,13,,5,2,7
014 Kuens,14,,2,3,5
014 Kuens,15,,1,4,5
014 Kuens,16,,3,2,5
014 Kuens,17,,4,2,6
014 Kuens,18,,2,3,5
014 Kuens,19,,4,2,6
014 Kuens,20,,3,2,5
014 Kuens,21,,1,3,4
014 Kuens,22,,2,-,2
014 Kuens,23,,1,-,1
014 Kuens,24,,1,-,1
014 Kuens,25,,-,2,2
014 Kuens,26,,2,-,2
014 Kuens,27,,2,1,3
014 Kuens,28,,2,3,5
014 Kuens,29,,4,5,9
014 Kuens,30,,1,2,3
014 Kuens,31,,2,1,3
014 Kuens,32,,2,1,3
014 Kuens,33,,3,2,5
014 Kuens,34,,4,6,10
014 Kuens,35,,3,8,11
014 Kuens,36,,-,4,4
014 Kuens,37,,5,2,7
014 Kuens,38,,2,4,6
014 Kuens,39,,7,3,10
014 Kuens,40,,4,1,5
014 Kuens,41,,4,4,8
014 Kuens,42,,5,11,16
014 Kuens,43,,1,6,7
014 Kuens,44,,7,1,8
014 Kuens,45,,7,5,12
014 Kuens,46,,9,2,11
014 Kuens,47,,5,1,6
014 Kuens,48,,-,5,5
014 Kuens,50,,1,-,1
014 Kuens,51,,1,4,5
014 Kuens,52,,3,-,3
014 Kuens,53,,3,-,3
014 Kuens,54,,-,3,3
014 Kuens,55,,-,1,1
014 Kuens,56,,1,2,3
014 Kuens,57,,1,3,4
014 Kuens,58,,1,-,1
014 Kuens,59,,-,3,3
014 Kuens,60,,-,2,2
014 Kuens,61,,3,1,4
014 Kuens,62,,1,2,3
014 Kuens,63,,1,2,3
014 Kuens,64,,3,1,4
014 Kuens,65,,1,-,1
014 Kuens,66,,-,2,2
014 Kuens,67,,-,3,3
014 Kuens,68,,-,2,2
014 Kuens,69,,-,1,1
014 Kuens,70,,5,2,7
014 Kuens,71,,3,2,5
014 Kuens,72,,1,3,4
014 Kuens,73,,2,2,4
014 Kuens,74,,1,3,4
014 Kuens,75,,-,1,1
014 Kuens,76,,-,1,1
014 Kuens,77,,4,2,6
014 Kuens,78,,2,2,4
014 Kuens,79,,2,2,4
014 Kuens,80,,1,-,1
014 Kuens,81,,1,-,1
014 Kuens,82,,1,-,1
014 Kuens,83,,1,1,2
014 Kuens,87,,-,2,2
014 Kuens,90,,-,1,1
014 Kuens,93,,-,1,1
014 Kuens,94,,1,-,1
015 Kaltern a.d. Weinstr.,0,,44,33,77
015 Kaltern a.d. Weinstr.,1,,42,41,83
015 Kaltern a.d. Weinstr.,2,,47,43,90
015 Kaltern a.d. Weinstr.,3,,43,41,84
015 Kaltern a.d. Weinstr.,4,,48,44,92
015 Kaltern a.d. Weinstr.,5,,43,46,89
015 Kaltern a.d. Weinstr.,6,,48,38,86
015 Kaltern a.d. Weinstr.,7,,43,37,80
015 Kaltern a.d. Weinstr.,8,,32,50,82
015 Kaltern a.d. Weinstr.,9,,38,38,76
015 Kaltern a.d. Weinstr.,10,,44,38,82
015 Kaltern a.d. Weinstr.,11,,39,49,88
015 Kaltern a.d. Weinstr.,12,,46,45,91
015 Kaltern a.d. Weinstr.,13,,42,44,86
015 Kaltern a.d. Weinstr.,14,,45,36,81
015 Kaltern a.d. Weinstr.,15,,37,38,75
015 Kaltern a.d. Weinstr.,16,,31,39,70
015 Kaltern a.d. Weinstr.,17,,38,40,78
015 Kaltern a.d. Weinstr.,18,,36,42,78
015 Kaltern a.d. Weinstr.,19,,40,35,75
015 Kaltern a.d. Weinstr.,20,,54,26,80
015 Kaltern a.d. Weinstr.,21,,42,38,80
015 Kaltern a.d. Weinstr.,22,,37,34,71
015 Kaltern a.d. Weinstr.,23,,55,40,95
015 Kaltern a.d. Weinstr.,24,,50,43,93
015 Kaltern a.d. Weinstr.,25,,40,37,77
015 Kaltern a.d. Weinstr.,26,,42,42,84
015 Kaltern a.d. Weinstr.,27,,51,56,107
015 Kaltern a.d. Weinstr.,28,,41,34,75
015 Kaltern a.d. Weinstr.,29,,46,57,103
015 Kaltern a.d. Weinstr.,30,,47,46,93
015 Kaltern a.d. Weinstr.,31,,52,48,100
015 Kaltern a.d. Weinstr.,32,,40,56,96
015 Kaltern a.d. Weinstr.,33,,46,60,106
015 Kaltern a.d. Weinstr.,34,,47,69,116
015 Kaltern a.d. Weinstr.,35,,49,55,104
015 Kaltern a.d. Weinstr.,36,,47,60,107
015 Kaltern a.d. Weinstr.,37,,62,69,131
015 Kaltern a.d. Weinstr.,38,,66,59,125
015 Kaltern a.d. Weinstr.,39,,60,63,123
015 Kaltern a.d. Weinstr.,40,,62,63,125
015 Kaltern a.d. Weinstr.,41,,78,70,148
015 Kaltern a.d. Weinstr.,42,,64,62,126
015 Kaltern a.d. Weinstr.,43,,66,70,136
015 Kaltern a.d. Weinstr.,44,,60,61,121
015 Kaltern a.d. Weinstr.,45,,83,52,135
015 Kaltern a.d. Weinstr.,46,,53,56,109
015 Kaltern a.d. Weinstr.,47,,57,63,120
015 Kaltern a.d. Weinstr.,48,,66,64,130
015 Kaltern a.d. Weinstr.,49,,53,64,117
015 Kaltern a.d. Weinstr.,50,,53,57,110
015 Kaltern a.d. Weinstr.,51,,56,63,119
015 Kaltern a.d. Weinstr.,52,,53,61,114
015 Kaltern a.d. Weinstr.,53,,65,42,107
015 Kaltern a.d. Weinstr.,54,,53,42,95
015 Kaltern a.d. Weinstr.,55,,36,50,86
015 Kaltern a.d. Weinstr.,56,,38,39,77
015 Kaltern a.d. Weinstr.,57,,41,58,99
015 Kaltern a.d. Weinstr.,58,,32,37,69
015 Kaltern a.d. Weinstr.,59,,43,35,78
015 Kaltern a.d. Weinstr.,60,,29,40,69
015 Kaltern a.d. Weinstr.,61,,38,35,73
015 Kaltern a.d. Weinstr.,62,,37,54,91
015 Kaltern a.d. Weinstr.,63,,48,45,93
015 Kaltern a.d. Weinstr.,64,,39,39,78
015 Kaltern a.d. Weinstr.,65,,34,39,73
015 Kaltern a.d. Weinstr.,66,,34,37,71
015 Kaltern a.d. Weinstr.,67,,41,40,81
015 Kaltern a.d. Weinstr.,68,,44,43,87
015 Kaltern a.d. Weinstr.,69,,30,44,74
015 Kaltern a.d. Weinstr.,70,,24,36,60
015 Kaltern a.d. Weinstr.,71,,36,38,74
015 Kaltern a.d. Weinstr.,72,,29,29,58
015 Kaltern a.d. Weinstr.,73,,24,21,45
015 Kaltern a.d. Weinstr.,74,,27,25,52
015 Kaltern a.d. Weinstr.,75,,21,25,46
015 Kaltern a.d. Weinstr.,76,,23,37,60
015 Kaltern a.d. Weinstr.,77,,27,31,58
015 Kaltern a.d. Weinstr.,78,,17,29,46
015 Kaltern a.d. Weinstr.,79,,21,37,58
015 Kaltern a.d. Weinstr.,80,,19,30,49
015 Kaltern a.d. Weinstr.,81,,18,28,46
015 Kaltern a.d. Weinstr.,82,,13,29,42
015 Kaltern a.d. Weinstr.,83,,11,26,37
015 Kaltern a.d. Weinstr.,84,,16,29,45
015 Kaltern a.d. Weinstr.,85,,8,19,27
015 Kaltern a.d. Weinstr.,86,,4,19,23
015 Kaltern a.d. Weinstr.,87,,6,24,30
015 Kaltern a.d. Weinstr.,88,,5,18,23
015 Kaltern a.d. Weinstr.,89,,3,17,20
015 Kaltern a.d. Weinstr.,90,,3,12,15
015 Kaltern a.d. Weinstr.,91,,2,6,8
015 Kaltern a.d. Weinstr.,92,,2,3,5
015 Kaltern a.d. Weinstr.,93,,1,-,1
015 Kaltern a.d. Weinstr.,94,,1,3,4
015 Kaltern a.d. Weinstr.,95,,1,8,9
015 Kaltern a.d. Weinstr.,96,,1,4,5
015 Kaltern a.d. Weinstr.,97,,-,5,5
015 Kaltern a.d. Weinstr.,98,,1,1,2
016 Freienfeld,0,,18,19,37
016 Freienfeld,1,,13,14,27
016 Freienfeld,2,,25,12,37
016 Freienfeld,3,,15,15,30
016 Freienfeld,4,,19,18,37
016 Freienfeld,5,,15,10,25
016 Freienfeld,6,,22,15,37
016 Freienfeld,7,,19,20,39
016 Freienfeld,8,,18,20,38
016 Freienfeld,9,,14,14,28
016 Freienfeld,10,,16,20,36
016 Freienfeld,11,,15,19,34
016 Freienfeld,12,,19,17,36
016 Freienfeld,13,,22,13,35
016 Freienfeld,14,,16,17,33
016 Freienfeld,15,,15,11,26
016 Freienfeld,16,,14,13,27
016 Freienfeld,17,,17,22,39
016 Freienfeld,18,,11,12,23
016 Freienfeld,19,,20,18,38
016 Freienfeld,20,,28,19,47
016 Freienfeld,21,,20,17,37
016 Freienfeld,22,,16,15,31
016 Freienfeld,23,,15,13,28
016 Freienfeld,24,,15,15,30
016 Freienfeld,25,,24,15,39
016 Freienfeld,26,,24,19,43
016 Freienfeld,27,,15,18,33
016 Freienfeld,28,,19,22,41
016 Freienfeld,29,,23,16,39
016 Freienfeld,30,,17,21,38
016 Freienfeld,31,,14,14,28
016 Freienfeld,32,,21,22,43
016 Freienfeld,33,,18,16,34
016 Freienfeld,34,,24,16,40
016 Freienfeld,35,,22,18,40
016 Freienfeld,36,,21,19,40
016 Freienfeld,37,,19,25,44
016 Freienfeld,38,,23,24,47
016 Freienfeld,39,,26,18,44
016 Freienfeld,40,,26,26,52
016 Freienfeld,41,,25,20,45
016 Freienfeld,42,,20,29,49
016 Freienfeld,43,,27,20,47
016 Freienfeld,44,,27,22,49
016 Freienfeld,45,,26,19,45
016 Freienfeld,46,,20,18,38
016 Freienfeld,47,,26,26,52
016 Freienfeld,48,,24,19,43
016 Freienfeld,49,,26,23,49
016 Freienfeld,50,,24,15,39
016 Freienfeld,51,,15,21,36
016 Freienfeld,52,,14,21,35
016 Freienfeld,53,,22,17,39
016 Freienfeld,54,,22,10,32
016 Freienfeld,55,,17,18,35
016 Freienfeld,56,,17,11,28
016 Freienfeld,57,,15,18,33
016 Freienfeld,58,,13,11,24
016 Freienfeld,59,,20,9,29
016 Freienfeld,60,,16,13,29
016 Freienfeld,61,,19,13,32
016 Freienfeld,62,,5,10,15
016 Freienfeld,63,,12,16,28
016 Freienfeld,64,,10,2,12
016 Freienfeld,65,,10,5,15
016 Freienfeld,66,,12,8,20
016 Freienfeld,67,,12,9,21
016 Freienfeld,68,,11,11,22
016 Freienfeld,69,,10,4,14
016 Freienfeld,70,,9,9,18
016 Freienfeld,71,,12,12,24
016 Freienfeld,72,,6,11,17
016 Freienfeld,73,,8,11,19
016 Freienfeld,74,,6,11,17
016 Freienfeld,75,,4,4,8
016 Freienfeld,76,,6,8,14
016 Freienfeld,77,,7,9,16
016 Freienfeld,78,,7,8,15
016 Freienfeld,79,,7,5,12
016 Freienfeld,80,,3,5,8
016 Freienfeld,81,,5,4,9
016 Freienfeld,82,,4,6,10
016 Freienfeld,83,,6,11,17
016 Freienfeld,84,,4,8,12
016 Freienfeld,85,,1,2,3
016 Freienfeld,86,,1,9,10
016 Freienfeld,87,,1,6,7
016 Freienfeld,89,,1,1,2
016 Freienfeld,90,,1,1,2
016 Freienfeld,91,,-,1,1
016 Freienfeld,93,,-,1,1
016 Freienfeld,95,,-,1,1
016 Freienfeld,98,,-,1,1
017 Sand in Taufers,0,,33,42,75
017 Sand in Taufers,1,,30,33,63
017 Sand in Taufers,2,,51,40,91
017 Sand in Taufers,3,,37,23,60
017 Sand in Taufers,4,,35,30,65
017 Sand in Taufers,5,,36,22,58
017 Sand in Taufers,6,,34,26,60
017 Sand in Taufers,7,,27,32,59
017 Sand in Taufers,8,,32,39,71
017 Sand in Taufers,9,,43,20,63
017 Sand in Taufers,10,,36,35,71
017 Sand in Taufers,11,,26,35,61
017 Sand in Taufers,12,,34,36,70
017 Sand in Taufers,13,,29,31,60
017 Sand in Taufers,14,,28,27,55
017 Sand in Taufers,15,,40,34,74
017 Sand in Taufers,16,,23,36,59
017 Sand in Taufers,17,,33,36,69
017 Sand in Taufers,18,,27,30,57
017 Sand in Taufers,19,,23,33,56
017 Sand in Taufers,20,,28,33,61
017 Sand in Taufers,21,,30,33,63
017 Sand in Taufers,22,,22,25,47
017 Sand in Taufers,23,,24,16,40
017 Sand in Taufers,24,,24,29,53
017 Sand in Taufers,25,,32,26,58
017 Sand in Taufers,26,,35,34,69
017 Sand in Taufers,27,,25,41,66
017 Sand in Taufers,28,,35,33,68
017 Sand in Taufers,29,,39,39,78
017 Sand in Taufers,30,,32,40,72
017 Sand in Taufers,31,,40,36,76
017 Sand in Taufers,32,,35,40,75
017 Sand in Taufers,33,,38,36,74
017 Sand in Taufers,34,,42,37,79
017 Sand in Taufers,35,,60,48,108
017 Sand in Taufers,36,,54,43,97
017 Sand in Taufers,37,,49,51,100
017 Sand in Taufers,38,,47,48,95
017 Sand in Taufers,39,,43,61,104
017 Sand in Taufers,40,,54,43,97
017 Sand in Taufers,41,,54,39,93
017 Sand in Taufers,42,,32,41,73
017 Sand in Taufers,43,,53,33,86
017 Sand in Taufers,44,,50,38,88
017 Sand in Taufers,45,,49,42,91
017 Sand in Taufers,46,,47,45,92
017 Sand in Taufers,47,,37,43,80
017 Sand in Taufers,48,,46,42,88
017 Sand in Taufers,49,,40,33,73
017 Sand in Taufers,50,,34,33,67
017 Sand in Taufers,51,,31,20,51
017 Sand in Taufers,52,,24,39,63
017 Sand in Taufers,53,,24,35,59
017 Sand in Taufers,54,,25,22,47
017 Sand in Taufers,55,,27,29,56
017 Sand in Taufers,56,,30,24,54
017 Sand in Taufers,57,,17,28,45
017 Sand in Taufers,58,,25,22,47
017 Sand in Taufers,59,,34,32,66
017 Sand in Taufers,60,,30,22,52
017 Sand in Taufers,61,,22,26,48
017 Sand in Taufers,62,,24,29,53
017 Sand in Taufers,63,,26,24,50
017 Sand in Taufers,64,,27,8,35
017 Sand in Taufers,65,,15,30,45
017 Sand in Taufers,66,,28,28,56
017 Sand in Taufers,67,,28,31,59
017 Sand in Taufers,68,,24,32,56
017 Sand in Taufers,69,,22,18,40
017 Sand in Taufers,70,,25,29,54
017 Sand in Taufers,71,,17,26,43
017 Sand in Taufers,72,,25,12,37
017 Sand in Taufers,73,,15,25,40
017 Sand in Taufers,74,,26,16,42
017 Sand in Taufers,75,,13,11,24
017 Sand in Taufers,76,,12,16,28
017 Sand in Taufers,77,,9,16,25
017 Sand in Taufers,78,,11,11,22
017 Sand in Taufers,79,,12,19,31
017 Sand in Taufers,80,,12,12,24
017 Sand in Taufers,81,,6,12,18
017 Sand in Taufers,82,,7,8,15
017 Sand in Taufers,83,,6,16,22
017 Sand in Taufers,84,,5,8,13
017 Sand in Taufers,85,,4,13,17
017 Sand in Taufers,86,,8,8,16
017 Sand in Taufers,87,,2,12,14
017 Sand in Taufers,88,,3,12,15
017 Sand in Taufers,89,,4,6,10
017 Sand in Taufers,90,,2,5,7
017 Sand in Taufers,91,,2,2,4
017 Sand in Taufers,92,,-,2,2
017 Sand in Taufers,93,,-,1,1
017 Sand in Taufers,94,,2,5,7
017 Sand in Taufers,95,,1,3,4
017 Sand in Taufers,96,,-,2,2
017 Sand in Taufers,97,,-,1,1
017 Sand in Taufers,98,,-,2,2
018 Kastelbell-Tschars,0,,12,8,20
018 Kastelbell-Tschars,1,,12,6,18
018 Kastelbell-Tschars,2,,12,11,23
018 Kastelbell-Tschars,3,,17,8,25
018 Kastelbell-Tschars,4,,9,9,18
018 Kastelbell-Tschars,5,,12,11,23
018 Kastelbell-Tschars,6,,12,9,21
018 Kastelbell-Tschars,7,,7,9,16
018 Kastelbell-Tschars,8,,14,15,29
018 Kastelbell-Tschars,9,,12,9,21
018 Kastelbell-Tschars,10,,25,12,37
018 Kastelbell-Tschars,11,,16,9,25
018 Kastelbell-Tschars,12,,10,11,21
018 Kastelbell-Tschars,13,,15,18,33
018 Kastelbell-Tschars,14,,16,10,26
018 Kastelbell-Tschars,15,,13,16,29
018 Kastelbell-Tschars,16,,14,14,28
018 Kastelbell-Tschars,17,,14,14,28
018 Kastelbell-Tschars,18,,17,14,31
018 Kastelbell-Tschars,19,,16,10,26
018 Kastelbell-Tschars,20,,16,10,26
018 Kastelbell-Tschars,21,,20,7,27
018 Kastelbell-Tschars,22,,18,15,33
018 Kastelbell-Tschars,23,,18,19,37
018 Kastelbell-Tschars,24,,21,22,43
018 Kastelbell-Tschars,25,,7,12,19
018 Kastelbell-Tschars,26,,17,20,37
018 Kastelbell-Tschars,27,,25,13,38
018 Kastelbell-Tschars,28,,13,16,29
018 Kastelbell-Tschars,29,,15,14,29
018 Kastelbell-Tschars,30,,15,15,30
018 Kastelbell-Tschars,31,,15,18,33
018 Kastelbell-Tschars,32,,12,18,30
018 Kastelbell-Tschars,33,,23,18,41
018 Kastelbell-Tschars,34,,18,12,30
018 Kastelbell-Tschars,35,,20,10,30
018 Kastelbell-Tschars,36,,17,25,42
018 Kastelbell-Tschars,37,,11,22,33
018 Kastelbell-Tschars,38,,17,15,32
018 Kastelbell-Tschars,39,,14,15,29
018 Kastelbell-Tschars,40,,24,26,50
018 Kastelbell-Tschars,41,,16,17,33
018 Kastelbell-Tschars,42,,13,20,33
018 Kastelbell-Tschars,43,,19,12,31
018 Kastelbell-Tschars,44,,19,12,31
018 Kastelbell-Tschars,45,,22,15,37
018 Kastelbell-Tschars,46,,26,21,47
018 Kastelbell-Tschars,47,,7,21,28
018 Kastelbell-Tschars,48,,21,19,40
018 Kastelbell-Tschars,49,,25,19,44
018 Kastelbell-Tschars,50,,22,19,41
018 Kastelbell-Tschars,51,,19,14,33
018 Kastelbell-Tschars,52,,16,11,27
018 Kastelbell-Tschars,53,,14,15,29
018 Kastelbell-Tschars,54,,22,18,40
018 Kastelbell-Tschars,55,,9,15,24
018 Kastelbell-Tschars,56,,9,17,26
018 Kastelbell-Tschars,57,,14,15,29
018 Kastelbell-Tschars,58,,16,12,28
018 Kastelbell-Tschars,59,,11,13,24
018 Kastelbell-Tschars,60,,15,9,24
018 Kastelbell-Tschars,61,,11,12,23
018 Kastelbell-Tschars,62,,9,8,17
018 Kastelbell-Tschars,63,,12,13,25
018 Kastelbell-Tschars,64,,10,4,14
018 Kastelbell-Tschars,65,,12,6,18
018 Kastelbell-Tschars,66,,8,7,15
018 Kastelbell-Tschars,67,,12,12,24
018 Kastelbell-Tschars,68,,10,8,18
018 Kastelbell-Tschars,69,,8,9,17
018 Kastelbell-Tschars,70,,12,12,24
018 Kastelbell-Tschars,71,,7,16,23
018 Kastelbell-Tschars,72,,11,11,22
018 Kastelbell-Tschars,73,,9,15,24
018 Kastelbell-Tschars,74,,10,9,19
018 Kastelbell-Tschars,75,,5,14,19
018 Kastelbell-Tschars,76,,16,13,29
018 Kastelbell-Tschars,77,,7,13,20
018 Kastelbell-Tschars,78,,8,14,22
018 Kastelbell-Tschars,79,,16,14,30
018 Kastelbell-Tschars,80,,9,11,20
018 Kastelbell-Tschars,81,,5,10,15
018 Kastelbell-Tschars,82,,4,7,11
018 Kastelbell-Tschars,83,,8,13,21
018 Kastelbell-Tschars,84,,10,10,20
018 Kastelbell-Tschars,85,,2,8,10
018 Kastelbell-Tschars,86,,3,7,10
018 Kastelbell-Tschars,87,,1,5,6
018 Kastelbell-Tschars,88,,1,3,4
018 Kastelbell-Tschars,89,,3,4,7
018 Kastelbell-Tschars,90,,-,1,1
018 Kastelbell-Tschars,91,,-,3,3
018 Kastelbell-Tschars,92,,1,2,3
018 Kastelbell-Tschars,93,,-,1,1
018 Kastelbell-Tschars,95,,-,1,1
018 Kastelbell-Tschars,98,,-,1,1
018 Kastelbell-Tschars,100,,1,-,1
019 Kastelruth,0,,28,37,65
019 Kastelruth,1,,53,39,92
019 Kastelruth,2,,42,40,82
019 Kastelruth,3,,47,34,81
019 Kastelruth,4,,47,35,82
019 Kastelruth,5,,43,38,81
019 Kastelruth,6,,43,40,83
019 Kastelruth,7,,39,33,72
019 Kastelruth,8,,41,32,73
019 Kastelruth,9,,35,28,63
019 Kastelruth,10,,34,41,75
019 Kastelruth,11,,50,43,93
019 Kastelruth,12,,47,48,95
019 Kastelruth,13,,43,37,80
019 Kastelruth,14,,52,39,91
019 Kastelruth,15,,34,33,67
019 Kastelruth,16,,38,36,74
019 Kastelruth,17,,38,56,94
019 Kastelruth,18,,35,40,75
019 Kastelruth,19,,39,38,77
019 Kastelruth,20,,47,39,86
019 Kastelruth,21,,26,23,49
019 Kastelruth,22,,35,40,75
019 Kastelruth,23,,34,25,59
019 Kastelruth,24,,30,33,63
019 Kastelruth,25,,32,36,68
019 Kastelruth,26,,36,37,73
019 Kastelruth,27,,48,42,90
019 Kastelruth,28,,42,40,82
019 Kastelruth,29,,44,37,81
019 Kastelruth,30,,39,39,78
019 Kastelruth,31,,29,37,66
019 Kastelruth,32,,36,36,72
019 Kastelruth,33,,39,70,109
019 Kastelruth,34,,53,41,94
019 Kastelruth,35,,65,44,109
019 Kastelruth,36,,40,61,101
019 Kastelruth,37,,64,43,107
019 Kastelruth,38,,57,43,100
019 Kastelruth,39,,53,52,105
019 Kastelruth,40,,59,45,104
019 Kastelruth,41,,61,60,121
019 Kastelruth,42,,67,53,120
019 Kastelruth,43,,72,51,123
019 Kastelruth,44,,47,76,123
019 Kastelruth,45,,55,39,94
019 Kastelruth,46,,51,34,85
019 Kastelruth,47,,39,53,92
019 Kastelruth,48,,55,44,99
019 Kastelruth,49,,49,44,93
019 Kastelruth,50,,46,45,91
019 Kastelruth,51,,48,41,89
019 Kastelruth,52,,40,41,81
019 Kastelruth,53,,36,31,67
019 Kastelruth,54,,40,37,77
019 Kastelruth,55,,34,30,64
019 Kastelruth,56,,29,29,58
019 Kastelruth,57,,36,26,62
019 Kastelruth,58,,30,24,54
019 Kastelruth,59,,44,25,69
019 Kastelruth,60,,19,35,54
019 Kastelruth,61,,28,41,69
019 Kastelruth,62,,36,30,66
019 Kastelruth,63,,23,38,61
019 Kastelruth,64,,25,21,46
019 Kastelruth,65,,20,46,66
019 Kastelruth,66,,39,39,78
019 Kastelruth,67,,33,28,61
019 Kastelruth,68,,30,45,75
019 Kastelruth,69,,28,34,62
019 Kastelruth,70,,26,28,54
019 Kastelruth,71,,25,25,50
019 Kastelruth,72,,27,24,51
019 Kastelruth,73,,28,19,47
019 Kastelruth,74,,25,27,52
019 Kastelruth,75,,21,22,43
019 Kastelruth,76,,32,28,60
019 Kastelruth,77,,16,35,51
019 Kastelruth,78,,34,22,56
019 Kastelruth,79,,11,24,35
019 Kastelruth,80,,19,25,44
019 Kastelruth,81,,8,14,22
019 Kastelruth,82,,15,27,42
019 Kastelruth,83,,10,16,26
019 Kastelruth,84,,10,15,25
019 Kastelruth,85,,9,18,27
019 Kastelruth,86,,6,15,21
019 Kastelruth,87,,8,12,20
019 Kastelruth,88,,5,11,16
019 Kastelruth,89,,2,9,11
019 Kastelruth,90,,5,4,9
019 Kastelruth,91,,1,3,4
019 Kastelruth,92,,1,2,3
019 Kastelruth,93,,-,2,2
019 Kastelruth,94,,1,5,6
019 Kastelruth,95,,-,5,5
019 Kastelruth,96,,1,3,4
019 Kastelruth,97,,-,2,2
019 Kastelruth,98,,-,2,2
020 Tscherms,0,,6,5,11
020 Tscherms,1,,6,13,19
020 Tscherms,2,,6,10,16
020 Tscherms,3,,8,9,17
020 Tscherms,4,,1,9,10
020 Tscherms,5,,8,6,14
020 Tscherms,6,,9,7,16
020 Tscherms,7,,7,8,15
020 Tscherms,8,,5,9,14
020 Tscherms,9,,9,6,15
020 Tscherms,10,,8,8,16
020 Tscherms,11,,4,8,12
020 Tscherms,12,,8,9,17
020 Tscherms,13,,6,3,9
020 Tscherms,14,,14,10,24
020 Tscherms,15,,9,18,27
020 Tscherms,16,,7,11,18
020 Tscherms,17,,13,7,20
020 Tscherms,18,,6,7,13
020 Tscherms,19,,8,6,14
020 Tscherms,20,,6,5,11
020 Tscherms,21,,5,14,19
020 Tscherms,22,,7,8,15
020 Tscherms,23,,12,9,21
020 Tscherms,24,,14,12,26
020 Tscherms,25,,14,7,21
020 Tscherms,26,,11,13,24
020 Tscherms,27,,8,6,14
020 Tscherms,28,,7,7,14
020 Tscherms,29,,9,9,18
020 Tscherms,30,,7,9,16
020 Tscherms,31,,7,11,18
020 Tscherms,32,,11,5,16
020 Tscherms,33,,5,9,14
020 Tscherms,34,,9,8,17
020 Tscherms,35,,9,7,16
020 Tscherms,36,,10,15,25
020 Tscherms,37,,9,10,19
020 Tscherms,38,,8,12,20
020 Tscherms,39,,11,8,19
020 Tscherms,40,,13,16,29
020 Tscherms,41,,14,11,25
020 Tscherms,42,,11,14,25
020 Tscherms,43,,17,5,22
020 Tscherms,44,,18,16,34
020 Tscherms,45,,14,15,29
020 Tscherms,46,,15,15,30
020 Tscherms,47,,17,14,31
020 Tscherms,48,,12,11,23
020 Tscherms,49,,10,16,26
020 Tscherms,50,,8,16,24
020 Tscherms,51,,8,7,15
020 Tscherms,52,,9,10,19
020 Tscherms,53,,9,6,15
020 Tscherms,54,,10,8,18
020 Tscherms,55,,10,8,18
020 Tscherms,56,,10,8,18
020 Tscherms,57,,10,6,16
020 Tscherms,58,,5,10,15
020 Tscherms,59,,9,6,15
020 Tscherms,60,,3,3,6
020 Tscherms,61,,6,5,11
020 Tscherms,62,,7,7,14
020 Tscherms,63,,5,7,12
020 Tscherms,64,,4,6,10
020 Tscherms,65,,4,9,13
020 Tscherms,66,,5,3,8
020 Tscherms,67,,7,4,11
020 Tscherms,68,,10,8,18
020 Tscherms,69,,5,5,10
020 Tscherms,70,,5,5,10
020 Tscherms,71,,8,2,10
020 Tscherms,72,,5,8,13
020 Tscherms,73,,6,7,13
020 Tscherms,74,,3,4,7
020 Tscherms,75,,2,8,10
020 Tscherms,76,,4,3,7
020 Tscherms,77,,4,4,8
020 Tscherms,78,,2,3,5
020 Tscherms,79,,3,5,8
020 Tscherms,80,,2,2,4
020 Tscherms,81,,4,3,7
020 Tscherms,82,,4,4,8
020 Tscherms,83,,3,2,5
020 Tscherms,84,,3,5,8
020 Tscherms,85,,3,5,8
020 Tscherms,86,,1,3,4
020 Tscherms,87,,1,4,5
020 Tscherms,88,,-,2,2
020 Tscherms,89,,2,2,4
020 Tscherms,90,,-,1,1
020 Tscherms,91,,-,1,1
020 Tscherms,92,,-,1,1
020 Tscherms,93,,-,1,1
020 Tscherms,94,,1,-,1
020 Tscherms,95,,-,1,1
020 Tscherms,97,,1,-,1
021 Kiens,0,,10,24,34
021 Kiens,1,,18,7,25
021 Kiens,2,,14,13,27
021 Kiens,3,,12,11,23
021 Kiens,4,,15,20,35
021 Kiens,5,,15,12,27
021 Kiens,6,,14,18,32
021 Kiens,7,,10,14,24
021 Kiens,8,,23,20,43
021 Kiens,9,,9,21,30
021 Kiens,10,,15,17,32
021 Kiens,11,,22,9,31
021 Kiens,12,,17,13,30
021 Kiens,13,,15,19,34
021 Kiens,14,,14,20,34
021 Kiens,15,,19,17,36
021 Kiens,16,,17,18,35
021 Kiens,17,,26,21,47
021 Kiens,18,,12,25,37
021 Kiens,19,,15,22,37
021 Kiens,20,,13,21,34
021 Kiens,21,,12,17,29
021 Kiens,22,,12,16,28
021 Kiens,23,,20,10,30
021 Kiens,24,,19,13,32
021 Kiens,25,,17,13,30
021 Kiens,26,,15,20,35
021 Kiens,27,,21,19,40
021 Kiens,28,,13,15,28
021 Kiens,29,,23,21,44
021 Kiens,30,,12,14,26
021 Kiens,31,,27,19,46
021 Kiens,32,,20,19,39
021 Kiens,33,,23,24,47
021 Kiens,34,,18,19,37
021 Kiens,35,,20,23,43
021 Kiens,36,,29,23,52
021 Kiens,37,,20,21,41
021 Kiens,38,,25,23,48
021 Kiens,39,,26,30,56
021 Kiens,40,,32,22,54
021 Kiens,41,,39,18,57
021 Kiens,42,,21,24,45
021 Kiens,43,,30,25,55
021 Kiens,44,,21,22,43
021 Kiens,45,,31,22,53
021 Kiens,46,,18,21,39
021 Kiens,47,,30,18,48
021 Kiens,48,,20,25,45
021 Kiens,49,,22,18,40
021 Kiens,50,,24,16,40
021 Kiens,51,,14,13,27
021 Kiens,52,,12,18,30
021 Kiens,53,,19,14,33
021 Kiens,54,,14,9,23
021 Kiens,55,,11,16,27
021 Kiens,56,,14,23,37
021 Kiens,57,,12,9,21
021 Kiens,58,,13,11,24
021 Kiens,59,,16,10,26
021 Kiens,60,,10,13,23
021 Kiens,61,,14,18,32
021 Kiens,62,,13,15,28
021 Kiens,63,,21,14,35
021 Kiens,64,,8,11,19
021 Kiens,65,,9,13,22
021 Kiens,66,,20,10,30
021 Kiens,67,,17,10,27
021 Kiens,68,,15,11,26
021 Kiens,69,,11,16,27
021 Kiens,70,,11,9,20
021 Kiens,71,,11,12,23
021 Kiens,72,,10,11,21
021 Kiens,73,,9,10,19
021 Kiens,74,,3,17,20
021 Kiens,75,,9,10,19
021 Kiens,76,,11,8,19
021 Kiens,77,,12,11,23
021 Kiens,78,,11,8,19
021 Kiens,79,,6,11,17
021 Kiens,80,,3,8,11
021 Kiens,81,,2,3,5
021 Kiens,82,,3,5,8
021 Kiens,83,,-,4,4
021 Kiens,84,,3,3,6
021 Kiens,85,,1,5,6
021 Kiens,86,,3,4,7
021 Kiens,87,,3,2,5
021 Kiens,88,,-,4,4
021 Kiens,89,,1,2,3
021 Kiens,91,,-,1,1
021 Kiens,92,,-,1,1
021 Kiens,94,,-,1,1
021 Kiens,95,,1,1,2
021 Kiens,96,,1,2,3
021 Kiens,97,,-,1,1
022 Klausen,0,,30,20,50
022 Klausen,1,,28,23,51
022 Klausen,2,,29,27,56
022 Klausen,3,,40,42,82
022 Klausen,4,,37,33,70
022 Klausen,5,,38,36,74
022 Klausen,6,,28,30,58
022 Klausen,7,,43,26,69
022 Klausen,8,,31,29,60
022 Klausen,9,,30,31,61
022 Klausen,10,,28,31,59
022 Klausen,11,,24,29,53
022 Klausen,12,,40,35,75
022 Klausen,13,,30,27,57
022 Klausen,14,,33,26,59
022 Klausen,15,,17,36,53
022 Klausen,16,,33,27,60
022 Klausen,17,,44,26,70
022 Klausen,18,,36,38,74
022 Klausen,19,,40,29,69
022 Klausen,20,,27,31,58
022 Klausen,21,,34,31,65
022 Klausen,22,,28,36,64
022 Klausen,23,,37,31,68
022 Klausen,24,,38,38,76
022 Klausen,25,,30,28,58
022 Klausen,26,,25,36,61
022 Klausen,27,,38,40,78
022 Klausen,28,,42,30,72
022 Klausen,29,,34,41,75
022 Klausen,30,,35,30,65
022 Klausen,31,,42,44,86
022 Klausen,32,,35,36,71
022 Klausen,33,,39,28,67
022 Klausen,34,,38,44,82
022 Klausen,35,,40,35,75
022 Klausen,36,,47,34,81
022 Klausen,37,,36,39,75
022 Klausen,38,,40,46,86
022 Klausen,39,,41,44,85
022 Klausen,40,,48,50,98
022 Klausen,41,,49,44,93
022 Klausen,42,,54,45,99
022 Klausen,43,,62,43,105
022 Klausen,44,,42,49,91
022 Klausen,45,,44,48,92
022 Klausen,46,,41,39,80
022 Klausen,47,,35,39,74
022 Klausen,48,,50,45,95
022 Klausen,49,,40,26,66
022 Klausen,50,,34,38,72
022 Klausen,51,,27,30,57
022 Klausen,52,,31,26,57
022 Klausen,53,,30,23,53
022 Klausen,54,,28,35,63
022 Klausen,55,,33,43,76
022 Klausen,56,,20,30,50
022 Klausen,57,,26,17,43
022 Klausen,58,,33,27,60
022 Klausen,59,,27,24,51
022 Klausen,60,,31,25,56
022 Klausen,61,,27,28,55
022 Klausen,62,,24,20,44
022 Klausen,63,,30,22,52
022 Klausen,64,,12,16,28
022 Klausen,65,,23,18,41
022 Klausen,66,,17,30,47
022 Klausen,67,,23,25,48
022 Klausen,68,,27,20,47
022 Klausen,69,,21,21,42
022 Klausen,70,,23,18,41
022 Klausen,71,,15,19,34
022 Klausen,72,,17,17,34
022 Klausen,73,,16,22,38
022 Klausen,74,,10,17,27
022 Klausen,75,,16,14,30
022 Klausen,76,,23,15,38
022 Klausen,77,,10,18,28
022 Klausen,78,,12,13,25
022 Klausen,79,,10,17,27
022 Klausen,80,,16,17,33
022 Klausen,81,,4,16,20
022 Klausen,82,,3,15,18
022 Klausen,83,,8,9,17
022 Klausen,84,,6,8,14
022 Klausen,85,,5,11,16
022 Klausen,86,,2,9,11
022 Klausen,87,,3,7,10
022 Klausen,88,,-,4,4
022 Klausen,89,,2,8,10
022 Klausen,90,,1,6,7
022 Klausen,91,,1,3,4
022 Klausen,92,,1,5,6
022 Klausen,93,,-,1,1
022 Klausen,95,,2,1,3
022 Klausen,96,,-,2,2
022 Klausen,98,,1,-,1
022 Klausen,99,,-,1,1
022 Klausen,100,,-,1,1
023 Karneid,0,,15,16,31
023 Karneid,1,,29,16,45
023 Karneid,2,,22,20,42
023 Karneid,3,,23,15,38
023 Karneid,4,,22,20,42
023 Karneid,5,,20,23,43
023 Karneid,6,,27,19,46
023 Karneid,7,,17,14,31
023 Karneid,8,,22,21,43
023 Karneid,9,,16,19,35
023 Karneid,10,,23,26,49
023 Karneid,11,,19,18,37
023 Karneid,12,,28,18,46
023 Karneid,13,,20,24,44
023 Karneid,14,,26,20,46
023 Karneid,15,,22,22,44
023 Karneid,16,,22,20,42
023 Karneid,17,,24,18,42
023 Karneid,18,,16,21,37
023 Karneid,19,,23,17,40
023 Karneid,20,,16,19,35
023 Karneid,21,,15,17,32
023 Karneid,22,,13,22,35
023 Karneid,23,,19,23,42
023 Karneid,24,,22,13,35
023 Karneid,25,,25,20,45
023 Karneid,26,,17,15,32
023 Karneid,27,,18,17,35
023 Karneid,28,,30,33,63
023 Karneid,29,,21,19,40
023 Karneid,30,,28,36,64
023 Karneid,31,,24,9,33
023 Karneid,32,,16,26,42
023 Karneid,33,,28,27,55
023 Karneid,34,,20,18,38
023 Karneid,35,,27,24,51
023 Karneid,36,,27,30,57
023 Karneid,37,,29,25,54
023 Karneid,38,,34,37,71
023 Karneid,39,,36,21,57
023 Karneid,40,,24,27,51
023 Karneid,41,,39,33,72
023 Karneid,42,,34,31,65
023 Karneid,43,,35,35,70
023 Karneid,44,,31,25,56
023 Karneid,45,,34,25,59
023 Karneid,46,,39,23,62
023 Karneid,47,,27,39,66
023 Karneid,48,,26,21,47
023 Karneid,49,,32,26,58
023 Karneid,50,,27,18,45
023 Karneid,51,,24,19,43
023 Karneid,52,,16,14,30
023 Karneid,53,,21,18,39
023 Karneid,54,,16,11,27
023 Karneid,55,,13,13,26
023 Karneid,56,,20,13,33
023 Karneid,57,,12,21,33
023 Karneid,58,,18,11,29
023 Karneid,59,,24,17,41
023 Karneid,60,,10,15,25
023 Karneid,61,,16,26,42
023 Karneid,62,,9,15,24
023 Karneid,63,,13,22,35
023 Karneid,64,,12,15,27
023 Karneid,65,,12,14,26
023 Karneid,66,,19,16,35
023 Karneid,67,,16,25,41
023 Karneid,68,,19,14,33
023 Karneid,69,,14,14,28
023 Karneid,70,,17,14,31
023 Karneid,71,,19,13,32
023 Karneid,72,,9,8,17
023 Karneid,73,,13,11,24
023 Karneid,74,,9,10,19
023 Karneid,75,,9,15,24
023 Karneid,76,,6,14,20
023 Karneid,77,,12,4,16
023 Karneid,78,,15,11,26
023 Karneid,79,,6,8,14
023 Karneid,80,,8,9,17
023 Karneid,81,,8,7,15
023 Karneid,82,,2,8,10
023 Karneid,83,,5,8,13
023 Karneid,84,,1,5,6
023 Karneid,85,,5,6,11
023 Karneid,86,,2,1,3
023 Karneid,87,,-,5,5
023 Karneid,88,,-,5,5
023 Karneid,89,,2,5,7
023 Karneid,90,,4,1,5
023 Karneid,91,,-,2,2
023 Karneid,92,,-,1,1
023 Karneid,93,,-,1,1
023 Karneid,96,,-,1,1
023 Karneid,97,,-,2,2
024 Kurtatsch a.d.Weinstr.,0,,12,11,23
024 Kurtatsch a.d.Weinstr.,1,,16,7,23
024 Kurtatsch a.d.Weinstr.,2,,7,5,12
024 Kurtatsch a.d.Weinstr.,3,,8,16,24
024 Kurtatsch a.d.Weinstr.,4,,12,16,28
024 Kurtatsch a.d.Weinstr.,5,,11,11,22
024 Kurtatsch a.d.Weinstr.,6,,11,12,23
024 Kurtatsch a.d.Weinstr.,7,,11,17,28
024 Kurtatsch a.d.Weinstr.,8,,20,13,33
024 Kurtatsch a.d.Weinstr.,9,,18,14,32
024 Kurtatsch a.d.Weinstr.,10,,18,13,31
024 Kurtatsch a.d.Weinstr.,11,,17,15,32
024 Kurtatsch a.d.Weinstr.,12,,13,15,28
024 Kurtatsch a.d.Weinstr.,13,,23,19,42
024 Kurtatsch a.d.Weinstr.,14,,19,11,30
024 Kurtatsch a.d.Weinstr.,15,,14,6,20
024 Kurtatsch a.d.Weinstr.,16,,23,18,41
024 Kurtatsch a.d.Weinstr.,17,,20,11,31
024 Kurtatsch a.d.Weinstr.,18,,16,17,33
024 Kurtatsch a.d.Weinstr.,19,,12,8,20
024 Kurtatsch a.d.Weinstr.,20,,10,16,26
024 Kurtatsch a.d.Weinstr.,21,,7,15,22
024 Kurtatsch a.d.Weinstr.,22,,10,12,22
024 Kurtatsch a.d.Weinstr.,23,,10,12,22
024 Kurtatsch a.d.Weinstr.,24,,13,13,26
024 Kurtatsch a.d.Weinstr.,25,,15,11,26
024 Kurtatsch a.d.Weinstr.,26,,17,7,24
024 Kurtatsch a.d.Weinstr.,27,,11,19,30
024 Kurtatsch a.d.Weinstr.,28,,13,11,24
024 Kurtatsch a.d.Weinstr.,29,,10,12,22
024 Kurtatsch a.d.Weinstr.,30,,8,14,22
024 Kurtatsch a.d.Weinstr.,31,,11,12,23
024 Kurtatsch a.d.Weinstr.,32,,9,18,27
024 Kurtatsch a.d.Weinstr.,33,,12,13,25
024 Kurtatsch a.d.Weinstr.,34,,11,12,23
024 Kurtatsch a.d.Weinstr.,35,,16,21,37
024 Kurtatsch a.d.Weinstr.,36,,17,18,35
024 Kurtatsch a.d.Weinstr.,37,,13,16,29
024 Kurtatsch a.d.Weinstr.,38,,16,20,36
024 Kurtatsch a.d.Weinstr.,39,,14,25,39
024 Kurtatsch a.d.Weinstr.,40,,27,23,50
024 Kurtatsch a.d.Weinstr.,41,,28,15,43
024 Kurtatsch a.d.Weinstr.,42,,19,20,39
024 Kurtatsch a.d.Weinstr.,43,,29,16,45
024 Kurtatsch a.d.Weinstr.,44,,25,27,52
024 Kurtatsch a.d.Weinstr.,45,,15,26,41
024 Kurtatsch a.d.Weinstr.,46,,23,20,43
024 Kurtatsch a.d.Weinstr.,47,,24,12,36
024 Kurtatsch a.d.Weinstr.,48,,19,15,34
024 Kurtatsch a.d.Weinstr.,49,,18,22,40
024 Kurtatsch a.d.Weinstr.,50,,19,11,30
024 Kurtatsch a.d.Weinstr.,51,,14,15,29
024 Kurtatsch a.d.Weinstr.,52,,11,11,22
024 Kurtatsch a.d.Weinstr.,53,,9,9,18
024 Kurtatsch a.d.Weinstr.,54,,13,20,33
024 Kurtatsch a.d.Weinstr.,55,,15,8,23
024 Kurtatsch a.d.Weinstr.,56,,18,20,38
024 Kurtatsch a.d.Weinstr.,57,,11,8,19
024 Kurtatsch a.d.Weinstr.,58,,8,15,23
024 Kurtatsch a.d.Weinstr.,59,,14,5,19
024 Kurtatsch a.d.Weinstr.,60,,11,9,20
024 Kurtatsch a.d.Weinstr.,61,,10,9,19
024 Kurtatsch a.d.Weinstr.,62,,11,8,19
024 Kurtatsch a.d.Weinstr.,63,,12,8,20
024 Kurtatsch a.d.Weinstr.,64,,7,8,15
024 Kurtatsch a.d.Weinstr.,65,,5,8,13
024 Kurtatsch a.d.Weinstr.,66,,10,6,16
024 Kurtatsch a.d.Weinstr.,67,,10,12,22
024 Kurtatsch a.d.Weinstr.,68,,8,12,20
024 Kurtatsch a.d.Weinstr.,69,,11,11,22
024 Kurtatsch a.d.Weinstr.,70,,3,15,18
024 Kurtatsch a.d.Weinstr.,71,,12,12,24
024 Kurtatsch a.d.Weinstr.,72,,4,10,14
024 Kurtatsch a.d.Weinstr.,73,,8,8,16
024 Kurtatsch a.d.Weinstr.,74,,3,7,10
024 Kurtatsch a.d.Weinstr.,75,,5,9,14
024 Kurtatsch a.d.Weinstr.,76,,8,7,15
024 Kurtatsch a.d.Weinstr.,77,,11,14,25
024 Kurtatsch a.d.Weinstr.,78,,6,9,15
024 Kurtatsch a.d.Weinstr.,79,,9,16,25
024 Kurtatsch a.d.Weinstr.,80,,7,6,13
024 Kurtatsch a.d.Weinstr.,81,,8,9,17
024 Kurtatsch a.d.Weinstr.,82,,8,4,12
024 Kurtatsch a.d.Weinstr.,83,,2,3,5
024 Kurtatsch a.d.Weinstr.,84,,4,7,11
024 Kurtatsch a.d.Weinstr.,85,,3,7,10
024 Kurtatsch a.d.Weinstr.,86,,4,14,18
024 Kurtatsch a.d.Weinstr.,87,,-,2,2
024 Kurtatsch a.d.Weinstr.,88,,-,6,6
024 Kurtatsch a.d.Weinstr.,89,,4,3,7
024 Kurtatsch a.d.Weinstr.,90,,1,-,1
024 Kurtatsch a.d.Weinstr.,92,,-,2,2
024 Kurtatsch a.d.Weinstr.,94,,1,-,1
024 Kurtatsch a.d.Weinstr.,97,,2,-,2
024 Kurtatsch a.d.Weinstr.,98,,-,2,2
025 Kurtinig a.d. Weinstr.,0,,4,3,7
025 Kurtinig a.d. Weinstr.,1,,5,-,5
025 Kurtinig a.d. Weinstr.,2,,5,3,8
025 Kurtinig a.d. Weinstr.,3,,3,1,4
025 Kurtinig a.d. Weinstr.,4,,-,4,4
025 Kurtinig a.d. Weinstr.,5,,1,2,3
025 Kurtinig a.d. Weinstr.,6,,5,3,8
025 Kurtinig a.d. Weinstr.,7,,3,4,7
025 Kurtinig a.d. Weinstr.,8,,1,8,9
025 Kurtinig a.d. Weinstr.,9,,4,5,9
025 Kurtinig a.d. Weinstr.,10,,3,2,5
025 Kurtinig a.d. Weinstr.,11,,3,5,8
025 Kurtinig a.d. Weinstr.,12,,3,5,8
025 Kurtinig a.d. Weinstr.,13,,1,2,3
025 Kurtinig a.d. Weinstr.,14,,6,2,8
025 Kurtinig a.d. Weinstr.,15,,3,2,5
025 Kurtinig a.d. Weinstr.,16,,4,4,8
025 Kurtinig a.d. Weinstr.,17,,2,3,5
025 Kurtinig a.d. Weinstr.,18,,6,1,7
025 Kurtinig a.d. Weinstr.,19,,3,2,5
025 Kurtinig a.d. Weinstr.,20,,6,4,10
025 Kurtinig a.d. Weinstr.,21,,6,4,10
025 Kurtinig a.d. Weinstr.,22,,6,5,11
025 Kurtinig a.d. Weinstr.,23,,4,4,8
025 Kurtinig a.d. Weinstr.,24,,2,3,5
025 Kurtinig a.d. Weinstr.,25,,3,6,9
025 Kurtinig a.d. Weinstr.,26,,3,3,6
025 Kurtinig a.d. Weinstr.,27,,5,5,10
025 Kurtinig a.d. Weinstr.,28,,8,6,14
025 Kurtinig a.d. Weinstr.,29,,8,5,13
025 Kurtinig a.d. Weinstr.,30,,5,5,10
025 Kurtinig a.d. Weinstr.,31,,3,2,5
025 Kurtinig a.d. Weinstr.,32,,2,3,5
025 Kurtinig a.d. Weinstr.,33,,1,1,2
025 Kurtinig a.d. Weinstr.,34,,2,7,9
025 Kurtinig a.d. Weinstr.,35,,4,3,7
025 Kurtinig a.d. Weinstr.,36,,6,5,11
025 Kurtinig a.d. Weinstr.,37,,4,6,10
025 Kurtinig a.d. Weinstr.,38,,4,3,7
025 Kurtinig a.d. Weinstr.,39,,6,3,9
025 Kurtinig a.d. Weinstr.,40,,7,6,13
025 Kurtinig a.d. Weinstr.,41,,5,3,8
025 Kurtinig a.d. Weinstr.,42,,6,4,10
025 Kurtinig a.d. Weinstr.,43,,1,5,6
025 Kurtinig a.d. Weinstr.,44,,4,4,8
025 Kurtinig a.d. Weinstr.,45,,6,5,11
025 Kurtinig a.d. Weinstr.,46,,9,5,14
025 Kurtinig a.d. Weinstr.,47,,4,4,8
025 Kurtinig a.d. Weinstr.,48,,7,10,17
025 Kurtinig a.d. Weinstr.,49,,6,4,10
025 Kurtinig a.d. Weinstr.,50,,11,6,17
025 Kurtinig a.d. Weinstr.,51,,3,8,11
025 Kurtinig a.d. Weinstr.,52,,7,9,16
025 Kurtinig a.d. Weinstr.,53,,5,1,6
025 Kurtinig a.d. Weinstr.,54,,3,1,4
025 Kurtinig a.d. Weinstr.,55,,7,3,10
025 Kurtinig a.d. Weinstr.,56,,4,6,10
025 Kurtinig a.d. Weinstr.,57,,2,4,6
025 Kurtinig a.d. Weinstr.,58,,2,4,6
025 Kurtinig a.d. Weinstr.,59,,2,3,5
025 Kurtinig a.d. Weinstr.,60,,3,4,7
025 Kurtinig a.d. Weinstr.,61,,5,4,9
025 Kurtinig a.d. Weinstr.,62,,5,2,7
025 Kurtinig a.d. Weinstr.,63,,-,5,5
025 Kurtinig a.d. Weinstr.,64,,3,3,6
025 Kurtinig a.d. Weinstr.,65,,3,2,5
025 Kurtinig a.d. Weinstr.,66,,4,2,6
025 Kurtinig a.d. Weinstr.,67,,2,2,4
025 Kurtinig a.d. Weinstr.,68,,4,2,6
025 Kurtinig a.d. Weinstr.,69,,2,2,4
025 Kurtinig a.d. Weinstr.,70,,5,3,8
025 Kurtinig a.d. Weinstr.,71,,2,2,4
025 Kurtinig a.d. Weinstr.,72,,2,3,5
025 Kurtinig a.d. Weinstr.,73,,4,3,7
025 Kurtinig a.d. Weinstr.,74,,-,6,6
025 Kurtinig a.d. Weinstr.,75,,2,4,6
025 Kurtinig a.d. Weinstr.,76,,1,2,3
025 Kurtinig a.d. Weinstr.,77,,3,4,7
025 Kurtinig a.d. Weinstr.,78,,2,2,4
025 Kurtinig a.d. Weinstr.,79,,4,3,7
025 Kurtinig a.d. Weinstr.,80,,1,3,4
025 Kurtinig a.d. Weinstr.,81,,2,3,5
025 Kurtinig a.d. Weinstr.,82,,2,2,4
025 Kurtinig a.d. Weinstr.,83,,2,1,3
025 Kurtinig a.d. Weinstr.,84,,-,5,5
025 Kurtinig a.d. Weinstr.,85,,-,3,3
025 Kurtinig a.d. Weinstr.,86,,-,1,1
025 Kurtinig a.d. Weinstr.,87,,-,1,1
025 Kurtinig a.d. Weinstr.,88,,1,1,2
025 Kurtinig a.d. Weinstr.,90,,-,1,1
025 Kurtinig a.d. Weinstr.,91,,-,1,1
025 Kurtinig a.d. Weinstr.,94,,-,1,1
025 Kurtinig a.d. Weinstr.,95,,-,2,2
026 Corvara,0,,9,5,14
026 Corvara,1,,7,7,14
026 Corvara,2,,5,9,14
026 Corvara,3,,8,3,11
026 Corvara,4,,8,5,13
026 Corvara,5,,7,3,10
026 Corvara,6,,12,4,16
026 Corvara,7,,4,4,8
026 Corvara,8,,5,7,12
026 Corvara,9,,7,3,10
026 Corvara,10,,8,7,15
026 Corvara,11,,10,9,19
026 Corvara,12,,3,5,8
026 Corvara,13,,10,4,14
026 Corvara,14,,7,7,14
026 Corvara,15,,8,5,13
026 Corvara,16,,5,3,8
026 Corvara,17,,6,10,16
026 Corvara,18,,3,5,8
026 Corvara,19,,9,8,17
026 Corvara,20,,5,5,10
026 Corvara,21,,5,4,9
026 Corvara,22,,9,7,16
026 Corvara,23,,4,-,4
026 Corvara,24,,6,8,14
026 Corvara,25,,6,3,9
026 Corvara,26,,7,9,16
026 Corvara,27,,9,12,21
026 Corvara,28,,13,5,18
026 Corvara,29,,11,7,18
026 Corvara,30,,10,10,20
026 Corvara,31,,11,2,13
026 Corvara,32,,16,11,27
026 Corvara,33,,10,6,16
026 Corvara,34,,9,21,30
026 Corvara,35,,8,14,22
026 Corvara,36,,11,9,20
026 Corvara,37,,9,6,15
026 Corvara,38,,9,5,14
026 Corvara,39,,10,13,23
026 Corvara,40,,17,13,30
026 Corvara,41,,8,15,23
026 Corvara,42,,15,20,35
026 Corvara,43,,12,19,31
026 Corvara,44,,16,17,33
026 Corvara,45,,9,8,17
026 Corvara,46,,14,10,24
026 Corvara,47,,12,11,23
026 Corvara,48,,8,8,16
026 Corvara,49,,17,13,30
026 Corvara,50,,8,7,15
026 Corvara,51,,11,6,17
026 Corvara,52,,8,4,12
026 Corvara,53,,4,7,11
026 Corvara,54,,11,7,18
026 Corvara,55,,10,8,18
026 Corvara,56,,6,12,18
026 Corvara,57,,5,8,13
026 Corvara,58,,5,8,13
026 Corvara,59,,7,8,15
026 Corvara,60,,3,9,12
026 Corvara,61,,4,5,9
026 Corvara,62,,4,10,14
026 Corvara,63,,12,11,23
026 Corvara,64,,5,5,10
026 Corvara,65,,6,8,14
026 Corvara,66,,5,10,15
026 Corvara,67,,6,8,14
026 Corvara,68,,10,11,21
026 Corvara,69,,8,6,14
026 Corvara,70,,6,5,11
026 Corvara,71,,3,7,10
026 Corvara,72,,6,9,15
026 Corvara,73,,4,6,10
026 Corvara,74,,6,4,10
026 Corvara,75,,6,9,15
026 Corvara,76,,3,4,7
026 Corvara,77,,4,4,8
026 Corvara,78,,7,9,16
026 Corvara,79,,3,3,6
026 Corvara,80,,4,5,9
026 Corvara,81,,1,2,3
026 Corvara,82,,5,2,7
026 Corvara,83,,2,1,3
026 Corvara,84,,1,3,4
026 Corvara,85,,2,-,2
026 Corvara,86,,5,2,7
026 Corvara,87,,2,3,5
026 Corvara,88,,2,1,3
026 Corvara,89,,1,1,2
026 Corvara,90,,1,2,3
026 Corvara,91,,-,1,1
026 Corvara,92,,-,1,1
026 Corvara,95,,-,2,2
027 Graun im Vinschgau,0,,17,21,38
027 Graun im Vinschgau,1,,15,8,23
027 Graun im Vinschgau,2,,20,14,34
027 Graun im Vinschgau,3,,13,21,34
027 Graun im Vinschgau,4,,13,14,27
027 Graun im Vinschgau,5,,11,15,26
027 Graun im Vinschgau,6,,9,12,21
027 Graun im Vinschgau,7,,12,13,25
027 Graun im Vinschgau,8,,16,12,28
027 Graun im Vinschgau,9,,18,16,34
027 Graun im Vinschgau,10,,15,10,25
027 Graun im Vinschgau,11,,9,14,23
027 Graun im Vinschgau,12,,19,17,36
027 Graun im Vinschgau,13,,21,18,39
027 Graun im Vinschgau,14,,19,16,35
027 Graun im Vinschgau,15,,18,12,30
027 Graun im Vinschgau,16,,20,14,34
027 Graun im Vinschgau,17,,18,14,32
027 Graun im Vinschgau,18,,10,12,22
027 Graun im Vinschgau,19,,19,19,38
027 Graun im Vinschgau,20,,26,17,43
027 Graun im Vinschgau,21,,20,10,30
027 Graun im Vinschgau,22,,16,10,26
027 Graun im Vinschgau,23,,7,7,14
027 Graun im Vinschgau,24,,18,11,29
027 Graun im Vinschgau,25,,18,14,32
027 Graun im Vinschgau,26,,6,20,26
027 Graun im Vinschgau,27,,18,11,29
027 Graun im Vinschgau,28,,20,19,39
027 Graun im Vinschgau,29,,19,17,36
027 Graun im Vinschgau,30,,15,22,37
027 Graun im Vinschgau,31,,14,18,32
027 Graun im Vinschgau,32,,14,18,32
027 Graun im Vinschgau,33,,14,19,33
027 Graun im Vinschgau,34,,22,16,38
027 Graun im Vinschgau,35,,20,14,34
027 Graun im Vinschgau,36,,19,20,39
027 Graun im Vinschgau,37,,21,17,38
027 Graun im Vinschgau,38,,20,13,33
027 Graun im Vinschgau,39,,21,15,36
027 Graun im Vinschgau,40,,26,19,45
027 Graun im Vinschgau,41,,15,21,36
027 Graun im Vinschgau,42,,23,22,45
027 Graun im Vinschgau,43,,18,24,42
027 Graun im Vinschgau,44,,18,20,38
027 Graun im Vinschgau,45,,22,22,44
027 Graun im Vinschgau,46,,24,18,42
027 Graun im Vinschgau,47,,22,24,46
027 Graun im Vinschgau,48,,19,12,31
027 Graun im Vinschgau,49,,22,19,41
027 Graun im Vinschgau,50,,21,12,33
027 Graun im Vinschgau,51,,19,16,35
027 Graun im Vinschgau,52,,12,13,25
027 Graun im Vinschgau,53,,15,10,25
027 Graun im Vinschgau,54,,13,9,22
027 Graun im Vinschgau,55,,16,15,31
027 Graun im Vinschgau,56,,14,6,20
027 Graun im Vinschgau,57,,17,11,28
027 Graun im Vinschgau,58,,11,16,27
027 Graun im Vinschgau,59,,12,12,24
027 Graun im Vinschgau,60,,7,21,28
027 Graun im Vinschgau,61,,14,12,26
027 Graun im Vinschgau,62,,5,9,14
027 Graun im Vinschgau,63,,10,8,18
027 Graun im Vinschgau,64,,7,8,15
027 Graun im Vinschgau,65,,10,9,19
027 Graun im Vinschgau,66,,9,11,20
027 Graun im Vinschgau,67,,9,12,21
027 Graun im Vinschgau,68,,15,10,25
027 Graun im Vinschgau,69,,11,10,21
027 Graun im Vinschgau,70,,10,11,21
027 Graun im Vinschgau,71,,8,11,19
027 Graun im Vinschgau,72,,12,3,15
027 Graun im Vinschgau,73,,14,14,28
027 Graun im Vinschgau,74,,7,8,15
027 Graun im Vinschgau,75,,11,9,20
027 Graun im Vinschgau,76,,7,7,14
027 Graun im Vinschgau,77,,9,7,16
027 Graun im Vinschgau,78,,9,10,19
027 Graun im Vinschgau,79,,3,5,8
027 Graun im Vinschgau,80,,9,12,21
027 Graun im Vinschgau,81,,6,10,16
027 Graun im Vinschgau,82,,5,7,12
027 Graun im Vinschgau,83,,5,11,16
027 Graun im Vinschgau,84,,1,3,4
027 Graun im Vinschgau,85,,4,7,11
027 Graun im Vinschgau,86,,4,9,13
027 Graun im Vinschgau,87,,6,6,12
027 Graun im Vinschgau,88,,4,6,10
027 Graun im Vinschgau,89,,1,2,3
027 Graun im Vinschgau,90,,-,3,3
027 Graun im Vinschgau,91,,1,1,2
027 Graun im Vinschgau,94,,-,1,1
027 Graun im Vinschgau,95,,-,1,1
027 Graun im Vinschgau,98,,-,1,1
027 Graun im Vinschgau,101,,-,1,1
028 Toblach,0,,13,21,34
028 Toblach,1,,22,20,42
028 Toblach,2,,23,15,38
028 Toblach,3,,18,11,29
028 Toblach,4,,13,19,32
028 Toblach,5,,17,21,38
028 Toblach,6,,19,27,46
028 Toblach,7,,14,20,34
028 Toblach,8,,26,17,43
028 Toblach,9,,21,16,37
028 Toblach,10,,15,22,37
028 Toblach,11,,17,12,29
028 Toblach,12,,23,16,39
028 Toblach,13,,26,21,47
028 Toblach,14,,17,9,26
028 Toblach,15,,21,18,39
028 Toblach,16,,19,21,40
028 Toblach,17,,14,17,31
028 Toblach,18,,17,28,45
028 Toblach,19,,15,23,38
028 Toblach,20,,9,14,23
028 Toblach,21,,14,24,38
028 Toblach,22,,31,16,47
028 Toblach,23,,15,18,33
028 Toblach,24,,25,21,46
028 Toblach,25,,21,27,48
028 Toblach,26,,17,17,34
028 Toblach,27,,27,22,49
028 Toblach,28,,24,24,48
028 Toblach,29,,21,19,40
028 Toblach,30,,29,22,51
028 Toblach,31,,19,18,37
028 Toblach,32,,15,22,37
028 Toblach,33,,23,33,56
028 Toblach,34,,20,21,41
028 Toblach,35,,29,20,49
028 Toblach,36,,27,27,54
028 Toblach,37,,28,30,58
028 Toblach,38,,29,22,51
028 Toblach,39,,19,24,43
028 Toblach,40,,40,24,64
028 Toblach,41,,33,26,59
028 Toblach,42,,26,18,44
028 Toblach,43,,30,29,59
028 Toblach,44,,32,25,57
028 Toblach,45,,35,29,64
028 Toblach,46,,30,26,56
028 Toblach,47,,35,28,63
028 Toblach,48,,21,32,53
028 Toblach,49,,21,16,37
028 Toblach,50,,35,26,61
028 Toblach,51,,20,16,36
028 Toblach,52,,26,23,49
028 Toblach,53,,17,24,41
028 Toblach,54,,17,27,44
028 Toblach,55,,19,19,38
028 Toblach,56,,20,25,45
028 Toblach,57,,20,16,36
028 Toblach,58,,25,13,38
028 Toblach,59,,14,15,29
028 Toblach,60,,21,15,36
028 Toblach,61,,14,25,39
028 Toblach,62,,18,16,34
028 Toblach,63,,13,14,27
028 Toblach,64,,9,18,27
028 Toblach,65,,16,10,26
028 Toblach,66,,13,18,31
028 Toblach,67,,15,19,34
028 Toblach,68,,18,12,30
028 Toblach,69,,12,13,25
028 Toblach,70,,13,12,25
028 Toblach,71,,14,7,21
028 Toblach,72,,4,10,14
028 Toblach,73,,7,14,21
028 Toblach,74,,6,15,21
028 Toblach,75,,14,15,29
028 Toblach,76,,8,9,17
028 Toblach,77,,10,14,24
028 Toblach,78,,11,10,21
028 Toblach,79,,8,10,18
028 Toblach,80,,8,10,18
028 Toblach,81,,10,9,19
028 Toblach,82,,8,9,17
028 Toblach,83,,6,11,17
028 Toblach,84,,6,5,11
028 Toblach,85,,5,7,12
028 Toblach,86,,5,3,8
028 Toblach,87,,4,6,10
028 Toblach,88,,1,3,4
028 Toblach,89,,2,2,4
028 Toblach,90,,3,5,8
028 Toblach,91,,1,-,1
028 Toblach,92,,1,1,2
028 Toblach,94,,-,2,2
028 Toblach,96,,-,2,2
028 Toblach,102,,1,-,1
029 Neumarkt,0,,32,23,55
029 Neumarkt,1,,23,24,47
029 Neumarkt,2,,34,21,55
029 Neumarkt,3,,25,34,59
029 Neumarkt,4,,34,32,66
029 Neumarkt,5,,23,19,42
029 Neumarkt,6,,36,29,65
029 Neumarkt,7,,29,21,50
029 Neumarkt,8,,35,34,69
029 Neumarkt,9,,32,19,51
029 Neumarkt,10,,26,30,56
029 Neumarkt,11,,21,44,65
029 Neumarkt,12,,22,18,40
029 Neumarkt,13,,22,26,48
029 Neumarkt,14,,25,26,51
029 Neumarkt,15,,24,22,46
029 Neumarkt,16,,24,38,62
029 Neumarkt,17,,27,28,55
029 Neumarkt,18,,24,23,47
029 Neumarkt,19,,26,28,54
029 Neumarkt,20,,26,30,56
029 Neumarkt,21,,23,28,51
029 Neumarkt,22,,25,29,54
029 Neumarkt,23,,30,23,53
029 Neumarkt,24,,26,19,45
029 Neumarkt,25,,22,25,47
029 Neumarkt,26,,21,29,50
029 Neumarkt,27,,24,31,55
029 Neumarkt,28,,32,26,58
029 Neumarkt,29,,27,44,71
029 Neumarkt,30,,32,28,60
029 Neumarkt,31,,40,42,82
029 Neumarkt,32,,26,24,50
029 Neumarkt,33,,25,33,58
029 Neumarkt,34,,42,42,84
029 Neumarkt,35,,36,42,78
029 Neumarkt,36,,31,38,69
029 Neumarkt,37,,37,32,69
029 Neumarkt,38,,35,50,85
029 Neumarkt,39,,37,38,75
029 Neumarkt,40,,40,37,77
029 Neumarkt,41,,28,53,81
029 Neumarkt,42,,48,50,98
029 Neumarkt,43,,50,47,97
029 Neumarkt,44,,54,42,96
029 Neumarkt,45,,49,48,97
029 Neumarkt,46,,52,50,102
029 Neumarkt,47,,49,36,85
029 Neumarkt,48,,39,42,81
029 Neumarkt,49,,49,41,90
029 Neumarkt,50,,43,31,74
029 Neumarkt,51,,31,34,65
029 Neumarkt,52,,41,30,71
029 Neumarkt,53,,29,28,57
029 Neumarkt,54,,41,42,83
029 Neumarkt,55,,34,28,62
029 Neumarkt,56,,17,17,34
029 Neumarkt,57,,29,20,49
029 Neumarkt,58,,24,26,50
029 Neumarkt,59,,21,24,45
029 Neumarkt,60,,14,24,38
029 Neumarkt,61,,19,23,42
029 Neumarkt,62,,26,31,57
029 Neumarkt,63,,32,34,66
029 Neumarkt,64,,22,22,44
029 Neumarkt,65,,19,18,37
029 Neumarkt,66,,21,23,44
029 Neumarkt,67,,24,23,47
029 Neumarkt,68,,36,26,62
029 Neumarkt,69,,25,30,55
029 Neumarkt,70,,18,28,46
029 Neumarkt,71,,21,16,37
029 Neumarkt,72,,20,14,34
029 Neumarkt,73,,18,18,36
029 Neumarkt,74,,15,23,38
029 Neumarkt,75,,14,21,35
029 Neumarkt,76,,18,16,34
029 Neumarkt,77,,14,21,35
029 Neumarkt,78,,19,29,48
029 Neumarkt,79,,13,21,34
029 Neumarkt,80,,12,16,28
029 Neumarkt,81,,3,16,19
029 Neumarkt,82,,11,15,26
029 Neumarkt,83,,10,17,27
029 Neumarkt,84,,9,15,24
029 Neumarkt,85,,4,15,19
029 Neumarkt,86,,11,17,28
029 Neumarkt,87,,3,8,11
029 Neumarkt,88,,4,15,19
029 Neumarkt,89,,1,11,12
029 Neumarkt,90,,2,4,6
029 Neumarkt,91,,-,1,1
029 Neumarkt,92,,-,3,3
029 Neumarkt,94,,-,1,1
029 Neumarkt,95,,1,2,3
029 Neumarkt,96,,1,-,1
029 Neumarkt,97,,-,2,2
030 Pfalzen,0,,15,16,31
030 Pfalzen,1,,13,20,33
030 Pfalzen,2,,13,10,23
030 Pfalzen,3,,20,17,37
030 Pfalzen,4,,21,15,36
030 Pfalzen,5,,14,21,35
030 Pfalzen,6,,21,13,34
030 Pfalzen,7,,13,16,29
030 Pfalzen,8,,18,15,33
030 Pfalzen,9,,15,17,32
030 Pfalzen,10,,19,20,39
030 Pfalzen,11,,17,14,31
030 Pfalzen,12,,13,17,30
030 Pfalzen,13,,14,13,27
030 Pfalzen,14,,23,18,41
030 Pfalzen,15,,12,18,30
030 Pfalzen,16,,11,18,29
030 Pfalzen,17,,14,22,36
030 Pfalzen,18,,15,18,33
030 Pfalzen,19,,18,13,31
030 Pfalzen,20,,19,21,40
030 Pfalzen,21,,13,9,22
030 Pfalzen,22,,13,22,35
030 Pfalzen,23,,18,18,36
030 Pfalzen,24,,24,17,41
030 Pfalzen,25,,17,11,28
030 Pfalzen,26,,11,12,23
030 Pfalzen,27,,20,19,39
030 Pfalzen,28,,17,21,38
030 Pfalzen,29,,18,22,40
030 Pfalzen,30,,18,19,37
030 Pfalzen,31,,19,21,40
030 Pfalzen,32,,19,21,40
030 Pfalzen,33,,19,12,31
030 Pfalzen,34,,15,17,32
030 Pfalzen,35,,23,15,38
030 Pfalzen,36,,20,26,46
030 Pfalzen,37,,24,22,46
030 Pfalzen,38,,31,27,58
030 Pfalzen,39,,24,24,48
030 Pfalzen,40,,29,12,41
030 Pfalzen,41,,21,36,57
030 Pfalzen,42,,20,22,42
030 Pfalzen,43,,24,21,45
030 Pfalzen,44,,21,27,48
030 Pfalzen,45,,19,22,41
030 Pfalzen,46,,31,19,50
030 Pfalzen,47,,22,31,53
030 Pfalzen,48,,25,20,45
030 Pfalzen,49,,22,15,37
030 Pfalzen,50,,15,13,28
030 Pfalzen,51,,16,19,35
030 Pfalzen,52,,24,18,42
030 Pfalzen,53,,16,14,30
030 Pfalzen,54,,17,11,28
030 Pfalzen,55,,14,11,25
030 Pfalzen,56,,14,11,25
030 Pfalzen,57,,10,10,20
030 Pfalzen,58,,15,17,32
030 Pfalzen,59,,10,11,21
030 Pfalzen,60,,16,6,22
030 Pfalzen,61,,9,11,20
030 Pfalzen,62,,11,3,14
030 Pfalzen,63,,8,10,18
030 Pfalzen,64,,7,9,16
030 Pfalzen,65,,10,6,16
030 Pfalzen,66,,8,10,18
030 Pfalzen,67,,6,12,18
030 Pfalzen,68,,11,8,19
030 Pfalzen,69,,14,9,23
030 Pfalzen,70,,9,5,14
030 Pfalzen,71,,12,9,21
030 Pfalzen,72,,5,5,10
030 Pfalzen,73,,2,9,11
030 Pfalzen,74,,6,7,13
030 Pfalzen,75,,8,11,19
030 Pfalzen,76,,5,8,13
030 Pfalzen,77,,7,5,12
030 Pfalzen,78,,9,7,16
030 Pfalzen,79,,7,8,15
030 Pfalzen,80,,8,5,13
030 Pfalzen,81,,2,4,6
030 Pfalzen,82,,4,5,9
030 Pfalzen,83,,4,2,6
030 Pfalzen,84,,4,2,6
030 Pfalzen,85,,2,7,9
030 Pfalzen,86,,5,3,8
030 Pfalzen,87,,2,1,3
030 Pfalzen,88,,-,4,4
030 Pfalzen,89,,-,4,4
030 Pfalzen,90,,2,1,3
030 Pfalzen,91,,1,1,2
030 Pfalzen,92,,-,1,1
030 Pfalzen,93,,-,2,2
030 Pfalzen,95,,-,2,2
030 Pfalzen,96,,1,-,1
031 Völs am Schlern,0,,20,17,37
031 Völs am Schlern,1,,20,40,60
031 Völs am Schlern,2,,19,22,41
031 Völs am Schlern,3,,24,25,49
031 Völs am Schlern,4,,37,16,53
031 Völs am Schlern,5,,22,16,38
031 Völs am Schlern,6,,15,23,38
031 Völs am Schlern,7,,19,31,50
031 Völs am Schlern,8,,20,28,48
031 Völs am Schlern,9,,24,28,52
031 Völs am Schlern,10,,18,20,38
031 Völs am Schlern,11,,26,30,56
031 Völs am Schlern,12,,17,25,42
031 Völs am Schlern,13,,13,20,33
031 Völs am Schlern,14,,24,24,48
031 Völs am Schlern,15,,21,11,32
031 Völs am Schlern,16,,15,16,31
031 Völs am Schlern,17,,21,17,38
031 Völs am Schlern,18,,13,21,34
031 Völs am Schlern,19,,22,18,40
031 Völs am Schlern,20,,20,12,32
031 Völs am Schlern,21,,17,15,32
031 Völs am Schlern,22,,19,16,35
031 Völs am Schlern,23,,22,17,39
031 Völs am Schlern,24,,14,19,33
031 Völs am Schlern,25,,20,8,28
031 Völs am Schlern,26,,15,29,44
031 Völs am Schlern,27,,22,28,50
031 Völs am Schlern,28,,26,19,45
031 Völs am Schlern,29,,32,17,49
031 Völs am Schlern,30,,26,29,55
031 Völs am Schlern,31,,31,27,58
031 Völs am Schlern,32,,25,26,51
031 Völs am Schlern,33,,34,22,56
031 Völs am Schlern,34,,25,25,50
031 Völs am Schlern,35,,22,26,48
031 Völs am Schlern,36,,31,34,65
031 Völs am Schlern,37,,44,25,69
031 Völs am Schlern,38,,40,42,82
031 Völs am Schlern,39,,30,36,66
031 Völs am Schlern,40,,37,31,68
031 Völs am Schlern,41,,36,35,71
031 Völs am Schlern,42,,29,27,56
031 Völs am Schlern,43,,37,33,70
031 Völs am Schlern,44,,30,29,59
031 Völs am Schlern,45,,32,25,57
031 Völs am Schlern,46,,30,23,53
031 Völs am Schlern,47,,26,19,45
031 Völs am Schlern,48,,24,20,44
031 Völs am Schlern,49,,22,18,40
031 Völs am Schlern,50,,19,12,31
031 Völs am Schlern,51,,23,15,38
031 Völs am Schlern,52,,19,18,37
031 Völs am Schlern,53,,16,21,37
031 Völs am Schlern,54,,16,16,32
031 Völs am Schlern,55,,16,25,41
031 Völs am Schlern,56,,16,25,41
031 Völs am Schlern,57,,18,19,37
031 Völs am Schlern,58,,18,21,39
031 Völs am Schlern,59,,21,18,39
031 Völs am Schlern,60,,15,9,24
031 Völs am Schlern,61,,17,13,30
031 Völs am Schlern,62,,14,21,35
031 Völs am Schlern,63,,17,12,29
031 Völs am Schlern,64,,8,14,22
031 Völs am Schlern,65,,14,9,23
031 Völs am Schlern,66,,14,21,35
031 Völs am Schlern,67,,14,16,30
031 Völs am Schlern,68,,18,20,38
031 Völs am Schlern,69,,11,22,33
031 Völs am Schlern,70,,13,11,24
031 Völs am Schlern,71,,11,14,25
031 Völs am Schlern,72,,9,10,19
031 Völs am Schlern,73,,8,19,27
031 Völs am Schlern,74,,14,13,27
031 Völs am Schlern,75,,13,8,21
031 Völs am Schlern,76,,6,15,21
031 Völs am Schlern,77,,14,9,23
031 Völs am Schlern,78,,11,15,26
031 Völs am Schlern,79,,3,11,14
031 Völs am Schlern,80,,3,10,13
031 Völs am Schlern,81,,4,13,17
031 Völs am Schlern,82,,6,10,16
031 Völs am Schlern,83,,4,5,9
031 Völs am Schlern,84,,6,10,16
031 Völs am Schlern,85,,7,9,16
031 Völs am Schlern,86,,2,3,5
031 Völs am Schlern,87,,1,4,5
031 Völs am Schlern,88,,-,8,8
031 Völs am Schlern,89,,1,4,5
031 Völs am Schlern,90,,-,2,2
031 Völs am Schlern,91,,1,3,4
031 Völs am Schlern,92,,1,2,3
031 Völs am Schlern,94,,2,2,4
031 Völs am Schlern,95,,2,2,4
031 Völs am Schlern,99,,1,-,1
032 Franzensfeste,0,,3,4,7
032 Franzensfeste,1,,5,7,12
032 Franzensfeste,2,,8,5,13
032 Franzensfeste,3,,4,6,10
032 Franzensfeste,4,,5,6,11
032 Franzensfeste,5,,6,6,12
032 Franzensfeste,6,,7,4,11
032 Franzensfeste,7,,11,2,13
032 Franzensfeste,8,,3,6,9
032 Franzensfeste,9,,4,5,9
032 Franzensfeste,10,,6,5,11
032 Franzensfeste,11,,6,6,12
032 Franzensfeste,12,,5,4,9
032 Franzensfeste,13,,6,5,11
032 Franzensfeste,14,,5,1,6
032 Franzensfeste,15,,7,7,14
032 Franzensfeste,16,,8,5,13
032 Franzensfeste,17,,6,5,11
032 Franzensfeste,18,,5,5,10
032 Franzensfeste,19,,1,7,8
032 Franzensfeste,20,,6,4,10
032 Franzensfeste,21,,2,3,5
032 Franzensfeste,22,,5,1,6
032 Franzensfeste,23,,8,3,11
032 Franzensfeste,24,,4,7,11
032 Franzensfeste,25,,3,12,15
032 Franzensfeste,26,,11,6,17
032 Franzensfeste,27,,3,9,12
032 Franzensfeste,28,,10,4,14
032 Franzensfeste,29,,4,9,13
032 Franzensfeste,30,,12,5,17
032 Franzensfeste,31,,7,8,15
032 Franzensfeste,32,,6,6,12
032 Franzensfeste,33,,5,5,10
032 Franzensfeste,34,,9,12,21
032 Franzensfeste,35,,10,7,17
032 Franzensfeste,36,,3,7,10
032 Franzensfeste,37,,6,11,17
032 Franzensfeste,38,,5,4,9
032 Franzensfeste,39,,9,6,15
032 Franzensfeste,40,,12,8,20
032 Franzensfeste,41,,10,11,21
032 Franzensfeste,42,,8,5,13
032 Franzensfeste,43,,11,5,16
032 Franzensfeste,44,,10,10,20
032 Franzensfeste,45,,15,7,22
032 Franzensfeste,46,,7,11,18
032 Franzensfeste,47,,11,3,14
032 Franzensfeste,48,,4,8,12
032 Franzensfeste,49,,4,8,12
032 Franzensfeste,50,,7,9,16
032 Franzensfeste,51,,13,2,15
032 Franzensfeste,52,,6,5,11
032 Franzensfeste,53,,5,7,12
032 Franzensfeste,54,,9,6,15
032 Franzensfeste,55,,6,8,14
032 Franzensfeste,56,,5,6,11
032 Franzensfeste,57,,5,4,9
032 Franzensfeste,58,,7,1,8
032 Franzensfeste,59,,11,3,14
032 Franzensfeste,60,,3,4,7
032 Franzensfeste,61,,3,4,7
032 Franzensfeste,62,,2,3,5
032 Franzensfeste,63,,8,6,14
032 Franzensfeste,64,,5,7,12
032 Franzensfeste,65,,4,9,13
032 Franzensfeste,66,,3,3,6
032 Franzensfeste,67,,4,-,4
032 Franzensfeste,68,,5,2,7
032 Franzensfeste,69,,3,4,7
032 Franzensfeste,70,,5,3,8
032 Franzensfeste,71,,1,3,4
032 Franzensfeste,72,,7,5,12
032 Franzensfeste,73,,3,2,5
032 Franzensfeste,74,,1,2,3
032 Franzensfeste,75,,3,3,6
032 Franzensfeste,76,,1,5,6
032 Franzensfeste,77,,3,4,7
032 Franzensfeste,78,,2,6,8
032 Franzensfeste,79,,6,4,10
032 Franzensfeste,80,,3,5,8
032 Franzensfeste,81,,2,3,5
032 Franzensfeste,82,,3,3,6
032 Franzensfeste,83,,2,7,9
032 Franzensfeste,84,,1,1,2
032 Franzensfeste,85,,4,4,8
032 Franzensfeste,86,,2,6,8
032 Franzensfeste,87,,2,3,5
032 Franzensfeste,88,,-,3,3
032 Franzensfeste,89,,-,1,1
032 Franzensfeste,91,,-,2,2
032 Franzensfeste,97,,-,1,1
033 Villnöss,0,,19,12,31
033 Villnöss,1,,18,11,29
033 Villnöss,2,,13,16,29
033 Villnöss,3,,12,22,34
033 Villnöss,4,,20,23,43
033 Villnöss,5,,12,17,29
033 Villnöss,6,,16,15,31
033 Villnöss,7,,21,14,35
033 Villnöss,8,,15,22,37
033 Villnöss,9,,18,15,33
033 Villnöss,10,,16,30,46
033 Villnöss,11,,22,20,42
033 Villnöss,12,,17,22,39
033 Villnöss,13,,20,17,37
033 Villnöss,14,,16,13,29
033 Villnöss,15,,15,12,27
033 Villnöss,16,,17,12,29
033 Villnöss,17,,11,14,25
033 Villnöss,18,,21,17,38
033 Villnöss,19,,15,12,27
033 Villnöss,20,,14,9,23
033 Villnöss,21,,16,22,38
033 Villnöss,22,,17,20,37
033 Villnöss,23,,11,14,25
033 Villnöss,24,,15,16,31
033 Villnöss,25,,18,15,33
033 Villnöss,26,,15,14,29
033 Villnöss,27,,11,15,26
033 Villnöss,28,,14,19,33
033 Villnöss,29,,22,11,33
033 Villnöss,30,,9,11,20
033 Villnöss,31,,17,16,33
033 Villnöss,32,,14,13,27
033 Villnöss,33,,15,12,27
033 Villnöss,34,,20,16,36
033 Villnöss,35,,20,17,37
033 Villnöss,36,,10,16,26
033 Villnöss,37,,16,24,40
033 Villnöss,38,,24,26,50
033 Villnöss,39,,16,26,42
033 Villnöss,40,,28,23,51
033 Villnöss,41,,28,19,47
033 Villnöss,42,,18,18,36
033 Villnöss,43,,27,19,46
033 Villnöss,44,,28,22,50
033 Villnöss,45,,31,28,59
033 Villnöss,46,,30,21,51
033 Villnöss,47,,30,21,51
033 Villnöss,48,,22,14,36
033 Villnöss,49,,21,11,32
033 Villnöss,50,,10,10,20
033 Villnöss,51,,12,15,27
033 Villnöss,52,,13,11,24
033 Villnöss,53,,15,16,31
033 Villnöss,54,,12,3,15
033 Villnöss,55,,17,14,31
033 Villnöss,56,,13,15,28
033 Villnöss,57,,12,11,23
033 Villnöss,58,,13,9,22
033 Villnöss,59,,7,9,16
033 Villnöss,60,,7,14,21
033 Villnöss,61,,10,10,20
033 Villnöss,62,,12,11,23
033 Villnöss,63,,9,5,14
033 Villnöss,64,,8,4,12
033 Villnöss,65,,6,13,19
033 Villnöss,66,,11,10,21
033 Villnöss,67,,12,19,31
033 Villnöss,68,,11,9,20
033 Villnöss,69,,7,17,24
033 Villnöss,70,,12,13,25
033 Villnöss,71,,12,9,21
033 Villnöss,72,,8,15,23
033 Villnöss,73,,3,16,19
033 Villnöss,74,,3,9,12
033 Villnöss,75,,8,8,16
033 Villnöss,76,,8,11,19
033 Villnöss,77,,12,12,24
033 Villnöss,78,,9,11,20
033 Villnöss,79,,10,10,20
033 Villnöss,80,,7,9,16
033 Villnöss,81,,12,7,19
033 Villnöss,82,,5,8,13
033 Villnöss,83,,2,7,9
033 Villnöss,84,,5,6,11
033 Villnöss,85,,2,7,9
033 Villnöss,86,,5,11,16
033 Villnöss,87,,2,5,7
033 Villnöss,88,,1,3,4
033 Villnöss,89,,-,4,4
033 Villnöss,90,,1,2,3
033 Villnöss,91,,-,1,1
033 Villnöss,92,,-,2,2
033 Villnöss,94,,-,1,1
033 Villnöss,96,,-,1,1
034 Gais,0,,24,13,37
034 Gais,1,,14,15,29
034 Gais,2,,17,18,35
034 Gais,3,,23,16,39
034 Gais,4,,28,18,46
034 Gais,5,,14,27,41
034 Gais,6,,20,17,37
034 Gais,7,,22,23,45
034 Gais,8,,21,17,38
034 Gais,9,,21,16,37
034 Gais,10,,21,27,48
034 Gais,11,,24,21,45
034 Gais,12,,29,12,41
034 Gais,13,,9,16,25
034 Gais,14,,28,19,47
034 Gais,15,,22,24,46
034 Gais,16,,15,20,35
034 Gais,17,,22,29,51
034 Gais,18,,24,30,54
034 Gais,19,,15,20,35
034 Gais,20,,17,12,29
034 Gais,21,,14,19,33
034 Gais,22,,18,18,36
034 Gais,23,,16,20,36
034 Gais,24,,21,17,38
034 Gais,25,,24,16,40
034 Gais,26,,19,23,42
034 Gais,27,,19,16,35
034 Gais,28,,21,20,41
034 Gais,29,,23,27,50
034 Gais,30,,27,12,39
034 Gais,31,,19,19,38
034 Gais,32,,23,25,48
034 Gais,33,,25,26,51
034 Gais,34,,26,22,48
034 Gais,35,,32,30,62
034 Gais,36,,27,25,52
034 Gais,37,,31,39,70
034 Gais,38,,38,26,64
034 Gais,39,,28,27,55
034 Gais,40,,39,32,71
034 Gais,41,,23,21,44
034 Gais,42,,25,31,56
034 Gais,43,,33,21,54
034 Gais,44,,26,25,51
034 Gais,45,,32,32,64
034 Gais,46,,17,17,34
034 Gais,47,,29,19,48
034 Gais,48,,24,31,55
034 Gais,49,,18,11,29
034 Gais,50,,18,21,39
034 Gais,51,,25,18,43
034 Gais,52,,13,15,28
034 Gais,53,,22,21,43
034 Gais,54,,21,11,32
034 Gais,55,,16,13,29
034 Gais,56,,13,13,26
034 Gais,57,,14,17,31
034 Gais,58,,14,20,34
034 Gais,59,,22,22,44
034 Gais,60,,15,12,27
034 Gais,61,,22,13,35
034 Gais,62,,20,11,31
034 Gais,63,,16,15,31
034 Gais,64,,14,9,23
034 Gais,65,,13,13,26
034 Gais,66,,11,17,28
034 Gais,67,,12,13,25
034 Gais,68,,21,12,33
034 Gais,69,,16,12,28
034 Gais,70,,12,15,27
034 Gais,71,,14,13,27
034 Gais,72,,17,16,33
034 Gais,73,,10,14,24
034 Gais,74,,12,12,24
034 Gais,75,,6,6,12
034 Gais,76,,5,10,15
034 Gais,77,,5,7,12
034 Gais,78,,8,7,15
034 Gais,79,,4,10,14
034 Gais,80,,2,3,5
034 Gais,81,,8,7,15
034 Gais,82,,6,7,13
034 Gais,83,,7,6,13
034 Gais,84,,3,4,7
034 Gais,85,,3,2,5
034 Gais,86,,2,7,9
034 Gais,87,,2,3,5
034 Gais,88,,-,4,4
034 Gais,89,,2,-,2
034 Gais,90,,-,1,1
034 Gais,91,,1,1,2
034 Gais,92,,1,-,1
034 Gais,94,,-,1,1
034 Gais,96,,2,-,2
034 Gais,98,,-,1,1
035 Gargazon,0,,5,7,12
035 Gargazon,1,,12,7,19
035 Gargazon,2,,8,6,14
035 Gargazon,3,,9,13,22
035 Gargazon,4,,8,8,16
035 Gargazon,5,,8,6,14
035 Gargazon,6,,7,14,21
035 Gargazon,7,,6,13,19
035 Gargazon,8,,4,7,11
035 Gargazon,9,,11,5,16
035 Gargazon,10,,14,9,23
035 Gargazon,11,,16,9,25
035 Gargazon,12,,5,13,18
035 Gargazon,13,,12,7,19
035 Gargazon,14,,12,4,16
035 Gargazon,15,,5,7,12
035 Gargazon,16,,9,8,17
035 Gargazon,17,,14,9,23
035 Gargazon,18,,18,11,29
035 Gargazon,19,,8,12,20
035 Gargazon,20,,8,6,14
035 Gargazon,21,,8,4,12
035 Gargazon,22,,7,9,16
035 Gargazon,23,,4,12,16
035 Gargazon,24,,13,6,19
035 Gargazon,25,,11,6,17
035 Gargazon,26,,5,11,16
035 Gargazon,27,,5,7,12
035 Gargazon,28,,10,10,20
035 Gargazon,29,,11,17,28
035 Gargazon,30,,8,7,15
035 Gargazon,31,,6,11,17
035 Gargazon,32,,10,11,21
035 Gargazon,33,,6,13,19
035 Gargazon,34,,9,10,19
035 Gargazon,35,,15,15,30
035 Gargazon,36,,14,10,24
035 Gargazon,37,,11,18,29
035 Gargazon,38,,18,16,34
035 Gargazon,39,,17,12,29
035 Gargazon,40,,20,16,36
035 Gargazon,41,,17,18,35
035 Gargazon,42,,11,13,24
035 Gargazon,43,,14,16,30
035 Gargazon,44,,13,9,22
035 Gargazon,45,,16,16,32
035 Gargazon,46,,18,20,38
035 Gargazon,47,,13,12,25
035 Gargazon,48,,11,15,26
035 Gargazon,49,,11,11,22
035 Gargazon,50,,19,13,32
035 Gargazon,51,,5,8,13
035 Gargazon,52,,14,12,26
035 Gargazon,53,,14,6,20
035 Gargazon,54,,8,4,12
035 Gargazon,55,,10,10,20
035 Gargazon,56,,15,9,24
035 Gargazon,57,,4,9,13
035 Gargazon,58,,10,8,18
035 Gargazon,59,,9,7,16
035 Gargazon,60,,6,9,15
035 Gargazon,61,,7,9,16
035 Gargazon,62,,5,6,11
035 Gargazon,63,,10,14,24
035 Gargazon,64,,9,6,15
035 Gargazon,65,,2,4,6
035 Gargazon,66,,6,9,15
035 Gargazon,67,,6,9,15
035 Gargazon,68,,9,8,17
035 Gargazon,69,,5,16,21
035 Gargazon,70,,8,6,14
035 Gargazon,71,,8,7,15
035 Gargazon,72,,7,12,19
035 Gargazon,73,,3,4,7
035 Gargazon,74,,12,2,14
035 Gargazon,75,,5,6,11
035 Gargazon,76,,1,10,11
035 Gargazon,77,,5,2,7
035 Gargazon,78,,3,7,10
035 Gargazon,79,,3,4,7
035 Gargazon,80,,2,4,6
035 Gargazon,81,,2,2,4
035 Gargazon,82,,2,5,7
035 Gargazon,83,,3,3,6
035 Gargazon,84,,1,3,4
035 Gargazon,85,,-,3,3
035 Gargazon,86,,4,4,8
035 Gargazon,87,,2,6,8
035 Gargazon,88,,1,3,4
035 Gargazon,90,,-,1,1
035 Gargazon,93,,-,1,1
035 Gargazon,94,,1,2,3
035 Gargazon,95,,1,-,1
035 Gargazon,96,,-,3,3
035 Gargazon,97,,1,-,1
036 Glurns,0,,1,4,5
036 Glurns,1,,9,3,12
036 Glurns,2,,5,2,7
036 Glurns,3,,4,6,10
036 Glurns,4,,5,5,10
036 Glurns,5,,3,4,7
036 Glurns,6,,6,6,12
036 Glurns,7,,3,5,8
036 Glurns,8,,5,1,6
036 Glurns,9,,4,4,8
036 Glurns,10,,3,2,5
036 Glurns,11,,9,3,12
036 Glurns,12,,4,7,11
036 Glurns,13,,7,4,11
036 Glurns,14,,7,5,12
036 Glurns,15,,2,3,5
036 Glurns,16,,6,7,13
036 Glurns,17,,5,8,13
036 Glurns,18,,6,2,8
036 Glurns,19,,8,7,15
036 Glurns,20,,4,3,7
036 Glurns,21,,6,8,14
036 Glurns,22,,5,4,9
036 Glurns,23,,6,6,12
036 Glurns,24,,3,1,4
036 Glurns,25,,7,6,13
036 Glurns,26,,10,6,16
036 Glurns,27,,11,7,18
036 Glurns,28,,5,3,8
036 Glurns,29,,12,3,15
036 Glurns,30,,4,8,12
036 Glurns,31,,7,6,13
036 Glurns,32,,3,4,7
036 Glurns,33,,11,5,16
036 Glurns,34,,7,10,17
036 Glurns,35,,9,11,20
036 Glurns,36,,3,3,6
036 Glurns,37,,5,7,12
036 Glurns,38,,5,5,10
036 Glurns,39,,5,1,6
036 Glurns,40,,2,6,8
036 Glurns,41,,8,4,12
036 Glurns,42,,5,9,14
036 Glurns,43,,6,8,14
036 Glurns,44,,3,6,9
036 Glurns,45,,9,5,14
036 Glurns,46,,5,9,14
036 Glurns,47,,5,5,10
036 Glurns,48,,6,6,12
036 Glurns,49,,7,9,16
036 Glurns,50,,12,6,18
036 Glurns,51,,4,9,13
036 Glurns,52,,6,12,18
036 Glurns,53,,6,6,12
036 Glurns,54,,8,7,15
036 Glurns,55,,12,4,16
036 Glurns,56,,8,9,17
036 Glurns,57,,4,8,12
036 Glurns,58,,8,10,18
036 Glurns,59,,6,5,11
036 Glurns,60,,5,3,8
036 Glurns,61,,7,5,12
036 Glurns,62,,10,7,17
036 Glurns,63,,8,2,10
036 Glurns,64,,6,1,7
036 Glurns,65,,5,4,9
036 Glurns,66,,1,4,5
036 Glurns,67,,4,6,10
036 Glurns,68,,4,2,6
036 Glurns,69,,6,1,7
036 Glurns,70,,1,3,4
036 Glurns,71,,4,3,7
036 Glurns,72,,4,4,8
036 Glurns,73,,-,1,1
036 Glurns,74,,2,4,6
036 Glurns,75,,1,5,6
036 Glurns,76,,1,1,2
036 Glurns,77,,5,3,8
036 Glurns,78,,4,1,5
036 Glurns,79,,2,2,4
036 Glurns,80,,2,7,9
036 Glurns,81,,-,2,2
036 Glurns,82,,1,2,3
036 Glurns,83,,-,2,2
036 Glurns,84,,1,5,6
036 Glurns,85,,1,2,3
036 Glurns,86,,-,1,1
036 Glurns,88,,1,-,1
036 Glurns,90,,1,1,2
036 Glurns,92,,-,1,1
036 Glurns,94,,-,1,1
037 Latsch,0,,21,30,51
037 Latsch,1,,23,22,45
037 Latsch,2,,27,31,58
037 Latsch,3,,29,25,54
037 Latsch,4,,21,28,49
037 Latsch,5,,31,25,56
037 Latsch,6,,23,22,45
037 Latsch,7,,28,25,53
037 Latsch,8,,36,20,56
037 Latsch,9,,36,33,69
037 Latsch,10,,29,21,50
037 Latsch,11,,26,20,46
037 Latsch,12,,37,39,76
037 Latsch,13,,39,34,73
037 Latsch,14,,46,34,80
037 Latsch,15,,40,22,62
037 Latsch,16,,32,36,68
037 Latsch,17,,32,36,68
037 Latsch,18,,30,39,69
037 Latsch,19,,36,48,84
037 Latsch,20,,35,31,66
037 Latsch,21,,42,37,79
037 Latsch,22,,33,39,72
037 Latsch,23,,38,32,70
037 Latsch,24,,32,38,70
037 Latsch,25,,36,34,70
037 Latsch,26,,28,33,61
037 Latsch,27,,35,42,77
037 Latsch,28,,27,44,71
037 Latsch,29,,34,38,72
037 Latsch,30,,42,35,77
037 Latsch,31,,37,21,58
037 Latsch,32,,33,33,66
037 Latsch,33,,31,27,58
037 Latsch,34,,37,37,74
037 Latsch,35,,30,29,59
037 Latsch,36,,36,35,71
037 Latsch,37,,34,38,72
037 Latsch,38,,45,42,87
037 Latsch,39,,34,35,69
037 Latsch,40,,38,40,78
037 Latsch,41,,49,52,101
037 Latsch,42,,54,48,102
037 Latsch,43,,32,49,81
037 Latsch,44,,58,45,103
037 Latsch,45,,56,48,104
037 Latsch,46,,53,47,100
037 Latsch,47,,41,46,87
037 Latsch,48,,47,41,88
037 Latsch,49,,38,50,88
037 Latsch,50,,46,46,92
037 Latsch,51,,39,30,69
037 Latsch,52,,31,35,66
037 Latsch,53,,33,33,66
037 Latsch,54,,35,25,60
037 Latsch,55,,29,18,47
037 Latsch,56,,24,23,47
037 Latsch,57,,38,21,59
037 Latsch,58,,21,33,54
037 Latsch,59,,31,17,48
037 Latsch,60,,16,21,37
037 Latsch,61,,15,20,35
037 Latsch,62,,17,15,32
037 Latsch,63,,19,21,40
037 Latsch,64,,15,20,35
037 Latsch,65,,24,12,36
037 Latsch,66,,22,21,43
037 Latsch,67,,23,25,48
037 Latsch,68,,16,23,39
037 Latsch,69,,21,24,45
037 Latsch,70,,18,17,35
037 Latsch,71,,14,26,40
037 Latsch,72,,11,24,35
037 Latsch,73,,16,13,29
037 Latsch,74,,24,14,38
037 Latsch,75,,16,26,42
037 Latsch,76,,14,23,37
037 Latsch,77,,21,19,40
037 Latsch,78,,14,17,31
037 Latsch,79,,18,16,34
037 Latsch,80,,15,14,29
037 Latsch,81,,16,17,33
037 Latsch,82,,11,23,34
037 Latsch,83,,12,16,28
037 Latsch,84,,11,14,25
037 Latsch,85,,5,10,15
037 Latsch,86,,5,11,16
037 Latsch,87,,5,11,16
037 Latsch,88,,9,6,15
037 Latsch,89,,4,3,7
037 Latsch,90,,2,3,5
037 Latsch,91,,2,3,5
037 Latsch,92,,1,1,2
037 Latsch,93,,1,1,2
037 Latsch,94,,-,2,2
037 Latsch,95,,-,2,2
037 Latsch,96,,-,1,1
037 Latsch,97,,1,-,1
037 Latsch,100,,-,1,1
038 Algund,0,,22,35,57
038 Algund,1,,16,19,35
038 Algund,2,,23,24,47
038 Algund,3,,26,19,45
038 Algund,4,,22,22,44
038 Algund,5,,24,22,46
038 Algund,6,,29,23,52
038 Algund,7,,22,31,53
038 Algund,8,,33,25,58
038 Algund,9,,22,34,56
038 Algund,10,,40,28,68
038 Algund,11,,24,25,49
038 Algund,12,,25,18,43
038 Algund,13,,22,22,44
038 Algund,14,,33,23,56
038 Algund,15,,27,24,51
038 Algund,16,,28,20,48
038 Algund,17,,34,22,56
038 Algund,18,,29,21,50
038 Algund,19,,31,23,54
038 Algund,20,,25,27,52
038 Algund,21,,20,26,46
038 Algund,22,,26,27,53
038 Algund,23,,23,35,58
038 Algund,24,,26,23,49
038 Algund,25,,26,25,51
038 Algund,26,,29,38,67
038 Algund,27,,28,22,50
038 Algund,28,,34,30,64
038 Algund,29,,30,32,62
038 Algund,30,,24,36,60
038 Algund,31,,25,30,55
038 Algund,32,,31,37,68
038 Algund,33,,30,37,67
038 Algund,34,,36,37,73
038 Algund,35,,32,41,73
038 Algund,36,,37,32,69
038 Algund,37,,44,40,84
038 Algund,38,,36,42,78
038 Algund,39,,51,39,90
038 Algund,40,,46,48,94
038 Algund,41,,44,32,76
038 Algund,42,,39,45,84
038 Algund,43,,40,39,79
038 Algund,44,,40,45,85
038 Algund,45,,54,26,80
038 Algund,46,,36,38,74
038 Algund,47,,39,45,84
038 Algund,48,,31,52,83
038 Algund,49,,40,40,80
038 Algund,50,,40,36,76
038 Algund,51,,44,31,75
038 Algund,52,,25,36,61
038 Algund,53,,36,31,67
038 Algund,54,,26,28,54
038 Algund,55,,37,25,62
038 Algund,56,,18,31,49
038 Algund,57,,27,26,53
038 Algund,58,,26,28,54
038 Algund,59,,23,29,52
038 Algund,60,,22,27,49
038 Algund,61,,26,23,49
038 Algund,62,,19,20,39
038 Algund,63,,30,30,60
038 Algund,64,,25,24,49
038 Algund,65,,24,28,52
038 Algund,66,,20,19,39
038 Algund,67,,16,34,50
038 Algund,68,,18,21,39
038 Algund,69,,18,24,42
038 Algund,70,,22,28,50
038 Algund,71,,19,21,40
038 Algund,72,,16,14,30
038 Algund,73,,15,26,41
038 Algund,74,,13,17,30
038 Algund,75,,22,25,47
038 Algund,76,,18,21,39
038 Algund,77,,14,20,34
038 Algund,78,,11,23,34
038 Algund,79,,12,21,33
038 Algund,80,,7,22,29
038 Algund,81,,8,16,24
038 Algund,82,,10,15,25
038 Algund,83,,11,13,24
038 Algund,84,,9,13,22
038 Algund,85,,4,12,16
038 Algund,86,,2,5,7
038 Algund,87,,6,14,20
038 Algund,88,,3,8,11
038 Algund,89,,4,3,7
038 Algund,90,,1,6,7
038 Algund,91,,2,2,4
038 Algund,92,,-,3,3
038 Algund,93,,1,2,3
038 Algund,94,,-,2,2
038 Algund,95,,-,2,2
038 Algund,96,,1,-,1
038 Algund,97,,1,2,3
038 Algund,98,,-,4,4
038 Algund,99,,-,1,1
038 Algund,101,,-,2,2
039 Lajen,0,,19,8,27
039 Lajen,1,,19,17,36
039 Lajen,2,,20,20,40
039 Lajen,3,,16,21,37
039 Lajen,4,,16,13,29
039 Lajen,5,,17,25,42
039 Lajen,6,,20,24,44
039 Lajen,7,,22,8,30
039 Lajen,8,,21,22,43
039 Lajen,9,,27,16,43
039 Lajen,10,,19,17,36
039 Lajen,11,,17,16,33
039 Lajen,12,,16,23,39
039 Lajen,13,,15,11,26
039 Lajen,14,,8,11,19
039 Lajen,15,,12,15,27
039 Lajen,16,,14,13,27
039 Lajen,17,,16,9,25
039 Lajen,18,,22,18,40
039 Lajen,19,,8,8,16
039 Lajen,20,,16,15,31
039 Lajen,21,,13,13,26
039 Lajen,22,,13,8,21
039 Lajen,23,,17,19,36
039 Lajen,24,,19,13,32
039 Lajen,25,,12,14,26
039 Lajen,26,,11,24,35
039 Lajen,27,,17,20,37
039 Lajen,28,,11,21,32
039 Lajen,29,,23,17,40
039 Lajen,30,,22,22,44
039 Lajen,31,,23,26,49
039 Lajen,32,,24,17,41
039 Lajen,33,,28,21,49
039 Lajen,34,,21,23,44
039 Lajen,35,,33,20,53
039 Lajen,36,,21,24,45
039 Lajen,37,,21,27,48
039 Lajen,38,,16,22,38
039 Lajen,39,,22,26,48
039 Lajen,40,,34,24,58
039 Lajen,41,,22,24,46
039 Lajen,42,,24,25,49
039 Lajen,43,,24,16,40
039 Lajen,44,,26,19,45
039 Lajen,45,,23,20,43
039 Lajen,46,,16,12,28
039 Lajen,47,,30,19,49
039 Lajen,48,,10,17,27
039 Lajen,49,,14,9,23
039 Lajen,50,,18,25,43
039 Lajen,51,,24,13,37
039 Lajen,52,,13,11,24
039 Lajen,53,,10,13,23
039 Lajen,54,,12,14,26
039 Lajen,55,,5,14,19
039 Lajen,56,,10,7,17
039 Lajen,57,,8,10,18
039 Lajen,58,,8,12,20
039 Lajen,59,,14,11,25
039 Lajen,60,,4,15,19
039 Lajen,61,,9,17,26
039 Lajen,62,,16,8,24
039 Lajen,63,,14,13,27
039 Lajen,64,,9,11,20
039 Lajen,65,,14,8,22
039 Lajen,66,,12,13,25
039 Lajen,67,,16,13,29
039 Lajen,68,,18,17,35
039 Lajen,69,,16,9,25
039 Lajen,70,,14,9,23
039 Lajen,71,,6,16,22
039 Lajen,72,,7,10,17
039 Lajen,73,,7,7,14
039 Lajen,74,,6,7,13
039 Lajen,75,,7,6,13
039 Lajen,76,,5,11,16
039 Lajen,77,,9,4,13
039 Lajen,78,,2,8,10
039 Lajen,79,,6,4,10
039 Lajen,80,,6,6,12
039 Lajen,81,,7,7,14
039 Lajen,82,,6,7,13
039 Lajen,83,,6,6,12
039 Lajen,84,,2,6,8
039 Lajen,85,,1,9,10
039 Lajen,86,,-,7,7
039 Lajen,87,,1,2,3
039 Lajen,88,,2,2,4
039 Lajen,89,,-,2,2
039 Lajen,90,,1,1,2
039 Lajen,91,,-,1,1
039 Lajen,96,,1,-,1
039 Lajen,97,,-,1,1
040 Leifers,0,,90,84,174
040 Leifers,1,,110,90,200
040 Leifers,2,,92,88,180
040 Leifers,3,,85,86,171
040 Leifers,4,,94,74,168
040 Leifers,5,,86,78,164
040 Leifers,6,,97,85,182
040 Leifers,7,,87,89,176
040 Leifers,8,,87,78,165
040 Leifers,9,,98,89,187
040 Leifers,10,,93,89,182
040 Leifers,11,,77,108,185
040 Leifers,12,,110,81,191
040 Leifers,13,,107,85,192
040 Leifers,14,,99,94,193
040 Leifers,15,,94,102,196
040 Leifers,16,,89,75,164
040 Leifers,17,,90,83,173
040 Leifers,18,,97,85,182
040 Leifers,19,,92,89,181
040 Leifers,20,,75,83,158
040 Leifers,21,,82,85,167
040 Leifers,22,,84,81,165
040 Leifers,23,,83,95,178
040 Leifers,24,,90,70,160
040 Leifers,25,,93,86,179
040 Leifers,26,,98,116,214
040 Leifers,27,,110,91,201
040 Leifers,28,,97,80,177
040 Leifers,29,,82,98,180
040 Leifers,30,,105,117,222
040 Leifers,31,,117,95,212
040 Leifers,32,,131,126,257
040 Leifers,33,,135,116,251
040 Leifers,34,,159,143,302
040 Leifers,35,,152,147,299
040 Leifers,36,,158,152,310
040 Leifers,37,,160,155,315
040 Leifers,38,,137,144,281
040 Leifers,39,,164,149,313
040 Leifers,40,,169,138,307
040 Leifers,41,,155,169,324
040 Leifers,42,,151,126,277
040 Leifers,43,,148,148,296
040 Leifers,44,,153,134,287
040 Leifers,45,,169,154,323
040 Leifers,46,,151,134,285
040 Leifers,47,,139,136,275
040 Leifers,48,,141,140,281
040 Leifers,49,,140,118,258
040 Leifers,50,,123,106,229
040 Leifers,51,,93,114,207
040 Leifers,52,,106,113,219
040 Leifers,53,,137,130,267
040 Leifers,54,,109,127,236
040 Leifers,55,,91,111,202
040 Leifers,56,,104,119,223
040 Leifers,57,,105,97,202
040 Leifers,58,,93,97,190
040 Leifers,59,,98,87,185
040 Leifers,60,,93,100,193
040 Leifers,61,,107,101,208
040 Leifers,62,,98,98,196
040 Leifers,63,,111,152,263
040 Leifers,64,,76,80,156
040 Leifers,65,,87,88,175
040 Leifers,66,,88,96,184
040 Leifers,67,,90,93,183
040 Leifers,68,,87,82,169
040 Leifers,69,,91,84,175
040 Leifers,70,,89,93,182
040 Leifers,71,,85,76,161
040 Leifers,72,,53,75,128
040 Leifers,73,,50,63,113
040 Leifers,74,,49,65,114
040 Leifers,75,,57,61,118
040 Leifers,76,,37,61,98
040 Leifers,77,,58,73,131
040 Leifers,78,,45,58,103
040 Leifers,79,,37,54,91
040 Leifers,80,,30,46,76
040 Leifers,81,,35,34,69
040 Leifers,82,,23,49,72
040 Leifers,83,,16,43,59
040 Leifers,84,,18,44,62
040 Leifers,85,,15,33,48
040 Leifers,86,,9,28,37
040 Leifers,87,,14,32,46
040 Leifers,88,,8,23,31
040 Leifers,89,,7,15,22
040 Leifers,90,,3,23,26
040 Leifers,91,,1,4,5
040 Leifers,92,,1,4,5
040 Leifers,93,,1,7,8
040 Leifers,94,,-,12,12
040 Leifers,95,,1,4,5
040 Leifers,96,,1,7,8
040 Leifers,97,,1,6,7
040 Leifers,98,,1,1,2
040 Leifers,99,,-,1,1
041 Lana,0,,62,48,110
041 Lana,1,,73,62,135
041 Lana,2,,71,56,127
041 Lana,3,,64,57,121
041 Lana,4,,76,63,139
041 Lana,5,,79,55,134
041 Lana,6,,63,61,124
041 Lana,7,,57,55,112
041 Lana,8,,72,55,127
041 Lana,9,,73,70,143
041 Lana,10,,72,58,130
041 Lana,11,,63,61,124
041 Lana,12,,60,66,126
041 Lana,13,,72,81,153
041 Lana,14,,69,63,132
041 Lana,15,,69,75,144
041 Lana,16,,61,61,122
041 Lana,17,,61,60,121
041 Lana,18,,62,57,119
041 Lana,19,,54,68,122
041 Lana,20,,48,79,127
041 Lana,21,,59,55,114
041 Lana,22,,75,48,123
041 Lana,23,,62,61,123
041 Lana,24,,57,71,128
041 Lana,25,,63,65,128
041 Lana,26,,80,75,155
041 Lana,27,,80,64,144
041 Lana,28,,57,86,143
041 Lana,29,,63,69,132
041 Lana,30,,67,93,160
041 Lana,31,,89,78,167
041 Lana,32,,76,71,147
041 Lana,33,,78,95,173
041 Lana,34,,62,90,152
041 Lana,35,,96,83,179
041 Lana,36,,81,91,172
041 Lana,37,,105,92,197
041 Lana,38,,96,109,205
041 Lana,39,,97,107,204
041 Lana,40,,122,82,204
041 Lana,41,,88,104,192
041 Lana,42,,93,99,192
041 Lana,43,,95,113,208
041 Lana,44,,97,88,185
041 Lana,45,,105,107,212
041 Lana,46,,107,87,194
041 Lana,47,,88,80,168
041 Lana,48,,84,89,173
041 Lana,49,,76,80,156
041 Lana,50,,82,78,160
041 Lana,51,,80,86,166
041 Lana,52,,74,74,148
041 Lana,53,,57,64,121
041 Lana,54,,64,75,139
041 Lana,55,,60,67,127
041 Lana,56,,57,60,117
041 Lana,57,,52,62,114
041 Lana,58,,53,65,118
041 Lana,59,,50,59,109
041 Lana,60,,54,54,108
041 Lana,61,,58,65,123
041 Lana,62,,59,47,106
041 Lana,63,,61,63,124
041 Lana,64,,39,51,90
041 Lana,65,,50,62,112
041 Lana,66,,57,58,115
041 Lana,67,,50,70,120
041 Lana,68,,48,45,93
041 Lana,69,,42,48,90
041 Lana,70,,50,52,102
041 Lana,71,,39,57,96
041 Lana,72,,34,37,71
041 Lana,73,,37,48,85
041 Lana,74,,34,32,66
041 Lana,75,,32,39,71
041 Lana,76,,25,43,68
041 Lana,77,,27,29,56
041 Lana,78,,22,42,64
041 Lana,79,,23,36,59
041 Lana,80,,16,32,48
041 Lana,81,,25,22,47
041 Lana,82,,23,29,52
041 Lana,83,,18,32,50
041 Lana,84,,16,34,50
041 Lana,85,,4,18,22
041 Lana,86,,12,21,33
041 Lana,87,,15,21,36
041 Lana,88,,9,25,34
041 Lana,89,,8,20,28
041 Lana,90,,3,12,15
041 Lana,91,,4,6,10
041 Lana,92,,3,8,11
041 Lana,93,,1,2,3
041 Lana,94,,1,6,7
041 Lana,95,,4,4,8
041 Lana,96,,-,3,3
041 Lana,97,,-,2,2
041 Lana,98,,-,2,2
041 Lana,99,,-,3,3
041 Lana,105,,-,1,1
042 Laas,0,,18,29,47
042 Laas,1,,22,24,46
042 Laas,2,,31,13,44
042 Laas,3,,19,30,49
042 Laas,4,,35,16,51
042 Laas,5,,23,20,43
042 Laas,6,,24,18,42
042 Laas,7,,27,17,44
042 Laas,8,,18,20,38
042 Laas,9,,25,24,49
042 Laas,10,,17,12,29
042 Laas,11,,26,33,59
042 Laas,12,,27,23,50
042 Laas,13,,30,33,63
042 Laas,14,,32,24,56
042 Laas,15,,23,25,48
042 Laas,16,,23,20,43
042 Laas,17,,17,26,43
042 Laas,18,,22,22,44
042 Laas,19,,19,25,44
042 Laas,20,,20,26,46
042 Laas,21,,21,21,42
042 Laas,22,,32,24,56
042 Laas,23,,32,20,52
042 Laas,24,,31,23,54
042 Laas,25,,30,30,60
042 Laas,26,,20,38,58
042 Laas,27,,34,30,64
042 Laas,28,,28,28,56
042 Laas,29,,20,27,47
042 Laas,30,,30,29,59
042 Laas,31,,26,33,59
042 Laas,32,,24,18,42
042 Laas,33,,30,28,58
042 Laas,34,,28,19,47
042 Laas,35,,44,32,76
042 Laas,36,,34,28,62
042 Laas,37,,29,24,53
042 Laas,38,,25,26,51
042 Laas,39,,38,24,62
042 Laas,40,,32,41,73
042 Laas,41,,37,28,65
042 Laas,42,,32,23,55
042 Laas,43,,33,25,58
042 Laas,44,,35,32,67
042 Laas,45,,29,30,59
042 Laas,46,,28,28,56
042 Laas,47,,35,27,62
042 Laas,48,,25,30,55
042 Laas,49,,37,24,61
042 Laas,50,,33,26,59
042 Laas,51,,26,25,51
042 Laas,52,,18,28,46
042 Laas,53,,23,16,39
042 Laas,54,,16,16,32
042 Laas,55,,16,24,40
042 Laas,56,,22,13,35
042 Laas,57,,28,25,53
042 Laas,58,,13,16,29
042 Laas,59,,20,25,45
042 Laas,60,,18,19,37
042 Laas,61,,16,21,37
042 Laas,62,,26,11,37
042 Laas,63,,13,15,28
042 Laas,64,,14,11,25
042 Laas,65,,12,15,27
042 Laas,66,,13,15,28
042 Laas,67,,16,19,35
042 Laas,68,,14,22,36
042 Laas,69,,17,23,40
042 Laas,70,,12,25,37
042 Laas,71,,18,12,30
042 Laas,72,,11,14,25
042 Laas,73,,19,10,29
042 Laas,74,,18,22,40
042 Laas,75,,11,18,29
042 Laas,76,,16,11,27
042 Laas,77,,11,14,25
042 Laas,78,,13,20,33
042 Laas,79,,13,14,27
042 Laas,80,,11,8,19
042 Laas,81,,12,11,23
042 Laas,82,,10,11,21
042 Laas,83,,11,11,22
042 Laas,84,,4,9,13
042 Laas,85,,5,19,24
042 Laas,86,,7,6,13
042 Laas,87,,3,12,15
042 Laas,88,,2,3,5
042 Laas,89,,3,8,11
042 Laas,90,,2,3,5
042 Laas,91,,3,-,3
042 Laas,93,,1,3,4
042 Laas,94,,-,1,1
042 Laas,95,,-,2,2
042 Laas,96,,-,3,3
042 Laas,97,,-,1,1
042 Laas,98,,-,1,1
042 Laas,99,,1,1,2
043 Laurein,0,,2,3,5
043 Laurein,1,,2,1,3
043 Laurein,2,,1,-,1
043 Laurein,3,,8,-,8
043 Laurein,4,,3,4,7
043 Laurein,5,,3,1,4
043 Laurein,6,,3,3,6
043 Laurein,7,,2,3,5
043 Laurein,8,,7,1,8
043 Laurein,9,,3,7,10
043 Laurein,10,,3,2,5
043 Laurein,11,,4,3,7
043 Laurein,12,,3,6,9
043 Laurein,13,,1,2,3
043 Laurein,14,,2,2,4
043 Laurein,15,,2,4,6
043 Laurein,16,,1,5,6
043 Laurein,17,,1,1,2
043 Laurein,18,,1,1,2
043 Laurein,19,,4,-,4
043 Laurein,20,,3,2,5
043 Laurein,21,,1,-,1
043 Laurein,22,,2,2,4
043 Laurein,23,,4,2,6
043 Laurein,24,,2,2,4
043 Laurein,25,,1,2,3
043 Laurein,27,,2,1,3
043 Laurein,28,,3,-,3
043 Laurein,29,,2,-,2
043 Laurein,30,,2,-,2
043 Laurein,31,,3,5,8
043 Laurein,32,,1,2,3
043 Laurein,33,,5,1,6
043 Laurein,34,,-,4,4
043 Laurein,35,,1,1,2
043 Laurein,36,,5,2,7
043 Laurein,37,,1,2,3
043 Laurein,38,,6,6,12
043 Laurein,39,,4,4,8
043 Laurein,40,,6,3,9
043 Laurein,41,,-,2,2
043 Laurein,42,,4,6,10
043 Laurein,43,,5,3,8
043 Laurein,44,,5,1,6
043 Laurein,45,,4,2,6
043 Laurein,46,,-,2,2
043 Laurein,47,,1,2,3
043 Laurein,48,,5,4,9
043 Laurein,49,,1,1,2
043 Laurein,50,,4,4,8
043 Laurein,51,,2,2,4
043 Laurein,52,,7,-,7
043 Laurein,54,,2,-,2
043 Laurein,55,,3,1,4
043 Laurein,56,,2,1,3
043 Laurein,57,,2,-,2
043 Laurein,59,,1,1,2
043 Laurein,60,,2,2,4
043 Laurein,61,,2,-,2
043 Laurein,62,,2,3,5
043 Laurein,63,,-,1,1
043 Laurein,64,,-,1,1
043 Laurein,65,,-,1,1
043 Laurein,66,,1,-,1
043 Laurein,67,,1,-,1
043 Laurein,69,,2,2,4
043 Laurein,70,,1,3,4
043 Laurein,71,,1,1,2
043 Laurein,72,,2,1,3
043 Laurein,73,,1,2,3
043 Laurein,74,,1,3,4
043 Laurein,75,,1,5,6
043 Laurein,76,,1,2,3
043 Laurein,77,,2,2,4
043 Laurein,78,,-,3,3
043 Laurein,79,,-,5,5
043 Laurein,80,,3,-,3
043 Laurein,81,,5,-,5
043 Laurein,82,,3,1,4
043 Laurein,83,,1,1,2
043 Laurein,84,,1,1,2
043 Laurein,85,,-,1,1
043 Laurein,87,,-,1,1
043 Laurein,88,,-,1,1
043 Laurein,89,,1,1,2
043 Laurein,96,,-,1,1
044 Lüsen,0,,9,9,18
044 Lüsen,1,,8,10,18
044 Lüsen,2,,12,11,23
044 Lüsen,3,,10,14,24
044 Lüsen,4,,9,10,19
044 Lüsen,5,,10,11,21
044 Lüsen,6,,12,8,20
044 Lüsen,7,,11,8,19
044 Lüsen,8,,10,10,20
044 Lüsen,9,,15,10,25
044 Lüsen,10,,5,10,15
044 Lüsen,11,,11,11,22
044 Lüsen,12,,16,6,22
044 Lüsen,13,,8,13,21
044 Lüsen,14,,10,12,22
044 Lüsen,15,,14,13,27
044 Lüsen,16,,9,8,17
044 Lüsen,17,,12,9,21
044 Lüsen,18,,9,9,18
044 Lüsen,19,,6,12,18
044 Lüsen,20,,15,8,23
044 Lüsen,21,,8,11,19
044 Lüsen,22,,6,9,15
044 Lüsen,23,,11,10,21
044 Lüsen,24,,4,2,6
044 Lüsen,25,,8,16,24
044 Lüsen,26,,6,7,13
044 Lüsen,27,,13,13,26
044 Lüsen,28,,11,14,25
044 Lüsen,29,,12,10,22
044 Lüsen,30,,8,7,15
044 Lüsen,31,,14,17,31
044 Lüsen,32,,8,13,21
044 Lüsen,33,,16,12,28
044 Lüsen,34,,13,13,26
044 Lüsen,35,,15,15,30
044 Lüsen,36,,9,7,16
044 Lüsen,37,,9,10,19
044 Lüsen,38,,17,9,26
044 Lüsen,39,,18,14,32
044 Lüsen,40,,9,9,18
044 Lüsen,41,,14,16,30
044 Lüsen,42,,10,19,29
044 Lüsen,43,,16,13,29
044 Lüsen,44,,18,13,31
044 Lüsen,45,,14,9,23
044 Lüsen,46,,15,12,27
044 Lüsen,47,,8,11,19
044 Lüsen,48,,12,10,22
044 Lüsen,49,,8,12,20
044 Lüsen,50,,8,6,14
044 Lüsen,51,,11,11,22
044 Lüsen,52,,10,10,20
044 Lüsen,53,,9,10,19
044 Lüsen,54,,6,6,12
044 Lüsen,55,,11,5,16
044 Lüsen,56,,6,10,16
044 Lüsen,57,,11,4,15
044 Lüsen,58,,5,7,12
044 Lüsen,59,,6,7,13
044 Lüsen,60,,8,10,18
044 Lüsen,61,,7,1,8
044 Lüsen,62,,5,5,10
044 Lüsen,63,,10,6,16
044 Lüsen,64,,3,9,12
044 Lüsen,65,,5,4,9
044 Lüsen,66,,8,7,15
044 Lüsen,67,,2,6,8
044 Lüsen,68,,6,3,9
044 Lüsen,69,,4,10,14
044 Lüsen,70,,8,7,15
044 Lüsen,71,,6,5,11
044 Lüsen,72,,7,5,12
044 Lüsen,73,,6,9,15
044 Lüsen,74,,5,4,9
044 Lüsen,75,,3,4,7
044 Lüsen,76,,7,3,10
044 Lüsen,77,,2,10,12
044 Lüsen,78,,6,5,11
044 Lüsen,79,,3,5,8
044 Lüsen,80,,2,5,7
044 Lüsen,81,,3,5,8
044 Lüsen,82,,3,4,7
044 Lüsen,83,,2,5,7
044 Lüsen,84,,1,3,4
044 Lüsen,85,,1,2,3
044 Lüsen,86,,1,4,5
044 Lüsen,87,,1,2,3
044 Lüsen,88,,1,5,6
044 Lüsen,89,,-,2,2
044 Lüsen,92,,-,1,1
044 Lüsen,93,,-,1,1
044 Lüsen,96,,-,1,1
045 Margreid a.d. Weinstr.,0,,7,2,9
045 Margreid a.d. Weinstr.,1,,9,10,19
045 Margreid a.d. Weinstr.,2,,6,2,8
045 Margreid a.d. Weinstr.,3,,7,5,12
045 Margreid a.d. Weinstr.,4,,8,9,17
045 Margreid a.d. Weinstr.,5,,10,8,18
045 Margreid a.d. Weinstr.,6,,3,4,7
045 Margreid a.d. Weinstr.,7,,11,7,18
045 Margreid a.d. Weinstr.,8,,12,9,21
045 Margreid a.d. Weinstr.,9,,7,8,15
045 Margreid a.d. Weinstr.,10,,7,9,16
045 Margreid a.d. Weinstr.,11,,2,11,13
045 Margreid a.d. Weinstr.,12,,10,14,24
045 Margreid a.d. Weinstr.,13,,5,2,7
045 Margreid a.d. Weinstr.,14,,2,6,8
045 Margreid a.d. Weinstr.,15,,6,7,13
045 Margreid a.d. Weinstr.,16,,4,12,16
045 Margreid a.d. Weinstr.,17,,2,3,5
045 Margreid a.d. Weinstr.,18,,5,5,10
045 Margreid a.d. Weinstr.,19,,8,9,17
045 Margreid a.d. Weinstr.,20,,8,6,14
045 Margreid a.d. Weinstr.,21,,8,7,15
045 Margreid a.d. Weinstr.,22,,9,5,14
045 Margreid a.d. Weinstr.,23,,6,9,15
045 Margreid a.d. Weinstr.,24,,13,1,14
045 Margreid a.d. Weinstr.,25,,8,12,20
045 Margreid a.d. Weinstr.,26,,6,11,17
045 Margreid a.d. Weinstr.,27,,14,14,28
045 Margreid a.d. Weinstr.,28,,17,7,24
045 Margreid a.d. Weinstr.,29,,3,8,11
045 Margreid a.d. Weinstr.,30,,14,7,21
045 Margreid a.d. Weinstr.,31,,10,10,20
045 Margreid a.d. Weinstr.,32,,9,9,18
045 Margreid a.d. Weinstr.,33,,14,17,31
045 Margreid a.d. Weinstr.,34,,10,7,17
045 Margreid a.d. Weinstr.,35,,9,6,15
045 Margreid a.d. Weinstr.,36,,9,10,19
045 Margreid a.d. Weinstr.,37,,5,5,10
045 Margreid a.d. Weinstr.,38,,9,14,23
045 Margreid a.d. Weinstr.,39,,9,10,19
045 Margreid a.d. Weinstr.,40,,9,9,18
045 Margreid a.d. Weinstr.,41,,24,17,41
045 Margreid a.d. Weinstr.,42,,12,17,29
045 Margreid a.d. Weinstr.,43,,22,10,32
045 Margreid a.d. Weinstr.,44,,12,6,18
045 Margreid a.d. Weinstr.,45,,8,6,14
045 Margreid a.d. Weinstr.,46,,11,11,22
045 Margreid a.d. Weinstr.,47,,8,17,25
045 Margreid a.d. Weinstr.,48,,15,14,29
045 Margreid a.d. Weinstr.,49,,15,12,27
045 Margreid a.d. Weinstr.,50,,9,12,21
045 Margreid a.d. Weinstr.,51,,5,9,14
045 Margreid a.d. Weinstr.,52,,8,6,14
045 Margreid a.d. Weinstr.,53,,16,7,23
045 Margreid a.d. Weinstr.,54,,9,8,17
045 Margreid a.d. Weinstr.,55,,4,5,9
045 Margreid a.d. Weinstr.,56,,7,8,15
045 Margreid a.d. Weinstr.,57,,5,9,14
045 Margreid a.d. Weinstr.,58,,5,8,13
045 Margreid a.d. Weinstr.,59,,7,6,13
045 Margreid a.d. Weinstr.,60,,7,3,10
045 Margreid a.d. Weinstr.,61,,5,9,14
045 Margreid a.d. Weinstr.,62,,7,7,14
045 Margreid a.d. Weinstr.,63,,2,3,5
045 Margreid a.d. Weinstr.,64,,6,7,13
045 Margreid a.d. Weinstr.,65,,3,6,9
045 Margreid a.d. Weinstr.,66,,6,3,9
045 Margreid a.d. Weinstr.,67,,10,4,14
045 Margreid a.d. Weinstr.,68,,7,5,12
045 Margreid a.d. Weinstr.,69,,5,3,8
045 Margreid a.d. Weinstr.,70,,3,7,10
045 Margreid a.d. Weinstr.,71,,4,9,13
045 Margreid a.d. Weinstr.,72,,5,3,8
045 Margreid a.d. Weinstr.,73,,6,4,10
045 Margreid a.d. Weinstr.,74,,1,6,7
045 Margreid a.d. Weinstr.,75,,5,4,9
045 Margreid a.d. Weinstr.,76,,3,4,7
045 Margreid a.d. Weinstr.,77,,5,5,10
045 Margreid a.d. Weinstr.,78,,3,5,8
045 Margreid a.d. Weinstr.,79,,6,2,8
045 Margreid a.d. Weinstr.,80,,1,4,5
045 Margreid a.d. Weinstr.,81,,4,2,6
045 Margreid a.d. Weinstr.,82,,1,3,4
045 Margreid a.d. Weinstr.,83,,2,7,9
045 Margreid a.d. Weinstr.,84,,3,2,5
045 Margreid a.d. Weinstr.,85,,1,4,5
045 Margreid a.d. Weinstr.,86,,1,3,4
045 Margreid a.d. Weinstr.,87,,1,1,2
045 Margreid a.d. Weinstr.,88,,-,1,1
045 Margreid a.d. Weinstr.,89,,-,1,1
045 Margreid a.d. Weinstr.,90,,1,4,5
045 Margreid a.d. Weinstr.,91,,1,-,1
045 Margreid a.d. Weinstr.,93,,1,2,3
046 Mals,0,,29,11,40
046 Mals,1,,26,21,47
046 Mals,2,,23,30,53
046 Mals,3,,35,38,73
046 Mals,4,,28,32,60
046 Mals,5,,29,24,53
046 Mals,6,,32,19,51
046 Mals,7,,22,27,49
046 Mals,8,,30,29,59
046 Mals,9,,31,36,67
046 Mals,10,,42,30,72
046 Mals,11,,35,33,68
046 Mals,12,,31,32,63
046 Mals,13,,35,25,60
046 Mals,14,,35,42,77
046 Mals,15,,38,31,69
046 Mals,16,,37,33,70
046 Mals,17,,31,34,65
046 Mals,18,,34,34,68
046 Mals,19,,34,28,62
046 Mals,20,,39,36,75
046 Mals,21,,35,25,60
046 Mals,22,,30,28,58
046 Mals,23,,29,38,67
046 Mals,24,,34,34,68
046 Mals,25,,38,34,72
046 Mals,26,,30,26,56
046 Mals,27,,38,29,67
046 Mals,28,,36,37,73
046 Mals,29,,42,32,74
046 Mals,30,,32,31,63
046 Mals,31,,45,31,76
046 Mals,32,,34,32,66
046 Mals,33,,34,29,63
046 Mals,34,,40,31,71
046 Mals,35,,47,26,73
046 Mals,36,,33,39,72
046 Mals,37,,30,51,81
046 Mals,38,,37,47,84
046 Mals,39,,42,48,90
046 Mals,40,,44,44,88
046 Mals,41,,55,39,94
046 Mals,42,,49,31,80
046 Mals,43,,55,54,109
046 Mals,44,,51,40,91
046 Mals,45,,49,42,91
046 Mals,46,,49,54,103
046 Mals,47,,36,28,64
046 Mals,48,,48,36,84
046 Mals,49,,35,40,75
046 Mals,50,,34,33,67
046 Mals,51,,33,23,56
046 Mals,52,,37,34,71
046 Mals,53,,33,27,60
046 Mals,54,,30,23,53
046 Mals,55,,20,21,41
046 Mals,56,,33,30,63
046 Mals,57,,28,22,50
046 Mals,58,,31,22,53
046 Mals,59,,33,21,54
046 Mals,60,,18,23,41
046 Mals,61,,26,14,40
046 Mals,62,,22,20,42
046 Mals,63,,21,29,50
046 Mals,64,,9,20,29
046 Mals,65,,28,14,42
046 Mals,66,,24,19,43
046 Mals,67,,22,23,45
046 Mals,68,,16,17,33
046 Mals,69,,19,28,47
046 Mals,70,,23,27,50
046 Mals,71,,18,21,39
046 Mals,72,,10,27,37
046 Mals,73,,19,18,37
046 Mals,74,,13,18,31
046 Mals,75,,11,17,28
046 Mals,76,,11,21,32
046 Mals,77,,15,11,26
046 Mals,78,,10,16,26
046 Mals,79,,20,14,34
046 Mals,80,,14,13,27
046 Mals,81,,15,12,27
046 Mals,82,,8,13,21
046 Mals,83,,5,16,21
046 Mals,84,,5,15,20
046 Mals,85,,6,9,15
046 Mals,86,,1,9,10
046 Mals,87,,8,11,19
046 Mals,88,,6,9,15
046 Mals,89,,2,10,12
046 Mals,90,,1,14,15
046 Mals,91,,1,1,2
046 Mals,92,,3,2,5
046 Mals,94,,1,2,3
046 Mals,95,,1,1,2
046 Mals,96,,1,3,4
046 Mals,99,,-,1,1
046 Mals,100,,-,1,1
047 Enneberg,0,,17,15,32
047 Enneberg,1,,16,19,35
047 Enneberg,2,,15,16,31
047 Enneberg,3,,23,19,42
047 Enneberg,4,,22,16,38
047 Enneberg,5,,14,16,30
047 Enneberg,6,,21,27,48
047 Enneberg,7,,19,13,32
047 Enneberg,8,,27,17,44
047 Enneberg,9,,18,20,38
047 Enneberg,10,,27,17,44
047 Enneberg,11,,18,10,28
047 Enneberg,12,,23,16,39
047 Enneberg,13,,17,13,30
047 Enneberg,14,,21,8,29
047 Enneberg,15,,21,15,36
047 Enneberg,16,,20,17,37
047 Enneberg,17,,15,15,30
047 Enneberg,18,,18,22,40
047 Enneberg,19,,15,18,33
047 Enneberg,20,,22,17,39
047 Enneberg,21,,20,15,35
047 Enneberg,22,,18,13,31
047 Enneberg,23,,19,12,31
047 Enneberg,24,,24,19,43
047 Enneberg,25,,21,18,39
047 Enneberg,26,,15,17,32
047 Enneberg,27,,25,18,43
047 Enneberg,28,,23,26,49
047 Enneberg,29,,24,18,42
047 Enneberg,30,,11,18,29
047 Enneberg,31,,18,23,41
047 Enneberg,32,,22,17,39
047 Enneberg,33,,15,20,35
047 Enneberg,34,,14,30,44
047 Enneberg,35,,29,32,61
047 Enneberg,36,,22,22,44
047 Enneberg,37,,22,27,49
047 Enneberg,38,,29,35,64
047 Enneberg,39,,28,20,48
047 Enneberg,40,,29,21,50
047 Enneberg,41,,22,21,43
047 Enneberg,42,,25,19,44
047 Enneberg,43,,18,22,40
047 Enneberg,44,,28,21,49
047 Enneberg,45,,24,22,46
047 Enneberg,46,,22,19,41
047 Enneberg,47,,18,17,35
047 Enneberg,48,,20,16,36
047 Enneberg,49,,15,17,32
047 Enneberg,50,,23,14,37
047 Enneberg,51,,20,11,31
047 Enneberg,52,,16,15,31
047 Enneberg,53,,15,19,34
047 Enneberg,54,,13,13,26
047 Enneberg,55,,14,11,25
047 Enneberg,56,,18,20,38
047 Enneberg,57,,14,16,30
047 Enneberg,58,,17,10,27
047 Enneberg,59,,11,15,26
047 Enneberg,60,,19,8,27
047 Enneberg,61,,16,13,29
047 Enneberg,62,,9,13,22
047 Enneberg,63,,13,17,30
047 Enneberg,64,,5,12,17
047 Enneberg,65,,19,17,36
047 Enneberg,66,,16,10,26
047 Enneberg,67,,11,20,31
047 Enneberg,68,,13,11,24
047 Enneberg,69,,10,7,17
047 Enneberg,70,,15,9,24
047 Enneberg,71,,12,19,31
047 Enneberg,72,,14,12,26
047 Enneberg,73,,10,12,22
047 Enneberg,74,,11,15,26
047 Enneberg,75,,8,10,18
047 Enneberg,76,,10,8,18
047 Enneberg,77,,7,17,24
047 Enneberg,78,,9,9,18
047 Enneberg,79,,12,13,25
047 Enneberg,80,,5,7,12
047 Enneberg,81,,7,11,18
047 Enneberg,82,,5,5,10
047 Enneberg,83,,5,8,13
047 Enneberg,84,,9,8,17
047 Enneberg,85,,2,5,7
047 Enneberg,86,,1,8,9
047 Enneberg,87,,6,5,11
047 Enneberg,88,,1,5,6
047 Enneberg,89,,5,2,7
047 Enneberg,90,,-,2,2
047 Enneberg,91,,1,4,5
047 Enneberg,92,,-,2,2
047 Enneberg,93,,1,5,6
047 Enneberg,94,,-,2,2
047 Enneberg,95,,1,3,4
048 Marling,0,,14,7,21
048 Marling,1,,10,10,20
048 Marling,2,,16,12,28
048 Marling,3,,11,17,28
048 Marling,4,,25,15,40
048 Marling,5,,14,14,28
048 Marling,6,,11,9,20
048 Marling,7,,16,15,31
048 Marling,8,,9,16,25
048 Marling,9,,15,14,29
048 Marling,10,,14,8,22
048 Marling,11,,11,11,22
048 Marling,12,,13,9,22
048 Marling,13,,12,14,26
048 Marling,14,,19,12,31
048 Marling,15,,10,8,18
048 Marling,16,,17,8,25
048 Marling,17,,16,14,30
048 Marling,18,,11,15,26
048 Marling,19,,11,20,31
048 Marling,20,,11,17,28
048 Marling,21,,15,13,28
048 Marling,22,,7,15,22
048 Marling,23,,14,13,27
048 Marling,24,,11,19,30
048 Marling,25,,16,9,25
048 Marling,26,,14,16,30
048 Marling,27,,18,14,32
048 Marling,28,,17,12,29
048 Marling,29,,18,12,30
048 Marling,30,,19,26,45
048 Marling,31,,21,17,38
048 Marling,32,,15,15,30
048 Marling,33,,17,29,46
048 Marling,34,,23,13,36
048 Marling,35,,15,10,25
048 Marling,36,,16,23,39
048 Marling,37,,16,19,35
048 Marling,38,,23,16,39
048 Marling,39,,20,21,41
048 Marling,40,,22,18,40
048 Marling,41,,28,21,49
048 Marling,42,,18,17,35
048 Marling,43,,24,28,52
048 Marling,44,,25,19,44
048 Marling,45,,29,21,50
048 Marling,46,,26,30,56
048 Marling,47,,21,20,41
048 Marling,48,,24,13,37
048 Marling,49,,17,20,37
048 Marling,50,,19,17,36
048 Marling,51,,18,14,32
048 Marling,52,,15,9,24
048 Marling,53,,11,13,24
048 Marling,54,,12,9,21
048 Marling,55,,16,13,29
048 Marling,56,,14,16,30
048 Marling,57,,16,17,33
048 Marling,58,,7,16,23
048 Marling,59,,14,14,28
048 Marling,60,,19,18,37
048 Marling,61,,5,14,19
048 Marling,62,,16,12,28
048 Marling,63,,12,15,27
048 Marling,64,,21,14,35
048 Marling,65,,16,16,32
048 Marling,66,,9,17,26
048 Marling,67,,10,11,21
048 Marling,68,,19,18,37
048 Marling,69,,12,12,24
048 Marling,70,,14,16,30
048 Marling,71,,8,13,21
048 Marling,72,,11,16,27
048 Marling,73,,16,8,24
048 Marling,74,,3,16,19
048 Marling,75,,11,8,19
048 Marling,76,,7,13,20
048 Marling,77,,8,10,18
048 Marling,78,,8,7,15
048 Marling,79,,3,8,11
048 Marling,80,,7,5,12
048 Marling,81,,7,2,9
048 Marling,82,,8,7,15
048 Marling,83,,1,8,9
048 Marling,84,,1,11,12
048 Marling,85,,-,5,5
048 Marling,86,,3,6,9
048 Marling,87,,1,3,4
048 Marling,88,,3,4,7
048 Marling,89,,-,1,1
048 Marling,90,,2,2,4
048 Marling,91,,1,1,2
048 Marling,93,,-,1,1
048 Marling,94,,1,1,2
048 Marling,95,,2,1,3
048 Marling,96,,-,2,2
048 Marling,97,,1,-,1
049 Martell,0,,3,4,7
049 Martell,1,,6,1,7
049 Martell,2,,7,-,7
049 Martell,3,,5,5,10
049 Martell,4,,7,2,9
049 Martell,5,,7,2,9
049 Martell,6,,5,5,10
049 Martell,7,,3,5,8
049 Martell,8,,4,7,11
049 Martell,9,,6,4,10
049 Martell,10,,3,7,10
049 Martell,11,,6,7,13
049 Martell,12,,4,9,13
049 Martell,13,,4,6,10
049 Martell,14,,6,8,14
049 Martell,15,,5,8,13
049 Martell,16,,6,5,11
049 Martell,17,,4,6,10
049 Martell,18,,7,5,12
049 Martell,19,,6,5,11
049 Martell,20,,9,4,13
049 Martell,21,,4,1,5
049 Martell,22,,7,4,11
049 Martell,23,,-,3,3
049 Martell,24,,4,6,10
049 Martell,25,,5,1,6
049 Martell,26,,6,5,11
049 Martell,27,,5,8,13
049 Martell,28,,7,5,12
049 Martell,29,,9,4,13
049 Martell,30,,8,7,15
049 Martell,31,,3,4,7
049 Martell,32,,7,5,12
049 Martell,33,,4,5,9
049 Martell,34,,1,7,8
049 Martell,35,,7,9,16
049 Martell,36,,9,5,14
049 Martell,37,,5,8,13
049 Martell,38,,9,5,14
049 Martell,39,,7,3,10
049 Martell,40,,6,13,19
049 Martell,41,,9,6,15
049 Martell,42,,5,7,12
049 Martell,43,,15,7,22
049 Martell,44,,17,11,28
049 Martell,45,,7,9,16
049 Martell,46,,13,1,14
049 Martell,47,,10,8,18
049 Martell,48,,7,5,12
049 Martell,49,,9,3,12
049 Martell,50,,8,6,14
049 Martell,51,,8,6,14
049 Martell,52,,7,3,10
049 Martell,53,,5,3,8
049 Martell,54,,7,2,9
049 Martell,55,,5,5,10
049 Martell,56,,4,4,8
049 Martell,57,,3,3,6
049 Martell,58,,6,7,13
049 Martell,59,,2,4,6
049 Martell,60,,3,1,4
049 Martell,61,,5,4,9
049 Martell,62,,3,3,6
049 Martell,63,,3,-,3
049 Martell,64,,4,1,5
049 Martell,65,,1,3,4
049 Martell,66,,3,4,7
049 Martell,67,,6,5,11
049 Martell,68,,3,4,7
049 Martell,69,,6,2,8
049 Martell,70,,2,4,6
049 Martell,71,,2,6,8
049 Martell,72,,2,4,6
049 Martell,73,,3,4,7
049 Martell,74,,4,8,12
049 Martell,75,,7,1,8
049 Martell,76,,4,6,10
049 Martell,77,,2,3,5
049 Martell,78,,4,-,4
049 Martell,79,,5,4,9
049 Martell,80,,3,3,6
049 Martell,81,,2,2,4
049 Martell,82,,2,3,5
049 Martell,83,,-,8,8
049 Martell,84,,2,1,3
049 Martell,85,,2,5,7
049 Martell,86,,-,6,6
049 Martell,87,,1,1,2
049 Martell,91,,1,1,2
049 Martell,94,,-,1,1
049 Martell,95,,-,1,1
049 Martell,98,,1,-,1
050 Mölten,0,,15,11,26
050 Mölten,1,,10,14,24
050 Mölten,2,,14,12,26
050 Mölten,3,,11,8,19
050 Mölten,4,,9,11,20
050 Mölten,5,,12,10,22
050 Mölten,6,,10,9,19
050 Mölten,7,,15,12,27
050 Mölten,8,,16,17,33
050 Mölten,9,,14,15,29
050 Mölten,10,,12,18,30
050 Mölten,11,,8,16,24
050 Mölten,12,,10,7,17
050 Mölten,13,,16,13,29
050 Mölten,14,,11,10,21
050 Mölten,15,,13,5,18
050 Mölten,16,,12,11,23
050 Mölten,17,,6,12,18
050 Mölten,18,,10,6,16
050 Mölten,19,,12,6,18
050 Mölten,20,,13,5,18
050 Mölten,21,,7,9,16
050 Mölten,22,,9,8,17
050 Mölten,23,,11,6,17
050 Mölten,24,,7,12,19
050 Mölten,25,,7,3,10
050 Mölten,26,,5,11,16
050 Mölten,27,,10,10,20
050 Mölten,28,,12,14,26
050 Mölten,29,,16,8,24
050 Mölten,30,,13,12,25
050 Mölten,31,,12,8,20
050 Mölten,32,,10,12,22
050 Mölten,33,,12,19,31
050 Mölten,34,,21,13,34
050 Mölten,35,,12,11,23
050 Mölten,36,,15,16,31
050 Mölten,37,,10,10,20
050 Mölten,38,,18,14,32
050 Mölten,39,,15,11,26
050 Mölten,40,,16,14,30
050 Mölten,41,,15,17,32
050 Mölten,42,,18,15,33
050 Mölten,43,,15,13,28
050 Mölten,44,,10,17,27
050 Mölten,45,,20,15,35
050 Mölten,46,,20,6,26
050 Mölten,47,,14,9,23
050 Mölten,48,,16,10,26
050 Mölten,49,,10,9,19
050 Mölten,50,,14,5,19
050 Mölten,51,,2,10,12
050 Mölten,52,,7,3,10
050 Mölten,53,,5,9,14
050 Mölten,54,,12,7,19
050 Mölten,55,,6,7,13
050 Mölten,56,,7,6,13
050 Mölten,57,,8,6,14
050 Mölten,58,,5,6,11
050 Mölten,59,,10,9,19
050 Mölten,60,,8,6,14
050 Mölten,61,,6,4,10
050 Mölten,62,,3,7,10
050 Mölten,63,,8,3,11
050 Mölten,64,,6,5,11
050 Mölten,65,,2,6,8
050 Mölten,66,,13,8,21
050 Mölten,67,,6,10,16
050 Mölten,68,,9,4,13
050 Mölten,69,,5,7,12
050 Mölten,70,,5,6,11
050 Mölten,71,,2,3,5
050 Mölten,72,,4,7,11
050 Mölten,73,,2,4,6
050 Mölten,74,,8,6,14
050 Mölten,75,,8,5,13
050 Mölten,76,,7,8,15
050 Mölten,77,,3,5,8
050 Mölten,78,,8,2,10
050 Mölten,79,,6,2,8
050 Mölten,80,,1,6,7
050 Mölten,81,,1,4,5
050 Mölten,82,,2,3,5
050 Mölten,83,,2,4,6
050 Mölten,84,,2,4,6
050 Mölten,85,,1,1,2
050 Mölten,86,,5,3,8
050 Mölten,87,,1,2,3
050 Mölten,88,,-,2,2
050 Mölten,89,,-,5,5
050 Mölten,90,,-,4,4
050 Mölten,94,,-,1,1
050 Mölten,95,,-,1,1
051 Meran,0,,175,166,341
051 Meran,1,,185,161,346
051 Meran,2,,217,177,394
051 Meran,3,,196,202,398
051 Meran,4,,182,162,344
051 Meran,5,,224,169,393
051 Meran,6,,182,170,352
051 Meran,7,,185,158,343
051 Meran,8,,191,184,375
051 Meran,9,,189,161,350
051 Meran,10,,181,192,373
051 Meran,11,,163,152,315
051 Meran,12,,198,170,368
051 Meran,13,,204,164,368
051 Meran,14,,170,160,330
051 Meran,15,,175,190,365
051 Meran,16,,146,160,306
051 Meran,17,,178,152,330
051 Meran,18,,167,195,362
051 Meran,19,,178,158,336
051 Meran,20,,199,166,365
051 Meran,21,,183,143,326
051 Meran,22,,192,163,355
051 Meran,23,,180,155,335
051 Meran,24,,166,224,390
051 Meran,25,,201,191,392
051 Meran,26,,192,216,408
051 Meran,27,,203,221,424
051 Meran,28,,241,221,462
051 Meran,29,,242,198,440
051 Meran,30,,210,202,412
051 Meran,31,,246,224,470
051 Meran,32,,231,258,489
051 Meran,33,,226,271,497
051 Meran,34,,254,283,537
051 Meran,35,,269,309,578
051 Meran,36,,275,292,567
051 Meran,37,,309,299,608
051 Meran,38,,307,290,597
051 Meran,39,,316,313,629
051 Meran,40,,330,328,658
051 Meran,41,,352,340,692
051 Meran,42,,349,344,693
051 Meran,43,,319,300,619
051 Meran,44,,335,333,668
051 Meran,45,,348,303,651
051 Meran,46,,340,289,629
051 Meran,47,,279,298,577
051 Meran,48,,299,301,600
051 Meran,49,,300,275,575
051 Meran,50,,283,252,535
051 Meran,51,,257,245,502
051 Meran,52,,232,261,493
051 Meran,53,,226,229,455
051 Meran,54,,202,226,428
051 Meran,55,,185,231,416
051 Meran,56,,175,234,409
051 Meran,57,,206,225,431
051 Meran,58,,204,213,417
051 Meran,59,,189,226,415
051 Meran,60,,223,246,469
051 Meran,61,,212,260,472
051 Meran,62,,220,283,503
051 Meran,63,,243,293,536
051 Meran,64,,200,211,411
051 Meran,65,,202,228,430
051 Meran,66,,252,240,492
051 Meran,67,,252,298,550
051 Meran,68,,225,280,505
051 Meran,69,,186,226,412
051 Meran,70,,183,247,430
051 Meran,71,,170,223,393
051 Meran,72,,174,222,396
051 Meran,73,,156,198,354
051 Meran,74,,151,199,350
051 Meran,75,,142,175,317
051 Meran,76,,137,166,303
051 Meran,77,,121,181,302
051 Meran,78,,101,161,262
051 Meran,79,,112,179,291
051 Meran,80,,89,132,221
051 Meran,81,,83,161,244
051 Meran,82,,85,130,215
051 Meran,83,,74,153,227
051 Meran,84,,51,139,190
051 Meran,85,,64,125,189
051 Meran,86,,45,121,166
051 Meran,87,,51,121,172
051 Meran,88,,27,119,146
051 Meran,89,,33,94,127
051 Meran,90,,25,58,83
051 Meran,91,,5,41,46
051 Meran,92,,12,35,47
051 Meran,93,,10,21,31
051 Meran,94,,8,28,36
051 Meran,95,,10,30,40
051 Meran,96,,4,17,21
051 Meran,97,,4,18,22
051 Meran,98,,2,5,7
051 Meran,99,,2,7,9
051 Meran,100,,-,8,8
051 Meran,101,,1,5,6
051 Meran,102,,-,1,1
051 Meran,103,,-,2,2
052 Welsberg-Taisten,0,,14,16,30
052 Welsberg-Taisten,1,,24,20,44
052 Welsberg-Taisten,2,,22,21,43
052 Welsberg-Taisten,3,,11,27,38
052 Welsberg-Taisten,4,,22,25,47
052 Welsberg-Taisten,5,,13,20,33
052 Welsberg-Taisten,6,,18,16,34
052 Welsberg-Taisten,7,,21,22,43
052 Welsberg-Taisten,8,,32,19,51
052 Welsberg-Taisten,9,,19,15,34
052 Welsberg-Taisten,10,,19,22,41
052 Welsberg-Taisten,11,,23,12,35
052 Welsberg-Taisten,12,,19,19,38
052 Welsberg-Taisten,13,,15,17,32
052 Welsberg-Taisten,14,,19,15,34
052 Welsberg-Taisten,15,,13,16,29
052 Welsberg-Taisten,16,,15,22,37
052 Welsberg-Taisten,17,,9,10,19
052 Welsberg-Taisten,18,,21,18,39
052 Welsberg-Taisten,19,,10,19,29
052 Welsberg-Taisten,20,,5,19,24
052 Welsberg-Taisten,21,,12,19,31
052 Welsberg-Taisten,22,,13,14,27
052 Welsberg-Taisten,23,,13,10,23
052 Welsberg-Taisten,24,,8,18,26
052 Welsberg-Taisten,25,,28,15,43
052 Welsberg-Taisten,26,,24,21,45
052 Welsberg-Taisten,27,,16,19,35
052 Welsberg-Taisten,28,,11,16,27
052 Welsberg-Taisten,29,,17,19,36
052 Welsberg-Taisten,30,,26,20,46
052 Welsberg-Taisten,31,,18,19,37
052 Welsberg-Taisten,32,,14,26,40
052 Welsberg-Taisten,33,,19,11,30
052 Welsberg-Taisten,34,,16,23,39
052 Welsberg-Taisten,35,,27,22,49
052 Welsberg-Taisten,36,,27,11,38
052 Welsberg-Taisten,37,,17,30,47
052 Welsberg-Taisten,38,,32,21,53
052 Welsberg-Taisten,39,,28,22,50
052 Welsberg-Taisten,40,,23,22,45
052 Welsberg-Taisten,41,,29,20,49
052 Welsberg-Taisten,42,,30,22,52
052 Welsberg-Taisten,43,,32,21,53
052 Welsberg-Taisten,44,,21,17,38
052 Welsberg-Taisten,45,,36,20,56
052 Welsberg-Taisten,46,,28,24,52
052 Welsberg-Taisten,47,,19,22,41
052 Welsberg-Taisten,48,,17,15,32
052 Welsberg-Taisten,49,,11,16,27
052 Welsberg-Taisten,50,,19,21,40
052 Welsberg-Taisten,51,,26,17,43
052 Welsberg-Taisten,52,,12,19,31
052 Welsberg-Taisten,53,,19,19,38
052 Welsberg-Taisten,54,,16,11,27
052 Welsberg-Taisten,55,,15,14,29
052 Welsberg-Taisten,56,,19,13,32
052 Welsberg-Taisten,57,,17,11,28
052 Welsberg-Taisten,58,,19,11,30
052 Welsberg-Taisten,59,,16,14,30
052 Welsberg-Taisten,60,,15,11,26
052 Welsberg-Taisten,61,,16,17,33
052 Welsberg-Taisten,62,,10,11,21
052 Welsberg-Taisten,63,,13,14,27
052 Welsberg-Taisten,64,,10,13,23
052 Welsberg-Taisten,65,,14,11,25
052 Welsberg-Taisten,66,,10,15,25
052 Welsberg-Taisten,67,,11,14,25
052 Welsberg-Taisten,68,,17,16,33
052 Welsberg-Taisten,69,,6,12,18
052 Welsberg-Taisten,70,,11,11,22
052 Welsberg-Taisten,71,,11,12,23
052 Welsberg-Taisten,72,,8,8,16
052 Welsberg-Taisten,73,,10,10,20
052 Welsberg-Taisten,74,,3,16,19
052 Welsberg-Taisten,75,,17,16,33
052 Welsberg-Taisten,76,,9,10,19
052 Welsberg-Taisten,77,,10,10,20
052 Welsberg-Taisten,78,,6,12,18
052 Welsberg-Taisten,79,,8,7,15
052 Welsberg-Taisten,80,,6,10,16
052 Welsberg-Taisten,81,,5,15,20
052 Welsberg-Taisten,82,,2,11,13
052 Welsberg-Taisten,83,,6,5,11
052 Welsberg-Taisten,84,,-,6,6
052 Welsberg-Taisten,85,,1,6,7
052 Welsberg-Taisten,86,,3,6,9
052 Welsberg-Taisten,87,,3,2,5
052 Welsberg-Taisten,88,,3,4,7
052 Welsberg-Taisten,89,,1,3,4
052 Welsberg-Taisten,90,,-,4,4
052 Welsberg-Taisten,91,,1,-,1
052 Welsberg-Taisten,92,,1,1,2
052 Welsberg-Taisten,93,,1,-,1
052 Welsberg-Taisten,94,,1,2,3
052 Welsberg-Taisten,96,,-,1,1
052 Welsberg-Taisten,97,,-,2,2
052 Welsberg-Taisten,98,,-,1,1
052 Welsberg-Taisten,99,,-,1,1
053 Montan,0,,7,6,13
053 Montan,1,,9,8,17
053 Montan,2,,6,6,12
053 Montan,3,,9,8,17
053 Montan,4,,10,8,18
053 Montan,5,,6,10,16
053 Montan,6,,9,9,18
053 Montan,7,,5,4,9
053 Montan,8,,12,4,16
053 Montan,9,,9,6,15
053 Montan,10,,7,11,18
053 Montan,11,,9,13,22
053 Montan,12,,8,9,17
053 Montan,13,,14,9,23
053 Montan,14,,16,15,31
053 Montan,15,,13,6,19
053 Montan,16,,5,8,13
053 Montan,17,,7,10,17
053 Montan,18,,14,9,23
053 Montan,19,,10,8,18
053 Montan,20,,10,11,21
053 Montan,21,,12,15,27
053 Montan,22,,11,17,28
053 Montan,23,,13,6,19
053 Montan,24,,10,10,20
053 Montan,25,,8,4,12
053 Montan,26,,12,8,20
053 Montan,27,,8,9,17
053 Montan,28,,12,14,26
053 Montan,29,,8,7,15
053 Montan,30,,12,7,19
053 Montan,31,,11,6,17
053 Montan,32,,7,6,13
053 Montan,33,,9,7,16
053 Montan,34,,10,16,26
053 Montan,35,,9,16,25
053 Montan,36,,13,4,17
053 Montan,37,,7,10,17
053 Montan,38,,11,7,18
053 Montan,39,,15,13,28
053 Montan,40,,15,18,33
053 Montan,41,,15,17,32
053 Montan,42,,11,13,24
053 Montan,43,,14,16,30
053 Montan,44,,26,16,42
053 Montan,45,,17,11,28
053 Montan,46,,12,17,29
053 Montan,47,,15,18,33
053 Montan,48,,19,13,32
053 Montan,49,,13,11,24
053 Montan,50,,14,8,22
053 Montan,51,,13,10,23
053 Montan,52,,13,10,23
053 Montan,53,,8,15,23
053 Montan,54,,9,13,22
053 Montan,55,,15,13,28
053 Montan,56,,12,7,19
053 Montan,57,,12,4,16
053 Montan,58,,8,7,15
053 Montan,59,,4,5,9
053 Montan,60,,8,3,11
053 Montan,61,,5,6,11
053 Montan,62,,8,11,19
053 Montan,63,,4,2,6
053 Montan,64,,5,3,8
053 Montan,65,,2,6,8
053 Montan,66,,5,6,11
053 Montan,67,,8,6,14
053 Montan,68,,6,5,11
053 Montan,69,,8,7,15
053 Montan,70,,4,10,14
053 Montan,71,,6,10,16
053 Montan,72,,2,6,8
053 Montan,73,,7,10,17
053 Montan,74,,1,8,9
053 Montan,75,,2,6,8
053 Montan,76,,14,4,18
053 Montan,77,,5,7,12
053 Montan,78,,7,10,17
053 Montan,79,,8,12,20
053 Montan,80,,6,9,15
053 Montan,81,,5,3,8
053 Montan,82,,3,3,6
053 Montan,83,,6,6,12
053 Montan,84,,1,8,9
053 Montan,85,,1,5,6
053 Montan,86,,-,9,9
053 Montan,87,,3,4,7
053 Montan,88,,1,2,3
053 Montan,89,,1,3,4
053 Montan,90,,-,2,2
053 Montan,91,,-,2,2
053 Montan,93,,-,1,1
053 Montan,94,,-,2,2
053 Montan,95,,1,-,1
053 Montan,96,,-,1,1
053 Montan,98,,-,1,1
053 Montan,100,,-,1,1
054 Moos in Passeier,0,,10,16,26
054 Moos in Passeier,1,,15,13,28
054 Moos in Passeier,2,,17,7,24
054 Moos in Passeier,3,,16,9,25
054 Moos in Passeier,4,,18,14,32
054 Moos in Passeier,5,,19,21,40
054 Moos in Passeier,6,,15,10,25
054 Moos in Passeier,7,,22,18,40
054 Moos in Passeier,8,,15,12,27
054 Moos in Passeier,9,,13,18,31
054 Moos in Passeier,10,,25,9,34
054 Moos in Passeier,11,,15,14,29
054 Moos in Passeier,12,,12,17,29
054 Moos in Passeier,13,,18,19,37
054 Moos in Passeier,14,,8,11,19
054 Moos in Passeier,15,,17,20,37
054 Moos in Passeier,16,,17,12,29
054 Moos in Passeier,17,,18,17,35
054 Moos in Passeier,18,,16,20,36
054 Moos in Passeier,19,,15,13,28
054 Moos in Passeier,20,,17,18,35
054 Moos in Passeier,21,,16,13,29
054 Moos in Passeier,22,,15,14,29
054 Moos in Passeier,23,,17,14,31
054 Moos in Passeier,24,,20,10,30
054 Moos in Passeier,25,,19,19,38
054 Moos in Passeier,26,,12,10,22
054 Moos in Passeier,27,,15,18,33
054 Moos in Passeier,28,,15,15,30
054 Moos in Passeier,29,,14,15,29
054 Moos in Passeier,30,,19,11,30
054 Moos in Passeier,31,,20,16,36
054 Moos in Passeier,32,,20,17,37
054 Moos in Passeier,33,,15,9,24
054 Moos in Passeier,34,,17,15,32
054 Moos in Passeier,35,,25,15,40
054 Moos in Passeier,36,,9,23,32
054 Moos in Passeier,37,,19,16,35
054 Moos in Passeier,38,,17,17,34
054 Moos in Passeier,39,,20,12,32
054 Moos in Passeier,40,,16,18,34
054 Moos in Passeier,41,,19,17,36
054 Moos in Passeier,42,,22,15,37
054 Moos in Passeier,43,,23,20,43
054 Moos in Passeier,44,,20,8,28
054 Moos in Passeier,45,,22,11,33
054 Moos in Passeier,46,,15,18,33
054 Moos in Passeier,47,,10,19,29
054 Moos in Passeier,48,,9,7,16
054 Moos in Passeier,49,,15,16,31
054 Moos in Passeier,50,,15,14,29
054 Moos in Passeier,51,,12,14,26
054 Moos in Passeier,52,,19,6,25
054 Moos in Passeier,53,,9,8,17
054 Moos in Passeier,54,,8,8,16
054 Moos in Passeier,55,,14,9,23
054 Moos in Passeier,56,,7,9,16
054 Moos in Passeier,57,,8,3,11
054 Moos in Passeier,58,,9,10,19
054 Moos in Passeier,59,,6,10,16
054 Moos in Passeier,60,,14,9,23
054 Moos in Passeier,61,,6,6,12
054 Moos in Passeier,62,,18,10,28
054 Moos in Passeier,63,,9,8,17
054 Moos in Passeier,64,,9,7,16
054 Moos in Passeier,65,,10,7,17
054 Moos in Passeier,66,,13,12,25
054 Moos in Passeier,67,,5,12,17
054 Moos in Passeier,68,,10,13,23
054 Moos in Passeier,69,,8,10,18
054 Moos in Passeier,70,,5,4,9
054 Moos in Passeier,71,,10,7,17
054 Moos in Passeier,72,,5,6,11
054 Moos in Passeier,73,,8,7,15
054 Moos in Passeier,74,,8,5,13
054 Moos in Passeier,75,,12,13,25
054 Moos in Passeier,76,,5,9,14
054 Moos in Passeier,77,,8,3,11
054 Moos in Passeier,78,,8,6,14
054 Moos in Passeier,79,,7,7,14
054 Moos in Passeier,80,,7,10,17
054 Moos in Passeier,81,,3,9,12
054 Moos in Passeier,82,,4,4,8
054 Moos in Passeier,83,,7,2,9
054 Moos in Passeier,84,,5,7,12
054 Moos in Passeier,85,,3,4,7
054 Moos in Passeier,86,,2,2,4
054 Moos in Passeier,87,,-,4,4
054 Moos in Passeier,88,,1,2,3
054 Moos in Passeier,89,,2,1,3
054 Moos in Passeier,90,,1,2,3
054 Moos in Passeier,92,,1,1,2
054 Moos in Passeier,93,,-,2,2
054 Moos in Passeier,95,,-,1,1
054 Moos in Passeier,97,,-,1,1
054 Moos in Passeier,99,,-,1,1
055 Nals,0,,9,10,19
055 Nals,1,,10,8,18
055 Nals,2,,8,8,16
055 Nals,3,,11,4,15
055 Nals,4,,7,14,21
055 Nals,5,,8,7,15
055 Nals,6,,9,5,14
055 Nals,7,,12,11,23
055 Nals,8,,7,9,16
055 Nals,9,,6,13,19
055 Nals,10,,14,9,23
055 Nals,11,,14,8,22
055 Nals,12,,12,7,19
055 Nals,13,,12,11,23
055 Nals,14,,7,6,13
055 Nals,15,,9,8,17
055 Nals,16,,7,12,19
055 Nals,17,,12,8,20
055 Nals,18,,10,10,20
055 Nals,19,,8,7,15
055 Nals,20,,12,8,20
055 Nals,21,,10,10,20
055 Nals,22,,13,11,24
055 Nals,23,,6,4,10
055 Nals,24,,13,6,19
055 Nals,25,,10,12,22
055 Nals,26,,8,10,18
055 Nals,27,,7,9,16
055 Nals,28,,15,11,26
055 Nals,29,,16,15,31
055 Nals,30,,9,13,22
055 Nals,31,,14,13,27
055 Nals,32,,9,15,24
055 Nals,33,,15,13,28
055 Nals,34,,7,13,20
055 Nals,35,,21,12,33
055 Nals,36,,16,7,23
055 Nals,37,,16,16,32
055 Nals,38,,17,16,33
055 Nals,39,,25,12,37
055 Nals,40,,18,16,34
055 Nals,41,,26,17,43
055 Nals,42,,17,15,32
055 Nals,43,,15,14,29
055 Nals,44,,17,14,31
055 Nals,45,,18,20,38
055 Nals,46,,11,22,33
055 Nals,47,,14,13,27
055 Nals,48,,18,14,32
055 Nals,49,,15,9,24
055 Nals,50,,15,15,30
055 Nals,51,,15,17,32
055 Nals,52,,7,7,14
055 Nals,53,,7,9,16
055 Nals,54,,20,14,34
055 Nals,55,,8,6,14
055 Nals,56,,8,8,16
055 Nals,57,,7,6,13
055 Nals,58,,3,10,13
055 Nals,59,,6,11,17
055 Nals,60,,10,8,18
055 Nals,61,,11,12,23
055 Nals,62,,12,5,17
055 Nals,63,,7,13,20
055 Nals,64,,7,12,19
055 Nals,65,,5,12,17
055 Nals,66,,9,6,15
055 Nals,67,,6,8,14
055 Nals,68,,10,6,16
055 Nals,69,,8,12,20
055 Nals,70,,9,10,19
055 Nals,71,,5,9,14
055 Nals,72,,3,13,16
055 Nals,73,,6,4,10
055 Nals,74,,5,6,11
055 Nals,75,,5,6,11
055 Nals,76,,8,10,18
055 Nals,77,,5,5,10
055 Nals,78,,3,5,8
055 Nals,79,,2,5,7
055 Nals,80,,8,7,15
055 Nals,81,,5,6,11
055 Nals,82,,3,6,9
055 Nals,83,,6,4,10
055 Nals,84,,3,3,6
055 Nals,85,,2,-,2
055 Nals,86,,-,3,3
055 Nals,87,,1,3,4
055 Nals,88,,-,8,8
055 Nals,90,,-,3,3
055 Nals,93,,-,1,1
055 Nals,94,,-,1,1
055 Nals,95,,-,2,2
055 Nals,96,,-,1,1
055 Nals,98,,-,1,1
055 Nals,99,,-,1,1
056 Naturns,0,,25,25,50
056 Naturns,1,,30,23,53
056 Naturns,2,,33,32,65
056 Naturns,3,,35,30,65
056 Naturns,4,,33,19,52
056 Naturns,5,,35,30,65
056 Naturns,6,,39,23,62
056 Naturns,7,,27,27,54
056 Naturns,8,,31,30,61
056 Naturns,9,,30,25,55
056 Naturns,10,,33,28,61
056 Naturns,11,,30,33,63
056 Naturns,12,,20,18,38
056 Naturns,13,,32,34,66
056 Naturns,14,,44,35,79
056 Naturns,15,,33,37,70
056 Naturns,16,,33,37,70
056 Naturns,17,,30,40,70
056 Naturns,18,,43,37,80
056 Naturns,19,,34,33,67
056 Naturns,20,,39,23,62
056 Naturns,21,,42,33,75
056 Naturns,22,,37,21,58
056 Naturns,23,,27,31,58
056 Naturns,24,,39,25,64
056 Naturns,25,,39,23,62
056 Naturns,26,,32,37,69
056 Naturns,27,,44,45,89
056 Naturns,28,,41,48,89
056 Naturns,29,,38,39,77
056 Naturns,30,,50,36,86
056 Naturns,31,,41,45,86
056 Naturns,32,,38,38,76
056 Naturns,33,,35,35,70
056 Naturns,34,,46,37,83
056 Naturns,35,,43,45,88
056 Naturns,36,,46,49,95
056 Naturns,37,,49,48,97
056 Naturns,38,,41,38,79
056 Naturns,39,,52,43,95
056 Naturns,40,,39,46,85
056 Naturns,41,,46,44,90
056 Naturns,42,,51,46,97
056 Naturns,43,,56,46,102
056 Naturns,44,,38,55,93
056 Naturns,45,,50,38,88
056 Naturns,46,,43,47,90
056 Naturns,47,,37,48,85
056 Naturns,48,,39,46,85
056 Naturns,49,,56,37,93
056 Naturns,50,,44,38,82
056 Naturns,51,,31,35,66
056 Naturns,52,,39,35,74
056 Naturns,53,,42,37,79
056 Naturns,54,,29,32,61
056 Naturns,55,,39,31,70
056 Naturns,56,,34,23,57
056 Naturns,57,,31,36,67
056 Naturns,58,,35,34,69
056 Naturns,59,,28,33,61
056 Naturns,60,,26,20,46
056 Naturns,61,,30,24,54
056 Naturns,62,,11,23,34
056 Naturns,63,,22,30,52
056 Naturns,64,,25,18,43
056 Naturns,65,,19,21,40
056 Naturns,66,,25,33,58
056 Naturns,67,,30,34,64
056 Naturns,68,,37,30,67
056 Naturns,69,,23,19,42
056 Naturns,70,,19,21,40
056 Naturns,71,,21,16,37
056 Naturns,72,,22,22,44
056 Naturns,73,,19,21,40
056 Naturns,74,,18,11,29
056 Naturns,75,,15,18,33
056 Naturns,76,,14,13,27
056 Naturns,77,,9,18,27
056 Naturns,78,,8,20,28
056 Naturns,79,,12,23,35
056 Naturns,80,,11,17,28
056 Naturns,81,,14,12,26
056 Naturns,82,,5,14,19
056 Naturns,83,,11,11,22
056 Naturns,84,,10,15,25
056 Naturns,85,,10,11,21
056 Naturns,86,,4,8,12
056 Naturns,87,,2,7,9
056 Naturns,88,,1,10,11
056 Naturns,89,,1,3,4
056 Naturns,90,,-,4,4
056 Naturns,91,,2,2,4
056 Naturns,92,,1,-,1
056 Naturns,93,,1,-,1
056 Naturns,94,,-,1,1
056 Naturns,95,,-,5,5
056 Naturns,96,,1,2,3
056 Naturns,97,,-,1,1
056 Naturns,98,,-,1,1
056 Naturns,99,,1,-,1
056 Naturns,100,,-,3,3
057 Natz-Schabs,0,,10,25,35
057 Natz-Schabs,1,,21,21,42
057 Natz-Schabs,2,,16,14,30
057 Natz-Schabs,3,,13,16,29
057 Natz-Schabs,4,,15,14,29
057 Natz-Schabs,5,,16,19,35
057 Natz-Schabs,6,,19,20,39
057 Natz-Schabs,7,,23,19,42
057 Natz-Schabs,8,,16,14,30
057 Natz-Schabs,9,,22,18,40
057 Natz-Schabs,10,,15,20,35
057 Natz-Schabs,11,,22,17,39
057 Natz-Schabs,12,,19,18,37
057 Natz-Schabs,13,,22,17,39
057 Natz-Schabs,14,,13,14,27
057 Natz-Schabs,15,,24,16,40
057 Natz-Schabs,16,,18,18,36
057 Natz-Schabs,17,,17,14,31
057 Natz-Schabs,18,,23,22,45
057 Natz-Schabs,19,,15,26,41
057 Natz-Schabs,20,,16,24,40
057 Natz-Schabs,21,,27,15,42
057 Natz-Schabs,22,,20,19,39
057 Natz-Schabs,23,,16,19,35
057 Natz-Schabs,24,,20,25,45
057 Natz-Schabs,25,,19,19,38
057 Natz-Schabs,26,,21,22,43
057 Natz-Schabs,27,,17,25,42
057 Natz-Schabs,28,,24,22,46
057 Natz-Schabs,29,,31,19,50
057 Natz-Schabs,30,,25,18,43
057 Natz-Schabs,31,,16,29,45
057 Natz-Schabs,32,,21,18,39
057 Natz-Schabs,33,,17,20,37
057 Natz-Schabs,34,,20,29,49
057 Natz-Schabs,35,,22,28,50
057 Natz-Schabs,36,,28,25,53
057 Natz-Schabs,37,,23,26,49
057 Natz-Schabs,38,,28,25,53
057 Natz-Schabs,39,,33,27,60
057 Natz-Schabs,40,,32,25,57
057 Natz-Schabs,41,,34,19,53
057 Natz-Schabs,42,,29,23,52
057 Natz-Schabs,43,,33,22,55
057 Natz-Schabs,44,,36,35,71
057 Natz-Schabs,45,,31,28,59
057 Natz-Schabs,46,,27,27,54
057 Natz-Schabs,47,,17,23,40
057 Natz-Schabs,48,,19,17,36
057 Natz-Schabs,49,,30,22,52
057 Natz-Schabs,50,,22,20,42
057 Natz-Schabs,51,,21,18,39
057 Natz-Schabs,52,,20,22,42
057 Natz-Schabs,53,,15,23,38
057 Natz-Schabs,54,,19,16,35
057 Natz-Schabs,55,,11,15,26
057 Natz-Schabs,56,,21,14,35
057 Natz-Schabs,57,,12,10,22
057 Natz-Schabs,58,,15,12,27
057 Natz-Schabs,59,,16,14,30
057 Natz-Schabs,60,,19,15,34
057 Natz-Schabs,61,,14,13,27
057 Natz-Schabs,62,,14,12,26
057 Natz-Schabs,63,,15,11,26
057 Natz-Schabs,64,,10,6,16
057 Natz-Schabs,65,,14,11,25
057 Natz-Schabs,66,,11,7,18
057 Natz-Schabs,67,,12,7,19
057 Natz-Schabs,68,,12,8,20
057 Natz-Schabs,69,,4,6,10
057 Natz-Schabs,70,,1,5,6
057 Natz-Schabs,71,,7,5,12
057 Natz-Schabs,72,,10,6,16
057 Natz-Schabs,73,,7,4,11
057 Natz-Schabs,74,,6,7,13
057 Natz-Schabs,75,,3,4,7
057 Natz-Schabs,76,,6,9,15
057 Natz-Schabs,77,,5,8,13
057 Natz-Schabs,78,,4,4,8
057 Natz-Schabs,79,,4,7,11
057 Natz-Schabs,80,,8,3,11
057 Natz-Schabs,81,,3,5,8
057 Natz-Schabs,82,,1,4,5
057 Natz-Schabs,83,,2,6,8
057 Natz-Schabs,84,,2,1,3
057 Natz-Schabs,85,,1,4,5
057 Natz-Schabs,86,,-,8,8
057 Natz-Schabs,87,,3,3,6
057 Natz-Schabs,88,,3,3,6
057 Natz-Schabs,89,,1,4,5
057 Natz-Schabs,90,,-,2,2
057 Natz-Schabs,91,,-,2,2
057 Natz-Schabs,92,,-,1,1
057 Natz-Schabs,100,,1,-,1
058 Welschnofen,0,,10,3,13
058 Welschnofen,1,,10,8,18
058 Welschnofen,2,,7,8,15
058 Welschnofen,3,,7,8,15
058 Welschnofen,4,,9,12,21
058 Welschnofen,5,,13,6,19
058 Welschnofen,6,,9,8,17
058 Welschnofen,7,,18,5,23
058 Welschnofen,8,,6,9,15
058 Welschnofen,9,,8,7,15
058 Welschnofen,10,,10,14,24
058 Welschnofen,11,,14,11,25
058 Welschnofen,12,,13,15,28
058 Welschnofen,13,,9,10,19
058 Welschnofen,14,,15,13,28
058 Welschnofen,15,,13,10,23
058 Welschnofen,16,,12,11,23
058 Welschnofen,17,,19,12,31
058 Welschnofen,18,,16,12,28
058 Welschnofen,19,,11,15,26
058 Welschnofen,20,,12,11,23
058 Welschnofen,21,,11,15,26
058 Welschnofen,22,,10,8,18
058 Welschnofen,23,,8,10,18
058 Welschnofen,24,,11,11,22
058 Welschnofen,25,,7,6,13
058 Welschnofen,26,,11,14,25
058 Welschnofen,27,,12,14,26
058 Welschnofen,28,,13,14,27
058 Welschnofen,29,,13,10,23
058 Welschnofen,30,,9,6,15
058 Welschnofen,31,,13,14,27
058 Welschnofen,32,,14,14,28
058 Welschnofen,33,,17,9,26
058 Welschnofen,34,,19,13,32
058 Welschnofen,35,,14,14,28
058 Welschnofen,36,,16,16,32
058 Welschnofen,37,,14,14,28
058 Welschnofen,38,,16,20,36
058 Welschnofen,39,,20,14,34
058 Welschnofen,40,,15,15,30
058 Welschnofen,41,,17,19,36
058 Welschnofen,42,,16,15,31
058 Welschnofen,43,,17,13,30
058 Welschnofen,44,,23,13,36
058 Welschnofen,45,,13,8,21
058 Welschnofen,46,,19,14,33
058 Welschnofen,47,,14,14,28
058 Welschnofen,48,,16,20,36
058 Welschnofen,49,,20,10,30
058 Welschnofen,50,,15,12,27
058 Welschnofen,51,,16,10,26
058 Welschnofen,52,,10,16,26
058 Welschnofen,53,,11,13,24
058 Welschnofen,54,,16,13,29
058 Welschnofen,55,,14,11,25
058 Welschnofen,56,,11,11,22
058 Welschnofen,57,,11,9,20
058 Welschnofen,58,,14,7,21
058 Welschnofen,59,,8,9,17
058 Welschnofen,60,,11,15,26
058 Welschnofen,61,,9,9,18
058 Welschnofen,62,,9,6,15
058 Welschnofen,63,,11,10,21
058 Welschnofen,64,,11,5,16
058 Welschnofen,65,,7,9,16
058 Welschnofen,66,,13,9,22
058 Welschnofen,67,,10,12,22
058 Welschnofen,68,,10,7,17
058 Welschnofen,69,,7,8,15
058 Welschnofen,70,,8,6,14
058 Welschnofen,71,,6,6,12
058 Welschnofen,72,,8,3,11
058 Welschnofen,73,,5,12,17
058 Welschnofen,74,,7,6,13
058 Welschnofen,75,,10,11,21
058 Welschnofen,76,,7,14,21
058 Welschnofen,77,,7,6,13
058 Welschnofen,78,,3,7,10
058 Welschnofen,79,,4,8,12
058 Welschnofen,80,,3,12,15
058 Welschnofen,81,,7,4,11
058 Welschnofen,82,,2,3,5
058 Welschnofen,83,,2,6,8
058 Welschnofen,84,,4,5,9
058 Welschnofen,85,,2,9,11
058 Welschnofen,86,,3,5,8
058 Welschnofen,87,,4,4,8
058 Welschnofen,88,,-,8,8
058 Welschnofen,89,,1,2,3
058 Welschnofen,90,,1,3,4
058 Welschnofen,91,,1,-,1
058 Welschnofen,92,,1,-,1
058 Welschnofen,93,,1,2,3
058 Welschnofen,94,,-,3,3
058 Welschnofen,96,,-,1,1
058 Welschnofen,97,,-,2,2
058 Welschnofen,98,,1,-,1
058 Welschnofen,99,,1,1,2
059 Deutschnofen,0,,24,18,42
059 Deutschnofen,1,,18,20,38
059 Deutschnofen,2,,18,16,34
059 Deutschnofen,3,,23,26,49
059 Deutschnofen,4,,26,32,58
059 Deutschnofen,5,,22,29,51
059 Deutschnofen,6,,18,33,51
059 Deutschnofen,7,,32,11,43
059 Deutschnofen,8,,23,33,56
059 Deutschnofen,9,,23,26,49
059 Deutschnofen,10,,30,23,53
059 Deutschnofen,11,,32,12,44
059 Deutschnofen,12,,23,29,52
059 Deutschnofen,13,,20,28,48
059 Deutschnofen,14,,27,24,51
059 Deutschnofen,15,,28,14,42
059 Deutschnofen,16,,26,26,52
059 Deutschnofen,17,,35,28,63
059 Deutschnofen,18,,21,20,41
059 Deutschnofen,19,,35,28,63
059 Deutschnofen,20,,25,20,45
059 Deutschnofen,21,,20,34,54
059 Deutschnofen,22,,22,28,50
059 Deutschnofen,23,,31,20,51
059 Deutschnofen,24,,26,22,48
059 Deutschnofen,25,,33,27,60
059 Deutschnofen,26,,26,25,51
059 Deutschnofen,27,,21,37,58
059 Deutschnofen,28,,26,19,45
059 Deutschnofen,29,,28,27,55
059 Deutschnofen,30,,26,25,51
059 Deutschnofen,31,,26,23,49
059 Deutschnofen,32,,35,23,58
059 Deutschnofen,33,,21,22,43
059 Deutschnofen,34,,25,23,48
059 Deutschnofen,35,,30,33,63
059 Deutschnofen,36,,23,29,52
059 Deutschnofen,37,,31,37,68
059 Deutschnofen,38,,29,25,54
059 Deutschnofen,39,,29,29,58
059 Deutschnofen,40,,40,29,69
059 Deutschnofen,41,,23,34,57
059 Deutschnofen,42,,32,30,62
059 Deutschnofen,43,,34,34,68
059 Deutschnofen,44,,36,21,57
059 Deutschnofen,45,,32,30,62
059 Deutschnofen,46,,33,24,57
059 Deutschnofen,47,,24,28,52
059 Deutschnofen,48,,36,20,56
059 Deutschnofen,49,,41,26,67
059 Deutschnofen,50,,31,18,49
059 Deutschnofen,51,,22,29,51
059 Deutschnofen,52,,23,25,48
059 Deutschnofen,53,,33,26,59
059 Deutschnofen,54,,30,22,52
059 Deutschnofen,55,,28,21,49
059 Deutschnofen,56,,23,20,43
059 Deutschnofen,57,,24,20,44
059 Deutschnofen,58,,22,15,37
059 Deutschnofen,59,,18,19,37
059 Deutschnofen,60,,21,15,36
059 Deutschnofen,61,,22,16,38
059 Deutschnofen,62,,13,12,25
059 Deutschnofen,63,,17,21,38
059 Deutschnofen,64,,16,13,29
059 Deutschnofen,65,,16,16,32
059 Deutschnofen,66,,23,21,44
059 Deutschnofen,67,,17,17,34
059 Deutschnofen,68,,16,25,41
059 Deutschnofen,69,,14,17,31
059 Deutschnofen,70,,23,15,38
059 Deutschnofen,71,,15,19,34
059 Deutschnofen,72,,12,7,19
059 Deutschnofen,73,,13,10,23
059 Deutschnofen,74,,8,11,19
059 Deutschnofen,75,,14,10,24
059 Deutschnofen,76,,8,13,21
059 Deutschnofen,77,,13,14,27
059 Deutschnofen,78,,8,9,17
059 Deutschnofen,79,,7,9,16
059 Deutschnofen,80,,7,7,14
059 Deutschnofen,81,,7,19,26
059 Deutschnofen,82,,6,13,19
059 Deutschnofen,83,,10,8,18
059 Deutschnofen,84,,4,18,22
059 Deutschnofen,85,,3,9,12
059 Deutschnofen,86,,3,7,10
059 Deutschnofen,87,,4,10,14
059 Deutschnofen,88,,2,10,12
059 Deutschnofen,89,,1,4,5
059 Deutschnofen,90,,1,2,3
059 Deutschnofen,91,,-,2,2
059 Deutschnofen,92,,-,2,2
059 Deutschnofen,93,,1,1,2
059 Deutschnofen,94,,2,2,4
059 Deutschnofen,95,,-,2,2
059 Deutschnofen,96,,-,2,2
059 Deutschnofen,98,,-,3,3
059 Deutschnofen,99,,1,-,1
060 Auer,0,,20,26,46
060 Auer,1,,14,22,36
060 Auer,2,,21,13,34
060 Auer,3,,15,11,26
060 Auer,4,,29,23,52
060 Auer,5,,20,17,37
060 Auer,6,,21,15,36
060 Auer,7,,31,17,48
060 Auer,8,,18,26,44
060 Auer,9,,21,24,45
060 Auer,10,,20,25,45
060 Auer,11,,21,25,46
060 Auer,12,,21,17,38
060 Auer,13,,19,21,40
060 Auer,14,,17,18,35
060 Auer,15,,23,23,46
060 Auer,16,,12,22,34
060 Auer,17,,19,21,40
060 Auer,18,,27,15,42
060 Auer,19,,16,19,35
060 Auer,20,,19,23,42
060 Auer,21,,20,27,47
060 Auer,22,,25,19,44
060 Auer,23,,18,15,33
060 Auer,24,,25,22,47
060 Auer,25,,20,17,37
060 Auer,26,,20,17,37
060 Auer,27,,19,25,44
060 Auer,28,,20,17,37
060 Auer,29,,19,18,37
060 Auer,30,,25,17,42
060 Auer,31,,16,20,36
060 Auer,32,,17,33,50
060 Auer,33,,23,31,54
060 Auer,34,,22,21,43
060 Auer,35,,31,32,63
060 Auer,36,,26,28,54
060 Auer,37,,19,27,46
060 Auer,38,,44,29,73
060 Auer,39,,32,29,61
060 Auer,40,,23,34,57
060 Auer,41,,32,36,68
060 Auer,42,,28,29,57
060 Auer,43,,39,44,83
060 Auer,44,,34,26,60
060 Auer,45,,33,23,56
060 Auer,46,,32,41,73
060 Auer,47,,27,22,49
060 Auer,48,,33,31,64
060 Auer,49,,28,34,62
060 Auer,50,,38,30,68
060 Auer,51,,36,23,59
060 Auer,52,,20,26,46
060 Auer,53,,27,30,57
060 Auer,54,,13,23,36
060 Auer,55,,23,13,36
060 Auer,56,,17,25,42
060 Auer,57,,17,21,38
060 Auer,58,,14,17,31
060 Auer,59,,17,22,39
060 Auer,60,,14,13,27
060 Auer,61,,30,15,45
060 Auer,62,,17,19,36
060 Auer,63,,16,25,41
060 Auer,64,,12,13,25
060 Auer,65,,22,16,38
060 Auer,66,,13,18,31
060 Auer,67,,14,19,33
060 Auer,68,,19,14,33
060 Auer,69,,11,10,21
060 Auer,70,,12,21,33
060 Auer,71,,17,17,34
060 Auer,72,,8,11,19
060 Auer,73,,12,9,21
060 Auer,74,,9,16,25
060 Auer,75,,15,12,27
060 Auer,76,,4,8,12
060 Auer,77,,4,13,17
060 Auer,78,,9,10,19
060 Auer,79,,7,7,14
060 Auer,80,,7,13,20
060 Auer,81,,9,6,15
060 Auer,82,,6,13,19
060 Auer,83,,1,17,18
060 Auer,84,,10,10,20
060 Auer,85,,6,9,15
060 Auer,86,,8,9,17
060 Auer,87,,2,9,11
060 Auer,88,,2,8,10
060 Auer,89,,3,7,10
060 Auer,90,,2,2,4
060 Auer,91,,-,4,4
060 Auer,92,,-,1,1
060 Auer,93,,-,1,1
060 Auer,94,,-,2,2
060 Auer,96,,1,3,4
060 Auer,98,,-,1,1
060 Auer,102,,1,-,1
061 St.Ulrich,0,,25,20,45
061 St.Ulrich,1,,32,21,53
061 St.Ulrich,2,,31,32,63
061 St.Ulrich,3,,33,28,61
061 St.Ulrich,4,,32,20,52
061 St.Ulrich,5,,22,32,54
061 St.Ulrich,6,,24,33,57
061 St.Ulrich,7,,25,35,60
061 St.Ulrich,8,,22,22,44
061 St.Ulrich,9,,27,33,60
061 St.Ulrich,10,,43,32,75
061 St.Ulrich,11,,45,35,80
061 St.Ulrich,12,,31,27,58
061 St.Ulrich,13,,31,23,54
061 St.Ulrich,14,,30,30,60
061 St.Ulrich,15,,29,28,57
061 St.Ulrich,16,,22,29,51
061 St.Ulrich,17,,34,30,64
061 St.Ulrich,18,,32,29,61
061 St.Ulrich,19,,26,23,49
061 St.Ulrich,20,,18,21,39
061 St.Ulrich,21,,18,23,41
061 St.Ulrich,22,,27,20,47
061 St.Ulrich,23,,20,16,36
061 St.Ulrich,24,,21,20,41
061 St.Ulrich,25,,21,18,39
061 St.Ulrich,26,,19,19,38
061 St.Ulrich,27,,23,35,58
061 St.Ulrich,28,,21,33,54
061 St.Ulrich,29,,24,32,56
061 St.Ulrich,30,,34,32,66
061 St.Ulrich,31,,22,30,52
061 St.Ulrich,32,,20,22,42
061 St.Ulrich,33,,34,33,67
061 St.Ulrich,34,,38,28,66
061 St.Ulrich,35,,32,35,67
061 St.Ulrich,36,,37,27,64
061 St.Ulrich,37,,38,32,70
061 St.Ulrich,38,,38,37,75
061 St.Ulrich,39,,36,34,70
061 St.Ulrich,40,,42,45,87
061 St.Ulrich,41,,43,45,88
061 St.Ulrich,42,,39,41,80
061 St.Ulrich,43,,35,38,73
061 St.Ulrich,44,,37,32,69
061 St.Ulrich,45,,39,40,79
061 St.Ulrich,46,,36,34,70
061 St.Ulrich,47,,28,34,62
061 St.Ulrich,48,,28,24,52
061 St.Ulrich,49,,33,27,60
061 St.Ulrich,50,,37,27,64
061 St.Ulrich,51,,24,17,41
061 St.Ulrich,52,,24,31,55
061 St.Ulrich,53,,19,28,47
061 St.Ulrich,54,,25,36,61
061 St.Ulrich,55,,27,33,60
061 St.Ulrich,56,,27,20,47
061 St.Ulrich,57,,12,29,41
061 St.Ulrich,58,,25,23,48
061 St.Ulrich,59,,19,26,45
061 St.Ulrich,60,,16,28,44
061 St.Ulrich,61,,29,29,58
061 St.Ulrich,62,,21,25,46
061 St.Ulrich,63,,30,24,54
061 St.Ulrich,64,,17,17,34
061 St.Ulrich,65,,27,32,59
061 St.Ulrich,66,,37,36,73
061 St.Ulrich,67,,29,34,63
061 St.Ulrich,68,,33,44,77
061 St.Ulrich,69,,28,28,56
061 St.Ulrich,70,,18,19,37
061 St.Ulrich,71,,23,23,46
061 St.Ulrich,72,,21,25,46
061 St.Ulrich,73,,22,16,38
061 St.Ulrich,74,,13,25,38
061 St.Ulrich,75,,16,12,28
061 St.Ulrich,76,,15,12,27
061 St.Ulrich,77,,14,21,35
061 St.Ulrich,78,,18,13,31
061 St.Ulrich,79,,19,9,28
061 St.Ulrich,80,,12,4,16
061 St.Ulrich,81,,14,11,25
061 St.Ulrich,82,,11,12,23
061 St.Ulrich,83,,7,12,19
061 St.Ulrich,84,,9,9,18
061 St.Ulrich,85,,4,14,18
061 St.Ulrich,86,,3,13,16
061 St.Ulrich,87,,3,12,15
061 St.Ulrich,88,,5,11,16
061 St.Ulrich,89,,3,10,13
061 St.Ulrich,90,,3,6,9
061 St.Ulrich,91,,1,5,6
061 St.Ulrich,92,,-,1,1
061 St.Ulrich,93,,2,1,3
061 St.Ulrich,94,,1,3,4
061 St.Ulrich,95,,1,2,3
061 St.Ulrich,96,,1,5,6
061 St.Ulrich,97,,-,1,1
061 St.Ulrich,99,,-,1,1
062 Partschins,0,,18,18,36
062 Partschins,1,,24,11,35
062 Partschins,2,,16,19,35
062 Partschins,3,,15,17,32
062 Partschins,4,,17,25,42
062 Partschins,5,,14,23,37
062 Partschins,6,,24,19,43
062 Partschins,7,,26,20,46
062 Partschins,8,,14,16,30
062 Partschins,9,,22,16,38
062 Partschins,10,,14,18,32
062 Partschins,11,,20,11,31
062 Partschins,12,,23,23,46
062 Partschins,13,,13,18,31
062 Partschins,14,,25,17,42
062 Partschins,15,,22,20,42
062 Partschins,16,,25,18,43
062 Partschins,17,,25,16,41
062 Partschins,18,,25,30,55
062 Partschins,19,,22,22,44
062 Partschins,20,,9,26,35
062 Partschins,21,,18,29,47
062 Partschins,22,,15,17,32
062 Partschins,23,,24,18,42
062 Partschins,24,,14,14,28
062 Partschins,25,,19,24,43
062 Partschins,26,,15,26,41
062 Partschins,27,,14,24,38
062 Partschins,28,,21,26,47
062 Partschins,29,,27,27,54
062 Partschins,30,,20,24,44
062 Partschins,31,,20,14,34
062 Partschins,32,,23,18,41
062 Partschins,33,,23,21,44
062 Partschins,34,,30,20,50
062 Partschins,35,,28,25,53
062 Partschins,36,,31,26,57
062 Partschins,37,,28,26,54
062 Partschins,38,,26,31,57
062 Partschins,39,,23,35,58
062 Partschins,40,,38,26,64
062 Partschins,41,,22,34,56
062 Partschins,42,,36,25,61
062 Partschins,43,,37,39,76
062 Partschins,44,,27,29,56
062 Partschins,45,,30,37,67
062 Partschins,46,,36,24,60
062 Partschins,47,,33,24,57
062 Partschins,48,,21,23,44
062 Partschins,49,,25,38,63
062 Partschins,50,,28,21,49
062 Partschins,51,,20,17,37
062 Partschins,52,,24,25,49
062 Partschins,53,,23,20,43
062 Partschins,54,,28,24,52
062 Partschins,55,,13,27,40
062 Partschins,56,,21,17,38
062 Partschins,57,,15,15,30
062 Partschins,58,,19,16,35
062 Partschins,59,,19,21,40
062 Partschins,60,,11,15,26
062 Partschins,61,,17,21,38
062 Partschins,62,,16,19,35
062 Partschins,63,,25,27,52
062 Partschins,64,,13,17,30
062 Partschins,65,,18,15,33
062 Partschins,66,,22,25,47
062 Partschins,67,,14,17,31
062 Partschins,68,,21,29,50
062 Partschins,69,,13,13,26
062 Partschins,70,,12,13,25
062 Partschins,71,,17,15,32
062 Partschins,72,,14,16,30
062 Partschins,73,,13,16,29
062 Partschins,74,,9,10,19
062 Partschins,75,,9,17,26
062 Partschins,76,,10,16,26
062 Partschins,77,,13,10,23
062 Partschins,78,,12,20,32
062 Partschins,79,,9,9,18
062 Partschins,80,,12,8,20
062 Partschins,81,,9,8,17
062 Partschins,82,,10,10,20
062 Partschins,83,,6,8,14
062 Partschins,84,,4,10,14
062 Partschins,85,,3,11,14
062 Partschins,86,,5,7,12
062 Partschins,87,,4,5,9
062 Partschins,88,,9,6,15
062 Partschins,89,,-,4,4
062 Partschins,90,,2,4,6
062 Partschins,91,,1,-,1
062 Partschins,92,,-,2,2
062 Partschins,93,,-,1,1
062 Partschins,94,,-,1,1
062 Partschins,95,,-,1,1
062 Partschins,96,,-,1,1
063 Percha,0,,11,6,17
063 Percha,1,,8,7,15
063 Percha,2,,10,6,16
063 Percha,3,,5,3,8
063 Percha,4,,5,12,17
063 Percha,5,,9,15,24
063 Percha,6,,9,7,16
063 Percha,7,,10,7,17
063 Percha,8,,4,5,9
063 Percha,9,,10,9,19
063 Percha,10,,6,8,14
063 Percha,11,,8,8,16
063 Percha,12,,12,15,27
063 Percha,13,,9,5,14
063 Percha,14,,7,8,15
063 Percha,15,,9,12,21
063 Percha,16,,7,8,15
063 Percha,17,,12,6,18
063 Percha,18,,10,10,20
063 Percha,19,,8,7,15
063 Percha,20,,6,10,16
063 Percha,21,,6,5,11
063 Percha,22,,9,19,28
063 Percha,23,,6,9,15
063 Percha,24,,7,15,22
063 Percha,25,,15,6,21
063 Percha,26,,15,12,27
063 Percha,27,,6,10,16
063 Percha,28,,10,7,17
063 Percha,29,,11,8,19
063 Percha,30,,5,12,17
063 Percha,31,,13,14,27
063 Percha,32,,9,6,15
063 Percha,33,,14,15,29
063 Percha,34,,9,11,20
063 Percha,35,,10,13,23
063 Percha,36,,13,9,22
063 Percha,37,,13,8,21
063 Percha,38,,17,17,34
063 Percha,39,,8,10,18
063 Percha,40,,19,14,33
063 Percha,41,,17,14,31
063 Percha,42,,10,9,19
063 Percha,43,,19,6,25
063 Percha,44,,13,19,32
063 Percha,45,,15,7,22
063 Percha,46,,11,15,26
063 Percha,47,,17,10,27
063 Percha,48,,9,13,22
063 Percha,49,,12,6,18
063 Percha,50,,6,10,16
063 Percha,51,,10,10,20
063 Percha,52,,10,5,15
063 Percha,53,,7,12,19
063 Percha,54,,9,9,18
063 Percha,55,,4,5,9
063 Percha,56,,8,6,14
063 Percha,57,,5,9,14
063 Percha,58,,7,8,15
063 Percha,59,,6,8,14
063 Percha,60,,9,6,15
063 Percha,61,,5,4,9
063 Percha,62,,5,7,12
063 Percha,63,,6,8,14
063 Percha,64,,8,5,13
063 Percha,65,,12,4,16
063 Percha,66,,8,8,16
063 Percha,67,,8,7,15
063 Percha,68,,7,7,14
063 Percha,69,,4,5,9
063 Percha,70,,7,5,12
063 Percha,71,,5,9,14
063 Percha,72,,2,5,7
063 Percha,73,,3,2,5
063 Percha,74,,4,4,8
063 Percha,75,,7,5,12
063 Percha,76,,4,5,9
063 Percha,77,,5,3,8
063 Percha,78,,5,1,6
063 Percha,79,,8,3,11
063 Percha,80,,1,4,5
063 Percha,81,,2,3,5
063 Percha,82,,4,2,6
063 Percha,83,,2,5,7
063 Percha,84,,2,4,6
063 Percha,85,,-,1,1
063 Percha,86,,1,2,3
063 Percha,87,,1,-,1
063 Percha,88,,-,2,2
063 Percha,89,,-,2,2
063 Percha,95,,-,1,1
064 Plaus,0,,5,4,9
064 Plaus,1,,4,4,8
064 Plaus,2,,4,2,6
064 Plaus,3,,4,1,5
064 Plaus,4,,4,2,6
064 Plaus,5,,6,4,10
064 Plaus,6,,3,3,6
064 Plaus,7,,5,6,11
064 Plaus,8,,8,4,12
064 Plaus,9,,11,4,15
064 Plaus,10,,12,5,17
064 Plaus,11,,6,7,13
064 Plaus,12,,7,5,12
064 Plaus,13,,4,3,7
064 Plaus,14,,2,2,4
064 Plaus,15,,6,1,7
064 Plaus,16,,9,4,13
064 Plaus,17,,6,7,13
064 Plaus,18,,3,9,12
064 Plaus,19,,4,3,7
064 Plaus,20,,5,5,10
064 Plaus,21,,4,3,7
064 Plaus,22,,5,2,7
064 Plaus,23,,-,7,7
064 Plaus,24,,1,5,6
064 Plaus,25,,6,2,8
064 Plaus,26,,2,5,7
064 Plaus,27,,1,4,5
064 Plaus,28,,2,6,8
064 Plaus,29,,7,3,10
064 Plaus,30,,4,4,8
064 Plaus,31,,5,4,9
064 Plaus,32,,2,7,9
064 Plaus,33,,5,3,8
064 Plaus,34,,12,4,16
064 Plaus,35,,6,9,15
064 Plaus,36,,12,5,17
064 Plaus,37,,7,8,15
064 Plaus,38,,7,8,15
064 Plaus,39,,8,4,12
064 Plaus,40,,7,9,16
064 Plaus,41,,4,8,12
064 Plaus,42,,7,10,17
064 Plaus,43,,5,5,10
064 Plaus,44,,13,2,15
064 Plaus,45,,7,9,16
064 Plaus,46,,3,4,7
064 Plaus,47,,9,5,14
064 Plaus,48,,7,3,10
064 Plaus,49,,2,8,10
064 Plaus,50,,7,2,9
064 Plaus,51,,3,3,6
064 Plaus,52,,2,3,5
064 Plaus,53,,2,2,4
064 Plaus,54,,2,5,7
064 Plaus,55,,1,1,2
064 Plaus,56,,3,5,8
064 Plaus,57,,4,2,6
064 Plaus,58,,5,3,8
064 Plaus,59,,2,2,4
064 Plaus,60,,5,3,8
064 Plaus,61,,1,4,5
064 Plaus,62,,2,4,6
064 Plaus,63,,5,2,7
064 Plaus,64,,4,1,5
064 Plaus,65,,2,3,5
064 Plaus,66,,5,1,6
064 Plaus,67,,1,4,5
064 Plaus,68,,3,2,5
064 Plaus,69,,3,1,4
064 Plaus,70,,4,2,6
064 Plaus,71,,1,1,2
064 Plaus,72,,3,2,5
064 Plaus,73,,-,1,1
064 Plaus,74,,1,2,3
064 Plaus,75,,4,1,5
064 Plaus,76,,2,3,5
064 Plaus,77,,2,3,5
064 Plaus,78,,-,1,1
064 Plaus,80,,1,1,2
064 Plaus,81,,-,1,1
064 Plaus,82,,1,1,2
064 Plaus,83,,-,1,1
064 Plaus,84,,1,-,1
064 Plaus,85,,-,3,3
064 Plaus,86,,-,1,1
064 Plaus,88,,-,1,1
064 Plaus,90,,-,2,2
064 Plaus,91,,-,1,1
064 Plaus,94,,-,1,1
065 Waidbruck,0,,2,2,4
065 Waidbruck,2,,1,-,1
065 Waidbruck,3,,2,-,2
065 Waidbruck,5,,1,-,1
065 Waidbruck,6,,-,2,2
065 Waidbruck,7,,-,1,1
065 Waidbruck,8,,1,-,1
065 Waidbruck,9,,1,2,3
065 Waidbruck,10,,2,1,3
065 Waidbruck,12,,4,3,7
065 Waidbruck,13,,3,1,4
065 Waidbruck,14,,1,2,3
065 Waidbruck,15,,3,1,4
065 Waidbruck,16,,1,1,2
065 Waidbruck,17,,-,3,3
065 Waidbruck,18,,1,-,1
065 Waidbruck,19,,-,2,2
065 Waidbruck,20,,3,1,4
065 Waidbruck,21,,-,1,1
065 Waidbruck,22,,1,-,1
065 Waidbruck,24,,1,2,3
065 Waidbruck,25,,1,1,2
065 Waidbruck,26,,2,-,2
065 Waidbruck,27,,1,-,1
065 Waidbruck,28,,3,2,5
065 Waidbruck,29,,1,1,2
065 Waidbruck,31,,4,-,4
065 Waidbruck,32,,-,1,1
065 Waidbruck,34,,-,1,1
065 Waidbruck,35,,5,2,7
065 Waidbruck,36,,-,1,1
065 Waidbruck,37,,1,1,2
065 Waidbruck,38,,2,-,2
065 Waidbruck,39,,-,2,2
065 Waidbruck,40,,3,2,5
065 Waidbruck,41,,3,1,4
065 Waidbruck,42,,1,4,5
065 Waidbruck,43,,3,3,6
065 Waidbruck,44,,2,1,3
065 Waidbruck,45,,3,-,3
065 Waidbruck,46,,1,1,2
065 Waidbruck,48,,1,1,2
065 Waidbruck,49,,4,1,5
065 Waidbruck,50,,2,1,3
065 Waidbruck,51,,-,1,1
065 Waidbruck,52,,3,1,4
065 Waidbruck,53,,2,-,2
065 Waidbruck,54,,3,-,3
065 Waidbruck,57,,1,1,2
065 Waidbruck,58,,-,1,1
065 Waidbruck,63,,-,3,3
065 Waidbruck,64,,1,1,2
065 Waidbruck,65,,2,1,3
065 Waidbruck,67,,1,1,2
065 Waidbruck,68,,-,2,2
065 Waidbruck,69,,-,2,2
065 Waidbruck,70,,1,-,1
065 Waidbruck,71,,-,2,2
065 Waidbruck,72,,1,-,1
065 Waidbruck,73,,2,1,3
065 Waidbruck,74,,-,3,3
065 Waidbruck,75,,2,1,3
065 Waidbruck,76,,1,-,1
065 Waidbruck,77,,-,3,3
065 Waidbruck,78,,1,-,1
065 Waidbruck,79,,1,-,1
065 Waidbruck,80,,-,2,2
065 Waidbruck,81,,1,-,1
065 Waidbruck,82,,2,1,3
065 Waidbruck,83,,-,1,1
065 Waidbruck,84,,1,-,1
065 Waidbruck,86,,-,2,2
065 Waidbruck,89,,-,1,1
065 Waidbruck,90,,-,2,2
065 Waidbruck,95,,-,1,1
066 Burgstall,0,,18,6,24
066 Burgstall,1,,12,15,27
066 Burgstall,2,,14,5,19
066 Burgstall,3,,10,13,23
066 Burgstall,4,,7,8,15
066 Burgstall,5,,14,7,21
066 Burgstall,6,,8,10,18
066 Burgstall,7,,8,12,20
066 Burgstall,8,,11,8,19
066 Burgstall,9,,13,11,24
066 Burgstall,10,,9,8,17
066 Burgstall,11,,10,9,19
066 Burgstall,12,,9,6,15
066 Burgstall,13,,7,7,14
066 Burgstall,14,,10,6,16
066 Burgstall,15,,6,4,10
066 Burgstall,16,,7,10,17
066 Burgstall,17,,5,6,11
066 Burgstall,18,,6,9,15
066 Burgstall,19,,14,10,24
066 Burgstall,20,,11,5,16
066 Burgstall,21,,7,9,16
066 Burgstall,22,,8,10,18
066 Burgstall,23,,10,5,15
066 Burgstall,24,,8,12,20
066 Burgstall,25,,9,15,24
066 Burgstall,26,,11,13,24
066 Burgstall,27,,10,12,22
066 Burgstall,28,,8,9,17
066 Burgstall,29,,13,12,25
066 Burgstall,30,,13,9,22
066 Burgstall,31,,8,9,17
066 Burgstall,32,,13,19,32
066 Burgstall,33,,9,11,20
066 Burgstall,34,,18,17,35
066 Burgstall,35,,9,13,22
066 Burgstall,36,,13,18,31
066 Burgstall,37,,12,20,32
066 Burgstall,38,,15,15,30
066 Burgstall,39,,18,15,33
066 Burgstall,40,,17,11,28
066 Burgstall,41,,20,15,35
066 Burgstall,42,,11,15,26
066 Burgstall,43,,15,19,34
066 Burgstall,44,,21,18,39
066 Burgstall,45,,13,12,25
066 Burgstall,46,,18,16,34
066 Burgstall,47,,16,12,28
066 Burgstall,48,,14,19,33
066 Burgstall,49,,17,12,29
066 Burgstall,50,,10,9,19
066 Burgstall,51,,15,9,24
066 Burgstall,52,,9,8,17
066 Burgstall,53,,12,10,22
066 Burgstall,54,,8,10,18
066 Burgstall,55,,9,17,26
066 Burgstall,56,,9,10,19
066 Burgstall,57,,13,14,27
066 Burgstall,58,,13,7,20
066 Burgstall,59,,9,10,19
066 Burgstall,60,,9,7,16
066 Burgstall,61,,9,11,20
066 Burgstall,62,,7,10,17
066 Burgstall,63,,9,8,17
066 Burgstall,64,,7,9,16
066 Burgstall,65,,8,10,18
066 Burgstall,66,,11,8,19
066 Burgstall,67,,5,5,10
066 Burgstall,68,,8,4,12
066 Burgstall,69,,5,12,17
066 Burgstall,70,,6,8,14
066 Burgstall,71,,9,13,22
066 Burgstall,72,,5,9,14
066 Burgstall,73,,5,6,11
066 Burgstall,74,,7,3,10
066 Burgstall,75,,6,8,14
066 Burgstall,76,,8,4,12
066 Burgstall,77,,2,7,9
066 Burgstall,78,,6,3,9
066 Burgstall,79,,5,6,11
066 Burgstall,80,,1,4,5
066 Burgstall,81,,3,5,8
066 Burgstall,82,,1,10,11
066 Burgstall,83,,4,7,11
066 Burgstall,84,,4,3,7
066 Burgstall,85,,1,5,6
066 Burgstall,86,,4,1,5
066 Burgstall,87,,1,5,6
066 Burgstall,89,,1,1,2
066 Burgstall,90,,-,1,1
066 Burgstall,91,,-,1,1
066 Burgstall,92,,1,-,1
066 Burgstall,93,,-,2,2
066 Burgstall,94,,1,1,2
067 Prad am Stilfser Joch,0,,16,16,32
067 Prad am Stilfser Joch,1,,17,16,33
067 Prad am Stilfser Joch,2,,15,12,27
067 Prad am Stilfser Joch,3,,16,19,35
067 Prad am Stilfser Joch,4,,22,16,38
067 Prad am Stilfser Joch,5,,20,20,40
067 Prad am Stilfser Joch,6,,13,14,27
067 Prad am Stilfser Joch,7,,11,17,28
067 Prad am Stilfser Joch,8,,24,16,40
067 Prad am Stilfser Joch,9,,17,18,35
067 Prad am Stilfser Joch,10,,19,20,39
067 Prad am Stilfser Joch,11,,22,23,45
067 Prad am Stilfser Joch,12,,27,17,44
067 Prad am Stilfser Joch,13,,22,21,43
067 Prad am Stilfser Joch,14,,20,13,33
067 Prad am Stilfser Joch,15,,23,30,53
067 Prad am Stilfser Joch,16,,23,28,51
067 Prad am Stilfser Joch,17,,17,20,37
067 Prad am Stilfser Joch,18,,21,11,32
067 Prad am Stilfser Joch,19,,20,22,42
067 Prad am Stilfser Joch,20,,19,23,42
067 Prad am Stilfser Joch,21,,28,16,44
067 Prad am Stilfser Joch,22,,12,21,33
067 Prad am Stilfser Joch,23,,26,26,52
067 Prad am Stilfser Joch,24,,31,26,57
067 Prad am Stilfser Joch,25,,30,26,56
067 Prad am Stilfser Joch,26,,28,27,55
067 Prad am Stilfser Joch,27,,26,24,50
067 Prad am Stilfser Joch,28,,24,25,49
067 Prad am Stilfser Joch,29,,28,21,49
067 Prad am Stilfser Joch,30,,17,20,37
067 Prad am Stilfser Joch,31,,22,19,41
067 Prad am Stilfser Joch,32,,21,31,52
067 Prad am Stilfser Joch,33,,25,21,46
067 Prad am Stilfser Joch,34,,20,20,40
067 Prad am Stilfser Joch,35,,30,16,46
067 Prad am Stilfser Joch,36,,21,42,63
067 Prad am Stilfser Joch,37,,25,25,50
067 Prad am Stilfser Joch,38,,27,26,53
067 Prad am Stilfser Joch,39,,27,23,50
067 Prad am Stilfser Joch,40,,29,28,57
067 Prad am Stilfser Joch,41,,32,33,65
067 Prad am Stilfser Joch,42,,27,24,51
067 Prad am Stilfser Joch,43,,35,26,61
067 Prad am Stilfser Joch,44,,33,26,59
067 Prad am Stilfser Joch,45,,26,26,52
067 Prad am Stilfser Joch,46,,27,10,37
067 Prad am Stilfser Joch,47,,28,32,60
067 Prad am Stilfser Joch,48,,21,26,47
067 Prad am Stilfser Joch,49,,18,25,43
067 Prad am Stilfser Joch,50,,34,15,49
067 Prad am Stilfser Joch,51,,18,28,46
067 Prad am Stilfser Joch,52,,25,26,51
067 Prad am Stilfser Joch,53,,25,24,49
067 Prad am Stilfser Joch,54,,24,18,42
067 Prad am Stilfser Joch,55,,28,16,44
067 Prad am Stilfser Joch,56,,26,18,44
067 Prad am Stilfser Joch,57,,14,20,34
067 Prad am Stilfser Joch,58,,18,22,40
067 Prad am Stilfser Joch,59,,19,17,36
067 Prad am Stilfser Joch,60,,21,21,42
067 Prad am Stilfser Joch,61,,19,11,30
067 Prad am Stilfser Joch,62,,15,12,27
067 Prad am Stilfser Joch,63,,17,14,31
067 Prad am Stilfser Joch,64,,15,11,26
067 Prad am Stilfser Joch,65,,11,15,26
067 Prad am Stilfser Joch,66,,23,17,40
067 Prad am Stilfser Joch,67,,15,16,31
067 Prad am Stilfser Joch,68,,25,8,33
067 Prad am Stilfser Joch,69,,7,17,24
067 Prad am Stilfser Joch,70,,13,16,29
067 Prad am Stilfser Joch,71,,16,15,31
067 Prad am Stilfser Joch,72,,8,11,19
067 Prad am Stilfser Joch,73,,9,10,19
067 Prad am Stilfser Joch,74,,15,12,27
067 Prad am Stilfser Joch,75,,6,22,28
067 Prad am Stilfser Joch,76,,12,10,22
067 Prad am Stilfser Joch,77,,9,18,27
067 Prad am Stilfser Joch,78,,6,12,18
067 Prad am Stilfser Joch,79,,11,11,22
067 Prad am Stilfser Joch,80,,10,13,23
067 Prad am Stilfser Joch,81,,6,8,14
067 Prad am Stilfser Joch,82,,5,11,16
067 Prad am Stilfser Joch,83,,5,8,13
067 Prad am Stilfser Joch,84,,6,4,10
067 Prad am Stilfser Joch,85,,2,6,8
067 Prad am Stilfser Joch,86,,2,9,11
067 Prad am Stilfser Joch,87,,2,9,11
067 Prad am Stilfser Joch,88,,2,4,6
067 Prad am Stilfser Joch,89,,2,4,6
067 Prad am Stilfser Joch,90,,3,2,5
067 Prad am Stilfser Joch,91,,-,2,2
067 Prad am Stilfser Joch,92,,-,2,2
067 Prad am Stilfser Joch,93,,-,1,1
067 Prad am Stilfser Joch,94,,1,-,1
067 Prad am Stilfser Joch,95,,-,1,1
067 Prad am Stilfser Joch,97,,2,-,2
068 Prettau,0,,1,1,2
068 Prettau,1,,7,3,10
068 Prettau,2,,5,2,7
068 Prettau,3,,4,5,9
068 Prettau,4,,2,1,3
068 Prettau,5,,4,5,9
068 Prettau,6,,2,4,6
068 Prettau,7,,1,2,3
068 Prettau,8,,3,5,8
068 Prettau,9,,1,4,5
068 Prettau,10,,6,6,12
068 Prettau,11,,6,3,9
068 Prettau,12,,1,5,6
068 Prettau,13,,1,2,3
068 Prettau,14,,4,4,8
068 Prettau,15,,4,7,11
068 Prettau,16,,3,5,8
068 Prettau,17,,3,3,6
068 Prettau,18,,1,4,5
068 Prettau,19,,1,7,8
068 Prettau,20,,-,3,3
068 Prettau,21,,4,3,7
068 Prettau,22,,4,2,6
068 Prettau,23,,1,2,3
068 Prettau,24,,2,1,3
068 Prettau,25,,3,7,10
068 Prettau,26,,4,1,5
068 Prettau,27,,3,2,5
068 Prettau,28,,2,1,3
068 Prettau,29,,4,4,8
068 Prettau,30,,6,2,8
068 Prettau,31,,1,2,3
068 Prettau,32,,4,2,6
068 Prettau,33,,1,2,3
068 Prettau,34,,4,2,6
068 Prettau,35,,5,-,5
068 Prettau,36,,5,6,11
068 Prettau,37,,9,4,13
068 Prettau,38,,4,6,10
068 Prettau,39,,3,6,9
068 Prettau,40,,6,6,12
068 Prettau,41,,3,1,4
068 Prettau,42,,9,3,12
068 Prettau,43,,7,1,8
068 Prettau,44,,5,9,14
068 Prettau,45,,7,6,13
068 Prettau,46,,5,6,11
068 Prettau,47,,2,5,7
068 Prettau,48,,5,5,10
068 Prettau,49,,7,4,11
068 Prettau,50,,5,2,7
068 Prettau,51,,7,-,7
068 Prettau,52,,4,1,5
068 Prettau,53,,6,5,11
068 Prettau,54,,6,5,11
068 Prettau,55,,5,2,7
068 Prettau,56,,3,3,6
068 Prettau,57,,4,3,7
068 Prettau,58,,3,2,5
068 Prettau,59,,2,2,4
068 Prettau,60,,2,3,5
068 Prettau,61,,2,1,3
068 Prettau,62,,4,6,10
068 Prettau,63,,7,4,11
068 Prettau,64,,1,3,4
068 Prettau,65,,6,5,11
068 Prettau,66,,3,2,5
068 Prettau,67,,3,2,5
068 Prettau,68,,3,2,5
068 Prettau,69,,4,4,8
068 Prettau,70,,4,3,7
068 Prettau,71,,5,6,11
068 Prettau,72,,2,6,8
068 Prettau,73,,3,3,6
068 Prettau,74,,3,2,5
068 Prettau,75,,1,3,4
068 Prettau,76,,3,3,6
068 Prettau,77,,3,-,3
068 Prettau,78,,1,1,2
068 Prettau,79,,4,4,8
068 Prettau,80,,4,5,9
068 Prettau,81,,-,1,1
068 Prettau,82,,3,1,4
068 Prettau,83,,1,5,6
068 Prettau,84,,-,1,1
068 Prettau,86,,-,1,1
068 Prettau,87,,2,-,2
068 Prettau,88,,-,1,1
068 Prettau,90,,2,-,2
068 Prettau,91,,1,1,2
068 Prettau,93,,-,2,2
068 Prettau,96,,-,1,1
069 Proveis,0,,3,2,5
069 Proveis,1,,-,1,1
069 Proveis,2,,1,1,2
069 Proveis,3,,1,-,1
069 Proveis,4,,-,4,4
069 Proveis,5,,2,2,4
069 Proveis,6,,2,1,3
069 Proveis,7,,4,-,4
069 Proveis,8,,1,1,2
069 Proveis,9,,-,1,1
069 Proveis,10,,4,-,4
069 Proveis,11,,2,2,4
069 Proveis,12,,1,2,3
069 Proveis,13,,1,1,2
069 Proveis,14,,-,5,5
069 Proveis,15,,2,-,2
069 Proveis,16,,2,1,3
069 Proveis,17,,3,1,4
069 Proveis,18,,3,2,5
069 Proveis,19,,-,1,1
069 Proveis,20,,1,1,2
069 Proveis,21,,2,3,5
069 Proveis,22,,2,2,4
069 Proveis,23,,3,1,4
069 Proveis,24,,5,-,5
069 Proveis,25,,4,4,8
069 Proveis,26,,3,3,6
069 Proveis,27,,3,-,3
069 Proveis,28,,3,3,6
069 Proveis,30,,3,1,4
069 Proveis,31,,1,2,3
069 Proveis,32,,2,2,4
069 Proveis,33,,1,1,2
069 Proveis,34,,2,-,2
069 Proveis,35,,3,2,5
069 Proveis,36,,2,-,2
069 Proveis,37,,1,1,2
069 Proveis,38,,-,1,1
069 Proveis,39,,3,2,5
069 Proveis,40,,3,4,7
069 Proveis,41,,3,1,4
069 Proveis,42,,2,1,3
069 Proveis,43,,2,2,4
069 Proveis,44,,1,1,2
069 Proveis,45,,3,-,3
069 Proveis,46,,4,2,6
069 Proveis,47,,4,2,6
069 Proveis,48,,3,1,4
069 Proveis,49,,-,4,4
069 Proveis,50,,4,-,4
069 Proveis,51,,1,3,4
069 Proveis,52,,2,2,4
069 Proveis,53,,4,2,6
069 Proveis,54,,4,4,8
069 Proveis,55,,3,2,5
069 Proveis,56,,1,1,2
069 Proveis,57,,2,3,5
069 Proveis,58,,2,-,2
069 Proveis,59,,1,1,2
069 Proveis,60,,1,-,1
069 Proveis,61,,2,1,3
069 Proveis,62,,2,2,4
069 Proveis,63,,3,-,3
069 Proveis,64,,1,-,1
069 Proveis,65,,2,-,2
069 Proveis,66,,2,1,3
069 Proveis,67,,1,1,2
069 Proveis,68,,1,1,2
069 Proveis,69,,2,-,2
069 Proveis,70,,1,3,4
069 Proveis,71,,-,2,2
069 Proveis,72,,1,1,2
069 Proveis,73,,2,1,3
069 Proveis,74,,1,1,2
069 Proveis,76,,-,2,2
069 Proveis,77,,-,1,1
069 Proveis,78,,1,1,2
069 Proveis,80,,2,3,5
069 Proveis,81,,3,1,4
069 Proveis,82,,-,1,1
069 Proveis,84,,-,1,1
069 Proveis,85,,1,-,1
069 Proveis,87,,-,1,1
069 Proveis,89,,-,1,1
070 Ratschings,0,,22,20,42
070 Ratschings,1,,20,19,39
070 Ratschings,2,,32,24,56
070 Ratschings,3,,27,26,53
070 Ratschings,4,,26,30,56
070 Ratschings,5,,33,26,59
070 Ratschings,6,,34,25,59
070 Ratschings,7,,16,28,44
070 Ratschings,8,,25,36,61
070 Ratschings,9,,36,25,61
070 Ratschings,10,,28,21,49
070 Ratschings,11,,33,20,53
070 Ratschings,12,,36,33,69
070 Ratschings,13,,29,33,62
070 Ratschings,14,,28,25,53
070 Ratschings,15,,24,28,52
070 Ratschings,16,,25,21,46
070 Ratschings,17,,40,30,70
070 Ratschings,18,,23,23,46
070 Ratschings,19,,32,28,60
070 Ratschings,20,,25,20,45
070 Ratschings,21,,31,28,59
070 Ratschings,22,,29,28,57
070 Ratschings,23,,29,27,56
070 Ratschings,24,,30,31,61
070 Ratschings,25,,22,20,42
070 Ratschings,26,,34,22,56
070 Ratschings,27,,33,31,64
070 Ratschings,28,,29,26,55
070 Ratschings,29,,26,32,58
070 Ratschings,30,,33,31,64
070 Ratschings,31,,31,23,54
070 Ratschings,32,,34,23,57
070 Ratschings,33,,23,23,46
070 Ratschings,34,,37,35,72
070 Ratschings,35,,36,30,66
070 Ratschings,36,,33,35,68
070 Ratschings,37,,42,36,78
070 Ratschings,38,,41,45,86
070 Ratschings,39,,35,41,76
070 Ratschings,40,,38,44,82
070 Ratschings,41,,51,40,91
070 Ratschings,42,,38,40,78
070 Ratschings,43,,43,47,90
070 Ratschings,44,,35,43,78
070 Ratschings,45,,52,39,91
070 Ratschings,46,,47,26,73
070 Ratschings,47,,36,42,78
070 Ratschings,48,,34,28,62
070 Ratschings,49,,41,25,66
070 Ratschings,50,,39,25,64
070 Ratschings,51,,30,27,57
070 Ratschings,52,,33,19,52
070 Ratschings,53,,36,22,58
070 Ratschings,54,,14,33,47
070 Ratschings,55,,26,15,41
070 Ratschings,56,,21,24,45
070 Ratschings,57,,19,19,38
070 Ratschings,58,,19,14,33
070 Ratschings,59,,26,21,47
070 Ratschings,60,,22,25,47
070 Ratschings,61,,28,19,47
070 Ratschings,62,,17,17,34
070 Ratschings,63,,21,7,28
070 Ratschings,64,,19,18,37
070 Ratschings,65,,16,11,27
070 Ratschings,66,,17,12,29
070 Ratschings,67,,19,18,37
070 Ratschings,68,,19,18,37
070 Ratschings,69,,17,16,33
070 Ratschings,70,,13,17,30
070 Ratschings,71,,14,20,34
070 Ratschings,72,,16,9,25
070 Ratschings,73,,11,10,21
070 Ratschings,74,,11,15,26
070 Ratschings,75,,10,9,19
070 Ratschings,76,,14,18,32
070 Ratschings,77,,13,11,24
070 Ratschings,78,,8,11,19
070 Ratschings,79,,7,15,22
070 Ratschings,80,,8,19,27
070 Ratschings,81,,6,11,17
070 Ratschings,82,,8,11,19
070 Ratschings,83,,8,10,18
070 Ratschings,84,,6,6,12
070 Ratschings,85,,5,8,13
070 Ratschings,86,,3,6,9
070 Ratschings,87,,1,4,5
070 Ratschings,88,,1,7,8
070 Ratschings,89,,2,6,8
070 Ratschings,90,,1,-,1
070 Ratschings,91,,-,3,3
070 Ratschings,94,,-,1,1
070 Ratschings,95,,-,1,1
071 Rasen-Antholz,0,,18,19,37
071 Rasen-Antholz,1,,18,7,25
071 Rasen-Antholz,2,,20,17,37
071 Rasen-Antholz,3,,16,21,37
071 Rasen-Antholz,4,,27,14,41
071 Rasen-Antholz,5,,14,21,35
071 Rasen-Antholz,6,,9,23,32
071 Rasen-Antholz,7,,14,21,35
071 Rasen-Antholz,8,,19,19,38
071 Rasen-Antholz,9,,25,21,46
071 Rasen-Antholz,10,,14,19,33
071 Rasen-Antholz,11,,19,14,33
071 Rasen-Antholz,12,,27,22,49
071 Rasen-Antholz,13,,28,19,47
071 Rasen-Antholz,14,,8,15,23
071 Rasen-Antholz,15,,20,11,31
071 Rasen-Antholz,16,,18,15,33
071 Rasen-Antholz,17,,25,20,45
071 Rasen-Antholz,18,,15,14,29
071 Rasen-Antholz,19,,14,25,39
071 Rasen-Antholz,20,,19,17,36
071 Rasen-Antholz,21,,19,21,40
071 Rasen-Antholz,22,,26,9,35
071 Rasen-Antholz,23,,17,21,38
071 Rasen-Antholz,24,,24,13,37
071 Rasen-Antholz,25,,18,21,39
071 Rasen-Antholz,26,,15,17,32
071 Rasen-Antholz,27,,25,21,46
071 Rasen-Antholz,28,,14,18,32
071 Rasen-Antholz,29,,18,15,33
071 Rasen-Antholz,30,,19,22,41
071 Rasen-Antholz,31,,16,23,39
071 Rasen-Antholz,32,,17,19,36
071 Rasen-Antholz,33,,23,14,37
071 Rasen-Antholz,34,,18,26,44
071 Rasen-Antholz,35,,27,19,46
071 Rasen-Antholz,36,,31,25,56
071 Rasen-Antholz,37,,25,20,45
071 Rasen-Antholz,38,,25,24,49
071 Rasen-Antholz,39,,25,24,49
071 Rasen-Antholz,40,,26,27,53
071 Rasen-Antholz,41,,23,27,50
071 Rasen-Antholz,42,,26,27,53
071 Rasen-Antholz,43,,29,20,49
071 Rasen-Antholz,44,,35,24,59
071 Rasen-Antholz,45,,30,24,54
071 Rasen-Antholz,46,,18,22,40
071 Rasen-Antholz,47,,28,20,48
071 Rasen-Antholz,48,,22,25,47
071 Rasen-Antholz,49,,21,23,44
071 Rasen-Antholz,50,,28,18,46
071 Rasen-Antholz,51,,24,15,39
071 Rasen-Antholz,52,,22,9,31
071 Rasen-Antholz,53,,18,14,32
071 Rasen-Antholz,54,,19,14,33
071 Rasen-Antholz,55,,14,13,27
071 Rasen-Antholz,56,,14,9,23
071 Rasen-Antholz,57,,12,15,27
071 Rasen-Antholz,58,,12,11,23
071 Rasen-Antholz,59,,13,8,21
071 Rasen-Antholz,60,,14,8,22
071 Rasen-Antholz,61,,14,11,25
071 Rasen-Antholz,62,,9,14,23
071 Rasen-Antholz,63,,9,14,23
071 Rasen-Antholz,64,,11,9,20
071 Rasen-Antholz,65,,10,8,18
071 Rasen-Antholz,66,,13,12,25
071 Rasen-Antholz,67,,11,15,26
071 Rasen-Antholz,68,,15,12,27
071 Rasen-Antholz,69,,10,17,27
071 Rasen-Antholz,70,,16,13,29
071 Rasen-Antholz,71,,13,7,20
071 Rasen-Antholz,72,,8,11,19
071 Rasen-Antholz,73,,9,12,21
071 Rasen-Antholz,74,,9,8,17
071 Rasen-Antholz,75,,11,10,21
071 Rasen-Antholz,76,,8,14,22
071 Rasen-Antholz,77,,11,11,22
071 Rasen-Antholz,78,,11,14,25
071 Rasen-Antholz,79,,4,9,13
071 Rasen-Antholz,80,,9,3,12
071 Rasen-Antholz,81,,2,3,5
071 Rasen-Antholz,82,,4,5,9
071 Rasen-Antholz,83,,5,6,11
071 Rasen-Antholz,84,,7,8,15
071 Rasen-Antholz,85,,4,10,14
071 Rasen-Antholz,86,,-,8,8
071 Rasen-Antholz,87,,2,4,6
071 Rasen-Antholz,88,,5,1,6
071 Rasen-Antholz,89,,1,3,4
071 Rasen-Antholz,90,,1,4,5
071 Rasen-Antholz,91,,-,2,2
071 Rasen-Antholz,92,,-,2,2
071 Rasen-Antholz,93,,-,1,1
071 Rasen-Antholz,94,,1,-,1
071 Rasen-Antholz,95,,1,-,1
071 Rasen-Antholz,104,,-,1,1
072 Ritten,0,,42,40,82
072 Ritten,1,,34,56,90
072 Ritten,2,,45,50,95
072 Ritten,3,,55,48,103
072 Ritten,4,,44,50,94
072 Ritten,5,,47,53,100
072 Ritten,6,,49,42,91
072 Ritten,7,,36,50,86
072 Ritten,8,,52,45,97
072 Ritten,9,,47,46,93
072 Ritten,10,,51,53,104
072 Ritten,11,,42,42,84
072 Ritten,12,,59,55,114
072 Ritten,13,,41,51,92
072 Ritten,14,,56,43,99
072 Ritten,15,,61,44,105
072 Ritten,16,,59,50,109
072 Ritten,17,,45,69,114
072 Ritten,18,,62,51,113
072 Ritten,19,,62,47,109
072 Ritten,20,,53,41,94
072 Ritten,21,,56,50,106
072 Ritten,22,,48,39,87
072 Ritten,23,,49,46,95
072 Ritten,24,,43,53,96
072 Ritten,25,,47,23,70
072 Ritten,26,,48,48,96
072 Ritten,27,,43,54,97
072 Ritten,28,,49,56,105
072 Ritten,29,,46,47,93
072 Ritten,30,,50,51,101
072 Ritten,31,,49,43,92
072 Ritten,32,,63,37,100
072 Ritten,33,,48,51,99
072 Ritten,34,,59,44,103
072 Ritten,35,,59,62,121
072 Ritten,36,,60,49,109
072 Ritten,37,,51,63,114
072 Ritten,38,,55,66,121
072 Ritten,39,,51,71,122
072 Ritten,40,,48,73,121
072 Ritten,41,,71,61,132
072 Ritten,42,,71,49,120
072 Ritten,43,,60,48,108
072 Ritten,44,,77,43,120
072 Ritten,45,,67,60,127
072 Ritten,46,,62,49,111
072 Ritten,47,,54,60,114
072 Ritten,48,,47,57,104
072 Ritten,49,,64,56,120
072 Ritten,50,,70,54,124
072 Ritten,51,,36,46,82
072 Ritten,52,,41,40,81
072 Ritten,53,,52,46,98
072 Ritten,54,,52,42,94
072 Ritten,55,,39,34,73
072 Ritten,56,,48,33,81
072 Ritten,57,,41,44,85
072 Ritten,58,,42,35,77
072 Ritten,59,,33,42,75
072 Ritten,60,,35,48,83
072 Ritten,61,,49,36,85
072 Ritten,62,,34,29,63
072 Ritten,63,,27,37,64
072 Ritten,64,,20,28,48
072 Ritten,65,,34,40,74
072 Ritten,66,,34,39,73
072 Ritten,67,,43,34,77
072 Ritten,68,,36,38,74
072 Ritten,69,,35,23,58
072 Ritten,70,,37,31,68
072 Ritten,71,,31,33,64
072 Ritten,72,,25,24,49
072 Ritten,73,,20,24,44
072 Ritten,74,,21,27,48
072 Ritten,75,,24,27,51
072 Ritten,76,,12,26,38
072 Ritten,77,,16,21,37
072 Ritten,78,,11,28,39
072 Ritten,79,,9,20,29
072 Ritten,80,,18,19,37
072 Ritten,81,,11,12,23
072 Ritten,82,,12,13,25
072 Ritten,83,,11,15,26
072 Ritten,84,,6,29,35
072 Ritten,85,,11,17,28
072 Ritten,86,,14,22,36
072 Ritten,87,,2,15,17
072 Ritten,88,,4,16,20
072 Ritten,89,,5,13,18
072 Ritten,90,,1,6,7
072 Ritten,91,,-,5,5
072 Ritten,92,,2,3,5
072 Ritten,93,,-,2,2
072 Ritten,94,,3,4,7
072 Ritten,95,,1,2,3
072 Ritten,96,,1,1,2
072 Ritten,97,,1,-,1
072 Ritten,98,,1,1,2
072 Ritten,99,,-,1,1
073 Riffian,0,,6,10,16
073 Riffian,1,,11,6,17
073 Riffian,2,,11,9,20
073 Riffian,3,,5,7,12
073 Riffian,4,,9,7,16
073 Riffian,5,,6,3,9
073 Riffian,6,,8,8,16
073 Riffian,7,,9,6,15
073 Riffian,8,,11,8,19
073 Riffian,9,,10,7,17
073 Riffian,10,,9,9,18
073 Riffian,11,,10,6,16
073 Riffian,12,,10,8,18
073 Riffian,13,,6,8,14
073 Riffian,14,,6,10,16
073 Riffian,15,,6,8,14
073 Riffian,16,,6,6,12
073 Riffian,17,,9,9,18
073 Riffian,18,,10,14,24
073 Riffian,19,,7,7,14
073 Riffian,20,,13,4,17
073 Riffian,21,,7,10,17
073 Riffian,22,,6,9,15
073 Riffian,23,,8,5,13
073 Riffian,24,,9,3,12
073 Riffian,25,,8,7,15
073 Riffian,26,,10,9,19
073 Riffian,27,,8,12,20
073 Riffian,28,,6,9,15
073 Riffian,29,,3,8,11
073 Riffian,30,,8,9,17
073 Riffian,31,,13,7,20
073 Riffian,32,,14,14,28
073 Riffian,33,,10,1,11
073 Riffian,34,,9,13,22
073 Riffian,35,,11,10,21
073 Riffian,36,,8,10,18
073 Riffian,37,,11,26,37
073 Riffian,38,,13,14,27
073 Riffian,39,,7,9,16
073 Riffian,40,,13,15,28
073 Riffian,41,,8,13,21
073 Riffian,42,,12,13,25
073 Riffian,43,,13,5,18
073 Riffian,44,,10,5,15
073 Riffian,45,,11,7,18
073 Riffian,46,,16,13,29
073 Riffian,47,,10,12,22
073 Riffian,48,,9,8,17
073 Riffian,49,,13,5,18
073 Riffian,50,,7,13,20
073 Riffian,51,,8,7,15
073 Riffian,52,,6,9,15
073 Riffian,53,,10,5,15
073 Riffian,54,,3,8,11
073 Riffian,55,,11,6,17
073 Riffian,56,,7,5,12
073 Riffian,57,,7,4,11
073 Riffian,58,,6,10,16
073 Riffian,59,,4,3,7
073 Riffian,60,,6,6,12
073 Riffian,61,,6,2,8
073 Riffian,62,,3,4,7
073 Riffian,63,,2,7,9
073 Riffian,64,,6,3,9
073 Riffian,65,,8,8,16
073 Riffian,66,,6,7,13
073 Riffian,67,,14,7,21
073 Riffian,68,,7,3,10
073 Riffian,69,,4,3,7
073 Riffian,70,,3,9,12
073 Riffian,71,,8,4,12
073 Riffian,72,,4,5,9
073 Riffian,73,,3,5,8
073 Riffian,74,,-,3,3
073 Riffian,75,,-,3,3
073 Riffian,76,,4,5,9
073 Riffian,77,,1,4,5
073 Riffian,78,,4,8,12
073 Riffian,79,,4,4,8
073 Riffian,80,,1,7,8
073 Riffian,81,,2,5,7
073 Riffian,82,,3,4,7
073 Riffian,83,,4,3,7
073 Riffian,84,,3,1,4
073 Riffian,85,,3,2,5
073 Riffian,86,,3,5,8
073 Riffian,87,,1,-,1
073 Riffian,88,,-,3,3
073 Riffian,89,,-,2,2
073 Riffian,92,,-,2,2
073 Riffian,94,,-,1,1
073 Riffian,95,,-,1,1
074 Mühlbach,0,,15,13,28
074 Mühlbach,1,,17,16,33
074 Mühlbach,2,,18,20,38
074 Mühlbach,3,,15,8,23
074 Mühlbach,4,,14,9,23
074 Mühlbach,5,,15,21,36
074 Mühlbach,6,,22,10,32
074 Mühlbach,7,,19,17,36
074 Mühlbach,8,,13,19,32
074 Mühlbach,9,,15,19,34
074 Mühlbach,10,,18,14,32
074 Mühlbach,11,,19,20,39
074 Mühlbach,12,,20,16,36
074 Mühlbach,13,,18,17,35
074 Mühlbach,14,,13,14,27
074 Mühlbach,15,,23,14,37
074 Mühlbach,16,,16,21,37
074 Mühlbach,17,,15,24,39
074 Mühlbach,18,,15,19,34
074 Mühlbach,19,,13,16,29
074 Mühlbach,20,,14,18,32
074 Mühlbach,21,,21,15,36
074 Mühlbach,22,,21,13,34
074 Mühlbach,23,,14,11,25
074 Mühlbach,24,,19,24,43
074 Mühlbach,25,,19,23,42
074 Mühlbach,26,,22,21,43
074 Mühlbach,27,,26,32,58
074 Mühlbach,28,,25,18,43
074 Mühlbach,29,,21,18,39
074 Mühlbach,30,,21,17,38
074 Mühlbach,31,,26,26,52
074 Mühlbach,32,,27,19,46
074 Mühlbach,33,,18,23,41
074 Mühlbach,34,,19,17,36
074 Mühlbach,35,,21,17,38
074 Mühlbach,36,,23,15,38
074 Mühlbach,37,,23,19,42
074 Mühlbach,38,,29,27,56
074 Mühlbach,39,,24,15,39
074 Mühlbach,40,,26,34,60
074 Mühlbach,41,,36,17,53
074 Mühlbach,42,,25,19,44
074 Mühlbach,43,,27,17,44
074 Mühlbach,44,,23,23,46
074 Mühlbach,45,,15,23,38
074 Mühlbach,46,,21,20,41
074 Mühlbach,47,,21,17,38
074 Mühlbach,48,,26,24,50
074 Mühlbach,49,,22,16,38
074 Mühlbach,50,,22,19,41
074 Mühlbach,51,,18,13,31
074 Mühlbach,52,,17,20,37
074 Mühlbach,53,,21,24,45
074 Mühlbach,54,,22,17,39
074 Mühlbach,55,,13,21,34
074 Mühlbach,56,,18,18,36
074 Mühlbach,57,,16,21,37
074 Mühlbach,58,,13,20,33
074 Mühlbach,59,,21,18,39
074 Mühlbach,60,,15,13,28
074 Mühlbach,61,,16,13,29
074 Mühlbach,62,,10,19,29
074 Mühlbach,63,,21,11,32
074 Mühlbach,64,,9,8,17
074 Mühlbach,65,,14,12,26
074 Mühlbach,66,,11,10,21
074 Mühlbach,67,,15,13,28
074 Mühlbach,68,,17,17,34
074 Mühlbach,69,,12,11,23
074 Mühlbach,70,,11,17,28
074 Mühlbach,71,,13,8,21
074 Mühlbach,72,,5,11,16
074 Mühlbach,73,,7,6,13
074 Mühlbach,74,,7,10,17
074 Mühlbach,75,,11,13,24
074 Mühlbach,76,,9,10,19
074 Mühlbach,77,,5,8,13
074 Mühlbach,78,,6,10,16
074 Mühlbach,79,,8,7,15
074 Mühlbach,80,,6,2,8
074 Mühlbach,81,,5,16,21
074 Mühlbach,82,,4,6,10
074 Mühlbach,83,,5,7,12
074 Mühlbach,84,,4,6,10
074 Mühlbach,85,,4,5,9
074 Mühlbach,86,,3,4,7
074 Mühlbach,87,,1,9,10
074 Mühlbach,88,,1,3,4
074 Mühlbach,89,,2,7,9
074 Mühlbach,90,,1,4,5
074 Mühlbach,91,,-,1,1
074 Mühlbach,95,,-,1,1
074 Mühlbach,96,,-,1,1
074 Mühlbach,97,,-,1,1
075 Rodeneck,0,,3,6,9
075 Rodeneck,1,,6,10,16
075 Rodeneck,2,,7,6,13
075 Rodeneck,3,,3,3,6
075 Rodeneck,4,,9,6,15
075 Rodeneck,5,,6,4,10
075 Rodeneck,6,,8,7,15
075 Rodeneck,7,,8,3,11
075 Rodeneck,8,,10,3,13
075 Rodeneck,9,,7,14,21
075 Rodeneck,10,,8,10,18
075 Rodeneck,11,,12,7,19
075 Rodeneck,12,,10,8,18
075 Rodeneck,13,,13,8,21
075 Rodeneck,14,,5,9,14
075 Rodeneck,15,,6,11,17
075 Rodeneck,16,,6,7,13
075 Rodeneck,17,,12,10,22
075 Rodeneck,18,,6,8,14
075 Rodeneck,19,,13,8,21
075 Rodeneck,20,,7,6,13
075 Rodeneck,21,,12,8,20
075 Rodeneck,22,,6,5,11
075 Rodeneck,23,,7,11,18
075 Rodeneck,24,,14,9,23
075 Rodeneck,25,,15,9,24
075 Rodeneck,26,,10,9,19
075 Rodeneck,27,,6,3,9
075 Rodeneck,28,,11,5,16
075 Rodeneck,29,,9,12,21
075 Rodeneck,30,,10,3,13
075 Rodeneck,31,,6,8,14
075 Rodeneck,32,,6,8,14
075 Rodeneck,33,,8,7,15
075 Rodeneck,34,,8,8,16
075 Rodeneck,35,,5,4,9
075 Rodeneck,36,,15,10,25
075 Rodeneck,37,,8,8,16
075 Rodeneck,38,,14,5,19
075 Rodeneck,39,,9,11,20
075 Rodeneck,40,,15,12,27
075 Rodeneck,41,,8,11,19
075 Rodeneck,42,,11,10,21
075 Rodeneck,43,,15,8,23
075 Rodeneck,44,,8,8,16
075 Rodeneck,45,,12,13,25
075 Rodeneck,46,,9,10,19
075 Rodeneck,47,,9,12,21
075 Rodeneck,48,,9,12,21
075 Rodeneck,49,,6,10,16
075 Rodeneck,50,,10,6,16
075 Rodeneck,51,,8,5,13
075 Rodeneck,52,,6,7,13
075 Rodeneck,53,,8,4,12
075 Rodeneck,54,,7,6,13
075 Rodeneck,55,,12,4,16
075 Rodeneck,56,,3,1,4
075 Rodeneck,57,,7,4,11
075 Rodeneck,58,,3,3,6
075 Rodeneck,59,,2,8,10
075 Rodeneck,60,,2,6,8
075 Rodeneck,61,,4,7,11
075 Rodeneck,62,,5,4,9
075 Rodeneck,63,,10,7,17
075 Rodeneck,64,,2,5,7
075 Rodeneck,65,,3,5,8
075 Rodeneck,66,,2,2,4
075 Rodeneck,67,,2,6,8
075 Rodeneck,68,,10,3,13
075 Rodeneck,69,,5,4,9
075 Rodeneck,70,,3,9,12
075 Rodeneck,71,,3,3,6
075 Rodeneck,72,,2,4,6
075 Rodeneck,73,,2,4,6
075 Rodeneck,74,,3,2,5
075 Rodeneck,75,,1,10,11
075 Rodeneck,76,,3,-,3
075 Rodeneck,77,,6,5,11
075 Rodeneck,78,,4,2,6
075 Rodeneck,79,,4,5,9
075 Rodeneck,80,,7,1,8
075 Rodeneck,81,,3,4,7
075 Rodeneck,82,,1,3,4
075 Rodeneck,83,,2,4,6
075 Rodeneck,84,,1,5,6
075 Rodeneck,85,,3,2,5
075 Rodeneck,86,,2,1,3
075 Rodeneck,87,,-,2,2
075 Rodeneck,88,,2,-,2
075 Rodeneck,89,,2,-,2
075 Rodeneck,90,,2,-,2
075 Rodeneck,91,,-,2,2
076 Salurn,0,,19,28,47
076 Salurn,1,,25,22,47
076 Salurn,2,,22,30,52
076 Salurn,3,,25,21,46
076 Salurn,4,,17,25,42
076 Salurn,5,,22,17,39
076 Salurn,6,,27,18,45
076 Salurn,7,,17,17,34
076 Salurn,8,,13,18,31
076 Salurn,9,,19,18,37
076 Salurn,10,,20,13,33
076 Salurn,11,,19,25,44
076 Salurn,12,,13,12,25
076 Salurn,13,,26,24,50
076 Salurn,14,,21,17,38
076 Salurn,15,,21,20,41
076 Salurn,16,,19,18,37
076 Salurn,17,,24,19,43
076 Salurn,18,,13,20,33
076 Salurn,19,,14,16,30
076 Salurn,20,,19,20,39
076 Salurn,21,,20,26,46
076 Salurn,22,,24,23,47
076 Salurn,23,,14,18,32
076 Salurn,24,,16,23,39
076 Salurn,25,,13,24,37
076 Salurn,26,,19,26,45
076 Salurn,27,,24,18,42
076 Salurn,28,,17,27,44
076 Salurn,29,,23,28,51
076 Salurn,30,,17,24,41
076 Salurn,31,,23,24,47
076 Salurn,32,,32,25,57
076 Salurn,33,,28,20,48
076 Salurn,34,,29,26,55
076 Salurn,35,,27,21,48
076 Salurn,36,,24,30,54
076 Salurn,37,,29,24,53
076 Salurn,38,,42,26,68
076 Salurn,39,,29,32,61
076 Salurn,40,,28,29,57
076 Salurn,41,,33,25,58
076 Salurn,42,,27,23,50
076 Salurn,43,,28,28,56
076 Salurn,44,,28,33,61
076 Salurn,45,,33,32,65
076 Salurn,46,,42,28,70
076 Salurn,47,,32,29,61
076 Salurn,48,,30,32,62
076 Salurn,49,,22,30,52
076 Salurn,50,,31,28,59
076 Salurn,51,,30,20,50
076 Salurn,52,,21,23,44
076 Salurn,53,,18,13,31
076 Salurn,54,,20,19,39
076 Salurn,55,,21,18,39
076 Salurn,56,,17,19,36
076 Salurn,57,,30,19,49
076 Salurn,58,,28,21,49
076 Salurn,59,,23,16,39
076 Salurn,60,,27,11,38
076 Salurn,61,,14,21,35
076 Salurn,62,,17,21,38
076 Salurn,63,,22,17,39
076 Salurn,64,,12,10,22
076 Salurn,65,,19,18,37
076 Salurn,66,,19,17,36
076 Salurn,67,,19,16,35
076 Salurn,68,,16,16,32
076 Salurn,69,,14,10,24
076 Salurn,70,,12,9,21
076 Salurn,71,,6,10,16
076 Salurn,72,,12,12,24
076 Salurn,73,,13,20,33
076 Salurn,74,,13,17,30
076 Salurn,75,,10,8,18
076 Salurn,76,,11,7,18
076 Salurn,77,,8,17,25
076 Salurn,78,,5,11,16
076 Salurn,79,,11,10,21
076 Salurn,80,,13,10,23
076 Salurn,81,,7,18,25
076 Salurn,82,,2,17,19
076 Salurn,83,,6,11,17
076 Salurn,84,,5,15,20
076 Salurn,85,,3,11,14
076 Salurn,86,,3,4,7
076 Salurn,87,,4,11,15
076 Salurn,88,,1,9,10
076 Salurn,89,,7,8,15
076 Salurn,90,,2,8,10
076 Salurn,91,,1,3,4
076 Salurn,92,,-,2,2
076 Salurn,93,,-,1,1
076 Salurn,94,,1,2,3
076 Salurn,95,,-,1,1
076 Salurn,97,,1,-,1
076 Salurn,98,,-,2,2
077 Innichen,0,,10,16,26
077 Innichen,1,,23,13,36
077 Innichen,2,,14,17,31
077 Innichen,3,,12,14,26
077 Innichen,4,,14,20,34
077 Innichen,5,,13,13,26
077 Innichen,6,,17,16,33
077 Innichen,7,,16,16,32
077 Innichen,8,,24,17,41
077 Innichen,9,,16,17,33
077 Innichen,10,,11,16,27
077 Innichen,11,,21,14,35
077 Innichen,12,,20,16,36
077 Innichen,13,,16,18,34
077 Innichen,14,,22,12,34
077 Innichen,15,,18,16,34
077 Innichen,16,,23,21,44
077 Innichen,17,,21,16,37
077 Innichen,18,,19,26,45
077 Innichen,19,,17,14,31
077 Innichen,20,,18,20,38
077 Innichen,21,,27,19,46
077 Innichen,22,,22,23,45
077 Innichen,23,,20,18,38
077 Innichen,24,,22,22,44
077 Innichen,25,,22,18,40
077 Innichen,26,,24,22,46
077 Innichen,27,,23,23,46
077 Innichen,28,,16,19,35
077 Innichen,29,,25,20,45
077 Innichen,30,,28,27,55
077 Innichen,31,,13,20,33
077 Innichen,32,,19,26,45
077 Innichen,33,,17,27,44
077 Innichen,34,,20,14,34
077 Innichen,35,,24,18,42
077 Innichen,36,,23,18,41
077 Innichen,37,,23,25,48
077 Innichen,38,,25,18,43
077 Innichen,39,,24,30,54
077 Innichen,40,,20,28,48
077 Innichen,41,,24,23,47
077 Innichen,42,,26,29,55
077 Innichen,43,,26,30,56
077 Innichen,44,,36,31,67
077 Innichen,45,,29,31,60
077 Innichen,46,,27,26,53
077 Innichen,47,,29,24,53
077 Innichen,48,,25,26,51
077 Innichen,49,,31,18,49
077 Innichen,50,,25,22,47
077 Innichen,51,,21,24,45
077 Innichen,52,,17,26,43
077 Innichen,53,,25,15,40
077 Innichen,54,,25,21,46
077 Innichen,55,,24,10,34
077 Innichen,56,,24,17,41
077 Innichen,57,,11,25,36
077 Innichen,58,,13,18,31
077 Innichen,59,,16,20,36
077 Innichen,60,,20,16,36
077 Innichen,61,,18,12,30
077 Innichen,62,,11,14,25
077 Innichen,63,,13,17,30
077 Innichen,64,,10,8,18
077 Innichen,65,,8,13,21
077 Innichen,66,,23,9,32
077 Innichen,67,,17,20,37
077 Innichen,68,,14,20,34
077 Innichen,69,,7,23,30
077 Innichen,70,,12,12,24
077 Innichen,71,,7,11,18
077 Innichen,72,,11,10,21
077 Innichen,73,,8,19,27
077 Innichen,74,,6,20,26
077 Innichen,75,,11,13,24
077 Innichen,76,,10,9,19
077 Innichen,77,,10,19,29
077 Innichen,78,,11,18,29
077 Innichen,79,,15,12,27
077 Innichen,80,,11,14,25
077 Innichen,81,,11,16,27
077 Innichen,82,,3,13,16
077 Innichen,83,,11,12,23
077 Innichen,84,,5,17,22
077 Innichen,85,,6,2,8
077 Innichen,86,,3,11,14
077 Innichen,87,,1,8,9
077 Innichen,88,,3,10,13
077 Innichen,89,,2,11,13
077 Innichen,90,,2,1,3
077 Innichen,91,,-,2,2
077 Innichen,92,,1,2,3
077 Innichen,93,,1,2,3
077 Innichen,94,,1,3,4
077 Innichen,96,,-,1,1
077 Innichen,97,,1,1,2
079 Jenesien,0,,18,16,34
079 Jenesien,1,,20,23,43
079 Jenesien,2,,21,18,39
079 Jenesien,3,,21,22,43
079 Jenesien,4,,15,17,32
079 Jenesien,5,,18,18,36
079 Jenesien,6,,17,22,39
079 Jenesien,7,,13,17,30
079 Jenesien,8,,17,22,39
079 Jenesien,9,,17,19,36
079 Jenesien,10,,26,23,49
079 Jenesien,11,,18,28,46
079 Jenesien,12,,20,18,38
079 Jenesien,13,,24,11,35
079 Jenesien,14,,25,17,42
079 Jenesien,15,,21,21,42
079 Jenesien,16,,15,18,33
079 Jenesien,17,,29,22,51
079 Jenesien,18,,18,20,38
079 Jenesien,19,,18,14,32
079 Jenesien,20,,18,13,31
079 Jenesien,21,,23,15,38
079 Jenesien,22,,15,21,36
079 Jenesien,23,,17,18,35
079 Jenesien,24,,16,6,22
079 Jenesien,25,,16,15,31
079 Jenesien,26,,17,19,36
079 Jenesien,27,,16,17,33
079 Jenesien,28,,13,17,30
079 Jenesien,29,,18,16,34
079 Jenesien,30,,21,17,38
079 Jenesien,31,,14,15,29
079 Jenesien,32,,19,18,37
079 Jenesien,33,,17,18,35
079 Jenesien,34,,11,18,29
079 Jenesien,35,,23,25,48
079 Jenesien,36,,20,32,52
079 Jenesien,37,,25,26,51
079 Jenesien,38,,29,26,55
079 Jenesien,39,,32,33,65
079 Jenesien,40,,32,20,52
079 Jenesien,41,,19,27,46
079 Jenesien,42,,17,24,41
079 Jenesien,43,,38,29,67
079 Jenesien,44,,35,29,64
079 Jenesien,45,,35,34,69
079 Jenesien,46,,25,24,49
079 Jenesien,47,,27,21,48
079 Jenesien,48,,30,21,51
079 Jenesien,49,,26,12,38
079 Jenesien,50,,23,16,39
079 Jenesien,51,,22,9,31
079 Jenesien,52,,13,18,31
079 Jenesien,53,,16,12,28
079 Jenesien,54,,10,12,22
079 Jenesien,55,,20,13,33
079 Jenesien,56,,13,10,23
079 Jenesien,57,,11,20,31
079 Jenesien,58,,13,10,23
079 Jenesien,59,,12,21,33
079 Jenesien,60,,11,13,24
079 Jenesien,61,,11,7,18
079 Jenesien,62,,14,11,25
079 Jenesien,63,,9,10,19
079 Jenesien,64,,8,14,22
079 Jenesien,65,,13,12,25
079 Jenesien,66,,17,9,26
079 Jenesien,67,,14,11,25
079 Jenesien,68,,14,22,36
079 Jenesien,69,,16,11,27
079 Jenesien,70,,14,18,32
079 Jenesien,71,,17,9,26
079 Jenesien,72,,10,16,26
079 Jenesien,73,,5,18,23
079 Jenesien,74,,6,8,14
079 Jenesien,75,,8,7,15
079 Jenesien,76,,16,10,26
079 Jenesien,77,,5,9,14
079 Jenesien,78,,8,7,15
079 Jenesien,79,,6,12,18
079 Jenesien,80,,4,15,19
079 Jenesien,81,,7,8,15
079 Jenesien,82,,3,9,12
079 Jenesien,83,,7,12,19
079 Jenesien,84,,-,7,7
079 Jenesien,85,,6,6,12
079 Jenesien,86,,4,4,8
079 Jenesien,87,,3,6,9
079 Jenesien,88,,1,1,2
079 Jenesien,89,,3,4,7
079 Jenesien,90,,-,2,2
079 Jenesien,91,,-,1,1
079 Jenesien,93,,-,1,1
079 Jenesien,94,,-,1,1
079 Jenesien,95,,1,-,1
079 Jenesien,96,,-,2,2
079 Jenesien,97,,-,1,1
079 Jenesien,101,,-,1,1
080 St.Leonhard in Pass.,0,,19,21,40
080 St.Leonhard in Pass.,1,,24,21,45
080 St.Leonhard in Pass.,2,,21,24,45
080 St.Leonhard in Pass.,3,,18,24,42
080 St.Leonhard in Pass.,4,,26,22,48
080 St.Leonhard in Pass.,5,,15,21,36
080 St.Leonhard in Pass.,6,,25,14,39
080 St.Leonhard in Pass.,7,,20,18,38
080 St.Leonhard in Pass.,8,,26,13,39
080 St.Leonhard in Pass.,9,,22,17,39
080 St.Leonhard in Pass.,10,,20,23,43
080 St.Leonhard in Pass.,11,,22,23,45
080 St.Leonhard in Pass.,12,,23,20,43
080 St.Leonhard in Pass.,13,,23,20,43
080 St.Leonhard in Pass.,14,,23,13,36
080 St.Leonhard in Pass.,15,,21,19,40
080 St.Leonhard in Pass.,16,,27,23,50
080 St.Leonhard in Pass.,17,,21,20,41
080 St.Leonhard in Pass.,18,,19,19,38
080 St.Leonhard in Pass.,19,,24,20,44
080 St.Leonhard in Pass.,20,,35,31,66
080 St.Leonhard in Pass.,21,,22,30,52
080 St.Leonhard in Pass.,22,,29,21,50
080 St.Leonhard in Pass.,23,,36,32,68
080 St.Leonhard in Pass.,24,,19,24,43
080 St.Leonhard in Pass.,25,,27,23,50
080 St.Leonhard in Pass.,26,,29,25,54
080 St.Leonhard in Pass.,27,,26,26,52
080 St.Leonhard in Pass.,28,,23,32,55
080 St.Leonhard in Pass.,29,,20,31,51
080 St.Leonhard in Pass.,30,,25,26,51
080 St.Leonhard in Pass.,31,,33,28,61
080 St.Leonhard in Pass.,32,,30,26,56
080 St.Leonhard in Pass.,33,,14,25,39
080 St.Leonhard in Pass.,34,,31,11,42
080 St.Leonhard in Pass.,35,,36,23,59
080 St.Leonhard in Pass.,36,,30,27,57
080 St.Leonhard in Pass.,37,,27,26,53
080 St.Leonhard in Pass.,38,,32,21,53
080 St.Leonhard in Pass.,39,,23,28,51
080 St.Leonhard in Pass.,40,,25,24,49
080 St.Leonhard in Pass.,41,,34,21,55
080 St.Leonhard in Pass.,42,,29,25,54
080 St.Leonhard in Pass.,43,,33,31,64
080 St.Leonhard in Pass.,44,,31,32,63
080 St.Leonhard in Pass.,45,,26,30,56
080 St.Leonhard in Pass.,46,,21,23,44
080 St.Leonhard in Pass.,47,,23,30,53
080 St.Leonhard in Pass.,48,,29,23,52
080 St.Leonhard in Pass.,49,,32,21,53
080 St.Leonhard in Pass.,50,,27,26,53
080 St.Leonhard in Pass.,51,,25,19,44
080 St.Leonhard in Pass.,52,,21,28,49
080 St.Leonhard in Pass.,53,,25,16,41
080 St.Leonhard in Pass.,54,,23,17,40
080 St.Leonhard in Pass.,55,,18,14,32
080 St.Leonhard in Pass.,56,,29,23,52
080 St.Leonhard in Pass.,57,,20,24,44
080 St.Leonhard in Pass.,58,,24,16,40
080 St.Leonhard in Pass.,59,,16,14,30
080 St.Leonhard in Pass.,60,,22,10,32
080 St.Leonhard in Pass.,61,,23,12,35
080 St.Leonhard in Pass.,62,,17,16,33
080 St.Leonhard in Pass.,63,,16,18,34
080 St.Leonhard in Pass.,64,,9,10,19
080 St.Leonhard in Pass.,65,,14,13,27
080 St.Leonhard in Pass.,66,,9,23,32
080 St.Leonhard in Pass.,67,,8,14,22
080 St.Leonhard in Pass.,68,,14,14,28
080 St.Leonhard in Pass.,69,,18,13,31
080 St.Leonhard in Pass.,70,,19,18,37
080 St.Leonhard in Pass.,71,,12,13,25
080 St.Leonhard in Pass.,72,,17,7,24
080 St.Leonhard in Pass.,73,,18,11,29
080 St.Leonhard in Pass.,74,,10,12,22
080 St.Leonhard in Pass.,75,,8,14,22
080 St.Leonhard in Pass.,76,,10,14,24
080 St.Leonhard in Pass.,77,,7,12,19
080 St.Leonhard in Pass.,78,,6,13,19
080 St.Leonhard in Pass.,79,,6,10,16
080 St.Leonhard in Pass.,80,,8,7,15
080 St.Leonhard in Pass.,81,,5,12,17
080 St.Leonhard in Pass.,82,,3,11,14
080 St.Leonhard in Pass.,83,,4,8,12
080 St.Leonhard in Pass.,84,,5,9,14
080 St.Leonhard in Pass.,85,,5,7,12
080 St.Leonhard in Pass.,86,,5,6,11
080 St.Leonhard in Pass.,87,,2,7,9
080 St.Leonhard in Pass.,88,,1,4,5
080 St.Leonhard in Pass.,89,,2,3,5
080 St.Leonhard in Pass.,90,,-,2,2
080 St.Leonhard in Pass.,92,,-,1,1
080 St.Leonhard in Pass.,94,,1,1,2
080 St.Leonhard in Pass.,95,,-,2,2
080 St.Leonhard in Pass.,97,,-,2,2
081 St.Lorenzen,0,,25,23,48
081 St.Lorenzen,1,,23,18,41
081 St.Lorenzen,2,,23,20,43
081 St.Lorenzen,3,,13,18,31
081 St.Lorenzen,4,,27,19,46
081 St.Lorenzen,5,,26,24,50
081 St.Lorenzen,6,,26,19,45
081 St.Lorenzen,7,,19,19,38
081 St.Lorenzen,8,,29,20,49
081 St.Lorenzen,9,,20,30,50
081 St.Lorenzen,10,,29,26,55
081 St.Lorenzen,11,,32,27,59
081 St.Lorenzen,12,,16,30,46
081 St.Lorenzen,13,,31,29,60
081 St.Lorenzen,14,,23,14,37
081 St.Lorenzen,15,,31,20,51
081 St.Lorenzen,16,,25,31,56
081 St.Lorenzen,17,,26,20,46
081 St.Lorenzen,18,,23,14,37
081 St.Lorenzen,19,,25,22,47
081 St.Lorenzen,20,,17,20,37
081 St.Lorenzen,21,,18,27,45
081 St.Lorenzen,22,,23,24,47
081 St.Lorenzen,23,,25,24,49
081 St.Lorenzen,24,,24,22,46
081 St.Lorenzen,25,,29,22,51
081 St.Lorenzen,26,,24,20,44
081 St.Lorenzen,27,,35,21,56
081 St.Lorenzen,28,,25,19,44
081 St.Lorenzen,29,,19,22,41
081 St.Lorenzen,30,,29,32,61
081 St.Lorenzen,31,,30,22,52
081 St.Lorenzen,32,,25,23,48
081 St.Lorenzen,33,,25,15,40
081 St.Lorenzen,34,,21,34,55
081 St.Lorenzen,35,,25,30,55
081 St.Lorenzen,36,,33,33,66
081 St.Lorenzen,37,,35,37,72
081 St.Lorenzen,38,,32,31,63
081 St.Lorenzen,39,,30,31,61
081 St.Lorenzen,40,,23,32,55
081 St.Lorenzen,41,,42,36,78
081 St.Lorenzen,42,,33,39,72
081 St.Lorenzen,43,,37,31,68
081 St.Lorenzen,44,,36,26,62
081 St.Lorenzen,45,,31,23,54
081 St.Lorenzen,46,,35,30,65
081 St.Lorenzen,47,,29,38,67
081 St.Lorenzen,48,,25,38,63
081 St.Lorenzen,49,,31,19,50
081 St.Lorenzen,50,,31,27,58
081 St.Lorenzen,51,,32,32,64
081 St.Lorenzen,52,,22,27,49
081 St.Lorenzen,53,,26,28,54
081 St.Lorenzen,54,,17,17,34
081 St.Lorenzen,55,,15,18,33
081 St.Lorenzen,56,,23,18,41
081 St.Lorenzen,57,,17,10,27
081 St.Lorenzen,58,,17,16,33
081 St.Lorenzen,59,,16,19,35
081 St.Lorenzen,60,,11,22,33
081 St.Lorenzen,61,,14,14,28
081 St.Lorenzen,62,,19,8,27
081 St.Lorenzen,63,,17,10,27
081 St.Lorenzen,64,,12,18,30
081 St.Lorenzen,65,,18,15,33
081 St.Lorenzen,66,,14,17,31
081 St.Lorenzen,67,,17,20,37
081 St.Lorenzen,68,,18,17,35
081 St.Lorenzen,69,,15,13,28
081 St.Lorenzen,70,,13,19,32
081 St.Lorenzen,71,,12,13,25
081 St.Lorenzen,72,,18,16,34
081 St.Lorenzen,73,,13,15,28
081 St.Lorenzen,74,,9,13,22
081 St.Lorenzen,75,,14,11,25
081 St.Lorenzen,76,,12,9,21
081 St.Lorenzen,77,,8,10,18
081 St.Lorenzen,78,,9,15,24
081 St.Lorenzen,79,,8,6,14
081 St.Lorenzen,80,,9,16,25
081 St.Lorenzen,81,,8,15,23
081 St.Lorenzen,82,,5,7,12
081 St.Lorenzen,83,,7,7,14
081 St.Lorenzen,84,,2,11,13
081 St.Lorenzen,85,,2,7,9
081 St.Lorenzen,86,,5,9,14
081 St.Lorenzen,87,,2,4,6
081 St.Lorenzen,88,,2,4,6
081 St.Lorenzen,89,,-,3,3
081 St.Lorenzen,90,,1,3,4
081 St.Lorenzen,91,,-,2,2
081 St.Lorenzen,92,,-,1,1
081 St.Lorenzen,95,,1,1,2
081 St.Lorenzen,99,,-,1,1
082 St.Martin in Thurn,0,,7,6,13
082 St.Martin in Thurn,1,,8,3,11
082 St.Martin in Thurn,2,,2,11,13
082 St.Martin in Thurn,3,,9,14,23
082 St.Martin in Thurn,4,,10,8,18
082 St.Martin in Thurn,5,,18,13,31
082 St.Martin in Thurn,6,,4,6,10
082 St.Martin in Thurn,7,,15,8,23
082 St.Martin in Thurn,8,,8,14,22
082 St.Martin in Thurn,9,,7,9,16
082 St.Martin in Thurn,10,,8,19,27
082 St.Martin in Thurn,11,,11,11,22
082 St.Martin in Thurn,12,,16,11,27
082 St.Martin in Thurn,13,,24,14,38
082 St.Martin in Thurn,14,,15,11,26
082 St.Martin in Thurn,15,,15,9,24
082 St.Martin in Thurn,16,,9,9,18
082 St.Martin in Thurn,17,,17,14,31
082 St.Martin in Thurn,18,,11,11,22
082 St.Martin in Thurn,19,,6,17,23
082 St.Martin in Thurn,20,,15,13,28
082 St.Martin in Thurn,21,,7,5,12
082 St.Martin in Thurn,22,,14,11,25
082 St.Martin in Thurn,23,,13,9,22
082 St.Martin in Thurn,24,,12,16,28
082 St.Martin in Thurn,25,,8,5,13
082 St.Martin in Thurn,26,,15,9,24
082 St.Martin in Thurn,27,,15,14,29
082 St.Martin in Thurn,28,,14,6,20
082 St.Martin in Thurn,29,,10,11,21
082 St.Martin in Thurn,30,,10,10,20
082 St.Martin in Thurn,31,,18,11,29
082 St.Martin in Thurn,32,,13,10,23
082 St.Martin in Thurn,33,,12,10,22
082 St.Martin in Thurn,34,,7,9,16
082 St.Martin in Thurn,35,,7,12,19
082 St.Martin in Thurn,36,,12,9,21
082 St.Martin in Thurn,37,,13,10,23
082 St.Martin in Thurn,38,,16,13,29
082 St.Martin in Thurn,39,,13,14,27
082 St.Martin in Thurn,40,,15,16,31
082 St.Martin in Thurn,41,,17,14,31
082 St.Martin in Thurn,42,,11,10,21
082 St.Martin in Thurn,43,,17,26,43
082 St.Martin in Thurn,44,,16,20,36
082 St.Martin in Thurn,45,,11,16,27
082 St.Martin in Thurn,46,,15,14,29
082 St.Martin in Thurn,47,,15,15,30
082 St.Martin in Thurn,48,,14,18,32
082 St.Martin in Thurn,49,,15,5,20
082 St.Martin in Thurn,50,,12,10,22
082 St.Martin in Thurn,51,,12,8,20
082 St.Martin in Thurn,52,,12,9,21
082 St.Martin in Thurn,53,,8,6,14
082 St.Martin in Thurn,54,,13,9,22
082 St.Martin in Thurn,55,,8,8,16
082 St.Martin in Thurn,56,,5,10,15
082 St.Martin in Thurn,57,,3,4,7
082 St.Martin in Thurn,58,,8,7,15
082 St.Martin in Thurn,59,,10,6,16
082 St.Martin in Thurn,60,,3,7,10
082 St.Martin in Thurn,61,,8,6,14
082 St.Martin in Thurn,62,,9,6,15
082 St.Martin in Thurn,63,,8,7,15
082 St.Martin in Thurn,64,,6,4,10
082 St.Martin in Thurn,65,,10,8,18
082 St.Martin in Thurn,66,,4,8,12
082 St.Martin in Thurn,67,,6,6,12
082 St.Martin in Thurn,68,,7,6,13
082 St.Martin in Thurn,69,,5,5,10
082 St.Martin in Thurn,70,,5,7,12
082 St.Martin in Thurn,71,,8,8,16
082 St.Martin in Thurn,72,,5,12,17
082 St.Martin in Thurn,73,,4,7,11
082 St.Martin in Thurn,74,,7,6,13
082 St.Martin in Thurn,75,,6,4,10
082 St.Martin in Thurn,76,,3,9,12
082 St.Martin in Thurn,77,,6,7,13
082 St.Martin in Thurn,78,,8,8,16
082 St.Martin in Thurn,79,,5,5,10
082 St.Martin in Thurn,80,,6,8,14
082 St.Martin in Thurn,81,,2,3,5
082 St.Martin in Thurn,82,,4,5,9
082 St.Martin in Thurn,83,,6,3,9
082 St.Martin in Thurn,84,,6,4,10
082 St.Martin in Thurn,85,,6,9,15
082 St.Martin in Thurn,86,,2,5,7
082 St.Martin in Thurn,87,,7,4,11
082 St.Martin in Thurn,88,,5,2,7
082 St.Martin in Thurn,89,,4,7,11
082 St.Martin in Thurn,90,,2,3,5
082 St.Martin in Thurn,92,,-,2,2
082 St.Martin in Thurn,95,,-,1,1
082 St.Martin in Thurn,96,,-,1,1
082 St.Martin in Thurn,97,,1,-,1
083 St.Martin in Passeier,0,,15,17,32
083 St.Martin in Passeier,1,,19,27,46
083 St.Martin in Passeier,2,,16,22,38
083 St.Martin in Passeier,3,,23,22,45
083 St.Martin in Passeier,4,,18,17,35
083 St.Martin in Passeier,5,,22,19,41
083 St.Martin in Passeier,6,,19,18,37
083 St.Martin in Passeier,7,,18,13,31
083 St.Martin in Passeier,8,,19,17,36
083 St.Martin in Passeier,9,,12,21,33
083 St.Martin in Passeier,10,,10,21,31
083 St.Martin in Passeier,11,,19,19,38
083 St.Martin in Passeier,12,,26,24,50
083 St.Martin in Passeier,13,,22,20,42
083 St.Martin in Passeier,14,,19,18,37
083 St.Martin in Passeier,15,,21,24,45
083 St.Martin in Passeier,16,,19,23,42
083 St.Martin in Passeier,17,,23,18,41
083 St.Martin in Passeier,18,,25,23,48
083 St.Martin in Passeier,19,,20,27,47
083 St.Martin in Passeier,20,,18,21,39
083 St.Martin in Passeier,21,,16,17,33
083 St.Martin in Passeier,22,,19,28,47
083 St.Martin in Passeier,23,,19,22,41
083 St.Martin in Passeier,24,,20,24,44
083 St.Martin in Passeier,25,,22,28,50
083 St.Martin in Passeier,26,,20,12,32
083 St.Martin in Passeier,27,,24,18,42
083 St.Martin in Passeier,28,,28,22,50
083 St.Martin in Passeier,29,,20,23,43
083 St.Martin in Passeier,30,,20,10,30
083 St.Martin in Passeier,31,,31,16,47
083 St.Martin in Passeier,32,,21,21,42
083 St.Martin in Passeier,33,,19,19,38
083 St.Martin in Passeier,34,,20,20,40
083 St.Martin in Passeier,35,,22,19,41
083 St.Martin in Passeier,36,,24,28,52
083 St.Martin in Passeier,37,,21,23,44
083 St.Martin in Passeier,38,,29,26,55
083 St.Martin in Passeier,39,,32,25,57
083 St.Martin in Passeier,40,,32,25,57
083 St.Martin in Passeier,41,,27,25,52
083 St.Martin in Passeier,42,,22,25,47
083 St.Martin in Passeier,43,,28,32,60
083 St.Martin in Passeier,44,,34,23,57
083 St.Martin in Passeier,45,,16,18,34
083 St.Martin in Passeier,46,,34,21,55
083 St.Martin in Passeier,47,,22,29,51
083 St.Martin in Passeier,48,,35,23,58
083 St.Martin in Passeier,49,,24,23,47
083 St.Martin in Passeier,50,,25,23,48
083 St.Martin in Passeier,51,,25,19,44
083 St.Martin in Passeier,52,,25,12,37
083 St.Martin in Passeier,53,,21,18,39
083 St.Martin in Passeier,54,,30,13,43
083 St.Martin in Passeier,55,,13,11,24
083 St.Martin in Passeier,56,,21,16,37
083 St.Martin in Passeier,57,,6,18,24
083 St.Martin in Passeier,58,,21,14,35
083 St.Martin in Passeier,59,,11,15,26
083 St.Martin in Passeier,60,,14,11,25
083 St.Martin in Passeier,61,,12,11,23
083 St.Martin in Passeier,62,,15,13,28
083 St.Martin in Passeier,63,,12,9,21
083 St.Martin in Passeier,64,,13,12,25
083 St.Martin in Passeier,65,,18,12,30
083 St.Martin in Passeier,66,,12,12,24
083 St.Martin in Passeier,67,,14,14,28
083 St.Martin in Passeier,68,,9,15,24
083 St.Martin in Passeier,69,,4,12,16
083 St.Martin in Passeier,70,,7,13,20
083 St.Martin in Passeier,71,,12,8,20
083 St.Martin in Passeier,72,,14,20,34
083 St.Martin in Passeier,73,,13,13,26
083 St.Martin in Passeier,74,,7,14,21
083 St.Martin in Passeier,75,,16,9,25
083 St.Martin in Passeier,76,,13,9,22
083 St.Martin in Passeier,77,,5,9,14
083 St.Martin in Passeier,78,,4,11,15
083 St.Martin in Passeier,79,,4,11,15
083 St.Martin in Passeier,80,,11,10,21
083 St.Martin in Passeier,81,,6,6,12
083 St.Martin in Passeier,82,,9,6,15
083 St.Martin in Passeier,83,,3,10,13
083 St.Martin in Passeier,84,,4,4,8
083 St.Martin in Passeier,85,,2,10,12
083 St.Martin in Passeier,86,,1,6,7
083 St.Martin in Passeier,87,,-,4,4
083 St.Martin in Passeier,88,,-,9,9
083 St.Martin in Passeier,89,,1,4,5
083 St.Martin in Passeier,90,,1,2,3
083 St.Martin in Passeier,91,,-,2,2
083 St.Martin in Passeier,92,,-,2,2
083 St.Martin in Passeier,93,,-,1,1
083 St.Martin in Passeier,94,,1,-,1
083 St.Martin in Passeier,95,,-,2,2
083 St.Martin in Passeier,98,,1,-,1
084 St.Pankraz,0,,9,11,20
084 St.Pankraz,1,,8,11,19
084 St.Pankraz,2,,9,10,19
084 St.Pankraz,3,,8,14,22
084 St.Pankraz,4,,13,8,21
084 St.Pankraz,5,,13,9,22
084 St.Pankraz,6,,12,7,19
084 St.Pankraz,7,,7,3,10
084 St.Pankraz,8,,14,15,29
084 St.Pankraz,9,,11,12,23
084 St.Pankraz,10,,8,4,12
084 St.Pankraz,11,,13,6,19
084 St.Pankraz,12,,8,11,19
084 St.Pankraz,13,,10,9,19
084 St.Pankraz,14,,8,5,13
084 St.Pankraz,15,,8,9,17
084 St.Pankraz,16,,5,11,16
084 St.Pankraz,17,,7,9,16
084 St.Pankraz,18,,10,12,22
084 St.Pankraz,19,,10,3,13
084 St.Pankraz,20,,11,15,26
084 St.Pankraz,21,,14,8,22
084 St.Pankraz,22,,8,7,15
084 St.Pankraz,23,,9,4,13
084 St.Pankraz,24,,10,8,18
084 St.Pankraz,25,,10,5,15
084 St.Pankraz,26,,11,7,18
084 St.Pankraz,27,,10,7,17
084 St.Pankraz,28,,8,12,20
084 St.Pankraz,29,,15,8,23
084 St.Pankraz,30,,3,6,9
084 St.Pankraz,31,,13,8,21
084 St.Pankraz,32,,9,9,18
084 St.Pankraz,33,,5,11,16
084 St.Pankraz,34,,8,12,20
084 St.Pankraz,35,,13,13,26
084 St.Pankraz,36,,12,7,19
084 St.Pankraz,37,,11,19,30
084 St.Pankraz,38,,15,12,27
084 St.Pankraz,39,,13,12,25
084 St.Pankraz,40,,17,10,27
084 St.Pankraz,41,,17,14,31
084 St.Pankraz,42,,9,15,24
084 St.Pankraz,43,,14,6,20
084 St.Pankraz,44,,23,14,37
084 St.Pankraz,45,,14,13,27
084 St.Pankraz,46,,8,10,18
084 St.Pankraz,47,,17,8,25
084 St.Pankraz,48,,14,13,27
084 St.Pankraz,49,,13,4,17
084 St.Pankraz,50,,15,13,28
084 St.Pankraz,51,,5,8,13
084 St.Pankraz,52,,11,9,20
084 St.Pankraz,53,,10,16,26
084 St.Pankraz,54,,6,4,10
084 St.Pankraz,55,,11,9,20
084 St.Pankraz,56,,10,10,20
084 St.Pankraz,57,,14,9,23
084 St.Pankraz,58,,6,2,8
084 St.Pankraz,59,,10,6,16
084 St.Pankraz,60,,7,6,13
084 St.Pankraz,61,,8,3,11
084 St.Pankraz,62,,7,6,13
084 St.Pankraz,63,,4,7,11
084 St.Pankraz,64,,3,6,9
084 St.Pankraz,65,,5,7,12
084 St.Pankraz,66,,12,14,26
084 St.Pankraz,67,,9,15,24
084 St.Pankraz,68,,8,10,18
084 St.Pankraz,69,,8,6,14
084 St.Pankraz,70,,8,7,15
084 St.Pankraz,71,,5,10,15
084 St.Pankraz,72,,9,8,17
084 St.Pankraz,73,,5,4,9
084 St.Pankraz,74,,5,3,8
084 St.Pankraz,75,,6,7,13
084 St.Pankraz,76,,8,2,10
084 St.Pankraz,77,,6,10,16
084 St.Pankraz,78,,7,4,11
084 St.Pankraz,79,,3,6,9
084 St.Pankraz,80,,5,9,14
084 St.Pankraz,81,,7,9,16
084 St.Pankraz,82,,7,3,10
084 St.Pankraz,83,,3,6,9
084 St.Pankraz,84,,4,6,10
084 St.Pankraz,85,,2,7,9
084 St.Pankraz,86,,6,3,9
084 St.Pankraz,87,,4,7,11
084 St.Pankraz,88,,2,6,8
084 St.Pankraz,89,,-,6,6
084 St.Pankraz,90,,-,1,1
084 St.Pankraz,91,,-,1,1
084 St.Pankraz,92,,-,1,1
084 St.Pankraz,94,,-,2,2
084 St.Pankraz,95,,-,1,1
084 St.Pankraz,97,,1,-,1
084 St.Pankraz,100,,-,1,1
085 St.Christina in Gröden,0,,10,6,16
085 St.Christina in Gröden,1,,11,10,21
085 St.Christina in Gröden,2,,9,9,18
085 St.Christina in Gröden,3,,9,8,17
085 St.Christina in Gröden,4,,15,13,28
085 St.Christina in Gröden,5,,15,12,27
085 St.Christina in Gröden,6,,9,7,16
085 St.Christina in Gröden,7,,11,15,26
085 St.Christina in Gröden,8,,9,13,22
085 St.Christina in Gröden,9,,20,12,32
085 St.Christina in Gröden,10,,20,10,30
085 St.Christina in Gröden,11,,12,15,27
085 St.Christina in Gröden,12,,12,12,24
085 St.Christina in Gröden,13,,12,5,17
085 St.Christina in Gröden,14,,16,10,26
085 St.Christina in Gröden,15,,8,14,22
085 St.Christina in Gröden,16,,14,13,27
085 St.Christina in Gröden,17,,14,14,28
085 St.Christina in Gröden,18,,14,18,32
085 St.Christina in Gröden,19,,8,14,22
085 St.Christina in Gröden,20,,6,8,14
085 St.Christina in Gröden,21,,10,8,18
085 St.Christina in Gröden,22,,12,6,18
085 St.Christina in Gröden,23,,13,11,24
085 St.Christina in Gröden,24,,6,11,17
085 St.Christina in Gröden,25,,10,6,16
085 St.Christina in Gröden,26,,20,13,33
085 St.Christina in Gröden,27,,9,7,16
085 St.Christina in Gröden,28,,10,11,21
085 St.Christina in Gröden,29,,13,17,30
085 St.Christina in Gröden,30,,11,9,20
085 St.Christina in Gröden,31,,5,17,22
085 St.Christina in Gröden,32,,5,10,15
085 St.Christina in Gröden,33,,15,9,24
085 St.Christina in Gröden,34,,14,14,28
085 St.Christina in Gröden,35,,10,19,29
085 St.Christina in Gröden,36,,10,13,23
085 St.Christina in Gröden,37,,17,11,28
085 St.Christina in Gröden,38,,11,16,27
085 St.Christina in Gröden,39,,24,21,45
085 St.Christina in Gröden,40,,23,13,36
085 St.Christina in Gröden,41,,26,25,51
085 St.Christina in Gröden,42,,17,15,32
085 St.Christina in Gröden,43,,20,7,27
085 St.Christina in Gröden,44,,13,14,27
085 St.Christina in Gröden,45,,13,25,38
085 St.Christina in Gröden,46,,13,18,31
085 St.Christina in Gröden,47,,20,14,34
085 St.Christina in Gröden,48,,21,16,37
085 St.Christina in Gröden,49,,21,16,37
085 St.Christina in Gröden,50,,13,9,22
085 St.Christina in Gröden,51,,9,11,20
085 St.Christina in Gröden,52,,17,11,28
085 St.Christina in Gröden,53,,11,10,21
085 St.Christina in Gröden,54,,9,9,18
085 St.Christina in Gröden,55,,13,13,26
085 St.Christina in Gröden,56,,9,10,19
085 St.Christina in Gröden,57,,5,7,12
085 St.Christina in Gröden,58,,12,5,17
085 St.Christina in Gröden,59,,7,5,12
085 St.Christina in Gröden,60,,8,10,18
085 St.Christina in Gröden,61,,8,5,13
085 St.Christina in Gröden,62,,6,8,14
085 St.Christina in Gröden,63,,9,11,20
085 St.Christina in Gröden,64,,6,7,13
085 St.Christina in Gröden,65,,5,11,16
085 St.Christina in Gröden,66,,12,15,27
085 St.Christina in Gröden,67,,8,6,14
085 St.Christina in Gröden,68,,13,8,21
085 St.Christina in Gröden,69,,9,11,20
085 St.Christina in Gröden,70,,9,10,19
085 St.Christina in Gröden,71,,8,7,15
085 St.Christina in Gröden,72,,8,4,12
085 St.Christina in Gröden,73,,10,10,20
085 St.Christina in Gröden,74,,12,4,16
085 St.Christina in Gröden,75,,7,12,19
085 St.Christina in Gröden,76,,5,12,17
085 St.Christina in Gröden,77,,7,8,15
085 St.Christina in Gröden,78,,2,6,8
085 St.Christina in Gröden,79,,12,4,16
085 St.Christina in Gröden,80,,2,10,12
085 St.Christina in Gröden,81,,3,4,7
085 St.Christina in Gröden,82,,5,6,11
085 St.Christina in Gröden,83,,7,5,12
085 St.Christina in Gröden,84,,3,7,10
085 St.Christina in Gröden,85,,-,2,2
085 St.Christina in Gröden,86,,1,4,5
085 St.Christina in Gröden,87,,-,8,8
085 St.Christina in Gröden,88,,2,3,5
085 St.Christina in Gröden,89,,1,2,3
085 St.Christina in Gröden,90,,-,1,1
085 St.Christina in Gröden,93,,-,2,2
085 St.Christina in Gröden,94,,2,1,3
085 St.Christina in Gröden,95,,-,1,1
085 St.Christina in Gröden,96,,2,-,2
086 Sarntal,0,,35,37,72
086 Sarntal,1,,43,56,99
086 Sarntal,2,,54,40,94
086 Sarntal,3,,44,51,95
086 Sarntal,4,,43,35,78
086 Sarntal,5,,39,40,79
086 Sarntal,6,,46,36,82
086 Sarntal,7,,30,40,70
086 Sarntal,8,,50,29,79
086 Sarntal,9,,37,41,78
086 Sarntal,10,,36,37,73
086 Sarntal,11,,52,42,94
086 Sarntal,12,,44,47,91
086 Sarntal,13,,48,43,91
086 Sarntal,14,,42,42,84
086 Sarntal,15,,33,41,74
086 Sarntal,16,,32,39,71
086 Sarntal,17,,43,38,81
086 Sarntal,18,,43,42,85
086 Sarntal,19,,45,32,77
086 Sarntal,20,,55,36,91
086 Sarntal,21,,43,45,88
086 Sarntal,22,,36,32,68
086 Sarntal,23,,37,44,81
086 Sarntal,24,,45,41,86
086 Sarntal,25,,40,39,79
086 Sarntal,26,,57,42,99
086 Sarntal,27,,64,49,113
086 Sarntal,28,,44,57,101
086 Sarntal,29,,54,47,101
086 Sarntal,30,,57,51,108
086 Sarntal,31,,54,51,105
086 Sarntal,32,,61,44,105
086 Sarntal,33,,43,35,78
086 Sarntal,34,,58,47,105
086 Sarntal,35,,47,58,105
086 Sarntal,36,,60,59,119
086 Sarntal,37,,68,41,109
086 Sarntal,38,,45,47,92
086 Sarntal,39,,68,58,126
086 Sarntal,40,,62,54,116
086 Sarntal,41,,55,44,99
086 Sarntal,42,,55,45,100
086 Sarntal,43,,48,49,97
086 Sarntal,44,,63,55,118
086 Sarntal,45,,58,64,122
086 Sarntal,46,,43,43,86
086 Sarntal,47,,57,35,92
086 Sarntal,48,,43,46,89
086 Sarntal,49,,64,47,111
086 Sarntal,50,,41,42,83
086 Sarntal,51,,56,43,99
086 Sarntal,52,,35,42,77
086 Sarntal,53,,40,30,70
086 Sarntal,54,,42,41,83
086 Sarntal,55,,36,30,66
086 Sarntal,56,,42,29,71
086 Sarntal,57,,34,42,76
086 Sarntal,58,,45,33,78
086 Sarntal,59,,37,34,71
086 Sarntal,60,,50,26,76
086 Sarntal,61,,32,39,71
086 Sarntal,62,,37,28,65
086 Sarntal,63,,35,37,72
086 Sarntal,64,,28,33,61
086 Sarntal,65,,30,29,59
086 Sarntal,66,,36,38,74
086 Sarntal,67,,39,35,74
086 Sarntal,68,,34,28,62
086 Sarntal,69,,28,43,71
086 Sarntal,70,,37,30,67
086 Sarntal,71,,31,29,60
086 Sarntal,72,,24,32,56
086 Sarntal,73,,16,23,39
086 Sarntal,74,,18,23,41
086 Sarntal,75,,22,20,42
086 Sarntal,76,,19,20,39
086 Sarntal,77,,21,23,44
086 Sarntal,78,,14,23,37
086 Sarntal,79,,15,21,36
086 Sarntal,80,,16,29,45
086 Sarntal,81,,14,23,37
086 Sarntal,82,,14,30,44
086 Sarntal,83,,13,13,26
086 Sarntal,84,,15,18,33
086 Sarntal,85,,2,18,20
086 Sarntal,86,,5,15,20
086 Sarntal,87,,4,20,24
086 Sarntal,88,,3,7,10
086 Sarntal,89,,2,10,12
086 Sarntal,90,,2,9,11
086 Sarntal,91,,1,7,8
086 Sarntal,92,,-,3,3
086 Sarntal,93,,-,1,1
086 Sarntal,94,,-,2,2
086 Sarntal,95,,-,1,1
086 Sarntal,96,,4,3,7
086 Sarntal,97,,-,1,1
086 Sarntal,102,,1,-,1
087 Schenna,0,,13,17,30
087 Schenna,1,,18,19,37
087 Schenna,2,,10,11,21
087 Schenna,3,,22,21,43
087 Schenna,4,,11,10,21
087 Schenna,5,,17,18,35
087 Schenna,6,,14,15,29
087 Schenna,7,,16,18,34
087 Schenna,8,,17,14,31
087 Schenna,9,,19,20,39
087 Schenna,10,,23,18,41
087 Schenna,11,,16,10,26
087 Schenna,12,,13,19,32
087 Schenna,13,,16,18,34
087 Schenna,14,,21,18,39
087 Schenna,15,,20,16,36
087 Schenna,16,,12,8,20
087 Schenna,17,,17,17,34
087 Schenna,18,,11,20,31
087 Schenna,19,,20,16,36
087 Schenna,20,,22,11,33
087 Schenna,21,,20,19,39
087 Schenna,22,,20,17,37
087 Schenna,23,,19,11,30
087 Schenna,24,,15,19,34
087 Schenna,25,,16,15,31
087 Schenna,26,,13,8,21
087 Schenna,27,,9,15,24
087 Schenna,28,,22,13,35
087 Schenna,29,,19,29,48
087 Schenna,30,,27,19,46
087 Schenna,31,,13,19,32
087 Schenna,32,,21,22,43
087 Schenna,33,,23,14,37
087 Schenna,34,,22,27,49
087 Schenna,35,,29,23,52
087 Schenna,36,,24,21,45
087 Schenna,37,,25,18,43
087 Schenna,38,,27,26,53
087 Schenna,39,,20,23,43
087 Schenna,40,,27,20,47
087 Schenna,41,,24,18,42
087 Schenna,42,,28,20,48
087 Schenna,43,,18,19,37
087 Schenna,44,,30,31,61
087 Schenna,45,,20,25,45
087 Schenna,46,,25,19,44
087 Schenna,47,,21,13,34
087 Schenna,48,,29,24,53
087 Schenna,49,,34,24,58
087 Schenna,50,,15,14,29
087 Schenna,51,,23,19,42
087 Schenna,52,,13,19,32
087 Schenna,53,,18,18,36
087 Schenna,54,,11,17,28
087 Schenna,55,,16,17,33
087 Schenna,56,,16,15,31
087 Schenna,57,,11,16,27
087 Schenna,58,,13,12,25
087 Schenna,59,,19,14,33
087 Schenna,60,,20,18,38
087 Schenna,61,,15,16,31
087 Schenna,62,,17,18,35
087 Schenna,63,,16,21,37
087 Schenna,64,,14,14,28
087 Schenna,65,,16,9,25
087 Schenna,66,,19,15,34
087 Schenna,67,,9,19,28
087 Schenna,68,,12,13,25
087 Schenna,69,,10,10,20
087 Schenna,70,,9,13,22
087 Schenna,71,,16,17,33
087 Schenna,72,,7,10,17
087 Schenna,73,,8,11,19
087 Schenna,74,,13,9,22
087 Schenna,75,,12,15,27
087 Schenna,76,,7,9,16
087 Schenna,77,,9,11,20
087 Schenna,78,,9,9,18
087 Schenna,79,,10,5,15
087 Schenna,80,,5,10,15
087 Schenna,81,,7,8,15
087 Schenna,82,,2,12,14
087 Schenna,83,,5,7,12
087 Schenna,84,,1,8,9
087 Schenna,85,,7,6,13
087 Schenna,86,,3,2,5
087 Schenna,87,,4,3,7
087 Schenna,88,,3,7,10
087 Schenna,89,,2,3,5
087 Schenna,90,,-,3,3
087 Schenna,93,,1,1,2
087 Schenna,95,,1,-,1
087 Schenna,96,,-,2,2
087 Schenna,97,,-,1,1
087 Schenna,99,,-,1,1
087 Schenna,103,,1,-,1
088 Mühlwald,0,,5,7,12
088 Mühlwald,1,,9,7,16
088 Mühlwald,2,,9,8,17
088 Mühlwald,3,,5,12,17
088 Mühlwald,4,,7,5,12
088 Mühlwald,5,,10,10,20
088 Mühlwald,6,,16,10,26
088 Mühlwald,7,,10,12,22
088 Mühlwald,8,,10,14,24
088 Mühlwald,9,,8,11,19
088 Mühlwald,10,,13,10,23
088 Mühlwald,11,,13,14,27
088 Mühlwald,12,,11,9,20
088 Mühlwald,13,,14,13,27
088 Mühlwald,14,,13,4,17
088 Mühlwald,15,,9,6,15
088 Mühlwald,16,,14,12,26
088 Mühlwald,17,,5,5,10
088 Mühlwald,18,,12,6,18
088 Mühlwald,19,,9,6,15
088 Mühlwald,20,,16,9,25
088 Mühlwald,21,,7,5,12
088 Mühlwald,22,,9,15,24
088 Mühlwald,23,,6,7,13
088 Mühlwald,24,,11,17,28
088 Mühlwald,25,,10,16,26
088 Mühlwald,26,,10,7,17
088 Mühlwald,27,,6,10,16
088 Mühlwald,28,,14,13,27
088 Mühlwald,29,,18,4,22
088 Mühlwald,30,,7,15,22
088 Mühlwald,31,,12,7,19
088 Mühlwald,32,,8,5,13
088 Mühlwald,33,,13,10,23
088 Mühlwald,34,,11,7,18
088 Mühlwald,35,,9,6,15
088 Mühlwald,36,,15,10,25
088 Mühlwald,37,,8,9,17
088 Mühlwald,38,,18,14,32
088 Mühlwald,39,,8,10,18
088 Mühlwald,40,,15,16,31
088 Mühlwald,41,,16,9,25
088 Mühlwald,42,,18,13,31
088 Mühlwald,43,,12,7,19
088 Mühlwald,44,,17,12,29
088 Mühlwald,45,,18,10,28
088 Mühlwald,46,,10,11,21
088 Mühlwald,47,,8,11,19
088 Mühlwald,48,,6,10,16
088 Mühlwald,49,,14,9,23
088 Mühlwald,50,,13,5,18
088 Mühlwald,51,,9,5,14
088 Mühlwald,52,,13,12,25
088 Mühlwald,53,,7,8,15
088 Mühlwald,54,,7,7,14
088 Mühlwald,55,,9,4,13
088 Mühlwald,56,,10,9,19
088 Mühlwald,57,,9,8,17
088 Mühlwald,58,,10,4,14
088 Mühlwald,59,,5,9,14
088 Mühlwald,60,,9,3,12
088 Mühlwald,61,,12,4,16
088 Mühlwald,62,,10,8,18
088 Mühlwald,63,,8,3,11
088 Mühlwald,64,,4,4,8
088 Mühlwald,65,,8,4,12
088 Mühlwald,66,,10,2,12
088 Mühlwald,67,,6,7,13
088 Mühlwald,68,,4,7,11
088 Mühlwald,69,,4,9,13
088 Mühlwald,70,,6,11,17
088 Mühlwald,71,,8,4,12
088 Mühlwald,72,,11,2,13
088 Mühlwald,73,,4,3,7
088 Mühlwald,74,,4,3,7
088 Mühlwald,75,,4,6,10
088 Mühlwald,76,,3,10,13
088 Mühlwald,77,,1,2,3
088 Mühlwald,78,,4,5,9
088 Mühlwald,79,,3,4,7
088 Mühlwald,80,,6,6,12
088 Mühlwald,81,,3,4,7
088 Mühlwald,82,,4,2,6
088 Mühlwald,83,,1,5,6
088 Mühlwald,84,,3,1,4
088 Mühlwald,85,,4,2,6
088 Mühlwald,86,,-,3,3
088 Mühlwald,87,,-,2,2
088 Mühlwald,88,,-,5,5
088 Mühlwald,89,,1,-,1
088 Mühlwald,90,,-,1,1
088 Mühlwald,92,,2,-,2
088 Mühlwald,94,,-,1,1
088 Mühlwald,96,,-,1,1
088 Mühlwald,101,,1,-,1
089 Wolkenstein in Gröden,0,,12,5,17
089 Wolkenstein in Gröden,1,,17,12,29
089 Wolkenstein in Gröden,2,,16,14,30
089 Wolkenstein in Gröden,3,,11,17,28
089 Wolkenstein in Gröden,4,,15,18,33
089 Wolkenstein in Gröden,5,,13,9,22
089 Wolkenstein in Gröden,6,,17,19,36
089 Wolkenstein in Gröden,7,,25,19,44
089 Wolkenstein in Gröden,8,,20,18,38
089 Wolkenstein in Gröden,9,,18,22,40
089 Wolkenstein in Gröden,10,,13,17,30
089 Wolkenstein in Gröden,11,,14,23,37
089 Wolkenstein in Gröden,12,,21,29,50
089 Wolkenstein in Gröden,13,,15,12,27
089 Wolkenstein in Gröden,14,,17,12,29
089 Wolkenstein in Gröden,15,,15,18,33
089 Wolkenstein in Gröden,16,,14,17,31
089 Wolkenstein in Gröden,17,,22,15,37
089 Wolkenstein in Gröden,18,,18,18,36
089 Wolkenstein in Gröden,19,,13,10,23
089 Wolkenstein in Gröden,20,,15,13,28
089 Wolkenstein in Gröden,21,,17,16,33
089 Wolkenstein in Gröden,22,,10,21,31
089 Wolkenstein in Gröden,23,,15,13,28
089 Wolkenstein in Gröden,24,,17,10,27
089 Wolkenstein in Gröden,25,,13,11,24
089 Wolkenstein in Gröden,26,,14,11,25
089 Wolkenstein in Gröden,27,,10,13,23
089 Wolkenstein in Gröden,28,,14,10,24
089 Wolkenstein in Gröden,29,,19,12,31
089 Wolkenstein in Gröden,30,,8,18,26
089 Wolkenstein in Gröden,31,,8,9,17
089 Wolkenstein in Gröden,32,,14,12,26
089 Wolkenstein in Gröden,33,,15,10,25
089 Wolkenstein in Gröden,34,,23,20,43
089 Wolkenstein in Gröden,35,,11,19,30
089 Wolkenstein in Gröden,36,,24,23,47
089 Wolkenstein in Gröden,37,,20,23,43
089 Wolkenstein in Gröden,38,,21,23,44
089 Wolkenstein in Gröden,39,,24,24,48
089 Wolkenstein in Gröden,40,,28,23,51
089 Wolkenstein in Gröden,41,,25,24,49
089 Wolkenstein in Gröden,42,,30,26,56
089 Wolkenstein in Gröden,43,,25,23,48
089 Wolkenstein in Gröden,44,,22,34,56
089 Wolkenstein in Gröden,45,,29,21,50
089 Wolkenstein in Gröden,46,,23,22,45
089 Wolkenstein in Gröden,47,,21,19,40
089 Wolkenstein in Gröden,48,,26,25,51
089 Wolkenstein in Gröden,49,,24,23,47
089 Wolkenstein in Gröden,50,,12,16,28
089 Wolkenstein in Gröden,51,,17,15,32
089 Wolkenstein in Gröden,52,,20,16,36
089 Wolkenstein in Gröden,53,,10,14,24
089 Wolkenstein in Gröden,54,,13,10,23
089 Wolkenstein in Gröden,55,,13,10,23
089 Wolkenstein in Gröden,56,,8,12,20
089 Wolkenstein in Gröden,57,,11,7,18
089 Wolkenstein in Gröden,58,,13,12,25
089 Wolkenstein in Gröden,59,,6,17,23
089 Wolkenstein in Gröden,60,,16,11,27
089 Wolkenstein in Gröden,61,,13,13,26
089 Wolkenstein in Gröden,62,,9,16,25
089 Wolkenstein in Gröden,63,,16,18,34
089 Wolkenstein in Gröden,64,,5,14,19
089 Wolkenstein in Gröden,65,,12,9,21
089 Wolkenstein in Gröden,66,,21,14,35
089 Wolkenstein in Gröden,67,,11,12,23
089 Wolkenstein in Gröden,68,,14,16,30
089 Wolkenstein in Gröden,69,,14,16,30
089 Wolkenstein in Gröden,70,,18,14,32
089 Wolkenstein in Gröden,71,,18,9,27
089 Wolkenstein in Gröden,72,,10,19,29
089 Wolkenstein in Gröden,73,,9,15,24
089 Wolkenstein in Gröden,74,,14,6,20
089 Wolkenstein in Gröden,75,,15,10,25
089 Wolkenstein in Gröden,76,,6,10,16
089 Wolkenstein in Gröden,77,,4,9,13
089 Wolkenstein in Gröden,78,,8,9,17
089 Wolkenstein in Gröden,79,,7,9,16
089 Wolkenstein in Gröden,80,,6,7,13
089 Wolkenstein in Gröden,81,,5,9,14
089 Wolkenstein in Gröden,82,,7,5,12
089 Wolkenstein in Gröden,83,,7,4,11
089 Wolkenstein in Gröden,84,,3,6,9
089 Wolkenstein in Gröden,85,,2,9,11
089 Wolkenstein in Gröden,86,,3,5,8
089 Wolkenstein in Gröden,87,,5,9,14
089 Wolkenstein in Gröden,88,,1,4,5
089 Wolkenstein in Gröden,89,,3,4,7
089 Wolkenstein in Gröden,90,,1,2,3
089 Wolkenstein in Gröden,92,,1,2,3
089 Wolkenstein in Gröden,94,,-,1,1
089 Wolkenstein in Gröden,97,,-,1,1
089 Wolkenstein in Gröden,98,,-,2,2
091 Schnals,0,,9,9,18
091 Schnals,1,,10,4,14
091 Schnals,2,,4,6,10
091 Schnals,3,,3,4,7
091 Schnals,4,,5,5,10
091 Schnals,5,,7,5,12
091 Schnals,6,,2,7,9
091 Schnals,7,,12,2,14
091 Schnals,8,,4,4,8
091 Schnals,9,,5,5,10
091 Schnals,10,,6,9,15
091 Schnals,11,,7,16,23
091 Schnals,12,,12,10,22
091 Schnals,13,,7,13,20
091 Schnals,14,,5,8,13
091 Schnals,15,,4,7,11
091 Schnals,16,,11,5,16
091 Schnals,17,,13,10,23
091 Schnals,18,,13,9,22
091 Schnals,19,,4,8,12
091 Schnals,20,,19,8,27
091 Schnals,21,,9,5,14
091 Schnals,22,,11,8,19
091 Schnals,23,,8,10,18
091 Schnals,24,,6,8,14
091 Schnals,25,,13,13,26
091 Schnals,26,,7,7,14
091 Schnals,27,,9,6,15
091 Schnals,28,,17,8,25
091 Schnals,29,,11,11,22
091 Schnals,30,,5,10,15
091 Schnals,31,,11,11,22
091 Schnals,32,,8,7,15
091 Schnals,33,,11,1,12
091 Schnals,34,,4,6,10
091 Schnals,35,,13,8,21
091 Schnals,36,,8,8,16
091 Schnals,37,,8,11,19
091 Schnals,38,,11,12,23
091 Schnals,39,,12,7,19
091 Schnals,40,,13,8,21
091 Schnals,41,,10,9,19
091 Schnals,42,,17,10,27
091 Schnals,43,,14,15,29
091 Schnals,44,,16,8,24
091 Schnals,45,,7,9,16
091 Schnals,46,,11,15,26
091 Schnals,47,,13,10,23
091 Schnals,48,,11,13,24
091 Schnals,49,,11,8,19
091 Schnals,50,,16,13,29
091 Schnals,51,,11,11,22
091 Schnals,52,,13,5,18
091 Schnals,53,,12,5,17
091 Schnals,54,,9,6,15
091 Schnals,55,,10,10,20
091 Schnals,56,,12,8,20
091 Schnals,57,,14,7,21
091 Schnals,58,,12,9,21
091 Schnals,59,,9,7,16
091 Schnals,60,,10,9,19
091 Schnals,61,,3,3,6
091 Schnals,62,,9,8,17
091 Schnals,63,,5,6,11
091 Schnals,64,,6,4,10
091 Schnals,65,,4,7,11
091 Schnals,66,,6,8,14
091 Schnals,67,,4,4,8
091 Schnals,68,,3,4,7
091 Schnals,69,,7,7,14
091 Schnals,70,,5,7,12
091 Schnals,71,,1,11,12
091 Schnals,72,,7,4,11
091 Schnals,73,,5,5,10
091 Schnals,74,,2,5,7
091 Schnals,75,,2,4,6
091 Schnals,76,,4,3,7
091 Schnals,77,,2,10,12
091 Schnals,78,,2,4,6
091 Schnals,79,,-,4,4
091 Schnals,80,,5,6,11
091 Schnals,81,,1,5,6
091 Schnals,82,,1,7,8
091 Schnals,83,,9,2,11
091 Schnals,84,,3,10,13
091 Schnals,85,,-,5,5
091 Schnals,86,,-,1,1
091 Schnals,87,,4,2,6
091 Schnals,88,,-,4,4
091 Schnals,89,,-,2,2
091 Schnals,90,,-,1,1
091 Schnals,91,,2,1,3
091 Schnals,92,,-,1,1
091 Schnals,93,,-,2,2
091 Schnals,94,,-,1,1
091 Schnals,95,,-,1,1
091 Schnals,96,,-,1,1
091 Schnals,97,,1,-,1
091 Schnals,98,,-,1,1
091 Schnals,100,,-,1,1
092 Sexten,0,,10,7,17
092 Sexten,1,,5,6,11
092 Sexten,2,,6,16,22
092 Sexten,3,,7,8,15
092 Sexten,4,,9,9,18
092 Sexten,5,,12,8,20
092 Sexten,6,,11,9,20
092 Sexten,7,,16,18,34
092 Sexten,8,,16,12,28
092 Sexten,9,,9,15,24
092 Sexten,10,,8,15,23
092 Sexten,11,,14,7,21
092 Sexten,12,,13,10,23
092 Sexten,13,,14,12,26
092 Sexten,14,,15,13,28
092 Sexten,15,,16,11,27
092 Sexten,16,,10,5,15
092 Sexten,17,,14,10,24
092 Sexten,18,,12,13,25
092 Sexten,19,,11,18,29
092 Sexten,20,,9,10,19
092 Sexten,21,,9,6,15
092 Sexten,22,,13,7,20
092 Sexten,23,,6,10,16
092 Sexten,24,,10,10,20
092 Sexten,25,,6,12,18
092 Sexten,26,,10,9,19
092 Sexten,27,,12,15,27
092 Sexten,28,,15,12,27
092 Sexten,29,,15,9,24
092 Sexten,30,,12,22,34
092 Sexten,31,,12,10,22
092 Sexten,32,,8,3,11
092 Sexten,33,,18,15,33
092 Sexten,34,,8,8,16
092 Sexten,35,,8,6,14
092 Sexten,36,,9,9,18
092 Sexten,37,,14,18,32
092 Sexten,38,,16,15,31
092 Sexten,39,,12,18,30
092 Sexten,40,,22,19,41
092 Sexten,41,,14,17,31
092 Sexten,42,,21,18,39
092 Sexten,43,,15,17,32
092 Sexten,44,,17,18,35
092 Sexten,45,,18,19,37
092 Sexten,46,,28,19,47
092 Sexten,47,,13,19,32
092 Sexten,48,,18,13,31
092 Sexten,49,,22,11,33
092 Sexten,50,,15,15,30
092 Sexten,51,,22,13,35
092 Sexten,52,,18,13,31
092 Sexten,53,,14,14,28
092 Sexten,54,,10,12,22
092 Sexten,55,,11,13,24
092 Sexten,56,,5,11,16
092 Sexten,57,,6,11,17
092 Sexten,58,,7,10,17
092 Sexten,59,,11,7,18
092 Sexten,60,,6,4,10
092 Sexten,61,,10,7,17
092 Sexten,62,,10,4,14
092 Sexten,63,,5,9,14
092 Sexten,64,,7,4,11
092 Sexten,65,,6,12,18
092 Sexten,66,,8,6,14
092 Sexten,67,,5,5,10
092 Sexten,68,,9,16,25
092 Sexten,69,,8,12,20
092 Sexten,70,,5,10,15
092 Sexten,71,,13,11,24
092 Sexten,72,,10,7,17
092 Sexten,73,,7,10,17
092 Sexten,74,,9,14,23
092 Sexten,75,,10,7,17
092 Sexten,76,,3,10,13
092 Sexten,77,,4,7,11
092 Sexten,78,,7,13,20
092 Sexten,79,,6,11,17
092 Sexten,80,,6,13,19
092 Sexten,81,,6,11,17
092 Sexten,82,,5,15,20
092 Sexten,83,,5,4,9
092 Sexten,84,,3,9,12
092 Sexten,85,,5,6,11
092 Sexten,86,,2,7,9
092 Sexten,87,,3,7,10
092 Sexten,88,,1,5,6
092 Sexten,89,,-,3,3
092 Sexten,90,,-,3,3
092 Sexten,92,,-,1,1
092 Sexten,97,,-,1,1
093 Schlanders,0,,26,40,66
093 Schlanders,1,,31,27,58
093 Schlanders,2,,30,32,62
093 Schlanders,3,,26,23,49
093 Schlanders,4,,28,36,64
093 Schlanders,5,,28,35,63
093 Schlanders,6,,27,24,51
093 Schlanders,7,,27,32,59
093 Schlanders,8,,30,32,62
093 Schlanders,9,,39,37,76
093 Schlanders,10,,26,39,65
093 Schlanders,11,,43,40,83
093 Schlanders,12,,57,48,105
093 Schlanders,13,,41,35,76
093 Schlanders,14,,38,28,66
093 Schlanders,15,,42,39,81
093 Schlanders,16,,46,43,89
093 Schlanders,17,,37,46,83
093 Schlanders,18,,43,38,81
093 Schlanders,19,,52,43,95
093 Schlanders,20,,39,35,74
093 Schlanders,21,,36,45,81
093 Schlanders,22,,34,32,66
093 Schlanders,23,,38,39,77
093 Schlanders,24,,41,38,79
093 Schlanders,25,,40,46,86
093 Schlanders,26,,36,43,79
093 Schlanders,27,,49,45,94
093 Schlanders,28,,50,42,92
093 Schlanders,29,,42,35,77
093 Schlanders,30,,30,41,71
093 Schlanders,31,,45,40,85
093 Schlanders,32,,37,48,85
093 Schlanders,33,,31,26,57
093 Schlanders,34,,38,39,77
093 Schlanders,35,,44,33,77
093 Schlanders,36,,40,49,89
093 Schlanders,37,,55,36,91
093 Schlanders,38,,47,47,94
093 Schlanders,39,,45,53,98
093 Schlanders,40,,64,40,104
093 Schlanders,41,,51,37,88
093 Schlanders,42,,45,57,102
093 Schlanders,43,,46,56,102
093 Schlanders,44,,55,53,108
093 Schlanders,45,,43,42,85
093 Schlanders,46,,55,60,115
093 Schlanders,47,,52,48,100
093 Schlanders,48,,40,58,98
093 Schlanders,49,,44,45,89
093 Schlanders,50,,39,40,79
093 Schlanders,51,,48,55,103
093 Schlanders,52,,41,35,76
093 Schlanders,53,,25,35,60
093 Schlanders,54,,26,38,64
093 Schlanders,55,,31,35,66
093 Schlanders,56,,34,38,72
093 Schlanders,57,,33,24,57
093 Schlanders,58,,28,31,59
093 Schlanders,59,,26,32,58
093 Schlanders,60,,29,38,67
093 Schlanders,61,,39,26,65
093 Schlanders,62,,22,22,44
093 Schlanders,63,,26,20,46
093 Schlanders,64,,31,16,47
093 Schlanders,65,,27,32,59
093 Schlanders,66,,30,35,65
093 Schlanders,67,,34,35,69
093 Schlanders,68,,32,37,69
093 Schlanders,69,,26,27,53
093 Schlanders,70,,29,35,64
093 Schlanders,71,,13,18,31
093 Schlanders,72,,25,24,49
093 Schlanders,73,,16,26,42
093 Schlanders,74,,15,24,39
093 Schlanders,75,,17,21,38
093 Schlanders,76,,20,30,50
093 Schlanders,77,,17,15,32
093 Schlanders,78,,20,16,36
093 Schlanders,79,,15,25,40
093 Schlanders,80,,12,14,26
093 Schlanders,81,,13,20,33
093 Schlanders,82,,12,21,33
093 Schlanders,83,,8,18,26
093 Schlanders,84,,9,16,25
093 Schlanders,85,,6,15,21
093 Schlanders,86,,7,13,20
093 Schlanders,87,,3,12,15
093 Schlanders,88,,4,9,13
093 Schlanders,89,,1,13,14
093 Schlanders,90,,2,7,9
093 Schlanders,91,,3,6,9
093 Schlanders,92,,1,1,2
093 Schlanders,93,,-,1,1
093 Schlanders,94,,2,2,4
093 Schlanders,95,,2,1,3
093 Schlanders,96,,-,1,1
093 Schlanders,97,,-,2,2
093 Schlanders,98,,-,1,1
093 Schlanders,99,,-,2,2
093 Schlanders,100,,-,1,1
094 Schluderns,0,,11,10,21
094 Schluderns,1,,8,3,11
094 Schluderns,2,,12,14,26
094 Schluderns,3,,10,8,18
094 Schluderns,4,,6,6,12
094 Schluderns,5,,6,13,19
094 Schluderns,6,,16,9,25
094 Schluderns,7,,14,8,22
094 Schluderns,8,,12,9,21
094 Schluderns,9,,19,8,27
094 Schluderns,10,,8,14,22
094 Schluderns,11,,6,10,16
094 Schluderns,12,,12,11,23
094 Schluderns,13,,12,15,27
094 Schluderns,14,,9,11,20
094 Schluderns,15,,13,18,31
094 Schluderns,16,,15,6,21
094 Schluderns,17,,8,11,19
094 Schluderns,18,,9,9,18
094 Schluderns,19,,22,6,28
094 Schluderns,20,,15,13,28
094 Schluderns,21,,11,11,22
094 Schluderns,22,,7,11,18
094 Schluderns,23,,12,21,33
094 Schluderns,24,,18,12,30
094 Schluderns,25,,15,11,26
094 Schluderns,26,,11,5,16
094 Schluderns,27,,10,16,26
094 Schluderns,28,,19,15,34
094 Schluderns,29,,7,10,17
094 Schluderns,30,,5,16,21
094 Schluderns,31,,11,13,24
094 Schluderns,32,,13,10,23
094 Schluderns,33,,11,18,29
094 Schluderns,34,,18,10,28
094 Schluderns,35,,18,14,32
094 Schluderns,36,,17,11,28
094 Schluderns,37,,13,12,25
094 Schluderns,38,,11,12,23
094 Schluderns,39,,12,12,24
094 Schluderns,40,,17,11,28
094 Schluderns,41,,18,18,36
094 Schluderns,42,,13,16,29
094 Schluderns,43,,15,16,31
094 Schluderns,44,,25,9,34
094 Schluderns,45,,26,13,39
094 Schluderns,46,,13,18,31
094 Schluderns,47,,11,18,29
094 Schluderns,48,,15,16,31
094 Schluderns,49,,11,5,16
094 Schluderns,50,,13,18,31
094 Schluderns,51,,10,13,23
094 Schluderns,52,,16,7,23
094 Schluderns,53,,10,16,26
094 Schluderns,54,,17,11,28
094 Schluderns,55,,14,7,21
094 Schluderns,56,,13,8,21
094 Schluderns,57,,7,6,13
094 Schluderns,58,,11,4,15
094 Schluderns,59,,8,15,23
094 Schluderns,60,,12,10,22
094 Schluderns,61,,9,10,19
094 Schluderns,62,,7,6,13
094 Schluderns,63,,8,9,17
094 Schluderns,64,,7,4,11
094 Schluderns,65,,5,12,17
094 Schluderns,66,,3,8,11
094 Schluderns,67,,8,7,15
094 Schluderns,68,,10,14,24
094 Schluderns,69,,8,4,12
094 Schluderns,70,,12,8,20
094 Schluderns,71,,8,8,16
094 Schluderns,72,,5,10,15
094 Schluderns,73,,4,6,10
094 Schluderns,74,,5,10,15
094 Schluderns,75,,8,11,19
094 Schluderns,76,,5,9,14
094 Schluderns,77,,10,10,20
094 Schluderns,78,,4,7,11
094 Schluderns,79,,6,9,15
094 Schluderns,80,,4,5,9
094 Schluderns,81,,5,7,12
094 Schluderns,82,,3,1,4
094 Schluderns,83,,2,10,12
094 Schluderns,84,,2,6,8
094 Schluderns,85,,2,1,3
094 Schluderns,86,,1,5,6
094 Schluderns,87,,4,2,6
094 Schluderns,88,,-,4,4
094 Schluderns,89,,-,1,1
094 Schluderns,90,,1,2,3
094 Schluderns,91,,2,1,3
094 Schluderns,92,,-,2,2
094 Schluderns,94,,-,1,1
094 Schluderns,95,,1,-,1
095 Stilfs,0,,2,3,5
095 Stilfs,1,,5,7,12
095 Stilfs,2,,2,5,7
095 Stilfs,3,,6,3,9
095 Stilfs,4,,5,5,10
095 Stilfs,5,,7,5,12
095 Stilfs,6,,5,6,11
095 Stilfs,7,,5,3,8
095 Stilfs,8,,5,11,16
095 Stilfs,9,,9,5,14
095 Stilfs,10,,2,7,9
095 Stilfs,11,,7,3,10
095 Stilfs,12,,9,11,20
095 Stilfs,13,,12,1,13
095 Stilfs,14,,7,6,13
095 Stilfs,15,,8,6,14
095 Stilfs,16,,6,15,21
095 Stilfs,17,,4,8,12
095 Stilfs,18,,10,5,15
095 Stilfs,19,,18,8,26
095 Stilfs,20,,8,6,14
095 Stilfs,21,,7,5,12
095 Stilfs,22,,6,8,14
095 Stilfs,23,,9,9,18
095 Stilfs,24,,13,5,18
095 Stilfs,25,,13,7,20
095 Stilfs,26,,9,4,13
095 Stilfs,27,,11,5,16
095 Stilfs,28,,9,6,15
095 Stilfs,29,,5,5,10
095 Stilfs,30,,6,7,13
095 Stilfs,31,,7,10,17
095 Stilfs,32,,8,4,12
095 Stilfs,33,,15,3,18
095 Stilfs,34,,9,8,17
095 Stilfs,35,,5,6,11
095 Stilfs,36,,9,18,27
095 Stilfs,37,,11,10,21
095 Stilfs,38,,12,11,23
095 Stilfs,39,,10,12,22
095 Stilfs,40,,11,11,22
095 Stilfs,41,,8,10,18
095 Stilfs,42,,8,9,17
095 Stilfs,43,,15,9,24
095 Stilfs,44,,12,12,24
095 Stilfs,45,,11,5,16
095 Stilfs,46,,10,6,16
095 Stilfs,47,,8,13,21
095 Stilfs,48,,8,2,10
095 Stilfs,49,,8,7,15
095 Stilfs,50,,9,9,18
095 Stilfs,51,,6,13,19
095 Stilfs,52,,10,6,16
095 Stilfs,53,,5,11,16
095 Stilfs,54,,4,3,7
095 Stilfs,55,,15,9,24
095 Stilfs,56,,10,4,14
095 Stilfs,57,,10,5,15
095 Stilfs,58,,14,9,23
095 Stilfs,59,,2,6,8
095 Stilfs,60,,5,3,8
095 Stilfs,61,,8,9,17
095 Stilfs,62,,6,4,10
095 Stilfs,63,,10,9,19
095 Stilfs,64,,2,4,6
095 Stilfs,65,,12,8,20
095 Stilfs,66,,9,7,16
095 Stilfs,67,,4,12,16
095 Stilfs,68,,7,4,11
095 Stilfs,69,,7,10,17
095 Stilfs,70,,3,8,11
095 Stilfs,71,,4,4,8
095 Stilfs,72,,7,5,12
095 Stilfs,73,,3,9,12
095 Stilfs,74,,2,6,8
095 Stilfs,75,,4,4,8
095 Stilfs,76,,3,6,9
095 Stilfs,77,,3,6,9
095 Stilfs,78,,2,4,6
095 Stilfs,79,,5,5,10
095 Stilfs,80,,2,1,3
095 Stilfs,81,,4,7,11
095 Stilfs,82,,4,4,8
095 Stilfs,83,,1,5,6
095 Stilfs,84,,3,3,6
095 Stilfs,85,,-,5,5
095 Stilfs,86,,-,4,4
095 Stilfs,87,,1,5,6
095 Stilfs,88,,1,5,6
095 Stilfs,89,,-,3,3
095 Stilfs,90,,1,-,1
095 Stilfs,91,,-,1,1
095 Stilfs,92,,-,1,1
095 Stilfs,93,,-,1,1
095 Stilfs,95,,1,-,1
095 Stilfs,97,,-,1,1
096 Terenten,0,,15,7,22
096 Terenten,1,,9,6,15
096 Terenten,2,,11,10,21
096 Terenten,3,,13,8,21
096 Terenten,4,,16,10,26
096 Terenten,5,,11,17,28
096 Terenten,6,,9,12,21
096 Terenten,7,,8,8,16
096 Terenten,8,,11,14,25
096 Terenten,9,,9,10,19
096 Terenten,10,,10,17,27
096 Terenten,11,,21,19,40
096 Terenten,12,,9,7,16
096 Terenten,13,,13,11,24
096 Terenten,14,,12,7,19
096 Terenten,15,,13,13,26
096 Terenten,16,,6,12,18
096 Terenten,17,,9,8,17
096 Terenten,18,,7,16,23
096 Terenten,19,,12,16,28
096 Terenten,20,,14,7,21
096 Terenten,21,,10,7,17
096 Terenten,22,,16,7,23
096 Terenten,23,,9,8,17
096 Terenten,24,,10,14,24
096 Terenten,25,,12,11,23
096 Terenten,26,,14,17,31
096 Terenten,27,,13,10,23
096 Terenten,28,,14,13,27
096 Terenten,29,,11,14,25
096 Terenten,30,,9,11,20
096 Terenten,31,,16,18,34
096 Terenten,32,,11,5,16
096 Terenten,33,,16,10,26
096 Terenten,34,,15,9,24
096 Terenten,35,,16,16,32
096 Terenten,36,,7,16,23
096 Terenten,37,,17,10,27
096 Terenten,38,,16,16,32
096 Terenten,39,,20,11,31
096 Terenten,40,,17,14,31
096 Terenten,41,,14,13,27
096 Terenten,42,,17,18,35
096 Terenten,43,,12,18,30
096 Terenten,44,,16,9,25
096 Terenten,45,,17,14,31
096 Terenten,46,,24,13,37
096 Terenten,47,,20,11,31
096 Terenten,48,,10,16,26
096 Terenten,49,,12,9,21
096 Terenten,50,,15,12,27
096 Terenten,51,,13,10,23
096 Terenten,52,,11,9,20
096 Terenten,53,,9,12,21
096 Terenten,54,,12,10,22
096 Terenten,55,,15,10,25
096 Terenten,56,,9,7,16
096 Terenten,57,,7,7,14
096 Terenten,58,,7,6,13
096 Terenten,59,,8,7,15
096 Terenten,60,,8,6,14
096 Terenten,61,,9,8,17
096 Terenten,62,,7,3,10
096 Terenten,63,,8,4,12
096 Terenten,64,,6,3,9
096 Terenten,65,,3,6,9
096 Terenten,66,,8,5,13
096 Terenten,67,,5,5,10
096 Terenten,68,,5,4,9
096 Terenten,69,,8,5,13
096 Terenten,70,,2,6,8
096 Terenten,71,,5,10,15
096 Terenten,72,,6,5,11
096 Terenten,73,,4,10,14
096 Terenten,74,,6,5,11
096 Terenten,75,,1,4,5
096 Terenten,76,,5,3,8
096 Terenten,77,,4,4,8
096 Terenten,78,,4,9,13
096 Terenten,79,,4,5,9
096 Terenten,80,,4,4,8
096 Terenten,81,,4,5,9
096 Terenten,82,,1,3,4
096 Terenten,83,,3,5,8
096 Terenten,84,,4,2,6
096 Terenten,85,,1,4,5
096 Terenten,86,,3,2,5
096 Terenten,87,,1,-,1
096 Terenten,88,,-,2,2
096 Terenten,89,,1,3,4
096 Terenten,90,,1,-,1
096 Terenten,91,,-,1,1
096 Terenten,92,,1,-,1
097 Terlan,0,,30,23,53
097 Terlan,1,,25,26,51
097 Terlan,2,,21,18,39
097 Terlan,3,,21,30,51
097 Terlan,4,,17,24,41
097 Terlan,5,,28,19,47
097 Terlan,6,,22,23,45
097 Terlan,7,,19,19,38
097 Terlan,8,,22,28,50
097 Terlan,9,,32,25,57
097 Terlan,10,,33,20,53
097 Terlan,11,,20,22,42
097 Terlan,12,,35,30,65
097 Terlan,13,,14,27,41
097 Terlan,14,,26,26,52
097 Terlan,15,,21,19,40
097 Terlan,16,,27,24,51
097 Terlan,17,,24,30,54
097 Terlan,18,,27,20,47
097 Terlan,19,,15,24,39
097 Terlan,20,,24,32,56
097 Terlan,21,,23,18,41
097 Terlan,22,,28,14,42
097 Terlan,23,,18,25,43
097 Terlan,24,,24,18,42
097 Terlan,25,,14,19,33
097 Terlan,26,,24,19,43
097 Terlan,27,,22,24,46
097 Terlan,28,,18,21,39
097 Terlan,29,,34,26,60
097 Terlan,30,,19,28,47
097 Terlan,31,,23,35,58
097 Terlan,32,,39,26,65
097 Terlan,33,,34,37,71
097 Terlan,34,,27,29,56
097 Terlan,35,,29,47,76
097 Terlan,36,,30,39,69
097 Terlan,37,,43,24,67
097 Terlan,38,,33,23,56
097 Terlan,39,,44,41,85
097 Terlan,40,,36,36,72
097 Terlan,41,,39,32,71
097 Terlan,42,,30,40,70
097 Terlan,43,,46,35,81
097 Terlan,44,,37,30,67
097 Terlan,45,,33,30,63
097 Terlan,46,,36,30,66
097 Terlan,47,,32,36,68
097 Terlan,48,,46,27,73
097 Terlan,49,,26,38,64
097 Terlan,50,,20,26,46
097 Terlan,51,,31,23,54
097 Terlan,52,,24,27,51
097 Terlan,53,,30,33,63
097 Terlan,54,,24,21,45
097 Terlan,55,,25,19,44
097 Terlan,56,,12,22,34
097 Terlan,57,,16,25,41
097 Terlan,58,,23,18,41
097 Terlan,59,,24,24,48
097 Terlan,60,,20,15,35
097 Terlan,61,,17,21,38
097 Terlan,62,,16,19,35
097 Terlan,63,,14,24,38
097 Terlan,64,,21,21,42
097 Terlan,65,,23,23,46
097 Terlan,66,,15,28,43
097 Terlan,67,,32,20,52
097 Terlan,68,,22,26,48
097 Terlan,69,,20,15,35
097 Terlan,70,,15,20,35
097 Terlan,71,,20,16,36
097 Terlan,72,,12,16,28
097 Terlan,73,,4,12,16
097 Terlan,74,,15,23,38
097 Terlan,75,,8,23,31
097 Terlan,76,,10,15,25
097 Terlan,77,,13,11,24
097 Terlan,78,,17,12,29
097 Terlan,79,,14,16,30
097 Terlan,80,,11,11,22
097 Terlan,81,,10,11,21
097 Terlan,82,,7,9,16
097 Terlan,83,,9,17,26
097 Terlan,84,,6,11,17
097 Terlan,85,,4,11,15
097 Terlan,86,,6,23,29
097 Terlan,87,,4,11,15
097 Terlan,88,,3,11,14
097 Terlan,89,,-,7,7
097 Terlan,90,,-,4,4
097 Terlan,91,,2,3,5
097 Terlan,92,,-,3,3
097 Terlan,93,,-,4,4
097 Terlan,94,,1,3,4
097 Terlan,95,,-,3,3
097 Terlan,96,,-,2,2
097 Terlan,98,,-,2,2
097 Terlan,99,,-,2,2
097 Terlan,102,,-,1,1
098 Tramin a.d. Weinstr.,0,,23,16,39
098 Tramin a.d. Weinstr.,1,,21,9,30
098 Tramin a.d. Weinstr.,2,,14,12,26
098 Tramin a.d. Weinstr.,3,,16,14,30
098 Tramin a.d. Weinstr.,4,,18,11,29
098 Tramin a.d. Weinstr.,5,,14,19,33
098 Tramin a.d. Weinstr.,6,,28,16,44
098 Tramin a.d. Weinstr.,7,,14,18,32
098 Tramin a.d. Weinstr.,8,,19,19,38
098 Tramin a.d. Weinstr.,9,,24,13,37
098 Tramin a.d. Weinstr.,10,,18,18,36
098 Tramin a.d. Weinstr.,11,,14,17,31
098 Tramin a.d. Weinstr.,12,,29,15,44
098 Tramin a.d. Weinstr.,13,,20,26,46
098 Tramin a.d. Weinstr.,14,,18,20,38
098 Tramin a.d. Weinstr.,15,,21,21,42
098 Tramin a.d. Weinstr.,16,,18,18,36
098 Tramin a.d. Weinstr.,17,,20,24,44
098 Tramin a.d. Weinstr.,18,,21,9,30
098 Tramin a.d. Weinstr.,19,,23,20,43
098 Tramin a.d. Weinstr.,20,,14,29,43
098 Tramin a.d. Weinstr.,21,,13,25,38
098 Tramin a.d. Weinstr.,22,,23,25,48
098 Tramin a.d. Weinstr.,23,,11,16,27
098 Tramin a.d. Weinstr.,24,,22,21,43
098 Tramin a.d. Weinstr.,25,,22,16,38
098 Tramin a.d. Weinstr.,26,,15,21,36
098 Tramin a.d. Weinstr.,27,,22,21,43
098 Tramin a.d. Weinstr.,28,,32,18,50
098 Tramin a.d. Weinstr.,29,,22,16,38
098 Tramin a.d. Weinstr.,30,,16,15,31
098 Tramin a.d. Weinstr.,31,,11,22,33
098 Tramin a.d. Weinstr.,32,,18,17,35
098 Tramin a.d. Weinstr.,33,,24,13,37
098 Tramin a.d. Weinstr.,34,,21,22,43
098 Tramin a.d. Weinstr.,35,,24,20,44
098 Tramin a.d. Weinstr.,36,,19,13,32
098 Tramin a.d. Weinstr.,37,,19,27,46
098 Tramin a.d. Weinstr.,38,,26,35,61
098 Tramin a.d. Weinstr.,39,,32,18,50
098 Tramin a.d. Weinstr.,40,,29,31,60
098 Tramin a.d. Weinstr.,41,,27,21,48
098 Tramin a.d. Weinstr.,42,,28,32,60
098 Tramin a.d. Weinstr.,43,,31,26,57
098 Tramin a.d. Weinstr.,44,,35,30,65
098 Tramin a.d. Weinstr.,45,,29,28,57
098 Tramin a.d. Weinstr.,46,,24,23,47
098 Tramin a.d. Weinstr.,47,,23,13,36
098 Tramin a.d. Weinstr.,48,,30,25,55
098 Tramin a.d. Weinstr.,49,,26,33,59
098 Tramin a.d. Weinstr.,50,,16,32,48
098 Tramin a.d. Weinstr.,51,,25,24,49
098 Tramin a.d. Weinstr.,52,,21,22,43
098 Tramin a.d. Weinstr.,53,,24,20,44
098 Tramin a.d. Weinstr.,54,,16,19,35
098 Tramin a.d. Weinstr.,55,,20,18,38
098 Tramin a.d. Weinstr.,56,,15,15,30
098 Tramin a.d. Weinstr.,57,,17,17,34
098 Tramin a.d. Weinstr.,58,,12,15,27
098 Tramin a.d. Weinstr.,59,,14,19,33
098 Tramin a.d. Weinstr.,60,,15,15,30
098 Tramin a.d. Weinstr.,61,,17,18,35
098 Tramin a.d. Weinstr.,62,,14,22,36
098 Tramin a.d. Weinstr.,63,,21,17,38
098 Tramin a.d. Weinstr.,64,,6,9,15
098 Tramin a.d. Weinstr.,65,,23,25,48
098 Tramin a.d. Weinstr.,66,,18,21,39
098 Tramin a.d. Weinstr.,67,,21,20,41
098 Tramin a.d. Weinstr.,68,,15,24,39
098 Tramin a.d. Weinstr.,69,,20,16,36
098 Tramin a.d. Weinstr.,70,,12,12,24
098 Tramin a.d. Weinstr.,71,,7,18,25
098 Tramin a.d. Weinstr.,72,,13,14,27
098 Tramin a.d. Weinstr.,73,,13,13,26
098 Tramin a.d. Weinstr.,74,,15,13,28
098 Tramin a.d. Weinstr.,75,,8,13,21
098 Tramin a.d. Weinstr.,76,,7,13,20
098 Tramin a.d. Weinstr.,77,,10,15,25
098 Tramin a.d. Weinstr.,78,,6,15,21
098 Tramin a.d. Weinstr.,79,,16,13,29
098 Tramin a.d. Weinstr.,80,,8,14,22
098 Tramin a.d. Weinstr.,81,,13,14,27
098 Tramin a.d. Weinstr.,82,,14,12,26
098 Tramin a.d. Weinstr.,83,,9,16,25
098 Tramin a.d. Weinstr.,84,,8,16,24
098 Tramin a.d. Weinstr.,85,,6,13,19
098 Tramin a.d. Weinstr.,86,,3,13,16
098 Tramin a.d. Weinstr.,87,,1,6,7
098 Tramin a.d. Weinstr.,88,,5,8,13
098 Tramin a.d. Weinstr.,89,,3,6,9
098 Tramin a.d. Weinstr.,90,,2,7,9
098 Tramin a.d. Weinstr.,91,,1,1,2
098 Tramin a.d. Weinstr.,93,,1,-,1
098 Tramin a.d. Weinstr.,94,,-,3,3
098 Tramin a.d. Weinstr.,95,,-,3,3
098 Tramin a.d. Weinstr.,97,,1,1,2
098 Tramin a.d. Weinstr.,98,,-,1,1
098 Tramin a.d. Weinstr.,99,,1,-,1
099 Tisens,0,,6,3,9
099 Tisens,1,,12,7,19
099 Tisens,2,,11,9,20
099 Tisens,3,,8,7,15
099 Tisens,4,,11,15,26
099 Tisens,5,,12,13,25
099 Tisens,6,,9,12,21
099 Tisens,7,,12,9,21
099 Tisens,8,,10,16,26
099 Tisens,9,,9,10,19
099 Tisens,10,,9,8,17
099 Tisens,11,,13,15,28
099 Tisens,12,,4,6,10
099 Tisens,13,,11,7,18
099 Tisens,14,,10,6,16
099 Tisens,15,,11,11,22
099 Tisens,16,,5,9,14
099 Tisens,17,,6,16,22
099 Tisens,18,,16,9,25
099 Tisens,19,,10,14,24
099 Tisens,20,,11,7,18
099 Tisens,21,,8,12,20
099 Tisens,22,,13,6,19
099 Tisens,23,,15,7,22
099 Tisens,24,,9,7,16
099 Tisens,25,,9,14,23
099 Tisens,26,,18,5,23
099 Tisens,27,,14,15,29
099 Tisens,28,,6,20,26
099 Tisens,29,,15,12,27
099 Tisens,30,,11,9,20
099 Tisens,31,,10,16,26
099 Tisens,32,,11,9,20
099 Tisens,33,,8,8,16
099 Tisens,34,,15,11,26
099 Tisens,35,,13,10,23
099 Tisens,36,,9,10,19
099 Tisens,37,,9,15,24
099 Tisens,38,,16,12,28
099 Tisens,39,,16,19,35
099 Tisens,40,,18,16,34
099 Tisens,41,,19,21,40
099 Tisens,42,,23,22,45
099 Tisens,43,,22,11,33
099 Tisens,44,,16,27,43
099 Tisens,45,,16,9,25
099 Tisens,46,,19,15,34
099 Tisens,47,,22,6,28
099 Tisens,48,,13,14,27
099 Tisens,49,,19,6,25
099 Tisens,50,,11,14,25
099 Tisens,51,,9,13,22
099 Tisens,52,,16,19,35
099 Tisens,53,,10,12,22
099 Tisens,54,,18,13,31
099 Tisens,55,,9,8,17
099 Tisens,56,,11,11,22
099 Tisens,57,,7,12,19
099 Tisens,58,,12,10,22
099 Tisens,59,,9,7,16
099 Tisens,60,,5,7,12
099 Tisens,61,,13,7,20
099 Tisens,62,,9,9,18
099 Tisens,63,,7,6,13
099 Tisens,64,,3,7,10
099 Tisens,65,,10,11,21
099 Tisens,66,,11,9,20
099 Tisens,67,,7,10,17
099 Tisens,68,,7,14,21
099 Tisens,69,,6,8,14
099 Tisens,70,,12,9,21
099 Tisens,71,,7,12,19
099 Tisens,72,,6,4,10
099 Tisens,73,,7,8,15
099 Tisens,74,,4,11,15
099 Tisens,75,,7,6,13
099 Tisens,76,,2,10,12
099 Tisens,77,,5,9,14
099 Tisens,78,,5,9,14
099 Tisens,79,,2,15,17
099 Tisens,80,,6,8,14
099 Tisens,81,,6,9,15
099 Tisens,82,,5,9,14
099 Tisens,83,,4,9,13
099 Tisens,84,,3,7,10
099 Tisens,85,,1,3,4
099 Tisens,86,,1,7,8
099 Tisens,87,,3,5,8
099 Tisens,88,,4,6,10
099 Tisens,89,,2,1,3
099 Tisens,90,,2,4,6
099 Tisens,93,,-,2,2
099 Tisens,94,,-,1,1
099 Tisens,95,,1,1,2
099 Tisens,97,,-,2,2
099 Tisens,98,,-,1,1
100 Tiers,0,,4,1,5
100 Tiers,1,,9,8,17
100 Tiers,2,,9,4,13
100 Tiers,3,,2,9,11
100 Tiers,4,,2,10,12
100 Tiers,5,,4,3,7
100 Tiers,6,,4,8,12
100 Tiers,7,,6,4,10
100 Tiers,8,,3,8,11
100 Tiers,9,,2,8,10
100 Tiers,10,,4,9,13
100 Tiers,11,,4,10,14
100 Tiers,12,,9,6,15
100 Tiers,13,,7,4,11
100 Tiers,14,,7,10,17
100 Tiers,15,,5,7,12
100 Tiers,16,,5,2,7
100 Tiers,17,,6,3,9
100 Tiers,18,,6,3,9
100 Tiers,19,,7,8,15
100 Tiers,20,,4,7,11
100 Tiers,21,,6,9,15
100 Tiers,22,,5,4,9
100 Tiers,23,,8,7,15
100 Tiers,24,,4,7,11
100 Tiers,25,,4,9,13
100 Tiers,26,,6,4,10
100 Tiers,27,,5,5,10
100 Tiers,28,,5,5,10
100 Tiers,29,,4,6,10
100 Tiers,30,,1,5,6
100 Tiers,31,,9,10,19
100 Tiers,32,,6,3,9
100 Tiers,33,,2,5,7
100 Tiers,34,,10,4,14
100 Tiers,35,,4,11,15
100 Tiers,36,,8,10,18
100 Tiers,37,,10,7,17
100 Tiers,38,,5,7,12
100 Tiers,39,,7,7,14
100 Tiers,40,,16,11,27
100 Tiers,41,,6,4,10
100 Tiers,42,,10,11,21
100 Tiers,43,,10,6,16
100 Tiers,44,,6,6,12
100 Tiers,45,,9,5,14
100 Tiers,46,,7,10,17
100 Tiers,47,,6,7,13
100 Tiers,48,,6,6,12
100 Tiers,49,,4,8,12
100 Tiers,50,,12,5,17
100 Tiers,51,,7,4,11
100 Tiers,52,,5,9,14
100 Tiers,53,,10,8,18
100 Tiers,54,,5,3,8
100 Tiers,55,,6,4,10
100 Tiers,56,,6,4,10
100 Tiers,57,,3,3,6
100 Tiers,58,,1,4,5
100 Tiers,59,,7,5,12
100 Tiers,60,,3,5,8
100 Tiers,61,,3,5,8
100 Tiers,62,,2,3,5
100 Tiers,63,,6,4,10
100 Tiers,64,,8,3,11
100 Tiers,65,,2,5,7
100 Tiers,66,,8,10,18
100 Tiers,67,,2,5,7
100 Tiers,68,,4,6,10
100 Tiers,69,,2,3,5
100 Tiers,70,,5,6,11
100 Tiers,71,,6,5,11
100 Tiers,72,,6,5,11
100 Tiers,73,,4,6,10
100 Tiers,74,,6,2,8
100 Tiers,75,,2,5,7
100 Tiers,76,,5,3,8
100 Tiers,77,,2,5,7
100 Tiers,78,,4,3,7
100 Tiers,79,,2,-,2
100 Tiers,80,,2,2,4
100 Tiers,81,,2,2,4
100 Tiers,82,,4,3,7
100 Tiers,83,,3,2,5
100 Tiers,84,,5,2,7
100 Tiers,85,,1,4,5
100 Tiers,86,,1,2,3
100 Tiers,87,,1,1,2
100 Tiers,88,,-,5,5
100 Tiers,89,,2,2,4
100 Tiers,90,,-,1,1
100 Tiers,91,,1,1,2
100 Tiers,92,,-,1,1
100 Tiers,94,,1,1,2
100 Tiers,97,,-,2,2
101 Tirol,0,,11,9,20
101 Tirol,1,,12,10,22
101 Tirol,2,,15,9,24
101 Tirol,3,,8,10,18
101 Tirol,4,,14,6,20
101 Tirol,5,,13,17,30
101 Tirol,6,,12,11,23
101 Tirol,7,,15,9,24
101 Tirol,8,,17,9,26
101 Tirol,9,,20,13,33
101 Tirol,10,,12,16,28
101 Tirol,11,,17,13,30
101 Tirol,12,,19,23,42
101 Tirol,13,,18,16,34
101 Tirol,14,,9,17,26
101 Tirol,15,,14,14,28
101 Tirol,16,,21,10,31
101 Tirol,17,,14,13,27
101 Tirol,18,,8,8,16
101 Tirol,19,,15,12,27
101 Tirol,20,,11,18,29
101 Tirol,21,,14,14,28
101 Tirol,22,,15,9,24
101 Tirol,23,,11,12,23
101 Tirol,24,,10,16,26
101 Tirol,25,,20,12,32
101 Tirol,26,,18,13,31
101 Tirol,27,,14,12,26
101 Tirol,28,,20,22,42
101 Tirol,29,,23,6,29
101 Tirol,30,,14,8,22
101 Tirol,31,,8,12,20
101 Tirol,32,,14,19,33
101 Tirol,33,,15,13,28
101 Tirol,34,,19,15,34
101 Tirol,35,,14,20,34
101 Tirol,36,,23,17,40
101 Tirol,37,,27,18,45
101 Tirol,38,,22,16,38
101 Tirol,39,,19,16,35
101 Tirol,40,,21,19,40
101 Tirol,41,,24,25,49
101 Tirol,42,,24,20,44
101 Tirol,43,,22,19,41
101 Tirol,44,,19,16,35
101 Tirol,45,,27,23,50
101 Tirol,46,,19,14,33
101 Tirol,47,,17,17,34
101 Tirol,48,,17,22,39
101 Tirol,49,,23,14,37
101 Tirol,50,,16,16,32
101 Tirol,51,,11,18,29
101 Tirol,52,,16,20,36
101 Tirol,53,,8,14,22
101 Tirol,54,,14,17,31
101 Tirol,55,,14,17,31
101 Tirol,56,,18,18,36
101 Tirol,57,,14,12,26
101 Tirol,58,,15,18,33
101 Tirol,59,,12,10,22
101 Tirol,60,,16,16,32
101 Tirol,61,,21,15,36
101 Tirol,62,,10,13,23
101 Tirol,63,,14,8,22
101 Tirol,64,,12,14,26
101 Tirol,65,,15,15,30
101 Tirol,66,,11,11,22
101 Tirol,67,,13,17,30
101 Tirol,68,,11,16,27
101 Tirol,69,,9,14,23
101 Tirol,70,,10,12,22
101 Tirol,71,,8,8,16
101 Tirol,72,,9,14,23
101 Tirol,73,,6,10,16
101 Tirol,74,,7,8,15
101 Tirol,75,,13,8,21
101 Tirol,76,,5,10,15
101 Tirol,77,,8,7,15
101 Tirol,78,,7,8,15
101 Tirol,79,,4,7,11
101 Tirol,80,,7,11,18
101 Tirol,81,,6,9,15
101 Tirol,82,,8,7,15
101 Tirol,83,,3,6,9
101 Tirol,84,,6,7,13
101 Tirol,85,,4,9,13
101 Tirol,86,,2,4,6
101 Tirol,87,,2,4,6
101 Tirol,88,,4,4,8
101 Tirol,89,,2,4,6
101 Tirol,90,,1,3,4
101 Tirol,91,,1,2,3
101 Tirol,93,,1,-,1
101 Tirol,95,,-,1,1
101 Tirol,98,,-,1,1
102 Truden im Naturpark,0,,9,8,17
102 Truden im Naturpark,1,,4,7,11
102 Truden im Naturpark,2,,9,6,15
102 Truden im Naturpark,3,,5,1,6
102 Truden im Naturpark,4,,1,5,6
102 Truden im Naturpark,5,,3,8,11
102 Truden im Naturpark,6,,6,4,10
102 Truden im Naturpark,7,,2,3,5
102 Truden im Naturpark,8,,4,2,6
102 Truden im Naturpark,9,,6,7,13
102 Truden im Naturpark,10,,-,3,3
102 Truden im Naturpark,11,,3,7,10
102 Truden im Naturpark,12,,7,6,13
102 Truden im Naturpark,13,,6,6,12
102 Truden im Naturpark,14,,5,6,11
102 Truden im Naturpark,15,,6,5,11
102 Truden im Naturpark,16,,11,6,17
102 Truden im Naturpark,17,,7,5,12
102 Truden im Naturpark,18,,7,8,15
102 Truden im Naturpark,19,,3,5,8
102 Truden im Naturpark,20,,10,9,19
102 Truden im Naturpark,21,,7,12,19
102 Truden im Naturpark,22,,7,4,11
102 Truden im Naturpark,23,,1,7,8
102 Truden im Naturpark,24,,8,6,14
102 Truden im Naturpark,25,,11,4,15
102 Truden im Naturpark,26,,5,5,10
102 Truden im Naturpark,27,,12,4,16
102 Truden im Naturpark,28,,3,12,15
102 Truden im Naturpark,29,,5,3,8
102 Truden im Naturpark,30,,8,6,14
102 Truden im Naturpark,31,,8,7,15
102 Truden im Naturpark,32,,3,5,8
102 Truden im Naturpark,33,,9,6,15
102 Truden im Naturpark,34,,7,4,11
102 Truden im Naturpark,35,,5,9,14
102 Truden im Naturpark,36,,8,10,18
102 Truden im Naturpark,37,,9,9,18
102 Truden im Naturpark,38,,3,3,6
102 Truden im Naturpark,39,,1,8,9
102 Truden im Naturpark,40,,9,9,18
102 Truden im Naturpark,41,,6,9,15
102 Truden im Naturpark,42,,12,6,18
102 Truden im Naturpark,43,,7,8,15
102 Truden im Naturpark,44,,8,8,16
102 Truden im Naturpark,45,,10,8,18
102 Truden im Naturpark,46,,12,6,18
102 Truden im Naturpark,47,,8,4,12
102 Truden im Naturpark,48,,8,6,14
102 Truden im Naturpark,49,,8,13,21
102 Truden im Naturpark,50,,6,9,15
102 Truden im Naturpark,51,,5,11,16
102 Truden im Naturpark,52,,6,8,14
102 Truden im Naturpark,53,,7,5,12
102 Truden im Naturpark,54,,7,10,17
102 Truden im Naturpark,55,,5,6,11
102 Truden im Naturpark,56,,9,7,16
102 Truden im Naturpark,57,,5,6,11
102 Truden im Naturpark,58,,8,5,13
102 Truden im Naturpark,59,,3,2,5
102 Truden im Naturpark,60,,6,3,9
102 Truden im Naturpark,61,,1,6,7
102 Truden im Naturpark,62,,6,1,7
102 Truden im Naturpark,63,,8,6,14
102 Truden im Naturpark,64,,5,3,8
102 Truden im Naturpark,65,,3,5,8
102 Truden im Naturpark,66,,5,5,10
102 Truden im Naturpark,67,,4,4,8
102 Truden im Naturpark,68,,4,5,9
102 Truden im Naturpark,69,,2,4,6
102 Truden im Naturpark,70,,8,2,10
102 Truden im Naturpark,71,,5,7,12
102 Truden im Naturpark,72,,2,4,6
102 Truden im Naturpark,73,,4,3,7
102 Truden im Naturpark,74,,3,3,6
102 Truden im Naturpark,75,,4,1,5
102 Truden im Naturpark,76,,5,7,12
102 Truden im Naturpark,77,,4,3,7
102 Truden im Naturpark,78,,5,4,9
102 Truden im Naturpark,79,,2,7,9
102 Truden im Naturpark,80,,-,6,6
102 Truden im Naturpark,81,,-,6,6
102 Truden im Naturpark,82,,3,6,9
102 Truden im Naturpark,83,,1,7,8
102 Truden im Naturpark,84,,-,4,4
102 Truden im Naturpark,85,,-,7,7
102 Truden im Naturpark,86,,1,5,6
102 Truden im Naturpark,87,,2,4,6
102 Truden im Naturpark,88,,-,3,3
102 Truden im Naturpark,89,,-,2,2
102 Truden im Naturpark,90,,-,3,3
102 Truden im Naturpark,91,,-,1,1
103 Taufers im Münstertal,0,,7,7,14
103 Taufers im Münstertal,1,,6,5,11
103 Taufers im Münstertal,2,,6,6,12
103 Taufers im Münstertal,3,,5,9,14
103 Taufers im Münstertal,4,,2,5,7
103 Taufers im Münstertal,5,,8,6,14
103 Taufers im Münstertal,6,,3,3,6
103 Taufers im Münstertal,7,,5,5,10
103 Taufers im Münstertal,8,,5,6,11
103 Taufers im Münstertal,9,,4,4,8
103 Taufers im Münstertal,10,,3,4,7
103 Taufers im Münstertal,11,,7,8,15
103 Taufers im Münstertal,12,,4,4,8
103 Taufers im Münstertal,13,,6,4,10
103 Taufers im Münstertal,14,,9,9,18
103 Taufers im Münstertal,15,,6,8,14
103 Taufers im Münstertal,16,,5,5,10
103 Taufers im Münstertal,17,,9,8,17
103 Taufers im Münstertal,18,,6,10,16
103 Taufers im Münstertal,19,,8,7,15
103 Taufers im Münstertal,20,,8,3,11
103 Taufers im Münstertal,21,,6,8,14
103 Taufers im Münstertal,22,,4,5,9
103 Taufers im Münstertal,23,,6,5,11
103 Taufers im Münstertal,24,,6,5,11
103 Taufers im Münstertal,25,,4,6,10
103 Taufers im Münstertal,26,,4,7,11
103 Taufers im Münstertal,27,,6,10,16
103 Taufers im Münstertal,28,,8,7,15
103 Taufers im Münstertal,29,,11,5,16
103 Taufers im Münstertal,30,,5,2,7
103 Taufers im Münstertal,31,,9,3,12
103 Taufers im Münstertal,32,,4,3,7
103 Taufers im Münstertal,33,,2,6,8
103 Taufers im Münstertal,34,,11,5,16
103 Taufers im Münstertal,35,,7,7,14
103 Taufers im Münstertal,36,,1,6,7
103 Taufers im Münstertal,37,,4,7,11
103 Taufers im Münstertal,38,,7,15,22
103 Taufers im Münstertal,39,,6,9,15
103 Taufers im Münstertal,40,,9,6,15
103 Taufers im Münstertal,41,,9,12,21
103 Taufers im Münstertal,42,,4,5,9
103 Taufers im Münstertal,43,,5,11,16
103 Taufers im Münstertal,44,,12,7,19
103 Taufers im Münstertal,45,,8,13,21
103 Taufers im Münstertal,46,,9,9,18
103 Taufers im Münstertal,47,,12,8,20
103 Taufers im Münstertal,48,,10,7,17
103 Taufers im Münstertal,49,,12,7,19
103 Taufers im Münstertal,50,,6,10,16
103 Taufers im Münstertal,51,,5,6,11
103 Taufers im Münstertal,52,,8,7,15
103 Taufers im Münstertal,53,,11,10,21
103 Taufers im Münstertal,54,,4,3,7
103 Taufers im Münstertal,55,,4,6,10
103 Taufers im Münstertal,56,,7,4,11
103 Taufers im Münstertal,57,,6,2,8
103 Taufers im Münstertal,58,,5,4,9
103 Taufers im Münstertal,59,,7,2,9
103 Taufers im Münstertal,60,,6,1,7
103 Taufers im Münstertal,61,,5,-,5
103 Taufers im Münstertal,62,,4,7,11
103 Taufers im Münstertal,63,,3,3,6
103 Taufers im Münstertal,64,,3,4,7
103 Taufers im Münstertal,65,,1,-,1
103 Taufers im Münstertal,66,,6,4,10
103 Taufers im Münstertal,67,,4,5,9
103 Taufers im Münstertal,68,,3,7,10
103 Taufers im Münstertal,69,,2,3,5
103 Taufers im Münstertal,70,,5,4,9
103 Taufers im Münstertal,71,,6,8,14
103 Taufers im Münstertal,72,,3,4,7
103 Taufers im Münstertal,73,,2,9,11
103 Taufers im Münstertal,74,,4,2,6
103 Taufers im Münstertal,75,,3,7,10
103 Taufers im Münstertal,76,,3,5,8
103 Taufers im Münstertal,77,,5,1,6
103 Taufers im Münstertal,78,,7,3,10
103 Taufers im Münstertal,79,,2,3,5
103 Taufers im Münstertal,80,,4,6,10
103 Taufers im Münstertal,81,,3,4,7
103 Taufers im Münstertal,82,,2,3,5
103 Taufers im Münstertal,83,,1,4,5
103 Taufers im Münstertal,84,,1,4,5
103 Taufers im Münstertal,85,,-,4,4
103 Taufers im Münstertal,86,,3,1,4
103 Taufers im Münstertal,87,,1,1,2
103 Taufers im Münstertal,88,,1,-,1
103 Taufers im Münstertal,89,,3,-,3
103 Taufers im Münstertal,90,,1,-,1
103 Taufers im Münstertal,91,,-,1,1
103 Taufers im Münstertal,92,,1,1,2
103 Taufers im Münstertal,96,,-,1,1
103 Taufers im Münstertal,97,,-,1,1
103 Taufers im Münstertal,100,,-,1,1
104 Ulten,0,,20,11,31
104 Ulten,1,,17,10,27
104 Ulten,2,,7,10,17
104 Ulten,3,,14,10,24
104 Ulten,4,,18,21,39
104 Ulten,5,,17,12,29
104 Ulten,6,,22,19,41
104 Ulten,7,,16,19,35
104 Ulten,8,,19,16,35
104 Ulten,9,,17,18,35
104 Ulten,10,,14,14,28
104 Ulten,11,,16,16,32
104 Ulten,12,,14,19,33
104 Ulten,13,,11,14,25
104 Ulten,14,,12,16,28
104 Ulten,15,,19,15,34
104 Ulten,16,,23,14,37
104 Ulten,17,,17,17,34
104 Ulten,18,,23,30,53
104 Ulten,19,,15,18,33
104 Ulten,20,,16,29,45
104 Ulten,21,,14,20,34
104 Ulten,22,,18,17,35
104 Ulten,23,,21,10,31
104 Ulten,24,,17,16,33
104 Ulten,25,,20,18,38
104 Ulten,26,,22,15,37
104 Ulten,27,,14,21,35
104 Ulten,28,,22,19,41
104 Ulten,29,,18,20,38
104 Ulten,30,,17,16,33
104 Ulten,31,,23,16,39
104 Ulten,32,,20,15,35
104 Ulten,33,,16,18,34
104 Ulten,34,,23,22,45
104 Ulten,35,,16,21,37
104 Ulten,36,,26,13,39
104 Ulten,37,,21,19,40
104 Ulten,38,,26,22,48
104 Ulten,39,,22,23,45
104 Ulten,40,,28,22,50
104 Ulten,41,,29,25,54
104 Ulten,42,,17,20,37
104 Ulten,43,,21,18,39
104 Ulten,44,,27,28,55
104 Ulten,45,,23,20,43
104 Ulten,46,,28,25,53
104 Ulten,47,,30,21,51
104 Ulten,48,,28,16,44
104 Ulten,49,,25,20,45
104 Ulten,50,,24,23,47
104 Ulten,51,,26,16,42
104 Ulten,52,,34,22,56
104 Ulten,53,,17,16,33
104 Ulten,54,,13,12,25
104 Ulten,55,,18,16,34
104 Ulten,56,,24,13,37
104 Ulten,57,,18,13,31
104 Ulten,58,,18,17,35
104 Ulten,59,,18,13,31
104 Ulten,60,,17,9,26
104 Ulten,61,,13,12,25
104 Ulten,62,,16,9,25
104 Ulten,63,,15,14,29
104 Ulten,64,,9,13,22
104 Ulten,65,,14,21,35
104 Ulten,66,,17,16,33
104 Ulten,67,,9,15,24
104 Ulten,68,,12,10,22
104 Ulten,69,,16,9,25
104 Ulten,70,,19,16,35
104 Ulten,71,,6,10,16
104 Ulten,72,,10,10,20
104 Ulten,73,,8,9,17
104 Ulten,74,,8,12,20
104 Ulten,75,,10,13,23
104 Ulten,76,,5,12,17
104 Ulten,77,,11,8,19
104 Ulten,78,,10,8,18
104 Ulten,79,,11,15,26
104 Ulten,80,,4,12,16
104 Ulten,81,,8,12,20
104 Ulten,82,,6,17,23
104 Ulten,83,,4,13,17
104 Ulten,84,,13,11,24
104 Ulten,85,,5,9,14
104 Ulten,86,,6,23,29
104 Ulten,87,,4,7,11
104 Ulten,88,,7,8,15
104 Ulten,89,,4,8,12
104 Ulten,90,,1,6,7
104 Ulten,91,,1,-,1
104 Ulten,93,,-,1,1
104 Ulten,94,,1,-,1
104 Ulten,95,,-,2,2
104 Ulten,98,,-,3,3
104 Ulten,111,,-,1,1
105 Pfatten,0,,5,8,13
105 Pfatten,1,,7,6,13
105 Pfatten,2,,7,5,12
105 Pfatten,3,,8,3,11
105 Pfatten,4,,7,12,19
105 Pfatten,5,,2,6,8
105 Pfatten,6,,12,7,19
105 Pfatten,7,,3,6,9
105 Pfatten,8,,4,4,8
105 Pfatten,9,,6,6,12
105 Pfatten,10,,4,7,11
105 Pfatten,11,,9,5,14
105 Pfatten,12,,5,2,7
105 Pfatten,13,,4,8,12
105 Pfatten,14,,5,7,12
105 Pfatten,15,,8,10,18
105 Pfatten,16,,4,6,10
105 Pfatten,17,,6,7,13
105 Pfatten,18,,8,6,14
105 Pfatten,19,,10,7,17
105 Pfatten,20,,6,7,13
105 Pfatten,21,,2,6,8
105 Pfatten,22,,7,4,11
105 Pfatten,23,,6,10,16
105 Pfatten,24,,5,7,12
105 Pfatten,25,,3,6,9
105 Pfatten,26,,3,8,11
105 Pfatten,27,,5,3,8
105 Pfatten,28,,10,3,13
105 Pfatten,29,,2,4,6
105 Pfatten,30,,7,11,18
105 Pfatten,31,,5,10,15
105 Pfatten,32,,8,6,14
105 Pfatten,33,,7,9,16
105 Pfatten,34,,3,11,14
105 Pfatten,35,,17,11,28
105 Pfatten,36,,11,6,17
105 Pfatten,37,,11,9,20
105 Pfatten,38,,10,6,16
105 Pfatten,39,,10,7,17
105 Pfatten,40,,7,4,11
105 Pfatten,41,,8,8,16
105 Pfatten,42,,12,7,19
105 Pfatten,43,,8,8,16
105 Pfatten,44,,11,11,22
105 Pfatten,45,,10,3,13
105 Pfatten,46,,7,9,16
105 Pfatten,47,,9,14,23
105 Pfatten,48,,11,15,26
105 Pfatten,49,,7,9,16
105 Pfatten,50,,5,13,18
105 Pfatten,51,,7,5,12
105 Pfatten,52,,16,5,21
105 Pfatten,53,,9,9,18
105 Pfatten,54,,6,5,11
105 Pfatten,55,,12,2,14
105 Pfatten,56,,6,5,11
105 Pfatten,57,,1,7,8
105 Pfatten,58,,3,5,8
105 Pfatten,59,,6,6,12
105 Pfatten,60,,9,2,11
105 Pfatten,61,,3,2,5
105 Pfatten,62,,7,7,14
105 Pfatten,63,,3,4,7
105 Pfatten,64,,6,3,9
105 Pfatten,65,,4,2,6
105 Pfatten,66,,2,3,5
105 Pfatten,67,,2,3,5
105 Pfatten,68,,5,4,9
105 Pfatten,69,,3,3,6
105 Pfatten,70,,4,2,6
105 Pfatten,71,,2,2,4
105 Pfatten,72,,4,1,5
105 Pfatten,73,,3,3,6
105 Pfatten,74,,5,3,8
105 Pfatten,75,,3,6,9
105 Pfatten,76,,1,2,3
105 Pfatten,77,,-,5,5
105 Pfatten,78,,2,4,6
105 Pfatten,79,,2,2,4
105 Pfatten,80,,-,5,5
105 Pfatten,81,,-,1,1
105 Pfatten,83,,2,2,4
105 Pfatten,84,,1,3,4
105 Pfatten,85,,1,3,4
105 Pfatten,86,,1,-,1
105 Pfatten,87,,1,-,1
105 Pfatten,88,,-,1,1
105 Pfatten,89,,-,1,1
105 Pfatten,92,,1,1,2
105 Pfatten,93,,-,1,1
106 Olang,0,,12,18,30
106 Olang,1,,23,20,43
106 Olang,2,,12,19,31
106 Olang,3,,7,18,25
106 Olang,4,,23,12,35
106 Olang,5,,16,11,27
106 Olang,6,,19,11,30
106 Olang,7,,16,13,29
106 Olang,8,,17,21,38
106 Olang,9,,19,23,42
106 Olang,10,,17,15,32
106 Olang,11,,18,23,41
106 Olang,12,,24,18,42
106 Olang,13,,26,23,49
106 Olang,14,,19,10,29
106 Olang,15,,21,11,32
106 Olang,16,,21,24,45
106 Olang,17,,16,17,33
106 Olang,18,,26,19,45
106 Olang,19,,25,23,48
106 Olang,20,,23,20,43
106 Olang,21,,16,18,34
106 Olang,22,,26,20,46
106 Olang,23,,15,19,34
106 Olang,24,,13,23,36
106 Olang,25,,25,12,37
106 Olang,26,,18,21,39
106 Olang,27,,22,25,47
106 Olang,28,,13,21,34
106 Olang,29,,21,24,45
106 Olang,30,,19,25,44
106 Olang,31,,22,18,40
106 Olang,32,,30,30,60
106 Olang,33,,21,23,44
106 Olang,34,,28,28,56
106 Olang,35,,14,28,42
106 Olang,36,,28,25,53
106 Olang,37,,27,19,46
106 Olang,38,,32,20,52
106 Olang,39,,22,21,43
106 Olang,40,,21,31,52
106 Olang,41,,29,25,54
106 Olang,42,,33,24,57
106 Olang,43,,32,24,56
106 Olang,44,,18,25,43
106 Olang,45,,21,29,50
106 Olang,46,,24,23,47
106 Olang,47,,26,13,39
106 Olang,48,,15,27,42
106 Olang,49,,21,25,46
106 Olang,50,,26,15,41
106 Olang,51,,23,14,37
106 Olang,52,,27,12,39
106 Olang,53,,15,28,43
106 Olang,54,,17,18,35
106 Olang,55,,15,19,34
106 Olang,56,,16,21,37
106 Olang,57,,16,13,29
106 Olang,58,,8,14,22
106 Olang,59,,32,18,50
106 Olang,60,,22,11,33
106 Olang,61,,19,22,41
106 Olang,62,,14,23,37
106 Olang,63,,15,13,28
106 Olang,64,,18,11,29
106 Olang,65,,15,6,21
106 Olang,66,,12,16,28
106 Olang,67,,14,17,31
106 Olang,68,,13,13,26
106 Olang,69,,16,10,26
106 Olang,70,,12,8,20
106 Olang,71,,9,14,23
106 Olang,72,,6,9,15
106 Olang,73,,7,8,15
106 Olang,74,,7,14,21
106 Olang,75,,11,9,20
106 Olang,76,,9,15,24
106 Olang,77,,9,11,20
106 Olang,78,,3,6,9
106 Olang,79,,13,6,19
106 Olang,80,,8,13,21
106 Olang,81,,4,7,11
106 Olang,82,,5,8,13
106 Olang,83,,2,9,11
106 Olang,84,,3,2,5
106 Olang,85,,2,6,8
106 Olang,86,,3,2,5
106 Olang,87,,2,5,7
106 Olang,88,,2,2,4
106 Olang,89,,1,5,6
106 Olang,90,,1,1,2
106 Olang,92,,-,1,1
106 Olang,93,,-,1,1
106 Olang,94,,1,3,4
106 Olang,95,,-,2,2
107 Pfitsch,0,,18,12,30
107 Pfitsch,1,,13,20,33
107 Pfitsch,2,,12,9,21
107 Pfitsch,3,,23,12,35
107 Pfitsch,4,,16,16,32
107 Pfitsch,5,,22,11,33
107 Pfitsch,6,,16,11,27
107 Pfitsch,7,,22,19,41
107 Pfitsch,8,,10,9,19
107 Pfitsch,9,,23,25,48
107 Pfitsch,10,,17,16,33
107 Pfitsch,11,,10,17,27
107 Pfitsch,12,,16,15,31
107 Pfitsch,13,,11,13,24
107 Pfitsch,14,,15,10,25
107 Pfitsch,15,,13,19,32
107 Pfitsch,16,,14,14,28
107 Pfitsch,17,,14,15,29
107 Pfitsch,18,,19,13,32
107 Pfitsch,19,,16,18,34
107 Pfitsch,20,,8,18,26
107 Pfitsch,21,,15,13,28
107 Pfitsch,22,,10,18,28
107 Pfitsch,23,,13,11,24
107 Pfitsch,24,,15,14,29
107 Pfitsch,25,,24,11,35
107 Pfitsch,26,,20,26,46
107 Pfitsch,27,,28,15,43
107 Pfitsch,28,,23,19,42
107 Pfitsch,29,,20,19,39
107 Pfitsch,30,,28,17,45
107 Pfitsch,31,,27,21,48
107 Pfitsch,32,,16,19,35
107 Pfitsch,33,,19,23,42
107 Pfitsch,34,,17,29,46
107 Pfitsch,35,,20,22,42
107 Pfitsch,36,,20,19,39
107 Pfitsch,37,,22,20,42
107 Pfitsch,38,,27,16,43
107 Pfitsch,39,,18,21,39
107 Pfitsch,40,,25,19,44
107 Pfitsch,41,,21,19,40
107 Pfitsch,42,,20,16,36
107 Pfitsch,43,,28,16,44
107 Pfitsch,44,,21,19,40
107 Pfitsch,45,,15,27,42
107 Pfitsch,46,,19,18,37
107 Pfitsch,47,,25,18,43
107 Pfitsch,48,,22,21,43
107 Pfitsch,49,,15,24,39
107 Pfitsch,50,,12,16,28
107 Pfitsch,51,,25,14,39
107 Pfitsch,52,,23,23,46
107 Pfitsch,53,,18,13,31
107 Pfitsch,54,,14,14,28
107 Pfitsch,55,,20,21,41
107 Pfitsch,56,,21,14,35
107 Pfitsch,57,,17,23,40
107 Pfitsch,58,,22,13,35
107 Pfitsch,59,,22,19,41
107 Pfitsch,60,,12,19,31
107 Pfitsch,61,,8,8,16
107 Pfitsch,62,,10,11,21
107 Pfitsch,63,,14,13,27
107 Pfitsch,64,,11,12,23
107 Pfitsch,65,,10,13,23
107 Pfitsch,66,,21,11,32
107 Pfitsch,67,,19,13,32
107 Pfitsch,68,,13,17,30
107 Pfitsch,69,,12,15,27
107 Pfitsch,70,,14,8,22
107 Pfitsch,71,,4,14,18
107 Pfitsch,72,,6,11,17
107 Pfitsch,73,,7,11,18
107 Pfitsch,74,,5,7,12
107 Pfitsch,75,,11,5,16
107 Pfitsch,76,,13,11,24
107 Pfitsch,77,,5,14,19
107 Pfitsch,78,,8,9,17
107 Pfitsch,79,,4,10,14
107 Pfitsch,80,,11,10,21
107 Pfitsch,81,,5,12,17
107 Pfitsch,82,,7,9,16
107 Pfitsch,83,,3,9,12
107 Pfitsch,84,,7,7,14
107 Pfitsch,85,,-,12,12
107 Pfitsch,86,,2,7,9
107 Pfitsch,87,,4,3,7
107 Pfitsch,88,,3,7,10
107 Pfitsch,89,,-,3,3
107 Pfitsch,90,,2,3,5
107 Pfitsch,91,,-,1,1
107 Pfitsch,92,,1,1,2
107 Pfitsch,93,,1,1,2
107 Pfitsch,94,,1,1,2
107 Pfitsch,99,,-,1,1
108 Ahrntal,0,,40,38,78
108 Ahrntal,1,,24,49,73
108 Ahrntal,2,,40,43,83
108 Ahrntal,3,,40,34,74
108 Ahrntal,4,,34,36,70
108 Ahrntal,5,,30,37,67
108 Ahrntal,6,,31,39,70
108 Ahrntal,7,,31,33,64
108 Ahrntal,8,,33,30,63
108 Ahrntal,9,,49,41,90
108 Ahrntal,10,,33,39,72
108 Ahrntal,11,,37,36,73
108 Ahrntal,12,,41,44,85
108 Ahrntal,13,,40,51,91
108 Ahrntal,14,,36,30,66
108 Ahrntal,15,,28,26,54
108 Ahrntal,16,,38,41,79
108 Ahrntal,17,,41,34,75
108 Ahrntal,18,,28,36,64
108 Ahrntal,19,,41,32,73
108 Ahrntal,20,,40,35,75
108 Ahrntal,21,,28,31,59
108 Ahrntal,22,,37,38,75
108 Ahrntal,23,,37,51,88
108 Ahrntal,24,,39,44,83
108 Ahrntal,25,,43,31,74
108 Ahrntal,26,,44,48,92
108 Ahrntal,27,,42,43,85
108 Ahrntal,28,,54,36,90
108 Ahrntal,29,,40,36,76
108 Ahrntal,30,,38,47,85
108 Ahrntal,31,,34,42,76
108 Ahrntal,32,,51,45,96
108 Ahrntal,33,,50,43,93
108 Ahrntal,34,,43,39,82
108 Ahrntal,35,,48,39,87
108 Ahrntal,36,,47,38,85
108 Ahrntal,37,,56,52,108
108 Ahrntal,38,,66,43,109
108 Ahrntal,39,,54,46,100
108 Ahrntal,40,,53,44,97
108 Ahrntal,41,,52,42,94
108 Ahrntal,42,,42,50,92
108 Ahrntal,43,,59,43,102
108 Ahrntal,44,,60,44,104
108 Ahrntal,45,,51,43,94
108 Ahrntal,46,,51,43,94
108 Ahrntal,47,,38,50,88
108 Ahrntal,48,,34,37,71
108 Ahrntal,49,,39,30,69
108 Ahrntal,50,,42,40,82
108 Ahrntal,51,,46,30,76
108 Ahrntal,52,,26,40,66
108 Ahrntal,53,,37,19,56
108 Ahrntal,54,,35,25,60
108 Ahrntal,55,,35,21,56
108 Ahrntal,56,,26,29,55
108 Ahrntal,57,,26,34,60
108 Ahrntal,58,,32,25,57
108 Ahrntal,59,,31,20,51
108 Ahrntal,60,,33,31,64
108 Ahrntal,61,,28,27,55
108 Ahrntal,62,,25,18,43
108 Ahrntal,63,,17,22,39
108 Ahrntal,64,,20,13,33
108 Ahrntal,65,,19,18,37
108 Ahrntal,66,,21,32,53
108 Ahrntal,67,,28,31,59
108 Ahrntal,68,,29,33,62
108 Ahrntal,69,,31,24,55
108 Ahrntal,70,,24,24,48
108 Ahrntal,71,,32,30,62
108 Ahrntal,72,,25,22,47
108 Ahrntal,73,,20,15,35
108 Ahrntal,74,,18,37,55
108 Ahrntal,75,,19,20,39
108 Ahrntal,76,,16,17,33
108 Ahrntal,77,,17,26,43
108 Ahrntal,78,,24,17,41
108 Ahrntal,79,,16,17,33
108 Ahrntal,80,,13,16,29
108 Ahrntal,81,,12,24,36
108 Ahrntal,82,,12,17,29
108 Ahrntal,83,,12,14,26
108 Ahrntal,84,,7,14,21
108 Ahrntal,85,,9,10,19
108 Ahrntal,86,,5,9,14
108 Ahrntal,87,,5,10,15
108 Ahrntal,88,,4,3,7
108 Ahrntal,89,,2,5,7
108 Ahrntal,90,,5,4,9
108 Ahrntal,91,,-,4,4
108 Ahrntal,92,,1,2,3
108 Ahrntal,93,,1,1,2
108 Ahrntal,94,,-,4,4
108 Ahrntal,95,,1,6,7
108 Ahrntal,99,,1,-,1
108 Ahrntal,102,,-,1,1
109 Gsies,0,,16,19,35
109 Gsies,1,,14,11,25
109 Gsies,2,,19,12,31
109 Gsies,3,,21,18,39
109 Gsies,4,,17,16,33
109 Gsies,5,,11,13,24
109 Gsies,6,,19,18,37
109 Gsies,7,,13,12,25
109 Gsies,8,,14,14,28
109 Gsies,9,,10,12,22
109 Gsies,10,,29,10,39
109 Gsies,11,,19,5,24
109 Gsies,12,,14,17,31
109 Gsies,13,,11,17,28
109 Gsies,14,,15,17,32
109 Gsies,15,,9,17,26
109 Gsies,16,,17,18,35
109 Gsies,17,,17,10,27
109 Gsies,18,,14,24,38
109 Gsies,19,,17,12,29
109 Gsies,20,,9,12,21
109 Gsies,21,,7,15,22
109 Gsies,22,,19,17,36
109 Gsies,23,,12,17,29
109 Gsies,24,,16,12,28
109 Gsies,25,,13,10,23
109 Gsies,26,,17,8,25
109 Gsies,27,,18,19,37
109 Gsies,28,,16,20,36
109 Gsies,29,,23,22,45
109 Gsies,30,,9,15,24
109 Gsies,31,,15,12,27
109 Gsies,32,,14,19,33
109 Gsies,33,,12,18,30
109 Gsies,34,,17,21,38
109 Gsies,35,,19,16,35
109 Gsies,36,,13,12,25
109 Gsies,37,,7,21,28
109 Gsies,38,,19,18,37
109 Gsies,39,,27,14,41
109 Gsies,40,,25,10,35
109 Gsies,41,,16,15,31
109 Gsies,42,,17,13,30
109 Gsies,43,,15,19,34
109 Gsies,44,,19,5,24
109 Gsies,45,,16,18,34
109 Gsies,46,,14,14,28
109 Gsies,47,,16,8,24
109 Gsies,48,,9,14,23
109 Gsies,49,,16,20,36
109 Gsies,50,,11,14,25
109 Gsies,51,,16,16,32
109 Gsies,52,,12,14,26
109 Gsies,53,,16,6,22
109 Gsies,54,,14,10,24
109 Gsies,55,,16,6,22
109 Gsies,56,,19,6,25
109 Gsies,57,,17,14,31
109 Gsies,58,,15,12,27
109 Gsies,59,,8,8,16
109 Gsies,60,,15,16,31
109 Gsies,61,,7,10,17
109 Gsies,62,,22,6,28
109 Gsies,63,,15,10,25
109 Gsies,64,,4,12,16
109 Gsies,65,,7,13,20
109 Gsies,66,,9,9,18
109 Gsies,67,,5,13,18
109 Gsies,68,,6,11,17
109 Gsies,69,,7,10,17
109 Gsies,70,,6,9,15
109 Gsies,71,,9,8,17
109 Gsies,72,,10,7,17
109 Gsies,73,,4,10,14
109 Gsies,74,,4,7,11
109 Gsies,75,,3,9,12
109 Gsies,76,,6,6,12
109 Gsies,77,,7,5,12
109 Gsies,78,,5,7,12
109 Gsies,79,,10,6,16
109 Gsies,80,,3,5,8
109 Gsies,81,,7,9,16
109 Gsies,82,,1,8,9
109 Gsies,83,,3,3,6
109 Gsies,84,,5,4,9
109 Gsies,85,,3,4,7
109 Gsies,86,,5,6,11
109 Gsies,87,,4,6,10
109 Gsies,88,,2,6,8
109 Gsies,89,,2,-,2
109 Gsies,90,,2,1,3
109 Gsies,91,,-,1,1
109 Gsies,92,,1,-,1
109 Gsies,94,,1,-,1
109 Gsies,98,,-,1,1
110 Vintl,0,,19,20,39
110 Vintl,1,,19,17,36
110 Vintl,2,,24,18,42
110 Vintl,3,,11,15,26
110 Vintl,4,,20,26,46
110 Vintl,5,,11,13,24
110 Vintl,6,,16,18,34
110 Vintl,7,,14,20,34
110 Vintl,8,,15,20,35
110 Vintl,9,,22,15,37
110 Vintl,10,,21,25,46
110 Vintl,11,,20,28,48
110 Vintl,12,,20,16,36
110 Vintl,13,,21,19,40
110 Vintl,14,,38,25,63
110 Vintl,15,,18,18,36
110 Vintl,16,,25,20,45
110 Vintl,17,,29,21,50
110 Vintl,18,,23,30,53
110 Vintl,19,,30,22,52
110 Vintl,20,,25,15,40
110 Vintl,21,,22,21,43
110 Vintl,22,,20,23,43
110 Vintl,23,,21,22,43
110 Vintl,24,,10,18,28
110 Vintl,25,,26,9,35
110 Vintl,26,,23,17,40
110 Vintl,27,,23,25,48
110 Vintl,28,,17,21,38
110 Vintl,29,,32,20,52
110 Vintl,30,,28,18,46
110 Vintl,31,,24,35,59
110 Vintl,32,,17,23,40
110 Vintl,33,,23,23,46
110 Vintl,34,,23,19,42
110 Vintl,35,,28,25,53
110 Vintl,36,,18,19,37
110 Vintl,37,,28,16,44
110 Vintl,38,,31,26,57
110 Vintl,39,,17,19,36
110 Vintl,40,,27,26,53
110 Vintl,41,,25,23,48
110 Vintl,42,,30,34,64
110 Vintl,43,,31,27,58
110 Vintl,44,,31,30,61
110 Vintl,45,,34,23,57
110 Vintl,46,,33,27,60
110 Vintl,47,,32,22,54
110 Vintl,48,,26,32,58
110 Vintl,49,,17,23,40
110 Vintl,50,,21,22,43
110 Vintl,51,,19,15,34
110 Vintl,52,,22,27,49
110 Vintl,53,,26,16,42
110 Vintl,54,,20,14,34
110 Vintl,55,,15,18,33
110 Vintl,56,,22,10,32
110 Vintl,57,,16,17,33
110 Vintl,58,,22,16,38
110 Vintl,59,,23,20,43
110 Vintl,60,,19,20,39
110 Vintl,61,,13,13,26
110 Vintl,62,,22,13,35
110 Vintl,63,,17,12,29
110 Vintl,64,,14,19,33
110 Vintl,65,,11,5,16
110 Vintl,66,,21,11,32
110 Vintl,67,,11,10,21
110 Vintl,68,,7,16,23
110 Vintl,69,,8,19,27
110 Vintl,70,,16,15,31
110 Vintl,71,,10,6,16
110 Vintl,72,,8,9,17
110 Vintl,73,,14,11,25
110 Vintl,74,,9,10,19
110 Vintl,75,,15,8,23
110 Vintl,76,,3,18,21
110 Vintl,77,,8,13,21
110 Vintl,78,,9,10,19
110 Vintl,79,,6,14,20
110 Vintl,80,,6,13,19
110 Vintl,81,,7,8,15
110 Vintl,82,,6,12,18
110 Vintl,83,,10,3,13
110 Vintl,84,,3,5,8
110 Vintl,85,,2,7,9
110 Vintl,86,,3,6,9
110 Vintl,87,,3,6,9
110 Vintl,88,,2,3,5
110 Vintl,89,,-,7,7
110 Vintl,90,,-,2,2
110 Vintl,92,,-,2,2
110 Vintl,93,,-,1,1
110 Vintl,94,,1,2,3
110 Vintl,95,,-,1,1
110 Vintl,97,,1,-,1
110 Vintl,98,,-,1,1
111 Vahrn,0,,35,25,60
111 Vahrn,1,,20,29,49
111 Vahrn,2,,35,19,54
111 Vahrn,3,,33,30,63
111 Vahrn,4,,29,30,59
111 Vahrn,5,,29,29,58
111 Vahrn,6,,27,13,40
111 Vahrn,7,,27,30,57
111 Vahrn,8,,27,20,47
111 Vahrn,9,,28,21,49
111 Vahrn,10,,27,35,62
111 Vahrn,11,,23,22,45
111 Vahrn,12,,19,24,43
111 Vahrn,13,,36,19,55
111 Vahrn,14,,23,21,44
111 Vahrn,15,,22,23,45
111 Vahrn,16,,22,21,43
111 Vahrn,17,,17,24,41
111 Vahrn,18,,22,22,44
111 Vahrn,19,,16,28,44
111 Vahrn,20,,28,21,49
111 Vahrn,21,,25,20,45
111 Vahrn,22,,18,23,41
111 Vahrn,23,,24,13,37
111 Vahrn,24,,29,32,61
111 Vahrn,25,,19,22,41
111 Vahrn,26,,22,36,58
111 Vahrn,27,,24,32,56
111 Vahrn,28,,31,30,61
111 Vahrn,29,,25,34,59
111 Vahrn,30,,21,33,54
111 Vahrn,31,,29,36,65
111 Vahrn,32,,27,26,53
111 Vahrn,33,,45,29,74
111 Vahrn,34,,36,34,70
111 Vahrn,35,,33,41,74
111 Vahrn,36,,42,43,85
111 Vahrn,37,,39,44,83
111 Vahrn,38,,40,31,71
111 Vahrn,39,,46,39,85
111 Vahrn,40,,48,44,92
111 Vahrn,41,,34,35,69
111 Vahrn,42,,46,34,80
111 Vahrn,43,,40,33,73
111 Vahrn,44,,42,41,83
111 Vahrn,45,,35,38,73
111 Vahrn,46,,36,34,70
111 Vahrn,47,,28,35,63
111 Vahrn,48,,30,23,53
111 Vahrn,49,,33,31,64
111 Vahrn,50,,31,28,59
111 Vahrn,51,,20,19,39
111 Vahrn,52,,29,30,59
111 Vahrn,53,,22,23,45
111 Vahrn,54,,27,31,58
111 Vahrn,55,,19,30,49
111 Vahrn,56,,23,25,48
111 Vahrn,57,,22,16,38
111 Vahrn,58,,20,15,35
111 Vahrn,59,,17,19,36
111 Vahrn,60,,22,32,54
111 Vahrn,61,,19,18,37
111 Vahrn,62,,15,26,41
111 Vahrn,63,,20,23,43
111 Vahrn,64,,11,15,26
111 Vahrn,65,,18,20,38
111 Vahrn,66,,23,24,47
111 Vahrn,67,,17,22,39
111 Vahrn,68,,19,22,41
111 Vahrn,69,,20,17,37
111 Vahrn,70,,20,20,40
111 Vahrn,71,,12,10,22
111 Vahrn,72,,16,18,34
111 Vahrn,73,,10,16,26
111 Vahrn,74,,7,13,20
111 Vahrn,75,,14,14,28
111 Vahrn,76,,8,13,21
111 Vahrn,77,,9,12,21
111 Vahrn,78,,8,12,20
111 Vahrn,79,,13,11,24
111 Vahrn,80,,6,19,25
111 Vahrn,81,,7,13,20
111 Vahrn,82,,2,17,19
111 Vahrn,83,,4,3,7
111 Vahrn,84,,2,11,13
111 Vahrn,85,,5,9,14
111 Vahrn,86,,5,7,12
111 Vahrn,87,,1,8,9
111 Vahrn,88,,2,6,8
111 Vahrn,89,,1,4,5
111 Vahrn,90,,3,-,3
111 Vahrn,91,,-,1,1
111 Vahrn,92,,2,2,4
111 Vahrn,93,,1,-,1
111 Vahrn,95,,-,2,2
111 Vahrn,97,,-,1,1
111 Vahrn,98,,-,1,1
111 Vahrn,99,,-,1,1
112 Vöran,0,,4,4,8
112 Vöran,1,,6,3,9
112 Vöran,2,,6,3,9
112 Vöran,3,,9,3,12
112 Vöran,4,,3,4,7
112 Vöran,5,,2,6,8
112 Vöran,6,,8,6,14
112 Vöran,7,,5,6,11
112 Vöran,8,,8,4,12
112 Vöran,9,,11,5,16
112 Vöran,10,,5,3,8
112 Vöran,11,,4,4,8
112 Vöran,12,,11,7,18
112 Vöran,13,,10,5,15
112 Vöran,14,,5,9,14
112 Vöran,15,,7,7,14
112 Vöran,16,,8,6,14
112 Vöran,17,,6,3,9
112 Vöran,18,,7,3,10
112 Vöran,19,,5,7,12
112 Vöran,20,,10,5,15
112 Vöran,21,,8,9,17
112 Vöran,22,,11,6,17
112 Vöran,23,,6,6,12
112 Vöran,24,,9,9,18
112 Vöran,25,,8,6,14
112 Vöran,26,,6,3,9
112 Vöran,27,,7,8,15
112 Vöran,28,,9,11,20
112 Vöran,29,,4,4,8
112 Vöran,30,,3,7,10
112 Vöran,31,,9,9,18
112 Vöran,32,,9,5,14
112 Vöran,33,,6,4,10
112 Vöran,34,,7,5,12
112 Vöran,35,,16,10,26
112 Vöran,36,,5,5,10
112 Vöran,37,,9,8,17
112 Vöran,38,,8,11,19
112 Vöran,39,,7,6,13
112 Vöran,40,,6,4,10
112 Vöran,41,,14,3,17
112 Vöran,42,,3,6,9
112 Vöran,43,,11,6,17
112 Vöran,44,,4,3,7
112 Vöran,45,,11,4,15
112 Vöran,46,,8,7,15
112 Vöran,47,,13,14,27
112 Vöran,48,,4,5,9
112 Vöran,49,,6,6,12
112 Vöran,50,,3,7,10
112 Vöran,51,,7,6,13
112 Vöran,52,,5,9,14
112 Vöran,53,,2,1,3
112 Vöran,54,,5,2,7
112 Vöran,55,,5,5,10
112 Vöran,56,,5,4,9
112 Vöran,57,,9,1,10
112 Vöran,58,,4,-,4
112 Vöran,59,,7,4,11
112 Vöran,60,,7,6,13
112 Vöran,61,,2,3,5
112 Vöran,62,,5,3,8
112 Vöran,63,,4,2,6
112 Vöran,64,,-,4,4
112 Vöran,65,,4,3,7
112 Vöran,66,,3,5,8
112 Vöran,67,,6,4,10
112 Vöran,68,,4,6,10
112 Vöran,69,,3,5,8
112 Vöran,70,,2,3,5
112 Vöran,71,,8,3,11
112 Vöran,72,,2,2,4
112 Vöran,73,,3,5,8
112 Vöran,74,,2,-,2
112 Vöran,75,,1,6,7
112 Vöran,76,,6,6,12
112 Vöran,77,,2,4,6
112 Vöran,78,,3,-,3
112 Vöran,79,,5,1,6
112 Vöran,80,,1,1,2
112 Vöran,81,,3,1,4
112 Vöran,82,,-,2,2
112 Vöran,83,,-,3,3
112 Vöran,84,,2,3,5
112 Vöran,85,,-,1,1
112 Vöran,86,,1,1,2
112 Vöran,87,,1,-,1
112 Vöran,88,,1,-,1
112 Vöran,89,,-,2,2
112 Vöran,98,,-,1,1
113 Niederdorf,0,,11,8,19
113 Niederdorf,1,,10,6,16
113 Niederdorf,2,,8,12,20
113 Niederdorf,3,,7,7,14
113 Niederdorf,4,,16,7,23
113 Niederdorf,5,,10,15,25
113 Niederdorf,6,,8,12,20
113 Niederdorf,7,,6,11,17
113 Niederdorf,8,,9,10,19
113 Niederdorf,9,,13,11,24
113 Niederdorf,10,,4,5,9
113 Niederdorf,11,,7,12,19
113 Niederdorf,12,,9,9,18
113 Niederdorf,13,,6,7,13
113 Niederdorf,14,,6,10,16
113 Niederdorf,15,,13,8,21
113 Niederdorf,16,,9,6,15
113 Niederdorf,17,,8,11,19
113 Niederdorf,18,,7,12,19
113 Niederdorf,19,,14,11,25
113 Niederdorf,20,,9,7,16
113 Niederdorf,21,,8,9,17
113 Niederdorf,22,,2,9,11
113 Niederdorf,23,,4,8,12
113 Niederdorf,24,,8,7,15
113 Niederdorf,25,,7,5,12
113 Niederdorf,26,,8,9,17
113 Niederdorf,27,,3,16,19
113 Niederdorf,28,,8,5,13
113 Niederdorf,29,,10,5,15
113 Niederdorf,30,,10,5,15
113 Niederdorf,31,,5,1,6
113 Niederdorf,32,,7,7,14
113 Niederdorf,33,,11,9,20
113 Niederdorf,34,,7,11,18
113 Niederdorf,35,,12,10,22
113 Niederdorf,36,,15,11,26
113 Niederdorf,37,,16,7,23
113 Niederdorf,38,,7,14,21
113 Niederdorf,39,,9,11,20
113 Niederdorf,40,,23,16,39
113 Niederdorf,41,,14,11,25
113 Niederdorf,42,,13,18,31
113 Niederdorf,43,,23,10,33
113 Niederdorf,44,,9,17,26
113 Niederdorf,45,,19,14,33
113 Niederdorf,46,,9,9,18
113 Niederdorf,47,,22,11,33
113 Niederdorf,48,,12,10,22
113 Niederdorf,49,,8,10,18
113 Niederdorf,50,,12,9,21
113 Niederdorf,51,,6,5,11
113 Niederdorf,52,,10,11,21
113 Niederdorf,53,,9,11,20
113 Niederdorf,54,,10,8,18
113 Niederdorf,55,,11,6,17
113 Niederdorf,56,,7,4,11
113 Niederdorf,57,,8,4,12
113 Niederdorf,58,,2,2,4
113 Niederdorf,59,,5,5,10
113 Niederdorf,60,,9,4,13
113 Niederdorf,61,,5,8,13
113 Niederdorf,62,,6,7,13
113 Niederdorf,63,,6,7,13
113 Niederdorf,64,,2,6,8
113 Niederdorf,65,,7,7,14
113 Niederdorf,66,,5,8,13
113 Niederdorf,67,,5,9,14
113 Niederdorf,68,,4,5,9
113 Niederdorf,69,,4,7,11
113 Niederdorf,70,,1,4,5
113 Niederdorf,71,,8,5,13
113 Niederdorf,72,,6,8,14
113 Niederdorf,73,,5,8,13
113 Niederdorf,74,,7,7,14
113 Niederdorf,75,,1,13,14
113 Niederdorf,76,,6,7,13
113 Niederdorf,77,,8,6,14
113 Niederdorf,78,,6,6,12
113 Niederdorf,79,,5,9,14
113 Niederdorf,80,,4,6,10
113 Niederdorf,81,,4,6,10
113 Niederdorf,82,,4,9,13
113 Niederdorf,83,,3,5,8
113 Niederdorf,84,,-,5,5
113 Niederdorf,85,,3,7,10
113 Niederdorf,86,,3,1,4
113 Niederdorf,87,,1,6,7
113 Niederdorf,88,,3,4,7
113 Niederdorf,89,,-,2,2
113 Niederdorf,91,,-,1,1
113 Niederdorf,92,,1,-,1
113 Niederdorf,93,,-,1,1
113 Niederdorf,94,,-,2,2
113 Niederdorf,98,,-,1,1
113 Niederdorf,99,,-,1,1
113 Niederdorf,104,,-,1,1
114 Villanders,0,,11,6,17
114 Villanders,1,,7,9,16
114 Villanders,2,,14,13,27
114 Villanders,3,,13,14,27
114 Villanders,4,,17,7,24
114 Villanders,5,,13,14,27
114 Villanders,6,,6,12,18
114 Villanders,7,,7,10,17
114 Villanders,8,,13,11,24
114 Villanders,9,,10,17,27
114 Villanders,10,,13,11,24
114 Villanders,11,,13,8,21
114 Villanders,12,,10,12,22
114 Villanders,13,,14,8,22
114 Villanders,14,,17,6,23
114 Villanders,15,,11,12,23
114 Villanders,16,,7,18,25
114 Villanders,17,,14,8,22
114 Villanders,18,,16,14,30
114 Villanders,19,,16,14,30
114 Villanders,20,,14,10,24
114 Villanders,21,,11,13,24
114 Villanders,22,,7,13,20
114 Villanders,23,,10,10,20
114 Villanders,24,,9,14,23
114 Villanders,25,,15,15,30
114 Villanders,26,,15,4,19
114 Villanders,27,,16,13,29
114 Villanders,28,,21,14,35
114 Villanders,29,,9,17,26
114 Villanders,30,,18,6,24
114 Villanders,31,,11,9,20
114 Villanders,32,,19,14,33
114 Villanders,33,,14,10,24
114 Villanders,34,,11,12,23
114 Villanders,35,,15,16,31
114 Villanders,36,,11,18,29
114 Villanders,37,,16,20,36
114 Villanders,38,,17,16,33
114 Villanders,39,,15,11,26
114 Villanders,40,,26,19,45
114 Villanders,41,,24,11,35
114 Villanders,42,,20,13,33
114 Villanders,43,,21,17,38
114 Villanders,44,,23,18,41
114 Villanders,45,,19,16,35
114 Villanders,46,,15,12,27
114 Villanders,47,,17,11,28
114 Villanders,48,,16,12,28
114 Villanders,49,,18,6,24
114 Villanders,50,,15,11,26
114 Villanders,51,,17,7,24
114 Villanders,52,,10,7,17
114 Villanders,53,,10,9,19
114 Villanders,54,,12,18,30
114 Villanders,55,,8,7,15
114 Villanders,56,,12,12,24
114 Villanders,57,,12,7,19
114 Villanders,58,,10,7,17
114 Villanders,59,,12,8,20
114 Villanders,60,,11,5,16
114 Villanders,61,,8,11,19
114 Villanders,62,,6,8,14
114 Villanders,63,,8,10,18
114 Villanders,64,,6,3,9
114 Villanders,65,,3,9,12
114 Villanders,66,,7,7,14
114 Villanders,67,,10,8,18
114 Villanders,68,,7,9,16
114 Villanders,69,,9,12,21
114 Villanders,70,,7,5,12
114 Villanders,71,,7,6,13
114 Villanders,72,,3,9,12
114 Villanders,73,,6,7,13
114 Villanders,74,,2,8,10
114 Villanders,75,,1,9,10
114 Villanders,76,,8,9,17
114 Villanders,77,,8,9,17
114 Villanders,78,,5,8,13
114 Villanders,79,,6,5,11
114 Villanders,80,,3,8,11
114 Villanders,81,,3,7,10
114 Villanders,82,,4,5,9
114 Villanders,83,,2,2,4
114 Villanders,84,,2,8,10
114 Villanders,85,,3,2,5
114 Villanders,86,,4,2,6
114 Villanders,87,,1,4,5
114 Villanders,88,,1,8,9
114 Villanders,89,,1,4,5
114 Villanders,90,,-,3,3
114 Villanders,94,,-,2,2
114 Villanders,96,,-,2,2
114 Villanders,97,,1,1,2
115 Sterzing,0,,32,31,63
115 Sterzing,1,,43,33,76
115 Sterzing,2,,33,31,64
115 Sterzing,3,,37,28,65
115 Sterzing,4,,27,27,54
115 Sterzing,5,,28,33,61
115 Sterzing,6,,29,36,65
115 Sterzing,7,,32,28,60
115 Sterzing,8,,34,30,64
115 Sterzing,9,,28,33,61
115 Sterzing,10,,32,24,56
115 Sterzing,11,,27,28,55
115 Sterzing,12,,33,33,66
115 Sterzing,13,,30,38,68
115 Sterzing,14,,36,27,63
115 Sterzing,15,,32,23,55
115 Sterzing,16,,33,28,61
115 Sterzing,17,,32,35,67
115 Sterzing,18,,33,31,64
115 Sterzing,19,,27,36,63
115 Sterzing,20,,39,25,64
115 Sterzing,21,,36,28,64
115 Sterzing,22,,33,31,64
115 Sterzing,23,,42,31,73
115 Sterzing,24,,25,34,59
115 Sterzing,25,,44,43,87
115 Sterzing,26,,56,45,101
115 Sterzing,27,,73,52,125
115 Sterzing,28,,94,42,136
115 Sterzing,29,,48,55,103
115 Sterzing,30,,53,46,99
115 Sterzing,31,,66,34,100
115 Sterzing,32,,42,39,81
115 Sterzing,33,,43,45,88
115 Sterzing,34,,54,44,98
115 Sterzing,35,,48,41,89
115 Sterzing,36,,46,60,106
115 Sterzing,37,,52,54,106
115 Sterzing,38,,48,48,96
115 Sterzing,39,,58,58,116
115 Sterzing,40,,48,35,83
115 Sterzing,41,,55,56,111
115 Sterzing,42,,65,49,114
115 Sterzing,43,,54,54,108
115 Sterzing,44,,56,44,100
115 Sterzing,45,,48,42,90
115 Sterzing,46,,50,53,103
115 Sterzing,47,,42,51,93
115 Sterzing,48,,42,38,80
115 Sterzing,49,,44,46,90
115 Sterzing,50,,57,41,98
115 Sterzing,51,,44,41,85
115 Sterzing,52,,34,47,81
115 Sterzing,53,,44,26,70
115 Sterzing,54,,35,45,80
115 Sterzing,55,,35,37,72
115 Sterzing,56,,30,42,72
115 Sterzing,57,,41,37,78
115 Sterzing,58,,36,42,78
115 Sterzing,59,,37,34,71
115 Sterzing,60,,36,48,84
115 Sterzing,61,,39,44,83
115 Sterzing,62,,28,28,56
115 Sterzing,63,,42,43,85
115 Sterzing,64,,36,37,73
115 Sterzing,65,,32,29,61
115 Sterzing,66,,39,49,88
115 Sterzing,67,,25,37,62
115 Sterzing,68,,29,27,56
115 Sterzing,69,,35,31,66
115 Sterzing,70,,23,31,54
115 Sterzing,71,,29,28,57
115 Sterzing,72,,17,36,53
115 Sterzing,73,,20,39,59
115 Sterzing,74,,21,27,48
115 Sterzing,75,,16,25,41
115 Sterzing,76,,25,28,53
115 Sterzing,77,,14,14,28
115 Sterzing,78,,20,32,52
115 Sterzing,79,,7,24,31
115 Sterzing,80,,13,17,30
115 Sterzing,81,,16,25,41
115 Sterzing,82,,12,20,32
115 Sterzing,83,,8,19,27
115 Sterzing,84,,4,14,18
115 Sterzing,85,,6,14,20
115 Sterzing,86,,6,13,19
115 Sterzing,87,,6,16,22
115 Sterzing,88,,2,10,12
115 Sterzing,89,,2,4,6
115 Sterzing,90,,2,4,6
115 Sterzing,91,,1,4,5
115 Sterzing,92,,1,-,1
115 Sterzing,93,,-,1,1
115 Sterzing,94,,1,3,4
115 Sterzing,95,,-,3,3
115 Sterzing,96,,-,1,1
115 Sterzing,97,,-,4,4
115 Sterzing,100,,-,1,1
116 Feldthurns,0,,16,16,32
116 Feldthurns,1,,20,17,37
116 Feldthurns,2,,25,16,41
116 Feldthurns,3,,28,22,50
116 Feldthurns,4,,23,17,40
116 Feldthurns,5,,19,16,35
116 Feldthurns,6,,12,13,25
116 Feldthurns,7,,22,20,42
116 Feldthurns,8,,16,19,35
116 Feldthurns,9,,24,14,38
116 Feldthurns,10,,19,20,39
116 Feldthurns,11,,22,19,41
116 Feldthurns,12,,22,16,38
116 Feldthurns,13,,16,19,35
116 Feldthurns,14,,18,20,38
116 Feldthurns,15,,15,18,33
116 Feldthurns,16,,26,20,46
116 Feldthurns,17,,19,19,38
116 Feldthurns,18,,14,12,26
116 Feldthurns,19,,13,14,27
116 Feldthurns,20,,21,14,35
116 Feldthurns,21,,14,19,33
116 Feldthurns,22,,25,12,37
116 Feldthurns,23,,18,20,38
116 Feldthurns,24,,15,19,34
116 Feldthurns,25,,17,25,42
116 Feldthurns,26,,24,24,48
116 Feldthurns,27,,15,17,32
116 Feldthurns,28,,21,18,39
116 Feldthurns,29,,12,23,35
116 Feldthurns,30,,11,19,30
116 Feldthurns,31,,31,20,51
116 Feldthurns,32,,20,15,35
116 Feldthurns,33,,22,22,44
116 Feldthurns,34,,20,18,38
116 Feldthurns,35,,25,27,52
116 Feldthurns,36,,20,19,39
116 Feldthurns,37,,31,23,54
116 Feldthurns,38,,19,25,44
116 Feldthurns,39,,17,19,36
116 Feldthurns,40,,23,26,49
116 Feldthurns,41,,20,27,47
116 Feldthurns,42,,23,22,45
116 Feldthurns,43,,22,22,44
116 Feldthurns,44,,26,26,52
116 Feldthurns,45,,24,18,42
116 Feldthurns,46,,29,19,48
116 Feldthurns,47,,13,19,32
116 Feldthurns,48,,17,18,35
116 Feldthurns,49,,17,14,31
116 Feldthurns,50,,16,17,33
116 Feldthurns,51,,15,19,34
116 Feldthurns,52,,15,13,28
116 Feldthurns,53,,11,19,30
116 Feldthurns,54,,12,12,24
116 Feldthurns,55,,14,14,28
116 Feldthurns,56,,18,13,31
116 Feldthurns,57,,22,15,37
116 Feldthurns,58,,13,12,25
116 Feldthurns,59,,14,14,28
116 Feldthurns,60,,7,14,21
116 Feldthurns,61,,12,12,24
116 Feldthurns,62,,15,9,24
116 Feldthurns,63,,11,10,21
116 Feldthurns,64,,13,12,25
116 Feldthurns,65,,18,10,28
116 Feldthurns,66,,10,12,22
116 Feldthurns,67,,8,7,15
116 Feldthurns,68,,6,4,10
116 Feldthurns,69,,10,6,16
116 Feldthurns,70,,8,11,19
116 Feldthurns,71,,11,8,19
116 Feldthurns,72,,4,9,13
116 Feldthurns,73,,7,9,16
116 Feldthurns,74,,10,11,21
116 Feldthurns,75,,2,5,7
116 Feldthurns,76,,6,4,10
116 Feldthurns,77,,6,9,15
116 Feldthurns,78,,4,7,11
116 Feldthurns,79,,4,14,18
116 Feldthurns,80,,3,9,12
116 Feldthurns,81,,8,4,12
116 Feldthurns,82,,2,4,6
116 Feldthurns,83,,2,7,9
116 Feldthurns,84,,4,7,11
116 Feldthurns,85,,4,9,13
116 Feldthurns,86,,5,6,11
116 Feldthurns,87,,2,6,8
116 Feldthurns,88,,1,6,7
116 Feldthurns,89,,2,7,9
116 Feldthurns,90,,2,2,4
116 Feldthurns,91,,2,-,2
116 Feldthurns,93,,-,2,2
116 Feldthurns,94,,-,3,3
116 Feldthurns,97,,-,1,1
116 Feldthurns,98,,-,1,1
117 Wengen,0,,7,8,15
117 Wengen,1,,6,9,15
117 Wengen,2,,10,11,21
117 Wengen,3,,7,9,16
117 Wengen,4,,9,5,14
117 Wengen,5,,6,8,14
117 Wengen,6,,5,7,12
117 Wengen,7,,11,4,15
117 Wengen,8,,5,10,15
117 Wengen,9,,10,6,16
117 Wengen,10,,9,5,14
117 Wengen,11,,7,8,15
117 Wengen,12,,12,8,20
117 Wengen,13,,9,8,17
117 Wengen,14,,11,9,20
117 Wengen,15,,12,7,19
117 Wengen,16,,10,7,17
117 Wengen,17,,10,7,17
117 Wengen,18,,17,8,25
117 Wengen,19,,12,7,19
117 Wengen,20,,6,6,12
117 Wengen,21,,6,10,16
117 Wengen,22,,11,5,16
117 Wengen,23,,8,8,16
117 Wengen,24,,9,6,15
117 Wengen,25,,14,8,22
117 Wengen,26,,13,4,17
117 Wengen,27,,11,7,18
117 Wengen,28,,6,7,13
117 Wengen,29,,8,11,19
117 Wengen,30,,12,6,18
117 Wengen,31,,5,6,11
117 Wengen,32,,11,8,19
117 Wengen,33,,6,5,11
117 Wengen,34,,17,10,27
117 Wengen,35,,11,7,18
117 Wengen,36,,18,11,29
117 Wengen,37,,13,11,24
117 Wengen,38,,12,14,26
117 Wengen,39,,11,14,25
117 Wengen,40,,8,9,17
117 Wengen,41,,18,10,28
117 Wengen,42,,10,13,23
117 Wengen,43,,13,6,19
117 Wengen,44,,8,11,19
117 Wengen,45,,11,6,17
117 Wengen,46,,14,12,26
117 Wengen,47,,14,7,21
117 Wengen,48,,7,9,16
117 Wengen,49,,10,12,22
117 Wengen,50,,7,6,13
117 Wengen,51,,6,7,13
117 Wengen,52,,6,11,17
117 Wengen,53,,4,6,10
117 Wengen,54,,7,6,13
117 Wengen,55,,9,4,13
117 Wengen,56,,6,2,8
117 Wengen,57,,6,6,12
117 Wengen,58,,9,6,15
117 Wengen,59,,2,5,7
117 Wengen,60,,4,8,12
117 Wengen,61,,2,11,13
117 Wengen,62,,6,3,9
117 Wengen,63,,5,3,8
117 Wengen,64,,6,3,9
117 Wengen,65,,8,8,16
117 Wengen,66,,3,7,10
117 Wengen,67,,7,6,13
117 Wengen,68,,4,4,8
117 Wengen,69,,6,9,15
117 Wengen,70,,6,3,9
117 Wengen,71,,5,4,9
117 Wengen,72,,6,7,13
117 Wengen,73,,1,1,2
117 Wengen,74,,2,7,9
117 Wengen,75,,2,7,9
117 Wengen,76,,3,2,5
117 Wengen,77,,2,7,9
117 Wengen,78,,5,2,7
117 Wengen,79,,4,2,6
117 Wengen,80,,2,7,9
117 Wengen,81,,1,2,3
117 Wengen,82,,1,3,4
117 Wengen,83,,1,3,4
117 Wengen,84,,1,3,4
117 Wengen,85,,-,4,4
117 Wengen,86,,2,3,5
117 Wengen,87,,3,3,6
117 Wengen,88,,2,6,8
117 Wengen,89,,1,1,2
117 Wengen,92,,2,-,2
117 Wengen,94,,1,-,1
117 Wengen,97,,1,-,1
118 U.L.Frau i.W.-St.Felix,0,,5,3,8
118 U.L.Frau i.W.-St.Felix,1,,1,8,9
118 U.L.Frau i.W.-St.Felix,2,,3,-,3
118 U.L.Frau i.W.-St.Felix,3,,3,2,5
118 U.L.Frau i.W.-St.Felix,4,,5,7,12
118 U.L.Frau i.W.-St.Felix,5,,5,3,8
118 U.L.Frau i.W.-St.Felix,6,,8,7,15
118 U.L.Frau i.W.-St.Felix,7,,7,3,10
118 U.L.Frau i.W.-St.Felix,8,,9,5,14
118 U.L.Frau i.W.-St.Felix,9,,3,2,5
118 U.L.Frau i.W.-St.Felix,10,,5,5,10
118 U.L.Frau i.W.-St.Felix,11,,6,9,15
118 U.L.Frau i.W.-St.Felix,12,,5,4,9
118 U.L.Frau i.W.-St.Felix,13,,8,5,13
118 U.L.Frau i.W.-St.Felix,14,,3,10,13
118 U.L.Frau i.W.-St.Felix,15,,7,7,14
118 U.L.Frau i.W.-St.Felix,16,,9,5,14
118 U.L.Frau i.W.-St.Felix,17,,7,4,11
118 U.L.Frau i.W.-St.Felix,18,,10,7,17
118 U.L.Frau i.W.-St.Felix,19,,6,3,9
118 U.L.Frau i.W.-St.Felix,20,,8,5,13
118 U.L.Frau i.W.-St.Felix,21,,8,5,13
118 U.L.Frau i.W.-St.Felix,22,,3,7,10
118 U.L.Frau i.W.-St.Felix,23,,7,3,10
118 U.L.Frau i.W.-St.Felix,24,,7,5,12
118 U.L.Frau i.W.-St.Felix,25,,6,1,7
118 U.L.Frau i.W.-St.Felix,26,,1,10,11
118 U.L.Frau i.W.-St.Felix,27,,3,6,9
118 U.L.Frau i.W.-St.Felix,28,,7,2,9
118 U.L.Frau i.W.-St.Felix,29,,3,6,9
118 U.L.Frau i.W.-St.Felix,30,,1,2,3
118 U.L.Frau i.W.-St.Felix,31,,-,3,3
118 U.L.Frau i.W.-St.Felix,32,,5,3,8
118 U.L.Frau i.W.-St.Felix,33,,4,7,11
118 U.L.Frau i.W.-St.Felix,34,,8,1,9
118 U.L.Frau i.W.-St.Felix,35,,4,6,10
118 U.L.Frau i.W.-St.Felix,36,,2,3,5
118 U.L.Frau i.W.-St.Felix,37,,7,5,12
118 U.L.Frau i.W.-St.Felix,38,,3,4,7
118 U.L.Frau i.W.-St.Felix,39,,5,9,14
118 U.L.Frau i.W.-St.Felix,40,,7,4,11
118 U.L.Frau i.W.-St.Felix,41,,4,9,13
118 U.L.Frau i.W.-St.Felix,42,,3,4,7
118 U.L.Frau i.W.-St.Felix,43,,8,7,15
118 U.L.Frau i.W.-St.Felix,44,,10,6,16
118 U.L.Frau i.W.-St.Felix,45,,6,8,14
118 U.L.Frau i.W.-St.Felix,46,,16,8,24
118 U.L.Frau i.W.-St.Felix,47,,8,10,18
118 U.L.Frau i.W.-St.Felix,48,,4,4,8
118 U.L.Frau i.W.-St.Felix,49,,8,9,17
118 U.L.Frau i.W.-St.Felix,50,,5,4,9
118 U.L.Frau i.W.-St.Felix,51,,4,2,6
118 U.L.Frau i.W.-St.Felix,52,,3,6,9
118 U.L.Frau i.W.-St.Felix,53,,5,6,11
118 U.L.Frau i.W.-St.Felix,54,,3,4,7
118 U.L.Frau i.W.-St.Felix,55,,6,3,9
118 U.L.Frau i.W.-St.Felix,56,,3,3,6
118 U.L.Frau i.W.-St.Felix,57,,6,3,9
118 U.L.Frau i.W.-St.Felix,58,,6,3,9
118 U.L.Frau i.W.-St.Felix,59,,3,4,7
118 U.L.Frau i.W.-St.Felix,60,,4,-,4
118 U.L.Frau i.W.-St.Felix,61,,4,1,5
118 U.L.Frau i.W.-St.Felix,62,,1,7,8
118 U.L.Frau i.W.-St.Felix,63,,1,4,5
118 U.L.Frau i.W.-St.Felix,64,,3,1,4
118 U.L.Frau i.W.-St.Felix,65,,5,1,6
118 U.L.Frau i.W.-St.Felix,66,,6,4,10
118 U.L.Frau i.W.-St.Felix,67,,2,3,5
118 U.L.Frau i.W.-St.Felix,68,,5,8,13
118 U.L.Frau i.W.-St.Felix,69,,2,-,2
118 U.L.Frau i.W.-St.Felix,70,,1,3,4
118 U.L.Frau i.W.-St.Felix,71,,3,4,7
118 U.L.Frau i.W.-St.Felix,72,,3,-,3
118 U.L.Frau i.W.-St.Felix,73,,4,2,6
118 U.L.Frau i.W.-St.Felix,74,,3,4,7
118 U.L.Frau i.W.-St.Felix,75,,3,3,6
118 U.L.Frau i.W.-St.Felix,76,,5,4,9
118 U.L.Frau i.W.-St.Felix,77,,6,1,7
118 U.L.Frau i.W.-St.Felix,78,,2,-,2
118 U.L.Frau i.W.-St.Felix,79,,4,5,9
118 U.L.Frau i.W.-St.Felix,80,,1,3,4
118 U.L.Frau i.W.-St.Felix,81,,2,4,6
118 U.L.Frau i.W.-St.Felix,82,,2,4,6
118 U.L.Frau i.W.-St.Felix,83,,2,3,5
118 U.L.Frau i.W.-St.Felix,84,,3,5,8
118 U.L.Frau i.W.-St.Felix,85,,1,1,2
118 U.L.Frau i.W.-St.Felix,86,,2,4,6
118 U.L.Frau i.W.-St.Felix,87,,1,-,1
118 U.L.Frau i.W.-St.Felix,88,,-,1,1
118 U.L.Frau i.W.-St.Felix,89,,-,1,1
118 U.L.Frau i.W.-St.Felix,92,,-,1,1
118 U.L.Frau i.W.-St.Felix,96,,1,-,1
