Gemeinde,Altersklassen,Geschlecht,Männer,Frauen,Insgesamt
001 Aldein,0,,12,8,20
001 Aldein,1,,5,10,15
001 Aldein,2,,6,13,19
001 Aldein,3,,8,12,20
001 Aldein,4,,7,15,22
001 Aldein,5,,10,8,18
001 Aldein,6,,17,8,25
001 Aldein,7,,14,9,23
001 Aldein,8,,11,8,19
001 Aldein,9,,16,8,24
001 Aldein,10,,12,4,16
001 Aldein,11,,16,14,30
001 Aldein,12,,10,16,26
001 Aldein,13,,15,8,23
001 Aldein,14,,7,8,15
001 Aldein,15,,8,12,20
001 Aldein,16,,14,7,21
001 Aldein,17,,13,11,24
001 Aldein,18,,9,13,22
001 Aldein,19,,7,7,14
001 Aldein,20,,7,6,13
001 Aldein,21,,9,16,25
001 Aldein,22,,11,9,20
001 Aldein,23,,11,8,19
001 Aldein,24,,12,7,19
001 Aldein,25,,15,15,30
001 Aldein,26,,9,7,16
001 Aldein,27,,11,11,22
001 Aldein,28,,15,4,19
001 Aldein,29,,10,11,21
001 Aldein,30,,9,14,23
001 Aldein,31,,9,13,22
001 Aldein,32,,10,8,18
001 Aldein,33,,9,18,27
001 Aldein,34,,9,15,24
001 Aldein,35,,17,14,31
001 Aldein,36,,13,11,24
001 Aldein,37,,13,10,23
001 Aldein,38,,17,9,26
001 Aldein,39,,14,14,28
001 Aldein,40,,13,15,28
001 Aldein,41,,22,7,29
001 Aldein,42,,12,16,28
001 Aldein,43,,6,14,20
001 Aldein,44,,5,20,25
001 Aldein,45,,17,9,26
001 Aldein,46,,14,11,25
001 Aldein,47,,13,6,19
001 Aldein,48,,8,16,24
001 Aldein,49,,17,14,31
001 Aldein,50,,15,9,24
001 Aldein,51,,11,13,24
001 Aldein,52,,7,5,12
001 Aldein,53,,9,10,19
001 Aldein,54,,9,8,17
001 Aldein,55,,9,9,18
001 Aldein,56,,9,6,15
001 Aldein,57,,9,9,18
001 Aldein,58,,7,4,11
001 Aldein,59,,16,10,26
001 Aldein,60,,5,13,18
001 Aldein,61,,9,6,15
001 Aldein,62,,9,9,18
001 Aldein,63,,5,10,15
001 Aldein,64,,6,10,16
001 Aldein,65,,10,5,15
001 Aldein,66,,5,7,12
001 Aldein,67,,10,10,20
001 Aldein,68,,6,12,18
001 Aldein,69,,5,12,17
001 Aldein,70,,6,8,14
001 Aldein,71,,5,9,14
001 Aldein,72,,7,7,14
001 Aldein,73,,5,9,14
001 Aldein,74,,5,6,11
001 Aldein,75,,4,4,8
001 Aldein,76,,13,4,17
001 Aldein,77,,6,4,10
001 Aldein,78,,3,7,10
001 Aldein,79,,6,4,10
001 Aldein,80,,1,4,5
001 Aldein,81,,6,7,13
001 Aldein,82,,4,1,5
001 Aldein,83,,5,4,9
001 Aldein,84,,-,2,2
001 Aldein,85,,1,4,5
001 Aldein,86,,-,6,6
001 Aldein,87,,2,4,6
001 Aldein,88,,-,8,8
001 Aldein,89,,1,7,8
001 Aldein,90,,1,1,2
001 Aldein,91,,-,2,2
001 Aldein,94,,1,-,1
001 Aldein,97,,-,1,1
001 Aldein,98,,-,1,1
002 Andrian,0,,5,8,13
002 Andrian,1,,9,10,19
002 Andrian,2,,8,6,14
002 Andrian,3,,4,6,10
002 Andrian,4,,9,4,13
002 Andrian,5,,6,6,12
002 Andrian,6,,10,4,14
002 Andrian,7,,7,10,17
002 Andrian,8,,3,3,6
002 Andrian,9,,3,4,7
002 Andrian,10,,6,5,11
002 Andrian,11,,4,5,9
002 Andrian,12,,8,3,11
002 Andrian,13,,8,7,15
002 Andrian,14,,3,10,13
002 Andrian,15,,8,4,12
002 Andrian,16,,7,7,14
002 Andrian,17,,5,4,9
002 Andrian,18,,7,6,13
002 Andrian,19,,6,8,14
002 Andrian,20,,5,6,11
002 Andrian,21,,5,4,9
002 Andrian,22,,13,6,19
002 Andrian,23,,6,8,14
002 Andrian,24,,9,6,15
002 Andrian,25,,2,5,7
002 Andrian,26,,9,4,13
002 Andrian,27,,7,5,12
002 Andrian,28,,10,8,18
002 Andrian,29,,4,5,9
002 Andrian,30,,8,6,14
002 Andrian,31,,7,10,17
002 Andrian,32,,7,7,14
002 Andrian,33,,7,9,16
002 Andrian,34,,11,10,21
002 Andrian,35,,9,4,13
002 Andrian,36,,5,9,14
002 Andrian,37,,15,11,26
002 Andrian,38,,7,11,18
002 Andrian,39,,11,10,21
002 Andrian,40,,12,5,17
002 Andrian,41,,6,9,15
002 Andrian,42,,9,9,18
002 Andrian,43,,10,8,18
002 Andrian,44,,11,10,21
002 Andrian,45,,11,12,23
002 Andrian,46,,8,8,16
002 Andrian,47,,7,13,20
002 Andrian,48,,11,7,18
002 Andrian,49,,9,3,12
002 Andrian,50,,7,7,14
002 Andrian,51,,9,5,14
002 Andrian,52,,8,8,16
002 Andrian,53,,9,7,16
002 Andrian,54,,4,9,13
002 Andrian,55,,2,5,7
002 Andrian,56,,6,3,9
002 Andrian,57,,6,8,14
002 Andrian,58,,3,3,6
002 Andrian,59,,2,3,5
002 Andrian,60,,6,5,11
002 Andrian,61,,4,2,6
002 Andrian,62,,5,4,9
002 Andrian,63,,5,4,9
002 Andrian,64,,7,8,15
002 Andrian,65,,1,2,3
002 Andrian,66,,1,4,5
002 Andrian,67,,6,7,13
002 Andrian,68,,2,5,7
002 Andrian,69,,6,4,10
002 Andrian,70,,3,7,10
002 Andrian,71,,1,7,8
002 Andrian,72,,4,3,7
002 Andrian,73,,4,4,8
002 Andrian,74,,2,3,5
002 Andrian,75,,4,2,6
002 Andrian,76,,5,1,6
002 Andrian,77,,3,4,7
002 Andrian,78,,7,4,11
002 Andrian,79,,2,4,6
002 Andrian,80,,4,1,5
002 Andrian,81,,2,1,3
002 Andrian,82,,1,3,4
002 Andrian,83,,-,2,2
002 Andrian,84,,3,4,7
002 Andrian,85,,1,1,2
002 Andrian,86,,1,3,4
002 Andrian,87,,-,1,1
002 Andrian,88,,1,3,4
002 Andrian,89,,1,3,4
002 Andrian,90,,1,-,1
002 Andrian,91,,1,-,1
002 Andrian,95,,-,1,1
002 Andrian,96,,1,1,2
003 Altrei,1,,2,2,4
003 Altrei,2,,1,3,4
003 Altrei,3,,6,4,10
003 Altrei,4,,2,-,2
003 Altrei,5,,3,1,4
003 Altrei,6,,1,1,2
003 Altrei,7,,-,1,1
003 Altrei,8,,2,1,3
003 Altrei,9,,4,1,5
003 Altrei,10,,1,1,2
003 Altrei,11,,3,-,3
003 Altrei,12,,3,1,4
003 Altrei,13,,-,1,1
003 Altrei,14,,-,2,2
003 Altrei,15,,1,2,3
003 Altrei,16,,3,2,5
003 Altrei,17,,3,-,3
003 Altrei,18,,6,3,9
003 Altrei,19,,1,-,1
003 Altrei,20,,3,2,5
003 Altrei,21,,1,2,3
003 Altrei,22,,3,5,8
003 Altrei,23,,2,1,3
003 Altrei,24,,3,2,5
003 Altrei,25,,3,2,5
003 Altrei,26,,3,-,3
003 Altrei,27,,4,1,5
003 Altrei,28,,2,3,5
003 Altrei,29,,3,2,5
003 Altrei,30,,2,2,4
003 Altrei,31,,1,2,3
003 Altrei,32,,2,4,6
003 Altrei,33,,-,2,2
003 Altrei,34,,2,3,5
003 Altrei,35,,3,1,4
003 Altrei,36,,1,-,1
003 Altrei,37,,2,3,5
003 Altrei,38,,4,-,4
003 Altrei,39,,4,3,7
003 Altrei,40,,1,2,3
003 Altrei,41,,3,5,8
003 Altrei,42,,1,4,5
003 Altrei,43,,3,1,4
003 Altrei,44,,2,4,6
003 Altrei,45,,2,4,6
003 Altrei,46,,3,6,9
003 Altrei,47,,2,2,4
003 Altrei,48,,10,2,12
003 Altrei,49,,2,3,5
003 Altrei,50,,5,2,7
003 Altrei,51,,5,4,9
003 Altrei,52,,2,3,5
003 Altrei,53,,1,2,3
003 Altrei,54,,5,1,6
003 Altrei,55,,2,3,5
003 Altrei,56,,2,1,3
003 Altrei,57,,3,2,5
003 Altrei,58,,6,3,9
003 Altrei,59,,5,3,8
003 Altrei,60,,1,3,4
003 Altrei,61,,1,-,1
003 Altrei,62,,3,2,5
003 Altrei,63,,3,2,5
003 Altrei,64,,2,3,5
003 Altrei,65,,3,1,4
003 Altrei,66,,2,3,5
003 Altrei,67,,1,3,4
003 Altrei,68,,3,1,4
003 Altrei,69,,1,3,4
003 Altrei,70,,2,4,6
003 Altrei,71,,2,3,5
003 Altrei,72,,1,1,2
003 Altrei,73,,3,1,4
003 Altrei,74,,3,1,4
003 Altrei,75,,3,2,5
003 Altrei,76,,-,2,2
003 Altrei,77,,2,2,4
003 Altrei,78,,-,2,2
003 Altrei,79,,-,2,2
003 Altrei,80,,1,1,2
003 Altrei,81,,2,2,4
003 Altrei,82,,-,2,2
003 Altrei,83,,2,3,5
003 Altrei,84,,1,4,5
003 Altrei,86,,-,2,2
003 Altrei,87,,-,1,1
003 Altrei,88,,-,1,1
003 Altrei,89,,-,1,1
003 Altrei,93,,-,2,2
003 Altrei,95,,-,1,1
003 Altrei,96,,-,1,1
003 Altrei,99,,-,1,1
004 Eppan a.d. Weinstr.,0,,82,66,148
004 Eppan a.d. Weinstr.,1,,76,65,141
004 Eppan a.d. Weinstr.,2,,85,96,181
004 Eppan a.d. Weinstr.,3,,75,68,143
004 Eppan a.d. Weinstr.,4,,105,80,185
004 Eppan a.d. Weinstr.,5,,76,108,184
004 Eppan a.d. Weinstr.,6,,86,69,155
004 Eppan a.d. Weinstr.,7,,82,70,152
004 Eppan a.d. Weinstr.,8,,76,76,152
004 Eppan a.d. Weinstr.,9,,81,73,154
004 Eppan a.d. Weinstr.,10,,70,78,148
004 Eppan a.d. Weinstr.,11,,90,59,149
004 Eppan a.d. Weinstr.,12,,85,83,168
004 Eppan a.d. Weinstr.,13,,72,71,143
004 Eppan a.d. Weinstr.,14,,74,75,149
004 Eppan a.d. Weinstr.,15,,71,68,139
004 Eppan a.d. Weinstr.,16,,77,78,155
004 Eppan a.d. Weinstr.,17,,84,87,171
004 Eppan a.d. Weinstr.,18,,69,69,138
004 Eppan a.d. Weinstr.,19,,82,65,147
004 Eppan a.d. Weinstr.,20,,86,62,148
004 Eppan a.d. Weinstr.,21,,80,72,152
004 Eppan a.d. Weinstr.,22,,81,87,168
004 Eppan a.d. Weinstr.,23,,77,68,145
004 Eppan a.d. Weinstr.,24,,96,82,178
004 Eppan a.d. Weinstr.,25,,87,58,145
004 Eppan a.d. Weinstr.,26,,83,80,163
004 Eppan a.d. Weinstr.,27,,78,84,162
004 Eppan a.d. Weinstr.,28,,86,95,181
004 Eppan a.d. Weinstr.,29,,76,109,185
004 Eppan a.d. Weinstr.,30,,93,93,186
004 Eppan a.d. Weinstr.,31,,93,93,186
004 Eppan a.d. Weinstr.,32,,103,97,200
004 Eppan a.d. Weinstr.,33,,92,87,179
004 Eppan a.d. Weinstr.,34,,95,87,182
004 Eppan a.d. Weinstr.,35,,100,108,208
004 Eppan a.d. Weinstr.,36,,101,107,208
004 Eppan a.d. Weinstr.,37,,113,107,220
004 Eppan a.d. Weinstr.,38,,110,136,246
004 Eppan a.d. Weinstr.,39,,117,104,221
004 Eppan a.d. Weinstr.,40,,133,120,253
004 Eppan a.d. Weinstr.,41,,144,133,277
004 Eppan a.d. Weinstr.,42,,129,124,253
004 Eppan a.d. Weinstr.,43,,127,130,257
004 Eppan a.d. Weinstr.,44,,134,145,279
004 Eppan a.d. Weinstr.,45,,112,118,230
004 Eppan a.d. Weinstr.,46,,142,110,252
004 Eppan a.d. Weinstr.,47,,117,124,241
004 Eppan a.d. Weinstr.,48,,130,117,247
004 Eppan a.d. Weinstr.,49,,126,110,236
004 Eppan a.d. Weinstr.,50,,110,120,230
004 Eppan a.d. Weinstr.,51,,113,106,219
004 Eppan a.d. Weinstr.,52,,102,104,206
004 Eppan a.d. Weinstr.,53,,96,91,187
004 Eppan a.d. Weinstr.,54,,91,80,171
004 Eppan a.d. Weinstr.,55,,86,84,170
004 Eppan a.d. Weinstr.,56,,74,89,163
004 Eppan a.d. Weinstr.,57,,89,80,169
004 Eppan a.d. Weinstr.,58,,69,86,155
004 Eppan a.d. Weinstr.,59,,83,67,150
004 Eppan a.d. Weinstr.,60,,58,82,140
004 Eppan a.d. Weinstr.,61,,63,60,123
004 Eppan a.d. Weinstr.,62,,75,74,149
004 Eppan a.d. Weinstr.,63,,58,84,142
004 Eppan a.d. Weinstr.,64,,81,71,152
004 Eppan a.d. Weinstr.,65,,55,50,105
004 Eppan a.d. Weinstr.,66,,70,83,153
004 Eppan a.d. Weinstr.,67,,90,83,173
004 Eppan a.d. Weinstr.,68,,89,78,167
004 Eppan a.d. Weinstr.,69,,61,106,167
004 Eppan a.d. Weinstr.,70,,70,55,125
004 Eppan a.d. Weinstr.,71,,59,78,137
004 Eppan a.d. Weinstr.,72,,50,51,101
004 Eppan a.d. Weinstr.,73,,44,56,100
004 Eppan a.d. Weinstr.,74,,44,46,90
004 Eppan a.d. Weinstr.,75,,32,45,77
004 Eppan a.d. Weinstr.,76,,31,47,78
004 Eppan a.d. Weinstr.,77,,47,50,97
004 Eppan a.d. Weinstr.,78,,38,48,86
004 Eppan a.d. Weinstr.,79,,28,56,84
004 Eppan a.d. Weinstr.,80,,37,53,90
004 Eppan a.d. Weinstr.,81,,28,49,77
004 Eppan a.d. Weinstr.,82,,29,36,65
004 Eppan a.d. Weinstr.,83,,22,42,64
004 Eppan a.d. Weinstr.,84,,20,47,67
004 Eppan a.d. Weinstr.,85,,20,41,61
004 Eppan a.d. Weinstr.,86,,10,40,50
004 Eppan a.d. Weinstr.,87,,11,29,40
004 Eppan a.d. Weinstr.,88,,9,33,42
004 Eppan a.d. Weinstr.,89,,12,23,35
004 Eppan a.d. Weinstr.,90,,6,19,25
004 Eppan a.d. Weinstr.,91,,4,9,13
004 Eppan a.d. Weinstr.,92,,5,7,12
004 Eppan a.d. Weinstr.,93,,4,3,7
004 Eppan a.d. Weinstr.,94,,2,3,5
004 Eppan a.d. Weinstr.,95,,2,1,3
004 Eppan a.d. Weinstr.,96,,1,5,6
004 Eppan a.d. Weinstr.,97,,1,3,4
004 Eppan a.d. Weinstr.,98,,-,3,3
004 Eppan a.d. Weinstr.,99,,1,4,5
004 Eppan a.d. Weinstr.,100,,-,1,1
004 Eppan a.d. Weinstr.,101,,2,2,4
004 Eppan a.d. Weinstr.,102,,-,1,1
005 Hafling,0,,4,4,8
005 Hafling,1,,3,7,10
005 Hafling,2,,5,5,10
005 Hafling,3,,3,2,5
005 Hafling,4,,6,6,12
005 Hafling,5,,4,3,7
005 Hafling,6,,1,6,7
005 Hafling,7,,1,6,7
005 Hafling,8,,6,3,9
005 Hafling,9,,4,3,7
005 Hafling,10,,5,8,13
005 Hafling,11,,4,3,7
005 Hafling,12,,3,7,10
005 Hafling,13,,2,9,11
005 Hafling,14,,12,4,16
005 Hafling,15,,6,4,10
005 Hafling,16,,4,5,9
005 Hafling,17,,2,7,9
005 Hafling,18,,3,4,7
005 Hafling,19,,8,3,11
005 Hafling,20,,4,6,10
005 Hafling,21,,3,2,5
005 Hafling,22,,2,6,8
005 Hafling,23,,4,2,6
005 Hafling,24,,5,2,7
005 Hafling,25,,3,5,8
005 Hafling,26,,4,10,14
005 Hafling,27,,2,-,2
005 Hafling,28,,5,3,8
005 Hafling,29,,4,8,12
005 Hafling,30,,4,12,16
005 Hafling,31,,5,4,9
005 Hafling,32,,4,5,9
005 Hafling,33,,6,6,12
005 Hafling,34,,6,7,13
005 Hafling,35,,6,4,10
005 Hafling,36,,6,6,12
005 Hafling,37,,10,1,11
005 Hafling,38,,9,1,10
005 Hafling,39,,12,6,18
005 Hafling,40,,11,10,21
005 Hafling,41,,7,12,19
005 Hafling,42,,2,11,13
005 Hafling,43,,3,1,4
005 Hafling,44,,11,7,18
005 Hafling,45,,7,13,20
005 Hafling,46,,3,2,5
005 Hafling,47,,6,3,9
005 Hafling,48,,7,2,9
005 Hafling,49,,8,4,12
005 Hafling,50,,9,7,16
005 Hafling,51,,6,5,11
005 Hafling,52,,3,4,7
005 Hafling,53,,2,4,6
005 Hafling,54,,3,8,11
005 Hafling,55,,6,3,9
005 Hafling,56,,3,2,5
005 Hafling,57,,2,3,5
005 Hafling,58,,7,2,9
005 Hafling,59,,2,3,5
005 Hafling,60,,5,4,9
005 Hafling,61,,5,4,9
005 Hafling,62,,6,2,8
005 Hafling,63,,3,4,7
005 Hafling,64,,1,4,5
005 Hafling,65,,3,3,6
005 Hafling,66,,2,2,4
005 Hafling,67,,4,5,9
005 Hafling,68,,6,3,9
005 Hafling,69,,3,4,7
005 Hafling,70,,2,1,3
005 Hafling,71,,4,5,9
005 Hafling,72,,2,3,5
005 Hafling,73,,2,1,3
005 Hafling,74,,1,1,2
005 Hafling,75,,2,2,4
005 Hafling,76,,-,2,2
005 Hafling,77,,4,3,7
005 Hafling,78,,3,4,7
005 Hafling,79,,3,6,9
005 Hafling,80,,1,4,5
005 Hafling,81,,2,1,3
005 Hafling,82,,-,2,2
005 Hafling,83,,3,2,5
005 Hafling,84,,-,2,2
005 Hafling,85,,1,-,1
005 Hafling,86,,1,-,1
005 Hafling,87,,1,-,1
005 Hafling,88,,-,1,1
005 Hafling,89,,-,1,1
005 Hafling,90,,3,1,4
005 Hafling,91,,-,1,1
005 Hafling,93,,-,1,1
005 Hafling,94,,-,1,1
006 Abtei,0,,24,16,40
006 Abtei,1,,21,19,40
006 Abtei,2,,23,18,41
006 Abtei,3,,28,23,51
006 Abtei,4,,30,23,53
006 Abtei,5,,22,29,51
006 Abtei,6,,28,14,42
006 Abtei,7,,21,18,39
006 Abtei,8,,13,30,43
006 Abtei,9,,25,23,48
006 Abtei,10,,23,32,55
006 Abtei,11,,21,26,47
006 Abtei,12,,14,14,28
006 Abtei,13,,26,23,49
006 Abtei,14,,27,15,42
006 Abtei,15,,24,29,53
006 Abtei,16,,19,16,35
006 Abtei,17,,16,18,34
006 Abtei,18,,24,14,38
006 Abtei,19,,22,13,35
006 Abtei,20,,24,16,40
006 Abtei,21,,15,16,31
006 Abtei,22,,15,11,26
006 Abtei,23,,19,12,31
006 Abtei,24,,17,18,35
006 Abtei,25,,12,10,22
006 Abtei,26,,14,18,32
006 Abtei,27,,14,13,27
006 Abtei,28,,20,17,37
006 Abtei,29,,20,18,38
006 Abtei,30,,24,18,42
006 Abtei,31,,17,25,42
006 Abtei,32,,21,32,53
006 Abtei,33,,23,33,56
006 Abtei,34,,27,24,51
006 Abtei,35,,16,32,48
006 Abtei,36,,19,30,49
006 Abtei,37,,28,23,51
006 Abtei,38,,44,34,78
006 Abtei,39,,20,33,53
006 Abtei,40,,29,32,61
006 Abtei,41,,31,34,65
006 Abtei,42,,29,34,63
006 Abtei,43,,36,33,69
006 Abtei,44,,22,30,52
006 Abtei,45,,36,25,61
006 Abtei,46,,26,31,57
006 Abtei,47,,30,25,55
006 Abtei,48,,26,31,57
006 Abtei,49,,25,27,52
006 Abtei,50,,26,24,50
006 Abtei,51,,27,23,50
006 Abtei,52,,20,20,40
006 Abtei,53,,19,15,34
006 Abtei,54,,19,17,36
006 Abtei,55,,17,16,33
006 Abtei,56,,11,15,26
006 Abtei,57,,14,20,34
006 Abtei,58,,11,13,24
006 Abtei,59,,11,13,24
006 Abtei,60,,15,20,35
006 Abtei,61,,10,18,28
006 Abtei,62,,24,17,41
006 Abtei,63,,15,16,31
006 Abtei,64,,22,19,41
006 Abtei,65,,15,20,35
006 Abtei,66,,12,17,29
006 Abtei,67,,11,11,22
006 Abtei,68,,20,12,32
006 Abtei,69,,14,23,37
006 Abtei,70,,16,16,32
006 Abtei,71,,14,14,28
006 Abtei,72,,15,17,32
006 Abtei,73,,6,17,23
006 Abtei,74,,16,9,25
006 Abtei,75,,10,17,27
006 Abtei,76,,12,14,26
006 Abtei,77,,8,15,23
006 Abtei,78,,5,5,10
006 Abtei,79,,8,11,19
006 Abtei,80,,12,11,23
006 Abtei,81,,5,7,12
006 Abtei,82,,5,11,16
006 Abtei,83,,6,7,13
006 Abtei,84,,4,4,8
006 Abtei,85,,5,4,9
006 Abtei,86,,4,8,12
006 Abtei,87,,4,7,11
006 Abtei,88,,4,3,7
006 Abtei,89,,1,1,2
006 Abtei,90,,2,6,8
006 Abtei,91,,1,3,4
006 Abtei,92,,1,2,3
006 Abtei,94,,1,2,3
006 Abtei,95,,-,1,1
006 Abtei,96,,-,1,1
006 Abtei,97,,1,-,1
006 Abtei,98,,-,1,1
007 Barbian,0,,7,11,18
007 Barbian,1,,9,16,25
007 Barbian,2,,13,4,17
007 Barbian,3,,9,11,20
007 Barbian,4,,6,2,8
007 Barbian,5,,16,5,21
007 Barbian,6,,6,5,11
007 Barbian,7,,8,16,24
007 Barbian,8,,6,7,13
007 Barbian,9,,11,14,25
007 Barbian,10,,14,5,19
007 Barbian,11,,11,10,21
007 Barbian,12,,14,7,21
007 Barbian,13,,8,9,17
007 Barbian,14,,13,10,23
007 Barbian,15,,11,8,19
007 Barbian,16,,9,5,14
007 Barbian,17,,10,12,22
007 Barbian,18,,12,9,21
007 Barbian,19,,13,12,25
007 Barbian,20,,16,13,29
007 Barbian,21,,7,14,21
007 Barbian,22,,13,7,20
007 Barbian,23,,8,6,14
007 Barbian,24,,14,8,22
007 Barbian,25,,6,9,15
007 Barbian,26,,10,7,17
007 Barbian,27,,11,10,21
007 Barbian,28,,9,11,20
007 Barbian,29,,12,14,26
007 Barbian,30,,13,5,18
007 Barbian,31,,16,12,28
007 Barbian,32,,10,10,20
007 Barbian,33,,11,18,29
007 Barbian,34,,7,13,20
007 Barbian,35,,8,9,17
007 Barbian,36,,12,10,22
007 Barbian,37,,12,19,31
007 Barbian,38,,18,14,32
007 Barbian,39,,17,8,25
007 Barbian,40,,11,13,24
007 Barbian,41,,15,7,22
007 Barbian,42,,15,10,25
007 Barbian,43,,10,8,18
007 Barbian,44,,13,12,25
007 Barbian,45,,7,14,21
007 Barbian,46,,14,14,28
007 Barbian,47,,15,14,29
007 Barbian,48,,16,15,31
007 Barbian,49,,17,11,28
007 Barbian,50,,13,15,28
007 Barbian,51,,13,9,22
007 Barbian,52,,7,9,16
007 Barbian,53,,14,7,21
007 Barbian,54,,5,9,14
007 Barbian,55,,7,6,13
007 Barbian,56,,7,15,22
007 Barbian,57,,8,10,18
007 Barbian,58,,8,4,12
007 Barbian,59,,8,10,18
007 Barbian,60,,10,11,21
007 Barbian,61,,5,6,11
007 Barbian,62,,3,5,8
007 Barbian,63,,5,11,16
007 Barbian,64,,17,6,23
007 Barbian,65,,5,6,11
007 Barbian,66,,10,9,19
007 Barbian,67,,8,7,15
007 Barbian,68,,11,10,21
007 Barbian,69,,8,12,20
007 Barbian,70,,10,4,14
007 Barbian,71,,5,4,9
007 Barbian,72,,4,11,15
007 Barbian,73,,8,9,17
007 Barbian,74,,3,5,8
007 Barbian,75,,2,6,8
007 Barbian,76,,5,5,10
007 Barbian,77,,7,4,11
007 Barbian,78,,6,6,12
007 Barbian,79,,2,6,8
007 Barbian,80,,5,4,9
007 Barbian,81,,5,7,12
007 Barbian,82,,4,6,10
007 Barbian,83,,3,1,4
007 Barbian,84,,3,1,4
007 Barbian,85,,3,2,5
007 Barbian,86,,1,3,4
007 Barbian,87,,-,3,3
007 Barbian,88,,1,2,3
007 Barbian,89,,1,1,2
007 Barbian,90,,-,1,1
007 Barbian,91,,-,1,1
007 Barbian,92,,1,-,1
007 Barbian,94,,-,1,1
008 Bozen,0,,481,478,959
008 Bozen,1,,497,456,953
008 Bozen,2,,524,493,1.017
008 Bozen,3,,560,478,1.038
008 Bozen,4,,472,494,966
008 Bozen,5,,532,489,1.021
008 Bozen,6,,535,491,1.026
008 Bozen,7,,530,515,1.045
008 Bozen,8,,522,461,983
008 Bozen,9,,511,471,982
008 Bozen,10,,469,490,959
008 Bozen,11,,509,486,995
008 Bozen,12,,495,473,968
008 Bozen,13,,486,427,913
008 Bozen,14,,462,500,962
008 Bozen,15,,460,420,880
008 Bozen,16,,486,471,957
008 Bozen,17,,442,469,911
008 Bozen,18,,490,421,911
008 Bozen,19,,520,441,961
008 Bozen,20,,506,447,953
008 Bozen,21,,496,467,963
008 Bozen,22,,515,467,982
008 Bozen,23,,412,454,866
008 Bozen,24,,490,475,965
008 Bozen,25,,517,483,1.000
008 Bozen,26,,528,526,1.054
008 Bozen,27,,595,508,1.103
008 Bozen,28,,578,541,1.119
008 Bozen,29,,619,557,1.176
008 Bozen,30,,667,554,1.221
008 Bozen,31,,595,591,1.186
008 Bozen,32,,615,606,1.221
008 Bozen,33,,661,631,1.292
008 Bozen,34,,671,694,1.365
008 Bozen,35,,710,727,1.437
008 Bozen,36,,773,767,1.540
008 Bozen,37,,727,834,1.561
008 Bozen,38,,828,849,1.677
008 Bozen,39,,889,897,1.786
008 Bozen,40,,858,819,1.677
008 Bozen,41,,912,873,1.785
008 Bozen,42,,830,811,1.641
008 Bozen,43,,811,884,1.695
008 Bozen,44,,899,891,1.790
008 Bozen,45,,905,905,1.810
008 Bozen,46,,913,917,1.830
008 Bozen,47,,768,874,1.642
008 Bozen,48,,773,808,1.581
008 Bozen,49,,765,748,1.513
008 Bozen,50,,712,744,1.456
008 Bozen,51,,715,714,1.429
008 Bozen,52,,701,727,1.428
008 Bozen,53,,622,733,1.355
008 Bozen,54,,629,690,1.319
008 Bozen,55,,594,660,1.254
008 Bozen,56,,593,622,1.215
008 Bozen,57,,536,632,1.168
008 Bozen,58,,526,652,1.178
008 Bozen,59,,529,629,1.158
008 Bozen,60,,557,676,1.233
008 Bozen,61,,567,635,1.202
008 Bozen,62,,614,729,1.343
008 Bozen,63,,579,794,1.373
008 Bozen,64,,671,858,1.529
008 Bozen,65,,495,578,1.073
008 Bozen,66,,548,702,1.250
008 Bozen,67,,596,709,1.305
008 Bozen,68,,615,691,1.306
008 Bozen,69,,650,727,1.377
008 Bozen,70,,610,703,1.313
008 Bozen,71,,547,697,1.244
008 Bozen,72,,563,640,1.203
008 Bozen,73,,482,549,1.031
008 Bozen,74,,432,544,976
008 Bozen,75,,412,540,952
008 Bozen,76,,418,531,949
008 Bozen,77,,360,520,880
008 Bozen,78,,363,527,890
008 Bozen,79,,358,503,861
008 Bozen,80,,345,485,830
008 Bozen,81,,231,432,663
008 Bozen,82,,275,428,703
008 Bozen,83,,225,403,628
008 Bozen,84,,254,372,626
008 Bozen,85,,195,393,588
008 Bozen,86,,174,323,497
008 Bozen,87,,140,339,479
008 Bozen,88,,115,327,442
008 Bozen,89,,103,266,369
008 Bozen,90,,77,229,306
008 Bozen,91,,34,139,173
008 Bozen,92,,20,71,91
008 Bozen,93,,15,53,68
008 Bozen,94,,17,65,82
008 Bozen,95,,10,70,80
008 Bozen,96,,16,55,71
008 Bozen,97,,9,36,45
008 Bozen,98,,8,34,42
008 Bozen,99,,5,22,27
008 Bozen,100,,1,10,11
008 Bozen,101,,2,3,5
008 Bozen,102,,-,5,5
008 Bozen,103,,-,2,2
008 Bozen,104,,-,1,1
008 Bozen,105,,-,1,1
009 Prags,0,,1,3,4
009 Prags,1,,1,1,2
009 Prags,2,,4,6,10
009 Prags,3,,4,6,10
009 Prags,4,,4,3,7
009 Prags,5,,3,1,4
009 Prags,6,,3,3,6
009 Prags,7,,2,5,7
009 Prags,8,,2,6,8
009 Prags,9,,7,6,13
009 Prags,10,,2,3,5
009 Prags,11,,5,9,14
009 Prags,12,,1,4,5
009 Prags,13,,3,5,8
009 Prags,14,,2,6,8
009 Prags,15,,3,1,4
009 Prags,16,,4,5,9
009 Prags,17,,7,2,9
009 Prags,18,,6,2,8
009 Prags,19,,8,1,9
009 Prags,20,,4,2,6
009 Prags,21,,8,2,10
009 Prags,22,,2,4,6
009 Prags,23,,3,3,6
009 Prags,24,,7,4,11
009 Prags,25,,8,2,10
009 Prags,26,,5,2,7
009 Prags,27,,3,4,7
009 Prags,28,,3,8,11
009 Prags,29,,2,5,7
009 Prags,30,,5,-,5
009 Prags,31,,2,2,4
009 Prags,32,,5,7,12
009 Prags,33,,2,3,5
009 Prags,34,,5,4,9
009 Prags,35,,3,5,8
009 Prags,36,,2,4,6
009 Prags,37,,7,3,10
009 Prags,38,,3,3,6
009 Prags,39,,6,4,10
009 Prags,40,,4,6,10
009 Prags,41,,9,5,14
009 Prags,42,,8,8,16
009 Prags,43,,7,6,13
009 Prags,44,,7,5,12
009 Prags,45,,7,7,14
009 Prags,46,,5,4,9
009 Prags,47,,6,5,11
009 Prags,48,,3,5,8
009 Prags,49,,5,12,17
009 Prags,50,,5,5,10
009 Prags,51,,11,5,16
009 Prags,52,,6,2,8
009 Prags,53,,6,4,10
009 Prags,54,,1,6,7
009 Prags,55,,4,5,9
009 Prags,56,,6,4,10
009 Prags,57,,4,1,5
009 Prags,58,,2,5,7
009 Prags,59,,3,1,4
009 Prags,60,,4,1,5
009 Prags,61,,1,1,2
009 Prags,62,,4,1,5
009 Prags,63,,1,-,1
009 Prags,64,,2,4,6
009 Prags,65,,2,2,4
009 Prags,66,,4,4,8
009 Prags,67,,1,3,4
009 Prags,68,,4,4,8
009 Prags,69,,5,2,7
009 Prags,70,,1,3,4
009 Prags,71,,3,5,8
009 Prags,72,,3,2,5
009 Prags,73,,-,2,2
009 Prags,74,,1,3,4
009 Prags,75,,1,3,4
009 Prags,76,,2,2,4
009 Prags,77,,3,2,5
009 Prags,78,,3,5,8
009 Prags,79,,-,3,3
009 Prags,80,,1,1,2
009 Prags,81,,1,2,3
009 Prags,82,,1,2,3
009 Prags,83,,2,5,7
009 Prags,84,,1,4,5
009 Prags,85,,1,4,5
009 Prags,86,,3,2,5
009 Prags,87,,-,4,4
009 Prags,88,,2,1,3
009 Prags,89,,1,2,3
009 Prags,90,,1,-,1
009 Prags,91,,-,2,2
009 Prags,95,,-,1,1
010 Brenner,0,,14,12,26
010 Brenner,1,,12,10,22
010 Brenner,2,,8,16,24
010 Brenner,3,,11,11,22
010 Brenner,4,,6,13,19
010 Brenner,5,,12,10,22
010 Brenner,6,,11,18,29
010 Brenner,7,,11,9,20
010 Brenner,8,,12,12,24
010 Brenner,9,,5,7,12
010 Brenner,10,,16,12,28
010 Brenner,11,,12,14,26
010 Brenner,12,,14,5,19
010 Brenner,13,,16,8,24
010 Brenner,14,,7,10,17
010 Brenner,15,,6,10,16
010 Brenner,16,,21,11,32
010 Brenner,17,,14,5,19
010 Brenner,18,,12,9,21
010 Brenner,19,,10,16,26
010 Brenner,20,,11,7,18
010 Brenner,21,,13,7,20
010 Brenner,22,,13,5,18
010 Brenner,23,,8,9,17
010 Brenner,24,,10,13,23
010 Brenner,25,,22,8,30
010 Brenner,26,,20,18,38
010 Brenner,27,,16,15,31
010 Brenner,28,,14,11,25
010 Brenner,29,,17,18,35
010 Brenner,30,,16,17,33
010 Brenner,31,,17,15,32
010 Brenner,32,,13,14,27
010 Brenner,33,,23,10,33
010 Brenner,34,,13,11,24
010 Brenner,35,,18,21,39
010 Brenner,36,,18,8,26
010 Brenner,37,,14,6,20
010 Brenner,38,,24,22,46
010 Brenner,39,,26,12,38
010 Brenner,40,,21,16,37
010 Brenner,41,,10,18,28
010 Brenner,42,,13,17,30
010 Brenner,43,,16,14,30
010 Brenner,44,,20,18,38
010 Brenner,45,,22,17,39
010 Brenner,46,,22,16,38
010 Brenner,47,,11,19,30
010 Brenner,48,,15,12,27
010 Brenner,49,,20,11,31
010 Brenner,50,,20,13,33
010 Brenner,51,,14,12,26
010 Brenner,52,,16,10,26
010 Brenner,53,,15,19,34
010 Brenner,54,,16,13,29
010 Brenner,55,,12,10,22
010 Brenner,56,,10,16,26
010 Brenner,57,,8,15,23
010 Brenner,58,,19,7,26
010 Brenner,59,,14,12,26
010 Brenner,60,,12,12,24
010 Brenner,61,,14,13,27
010 Brenner,62,,7,8,15
010 Brenner,63,,20,13,33
010 Brenner,64,,8,16,24
010 Brenner,65,,4,8,12
010 Brenner,66,,17,12,29
010 Brenner,67,,15,12,27
010 Brenner,68,,7,9,16
010 Brenner,69,,11,12,23
010 Brenner,70,,8,12,20
010 Brenner,71,,7,9,16
010 Brenner,72,,9,15,24
010 Brenner,73,,8,13,21
010 Brenner,74,,12,7,19
010 Brenner,75,,4,6,10
010 Brenner,76,,8,7,15
010 Brenner,77,,5,5,10
010 Brenner,78,,-,4,4
010 Brenner,79,,5,8,13
010 Brenner,80,,7,10,17
010 Brenner,81,,6,7,13
010 Brenner,82,,6,5,11
010 Brenner,83,,5,2,7
010 Brenner,84,,4,4,8
010 Brenner,85,,2,5,7
010 Brenner,86,,2,4,6
010 Brenner,87,,2,6,8
010 Brenner,88,,-,4,4
010 Brenner,90,,1,4,5
010 Brenner,91,,1,2,3
010 Brenner,92,,1,-,1
010 Brenner,99,,1,-,1
011 Brixen,0,,122,117,239
011 Brixen,1,,119,106,225
011 Brixen,2,,109,101,210
011 Brixen,3,,126,103,229
011 Brixen,4,,129,103,232
011 Brixen,5,,129,118,247
011 Brixen,6,,115,118,233
011 Brixen,7,,111,106,217
011 Brixen,8,,116,115,231
011 Brixen,9,,126,125,251
011 Brixen,10,,121,110,231
011 Brixen,11,,141,121,262
011 Brixen,12,,113,135,248
011 Brixen,13,,124,109,233
011 Brixen,14,,120,117,237
011 Brixen,15,,118,123,241
011 Brixen,16,,127,124,251
011 Brixen,17,,120,108,228
011 Brixen,18,,115,124,239
011 Brixen,19,,122,109,231
011 Brixen,20,,106,112,218
011 Brixen,21,,126,102,228
011 Brixen,22,,124,99,223
011 Brixen,23,,111,112,223
011 Brixen,24,,109,126,235
011 Brixen,25,,123,101,224
011 Brixen,26,,124,109,233
011 Brixen,27,,134,141,275
011 Brixen,28,,133,115,248
011 Brixen,29,,136,127,263
011 Brixen,30,,110,118,228
011 Brixen,31,,147,135,282
011 Brixen,32,,116,139,255
011 Brixen,33,,139,132,271
011 Brixen,34,,139,153,292
011 Brixen,35,,133,129,262
011 Brixen,36,,141,152,293
011 Brixen,37,,153,164,317
011 Brixen,38,,161,174,335
011 Brixen,39,,162,172,334
011 Brixen,40,,174,164,338
011 Brixen,41,,194,189,383
011 Brixen,42,,182,205,387
011 Brixen,43,,172,171,343
011 Brixen,44,,179,194,373
011 Brixen,45,,183,166,349
011 Brixen,46,,189,183,372
011 Brixen,47,,154,164,318
011 Brixen,48,,170,165,335
011 Brixen,49,,139,167,306
011 Brixen,50,,141,150,291
011 Brixen,51,,148,140,288
011 Brixen,52,,147,129,276
011 Brixen,53,,137,145,282
011 Brixen,54,,117,142,259
011 Brixen,55,,126,103,229
011 Brixen,56,,94,118,212
011 Brixen,57,,93,109,202
011 Brixen,58,,102,108,210
011 Brixen,59,,96,110,206
011 Brixen,60,,116,101,217
011 Brixen,61,,83,127,210
011 Brixen,62,,107,116,223
011 Brixen,63,,92,116,208
011 Brixen,64,,100,105,205
011 Brixen,65,,66,101,167
011 Brixen,66,,110,112,222
011 Brixen,67,,121,119,240
011 Brixen,68,,89,98,187
011 Brixen,69,,102,119,221
011 Brixen,70,,84,115,199
011 Brixen,71,,88,101,189
011 Brixen,72,,82,92,174
011 Brixen,73,,83,90,173
011 Brixen,74,,63,93,156
011 Brixen,75,,72,85,157
011 Brixen,76,,64,85,149
011 Brixen,77,,66,64,130
011 Brixen,78,,67,76,143
011 Brixen,79,,58,74,132
011 Brixen,80,,47,84,131
011 Brixen,81,,40,78,118
011 Brixen,82,,45,61,106
011 Brixen,83,,26,78,104
011 Brixen,84,,33,60,93
011 Brixen,85,,29,61,90
011 Brixen,86,,23,56,79
011 Brixen,87,,29,41,70
011 Brixen,88,,15,48,63
011 Brixen,89,,13,47,60
011 Brixen,90,,11,34,45
011 Brixen,91,,6,20,26
011 Brixen,92,,3,12,15
011 Brixen,93,,8,17,25
011 Brixen,94,,2,10,12
011 Brixen,95,,1,8,9
011 Brixen,96,,3,9,12
011 Brixen,97,,1,5,6
011 Brixen,98,,1,5,6
011 Brixen,99,,-,6,6
011 Brixen,100,,-,2,2
011 Brixen,102,,-,1,1
011 Brixen,103,,-,1,1
012 Branzoll,0,,13,22,35
012 Branzoll,1,,17,17,34
012 Branzoll,2,,12,13,25
012 Branzoll,3,,13,16,29
012 Branzoll,4,,14,10,24
012 Branzoll,5,,9,9,18
012 Branzoll,6,,17,15,32
012 Branzoll,7,,17,23,40
012 Branzoll,8,,14,12,26
012 Branzoll,9,,11,12,23
012 Branzoll,10,,21,8,29
012 Branzoll,11,,10,14,24
012 Branzoll,12,,15,7,22
012 Branzoll,13,,13,22,35
012 Branzoll,14,,16,8,24
012 Branzoll,15,,14,13,27
012 Branzoll,16,,17,8,25
012 Branzoll,17,,20,12,32
012 Branzoll,18,,14,13,27
012 Branzoll,19,,14,16,30
012 Branzoll,20,,13,17,30
012 Branzoll,21,,10,11,21
012 Branzoll,22,,18,16,34
012 Branzoll,23,,11,8,19
012 Branzoll,24,,11,14,25
012 Branzoll,25,,15,16,31
012 Branzoll,26,,17,15,32
012 Branzoll,27,,13,13,26
012 Branzoll,28,,19,15,34
012 Branzoll,29,,14,16,30
012 Branzoll,30,,11,18,29
012 Branzoll,31,,15,12,27
012 Branzoll,32,,12,23,35
012 Branzoll,33,,14,23,37
012 Branzoll,34,,15,18,33
012 Branzoll,35,,21,16,37
012 Branzoll,36,,25,27,52
012 Branzoll,37,,26,15,41
012 Branzoll,38,,23,16,39
012 Branzoll,39,,26,28,54
012 Branzoll,40,,21,22,43
012 Branzoll,41,,27,26,53
012 Branzoll,42,,24,24,48
012 Branzoll,43,,19,24,43
012 Branzoll,44,,20,19,39
012 Branzoll,45,,23,22,45
012 Branzoll,46,,29,26,55
012 Branzoll,47,,19,19,38
012 Branzoll,48,,16,17,33
012 Branzoll,49,,28,27,55
012 Branzoll,50,,29,20,49
012 Branzoll,51,,20,24,44
012 Branzoll,52,,19,18,37
012 Branzoll,53,,20,15,35
012 Branzoll,54,,13,18,31
012 Branzoll,55,,18,19,37
012 Branzoll,56,,21,17,38
012 Branzoll,57,,12,22,34
012 Branzoll,58,,15,20,35
012 Branzoll,59,,16,14,30
012 Branzoll,60,,17,15,32
012 Branzoll,61,,17,15,32
012 Branzoll,62,,15,16,31
012 Branzoll,63,,15,17,32
012 Branzoll,64,,14,21,35
012 Branzoll,65,,15,9,24
012 Branzoll,66,,12,11,23
012 Branzoll,67,,14,10,24
012 Branzoll,68,,19,11,30
012 Branzoll,69,,20,13,33
012 Branzoll,70,,12,13,25
012 Branzoll,71,,15,12,27
012 Branzoll,72,,9,9,18
012 Branzoll,73,,3,7,10
012 Branzoll,74,,7,8,15
012 Branzoll,75,,8,8,16
012 Branzoll,76,,4,10,14
012 Branzoll,77,,18,10,28
012 Branzoll,78,,8,10,18
012 Branzoll,79,,2,10,12
012 Branzoll,80,,5,15,20
012 Branzoll,81,,4,10,14
012 Branzoll,82,,3,9,12
012 Branzoll,83,,3,5,8
012 Branzoll,84,,4,9,13
012 Branzoll,85,,2,4,6
012 Branzoll,86,,1,5,6
012 Branzoll,87,,3,8,11
012 Branzoll,88,,-,2,2
012 Branzoll,89,,3,5,8
012 Branzoll,90,,1,4,5
012 Branzoll,91,,1,3,4
012 Branzoll,92,,2,1,3
012 Branzoll,96,,-,2,2
012 Branzoll,98,,-,2,2
012 Branzoll,99,,1,1,2
013 Bruneck,0,,76,76,152
013 Bruneck,1,,92,63,155
013 Bruneck,2,,77,68,145
013 Bruneck,3,,87,62,149
013 Bruneck,4,,109,73,182
013 Bruneck,5,,79,85,164
013 Bruneck,6,,91,99,190
013 Bruneck,7,,97,76,173
013 Bruneck,8,,78,93,171
013 Bruneck,9,,96,76,172
013 Bruneck,10,,87,87,174
013 Bruneck,11,,94,96,190
013 Bruneck,12,,95,92,187
013 Bruneck,13,,111,71,182
013 Bruneck,14,,83,97,180
013 Bruneck,15,,66,81,147
013 Bruneck,16,,89,76,165
013 Bruneck,17,,88,67,155
013 Bruneck,18,,99,76,175
013 Bruneck,19,,86,66,152
013 Bruneck,20,,95,75,170
013 Bruneck,21,,90,92,182
013 Bruneck,22,,74,78,152
013 Bruneck,23,,66,66,132
013 Bruneck,24,,114,88,202
013 Bruneck,25,,91,79,170
013 Bruneck,26,,92,90,182
013 Bruneck,27,,97,94,191
013 Bruneck,28,,100,109,209
013 Bruneck,29,,108,117,225
013 Bruneck,30,,107,106,213
013 Bruneck,31,,103,107,210
013 Bruneck,32,,129,122,251
013 Bruneck,33,,121,106,227
013 Bruneck,34,,114,124,238
013 Bruneck,35,,124,121,245
013 Bruneck,36,,133,113,246
013 Bruneck,37,,134,117,251
013 Bruneck,38,,120,121,241
013 Bruneck,39,,144,121,265
013 Bruneck,40,,126,142,268
013 Bruneck,41,,138,119,257
013 Bruneck,42,,126,147,273
013 Bruneck,43,,141,134,275
013 Bruneck,44,,128,124,252
013 Bruneck,45,,158,145,303
013 Bruneck,46,,138,135,273
013 Bruneck,47,,134,114,248
013 Bruneck,48,,128,120,248
013 Bruneck,49,,118,102,220
013 Bruneck,50,,102,116,218
013 Bruneck,51,,110,102,212
013 Bruneck,52,,106,112,218
013 Bruneck,53,,89,104,193
013 Bruneck,54,,87,93,180
013 Bruneck,55,,72,82,154
013 Bruneck,56,,92,79,171
013 Bruneck,57,,74,99,173
013 Bruneck,58,,89,98,187
013 Bruneck,59,,68,102,170
013 Bruneck,60,,80,95,175
013 Bruneck,61,,82,92,174
013 Bruneck,62,,79,109,188
013 Bruneck,63,,95,70,165
013 Bruneck,64,,102,86,188
013 Bruneck,65,,63,68,131
013 Bruneck,66,,86,94,180
013 Bruneck,67,,93,83,176
013 Bruneck,68,,83,87,170
013 Bruneck,69,,72,98,170
013 Bruneck,70,,73,85,158
013 Bruneck,71,,76,91,167
013 Bruneck,72,,52,50,102
013 Bruneck,73,,50,53,103
013 Bruneck,74,,50,56,106
013 Bruneck,75,,44,47,91
013 Bruneck,76,,34,50,84
013 Bruneck,77,,42,57,99
013 Bruneck,78,,43,49,92
013 Bruneck,79,,32,45,77
013 Bruneck,80,,27,54,81
013 Bruneck,81,,22,51,73
013 Bruneck,82,,33,53,86
013 Bruneck,83,,21,38,59
013 Bruneck,84,,17,33,50
013 Bruneck,85,,17,40,57
013 Bruneck,86,,10,43,53
013 Bruneck,87,,17,29,46
013 Bruneck,88,,15,20,35
013 Bruneck,89,,6,19,25
013 Bruneck,90,,6,19,25
013 Bruneck,91,,7,9,16
013 Bruneck,92,,1,7,8
013 Bruneck,93,,3,11,14
013 Bruneck,94,,1,11,12
013 Bruneck,95,,1,5,6
013 Bruneck,96,,3,5,8
013 Bruneck,97,,-,8,8
013 Bruneck,98,,3,2,5
013 Bruneck,99,,-,2,2
013 Bruneck,100,,-,2,2
013 Bruneck,101,,-,1,1
014 Kuens,0,,1,1,2
014 Kuens,1,,2,4,6
014 Kuens,2,,4,4,8
014 Kuens,3,,2,5,7
014 Kuens,4,,2,1,3
014 Kuens,5,,6,2,8
014 Kuens,6,,2,3,5
014 Kuens,7,,5,4,9
014 Kuens,8,,2,1,3
014 Kuens,9,,5,2,7
014 Kuens,10,,2,6,8
014 Kuens,11,,2,3,5
014 Kuens,12,,2,6,8
014 Kuens,13,,2,1,3
014 Kuens,14,,5,2,7
014 Kuens,15,,2,3,5
014 Kuens,16,,1,4,5
014 Kuens,17,,3,2,5
014 Kuens,18,,4,2,6
014 Kuens,19,,2,2,4
014 Kuens,20,,4,2,6
014 Kuens,21,,2,2,4
014 Kuens,22,,1,3,4
014 Kuens,23,,2,-,2
014 Kuens,24,,1,-,1
014 Kuens,25,,1,-,1
014 Kuens,26,,1,3,4
014 Kuens,27,,1,-,1
014 Kuens,28,,2,1,3
014 Kuens,29,,1,3,4
014 Kuens,30,,4,5,9
014 Kuens,31,,1,2,3
014 Kuens,32,,3,2,5
014 Kuens,33,,2,2,4
014 Kuens,34,,3,2,5
014 Kuens,35,,4,6,10
014 Kuens,36,,3,7,10
014 Kuens,37,,1,3,4
014 Kuens,38,,6,1,7
014 Kuens,39,,2,4,6
014 Kuens,40,,7,5,12
014 Kuens,41,,4,1,5
014 Kuens,42,,4,4,8
014 Kuens,43,,6,11,17
014 Kuens,44,,1,5,6
014 Kuens,45,,7,1,8
014 Kuens,46,,6,6,12
014 Kuens,47,,9,2,11
014 Kuens,48,,5,1,6
014 Kuens,49,,-,5,5
014 Kuens,51,,1,-,1
014 Kuens,52,,-,4,4
014 Kuens,53,,3,-,3
014 Kuens,54,,3,-,3
014 Kuens,55,,-,2,2
014 Kuens,56,,-,1,1
014 Kuens,57,,1,2,3
014 Kuens,58,,1,3,4
014 Kuens,60,,-,3,3
014 Kuens,61,,1,3,4
014 Kuens,62,,3,1,4
014 Kuens,63,,1,2,3
014 Kuens,64,,1,2,3
014 Kuens,65,,3,1,4
014 Kuens,66,,1,-,1
014 Kuens,67,,-,2,2
014 Kuens,68,,1,3,4
014 Kuens,69,,1,2,3
014 Kuens,70,,-,1,1
014 Kuens,71,,5,2,7
014 Kuens,72,,3,2,5
014 Kuens,73,,1,3,4
014 Kuens,74,,2,2,4
014 Kuens,75,,1,3,4
014 Kuens,76,,-,1,1
014 Kuens,77,,-,1,1
014 Kuens,78,,4,2,6
014 Kuens,79,,2,2,4
014 Kuens,80,,2,2,4
014 Kuens,81,,1,-,1
014 Kuens,82,,1,-,1
014 Kuens,83,,1,-,1
014 Kuens,84,,1,1,2
014 Kuens,88,,-,2,2
014 Kuens,91,,-,1,1
014 Kuens,94,,-,1,1
014 Kuens,95,,1,-,1
015 Kaltern a.d. Weinstr.,0,,54,31,85
015 Kaltern a.d. Weinstr.,1,,44,32,76
015 Kaltern a.d. Weinstr.,2,,41,41,82
015 Kaltern a.d. Weinstr.,3,,42,42,84
015 Kaltern a.d. Weinstr.,4,,44,40,84
015 Kaltern a.d. Weinstr.,5,,47,43,90
015 Kaltern a.d. Weinstr.,6,,45,45,90
015 Kaltern a.d. Weinstr.,7,,48,36,84
015 Kaltern a.d. Weinstr.,8,,43,37,80
015 Kaltern a.d. Weinstr.,9,,31,50,81
015 Kaltern a.d. Weinstr.,10,,37,38,75
015 Kaltern a.d. Weinstr.,11,,44,39,83
015 Kaltern a.d. Weinstr.,12,,41,49,90
015 Kaltern a.d. Weinstr.,13,,46,45,91
015 Kaltern a.d. Weinstr.,14,,43,43,86
015 Kaltern a.d. Weinstr.,15,,45,38,83
015 Kaltern a.d. Weinstr.,16,,36,38,74
015 Kaltern a.d. Weinstr.,17,,31,38,69
015 Kaltern a.d. Weinstr.,18,,38,39,77
015 Kaltern a.d. Weinstr.,19,,37,44,81
015 Kaltern a.d. Weinstr.,20,,42,35,77
015 Kaltern a.d. Weinstr.,21,,53,26,79
015 Kaltern a.d. Weinstr.,22,,41,37,78
015 Kaltern a.d. Weinstr.,23,,38,36,74
015 Kaltern a.d. Weinstr.,24,,53,39,92
015 Kaltern a.d. Weinstr.,25,,50,43,93
015 Kaltern a.d. Weinstr.,26,,45,43,88
015 Kaltern a.d. Weinstr.,27,,44,45,89
015 Kaltern a.d. Weinstr.,28,,51,55,106
015 Kaltern a.d. Weinstr.,29,,39,35,74
015 Kaltern a.d. Weinstr.,30,,50,56,106
015 Kaltern a.d. Weinstr.,31,,49,46,95
015 Kaltern a.d. Weinstr.,32,,57,49,106
015 Kaltern a.d. Weinstr.,33,,39,55,94
015 Kaltern a.d. Weinstr.,34,,47,55,102
015 Kaltern a.d. Weinstr.,35,,51,68,119
015 Kaltern a.d. Weinstr.,36,,47,56,103
015 Kaltern a.d. Weinstr.,37,,45,60,105
015 Kaltern a.d. Weinstr.,38,,62,69,131
015 Kaltern a.d. Weinstr.,39,,66,58,124
015 Kaltern a.d. Weinstr.,40,,61,64,125
015 Kaltern a.d. Weinstr.,41,,61,63,124
015 Kaltern a.d. Weinstr.,42,,78,71,149
015 Kaltern a.d. Weinstr.,43,,63,62,125
015 Kaltern a.d. Weinstr.,44,,63,69,132
015 Kaltern a.d. Weinstr.,45,,61,60,121
015 Kaltern a.d. Weinstr.,46,,84,55,139
015 Kaltern a.d. Weinstr.,47,,52,58,110
015 Kaltern a.d. Weinstr.,48,,57,61,118
015 Kaltern a.d. Weinstr.,49,,67,66,133
015 Kaltern a.d. Weinstr.,50,,51,65,116
015 Kaltern a.d. Weinstr.,51,,54,56,110
015 Kaltern a.d. Weinstr.,52,,57,65,122
015 Kaltern a.d. Weinstr.,53,,50,61,111
015 Kaltern a.d. Weinstr.,54,,65,41,106
015 Kaltern a.d. Weinstr.,55,,52,41,93
015 Kaltern a.d. Weinstr.,56,,38,48,86
015 Kaltern a.d. Weinstr.,57,,38,38,76
015 Kaltern a.d. Weinstr.,58,,41,57,98
015 Kaltern a.d. Weinstr.,59,,33,37,70
015 Kaltern a.d. Weinstr.,60,,42,34,76
015 Kaltern a.d. Weinstr.,61,,29,38,67
015 Kaltern a.d. Weinstr.,62,,37,35,72
015 Kaltern a.d. Weinstr.,63,,37,54,91
015 Kaltern a.d. Weinstr.,64,,48,46,94
015 Kaltern a.d. Weinstr.,65,,39,39,78
015 Kaltern a.d. Weinstr.,66,,33,40,73
015 Kaltern a.d. Weinstr.,67,,32,37,69
015 Kaltern a.d. Weinstr.,68,,41,40,81
015 Kaltern a.d. Weinstr.,69,,43,42,85
015 Kaltern a.d. Weinstr.,70,,31,43,74
015 Kaltern a.d. Weinstr.,71,,23,36,59
015 Kaltern a.d. Weinstr.,72,,35,37,72
015 Kaltern a.d. Weinstr.,73,,27,29,56
015 Kaltern a.d. Weinstr.,74,,25,21,46
015 Kaltern a.d. Weinstr.,75,,23,26,49
015 Kaltern a.d. Weinstr.,76,,20,25,45
015 Kaltern a.d. Weinstr.,77,,23,37,60
015 Kaltern a.d. Weinstr.,78,,22,32,54
015 Kaltern a.d. Weinstr.,79,,16,29,45
015 Kaltern a.d. Weinstr.,80,,20,34,54
015 Kaltern a.d. Weinstr.,81,,19,30,49
015 Kaltern a.d. Weinstr.,82,,17,26,43
015 Kaltern a.d. Weinstr.,83,,14,27,41
015 Kaltern a.d. Weinstr.,84,,11,25,36
015 Kaltern a.d. Weinstr.,85,,15,28,43
015 Kaltern a.d. Weinstr.,86,,8,18,26
015 Kaltern a.d. Weinstr.,87,,3,16,19
015 Kaltern a.d. Weinstr.,88,,6,22,28
015 Kaltern a.d. Weinstr.,89,,5,16,21
015 Kaltern a.d. Weinstr.,90,,2,16,18
015 Kaltern a.d. Weinstr.,91,,3,8,11
015 Kaltern a.d. Weinstr.,92,,1,6,7
015 Kaltern a.d. Weinstr.,93,,2,3,5
015 Kaltern a.d. Weinstr.,94,,1,-,1
015 Kaltern a.d. Weinstr.,95,,1,2,3
015 Kaltern a.d. Weinstr.,96,,-,5,5
015 Kaltern a.d. Weinstr.,97,,1,4,5
015 Kaltern a.d. Weinstr.,98,,-,4,4
015 Kaltern a.d. Weinstr.,99,,-,1,1
016 Freienfeld,0,,13,11,24
016 Freienfeld,1,,17,17,34
016 Freienfeld,2,,12,12,24
016 Freienfeld,3,,21,11,32
016 Freienfeld,4,,15,15,30
016 Freienfeld,5,,19,19,38
016 Freienfeld,6,,16,10,26
016 Freienfeld,7,,22,15,37
016 Freienfeld,8,,19,20,39
016 Freienfeld,9,,18,19,37
016 Freienfeld,10,,15,14,29
016 Freienfeld,11,,16,20,36
016 Freienfeld,12,,15,20,35
016 Freienfeld,13,,18,17,35
016 Freienfeld,14,,22,14,36
016 Freienfeld,15,,17,17,34
016 Freienfeld,16,,14,11,25
016 Freienfeld,17,,14,12,26
016 Freienfeld,18,,17,22,39
016 Freienfeld,19,,11,11,22
016 Freienfeld,20,,21,19,40
016 Freienfeld,21,,28,20,48
016 Freienfeld,22,,21,16,37
016 Freienfeld,23,,17,15,32
016 Freienfeld,24,,15,12,27
016 Freienfeld,25,,14,14,28
016 Freienfeld,26,,25,14,39
016 Freienfeld,27,,22,19,41
016 Freienfeld,28,,18,19,37
016 Freienfeld,29,,18,20,38
016 Freienfeld,30,,21,16,37
016 Freienfeld,31,,17,19,36
016 Freienfeld,32,,14,15,29
016 Freienfeld,33,,21,19,40
016 Freienfeld,34,,16,16,32
016 Freienfeld,35,,24,16,40
016 Freienfeld,36,,22,21,43
016 Freienfeld,37,,21,19,40
016 Freienfeld,38,,22,25,47
016 Freienfeld,39,,23,23,46
016 Freienfeld,40,,25,18,43
016 Freienfeld,41,,25,25,50
016 Freienfeld,42,,24,18,42
016 Freienfeld,43,,19,29,48
016 Freienfeld,44,,25,21,46
016 Freienfeld,45,,28,22,50
016 Freienfeld,46,,25,18,43
016 Freienfeld,47,,20,17,37
016 Freienfeld,48,,26,27,53
016 Freienfeld,49,,25,17,42
016 Freienfeld,50,,25,23,48
016 Freienfeld,51,,24,14,38
016 Freienfeld,52,,18,23,41
016 Freienfeld,53,,14,20,34
016 Freienfeld,54,,22,17,39
016 Freienfeld,55,,22,10,32
016 Freienfeld,56,,17,18,35
016 Freienfeld,57,,18,11,29
016 Freienfeld,58,,15,18,33
016 Freienfeld,59,,12,11,23
016 Freienfeld,60,,19,9,28
016 Freienfeld,61,,16,13,29
016 Freienfeld,62,,19,13,32
016 Freienfeld,63,,5,10,15
016 Freienfeld,64,,11,16,27
016 Freienfeld,65,,9,2,11
016 Freienfeld,66,,8,5,13
016 Freienfeld,67,,11,8,19
016 Freienfeld,68,,12,9,21
016 Freienfeld,69,,12,11,23
016 Freienfeld,70,,10,4,14
016 Freienfeld,71,,7,9,16
016 Freienfeld,72,,12,12,24
016 Freienfeld,73,,5,11,16
016 Freienfeld,74,,8,11,19
016 Freienfeld,75,,6,11,17
016 Freienfeld,76,,4,4,8
016 Freienfeld,77,,6,8,14
016 Freienfeld,78,,7,9,16
016 Freienfeld,79,,6,8,14
016 Freienfeld,80,,7,5,12
016 Freienfeld,81,,2,5,7
016 Freienfeld,82,,5,4,9
016 Freienfeld,83,,4,5,9
016 Freienfeld,84,,6,9,15
016 Freienfeld,85,,4,6,10
016 Freienfeld,86,,1,2,3
016 Freienfeld,87,,1,7,8
016 Freienfeld,88,,1,6,7
016 Freienfeld,90,,1,1,2
016 Freienfeld,91,,1,-,1
016 Freienfeld,94,,-,1,1
016 Freienfeld,96,,-,1,1
016 Freienfeld,99,,-,1,1
017 Sand in Taufers,0,,25,25,50
017 Sand in Taufers,1,,36,42,78
017 Sand in Taufers,2,,29,31,60
017 Sand in Taufers,3,,48,41,89
017 Sand in Taufers,4,,36,24,60
017 Sand in Taufers,5,,36,30,66
017 Sand in Taufers,6,,36,23,59
017 Sand in Taufers,7,,32,27,59
017 Sand in Taufers,8,,27,30,57
017 Sand in Taufers,9,,31,38,69
017 Sand in Taufers,10,,44,21,65
017 Sand in Taufers,11,,35,35,70
017 Sand in Taufers,12,,27,35,62
017 Sand in Taufers,13,,34,36,70
017 Sand in Taufers,14,,29,31,60
017 Sand in Taufers,15,,30,27,57
017 Sand in Taufers,16,,41,35,76
017 Sand in Taufers,17,,23,37,60
017 Sand in Taufers,18,,33,37,70
017 Sand in Taufers,19,,28,31,59
017 Sand in Taufers,20,,23,34,57
017 Sand in Taufers,21,,28,31,59
017 Sand in Taufers,22,,30,32,62
017 Sand in Taufers,23,,22,26,48
017 Sand in Taufers,24,,25,17,42
017 Sand in Taufers,25,,24,32,56
017 Sand in Taufers,26,,32,27,59
017 Sand in Taufers,27,,36,34,70
017 Sand in Taufers,28,,26,38,64
017 Sand in Taufers,29,,35,30,65
017 Sand in Taufers,30,,38,43,81
017 Sand in Taufers,31,,33,43,76
017 Sand in Taufers,32,,42,37,79
017 Sand in Taufers,33,,31,38,69
017 Sand in Taufers,34,,38,35,73
017 Sand in Taufers,35,,42,36,78
017 Sand in Taufers,36,,60,48,108
017 Sand in Taufers,37,,52,42,94
017 Sand in Taufers,38,,48,52,100
017 Sand in Taufers,39,,43,50,93
017 Sand in Taufers,40,,43,63,106
017 Sand in Taufers,41,,54,44,98
017 Sand in Taufers,42,,54,40,94
017 Sand in Taufers,43,,35,41,76
017 Sand in Taufers,44,,52,35,87
017 Sand in Taufers,45,,51,38,89
017 Sand in Taufers,46,,51,41,92
017 Sand in Taufers,47,,46,44,90
017 Sand in Taufers,48,,36,43,79
017 Sand in Taufers,49,,47,41,88
017 Sand in Taufers,50,,41,34,75
017 Sand in Taufers,51,,36,34,70
017 Sand in Taufers,52,,31,21,52
017 Sand in Taufers,53,,23,39,62
017 Sand in Taufers,54,,24,34,58
017 Sand in Taufers,55,,25,22,47
017 Sand in Taufers,56,,26,29,55
017 Sand in Taufers,57,,29,24,53
017 Sand in Taufers,58,,17,28,45
017 Sand in Taufers,59,,25,22,47
017 Sand in Taufers,60,,33,32,65
017 Sand in Taufers,61,,29,22,51
017 Sand in Taufers,62,,21,26,47
017 Sand in Taufers,63,,24,29,53
017 Sand in Taufers,64,,26,23,49
017 Sand in Taufers,65,,28,8,36
017 Sand in Taufers,66,,17,30,47
017 Sand in Taufers,67,,27,29,56
017 Sand in Taufers,68,,28,32,60
017 Sand in Taufers,69,,24,31,55
017 Sand in Taufers,70,,22,18,40
017 Sand in Taufers,71,,24,29,53
017 Sand in Taufers,72,,17,26,43
017 Sand in Taufers,73,,26,12,38
017 Sand in Taufers,74,,15,25,40
017 Sand in Taufers,75,,25,18,43
017 Sand in Taufers,76,,14,11,25
017 Sand in Taufers,77,,12,15,27
017 Sand in Taufers,78,,11,16,27
017 Sand in Taufers,79,,11,11,22
017 Sand in Taufers,80,,11,18,29
017 Sand in Taufers,81,,10,11,21
017 Sand in Taufers,82,,6,11,17
017 Sand in Taufers,83,,6,7,13
017 Sand in Taufers,84,,5,16,21
017 Sand in Taufers,85,,4,8,12
017 Sand in Taufers,86,,5,11,16
017 Sand in Taufers,87,,6,7,13
017 Sand in Taufers,88,,2,10,12
017 Sand in Taufers,89,,2,11,13
017 Sand in Taufers,90,,2,4,6
017 Sand in Taufers,91,,1,5,6
017 Sand in Taufers,92,,2,2,4
017 Sand in Taufers,93,,-,2,2
017 Sand in Taufers,94,,-,1,1
017 Sand in Taufers,95,,2,4,6
017 Sand in Taufers,96,,1,1,2
017 Sand in Taufers,97,,-,2,2
017 Sand in Taufers,98,,-,1,1
017 Sand in Taufers,99,,-,1,1
018 Kastelbell-Tschars,0,,11,20,31
018 Kastelbell-Tschars,1,,13,10,23
018 Kastelbell-Tschars,2,,12,6,18
018 Kastelbell-Tschars,3,,12,11,23
018 Kastelbell-Tschars,4,,19,8,27
018 Kastelbell-Tschars,5,,10,9,19
018 Kastelbell-Tschars,6,,12,11,23
018 Kastelbell-Tschars,7,,11,9,20
018 Kastelbell-Tschars,8,,7,9,16
018 Kastelbell-Tschars,9,,14,15,29
018 Kastelbell-Tschars,10,,12,9,21
018 Kastelbell-Tschars,11,,25,12,37
018 Kastelbell-Tschars,12,,16,7,23
018 Kastelbell-Tschars,13,,10,11,21
018 Kastelbell-Tschars,14,,15,18,33
018 Kastelbell-Tschars,15,,15,10,25
018 Kastelbell-Tschars,16,,13,16,29
018 Kastelbell-Tschars,17,,14,14,28
018 Kastelbell-Tschars,18,,14,14,28
018 Kastelbell-Tschars,19,,17,13,30
018 Kastelbell-Tschars,20,,16,11,27
018 Kastelbell-Tschars,21,,17,10,27
018 Kastelbell-Tschars,22,,21,6,27
018 Kastelbell-Tschars,23,,18,17,35
018 Kastelbell-Tschars,24,,18,18,36
018 Kastelbell-Tschars,25,,21,21,42
018 Kastelbell-Tschars,26,,7,14,21
018 Kastelbell-Tschars,27,,16,18,34
018 Kastelbell-Tschars,28,,25,13,38
018 Kastelbell-Tschars,29,,14,16,30
018 Kastelbell-Tschars,30,,14,15,29
018 Kastelbell-Tschars,31,,14,14,28
018 Kastelbell-Tschars,32,,14,16,30
018 Kastelbell-Tschars,33,,11,18,29
018 Kastelbell-Tschars,34,,23,19,42
018 Kastelbell-Tschars,35,,19,12,31
018 Kastelbell-Tschars,36,,20,12,32
018 Kastelbell-Tschars,37,,14,25,39
018 Kastelbell-Tschars,38,,12,22,34
018 Kastelbell-Tschars,39,,16,15,31
018 Kastelbell-Tschars,40,,14,16,30
018 Kastelbell-Tschars,41,,24,27,51
018 Kastelbell-Tschars,42,,16,17,33
018 Kastelbell-Tschars,43,,14,20,34
018 Kastelbell-Tschars,44,,18,12,30
018 Kastelbell-Tschars,45,,19,12,31
018 Kastelbell-Tschars,46,,24,14,38
018 Kastelbell-Tschars,47,,25,21,46
018 Kastelbell-Tschars,48,,7,21,28
018 Kastelbell-Tschars,49,,20,18,38
018 Kastelbell-Tschars,50,,26,19,45
018 Kastelbell-Tschars,51,,22,19,41
018 Kastelbell-Tschars,52,,19,14,33
018 Kastelbell-Tschars,53,,16,11,27
018 Kastelbell-Tschars,54,,14,16,30
018 Kastelbell-Tschars,55,,23,17,40
018 Kastelbell-Tschars,56,,9,14,23
018 Kastelbell-Tschars,57,,9,16,25
018 Kastelbell-Tschars,58,,13,15,28
018 Kastelbell-Tschars,59,,16,13,29
018 Kastelbell-Tschars,60,,10,13,23
018 Kastelbell-Tschars,61,,16,10,26
018 Kastelbell-Tschars,62,,12,12,24
018 Kastelbell-Tschars,63,,9,8,17
018 Kastelbell-Tschars,64,,12,13,25
018 Kastelbell-Tschars,65,,10,4,14
018 Kastelbell-Tschars,66,,12,6,18
018 Kastelbell-Tschars,67,,7,7,14
018 Kastelbell-Tschars,68,,12,11,23
018 Kastelbell-Tschars,69,,9,8,17
018 Kastelbell-Tschars,70,,8,9,17
018 Kastelbell-Tschars,71,,12,12,24
018 Kastelbell-Tschars,72,,8,16,24
018 Kastelbell-Tschars,73,,11,11,22
018 Kastelbell-Tschars,74,,9,15,24
018 Kastelbell-Tschars,75,,10,9,19
018 Kastelbell-Tschars,76,,5,14,19
018 Kastelbell-Tschars,77,,16,12,28
018 Kastelbell-Tschars,78,,7,12,19
018 Kastelbell-Tschars,79,,8,13,21
018 Kastelbell-Tschars,80,,16,14,30
018 Kastelbell-Tschars,81,,9,10,19
018 Kastelbell-Tschars,82,,5,10,15
018 Kastelbell-Tschars,83,,4,6,10
018 Kastelbell-Tschars,84,,6,12,18
018 Kastelbell-Tschars,85,,9,8,17
018 Kastelbell-Tschars,86,,2,6,8
018 Kastelbell-Tschars,87,,2,7,9
018 Kastelbell-Tschars,88,,-,5,5
018 Kastelbell-Tschars,89,,1,3,4
018 Kastelbell-Tschars,90,,3,3,6
018 Kastelbell-Tschars,91,,-,1,1
018 Kastelbell-Tschars,92,,-,2,2
018 Kastelbell-Tschars,93,,-,2,2
018 Kastelbell-Tschars,99,,-,1,1
018 Kastelbell-Tschars,101,,1,-,1
019 Kastelruth,0,,40,33,73
019 Kastelruth,1,,27,37,64
019 Kastelruth,2,,53,36,89
019 Kastelruth,3,,42,40,82
019 Kastelruth,4,,45,34,79
019 Kastelruth,5,,47,37,84
019 Kastelruth,6,,44,38,82
019 Kastelruth,7,,43,40,83
019 Kastelruth,8,,39,33,72
019 Kastelruth,9,,41,33,74
019 Kastelruth,10,,35,28,63
019 Kastelruth,11,,34,41,75
019 Kastelruth,12,,51,43,94
019 Kastelruth,13,,47,46,93
019 Kastelruth,14,,43,38,81
019 Kastelruth,15,,51,40,91
019 Kastelruth,16,,34,32,66
019 Kastelruth,17,,38,36,74
019 Kastelruth,18,,37,55,92
019 Kastelruth,19,,36,39,75
019 Kastelruth,20,,39,40,79
019 Kastelruth,21,,45,39,84
019 Kastelruth,22,,27,25,52
019 Kastelruth,23,,36,39,75
019 Kastelruth,24,,36,25,61
019 Kastelruth,25,,30,35,65
019 Kastelruth,26,,28,32,60
019 Kastelruth,27,,38,36,74
019 Kastelruth,28,,46,42,88
019 Kastelruth,29,,40,42,82
019 Kastelruth,30,,44,35,79
019 Kastelruth,31,,37,39,76
019 Kastelruth,32,,28,40,68
019 Kastelruth,33,,31,38,69
019 Kastelruth,34,,41,66,107
019 Kastelruth,35,,49,43,92
019 Kastelruth,36,,62,44,106
019 Kastelruth,37,,43,63,106
019 Kastelruth,38,,65,43,108
019 Kastelruth,39,,55,42,97
019 Kastelruth,40,,54,52,106
019 Kastelruth,41,,60,45,105
019 Kastelruth,42,,59,58,117
019 Kastelruth,43,,68,53,121
019 Kastelruth,44,,74,49,123
019 Kastelruth,45,,48,73,121
019 Kastelruth,46,,53,39,92
019 Kastelruth,47,,52,35,87
019 Kastelruth,48,,35,52,87
019 Kastelruth,49,,56,41,97
019 Kastelruth,50,,49,45,94
019 Kastelruth,51,,45,46,91
019 Kastelruth,52,,49,42,91
019 Kastelruth,53,,39,41,80
019 Kastelruth,54,,36,30,66
019 Kastelruth,55,,39,37,76
019 Kastelruth,56,,34,31,65
019 Kastelruth,57,,29,29,58
019 Kastelruth,58,,35,26,61
019 Kastelruth,59,,29,24,53
019 Kastelruth,60,,44,26,70
019 Kastelruth,61,,20,36,56
019 Kastelruth,62,,28,41,69
019 Kastelruth,63,,34,31,65
019 Kastelruth,64,,23,38,61
019 Kastelruth,65,,23,21,44
019 Kastelruth,66,,20,45,65
019 Kastelruth,67,,39,39,78
019 Kastelruth,68,,33,28,61
019 Kastelruth,69,,30,45,75
019 Kastelruth,70,,28,34,62
019 Kastelruth,71,,26,28,54
019 Kastelruth,72,,26,25,51
019 Kastelruth,73,,26,23,49
019 Kastelruth,74,,28,18,46
019 Kastelruth,75,,24,27,51
019 Kastelruth,76,,18,22,40
019 Kastelruth,77,,31,27,58
019 Kastelruth,78,,16,35,51
019 Kastelruth,79,,35,21,56
019 Kastelruth,80,,10,25,35
019 Kastelruth,81,,18,24,42
019 Kastelruth,82,,8,13,21
019 Kastelruth,83,,13,25,38
019 Kastelruth,84,,10,15,25
019 Kastelruth,85,,10,14,24
019 Kastelruth,86,,8,17,25
019 Kastelruth,87,,5,15,20
019 Kastelruth,88,,7,10,17
019 Kastelruth,89,,4,9,13
019 Kastelruth,90,,2,8,10
019 Kastelruth,91,,4,4,8
019 Kastelruth,92,,1,1,2
019 Kastelruth,93,,1,2,3
019 Kastelruth,94,,-,2,2
019 Kastelruth,95,,1,4,5
019 Kastelruth,96,,-,1,1
019 Kastelruth,97,,-,1,1
019 Kastelruth,98,,-,2,2
019 Kastelruth,99,,-,2,2
020 Tscherms,0,,7,5,12
020 Tscherms,1,,6,6,12
020 Tscherms,2,,6,12,18
020 Tscherms,3,,6,11,17
020 Tscherms,4,,6,8,14
020 Tscherms,5,,2,9,11
020 Tscherms,6,,8,7,15
020 Tscherms,7,,9,7,16
020 Tscherms,8,,8,8,16
020 Tscherms,9,,5,9,14
020 Tscherms,10,,9,7,16
020 Tscherms,11,,8,8,16
020 Tscherms,12,,4,8,12
020 Tscherms,13,,8,8,16
020 Tscherms,14,,7,3,10
020 Tscherms,15,,15,10,25
020 Tscherms,16,,9,17,26
020 Tscherms,17,,7,11,18
020 Tscherms,18,,13,7,20
020 Tscherms,19,,6,7,13
020 Tscherms,20,,8,6,14
020 Tscherms,21,,6,6,12
020 Tscherms,22,,4,15,19
020 Tscherms,23,,7,9,16
020 Tscherms,24,,12,6,18
020 Tscherms,25,,13,13,26
020 Tscherms,26,,13,6,19
020 Tscherms,27,,10,13,23
020 Tscherms,28,,8,8,16
020 Tscherms,29,,7,11,18
020 Tscherms,30,,9,10,19
020 Tscherms,31,,6,7,13
020 Tscherms,32,,8,11,19
020 Tscherms,33,,11,5,16
020 Tscherms,34,,6,10,16
020 Tscherms,35,,10,8,18
020 Tscherms,36,,9,8,17
020 Tscherms,37,,11,15,26
020 Tscherms,38,,10,10,20
020 Tscherms,39,,10,11,21
020 Tscherms,40,,11,8,19
020 Tscherms,41,,12,15,27
020 Tscherms,42,,14,9,23
020 Tscherms,43,,11,13,24
020 Tscherms,44,,17,7,24
020 Tscherms,45,,17,16,33
020 Tscherms,46,,13,15,28
020 Tscherms,47,,15,15,30
020 Tscherms,48,,17,15,32
020 Tscherms,49,,12,11,23
020 Tscherms,50,,10,16,26
020 Tscherms,51,,8,18,26
020 Tscherms,52,,8,6,14
020 Tscherms,53,,8,9,17
020 Tscherms,54,,10,6,16
020 Tscherms,55,,9,7,16
020 Tscherms,56,,8,9,17
020 Tscherms,57,,9,10,19
020 Tscherms,58,,11,6,17
020 Tscherms,59,,5,9,14
020 Tscherms,60,,9,6,15
020 Tscherms,61,,3,3,6
020 Tscherms,62,,6,5,11
020 Tscherms,63,,7,8,15
020 Tscherms,64,,5,7,12
020 Tscherms,65,,4,6,10
020 Tscherms,66,,4,8,12
020 Tscherms,67,,5,3,8
020 Tscherms,68,,7,4,11
020 Tscherms,69,,10,8,18
020 Tscherms,70,,5,4,9
020 Tscherms,71,,5,5,10
020 Tscherms,72,,6,3,9
020 Tscherms,73,,6,8,14
020 Tscherms,74,,6,7,13
020 Tscherms,75,,3,4,7
020 Tscherms,76,,2,8,10
020 Tscherms,77,,4,3,7
020 Tscherms,78,,5,4,9
020 Tscherms,79,,2,3,5
020 Tscherms,80,,3,5,8
020 Tscherms,81,,2,2,4
020 Tscherms,82,,4,3,7
020 Tscherms,83,,3,3,6
020 Tscherms,84,,3,2,5
020 Tscherms,85,,2,5,7
020 Tscherms,86,,3,4,7
020 Tscherms,87,,1,3,4
020 Tscherms,88,,1,5,6
020 Tscherms,89,,-,2,2
020 Tscherms,90,,2,1,3
020 Tscherms,91,,-,1,1
020 Tscherms,92,,-,1,1
020 Tscherms,93,,-,1,1
020 Tscherms,95,,1,-,1
020 Tscherms,96,,-,1,1
020 Tscherms,98,,1,-,1
021 Kiens,0,,16,16,32
021 Kiens,1,,8,20,28
021 Kiens,2,,17,9,26
021 Kiens,3,,14,11,25
021 Kiens,4,,15,11,26
021 Kiens,5,,16,19,35
021 Kiens,6,,16,11,27
021 Kiens,7,,14,18,32
021 Kiens,8,,9,14,23
021 Kiens,9,,22,19,41
021 Kiens,10,,9,21,30
021 Kiens,11,,15,17,32
021 Kiens,12,,21,9,30
021 Kiens,13,,16,14,30
021 Kiens,14,,15,18,33
021 Kiens,15,,14,20,34
021 Kiens,16,,18,16,34
021 Kiens,17,,18,18,36
021 Kiens,18,,26,20,46
021 Kiens,19,,12,25,37
021 Kiens,20,,14,22,36
021 Kiens,21,,13,22,35
021 Kiens,22,,13,17,30
021 Kiens,23,,12,17,29
021 Kiens,24,,20,11,31
021 Kiens,25,,20,13,33
021 Kiens,26,,16,11,27
021 Kiens,27,,15,22,37
021 Kiens,28,,21,19,40
021 Kiens,29,,14,12,26
021 Kiens,30,,23,21,44
021 Kiens,31,,12,12,24
021 Kiens,32,,30,20,50
021 Kiens,33,,18,16,34
021 Kiens,34,,25,22,47
021 Kiens,35,,20,18,38
021 Kiens,36,,23,22,45
021 Kiens,37,,34,25,59
021 Kiens,38,,21,18,39
021 Kiens,39,,24,22,46
021 Kiens,40,,25,29,54
021 Kiens,41,,32,22,54
021 Kiens,42,,38,19,57
021 Kiens,43,,20,24,44
021 Kiens,44,,29,26,55
021 Kiens,45,,21,22,43
021 Kiens,46,,31,22,53
021 Kiens,47,,19,21,40
021 Kiens,48,,30,18,48
021 Kiens,49,,20,24,44
021 Kiens,50,,22,18,40
021 Kiens,51,,24,16,40
021 Kiens,52,,15,13,28
021 Kiens,53,,12,18,30
021 Kiens,54,,18,14,32
021 Kiens,55,,14,8,22
021 Kiens,56,,11,16,27
021 Kiens,57,,15,22,37
021 Kiens,58,,11,9,20
021 Kiens,59,,13,11,24
021 Kiens,60,,16,10,26
021 Kiens,61,,10,13,23
021 Kiens,62,,14,18,32
021 Kiens,63,,13,15,28
021 Kiens,64,,21,14,35
021 Kiens,65,,8,11,19
021 Kiens,66,,9,13,22
021 Kiens,67,,19,10,29
021 Kiens,68,,16,10,26
021 Kiens,69,,15,11,26
021 Kiens,70,,11,16,27
021 Kiens,71,,11,9,20
021 Kiens,72,,10,12,22
021 Kiens,73,,10,11,21
021 Kiens,74,,9,10,19
021 Kiens,75,,3,17,20
021 Kiens,76,,7,10,17
021 Kiens,77,,10,8,18
021 Kiens,78,,12,10,22
021 Kiens,79,,11,7,18
021 Kiens,80,,6,11,17
021 Kiens,81,,2,8,10
021 Kiens,82,,1,3,4
021 Kiens,83,,3,4,7
021 Kiens,84,,-,4,4
021 Kiens,85,,3,3,6
021 Kiens,86,,1,5,6
021 Kiens,87,,2,4,6
021 Kiens,88,,3,1,4
021 Kiens,89,,-,4,4
021 Kiens,90,,1,2,3
021 Kiens,92,,-,1,1
021 Kiens,93,,-,1,1
021 Kiens,95,,-,1,1
021 Kiens,96,,-,1,1
021 Kiens,97,,1,2,3
022 Klausen,0,,24,31,55
022 Klausen,1,,30,19,49
022 Klausen,2,,25,25,50
022 Klausen,3,,28,27,55
022 Klausen,4,,38,39,77
022 Klausen,5,,34,33,67
022 Klausen,6,,40,36,76
022 Klausen,7,,29,29,58
022 Klausen,8,,42,27,69
022 Klausen,9,,31,31,62
022 Klausen,10,,30,32,62
022 Klausen,11,,28,30,58
022 Klausen,12,,24,28,52
022 Klausen,13,,40,33,73
022 Klausen,14,,30,26,56
022 Klausen,15,,32,26,58
022 Klausen,16,,17,36,53
022 Klausen,17,,32,26,58
022 Klausen,18,,42,25,67
022 Klausen,19,,36,38,74
022 Klausen,20,,39,28,67
022 Klausen,21,,27,32,59
022 Klausen,22,,33,31,64
022 Klausen,23,,27,35,62
022 Klausen,24,,35,31,66
022 Klausen,25,,40,36,76
022 Klausen,26,,31,29,60
022 Klausen,27,,26,35,61
022 Klausen,28,,40,40,80
022 Klausen,29,,39,31,70
022 Klausen,30,,30,41,71
022 Klausen,31,,32,30,62
022 Klausen,32,,44,44,88
022 Klausen,33,,33,33,66
022 Klausen,34,,39,29,68
022 Klausen,35,,37,40,77
022 Klausen,36,,39,34,73
022 Klausen,37,,47,32,79
022 Klausen,38,,37,40,77
022 Klausen,39,,41,46,87
022 Klausen,40,,41,42,83
022 Klausen,41,,47,49,96
022 Klausen,42,,47,44,91
022 Klausen,43,,53,45,98
022 Klausen,44,,63,43,106
022 Klausen,45,,40,49,89
022 Klausen,46,,47,49,96
022 Klausen,47,,39,39,78
022 Klausen,48,,34,42,76
022 Klausen,49,,50,46,96
022 Klausen,50,,41,27,68
022 Klausen,51,,34,40,74
022 Klausen,52,,29,29,58
022 Klausen,53,,32,27,59
022 Klausen,54,,30,25,55
022 Klausen,55,,27,35,62
022 Klausen,56,,33,42,75
022 Klausen,57,,20,30,50
022 Klausen,58,,27,16,43
022 Klausen,59,,34,26,60
022 Klausen,60,,28,23,51
022 Klausen,61,,31,25,56
022 Klausen,62,,27,28,55
022 Klausen,63,,23,20,43
022 Klausen,64,,30,23,53
022 Klausen,65,,12,16,28
022 Klausen,66,,23,18,41
022 Klausen,67,,17,29,46
022 Klausen,68,,21,25,46
022 Klausen,69,,26,19,45
022 Klausen,70,,21,21,42
022 Klausen,71,,23,18,41
022 Klausen,72,,15,20,35
022 Klausen,73,,17,18,35
022 Klausen,74,,17,22,39
022 Klausen,75,,10,17,27
022 Klausen,76,,16,14,30
022 Klausen,77,,20,15,35
022 Klausen,78,,10,18,28
022 Klausen,79,,12,12,24
022 Klausen,80,,10,16,26
022 Klausen,81,,13,17,30
022 Klausen,82,,3,15,18
022 Klausen,83,,3,16,19
022 Klausen,84,,7,8,15
022 Klausen,85,,5,7,12
022 Klausen,86,,5,12,17
022 Klausen,87,,2,7,9
022 Klausen,88,,4,6,10
022 Klausen,89,,-,4,4
022 Klausen,90,,1,6,7
022 Klausen,91,,1,5,6
022 Klausen,92,,1,2,3
022 Klausen,93,,1,5,6
022 Klausen,94,,-,1,1
022 Klausen,96,,2,1,3
022 Klausen,97,,-,2,2
023 Karneid,0,,10,18,28
023 Karneid,1,,16,17,33
023 Karneid,2,,28,15,43
023 Karneid,3,,22,21,43
023 Karneid,4,,24,16,40
023 Karneid,5,,23,19,42
023 Karneid,6,,20,24,44
023 Karneid,7,,27,17,44
023 Karneid,8,,17,16,33
023 Karneid,9,,21,20,41
023 Karneid,10,,16,19,35
023 Karneid,11,,23,25,48
023 Karneid,12,,18,18,36
023 Karneid,13,,27,18,45
023 Karneid,14,,19,24,43
023 Karneid,15,,26,20,46
023 Karneid,16,,22,22,44
023 Karneid,17,,22,20,42
023 Karneid,18,,23,18,41
023 Karneid,19,,16,20,36
023 Karneid,20,,23,16,39
023 Karneid,21,,16,19,35
023 Karneid,22,,15,17,32
023 Karneid,23,,14,24,38
023 Karneid,24,,19,21,40
023 Karneid,25,,21,14,35
023 Karneid,26,,26,20,46
023 Karneid,27,,17,13,30
023 Karneid,28,,18,17,35
023 Karneid,29,,30,30,60
023 Karneid,30,,21,20,41
023 Karneid,31,,28,33,61
023 Karneid,32,,23,12,35
023 Karneid,33,,18,25,43
023 Karneid,34,,28,27,55
023 Karneid,35,,21,16,37
023 Karneid,36,,26,26,52
023 Karneid,37,,29,31,60
023 Karneid,38,,30,24,54
023 Karneid,39,,32,37,69
023 Karneid,40,,36,22,58
023 Karneid,41,,25,27,52
023 Karneid,42,,38,32,70
023 Karneid,43,,32,30,62
023 Karneid,44,,35,34,69
023 Karneid,45,,31,25,56
023 Karneid,46,,34,25,59
023 Karneid,47,,38,22,60
023 Karneid,48,,27,38,65
023 Karneid,49,,27,22,49
023 Karneid,50,,31,26,57
023 Karneid,51,,27,18,45
023 Karneid,52,,24,19,43
023 Karneid,53,,16,13,29
023 Karneid,54,,20,18,38
023 Karneid,55,,16,11,27
023 Karneid,56,,13,13,26
023 Karneid,57,,18,14,32
023 Karneid,58,,12,21,33
023 Karneid,59,,17,11,28
023 Karneid,60,,23,14,37
023 Karneid,61,,10,15,25
023 Karneid,62,,15,26,41
023 Karneid,63,,9,15,24
023 Karneid,64,,12,22,34
023 Karneid,65,,12,15,27
023 Karneid,66,,11,14,25
023 Karneid,67,,19,15,34
023 Karneid,68,,16,25,41
023 Karneid,69,,17,14,31
023 Karneid,70,,13,14,27
023 Karneid,71,,17,14,31
023 Karneid,72,,18,13,31
023 Karneid,73,,8,8,16
023 Karneid,74,,13,11,24
023 Karneid,75,,9,9,18
023 Karneid,76,,9,15,24
023 Karneid,77,,6,14,20
023 Karneid,78,,12,4,16
023 Karneid,79,,14,11,25
023 Karneid,80,,6,8,14
023 Karneid,81,,8,8,16
023 Karneid,82,,6,7,13
023 Karneid,83,,2,7,9
023 Karneid,84,,5,6,11
023 Karneid,85,,1,5,6
023 Karneid,86,,3,5,8
023 Karneid,87,,1,1,2
023 Karneid,88,,-,4,4
023 Karneid,89,,-,5,5
023 Karneid,90,,1,4,5
023 Karneid,91,,2,1,3
023 Karneid,92,,-,1,1
023 Karneid,98,,-,2,2
024 Kurtatsch a.d.Weinstr.,0,,6,10,16
024 Kurtatsch a.d.Weinstr.,1,,11,12,23
024 Kurtatsch a.d.Weinstr.,2,,15,7,22
024 Kurtatsch a.d.Weinstr.,3,,7,5,12
024 Kurtatsch a.d.Weinstr.,4,,9,16,25
024 Kurtatsch a.d.Weinstr.,5,,12,15,27
024 Kurtatsch a.d.Weinstr.,6,,11,11,22
024 Kurtatsch a.d.Weinstr.,7,,11,12,23
024 Kurtatsch a.d.Weinstr.,8,,11,17,28
024 Kurtatsch a.d.Weinstr.,9,,19,13,32
024 Kurtatsch a.d.Weinstr.,10,,18,14,32
024 Kurtatsch a.d.Weinstr.,11,,18,13,31
024 Kurtatsch a.d.Weinstr.,12,,17,15,32
024 Kurtatsch a.d.Weinstr.,13,,13,15,28
024 Kurtatsch a.d.Weinstr.,14,,24,19,43
024 Kurtatsch a.d.Weinstr.,15,,19,11,30
024 Kurtatsch a.d.Weinstr.,16,,14,6,20
024 Kurtatsch a.d.Weinstr.,17,,23,18,41
024 Kurtatsch a.d.Weinstr.,18,,20,11,31
024 Kurtatsch a.d.Weinstr.,19,,17,17,34
024 Kurtatsch a.d.Weinstr.,20,,12,8,20
024 Kurtatsch a.d.Weinstr.,21,,10,16,26
024 Kurtatsch a.d.Weinstr.,22,,7,15,22
024 Kurtatsch a.d.Weinstr.,23,,11,12,23
024 Kurtatsch a.d.Weinstr.,24,,9,14,23
024 Kurtatsch a.d.Weinstr.,25,,13,12,25
024 Kurtatsch a.d.Weinstr.,26,,13,10,23
024 Kurtatsch a.d.Weinstr.,27,,17,9,26
024 Kurtatsch a.d.Weinstr.,28,,10,22,32
024 Kurtatsch a.d.Weinstr.,29,,13,12,25
024 Kurtatsch a.d.Weinstr.,30,,11,13,24
024 Kurtatsch a.d.Weinstr.,31,,9,14,23
024 Kurtatsch a.d.Weinstr.,32,,10,12,22
024 Kurtatsch a.d.Weinstr.,33,,9,17,26
024 Kurtatsch a.d.Weinstr.,34,,13,13,26
024 Kurtatsch a.d.Weinstr.,35,,11,13,24
024 Kurtatsch a.d.Weinstr.,36,,17,20,37
024 Kurtatsch a.d.Weinstr.,37,,17,19,36
024 Kurtatsch a.d.Weinstr.,38,,13,16,29
024 Kurtatsch a.d.Weinstr.,39,,18,20,38
024 Kurtatsch a.d.Weinstr.,40,,15,24,39
024 Kurtatsch a.d.Weinstr.,41,,26,25,51
024 Kurtatsch a.d.Weinstr.,42,,28,14,42
024 Kurtatsch a.d.Weinstr.,43,,20,19,39
024 Kurtatsch a.d.Weinstr.,44,,29,16,45
024 Kurtatsch a.d.Weinstr.,45,,25,26,51
024 Kurtatsch a.d.Weinstr.,46,,16,26,42
024 Kurtatsch a.d.Weinstr.,47,,21,20,41
024 Kurtatsch a.d.Weinstr.,48,,24,12,36
024 Kurtatsch a.d.Weinstr.,49,,19,15,34
024 Kurtatsch a.d.Weinstr.,50,,18,22,40
024 Kurtatsch a.d.Weinstr.,51,,19,10,29
024 Kurtatsch a.d.Weinstr.,52,,14,15,29
024 Kurtatsch a.d.Weinstr.,53,,12,11,23
024 Kurtatsch a.d.Weinstr.,54,,11,8,19
024 Kurtatsch a.d.Weinstr.,55,,14,20,34
024 Kurtatsch a.d.Weinstr.,56,,14,8,22
024 Kurtatsch a.d.Weinstr.,57,,17,20,37
024 Kurtatsch a.d.Weinstr.,58,,11,8,19
024 Kurtatsch a.d.Weinstr.,59,,8,15,23
024 Kurtatsch a.d.Weinstr.,60,,14,4,18
024 Kurtatsch a.d.Weinstr.,61,,11,9,20
024 Kurtatsch a.d.Weinstr.,62,,10,9,19
024 Kurtatsch a.d.Weinstr.,63,,11,8,19
024 Kurtatsch a.d.Weinstr.,64,,12,8,20
024 Kurtatsch a.d.Weinstr.,65,,7,8,15
024 Kurtatsch a.d.Weinstr.,66,,5,8,13
024 Kurtatsch a.d.Weinstr.,67,,10,6,16
024 Kurtatsch a.d.Weinstr.,68,,10,12,22
024 Kurtatsch a.d.Weinstr.,69,,8,12,20
024 Kurtatsch a.d.Weinstr.,70,,11,11,22
024 Kurtatsch a.d.Weinstr.,71,,3,16,19
024 Kurtatsch a.d.Weinstr.,72,,11,12,23
024 Kurtatsch a.d.Weinstr.,73,,4,9,13
024 Kurtatsch a.d.Weinstr.,74,,8,8,16
024 Kurtatsch a.d.Weinstr.,75,,3,7,10
024 Kurtatsch a.d.Weinstr.,76,,4,9,13
024 Kurtatsch a.d.Weinstr.,77,,7,7,14
024 Kurtatsch a.d.Weinstr.,78,,10,14,24
024 Kurtatsch a.d.Weinstr.,79,,6,9,15
024 Kurtatsch a.d.Weinstr.,80,,7,15,22
024 Kurtatsch a.d.Weinstr.,81,,6,6,12
024 Kurtatsch a.d.Weinstr.,82,,7,9,16
024 Kurtatsch a.d.Weinstr.,83,,7,4,11
024 Kurtatsch a.d.Weinstr.,84,,2,3,5
024 Kurtatsch a.d.Weinstr.,85,,4,7,11
024 Kurtatsch a.d.Weinstr.,86,,2,6,8
024 Kurtatsch a.d.Weinstr.,87,,4,14,18
024 Kurtatsch a.d.Weinstr.,88,,-,2,2
024 Kurtatsch a.d.Weinstr.,89,,-,6,6
024 Kurtatsch a.d.Weinstr.,90,,3,4,7
024 Kurtatsch a.d.Weinstr.,91,,-,1,1
024 Kurtatsch a.d.Weinstr.,93,,-,1,1
024 Kurtatsch a.d.Weinstr.,95,,1,-,1
024 Kurtatsch a.d.Weinstr.,98,,2,-,2
024 Kurtatsch a.d.Weinstr.,99,,-,2,2
025 Kurtinig a.d. Weinstr.,0,,5,5,10
025 Kurtinig a.d. Weinstr.,1,,5,3,8
025 Kurtinig a.d. Weinstr.,2,,4,-,4
025 Kurtinig a.d. Weinstr.,3,,5,3,8
025 Kurtinig a.d. Weinstr.,4,,3,1,4
025 Kurtinig a.d. Weinstr.,5,,-,4,4
025 Kurtinig a.d. Weinstr.,6,,1,2,3
025 Kurtinig a.d. Weinstr.,7,,5,2,7
025 Kurtinig a.d. Weinstr.,8,,3,4,7
025 Kurtinig a.d. Weinstr.,9,,1,8,9
025 Kurtinig a.d. Weinstr.,10,,3,5,8
025 Kurtinig a.d. Weinstr.,11,,3,2,5
025 Kurtinig a.d. Weinstr.,12,,3,5,8
025 Kurtinig a.d. Weinstr.,13,,3,5,8
025 Kurtinig a.d. Weinstr.,14,,1,2,3
025 Kurtinig a.d. Weinstr.,15,,6,2,8
025 Kurtinig a.d. Weinstr.,16,,3,2,5
025 Kurtinig a.d. Weinstr.,17,,4,4,8
025 Kurtinig a.d. Weinstr.,18,,2,3,5
025 Kurtinig a.d. Weinstr.,19,,6,1,7
025 Kurtinig a.d. Weinstr.,20,,3,2,5
025 Kurtinig a.d. Weinstr.,21,,6,4,10
025 Kurtinig a.d. Weinstr.,22,,6,4,10
025 Kurtinig a.d. Weinstr.,23,,6,6,12
025 Kurtinig a.d. Weinstr.,24,,4,4,8
025 Kurtinig a.d. Weinstr.,25,,3,5,8
025 Kurtinig a.d. Weinstr.,26,,3,6,9
025 Kurtinig a.d. Weinstr.,27,,6,3,9
025 Kurtinig a.d. Weinstr.,28,,6,5,11
025 Kurtinig a.d. Weinstr.,29,,5,6,11
025 Kurtinig a.d. Weinstr.,30,,8,3,11
025 Kurtinig a.d. Weinstr.,31,,5,5,10
025 Kurtinig a.d. Weinstr.,32,,3,3,6
025 Kurtinig a.d. Weinstr.,33,,2,3,5
025 Kurtinig a.d. Weinstr.,34,,1,-,1
025 Kurtinig a.d. Weinstr.,35,,2,7,9
025 Kurtinig a.d. Weinstr.,36,,4,4,8
025 Kurtinig a.d. Weinstr.,37,,8,5,13
025 Kurtinig a.d. Weinstr.,38,,4,6,10
025 Kurtinig a.d. Weinstr.,39,,3,3,6
025 Kurtinig a.d. Weinstr.,40,,6,3,9
025 Kurtinig a.d. Weinstr.,41,,6,5,11
025 Kurtinig a.d. Weinstr.,42,,4,2,6
025 Kurtinig a.d. Weinstr.,43,,6,5,11
025 Kurtinig a.d. Weinstr.,44,,2,5,7
025 Kurtinig a.d. Weinstr.,45,,4,4,8
025 Kurtinig a.d. Weinstr.,46,,6,5,11
025 Kurtinig a.d. Weinstr.,47,,9,5,14
025 Kurtinig a.d. Weinstr.,48,,4,4,8
025 Kurtinig a.d. Weinstr.,49,,7,10,17
025 Kurtinig a.d. Weinstr.,50,,6,4,10
025 Kurtinig a.d. Weinstr.,51,,10,6,16
025 Kurtinig a.d. Weinstr.,52,,3,8,11
025 Kurtinig a.d. Weinstr.,53,,7,9,16
025 Kurtinig a.d. Weinstr.,54,,5,1,6
025 Kurtinig a.d. Weinstr.,55,,3,1,4
025 Kurtinig a.d. Weinstr.,56,,7,3,10
025 Kurtinig a.d. Weinstr.,57,,4,6,10
025 Kurtinig a.d. Weinstr.,58,,3,4,7
025 Kurtinig a.d. Weinstr.,59,,2,4,6
025 Kurtinig a.d. Weinstr.,60,,1,3,4
025 Kurtinig a.d. Weinstr.,61,,3,4,7
025 Kurtinig a.d. Weinstr.,62,,5,4,9
025 Kurtinig a.d. Weinstr.,63,,5,2,7
025 Kurtinig a.d. Weinstr.,64,,-,5,5
025 Kurtinig a.d. Weinstr.,65,,3,3,6
025 Kurtinig a.d. Weinstr.,66,,3,2,5
025 Kurtinig a.d. Weinstr.,67,,4,2,6
025 Kurtinig a.d. Weinstr.,68,,2,2,4
025 Kurtinig a.d. Weinstr.,69,,4,2,6
025 Kurtinig a.d. Weinstr.,70,,2,2,4
025 Kurtinig a.d. Weinstr.,71,,5,3,8
025 Kurtinig a.d. Weinstr.,72,,2,2,4
025 Kurtinig a.d. Weinstr.,73,,2,3,5
025 Kurtinig a.d. Weinstr.,74,,4,3,7
025 Kurtinig a.d. Weinstr.,75,,-,6,6
025 Kurtinig a.d. Weinstr.,76,,2,4,6
025 Kurtinig a.d. Weinstr.,77,,1,2,3
025 Kurtinig a.d. Weinstr.,78,,3,3,6
025 Kurtinig a.d. Weinstr.,79,,2,2,4
025 Kurtinig a.d. Weinstr.,80,,4,3,7
025 Kurtinig a.d. Weinstr.,81,,1,3,4
025 Kurtinig a.d. Weinstr.,82,,2,3,5
025 Kurtinig a.d. Weinstr.,83,,2,2,4
025 Kurtinig a.d. Weinstr.,84,,2,1,3
025 Kurtinig a.d. Weinstr.,85,,-,5,5
025 Kurtinig a.d. Weinstr.,86,,-,3,3
025 Kurtinig a.d. Weinstr.,87,,-,1,1
025 Kurtinig a.d. Weinstr.,89,,1,1,2
025 Kurtinig a.d. Weinstr.,91,,-,1,1
025 Kurtinig a.d. Weinstr.,92,,-,1,1
025 Kurtinig a.d. Weinstr.,95,,-,1,1
025 Kurtinig a.d. Weinstr.,96,,-,2,2
026 Corvara,0,,13,7,20
026 Corvara,1,,9,6,15
026 Corvara,2,,7,8,15
026 Corvara,3,,4,8,12
026 Corvara,4,,7,3,10
026 Corvara,5,,7,5,12
026 Corvara,6,,7,3,10
026 Corvara,7,,12,5,17
026 Corvara,8,,4,4,8
026 Corvara,9,,5,7,12
026 Corvara,10,,7,4,11
026 Corvara,11,,8,7,15
026 Corvara,12,,10,10,20
026 Corvara,13,,3,5,8
026 Corvara,14,,10,4,14
026 Corvara,15,,7,7,14
026 Corvara,16,,8,5,13
026 Corvara,17,,5,3,8
026 Corvara,18,,6,10,16
026 Corvara,19,,3,5,8
026 Corvara,20,,9,8,17
026 Corvara,21,,5,5,10
026 Corvara,22,,5,4,9
026 Corvara,23,,9,7,16
026 Corvara,24,,4,-,4
026 Corvara,25,,6,7,13
026 Corvara,26,,6,4,10
026 Corvara,27,,8,9,17
026 Corvara,28,,8,12,20
026 Corvara,29,,14,5,19
026 Corvara,30,,12,9,21
026 Corvara,31,,10,10,20
026 Corvara,32,,11,3,14
026 Corvara,33,,17,11,28
026 Corvara,34,,10,6,16
026 Corvara,35,,9,23,32
026 Corvara,36,,8,14,22
026 Corvara,37,,11,10,21
026 Corvara,38,,9,7,16
026 Corvara,39,,9,5,14
026 Corvara,40,,11,15,26
026 Corvara,41,,16,13,29
026 Corvara,42,,8,16,24
026 Corvara,43,,15,21,36
026 Corvara,44,,12,19,31
026 Corvara,45,,16,17,33
026 Corvara,46,,9,8,17
026 Corvara,47,,15,11,26
026 Corvara,48,,12,11,23
026 Corvara,49,,8,8,16
026 Corvara,50,,16,14,30
026 Corvara,51,,8,7,15
026 Corvara,52,,11,7,18
026 Corvara,53,,8,4,12
026 Corvara,54,,4,7,11
026 Corvara,55,,11,7,18
026 Corvara,56,,10,9,19
026 Corvara,57,,6,12,18
026 Corvara,58,,5,8,13
026 Corvara,59,,5,8,13
026 Corvara,60,,7,8,15
026 Corvara,61,,3,9,12
026 Corvara,62,,4,5,9
026 Corvara,63,,4,10,14
026 Corvara,64,,12,11,23
026 Corvara,65,,5,5,10
026 Corvara,66,,6,8,14
026 Corvara,67,,5,10,15
026 Corvara,68,,6,8,14
026 Corvara,69,,10,11,21
026 Corvara,70,,8,6,14
026 Corvara,71,,5,5,10
026 Corvara,72,,3,7,10
026 Corvara,73,,6,9,15
026 Corvara,74,,4,6,10
026 Corvara,75,,6,4,10
026 Corvara,76,,5,9,14
026 Corvara,77,,3,4,7
026 Corvara,78,,4,4,8
026 Corvara,79,,6,9,15
026 Corvara,80,,3,3,6
026 Corvara,81,,4,4,8
026 Corvara,82,,1,2,3
026 Corvara,83,,5,2,7
026 Corvara,84,,2,1,3
026 Corvara,85,,1,2,3
026 Corvara,86,,2,-,2
026 Corvara,87,,4,1,5
026 Corvara,88,,1,2,3
026 Corvara,89,,2,1,3
026 Corvara,90,,1,-,1
026 Corvara,91,,1,2,3
026 Corvara,92,,-,1,1
026 Corvara,93,,-,1,1
026 Corvara,96,,-,1,1
027 Graun im Vinschgau,0,,11,13,24
027 Graun im Vinschgau,1,,17,21,38
027 Graun im Vinschgau,2,,15,8,23
027 Graun im Vinschgau,3,,20,14,34
027 Graun im Vinschgau,4,,14,20,34
027 Graun im Vinschgau,5,,13,14,27
027 Graun im Vinschgau,6,,11,15,26
027 Graun im Vinschgau,7,,9,12,21
027 Graun im Vinschgau,8,,11,13,24
027 Graun im Vinschgau,9,,17,12,29
027 Graun im Vinschgau,10,,17,16,33
027 Graun im Vinschgau,11,,15,10,25
027 Graun im Vinschgau,12,,10,14,24
027 Graun im Vinschgau,13,,19,17,36
027 Graun im Vinschgau,14,,22,18,40
027 Graun im Vinschgau,15,,19,16,35
027 Graun im Vinschgau,16,,18,12,30
027 Graun im Vinschgau,17,,20,14,34
027 Graun im Vinschgau,18,,18,14,32
027 Graun im Vinschgau,19,,9,12,21
027 Graun im Vinschgau,20,,19,19,38
027 Graun im Vinschgau,21,,26,17,43
027 Graun im Vinschgau,22,,21,11,32
027 Graun im Vinschgau,23,,16,11,27
027 Graun im Vinschgau,24,,7,6,13
027 Graun im Vinschgau,25,,18,9,27
027 Graun im Vinschgau,26,,17,14,31
027 Graun im Vinschgau,27,,7,18,25
027 Graun im Vinschgau,28,,18,13,31
027 Graun im Vinschgau,29,,22,20,42
027 Graun im Vinschgau,30,,19,18,37
027 Graun im Vinschgau,31,,14,21,35
027 Graun im Vinschgau,32,,14,17,31
027 Graun im Vinschgau,33,,14,18,32
027 Graun im Vinschgau,34,,14,19,33
027 Graun im Vinschgau,35,,23,16,39
027 Graun im Vinschgau,36,,19,13,32
027 Graun im Vinschgau,37,,19,20,39
027 Graun im Vinschgau,38,,22,16,38
027 Graun im Vinschgau,39,,20,12,32
027 Graun im Vinschgau,40,,21,16,37
027 Graun im Vinschgau,41,,25,19,44
027 Graun im Vinschgau,42,,15,21,36
027 Graun im Vinschgau,43,,23,22,45
027 Graun im Vinschgau,44,,18,24,42
027 Graun im Vinschgau,45,,18,19,37
027 Graun im Vinschgau,46,,21,21,42
027 Graun im Vinschgau,47,,23,18,41
027 Graun im Vinschgau,48,,22,24,46
027 Graun im Vinschgau,49,,20,12,32
027 Graun im Vinschgau,50,,22,19,41
027 Graun im Vinschgau,51,,21,12,33
027 Graun im Vinschgau,52,,18,17,35
027 Graun im Vinschgau,53,,12,13,25
027 Graun im Vinschgau,54,,14,10,24
027 Graun im Vinschgau,55,,13,9,22
027 Graun im Vinschgau,56,,16,14,30
027 Graun im Vinschgau,57,,14,6,20
027 Graun im Vinschgau,58,,17,11,28
027 Graun im Vinschgau,59,,11,16,27
027 Graun im Vinschgau,60,,11,12,23
027 Graun im Vinschgau,61,,7,20,27
027 Graun im Vinschgau,62,,14,12,26
027 Graun im Vinschgau,63,,5,9,14
027 Graun im Vinschgau,64,,10,8,18
027 Graun im Vinschgau,65,,7,8,15
027 Graun im Vinschgau,66,,10,9,19
027 Graun im Vinschgau,67,,9,11,20
027 Graun im Vinschgau,68,,9,12,21
027 Graun im Vinschgau,69,,15,10,25
027 Graun im Vinschgau,70,,11,10,21
027 Graun im Vinschgau,71,,10,11,21
027 Graun im Vinschgau,72,,8,11,19
027 Graun im Vinschgau,73,,11,3,14
027 Graun im Vinschgau,74,,14,14,28
027 Graun im Vinschgau,75,,7,7,14
027 Graun im Vinschgau,76,,11,9,20
027 Graun im Vinschgau,77,,7,7,14
027 Graun im Vinschgau,78,,9,6,15
027 Graun im Vinschgau,79,,9,10,19
027 Graun im Vinschgau,80,,3,5,8
027 Graun im Vinschgau,81,,8,12,20
027 Graun im Vinschgau,82,,6,9,15
027 Graun im Vinschgau,83,,5,7,12
027 Graun im Vinschgau,84,,5,11,16
027 Graun im Vinschgau,85,,1,3,4
027 Graun im Vinschgau,86,,4,6,10
027 Graun im Vinschgau,87,,4,9,13
027 Graun im Vinschgau,88,,3,4,7
027 Graun im Vinschgau,89,,2,6,8
027 Graun im Vinschgau,90,,1,1,2
027 Graun im Vinschgau,91,,-,3,3
027 Graun im Vinschgau,92,,-,1,1
027 Graun im Vinschgau,96,,-,1,1
028 Toblach,0,,22,23,45
028 Toblach,1,,14,19,33
028 Toblach,2,,23,21,44
028 Toblach,3,,23,14,37
028 Toblach,4,,20,10,30
028 Toblach,5,,13,18,31
028 Toblach,6,,18,22,40
028 Toblach,7,,19,27,46
028 Toblach,8,,14,18,32
028 Toblach,9,,26,17,43
028 Toblach,10,,21,17,38
028 Toblach,11,,16,22,38
028 Toblach,12,,18,13,31
028 Toblach,13,,23,16,39
028 Toblach,14,,27,20,47
028 Toblach,15,,17,9,26
028 Toblach,16,,21,18,39
028 Toblach,17,,19,21,40
028 Toblach,18,,15,17,32
028 Toblach,19,,17,28,45
028 Toblach,20,,15,24,39
028 Toblach,21,,9,15,24
028 Toblach,22,,15,22,37
028 Toblach,23,,32,16,48
028 Toblach,24,,15,21,36
028 Toblach,25,,25,21,46
028 Toblach,26,,21,27,48
028 Toblach,27,,17,18,35
028 Toblach,28,,27,24,51
028 Toblach,29,,24,23,47
028 Toblach,30,,20,22,42
028 Toblach,31,,27,24,51
028 Toblach,32,,17,18,35
028 Toblach,33,,15,21,36
028 Toblach,34,,23,32,55
028 Toblach,35,,20,22,42
028 Toblach,36,,26,20,46
028 Toblach,37,,30,25,55
028 Toblach,38,,25,31,56
028 Toblach,39,,28,23,51
028 Toblach,40,,19,26,45
028 Toblach,41,,41,24,65
028 Toblach,42,,32,27,59
028 Toblach,43,,26,18,44
028 Toblach,44,,29,28,57
028 Toblach,45,,32,27,59
028 Toblach,46,,35,29,64
028 Toblach,47,,29,27,56
028 Toblach,48,,37,29,66
028 Toblach,49,,21,32,53
028 Toblach,50,,21,16,37
028 Toblach,51,,35,26,61
028 Toblach,52,,21,15,36
028 Toblach,53,,28,22,50
028 Toblach,54,,17,23,40
028 Toblach,55,,16,27,43
028 Toblach,56,,20,18,38
028 Toblach,57,,20,24,44
028 Toblach,58,,20,16,36
028 Toblach,59,,24,13,37
028 Toblach,60,,14,15,29
028 Toblach,61,,22,15,37
028 Toblach,62,,15,24,39
028 Toblach,63,,17,16,33
028 Toblach,64,,13,14,27
028 Toblach,65,,9,18,27
028 Toblach,66,,16,10,26
028 Toblach,67,,13,18,31
028 Toblach,68,,14,19,33
028 Toblach,69,,18,12,30
028 Toblach,70,,12,13,25
028 Toblach,71,,13,12,25
028 Toblach,72,,14,7,21
028 Toblach,73,,4,10,14
028 Toblach,74,,7,14,21
028 Toblach,75,,6,15,21
028 Toblach,76,,14,15,29
028 Toblach,77,,8,9,17
028 Toblach,78,,10,14,24
028 Toblach,79,,11,10,21
028 Toblach,80,,7,9,16
028 Toblach,81,,7,10,17
028 Toblach,82,,10,8,18
028 Toblach,83,,7,9,16
028 Toblach,84,,6,11,17
028 Toblach,85,,5,5,10
028 Toblach,86,,5,7,12
028 Toblach,87,,5,3,8
028 Toblach,88,,2,6,8
028 Toblach,89,,1,3,4
028 Toblach,90,,2,1,3
028 Toblach,91,,2,4,6
028 Toblach,92,,1,-,1
028 Toblach,93,,1,1,2
028 Toblach,95,,-,2,2
028 Toblach,97,,-,1,1
028 Toblach,103,,1,-,1
029 Neumarkt,0,,26,27,53
029 Neumarkt,1,,33,23,56
029 Neumarkt,2,,25,25,50
029 Neumarkt,3,,33,23,56
029 Neumarkt,4,,25,33,58
029 Neumarkt,5,,37,34,71
029 Neumarkt,6,,24,18,42
029 Neumarkt,7,,36,30,66
029 Neumarkt,8,,29,21,50
029 Neumarkt,9,,34,33,67
029 Neumarkt,10,,32,22,54
029 Neumarkt,11,,26,29,55
029 Neumarkt,12,,21,44,65
029 Neumarkt,13,,21,19,40
029 Neumarkt,14,,20,26,46
029 Neumarkt,15,,27,27,54
029 Neumarkt,16,,24,22,46
029 Neumarkt,17,,24,38,62
029 Neumarkt,18,,28,28,56
029 Neumarkt,19,,26,25,51
029 Neumarkt,20,,26,27,53
029 Neumarkt,21,,26,33,59
029 Neumarkt,22,,22,28,50
029 Neumarkt,23,,25,28,53
029 Neumarkt,24,,28,23,51
029 Neumarkt,25,,26,22,48
029 Neumarkt,26,,22,25,47
029 Neumarkt,27,,20,28,48
029 Neumarkt,28,,27,31,58
029 Neumarkt,29,,29,28,57
029 Neumarkt,30,,32,47,79
029 Neumarkt,31,,35,30,65
029 Neumarkt,32,,40,42,82
029 Neumarkt,33,,26,27,53
029 Neumarkt,34,,29,33,62
029 Neumarkt,35,,41,42,83
029 Neumarkt,36,,36,43,79
029 Neumarkt,37,,31,35,66
029 Neumarkt,38,,38,33,71
029 Neumarkt,39,,34,49,83
029 Neumarkt,40,,40,38,78
029 Neumarkt,41,,42,37,79
029 Neumarkt,42,,29,51,80
029 Neumarkt,43,,47,48,95
029 Neumarkt,44,,51,50,101
029 Neumarkt,45,,54,42,96
029 Neumarkt,46,,50,49,99
029 Neumarkt,47,,53,50,103
029 Neumarkt,48,,50,38,88
029 Neumarkt,49,,39,43,82
029 Neumarkt,50,,50,42,92
029 Neumarkt,51,,43,31,74
029 Neumarkt,52,,31,35,66
029 Neumarkt,53,,40,29,69
029 Neumarkt,54,,29,29,58
029 Neumarkt,55,,44,41,85
029 Neumarkt,56,,33,27,60
029 Neumarkt,57,,19,16,35
029 Neumarkt,58,,29,22,51
029 Neumarkt,59,,24,26,50
029 Neumarkt,60,,22,24,46
029 Neumarkt,61,,14,25,39
029 Neumarkt,62,,18,22,40
029 Neumarkt,63,,26,30,56
029 Neumarkt,64,,31,34,65
029 Neumarkt,65,,22,22,44
029 Neumarkt,66,,20,18,38
029 Neumarkt,67,,19,23,42
029 Neumarkt,68,,25,23,48
029 Neumarkt,69,,36,26,62
029 Neumarkt,70,,24,30,54
029 Neumarkt,71,,18,28,46
029 Neumarkt,72,,21,15,36
029 Neumarkt,73,,20,13,33
029 Neumarkt,74,,16,18,34
029 Neumarkt,75,,15,23,38
029 Neumarkt,76,,15,20,35
029 Neumarkt,77,,17,16,33
029 Neumarkt,78,,14,21,35
029 Neumarkt,79,,19,29,48
029 Neumarkt,80,,12,23,35
029 Neumarkt,81,,12,16,28
029 Neumarkt,82,,2,15,17
029 Neumarkt,83,,11,15,26
029 Neumarkt,84,,10,16,26
029 Neumarkt,85,,9,14,23
029 Neumarkt,86,,4,15,19
029 Neumarkt,87,,10,15,25
029 Neumarkt,88,,3,7,10
029 Neumarkt,89,,3,14,17
029 Neumarkt,90,,1,10,11
029 Neumarkt,91,,2,3,5
029 Neumarkt,92,,-,1,1
029 Neumarkt,93,,-,3,3
029 Neumarkt,95,,-,1,1
029 Neumarkt,96,,1,2,3
029 Neumarkt,98,,-,1,1
030 Pfalzen,0,,18,15,33
030 Pfalzen,1,,16,18,34
030 Pfalzen,2,,16,20,36
030 Pfalzen,3,,12,10,22
030 Pfalzen,4,,20,17,37
030 Pfalzen,5,,21,15,36
030 Pfalzen,6,,14,21,35
030 Pfalzen,7,,23,13,36
030 Pfalzen,8,,14,17,31
030 Pfalzen,9,,17,15,32
030 Pfalzen,10,,16,17,33
030 Pfalzen,11,,19,20,39
030 Pfalzen,12,,17,16,33
030 Pfalzen,13,,14,18,32
030 Pfalzen,14,,15,13,28
030 Pfalzen,15,,23,18,41
030 Pfalzen,16,,14,18,32
030 Pfalzen,17,,12,21,33
030 Pfalzen,18,,14,22,36
030 Pfalzen,19,,15,18,33
030 Pfalzen,20,,18,13,31
030 Pfalzen,21,,17,22,39
030 Pfalzen,22,,13,10,23
030 Pfalzen,23,,13,22,35
030 Pfalzen,24,,18,18,36
030 Pfalzen,25,,24,17,41
030 Pfalzen,26,,17,12,29
030 Pfalzen,27,,12,13,25
030 Pfalzen,28,,20,20,40
030 Pfalzen,29,,18,20,38
030 Pfalzen,30,,20,21,41
030 Pfalzen,31,,18,19,37
030 Pfalzen,32,,19,20,39
030 Pfalzen,33,,21,24,45
030 Pfalzen,34,,18,13,31
030 Pfalzen,35,,15,16,31
030 Pfalzen,36,,24,15,39
030 Pfalzen,37,,18,26,44
030 Pfalzen,38,,22,25,47
030 Pfalzen,39,,31,27,58
030 Pfalzen,40,,22,23,45
030 Pfalzen,41,,28,14,42
030 Pfalzen,42,,23,35,58
030 Pfalzen,43,,20,23,43
030 Pfalzen,44,,25,20,45
030 Pfalzen,45,,22,28,50
030 Pfalzen,46,,20,23,43
030 Pfalzen,47,,30,20,50
030 Pfalzen,48,,21,31,52
030 Pfalzen,49,,25,20,45
030 Pfalzen,50,,23,15,38
030 Pfalzen,51,,16,13,29
030 Pfalzen,52,,15,21,36
030 Pfalzen,53,,25,18,43
030 Pfalzen,54,,16,14,30
030 Pfalzen,55,,17,13,30
030 Pfalzen,56,,14,11,25
030 Pfalzen,57,,14,11,25
030 Pfalzen,58,,11,10,21
030 Pfalzen,59,,15,17,32
030 Pfalzen,60,,10,11,21
030 Pfalzen,61,,16,6,22
030 Pfalzen,62,,9,11,20
030 Pfalzen,63,,12,3,15
030 Pfalzen,64,,8,10,18
030 Pfalzen,65,,6,9,15
030 Pfalzen,66,,10,6,16
030 Pfalzen,67,,8,10,18
030 Pfalzen,68,,6,12,18
030 Pfalzen,69,,12,8,20
030 Pfalzen,70,,14,9,23
030 Pfalzen,71,,9,5,14
030 Pfalzen,72,,12,9,21
030 Pfalzen,73,,5,5,10
030 Pfalzen,74,,2,8,10
030 Pfalzen,75,,6,7,13
030 Pfalzen,76,,8,11,19
030 Pfalzen,77,,5,8,13
030 Pfalzen,78,,6,4,10
030 Pfalzen,79,,9,7,16
030 Pfalzen,80,,7,8,15
030 Pfalzen,81,,8,4,12
030 Pfalzen,82,,2,4,6
030 Pfalzen,83,,4,5,9
030 Pfalzen,84,,3,2,5
030 Pfalzen,85,,3,2,5
030 Pfalzen,86,,2,7,9
030 Pfalzen,87,,4,3,7
030 Pfalzen,88,,2,-,2
030 Pfalzen,89,,-,4,4
030 Pfalzen,90,,-,3,3
030 Pfalzen,91,,1,1,2
030 Pfalzen,92,,-,1,1
030 Pfalzen,94,,-,2,2
030 Pfalzen,96,,-,1,1
030 Pfalzen,97,,1,-,1
031 Völs am Schlern,0,,31,18,49
031 Völs am Schlern,1,,20,17,37
031 Völs am Schlern,2,,21,34,55
031 Völs am Schlern,3,,18,23,41
031 Völs am Schlern,4,,22,25,47
031 Völs am Schlern,5,,36,15,51
031 Völs am Schlern,6,,21,16,37
031 Völs am Schlern,7,,15,23,38
031 Völs am Schlern,8,,19,31,50
031 Völs am Schlern,9,,20,27,47
031 Völs am Schlern,10,,25,28,53
031 Völs am Schlern,11,,18,20,38
031 Völs am Schlern,12,,25,31,56
031 Völs am Schlern,13,,17,25,42
031 Völs am Schlern,14,,13,19,32
031 Völs am Schlern,15,,24,24,48
031 Völs am Schlern,16,,21,11,32
031 Völs am Schlern,17,,16,15,31
031 Völs am Schlern,18,,21,17,38
031 Völs am Schlern,19,,14,21,35
031 Völs am Schlern,20,,22,17,39
031 Völs am Schlern,21,,22,13,35
031 Völs am Schlern,22,,16,16,32
031 Völs am Schlern,23,,20,19,39
031 Völs am Schlern,24,,22,19,41
031 Völs am Schlern,25,,16,21,37
031 Völs am Schlern,26,,21,8,29
031 Völs am Schlern,27,,15,30,45
031 Völs am Schlern,28,,21,26,47
031 Völs am Schlern,29,,29,21,50
031 Völs am Schlern,30,,32,17,49
031 Völs am Schlern,31,,25,29,54
031 Völs am Schlern,32,,31,29,60
031 Völs am Schlern,33,,24,26,50
031 Völs am Schlern,34,,33,21,54
031 Völs am Schlern,35,,26,22,48
031 Völs am Schlern,36,,22,24,46
031 Völs am Schlern,37,,29,35,64
031 Völs am Schlern,38,,40,26,66
031 Völs am Schlern,39,,39,45,84
031 Völs am Schlern,40,,29,39,68
031 Völs am Schlern,41,,38,30,68
031 Völs am Schlern,42,,38,36,74
031 Völs am Schlern,43,,28,26,54
031 Völs am Schlern,44,,36,33,69
031 Völs am Schlern,45,,30,30,60
031 Völs am Schlern,46,,31,25,56
031 Völs am Schlern,47,,28,22,50
031 Völs am Schlern,48,,27,20,47
031 Völs am Schlern,49,,25,21,46
031 Völs am Schlern,50,,22,17,39
031 Völs am Schlern,51,,22,12,34
031 Völs am Schlern,52,,22,16,38
031 Völs am Schlern,53,,19,18,37
031 Völs am Schlern,54,,15,21,36
031 Völs am Schlern,55,,16,14,30
031 Völs am Schlern,56,,16,25,41
031 Völs am Schlern,57,,16,26,42
031 Völs am Schlern,58,,18,19,37
031 Völs am Schlern,59,,19,21,40
031 Völs am Schlern,60,,20,18,38
031 Völs am Schlern,61,,15,9,24
031 Völs am Schlern,62,,17,13,30
031 Völs am Schlern,63,,14,21,35
031 Völs am Schlern,64,,15,12,27
031 Völs am Schlern,65,,8,14,22
031 Völs am Schlern,66,,15,9,24
031 Völs am Schlern,67,,15,21,36
031 Völs am Schlern,68,,15,17,32
031 Völs am Schlern,69,,18,20,38
031 Völs am Schlern,70,,11,22,33
031 Völs am Schlern,71,,13,11,24
031 Völs am Schlern,72,,11,15,26
031 Völs am Schlern,73,,10,9,19
031 Völs am Schlern,74,,7,19,26
031 Völs am Schlern,75,,15,11,26
031 Völs am Schlern,76,,13,6,19
031 Völs am Schlern,77,,5,15,20
031 Völs am Schlern,78,,14,9,23
031 Völs am Schlern,79,,10,14,24
031 Völs am Schlern,80,,3,11,14
031 Völs am Schlern,81,,3,11,14
031 Völs am Schlern,82,,4,13,17
031 Völs am Schlern,83,,5,10,15
031 Völs am Schlern,84,,4,5,9
031 Völs am Schlern,85,,6,9,15
031 Völs am Schlern,86,,7,9,16
031 Völs am Schlern,87,,2,3,5
031 Völs am Schlern,88,,1,4,5
031 Völs am Schlern,89,,-,8,8
031 Völs am Schlern,90,,1,4,5
031 Völs am Schlern,91,,-,2,2
031 Völs am Schlern,92,,1,3,4
031 Völs am Schlern,93,,1,2,3
031 Völs am Schlern,95,,1,2,3
031 Völs am Schlern,96,,1,1,2
031 Völs am Schlern,100,,1,-,1
032 Franzensfeste,0,,7,7,14
032 Franzensfeste,1,,3,4,7
032 Franzensfeste,2,,4,7,11
032 Franzensfeste,3,,8,5,13
032 Franzensfeste,4,,4,4,8
032 Franzensfeste,5,,5,6,11
032 Franzensfeste,6,,7,5,12
032 Franzensfeste,7,,7,4,11
032 Franzensfeste,8,,11,1,12
032 Franzensfeste,9,,3,6,9
032 Franzensfeste,10,,3,5,8
032 Franzensfeste,11,,5,5,10
032 Franzensfeste,12,,7,6,13
032 Franzensfeste,13,,4,4,8
032 Franzensfeste,14,,7,4,11
032 Franzensfeste,15,,5,1,6
032 Franzensfeste,16,,6,6,12
032 Franzensfeste,17,,8,5,13
032 Franzensfeste,18,,7,5,12
032 Franzensfeste,19,,5,5,10
032 Franzensfeste,20,,1,8,9
032 Franzensfeste,21,,7,4,11
032 Franzensfeste,22,,2,3,5
032 Franzensfeste,23,,5,2,7
032 Franzensfeste,24,,8,3,11
032 Franzensfeste,25,,5,8,13
032 Franzensfeste,26,,3,9,12
032 Franzensfeste,27,,8,6,14
032 Franzensfeste,28,,2,9,11
032 Franzensfeste,29,,10,4,14
032 Franzensfeste,30,,6,11,17
032 Franzensfeste,31,,12,4,16
032 Franzensfeste,32,,6,7,13
032 Franzensfeste,33,,5,7,12
032 Franzensfeste,34,,4,5,9
032 Franzensfeste,35,,9,11,20
032 Franzensfeste,36,,10,7,17
032 Franzensfeste,37,,3,7,10
032 Franzensfeste,38,,7,10,17
032 Franzensfeste,39,,6,4,10
032 Franzensfeste,40,,8,6,14
032 Franzensfeste,41,,12,9,21
032 Franzensfeste,42,,9,11,20
032 Franzensfeste,43,,9,4,13
032 Franzensfeste,44,,10,5,15
032 Franzensfeste,45,,11,10,21
032 Franzensfeste,46,,14,8,22
032 Franzensfeste,47,,7,10,17
032 Franzensfeste,48,,12,3,15
032 Franzensfeste,49,,5,8,13
032 Franzensfeste,50,,3,9,12
032 Franzensfeste,51,,6,9,15
032 Franzensfeste,52,,12,3,15
032 Franzensfeste,53,,6,5,11
032 Franzensfeste,54,,5,8,13
032 Franzensfeste,55,,9,6,15
032 Franzensfeste,56,,7,7,14
032 Franzensfeste,57,,5,7,12
032 Franzensfeste,58,,5,4,9
032 Franzensfeste,59,,7,1,8
032 Franzensfeste,60,,11,4,15
032 Franzensfeste,61,,3,4,7
032 Franzensfeste,62,,3,4,7
032 Franzensfeste,63,,2,3,5
032 Franzensfeste,64,,8,6,14
032 Franzensfeste,65,,5,7,12
032 Franzensfeste,66,,4,9,13
032 Franzensfeste,67,,4,2,6
032 Franzensfeste,68,,4,1,5
032 Franzensfeste,69,,5,3,8
032 Franzensfeste,70,,3,4,7
032 Franzensfeste,71,,5,3,8
032 Franzensfeste,72,,1,3,4
032 Franzensfeste,73,,7,6,13
032 Franzensfeste,74,,2,2,4
032 Franzensfeste,75,,1,2,3
032 Franzensfeste,76,,3,3,6
032 Franzensfeste,77,,1,4,5
032 Franzensfeste,78,,3,4,7
032 Franzensfeste,79,,2,6,8
032 Franzensfeste,80,,6,4,10
032 Franzensfeste,81,,3,5,8
032 Franzensfeste,82,,2,3,5
032 Franzensfeste,83,,3,3,6
032 Franzensfeste,84,,1,6,7
032 Franzensfeste,85,,1,1,2
032 Franzensfeste,86,,4,4,8
032 Franzensfeste,87,,2,6,8
032 Franzensfeste,88,,2,2,4
032 Franzensfeste,89,,-,2,2
032 Franzensfeste,90,,-,1,1
032 Franzensfeste,92,,-,2,2
032 Franzensfeste,98,,-,1,1
033 Villnöss,0,,15,16,31
033 Villnöss,1,,19,13,32
033 Villnöss,2,,18,10,28
033 Villnöss,3,,14,15,29
033 Villnöss,4,,14,22,36
033 Villnöss,5,,20,22,42
033 Villnöss,6,,11,17,28
033 Villnöss,7,,17,15,32
033 Villnöss,8,,21,14,35
033 Villnöss,9,,15,22,37
033 Villnöss,10,,18,14,32
033 Villnöss,11,,16,30,46
033 Villnöss,12,,24,19,43
033 Villnöss,13,,17,22,39
033 Villnöss,14,,20,17,37
033 Villnöss,15,,16,13,29
033 Villnöss,16,,14,12,26
033 Villnöss,17,,17,12,29
033 Villnöss,18,,11,14,25
033 Villnöss,19,,21,17,38
033 Villnöss,20,,15,11,26
033 Villnöss,21,,14,9,23
033 Villnöss,22,,16,22,38
033 Villnöss,23,,17,20,37
033 Villnöss,24,,13,13,26
033 Villnöss,25,,15,18,33
033 Villnöss,26,,17,15,32
033 Villnöss,27,,16,13,29
033 Villnöss,28,,12,15,27
033 Villnöss,29,,13,17,30
033 Villnöss,30,,24,10,34
033 Villnöss,31,,9,11,20
033 Villnöss,32,,17,16,33
033 Villnöss,33,,14,12,26
033 Villnöss,34,,16,12,28
033 Villnöss,35,,20,15,35
033 Villnöss,36,,21,16,37
033 Villnöss,37,,11,18,29
033 Villnöss,38,,17,25,42
033 Villnöss,39,,24,26,50
033 Villnöss,40,,17,27,44
033 Villnöss,41,,28,23,51
033 Villnöss,42,,27,19,46
033 Villnöss,43,,18,18,36
033 Villnöss,44,,28,19,47
033 Villnöss,45,,28,22,50
033 Villnöss,46,,31,27,58
033 Villnöss,47,,30,21,51
033 Villnöss,48,,27,21,48
033 Villnöss,49,,22,14,36
033 Villnöss,50,,22,11,33
033 Villnöss,51,,10,10,20
033 Villnöss,52,,12,15,27
033 Villnöss,53,,13,11,24
033 Villnöss,54,,15,16,31
033 Villnöss,55,,12,3,15
033 Villnöss,56,,16,14,30
033 Villnöss,57,,13,16,29
033 Villnöss,58,,13,11,24
033 Villnöss,59,,13,9,22
033 Villnöss,60,,6,9,15
033 Villnöss,61,,7,14,21
033 Villnöss,62,,8,10,18
033 Villnöss,63,,13,11,24
033 Villnöss,64,,9,5,14
033 Villnöss,65,,8,4,12
033 Villnöss,66,,6,13,19
033 Villnöss,67,,11,9,20
033 Villnöss,68,,12,19,31
033 Villnöss,69,,11,9,20
033 Villnöss,70,,7,17,24
033 Villnöss,71,,12,13,25
033 Villnöss,72,,11,9,20
033 Villnöss,73,,7,15,22
033 Villnöss,74,,4,16,20
033 Villnöss,75,,3,8,11
033 Villnöss,76,,7,8,15
033 Villnöss,77,,9,10,19
033 Villnöss,78,,12,12,24
033 Villnöss,79,,9,11,20
033 Villnöss,80,,8,10,18
033 Villnöss,81,,7,9,16
033 Villnöss,82,,12,7,19
033 Villnöss,83,,5,8,13
033 Villnöss,84,,2,7,9
033 Villnöss,85,,4,6,10
033 Villnöss,86,,2,7,9
033 Villnöss,87,,4,11,15
033 Villnöss,88,,2,5,7
033 Villnöss,89,,1,3,4
033 Villnöss,90,,-,3,3
033 Villnöss,91,,1,2,3
033 Villnöss,92,,-,1,1
033 Villnöss,93,,-,2,2
033 Villnöss,95,,-,1,1
033 Villnöss,97,,-,1,1
034 Gais,0,,29,14,43
034 Gais,1,,22,11,33
034 Gais,2,,13,16,29
034 Gais,3,,17,18,35
034 Gais,4,,23,16,39
034 Gais,5,,28,18,46
034 Gais,6,,14,28,42
034 Gais,7,,19,17,36
034 Gais,8,,22,22,44
034 Gais,9,,21,19,40
034 Gais,10,,21,16,37
034 Gais,11,,21,27,48
034 Gais,12,,25,20,45
034 Gais,13,,28,12,40
034 Gais,14,,8,16,24
034 Gais,15,,27,19,46
034 Gais,16,,24,25,49
034 Gais,17,,14,19,33
034 Gais,18,,22,28,50
034 Gais,19,,24,29,53
034 Gais,20,,15,20,35
034 Gais,21,,17,14,31
034 Gais,22,,14,18,32
034 Gais,23,,18,17,35
034 Gais,24,,17,21,38
034 Gais,25,,19,17,36
034 Gais,26,,25,16,41
034 Gais,27,,20,22,42
034 Gais,28,,20,17,37
034 Gais,29,,20,21,41
034 Gais,30,,21,25,46
034 Gais,31,,26,14,40
034 Gais,32,,19,22,41
034 Gais,33,,21,26,47
034 Gais,34,,23,25,48
034 Gais,35,,25,21,46
034 Gais,36,,33,29,62
034 Gais,37,,26,26,52
034 Gais,38,,31,41,72
034 Gais,39,,39,25,64
034 Gais,40,,28,26,54
034 Gais,41,,40,32,72
034 Gais,42,,24,21,45
034 Gais,43,,26,31,57
034 Gais,44,,33,20,53
034 Gais,45,,25,24,49
034 Gais,46,,29,33,62
034 Gais,47,,18,19,37
034 Gais,48,,29,20,49
034 Gais,49,,24,31,55
034 Gais,50,,17,11,28
034 Gais,51,,17,21,38
034 Gais,52,,25,18,43
034 Gais,53,,13,15,28
034 Gais,54,,22,21,43
034 Gais,55,,20,11,31
034 Gais,56,,16,13,29
034 Gais,57,,13,13,26
034 Gais,58,,14,17,31
034 Gais,59,,14,20,34
034 Gais,60,,22,22,44
034 Gais,61,,15,12,27
034 Gais,62,,22,13,35
034 Gais,63,,19,11,30
034 Gais,64,,16,15,31
034 Gais,65,,13,9,22
034 Gais,66,,13,13,26
034 Gais,67,,10,17,27
034 Gais,68,,12,13,25
034 Gais,69,,21,12,33
034 Gais,70,,16,12,28
034 Gais,71,,12,14,26
034 Gais,72,,13,13,26
034 Gais,73,,16,16,32
034 Gais,74,,10,13,23
034 Gais,75,,11,12,23
034 Gais,76,,5,6,11
034 Gais,77,,5,10,15
034 Gais,78,,4,7,11
034 Gais,79,,8,7,15
034 Gais,80,,4,10,14
034 Gais,81,,1,3,4
034 Gais,82,,6,7,13
034 Gais,83,,6,7,13
034 Gais,84,,7,5,12
034 Gais,85,,3,4,7
034 Gais,86,,1,2,3
034 Gais,87,,2,7,9
034 Gais,88,,1,3,4
034 Gais,89,,-,3,3
034 Gais,90,,2,-,2
034 Gais,91,,-,1,1
034 Gais,92,,1,1,2
034 Gais,93,,1,-,1
034 Gais,95,,-,1,1
034 Gais,97,,2,-,2
035 Gargazon,0,,9,12,21
035 Gargazon,1,,5,8,13
035 Gargazon,2,,13,8,21
035 Gargazon,3,,7,6,13
035 Gargazon,4,,9,13,22
035 Gargazon,5,,8,8,16
035 Gargazon,6,,8,6,14
035 Gargazon,7,,7,15,22
035 Gargazon,8,,7,14,21
035 Gargazon,9,,4,8,12
035 Gargazon,10,,12,5,17
035 Gargazon,11,,14,9,23
035 Gargazon,12,,16,9,25
035 Gargazon,13,,5,14,19
035 Gargazon,14,,12,8,20
035 Gargazon,15,,12,4,16
035 Gargazon,16,,5,7,12
035 Gargazon,17,,9,7,16
035 Gargazon,18,,14,10,24
035 Gargazon,19,,18,12,30
035 Gargazon,20,,8,14,22
035 Gargazon,21,,9,5,14
035 Gargazon,22,,9,4,13
035 Gargazon,23,,7,8,15
035 Gargazon,24,,4,12,16
035 Gargazon,25,,12,5,17
035 Gargazon,26,,10,8,18
035 Gargazon,27,,8,11,19
035 Gargazon,28,,7,5,12
035 Gargazon,29,,10,9,19
035 Gargazon,30,,10,15,25
035 Gargazon,31,,8,5,13
035 Gargazon,32,,6,12,18
035 Gargazon,33,,10,11,21
035 Gargazon,34,,5,13,18
035 Gargazon,35,,10,10,20
035 Gargazon,36,,15,18,33
035 Gargazon,37,,14,11,25
035 Gargazon,38,,14,19,33
035 Gargazon,39,,18,17,35
035 Gargazon,40,,16,14,30
035 Gargazon,41,,22,16,38
035 Gargazon,42,,18,19,37
035 Gargazon,43,,14,15,29
035 Gargazon,44,,13,18,31
035 Gargazon,45,,15,8,23
035 Gargazon,46,,17,17,34
035 Gargazon,47,,19,20,39
035 Gargazon,48,,13,13,26
035 Gargazon,49,,11,14,25
035 Gargazon,50,,11,11,22
035 Gargazon,51,,19,13,32
035 Gargazon,52,,6,9,15
035 Gargazon,53,,15,12,27
035 Gargazon,54,,14,6,20
035 Gargazon,55,,9,5,14
035 Gargazon,56,,10,10,20
035 Gargazon,57,,15,9,24
035 Gargazon,58,,4,9,13
035 Gargazon,59,,10,8,18
035 Gargazon,60,,8,7,15
035 Gargazon,61,,6,9,15
035 Gargazon,62,,7,9,16
035 Gargazon,63,,5,6,11
035 Gargazon,64,,10,14,24
035 Gargazon,65,,9,6,15
035 Gargazon,66,,2,4,6
035 Gargazon,67,,5,9,14
035 Gargazon,68,,6,9,15
035 Gargazon,69,,9,8,17
035 Gargazon,70,,5,16,21
035 Gargazon,71,,8,6,14
035 Gargazon,72,,8,7,15
035 Gargazon,73,,7,12,19
035 Gargazon,74,,3,3,6
035 Gargazon,75,,12,2,14
035 Gargazon,76,,5,6,11
035 Gargazon,77,,1,10,11
035 Gargazon,78,,5,2,7
035 Gargazon,79,,3,7,10
035 Gargazon,80,,3,4,7
035 Gargazon,81,,2,4,6
035 Gargazon,82,,2,2,4
035 Gargazon,83,,2,5,7
035 Gargazon,84,,3,3,6
035 Gargazon,85,,1,3,4
035 Gargazon,86,,-,3,3
035 Gargazon,87,,3,4,7
035 Gargazon,88,,1,5,6
035 Gargazon,89,,1,2,3
035 Gargazon,91,,-,1,1
035 Gargazon,94,,-,1,1
035 Gargazon,95,,-,2,2
035 Gargazon,96,,1,-,1
035 Gargazon,97,,-,3,3
036 Glurns,0,,3,3,6
036 Glurns,1,,1,4,5
036 Glurns,2,,9,2,11
036 Glurns,3,,5,2,7
036 Glurns,4,,4,8,12
036 Glurns,5,,7,5,12
036 Glurns,6,,4,4,8
036 Glurns,7,,6,6,12
036 Glurns,8,,3,4,7
036 Glurns,9,,5,1,6
036 Glurns,10,,4,3,7
036 Glurns,11,,3,2,5
036 Glurns,12,,10,3,13
036 Glurns,13,,4,7,11
036 Glurns,14,,7,4,11
036 Glurns,15,,7,5,12
036 Glurns,16,,2,3,5
036 Glurns,17,,6,7,13
036 Glurns,18,,5,8,13
036 Glurns,19,,6,2,8
036 Glurns,20,,8,6,14
036 Glurns,21,,4,3,7
036 Glurns,22,,6,7,13
036 Glurns,23,,4,5,9
036 Glurns,24,,6,6,12
036 Glurns,25,,3,1,4
036 Glurns,26,,7,5,12
036 Glurns,27,,10,6,16
036 Glurns,28,,11,8,19
036 Glurns,29,,6,3,9
036 Glurns,30,,13,4,17
036 Glurns,31,,3,8,11
036 Glurns,32,,7,6,13
036 Glurns,33,,3,5,8
036 Glurns,34,,12,5,17
036 Glurns,35,,7,11,18
036 Glurns,36,,8,11,19
036 Glurns,37,,4,3,7
036 Glurns,38,,5,7,12
036 Glurns,39,,6,5,11
036 Glurns,40,,5,1,6
036 Glurns,41,,2,6,8
036 Glurns,42,,7,4,11
036 Glurns,43,,4,9,13
036 Glurns,44,,6,8,14
036 Glurns,45,,3,6,9
036 Glurns,46,,10,5,15
036 Glurns,47,,5,9,14
036 Glurns,48,,5,5,10
036 Glurns,49,,6,6,12
036 Glurns,50,,7,9,16
036 Glurns,51,,12,6,18
036 Glurns,52,,4,9,13
036 Glurns,53,,6,12,18
036 Glurns,54,,6,6,12
036 Glurns,55,,8,7,15
036 Glurns,56,,12,4,16
036 Glurns,57,,8,9,17
036 Glurns,58,,4,8,12
036 Glurns,59,,8,10,18
036 Glurns,60,,6,5,11
036 Glurns,61,,6,3,9
036 Glurns,62,,7,5,12
036 Glurns,63,,10,7,17
036 Glurns,64,,8,2,10
036 Glurns,65,,6,1,7
036 Glurns,66,,5,4,9
036 Glurns,67,,1,4,5
036 Glurns,68,,4,6,10
036 Glurns,69,,3,2,5
036 Glurns,70,,6,1,7
036 Glurns,71,,1,3,4
036 Glurns,72,,4,3,7
036 Glurns,73,,4,4,8
036 Glurns,74,,-,2,2
036 Glurns,75,,2,4,6
036 Glurns,76,,1,5,6
036 Glurns,77,,1,1,2
036 Glurns,78,,5,2,7
036 Glurns,79,,4,1,5
036 Glurns,80,,2,2,4
036 Glurns,81,,2,6,8
036 Glurns,82,,-,1,1
036 Glurns,83,,1,2,3
036 Glurns,84,,-,1,1
036 Glurns,85,,1,5,6
036 Glurns,86,,1,2,3
036 Glurns,87,,-,1,1
036 Glurns,89,,1,-,1
036 Glurns,91,,1,1,2
036 Glurns,93,,-,1,1
036 Glurns,95,,-,1,1
037 Latsch,0,,21,17,38
037 Latsch,1,,21,31,52
037 Latsch,2,,20,21,41
037 Latsch,3,,27,31,58
037 Latsch,4,,29,23,52
037 Latsch,5,,20,28,48
037 Latsch,6,,31,25,56
037 Latsch,7,,25,23,48
037 Latsch,8,,27,26,53
037 Latsch,9,,37,20,57
037 Latsch,10,,36,33,69
037 Latsch,11,,31,19,50
037 Latsch,12,,26,22,48
037 Latsch,13,,37,39,76
037 Latsch,14,,39,34,73
037 Latsch,15,,46,33,79
037 Latsch,16,,39,22,61
037 Latsch,17,,33,37,70
037 Latsch,18,,33,37,70
037 Latsch,19,,31,38,69
037 Latsch,20,,38,48,86
037 Latsch,21,,34,30,64
037 Latsch,22,,40,36,76
037 Latsch,23,,33,36,69
037 Latsch,24,,38,32,70
037 Latsch,25,,34,36,70
037 Latsch,26,,36,32,68
037 Latsch,27,,25,32,57
037 Latsch,28,,36,40,76
037 Latsch,29,,27,43,70
037 Latsch,30,,34,40,74
037 Latsch,31,,40,35,75
037 Latsch,32,,37,21,58
037 Latsch,33,,33,35,68
037 Latsch,34,,32,25,57
037 Latsch,35,,34,38,72
037 Latsch,36,,29,29,58
037 Latsch,37,,33,33,66
037 Latsch,38,,36,40,76
037 Latsch,39,,42,43,85
037 Latsch,40,,33,36,69
037 Latsch,41,,40,41,81
037 Latsch,42,,50,52,102
037 Latsch,43,,55,50,105
037 Latsch,44,,30,49,79
037 Latsch,45,,59,44,103
037 Latsch,46,,59,48,107
037 Latsch,47,,54,47,101
037 Latsch,48,,41,49,90
037 Latsch,49,,47,41,88
037 Latsch,50,,38,50,88
037 Latsch,51,,44,47,91
037 Latsch,52,,39,31,70
037 Latsch,53,,28,36,64
037 Latsch,54,,31,33,64
037 Latsch,55,,35,26,61
037 Latsch,56,,29,18,47
037 Latsch,57,,24,23,47
037 Latsch,58,,38,20,58
037 Latsch,59,,20,32,52
037 Latsch,60,,32,16,48
037 Latsch,61,,16,20,36
037 Latsch,62,,14,20,34
037 Latsch,63,,17,15,32
037 Latsch,64,,18,21,39
037 Latsch,65,,15,20,35
037 Latsch,66,,23,12,35
037 Latsch,67,,22,21,43
037 Latsch,68,,23,25,48
037 Latsch,69,,16,23,39
037 Latsch,70,,20,24,44
037 Latsch,71,,18,18,36
037 Latsch,72,,14,26,40
037 Latsch,73,,11,23,34
037 Latsch,74,,16,12,28
037 Latsch,75,,23,13,36
037 Latsch,76,,15,25,40
037 Latsch,77,,14,23,37
037 Latsch,78,,20,19,39
037 Latsch,79,,14,17,31
037 Latsch,80,,18,16,34
037 Latsch,81,,15,13,28
037 Latsch,82,,16,17,33
037 Latsch,83,,10,23,33
037 Latsch,84,,10,14,24
037 Latsch,85,,10,14,24
037 Latsch,86,,5,9,14
037 Latsch,87,,4,10,14
037 Latsch,88,,5,10,15
037 Latsch,89,,8,6,14
037 Latsch,90,,3,2,5
037 Latsch,91,,2,3,5
037 Latsch,92,,1,2,3
037 Latsch,93,,-,1,1
037 Latsch,94,,1,-,1
037 Latsch,95,,-,2,2
037 Latsch,96,,-,1,1
037 Latsch,97,,-,1,1
037 Latsch,98,,1,-,1
037 Latsch,99,,-,1,1
037 Latsch,101,,-,1,1
038 Algund,0,,30,22,52
038 Algund,1,,20,32,52
038 Algund,2,,17,19,36
038 Algund,3,,23,22,45
038 Algund,4,,25,22,47
038 Algund,5,,23,23,46
038 Algund,6,,23,22,45
038 Algund,7,,30,26,56
038 Algund,8,,23,29,52
038 Algund,9,,34,25,59
038 Algund,10,,22,34,56
038 Algund,11,,41,28,69
038 Algund,12,,24,24,48
038 Algund,13,,26,20,46
038 Algund,14,,21,24,45
038 Algund,15,,31,23,54
038 Algund,16,,27,24,51
038 Algund,17,,28,18,46
038 Algund,18,,33,22,55
038 Algund,19,,28,21,49
038 Algund,20,,31,22,53
038 Algund,21,,23,30,53
038 Algund,22,,22,28,50
038 Algund,23,,27,27,54
038 Algund,24,,30,38,68
038 Algund,25,,28,22,50
038 Algund,26,,23,24,47
038 Algund,27,,26,40,66
038 Algund,28,,27,22,49
038 Algund,29,,35,31,66
038 Algund,30,,34,32,66
038 Algund,31,,24,39,63
038 Algund,32,,26,34,60
038 Algund,33,,31,38,69
038 Algund,34,,32,36,68
038 Algund,35,,39,39,78
038 Algund,36,,34,41,75
038 Algund,37,,38,31,69
038 Algund,38,,46,42,88
038 Algund,39,,41,42,83
038 Algund,40,,51,39,90
038 Algund,41,,45,50,95
038 Algund,42,,43,33,76
038 Algund,43,,37,46,83
038 Algund,44,,40,40,80
038 Algund,45,,40,47,87
038 Algund,46,,54,26,80
038 Algund,47,,37,39,76
038 Algund,48,,38,46,84
038 Algund,49,,31,53,84
038 Algund,50,,41,39,80
038 Algund,51,,39,36,75
038 Algund,52,,44,28,72
038 Algund,53,,25,37,62
038 Algund,54,,36,31,67
038 Algund,55,,26,30,56
038 Algund,56,,37,26,63
038 Algund,57,,18,30,48
038 Algund,58,,29,25,54
038 Algund,59,,27,29,56
038 Algund,60,,23,28,51
038 Algund,61,,21,27,48
038 Algund,62,,27,22,49
038 Algund,63,,19,20,39
038 Algund,64,,29,30,59
038 Algund,65,,25,23,48
038 Algund,66,,23,29,52
038 Algund,67,,21,20,41
038 Algund,68,,16,33,49
038 Algund,69,,19,21,40
038 Algund,70,,18,24,42
038 Algund,71,,22,28,50
038 Algund,72,,18,21,39
038 Algund,73,,17,14,31
038 Algund,74,,14,25,39
038 Algund,75,,13,18,31
038 Algund,76,,21,24,45
038 Algund,77,,18,20,38
038 Algund,78,,13,19,32
038 Algund,79,,10,22,32
038 Algund,80,,11,20,31
038 Algund,81,,7,21,28
038 Algund,82,,8,14,22
038 Algund,83,,9,14,23
038 Algund,84,,11,12,23
038 Algund,85,,9,11,20
038 Algund,86,,4,12,16
038 Algund,87,,1,4,5
038 Algund,88,,4,13,17
038 Algund,89,,3,7,10
038 Algund,90,,4,3,7
038 Algund,91,,1,5,6
038 Algund,92,,1,2,3
038 Algund,93,,-,1,1
038 Algund,94,,1,1,2
038 Algund,95,,-,2,2
038 Algund,96,,-,2,2
038 Algund,98,,1,2,3
038 Algund,99,,-,2,2
038 Algund,100,,-,1,1
038 Algund,102,,-,1,1
039 Lajen,0,,18,20,38
039 Lajen,1,,21,6,27
039 Lajen,2,,17,18,35
039 Lajen,3,,18,19,37
039 Lajen,4,,15,20,35
039 Lajen,5,,17,13,30
039 Lajen,6,,17,24,41
039 Lajen,7,,20,23,43
039 Lajen,8,,22,8,30
039 Lajen,9,,21,22,43
039 Lajen,10,,27,17,44
039 Lajen,11,,19,16,35
039 Lajen,12,,17,16,33
039 Lajen,13,,16,23,39
039 Lajen,14,,14,11,25
039 Lajen,15,,9,12,21
039 Lajen,16,,12,14,26
039 Lajen,17,,14,13,27
039 Lajen,18,,15,8,23
039 Lajen,19,,21,18,39
039 Lajen,20,,8,9,17
039 Lajen,21,,17,15,32
039 Lajen,22,,13,14,27
039 Lajen,23,,14,8,22
039 Lajen,24,,17,18,35
039 Lajen,25,,20,11,31
039 Lajen,26,,11,14,25
039 Lajen,27,,10,25,35
039 Lajen,28,,19,22,41
039 Lajen,29,,12,22,34
039 Lajen,30,,22,19,41
039 Lajen,31,,24,21,45
039 Lajen,32,,22,27,49
039 Lajen,33,,22,16,38
039 Lajen,34,,29,19,48
039 Lajen,35,,22,25,47
039 Lajen,36,,35,18,53
039 Lajen,37,,21,23,44
039 Lajen,38,,21,25,46
039 Lajen,39,,16,23,39
039 Lajen,40,,18,28,46
039 Lajen,41,,34,24,58
039 Lajen,42,,22,23,45
039 Lajen,43,,24,25,49
039 Lajen,44,,24,16,40
039 Lajen,45,,25,19,44
039 Lajen,46,,24,20,44
039 Lajen,47,,17,13,30
039 Lajen,48,,32,20,52
039 Lajen,49,,10,18,28
039 Lajen,50,,13,8,21
039 Lajen,51,,19,25,44
039 Lajen,52,,23,13,36
039 Lajen,53,,13,12,25
039 Lajen,54,,10,13,23
039 Lajen,55,,12,13,25
039 Lajen,56,,5,14,19
039 Lajen,57,,10,7,17
039 Lajen,58,,8,10,18
039 Lajen,59,,9,12,21
039 Lajen,60,,14,10,24
039 Lajen,61,,4,15,19
039 Lajen,62,,9,15,24
039 Lajen,63,,16,8,24
039 Lajen,64,,14,14,28
039 Lajen,65,,9,11,20
039 Lajen,66,,14,8,22
039 Lajen,67,,12,13,25
039 Lajen,68,,16,13,29
039 Lajen,69,,17,16,33
039 Lajen,70,,16,9,25
039 Lajen,71,,14,9,23
039 Lajen,72,,6,16,22
039 Lajen,73,,7,10,17
039 Lajen,74,,6,7,13
039 Lajen,75,,6,7,13
039 Lajen,76,,6,6,12
039 Lajen,77,,5,11,16
039 Lajen,78,,9,3,12
039 Lajen,79,,2,8,10
039 Lajen,80,,6,5,11
039 Lajen,81,,5,7,12
039 Lajen,82,,7,7,14
039 Lajen,83,,6,8,14
039 Lajen,84,,5,6,11
039 Lajen,85,,2,5,7
039 Lajen,86,,1,8,9
039 Lajen,87,,-,7,7
039 Lajen,88,,1,3,4
039 Lajen,89,,2,2,4
039 Lajen,90,,-,2,2
039 Lajen,91,,1,1,2
039 Lajen,92,,-,1,1
039 Lajen,97,,1,-,1
039 Lajen,98,,-,1,1
039 Lajen,100,,-,1,1
040 Leifers,0,,101,88,189
040 Leifers,1,,92,90,182
040 Leifers,2,,110,91,201
040 Leifers,3,,91,89,180
040 Leifers,4,,89,87,176
040 Leifers,5,,96,75,171
040 Leifers,6,,87,76,163
040 Leifers,7,,100,85,185
040 Leifers,8,,87,89,176
040 Leifers,9,,88,77,165
040 Leifers,10,,97,93,190
040 Leifers,11,,93,88,181
040 Leifers,12,,79,108,187
040 Leifers,13,,111,81,192
040 Leifers,14,,104,88,192
040 Leifers,15,,97,94,191
040 Leifers,16,,94,98,192
040 Leifers,17,,89,78,167
040 Leifers,18,,91,85,176
040 Leifers,19,,97,86,183
040 Leifers,20,,90,91,181
040 Leifers,21,,74,84,158
040 Leifers,22,,85,92,177
040 Leifers,23,,92,81,173
040 Leifers,24,,84,98,182
040 Leifers,25,,92,78,170
040 Leifers,26,,100,85,185
040 Leifers,27,,110,123,233
040 Leifers,28,,124,99,223
040 Leifers,29,,104,92,196
040 Leifers,30,,83,102,185
040 Leifers,31,,103,118,221
040 Leifers,32,,121,96,217
040 Leifers,33,,126,133,259
040 Leifers,34,,133,119,252
040 Leifers,35,,157,150,307
040 Leifers,36,,148,152,300
040 Leifers,37,,156,154,310
040 Leifers,38,,164,157,321
040 Leifers,39,,136,137,273
040 Leifers,40,,174,148,322
040 Leifers,41,,169,141,310
040 Leifers,42,,153,170,323
040 Leifers,43,,150,127,277
040 Leifers,44,,145,142,287
040 Leifers,45,,154,133,287
040 Leifers,46,,164,157,321
040 Leifers,47,,152,134,286
040 Leifers,48,,138,133,271
040 Leifers,49,,141,145,286
040 Leifers,50,,143,119,262
040 Leifers,51,,122,106,228
040 Leifers,52,,93,114,207
040 Leifers,53,,103,113,216
040 Leifers,54,,138,129,267
040 Leifers,55,,107,126,233
040 Leifers,56,,90,111,201
040 Leifers,57,,105,118,223
040 Leifers,58,,106,97,203
040 Leifers,59,,94,96,190
040 Leifers,60,,99,90,189
040 Leifers,61,,91,98,189
040 Leifers,62,,107,100,207
040 Leifers,63,,95,98,193
040 Leifers,64,,108,150,258
040 Leifers,65,,76,81,157
040 Leifers,66,,87,88,175
040 Leifers,67,,88,95,183
040 Leifers,68,,87,92,179
040 Leifers,69,,83,81,164
040 Leifers,70,,92,82,174
040 Leifers,71,,88,94,182
040 Leifers,72,,82,75,157
040 Leifers,73,,51,73,124
040 Leifers,74,,50,62,112
040 Leifers,75,,49,65,114
040 Leifers,76,,54,61,115
040 Leifers,77,,36,59,95
040 Leifers,78,,56,71,127
040 Leifers,79,,41,59,100
040 Leifers,80,,34,52,86
040 Leifers,81,,29,45,74
040 Leifers,82,,33,33,66
040 Leifers,83,,21,44,65
040 Leifers,84,,13,41,54
040 Leifers,85,,18,40,58
040 Leifers,86,,12,31,43
040 Leifers,87,,9,30,39
040 Leifers,88,,11,29,40
040 Leifers,89,,8,20,28
040 Leifers,90,,6,13,19
040 Leifers,91,,4,20,24
040 Leifers,92,,1,3,4
040 Leifers,93,,1,4,5
040 Leifers,94,,-,5,5
040 Leifers,95,,-,10,10
040 Leifers,96,,-,3,3
040 Leifers,97,,1,7,8
040 Leifers,98,,1,5,6
040 Leifers,99,,-,1,1
040 Leifers,101,,-,1,1
041 Lana,0,,52,63,115
041 Lana,1,,65,50,115
041 Lana,2,,72,62,134
041 Lana,3,,70,55,125
041 Lana,4,,66,57,123
041 Lana,5,,77,64,141
041 Lana,6,,77,55,132
041 Lana,7,,63,59,122
041 Lana,8,,56,55,111
041 Lana,9,,73,55,128
041 Lana,10,,72,70,142
041 Lana,11,,72,60,132
041 Lana,12,,61,61,122
041 Lana,13,,61,67,128
041 Lana,14,,73,79,152
041 Lana,15,,69,63,132
041 Lana,16,,69,76,145
041 Lana,17,,63,60,123
041 Lana,18,,62,60,122
041 Lana,19,,63,59,122
041 Lana,20,,53,70,123
041 Lana,21,,46,79,125
041 Lana,22,,58,54,112
041 Lana,23,,74,50,124
041 Lana,24,,60,62,122
041 Lana,25,,56,69,125
041 Lana,26,,62,68,130
041 Lana,27,,86,77,163
041 Lana,28,,81,70,151
041 Lana,29,,59,80,139
041 Lana,30,,63,70,133
041 Lana,31,,72,93,165
041 Lana,32,,88,82,170
041 Lana,33,,71,73,144
041 Lana,34,,78,96,174
041 Lana,35,,65,90,155
041 Lana,36,,97,83,180
041 Lana,37,,82,91,173
041 Lana,38,,109,96,205
041 Lana,39,,96,110,206
041 Lana,40,,97,105,202
041 Lana,41,,124,83,207
041 Lana,42,,91,104,195
041 Lana,43,,92,100,192
041 Lana,44,,95,115,210
041 Lana,45,,99,89,188
041 Lana,46,,106,107,213
041 Lana,47,,109,85,194
041 Lana,48,,89,81,170
041 Lana,49,,84,91,175
041 Lana,50,,77,79,156
041 Lana,51,,83,76,159
041 Lana,52,,78,87,165
041 Lana,53,,74,73,147
041 Lana,54,,57,62,119
041 Lana,55,,63,76,139
041 Lana,56,,60,67,127
041 Lana,57,,56,59,115
041 Lana,58,,51,61,112
041 Lana,59,,51,65,116
041 Lana,60,,51,57,108
041 Lana,61,,54,54,108
041 Lana,62,,55,65,120
041 Lana,63,,58,47,105
041 Lana,64,,61,61,122
041 Lana,65,,40,50,90
041 Lana,66,,48,60,108
041 Lana,67,,57,59,116
041 Lana,68,,49,70,119
041 Lana,69,,48,44,92
041 Lana,70,,43,48,91
041 Lana,71,,48,52,100
041 Lana,72,,38,59,97
041 Lana,73,,33,38,71
041 Lana,74,,37,47,84
041 Lana,75,,33,32,65
041 Lana,76,,32,39,71
041 Lana,77,,25,43,68
041 Lana,78,,26,29,55
041 Lana,79,,22,41,63
041 Lana,80,,22,37,59
041 Lana,81,,16,32,48
041 Lana,82,,24,23,47
041 Lana,83,,23,28,51
041 Lana,84,,16,30,46
041 Lana,85,,15,33,48
041 Lana,86,,4,17,21
041 Lana,87,,11,21,32
041 Lana,88,,15,20,35
041 Lana,89,,7,25,32
041 Lana,90,,7,19,26
041 Lana,91,,2,10,12
041 Lana,92,,4,6,10
041 Lana,93,,3,6,9
041 Lana,94,,1,2,3
041 Lana,95,,-,4,4
041 Lana,96,,4,3,7
041 Lana,97,,-,3,3
041 Lana,98,,-,1,1
041 Lana,99,,-,1,1
041 Lana,100,,-,2,2
042 Laas,0,,33,29,62
042 Laas,1,,19,30,49
042 Laas,2,,23,24,47
042 Laas,3,,30,14,44
042 Laas,4,,19,29,48
042 Laas,5,,35,15,50
042 Laas,6,,23,20,43
042 Laas,7,,24,19,43
042 Laas,8,,28,17,45
042 Laas,9,,17,20,37
042 Laas,10,,26,24,50
042 Laas,11,,17,13,30
042 Laas,12,,26,32,58
042 Laas,13,,28,24,52
042 Laas,14,,30,33,63
042 Laas,15,,32,25,57
042 Laas,16,,23,27,50
042 Laas,17,,23,19,42
042 Laas,18,,18,25,43
042 Laas,19,,22,21,43
042 Laas,20,,20,25,45
042 Laas,21,,22,27,49
042 Laas,22,,21,19,40
042 Laas,23,,31,22,53
042 Laas,24,,33,20,53
042 Laas,25,,30,21,51
042 Laas,26,,28,31,59
042 Laas,27,,20,44,64
042 Laas,28,,32,30,62
042 Laas,29,,27,29,56
042 Laas,30,,21,27,48
042 Laas,31,,32,28,60
042 Laas,32,,25,31,56
042 Laas,33,,23,18,41
042 Laas,34,,31,28,59
042 Laas,35,,28,21,49
042 Laas,36,,44,32,76
042 Laas,37,,36,28,64
042 Laas,38,,27,24,51
042 Laas,39,,24,27,51
042 Laas,40,,39,24,63
042 Laas,41,,31,38,69
042 Laas,42,,38,30,68
042 Laas,43,,34,23,57
042 Laas,44,,34,24,58
042 Laas,45,,35,32,67
042 Laas,46,,28,31,59
042 Laas,47,,27,28,55
042 Laas,48,,35,26,61
042 Laas,49,,24,30,54
042 Laas,50,,39,25,64
042 Laas,51,,32,26,58
042 Laas,52,,26,25,51
042 Laas,53,,18,28,46
042 Laas,54,,23,17,40
042 Laas,55,,16,16,32
042 Laas,56,,15,24,39
042 Laas,57,,22,13,35
042 Laas,58,,28,25,53
042 Laas,59,,13,16,29
042 Laas,60,,20,24,44
042 Laas,61,,18,19,37
042 Laas,62,,16,21,37
042 Laas,63,,25,11,36
042 Laas,64,,13,16,29
042 Laas,65,,14,11,25
042 Laas,66,,12,15,27
042 Laas,67,,13,15,28
042 Laas,68,,16,19,35
042 Laas,69,,13,21,34
042 Laas,70,,17,22,39
042 Laas,71,,12,25,37
042 Laas,72,,18,12,30
042 Laas,73,,11,13,24
042 Laas,74,,18,10,28
042 Laas,75,,18,22,40
042 Laas,76,,9,18,27
042 Laas,77,,16,11,27
042 Laas,78,,11,13,24
042 Laas,79,,12,20,32
042 Laas,80,,13,12,25
042 Laas,81,,10,8,18
042 Laas,82,,11,11,22
042 Laas,83,,9,12,21
042 Laas,84,,11,11,22
042 Laas,85,,3,9,12
042 Laas,86,,4,19,23
042 Laas,87,,7,6,13
042 Laas,88,,3,9,12
042 Laas,89,,1,3,4
042 Laas,90,,2,6,8
042 Laas,91,,2,2,4
042 Laas,92,,2,-,2
042 Laas,94,,-,3,3
042 Laas,96,,-,2,2
042 Laas,97,,-,2,2
042 Laas,98,,-,1,1
042 Laas,99,,-,1,1
042 Laas,100,,-,1,1
043 Laurein,0,,2,1,3
043 Laurein,1,,2,3,5
043 Laurein,2,,2,1,3
043 Laurein,3,,1,-,1
043 Laurein,4,,7,-,7
043 Laurein,5,,3,4,7
043 Laurein,6,,3,1,4
043 Laurein,7,,2,3,5
043 Laurein,8,,2,3,5
043 Laurein,9,,7,1,8
043 Laurein,10,,3,7,10
043 Laurein,11,,2,1,3
043 Laurein,12,,4,3,7
043 Laurein,13,,3,5,8
043 Laurein,14,,1,2,3
043 Laurein,15,,2,2,4
043 Laurein,16,,2,4,6
043 Laurein,17,,1,5,6
043 Laurein,18,,1,1,2
043 Laurein,19,,1,1,2
043 Laurein,20,,4,-,4
043 Laurein,21,,3,2,5
043 Laurein,22,,1,-,1
043 Laurein,23,,2,3,5
043 Laurein,24,,4,2,6
043 Laurein,25,,2,2,4
043 Laurein,26,,1,1,2
043 Laurein,28,,2,1,3
043 Laurein,29,,3,-,3
043 Laurein,30,,2,-,2
043 Laurein,31,,1,-,1
043 Laurein,32,,3,5,8
043 Laurein,33,,1,2,3
043 Laurein,34,,5,1,6
043 Laurein,35,,-,3,3
043 Laurein,36,,1,1,2
043 Laurein,37,,5,2,7
043 Laurein,38,,1,2,3
043 Laurein,39,,5,5,10
043 Laurein,40,,4,4,8
043 Laurein,41,,6,3,9
043 Laurein,42,,-,2,2
043 Laurein,43,,4,6,10
043 Laurein,44,,5,3,8
043 Laurein,45,,5,1,6
043 Laurein,46,,4,2,6
043 Laurein,47,,-,2,2
043 Laurein,48,,1,2,3
043 Laurein,49,,5,4,9
043 Laurein,50,,1,-,1
043 Laurein,51,,4,4,8
043 Laurein,52,,2,2,4
043 Laurein,53,,7,-,7
043 Laurein,55,,2,-,2
043 Laurein,56,,3,1,4
043 Laurein,57,,2,1,3
043 Laurein,58,,2,-,2
043 Laurein,60,,1,1,2
043 Laurein,61,,2,2,4
043 Laurein,62,,2,-,2
043 Laurein,63,,2,3,5
043 Laurein,64,,-,1,1
043 Laurein,65,,-,1,1
043 Laurein,66,,-,1,1
043 Laurein,67,,1,-,1
043 Laurein,68,,1,-,1
043 Laurein,70,,2,2,4
043 Laurein,71,,1,2,3
043 Laurein,72,,1,1,2
043 Laurein,73,,2,1,3
043 Laurein,74,,1,2,3
043 Laurein,75,,-,3,3
043 Laurein,76,,1,5,6
043 Laurein,77,,1,1,2
043 Laurein,78,,2,2,4
043 Laurein,79,,-,3,3
043 Laurein,80,,-,4,4
043 Laurein,81,,2,-,2
043 Laurein,82,,5,-,5
043 Laurein,83,,3,1,4
043 Laurein,84,,1,1,2
043 Laurein,85,,-,1,1
043 Laurein,86,,-,1,1
043 Laurein,88,,-,1,1
043 Laurein,89,,-,1,1
043 Laurein,90,,1,1,2
043 Laurein,97,,-,1,1
044 Lüsen,0,,12,10,22
044 Lüsen,1,,12,11,23
044 Lüsen,2,,8,8,16
044 Lüsen,3,,13,12,25
044 Lüsen,4,,10,14,24
044 Lüsen,5,,9,9,18
044 Lüsen,6,,10,11,21
044 Lüsen,7,,12,8,20
044 Lüsen,8,,10,9,19
044 Lüsen,9,,10,11,21
044 Lüsen,10,,15,10,25
044 Lüsen,11,,5,10,15
044 Lüsen,12,,11,11,22
044 Lüsen,13,,16,6,22
044 Lüsen,14,,8,13,21
044 Lüsen,15,,9,12,21
044 Lüsen,16,,14,13,27
044 Lüsen,17,,9,8,17
044 Lüsen,18,,11,9,20
044 Lüsen,19,,9,9,18
044 Lüsen,20,,6,11,17
044 Lüsen,21,,15,8,23
044 Lüsen,22,,8,10,18
044 Lüsen,23,,6,9,15
044 Lüsen,24,,11,10,21
044 Lüsen,25,,3,2,5
044 Lüsen,26,,9,17,26
044 Lüsen,27,,6,7,13
044 Lüsen,28,,12,12,24
044 Lüsen,29,,11,14,25
044 Lüsen,30,,13,9,22
044 Lüsen,31,,7,8,15
044 Lüsen,32,,17,17,34
044 Lüsen,33,,8,13,21
044 Lüsen,34,,14,11,25
044 Lüsen,35,,13,14,27
044 Lüsen,36,,14,15,29
044 Lüsen,37,,8,7,15
044 Lüsen,38,,8,10,18
044 Lüsen,39,,16,9,25
044 Lüsen,40,,18,14,32
044 Lüsen,41,,9,10,19
044 Lüsen,42,,13,15,28
044 Lüsen,43,,10,18,28
044 Lüsen,44,,16,13,29
044 Lüsen,45,,19,13,32
044 Lüsen,46,,13,9,22
044 Lüsen,47,,15,12,27
044 Lüsen,48,,7,11,18
044 Lüsen,49,,12,9,21
044 Lüsen,50,,8,12,20
044 Lüsen,51,,8,6,14
044 Lüsen,52,,11,11,22
044 Lüsen,53,,10,9,19
044 Lüsen,54,,9,10,19
044 Lüsen,55,,6,6,12
044 Lüsen,56,,11,6,17
044 Lüsen,57,,6,10,16
044 Lüsen,58,,9,4,13
044 Lüsen,59,,5,7,12
044 Lüsen,60,,6,8,14
044 Lüsen,61,,7,10,17
044 Lüsen,62,,7,1,8
044 Lüsen,63,,5,5,10
044 Lüsen,64,,9,6,15
044 Lüsen,65,,3,9,12
044 Lüsen,66,,5,4,9
044 Lüsen,67,,8,8,16
044 Lüsen,68,,2,6,8
044 Lüsen,69,,6,3,9
044 Lüsen,70,,4,10,14
044 Lüsen,71,,8,7,15
044 Lüsen,72,,6,5,11
044 Lüsen,73,,7,4,11
044 Lüsen,74,,5,9,14
044 Lüsen,75,,4,4,8
044 Lüsen,76,,3,4,7
044 Lüsen,77,,7,3,10
044 Lüsen,78,,2,10,12
044 Lüsen,79,,5,5,10
044 Lüsen,80,,1,5,6
044 Lüsen,81,,2,5,7
044 Lüsen,82,,2,5,7
044 Lüsen,83,,3,3,6
044 Lüsen,84,,2,4,6
044 Lüsen,85,,1,3,4
044 Lüsen,86,,1,2,3
044 Lüsen,87,,1,3,4
044 Lüsen,88,,1,2,3
044 Lüsen,89,,1,4,5
044 Lüsen,97,,-,1,1
045 Margreid a.d. Weinstr.,0,,4,10,14
045 Margreid a.d. Weinstr.,1,,7,4,11
045 Margreid a.d. Weinstr.,2,,9,11,20
045 Margreid a.d. Weinstr.,3,,6,4,10
045 Margreid a.d. Weinstr.,4,,8,5,13
045 Margreid a.d. Weinstr.,5,,8,9,17
045 Margreid a.d. Weinstr.,6,,10,8,18
045 Margreid a.d. Weinstr.,7,,4,4,8
045 Margreid a.d. Weinstr.,8,,11,8,19
045 Margreid a.d. Weinstr.,9,,12,9,21
045 Margreid a.d. Weinstr.,10,,7,8,15
045 Margreid a.d. Weinstr.,11,,7,9,16
045 Margreid a.d. Weinstr.,12,,2,11,13
045 Margreid a.d. Weinstr.,13,,10,13,23
045 Margreid a.d. Weinstr.,14,,5,2,7
045 Margreid a.d. Weinstr.,15,,2,6,8
045 Margreid a.d. Weinstr.,16,,6,7,13
045 Margreid a.d. Weinstr.,17,,4,12,16
045 Margreid a.d. Weinstr.,18,,1,3,4
045 Margreid a.d. Weinstr.,19,,5,5,10
045 Margreid a.d. Weinstr.,20,,9,9,18
045 Margreid a.d. Weinstr.,21,,8,7,15
045 Margreid a.d. Weinstr.,22,,8,7,15
045 Margreid a.d. Weinstr.,23,,9,6,15
045 Margreid a.d. Weinstr.,24,,6,11,17
045 Margreid a.d. Weinstr.,25,,13,1,14
045 Margreid a.d. Weinstr.,26,,8,10,18
045 Margreid a.d. Weinstr.,27,,7,10,17
045 Margreid a.d. Weinstr.,28,,14,14,28
045 Margreid a.d. Weinstr.,29,,16,7,23
045 Margreid a.d. Weinstr.,30,,3,8,11
045 Margreid a.d. Weinstr.,31,,13,5,18
045 Margreid a.d. Weinstr.,32,,9,8,17
045 Margreid a.d. Weinstr.,33,,8,9,17
045 Margreid a.d. Weinstr.,34,,14,18,32
045 Margreid a.d. Weinstr.,35,,10,8,18
045 Margreid a.d. Weinstr.,36,,11,5,16
045 Margreid a.d. Weinstr.,37,,9,10,19
045 Margreid a.d. Weinstr.,38,,5,6,11
045 Margreid a.d. Weinstr.,39,,10,14,24
045 Margreid a.d. Weinstr.,40,,9,11,20
045 Margreid a.d. Weinstr.,41,,9,10,19
045 Margreid a.d. Weinstr.,42,,22,17,39
045 Margreid a.d. Weinstr.,43,,12,18,30
045 Margreid a.d. Weinstr.,44,,22,9,31
045 Margreid a.d. Weinstr.,45,,11,5,16
045 Margreid a.d. Weinstr.,46,,6,5,11
045 Margreid a.d. Weinstr.,47,,10,11,21
045 Margreid a.d. Weinstr.,48,,8,16,24
045 Margreid a.d. Weinstr.,49,,15,14,29
045 Margreid a.d. Weinstr.,50,,15,12,27
045 Margreid a.d. Weinstr.,51,,9,13,22
045 Margreid a.d. Weinstr.,52,,6,9,15
045 Margreid a.d. Weinstr.,53,,8,7,15
045 Margreid a.d. Weinstr.,54,,14,6,20
045 Margreid a.d. Weinstr.,55,,9,8,17
045 Margreid a.d. Weinstr.,56,,5,4,9
045 Margreid a.d. Weinstr.,57,,8,8,16
045 Margreid a.d. Weinstr.,58,,5,10,15
045 Margreid a.d. Weinstr.,59,,5,8,13
045 Margreid a.d. Weinstr.,60,,7,6,13
045 Margreid a.d. Weinstr.,61,,7,3,10
045 Margreid a.d. Weinstr.,62,,5,9,14
045 Margreid a.d. Weinstr.,63,,6,6,12
045 Margreid a.d. Weinstr.,64,,2,3,5
045 Margreid a.d. Weinstr.,65,,6,7,13
045 Margreid a.d. Weinstr.,66,,3,6,9
045 Margreid a.d. Weinstr.,67,,6,3,9
045 Margreid a.d. Weinstr.,68,,10,4,14
045 Margreid a.d. Weinstr.,69,,7,5,12
045 Margreid a.d. Weinstr.,70,,5,3,8
045 Margreid a.d. Weinstr.,71,,3,7,10
045 Margreid a.d. Weinstr.,72,,3,9,12
045 Margreid a.d. Weinstr.,73,,4,3,7
045 Margreid a.d. Weinstr.,74,,6,4,10
045 Margreid a.d. Weinstr.,75,,1,6,7
045 Margreid a.d. Weinstr.,76,,5,4,9
045 Margreid a.d. Weinstr.,77,,3,4,7
045 Margreid a.d. Weinstr.,78,,5,4,9
045 Margreid a.d. Weinstr.,79,,3,5,8
045 Margreid a.d. Weinstr.,80,,6,1,7
045 Margreid a.d. Weinstr.,81,,1,5,6
045 Margreid a.d. Weinstr.,82,,3,2,5
045 Margreid a.d. Weinstr.,83,,1,3,4
045 Margreid a.d. Weinstr.,84,,2,7,9
045 Margreid a.d. Weinstr.,85,,3,2,5
045 Margreid a.d. Weinstr.,86,,1,4,5
045 Margreid a.d. Weinstr.,87,,1,3,4
045 Margreid a.d. Weinstr.,88,,1,1,2
045 Margreid a.d. Weinstr.,89,,-,1,1
045 Margreid a.d. Weinstr.,90,,-,1,1
045 Margreid a.d. Weinstr.,91,,1,3,4
045 Margreid a.d. Weinstr.,92,,1,-,1
045 Margreid a.d. Weinstr.,94,,-,2,2
046 Mals,0,,34,25,59
046 Mals,1,,30,13,43
046 Mals,2,,28,23,51
046 Mals,3,,23,31,54
046 Mals,4,,37,37,74
046 Mals,5,,26,31,57
046 Mals,6,,29,25,54
046 Mals,7,,33,20,53
046 Mals,8,,22,28,50
046 Mals,9,,30,30,60
046 Mals,10,,31,37,68
046 Mals,11,,41,30,71
046 Mals,12,,35,33,68
046 Mals,13,,31,32,63
046 Mals,14,,35,25,60
046 Mals,15,,35,41,76
046 Mals,16,,38,31,69
046 Mals,17,,37,33,70
046 Mals,18,,32,34,66
046 Mals,19,,34,35,69
046 Mals,20,,34,30,64
046 Mals,21,,40,35,75
046 Mals,22,,32,24,56
046 Mals,23,,31,30,61
046 Mals,24,,27,40,67
046 Mals,25,,37,38,75
046 Mals,26,,36,30,66
046 Mals,27,,31,27,58
046 Mals,28,,39,34,73
046 Mals,29,,35,35,70
046 Mals,30,,41,30,71
046 Mals,31,,31,29,60
046 Mals,32,,44,31,75
046 Mals,33,,33,32,65
046 Mals,34,,32,29,61
046 Mals,35,,42,30,72
046 Mals,36,,49,25,74
046 Mals,37,,34,40,74
046 Mals,38,,29,51,80
046 Mals,39,,38,47,85
046 Mals,40,,45,47,92
046 Mals,41,,47,43,90
046 Mals,42,,56,38,94
046 Mals,43,,50,34,84
046 Mals,44,,55,54,109
046 Mals,45,,51,40,91
046 Mals,46,,49,42,91
046 Mals,47,,49,54,103
046 Mals,48,,36,28,64
046 Mals,49,,48,36,84
046 Mals,50,,35,41,76
046 Mals,51,,35,33,68
046 Mals,52,,31,23,54
046 Mals,53,,36,34,70
046 Mals,54,,33,26,59
046 Mals,55,,29,23,52
046 Mals,56,,20,21,41
046 Mals,57,,33,31,64
046 Mals,58,,28,23,51
046 Mals,59,,30,22,52
046 Mals,60,,33,22,55
046 Mals,61,,19,24,43
046 Mals,62,,26,14,40
046 Mals,63,,21,19,40
046 Mals,64,,20,29,49
046 Mals,65,,10,19,29
046 Mals,66,,28,14,42
046 Mals,67,,23,19,42
046 Mals,68,,21,23,44
046 Mals,69,,16,16,32
046 Mals,70,,20,28,48
046 Mals,71,,23,27,50
046 Mals,72,,18,21,39
046 Mals,73,,11,27,38
046 Mals,74,,18,18,36
046 Mals,75,,13,18,31
046 Mals,76,,12,16,28
046 Mals,77,,11,20,31
046 Mals,78,,15,11,26
046 Mals,79,,9,16,25
046 Mals,80,,19,14,33
046 Mals,81,,14,13,27
046 Mals,82,,14,11,25
046 Mals,83,,8,13,21
046 Mals,84,,5,15,20
046 Mals,85,,5,15,20
046 Mals,86,,4,9,13
046 Mals,87,,-,7,7
046 Mals,88,,8,10,18
046 Mals,89,,4,6,10
046 Mals,90,,1,7,8
046 Mals,91,,1,9,10
046 Mals,92,,1,-,1
046 Mals,93,,2,1,3
046 Mals,95,,-,2,2
046 Mals,96,,1,-,1
046 Mals,97,,-,2,2
046 Mals,100,,-,1,1
046 Mals,101,,-,1,1
047 Enneberg,0,,17,13,30
047 Enneberg,1,,16,14,30
047 Enneberg,2,,16,19,35
047 Enneberg,3,,14,16,30
047 Enneberg,4,,23,19,42
047 Enneberg,5,,22,15,37
047 Enneberg,6,,14,17,31
047 Enneberg,7,,21,27,48
047 Enneberg,8,,18,14,32
047 Enneberg,9,,27,17,44
047 Enneberg,10,,19,21,40
047 Enneberg,11,,26,17,43
047 Enneberg,12,,18,10,28
047 Enneberg,13,,23,16,39
047 Enneberg,14,,17,13,30
047 Enneberg,15,,21,8,29
047 Enneberg,16,,21,15,36
047 Enneberg,17,,20,17,37
047 Enneberg,18,,15,15,30
047 Enneberg,19,,17,22,39
047 Enneberg,20,,15,18,33
047 Enneberg,21,,23,16,39
047 Enneberg,22,,20,15,35
047 Enneberg,23,,18,13,31
047 Enneberg,24,,19,11,30
047 Enneberg,25,,25,20,45
047 Enneberg,26,,21,19,40
047 Enneberg,27,,15,18,33
047 Enneberg,28,,23,18,41
047 Enneberg,29,,23,27,50
047 Enneberg,30,,23,18,41
047 Enneberg,31,,11,17,28
047 Enneberg,32,,19,24,43
047 Enneberg,33,,25,20,45
047 Enneberg,34,,14,18,32
047 Enneberg,35,,14,27,41
047 Enneberg,36,,29,32,61
047 Enneberg,37,,22,21,43
047 Enneberg,38,,24,27,51
047 Enneberg,39,,28,35,63
047 Enneberg,40,,27,20,47
047 Enneberg,41,,29,19,48
047 Enneberg,42,,22,22,44
047 Enneberg,43,,24,19,43
047 Enneberg,44,,18,23,41
047 Enneberg,45,,29,21,50
047 Enneberg,46,,25,22,47
047 Enneberg,47,,22,19,41
047 Enneberg,48,,18,16,34
047 Enneberg,49,,20,17,37
047 Enneberg,50,,15,17,32
047 Enneberg,51,,23,14,37
047 Enneberg,52,,20,12,32
047 Enneberg,53,,16,15,31
047 Enneberg,54,,14,19,33
047 Enneberg,55,,13,13,26
047 Enneberg,56,,14,11,25
047 Enneberg,57,,17,20,37
047 Enneberg,58,,14,16,30
047 Enneberg,59,,17,10,27
047 Enneberg,60,,11,15,26
047 Enneberg,61,,18,8,26
047 Enneberg,62,,15,14,29
047 Enneberg,63,,9,13,22
047 Enneberg,64,,12,17,29
047 Enneberg,65,,5,12,17
047 Enneberg,66,,18,17,35
047 Enneberg,67,,17,10,27
047 Enneberg,68,,11,20,31
047 Enneberg,69,,12,11,23
047 Enneberg,70,,10,7,17
047 Enneberg,71,,15,9,24
047 Enneberg,72,,12,19,31
047 Enneberg,73,,14,12,26
047 Enneberg,74,,9,11,20
047 Enneberg,75,,11,15,26
047 Enneberg,76,,8,10,18
047 Enneberg,77,,10,8,18
047 Enneberg,78,,7,16,23
047 Enneberg,79,,9,10,19
047 Enneberg,80,,12,12,24
047 Enneberg,81,,4,7,11
047 Enneberg,82,,7,9,16
047 Enneberg,83,,5,5,10
047 Enneberg,84,,5,7,12
047 Enneberg,85,,9,8,17
047 Enneberg,86,,2,5,7
047 Enneberg,87,,1,7,8
047 Enneberg,88,,6,5,11
047 Enneberg,89,,1,5,6
047 Enneberg,90,,3,2,5
047 Enneberg,91,,-,2,2
047 Enneberg,92,,-,4,4
047 Enneberg,93,,-,2,2
047 Enneberg,94,,1,4,5
047 Enneberg,95,,-,2,2
047 Enneberg,96,,1,3,4
048 Marling,0,,15,11,26
048 Marling,1,,15,8,23
048 Marling,2,,10,11,21
048 Marling,3,,16,12,28
048 Marling,4,,11,17,28
048 Marling,5,,27,15,42
048 Marling,6,,14,14,28
048 Marling,7,,11,9,20
048 Marling,8,,17,15,32
048 Marling,9,,9,16,25
048 Marling,10,,14,14,28
048 Marling,11,,14,8,22
048 Marling,12,,11,11,22
048 Marling,13,,13,9,22
048 Marling,14,,12,14,26
048 Marling,15,,18,12,30
048 Marling,16,,10,8,18
048 Marling,17,,17,8,25
048 Marling,18,,17,14,31
048 Marling,19,,13,14,27
048 Marling,20,,12,20,32
048 Marling,21,,11,18,29
048 Marling,22,,17,16,33
048 Marling,23,,7,16,23
048 Marling,24,,12,9,21
048 Marling,25,,11,23,34
048 Marling,26,,15,8,23
048 Marling,27,,12,20,32
048 Marling,28,,18,10,28
048 Marling,29,,19,13,32
048 Marling,30,,21,15,36
048 Marling,31,,17,27,44
048 Marling,32,,21,16,37
048 Marling,33,,16,15,31
048 Marling,34,,18,24,42
048 Marling,35,,22,14,36
048 Marling,36,,19,11,30
048 Marling,37,,17,21,38
048 Marling,38,,18,19,37
048 Marling,39,,23,16,39
048 Marling,40,,21,21,42
048 Marling,41,,22,20,42
048 Marling,42,,29,20,49
048 Marling,43,,17,18,35
048 Marling,44,,24,27,51
048 Marling,45,,26,18,44
048 Marling,46,,28,21,49
048 Marling,47,,27,31,58
048 Marling,48,,22,19,41
048 Marling,49,,24,13,37
048 Marling,50,,19,22,41
048 Marling,51,,20,17,37
048 Marling,52,,18,13,31
048 Marling,53,,14,9,23
048 Marling,54,,10,13,23
048 Marling,55,,12,9,21
048 Marling,56,,16,13,29
048 Marling,57,,13,16,29
048 Marling,58,,16,16,32
048 Marling,59,,7,16,23
048 Marling,60,,15,14,29
048 Marling,61,,19,19,38
048 Marling,62,,5,14,19
048 Marling,63,,16,13,29
048 Marling,64,,12,15,27
048 Marling,65,,21,13,34
048 Marling,66,,15,16,31
048 Marling,67,,9,17,26
048 Marling,68,,9,11,20
048 Marling,69,,19,18,37
048 Marling,70,,12,12,24
048 Marling,71,,14,16,30
048 Marling,72,,8,13,21
048 Marling,73,,11,15,26
048 Marling,74,,16,8,24
048 Marling,75,,3,17,20
048 Marling,76,,10,8,18
048 Marling,77,,7,12,19
048 Marling,78,,8,10,18
048 Marling,79,,8,8,16
048 Marling,80,,3,8,11
048 Marling,81,,6,5,11
048 Marling,82,,6,1,7
048 Marling,83,,7,7,14
048 Marling,84,,1,8,9
048 Marling,85,,1,10,11
048 Marling,86,,-,5,5
048 Marling,87,,2,5,7
048 Marling,88,,2,2,4
048 Marling,89,,3,3,6
048 Marling,90,,-,1,1
048 Marling,91,,2,2,4
048 Marling,92,,1,1,2
048 Marling,94,,-,1,1
048 Marling,95,,1,1,2
048 Marling,96,,1,-,1
048 Marling,97,,-,2,2
048 Marling,98,,1,-,1
049 Martell,0,,8,4,12
049 Martell,1,,3,4,7
049 Martell,2,,6,1,7
049 Martell,3,,7,-,7
049 Martell,4,,5,5,10
049 Martell,5,,8,2,10
049 Martell,6,,7,1,8
049 Martell,7,,5,5,10
049 Martell,8,,4,5,9
049 Martell,9,,4,7,11
049 Martell,10,,7,3,10
049 Martell,11,,3,7,10
049 Martell,12,,6,7,13
049 Martell,13,,5,9,14
049 Martell,14,,4,6,10
049 Martell,15,,6,8,14
049 Martell,16,,6,8,14
049 Martell,17,,6,5,11
049 Martell,18,,4,5,9
049 Martell,19,,8,5,13
049 Martell,20,,6,5,11
049 Martell,21,,9,4,13
049 Martell,22,,4,1,5
049 Martell,23,,8,5,13
049 Martell,24,,-,3,3
049 Martell,25,,3,6,9
049 Martell,26,,5,2,7
049 Martell,27,,7,4,11
049 Martell,28,,5,8,13
049 Martell,29,,6,6,12
049 Martell,30,,9,3,12
049 Martell,31,,8,5,13
049 Martell,32,,3,4,7
049 Martell,33,,7,5,12
049 Martell,34,,5,4,9
049 Martell,35,,1,7,8
049 Martell,36,,7,10,17
049 Martell,37,,8,5,13
049 Martell,38,,4,8,12
049 Martell,39,,9,5,14
049 Martell,40,,8,4,12
049 Martell,41,,6,14,20
049 Martell,42,,9,6,15
049 Martell,43,,4,7,11
049 Martell,44,,16,7,23
049 Martell,45,,17,11,28
049 Martell,46,,7,9,16
049 Martell,47,,13,1,14
049 Martell,48,,11,8,19
049 Martell,49,,7,5,12
049 Martell,50,,9,3,12
049 Martell,51,,8,6,14
049 Martell,52,,8,6,14
049 Martell,53,,7,3,10
049 Martell,54,,5,3,8
049 Martell,55,,7,3,10
049 Martell,56,,5,5,10
049 Martell,57,,4,5,9
049 Martell,58,,3,3,6
049 Martell,59,,6,7,13
049 Martell,60,,2,5,7
049 Martell,61,,3,1,4
049 Martell,62,,5,4,9
049 Martell,63,,4,3,7
049 Martell,64,,3,-,3
049 Martell,65,,4,1,5
049 Martell,66,,1,3,4
049 Martell,67,,3,4,7
049 Martell,68,,6,5,11
049 Martell,69,,3,4,7
049 Martell,70,,6,2,8
049 Martell,71,,2,4,6
049 Martell,72,,2,5,7
049 Martell,73,,2,4,6
049 Martell,74,,3,4,7
049 Martell,75,,4,8,12
049 Martell,76,,6,1,7
049 Martell,77,,4,6,10
049 Martell,78,,2,3,5
049 Martell,79,,4,-,4
049 Martell,80,,5,4,9
049 Martell,81,,2,3,5
049 Martell,82,,1,1,2
049 Martell,83,,2,3,5
049 Martell,84,,-,7,7
049 Martell,85,,2,1,3
049 Martell,86,,2,4,6
049 Martell,87,,-,6,6
049 Martell,88,,1,1,2
049 Martell,95,,-,1,1
049 Martell,96,,-,1,1
049 Martell,99,,1,-,1
050 Mölten,0,,6,11,17
050 Mölten,1,,15,11,26
050 Mölten,2,,10,14,24
050 Mölten,3,,13,11,24
050 Mölten,4,,10,8,18
050 Mölten,5,,9,11,20
050 Mölten,6,,12,11,23
050 Mölten,7,,10,10,20
050 Mölten,8,,15,11,26
050 Mölten,9,,16,17,33
050 Mölten,10,,13,15,28
050 Mölten,11,,12,18,30
050 Mölten,12,,8,16,24
050 Mölten,13,,10,7,17
050 Mölten,14,,16,13,29
050 Mölten,15,,11,10,21
050 Mölten,16,,14,5,19
050 Mölten,17,,12,11,23
050 Mölten,18,,6,12,18
050 Mölten,19,,10,6,16
050 Mölten,20,,12,6,18
050 Mölten,21,,12,6,18
050 Mölten,22,,8,10,18
050 Mölten,23,,9,8,17
050 Mölten,24,,11,6,17
050 Mölten,25,,6,9,15
050 Mölten,26,,7,4,11
050 Mölten,27,,6,11,17
050 Mölten,28,,10,10,20
050 Mölten,29,,13,14,27
050 Mölten,30,,16,7,23
050 Mölten,31,,13,12,25
050 Mölten,32,,11,8,19
050 Mölten,33,,9,13,22
050 Mölten,34,,13,19,32
050 Mölten,35,,22,13,35
050 Mölten,36,,13,10,23
050 Mölten,37,,15,16,31
050 Mölten,38,,10,10,20
050 Mölten,39,,15,15,30
050 Mölten,40,,14,10,24
050 Mölten,41,,16,14,30
050 Mölten,42,,15,17,32
050 Mölten,43,,18,15,33
050 Mölten,44,,17,13,30
050 Mölten,45,,11,18,29
050 Mölten,46,,20,16,36
050 Mölten,47,,19,6,25
050 Mölten,48,,15,9,24
050 Mölten,49,,15,10,25
050 Mölten,50,,10,9,19
050 Mölten,51,,15,5,20
050 Mölten,52,,3,11,14
050 Mölten,53,,7,3,10
050 Mölten,54,,5,9,14
050 Mölten,55,,12,7,19
050 Mölten,56,,6,8,14
050 Mölten,57,,7,7,14
050 Mölten,58,,7,6,13
050 Mölten,59,,5,6,11
050 Mölten,60,,10,9,19
050 Mölten,61,,8,6,14
050 Mölten,62,,7,4,11
050 Mölten,63,,3,7,10
050 Mölten,64,,8,4,12
050 Mölten,65,,7,5,12
050 Mölten,66,,3,7,10
050 Mölten,67,,12,8,20
050 Mölten,68,,6,10,16
050 Mölten,69,,8,4,12
050 Mölten,70,,5,7,12
050 Mölten,71,,5,6,11
050 Mölten,72,,3,3,6
050 Mölten,73,,4,7,11
050 Mölten,74,,2,4,6
050 Mölten,75,,8,6,14
050 Mölten,76,,8,5,13
050 Mölten,77,,6,8,14
050 Mölten,78,,3,5,8
050 Mölten,79,,8,2,10
050 Mölten,80,,6,2,8
050 Mölten,81,,1,5,6
050 Mölten,82,,1,4,5
050 Mölten,83,,1,3,4
050 Mölten,84,,1,4,5
050 Mölten,85,,2,4,6
050 Mölten,86,,1,-,1
050 Mölten,87,,3,2,5
050 Mölten,88,,1,2,3
050 Mölten,89,,-,2,2
050 Mölten,90,,-,5,5
050 Mölten,91,,-,3,3
050 Mölten,95,,-,1,1
050 Mölten,96,,-,1,1
051 Meran,0,,180,183,363
051 Meran,1,,183,166,349
051 Meran,2,,181,170,351
051 Meran,3,,219,189,408
051 Meran,4,,202,198,400
051 Meran,5,,182,167,349
051 Meran,6,,232,168,400
051 Meran,7,,185,169,354
051 Meran,8,,187,159,346
051 Meran,9,,194,182,376
051 Meran,10,,193,167,360
051 Meran,11,,179,191,370
051 Meran,12,,166,154,320
051 Meran,13,,199,172,371
051 Meran,14,,205,169,374
051 Meran,15,,175,166,341
051 Meran,16,,175,198,373
051 Meran,17,,146,162,308
051 Meran,18,,185,151,336
051 Meran,19,,169,201,370
051 Meran,20,,185,165,350
051 Meran,21,,209,171,380
051 Meran,22,,185,154,339
051 Meran,23,,191,184,375
051 Meran,24,,181,168,349
051 Meran,25,,172,237,409
051 Meran,26,,214,215,429
051 Meran,27,,207,228,435
051 Meran,28,,217,218,435
051 Meran,29,,239,223,462
051 Meran,30,,259,209,468
051 Meran,31,,214,215,429
051 Meran,32,,268,230,498
051 Meran,33,,233,265,498
051 Meran,34,,235,285,520
051 Meran,35,,259,284,543
051 Meran,36,,281,308,589
051 Meran,37,,280,300,580
051 Meran,38,,308,298,606
051 Meran,39,,316,289,605
051 Meran,40,,325,324,649
051 Meran,41,,330,331,661
051 Meran,42,,361,349,710
051 Meran,43,,359,340,699
051 Meran,44,,323,303,626
051 Meran,45,,335,338,673
051 Meran,46,,346,306,652
051 Meran,47,,342,296,638
051 Meran,48,,270,298,568
051 Meran,49,,297,305,602
051 Meran,50,,292,277,569
051 Meran,51,,280,249,529
051 Meran,52,,264,249,513
051 Meran,53,,230,262,492
051 Meran,54,,229,234,463
051 Meran,55,,203,231,434
051 Meran,56,,184,232,416
051 Meran,57,,178,232,410
051 Meran,58,,204,225,429
051 Meran,59,,201,218,419
051 Meran,60,,188,227,415
051 Meran,61,,224,247,471
051 Meran,62,,208,261,469
051 Meran,63,,223,281,504
051 Meran,64,,241,292,533
051 Meran,65,,195,209,404
051 Meran,66,,196,228,424
051 Meran,67,,249,236,485
051 Meran,68,,249,295,544
051 Meran,69,,218,279,497
051 Meran,70,,176,225,401
051 Meran,71,,183,242,425
051 Meran,72,,171,222,393
051 Meran,73,,172,220,392
051 Meran,74,,150,197,347
051 Meran,75,,142,197,339
051 Meran,76,,140,177,317
051 Meran,77,,133,160,293
051 Meran,78,,118,176,294
051 Meran,79,,100,155,255
051 Meran,80,,109,173,282
051 Meran,81,,82,132,214
051 Meran,82,,81,157,238
051 Meran,83,,73,121,194
051 Meran,84,,70,146,216
051 Meran,85,,48,135,183
051 Meran,86,,55,123,178
051 Meran,87,,41,113,154
051 Meran,88,,48,109,157
051 Meran,89,,21,111,132
051 Meran,90,,26,87,113
051 Meran,91,,22,50,72
051 Meran,92,,2,32,34
051 Meran,93,,10,28,38
051 Meran,94,,9,16,25
051 Meran,95,,6,25,31
051 Meran,96,,8,29,37
051 Meran,97,,4,11,15
051 Meran,98,,3,16,19
051 Meran,99,,2,3,5
051 Meran,100,,1,6,7
051 Meran,101,,-,5,5
051 Meran,102,,1,3,4
051 Meran,104,,-,1,1
052 Welsberg-Taisten,0,,10,16,26
052 Welsberg-Taisten,1,,13,15,28
052 Welsberg-Taisten,2,,25,20,45
052 Welsberg-Taisten,3,,22,21,43
052 Welsberg-Taisten,4,,11,27,38
052 Welsberg-Taisten,5,,22,26,48
052 Welsberg-Taisten,6,,13,20,33
052 Welsberg-Taisten,7,,18,16,34
052 Welsberg-Taisten,8,,21,22,43
052 Welsberg-Taisten,9,,32,19,51
052 Welsberg-Taisten,10,,19,15,34
052 Welsberg-Taisten,11,,19,22,41
052 Welsberg-Taisten,12,,23,12,35
052 Welsberg-Taisten,13,,19,19,38
052 Welsberg-Taisten,14,,15,17,32
052 Welsberg-Taisten,15,,19,15,34
052 Welsberg-Taisten,16,,13,16,29
052 Welsberg-Taisten,17,,15,22,37
052 Welsberg-Taisten,18,,9,12,21
052 Welsberg-Taisten,19,,20,18,38
052 Welsberg-Taisten,20,,10,19,29
052 Welsberg-Taisten,21,,5,18,23
052 Welsberg-Taisten,22,,12,20,32
052 Welsberg-Taisten,23,,12,14,26
052 Welsberg-Taisten,24,,14,9,23
052 Welsberg-Taisten,25,,9,16,25
052 Welsberg-Taisten,26,,28,15,43
052 Welsberg-Taisten,27,,23,19,42
052 Welsberg-Taisten,28,,15,19,34
052 Welsberg-Taisten,29,,12,16,28
052 Welsberg-Taisten,30,,18,18,36
052 Welsberg-Taisten,31,,24,20,44
052 Welsberg-Taisten,32,,16,17,33
052 Welsberg-Taisten,33,,14,26,40
052 Welsberg-Taisten,34,,20,12,32
052 Welsberg-Taisten,35,,16,23,39
052 Welsberg-Taisten,36,,28,21,49
052 Welsberg-Taisten,37,,26,11,37
052 Welsberg-Taisten,38,,17,31,48
052 Welsberg-Taisten,39,,32,21,53
052 Welsberg-Taisten,40,,28,24,52
052 Welsberg-Taisten,41,,22,22,44
052 Welsberg-Taisten,42,,30,20,50
052 Welsberg-Taisten,43,,32,22,54
052 Welsberg-Taisten,44,,32,21,53
052 Welsberg-Taisten,45,,21,18,39
052 Welsberg-Taisten,46,,36,20,56
052 Welsberg-Taisten,47,,28,24,52
052 Welsberg-Taisten,48,,20,22,42
052 Welsberg-Taisten,49,,16,15,31
052 Welsberg-Taisten,50,,11,16,27
052 Welsberg-Taisten,51,,20,21,41
052 Welsberg-Taisten,52,,26,17,43
052 Welsberg-Taisten,53,,13,19,32
052 Welsberg-Taisten,54,,19,19,38
052 Welsberg-Taisten,55,,16,11,27
052 Welsberg-Taisten,56,,15,14,29
052 Welsberg-Taisten,57,,19,13,32
052 Welsberg-Taisten,58,,17,11,28
052 Welsberg-Taisten,59,,19,11,30
052 Welsberg-Taisten,60,,16,14,30
052 Welsberg-Taisten,61,,15,11,26
052 Welsberg-Taisten,62,,16,17,33
052 Welsberg-Taisten,63,,10,11,21
052 Welsberg-Taisten,64,,12,14,26
052 Welsberg-Taisten,65,,10,12,22
052 Welsberg-Taisten,66,,13,11,24
052 Welsberg-Taisten,67,,10,15,25
052 Welsberg-Taisten,68,,10,14,24
052 Welsberg-Taisten,69,,15,16,31
052 Welsberg-Taisten,70,,6,12,18
052 Welsberg-Taisten,71,,11,10,21
052 Welsberg-Taisten,72,,11,12,23
052 Welsberg-Taisten,73,,8,8,16
052 Welsberg-Taisten,74,,9,10,19
052 Welsberg-Taisten,75,,3,15,18
052 Welsberg-Taisten,76,,17,16,33
052 Welsberg-Taisten,77,,8,9,17
052 Welsberg-Taisten,78,,10,10,20
052 Welsberg-Taisten,79,,6,12,18
052 Welsberg-Taisten,80,,8,7,15
052 Welsberg-Taisten,81,,6,10,16
052 Welsberg-Taisten,82,,5,15,20
052 Welsberg-Taisten,83,,2,11,13
052 Welsberg-Taisten,84,,5,5,10
052 Welsberg-Taisten,85,,-,6,6
052 Welsberg-Taisten,86,,1,5,6
052 Welsberg-Taisten,87,,3,6,9
052 Welsberg-Taisten,88,,2,2,4
052 Welsberg-Taisten,89,,3,4,7
052 Welsberg-Taisten,90,,1,3,4
052 Welsberg-Taisten,91,,-,3,3
052 Welsberg-Taisten,93,,-,1,1
052 Welsberg-Taisten,94,,1,-,1
052 Welsberg-Taisten,95,,1,2,3
052 Welsberg-Taisten,97,,-,1,1
052 Welsberg-Taisten,98,,-,1,1
052 Welsberg-Taisten,99,,-,1,1
053 Montan,0,,14,10,24
053 Montan,1,,7,7,14
053 Montan,2,,11,8,19
053 Montan,3,,7,6,13
053 Montan,4,,8,6,14
053 Montan,5,,9,8,17
053 Montan,6,,7,10,17
053 Montan,7,,10,11,21
053 Montan,8,,5,4,9
053 Montan,9,,14,4,18
053 Montan,10,,10,6,16
053 Montan,11,,7,11,18
053 Montan,12,,9,13,22
053 Montan,13,,8,9,17
053 Montan,14,,14,9,23
053 Montan,15,,16,15,31
053 Montan,16,,13,6,19
053 Montan,17,,5,7,12
053 Montan,18,,6,10,16
053 Montan,19,,14,9,23
053 Montan,20,,11,7,18
053 Montan,21,,11,11,22
053 Montan,22,,12,17,29
053 Montan,23,,11,18,29
053 Montan,24,,14,6,20
053 Montan,25,,10,9,19
053 Montan,26,,7,3,10
053 Montan,27,,12,7,19
053 Montan,28,,9,8,17
053 Montan,29,,12,14,26
053 Montan,30,,8,8,16
053 Montan,31,,13,7,20
053 Montan,32,,11,7,18
053 Montan,33,,8,6,14
053 Montan,34,,9,7,16
053 Montan,35,,10,15,25
053 Montan,36,,9,15,24
053 Montan,37,,15,5,20
053 Montan,38,,8,9,17
053 Montan,39,,12,10,22
053 Montan,40,,15,13,28
053 Montan,41,,15,19,34
053 Montan,42,,14,18,32
053 Montan,43,,11,13,24
053 Montan,44,,15,16,31
053 Montan,45,,25,16,41
053 Montan,46,,16,11,27
053 Montan,47,,12,18,30
053 Montan,48,,15,18,33
053 Montan,49,,19,13,32
053 Montan,50,,14,11,25
053 Montan,51,,14,8,22
053 Montan,52,,13,10,23
053 Montan,53,,13,10,23
053 Montan,54,,8,15,23
053 Montan,55,,9,13,22
053 Montan,56,,14,13,27
053 Montan,57,,12,6,18
053 Montan,58,,12,4,16
053 Montan,59,,8,7,15
053 Montan,60,,4,5,9
053 Montan,61,,8,3,11
053 Montan,62,,5,7,12
053 Montan,63,,8,11,19
053 Montan,64,,5,2,7
053 Montan,65,,5,3,8
053 Montan,66,,2,6,8
053 Montan,67,,5,6,11
053 Montan,68,,7,6,13
053 Montan,69,,6,6,12
053 Montan,70,,8,7,15
053 Montan,71,,4,10,14
053 Montan,72,,6,11,17
053 Montan,73,,2,5,7
053 Montan,74,,7,10,17
053 Montan,75,,1,8,9
053 Montan,76,,2,6,8
053 Montan,77,,14,4,18
053 Montan,78,,5,7,12
053 Montan,79,,7,10,17
053 Montan,80,,8,12,20
053 Montan,81,,5,9,14
053 Montan,82,,5,3,8
053 Montan,83,,3,3,6
053 Montan,84,,5,5,10
053 Montan,85,,1,9,10
053 Montan,86,,1,4,5
053 Montan,87,,-,9,9
053 Montan,88,,3,3,6
053 Montan,89,,-,2,2
053 Montan,90,,1,3,4
053 Montan,91,,-,2,2
053 Montan,92,,-,2,2
053 Montan,95,,-,2,2
054 Moos in Passeier,0,,10,9,19
054 Moos in Passeier,1,,10,16,26
054 Moos in Passeier,2,,15,11,26
054 Moos in Passeier,3,,17,7,24
054 Moos in Passeier,4,,15,9,24
054 Moos in Passeier,5,,17,14,31
054 Moos in Passeier,6,,17,19,36
054 Moos in Passeier,7,,15,10,25
054 Moos in Passeier,8,,21,18,39
054 Moos in Passeier,9,,15,12,27
054 Moos in Passeier,10,,12,18,30
054 Moos in Passeier,11,,24,9,33
054 Moos in Passeier,12,,15,14,29
054 Moos in Passeier,13,,12,17,29
054 Moos in Passeier,14,,18,19,37
054 Moos in Passeier,15,,8,12,20
054 Moos in Passeier,16,,17,20,37
054 Moos in Passeier,17,,17,12,29
054 Moos in Passeier,18,,18,17,35
054 Moos in Passeier,19,,16,19,35
054 Moos in Passeier,20,,15,14,29
054 Moos in Passeier,21,,16,18,34
054 Moos in Passeier,22,,15,13,28
054 Moos in Passeier,23,,15,14,29
054 Moos in Passeier,24,,17,14,31
054 Moos in Passeier,25,,19,10,29
054 Moos in Passeier,26,,18,19,37
054 Moos in Passeier,27,,12,11,23
054 Moos in Passeier,28,,15,19,34
054 Moos in Passeier,29,,14,15,29
054 Moos in Passeier,30,,14,14,28
054 Moos in Passeier,31,,17,11,28
054 Moos in Passeier,32,,19,14,33
054 Moos in Passeier,33,,20,16,36
054 Moos in Passeier,34,,15,8,23
054 Moos in Passeier,35,,16,10,26
054 Moos in Passeier,36,,24,14,38
054 Moos in Passeier,37,,9,21,30
054 Moos in Passeier,38,,17,16,33
054 Moos in Passeier,39,,17,18,35
054 Moos in Passeier,40,,20,11,31
054 Moos in Passeier,41,,16,18,34
054 Moos in Passeier,42,,19,17,36
054 Moos in Passeier,43,,22,17,39
054 Moos in Passeier,44,,23,20,43
054 Moos in Passeier,45,,20,8,28
054 Moos in Passeier,46,,20,11,31
054 Moos in Passeier,47,,15,18,33
054 Moos in Passeier,48,,10,19,29
054 Moos in Passeier,49,,9,7,16
054 Moos in Passeier,50,,15,15,30
054 Moos in Passeier,51,,14,13,27
054 Moos in Passeier,52,,12,13,25
054 Moos in Passeier,53,,19,6,25
054 Moos in Passeier,54,,9,8,17
054 Moos in Passeier,55,,8,8,16
054 Moos in Passeier,56,,14,9,23
054 Moos in Passeier,57,,7,8,15
054 Moos in Passeier,58,,8,3,11
054 Moos in Passeier,59,,9,10,19
054 Moos in Passeier,60,,6,10,16
054 Moos in Passeier,61,,13,9,22
054 Moos in Passeier,62,,6,6,12
054 Moos in Passeier,63,,17,10,27
054 Moos in Passeier,64,,9,8,17
054 Moos in Passeier,65,,9,7,16
054 Moos in Passeier,66,,10,7,17
054 Moos in Passeier,67,,14,11,25
054 Moos in Passeier,68,,5,12,17
054 Moos in Passeier,69,,10,13,23
054 Moos in Passeier,70,,8,10,18
054 Moos in Passeier,71,,5,4,9
054 Moos in Passeier,72,,10,6,16
054 Moos in Passeier,73,,5,6,11
054 Moos in Passeier,74,,8,7,15
054 Moos in Passeier,75,,8,5,13
054 Moos in Passeier,76,,12,13,25
054 Moos in Passeier,77,,5,9,14
054 Moos in Passeier,78,,8,3,11
054 Moos in Passeier,79,,8,6,14
054 Moos in Passeier,80,,7,7,14
054 Moos in Passeier,81,,7,10,17
054 Moos in Passeier,82,,3,9,12
054 Moos in Passeier,83,,4,4,8
054 Moos in Passeier,84,,7,2,9
054 Moos in Passeier,85,,4,6,10
054 Moos in Passeier,86,,3,4,7
054 Moos in Passeier,87,,2,2,4
054 Moos in Passeier,88,,-,3,3
054 Moos in Passeier,89,,-,1,1
054 Moos in Passeier,90,,1,1,2
054 Moos in Passeier,91,,1,2,3
054 Moos in Passeier,93,,1,1,2
054 Moos in Passeier,94,,-,2,2
054 Moos in Passeier,96,,-,1,1
054 Moos in Passeier,98,,-,1,1
054 Moos in Passeier,100,,-,1,1
055 Nals,0,,9,20,29
055 Nals,1,,9,11,20
055 Nals,2,,11,7,18
055 Nals,3,,8,10,18
055 Nals,4,,12,3,15
055 Nals,5,,7,14,21
055 Nals,6,,7,7,14
055 Nals,7,,10,5,15
055 Nals,8,,12,12,24
055 Nals,9,,8,9,17
055 Nals,10,,6,13,19
055 Nals,11,,14,8,22
055 Nals,12,,14,8,22
055 Nals,13,,12,8,20
055 Nals,14,,12,11,23
055 Nals,15,,7,6,13
055 Nals,16,,9,8,17
055 Nals,17,,7,12,19
055 Nals,18,,11,8,19
055 Nals,19,,10,10,20
055 Nals,20,,9,7,16
055 Nals,21,,12,8,20
055 Nals,22,,13,10,23
055 Nals,23,,11,10,21
055 Nals,24,,7,4,11
055 Nals,25,,14,9,23
055 Nals,26,,11,14,25
055 Nals,27,,8,9,17
055 Nals,28,,8,11,19
055 Nals,29,,14,11,25
055 Nals,30,,16,17,33
055 Nals,31,,9,14,23
055 Nals,32,,14,15,29
055 Nals,33,,8,17,25
055 Nals,34,,15,13,28
055 Nals,35,,10,14,24
055 Nals,36,,21,14,35
055 Nals,37,,17,7,24
055 Nals,38,,16,18,34
055 Nals,39,,19,18,37
055 Nals,40,,26,12,38
055 Nals,41,,17,17,34
055 Nals,42,,23,17,40
055 Nals,43,,19,15,34
055 Nals,44,,15,15,30
055 Nals,45,,18,15,33
055 Nals,46,,17,21,38
055 Nals,47,,11,23,34
055 Nals,48,,13,13,26
055 Nals,49,,18,14,32
055 Nals,50,,16,10,26
055 Nals,51,,15,17,32
055 Nals,52,,15,17,32
055 Nals,53,,7,6,13
055 Nals,54,,7,8,15
055 Nals,55,,21,14,35
055 Nals,56,,8,6,14
055 Nals,57,,9,8,17
055 Nals,58,,8,8,16
055 Nals,59,,3,9,12
055 Nals,60,,6,10,16
055 Nals,61,,10,9,19
055 Nals,62,,12,12,24
055 Nals,63,,11,5,16
055 Nals,64,,7,14,21
055 Nals,65,,7,12,19
055 Nals,66,,5,12,17
055 Nals,67,,9,7,16
055 Nals,68,,5,8,13
055 Nals,69,,10,6,16
055 Nals,70,,7,12,19
055 Nals,71,,9,11,20
055 Nals,72,,5,9,14
055 Nals,73,,3,13,16
055 Nals,74,,6,4,10
055 Nals,75,,5,6,11
055 Nals,76,,5,6,11
055 Nals,77,,7,10,17
055 Nals,78,,5,5,10
055 Nals,79,,3,5,8
055 Nals,80,,2,5,7
055 Nals,81,,7,7,14
055 Nals,82,,5,6,11
055 Nals,83,,3,6,9
055 Nals,84,,5,4,9
055 Nals,85,,3,2,5
055 Nals,86,,2,-,2
055 Nals,87,,-,3,3
055 Nals,88,,1,3,4
055 Nals,89,,-,8,8
055 Nals,91,,-,2,2
055 Nals,94,,-,1,1
055 Nals,95,,-,1,1
055 Nals,96,,-,1,1
055 Nals,99,,-,1,1
055 Nals,100,,-,1,1
056 Naturns,0,,41,22,63
056 Naturns,1,,26,26,52
056 Naturns,2,,31,23,54
056 Naturns,3,,33,33,66
056 Naturns,4,,34,31,65
056 Naturns,5,,33,21,54
056 Naturns,6,,36,33,69
056 Naturns,7,,39,23,62
056 Naturns,8,,27,28,55
056 Naturns,9,,32,30,62
056 Naturns,10,,30,26,56
056 Naturns,11,,32,27,59
056 Naturns,12,,29,34,63
056 Naturns,13,,21,18,39
056 Naturns,14,,33,36,69
056 Naturns,15,,44,34,78
056 Naturns,16,,33,38,71
056 Naturns,17,,36,37,73
056 Naturns,18,,30,39,69
056 Naturns,19,,44,38,82
056 Naturns,20,,35,34,69
056 Naturns,21,,39,26,65
056 Naturns,22,,46,34,80
056 Naturns,23,,36,19,55
056 Naturns,24,,28,31,59
056 Naturns,25,,40,27,67
056 Naturns,26,,41,23,64
056 Naturns,27,,34,37,71
056 Naturns,28,,41,48,89
056 Naturns,29,,45,50,95
056 Naturns,30,,37,38,75
056 Naturns,31,,54,36,90
056 Naturns,32,,40,45,85
056 Naturns,33,,39,40,79
056 Naturns,34,,35,37,72
056 Naturns,35,,48,40,88
056 Naturns,36,,44,47,91
056 Naturns,37,,47,51,98
056 Naturns,38,,49,49,98
056 Naturns,39,,41,42,83
056 Naturns,40,,53,42,95
056 Naturns,41,,40,46,86
056 Naturns,42,,47,44,91
056 Naturns,43,,48,46,94
056 Naturns,44,,56,44,100
056 Naturns,45,,36,55,91
056 Naturns,46,,53,38,91
056 Naturns,47,,43,47,90
056 Naturns,48,,38,50,88
056 Naturns,49,,40,47,87
056 Naturns,50,,55,39,94
056 Naturns,51,,44,37,81
056 Naturns,52,,34,36,70
056 Naturns,53,,39,35,74
056 Naturns,54,,42,39,81
056 Naturns,55,,29,32,61
056 Naturns,56,,39,31,70
056 Naturns,57,,36,22,58
056 Naturns,58,,31,36,67
056 Naturns,59,,34,35,69
056 Naturns,60,,28,32,60
056 Naturns,61,,25,19,44
056 Naturns,62,,28,24,52
056 Naturns,63,,11,23,34
056 Naturns,64,,22,30,52
056 Naturns,65,,25,18,43
056 Naturns,66,,19,19,38
056 Naturns,67,,25,34,59
056 Naturns,68,,30,35,65
056 Naturns,69,,37,30,67
056 Naturns,70,,23,19,42
056 Naturns,71,,19,21,40
056 Naturns,72,,20,16,36
056 Naturns,73,,22,21,43
056 Naturns,74,,18,21,39
056 Naturns,75,,17,11,28
056 Naturns,76,,15,18,33
056 Naturns,77,,14,13,27
056 Naturns,78,,9,17,26
056 Naturns,79,,7,20,27
056 Naturns,80,,12,22,34
056 Naturns,81,,11,17,28
056 Naturns,82,,13,12,25
056 Naturns,83,,4,14,18
056 Naturns,84,,11,12,23
056 Naturns,85,,10,15,25
056 Naturns,86,,10,11,21
056 Naturns,87,,2,8,10
056 Naturns,88,,1,6,7
056 Naturns,89,,1,10,11
056 Naturns,90,,1,3,4
056 Naturns,91,,-,4,4
056 Naturns,92,,2,2,4
056 Naturns,93,,1,-,1
056 Naturns,95,,-,1,1
056 Naturns,96,,-,5,5
056 Naturns,97,,1,2,3
056 Naturns,98,,-,1,1
056 Naturns,99,,-,1,1
056 Naturns,101,,-,1,1
057 Natz-Schabs,0,,13,14,27
057 Natz-Schabs,1,,9,25,34
057 Natz-Schabs,2,,19,22,41
057 Natz-Schabs,3,,16,12,28
057 Natz-Schabs,4,,13,17,30
057 Natz-Schabs,5,,14,15,29
057 Natz-Schabs,6,,16,19,35
057 Natz-Schabs,7,,18,19,37
057 Natz-Schabs,8,,24,19,43
057 Natz-Schabs,9,,17,14,31
057 Natz-Schabs,10,,21,17,38
057 Natz-Schabs,11,,15,20,35
057 Natz-Schabs,12,,23,17,40
057 Natz-Schabs,13,,19,17,36
057 Natz-Schabs,14,,22,17,39
057 Natz-Schabs,15,,13,15,28
057 Natz-Schabs,16,,24,16,40
057 Natz-Schabs,17,,18,18,36
057 Natz-Schabs,18,,16,14,30
057 Natz-Schabs,19,,21,22,43
057 Natz-Schabs,20,,15,28,43
057 Natz-Schabs,21,,15,25,40
057 Natz-Schabs,22,,27,15,42
057 Natz-Schabs,23,,20,18,38
057 Natz-Schabs,24,,17,20,37
057 Natz-Schabs,25,,20,25,45
057 Natz-Schabs,26,,19,20,39
057 Natz-Schabs,27,,21,21,42
057 Natz-Schabs,28,,14,26,40
057 Natz-Schabs,29,,26,26,52
057 Natz-Schabs,30,,29,21,50
057 Natz-Schabs,31,,21,18,39
057 Natz-Schabs,32,,17,30,47
057 Natz-Schabs,33,,24,17,41
057 Natz-Schabs,34,,16,22,38
057 Natz-Schabs,35,,22,28,50
057 Natz-Schabs,36,,22,28,50
057 Natz-Schabs,37,,28,23,51
057 Natz-Schabs,38,,24,24,48
057 Natz-Schabs,39,,28,25,53
057 Natz-Schabs,40,,33,27,60
057 Natz-Schabs,41,,31,24,55
057 Natz-Schabs,42,,34,18,52
057 Natz-Schabs,43,,28,23,51
057 Natz-Schabs,44,,34,22,56
057 Natz-Schabs,45,,35,36,71
057 Natz-Schabs,46,,31,30,61
057 Natz-Schabs,47,,26,27,53
057 Natz-Schabs,48,,17,22,39
057 Natz-Schabs,49,,19,18,37
057 Natz-Schabs,50,,29,21,50
057 Natz-Schabs,51,,22,19,41
057 Natz-Schabs,52,,21,18,39
057 Natz-Schabs,53,,19,22,41
057 Natz-Schabs,54,,15,23,38
057 Natz-Schabs,55,,19,16,35
057 Natz-Schabs,56,,10,15,25
057 Natz-Schabs,57,,20,13,33
057 Natz-Schabs,58,,12,10,22
057 Natz-Schabs,59,,15,12,27
057 Natz-Schabs,60,,16,16,32
057 Natz-Schabs,61,,19,15,34
057 Natz-Schabs,62,,15,12,27
057 Natz-Schabs,63,,12,13,25
057 Natz-Schabs,64,,15,11,26
057 Natz-Schabs,65,,9,6,15
057 Natz-Schabs,66,,14,10,24
057 Natz-Schabs,67,,13,7,20
057 Natz-Schabs,68,,12,7,19
057 Natz-Schabs,69,,12,8,20
057 Natz-Schabs,70,,4,6,10
057 Natz-Schabs,71,,1,5,6
057 Natz-Schabs,72,,7,5,12
057 Natz-Schabs,73,,9,6,15
057 Natz-Schabs,74,,7,4,11
057 Natz-Schabs,75,,6,7,13
057 Natz-Schabs,76,,3,3,6
057 Natz-Schabs,77,,6,9,15
057 Natz-Schabs,78,,5,8,13
057 Natz-Schabs,79,,4,4,8
057 Natz-Schabs,80,,4,7,11
057 Natz-Schabs,81,,8,3,11
057 Natz-Schabs,82,,3,6,9
057 Natz-Schabs,83,,1,4,5
057 Natz-Schabs,84,,2,4,6
057 Natz-Schabs,85,,2,1,3
057 Natz-Schabs,86,,-,3,3
057 Natz-Schabs,87,,-,8,8
057 Natz-Schabs,88,,3,2,5
057 Natz-Schabs,89,,2,2,4
057 Natz-Schabs,90,,1,4,5
057 Natz-Schabs,92,,-,2,2
057 Natz-Schabs,93,,-,1,1
057 Natz-Schabs,101,,1,-,1
058 Welschnofen,0,,6,6,12
058 Welschnofen,1,,11,4,15
058 Welschnofen,2,,10,8,18
058 Welschnofen,3,,8,8,16
058 Welschnofen,4,,7,8,15
058 Welschnofen,5,,9,12,21
058 Welschnofen,6,,12,6,18
058 Welschnofen,7,,8,8,16
058 Welschnofen,8,,17,5,22
058 Welschnofen,9,,6,9,15
058 Welschnofen,10,,8,7,15
058 Welschnofen,11,,11,13,24
058 Welschnofen,12,,14,11,25
058 Welschnofen,13,,13,14,27
058 Welschnofen,14,,9,10,19
058 Welschnofen,15,,14,13,27
058 Welschnofen,16,,13,10,23
058 Welschnofen,17,,12,10,22
058 Welschnofen,18,,18,12,30
058 Welschnofen,19,,15,11,26
058 Welschnofen,20,,11,15,26
058 Welschnofen,21,,12,11,23
058 Welschnofen,22,,11,14,25
058 Welschnofen,23,,10,8,18
058 Welschnofen,24,,7,12,19
058 Welschnofen,25,,12,11,23
058 Welschnofen,26,,6,7,13
058 Welschnofen,27,,12,13,25
058 Welschnofen,28,,12,15,27
058 Welschnofen,29,,13,15,28
058 Welschnofen,30,,13,9,22
058 Welschnofen,31,,9,8,17
058 Welschnofen,32,,13,15,28
058 Welschnofen,33,,14,15,29
058 Welschnofen,34,,17,9,26
058 Welschnofen,35,,20,13,33
058 Welschnofen,36,,13,15,28
058 Welschnofen,37,,16,17,33
058 Welschnofen,38,,13,13,26
058 Welschnofen,39,,16,19,35
058 Welschnofen,40,,20,13,33
058 Welschnofen,41,,15,15,30
058 Welschnofen,42,,18,19,37
058 Welschnofen,43,,15,15,30
058 Welschnofen,44,,17,12,29
058 Welschnofen,45,,24,13,37
058 Welschnofen,46,,13,8,21
058 Welschnofen,47,,19,14,33
058 Welschnofen,48,,14,14,28
058 Welschnofen,49,,17,19,36
058 Welschnofen,50,,19,10,29
058 Welschnofen,51,,14,12,26
058 Welschnofen,52,,16,11,27
058 Welschnofen,53,,11,16,27
058 Welschnofen,54,,11,12,23
058 Welschnofen,55,,15,13,28
058 Welschnofen,56,,13,10,23
058 Welschnofen,57,,10,11,21
058 Welschnofen,58,,11,9,20
058 Welschnofen,59,,14,7,21
058 Welschnofen,60,,8,9,17
058 Welschnofen,61,,11,15,26
058 Welschnofen,62,,8,10,18
058 Welschnofen,63,,9,6,15
058 Welschnofen,64,,11,10,21
058 Welschnofen,65,,12,5,17
058 Welschnofen,66,,7,9,16
058 Welschnofen,67,,13,9,22
058 Welschnofen,68,,10,12,22
058 Welschnofen,69,,10,6,16
058 Welschnofen,70,,7,7,14
058 Welschnofen,71,,8,6,14
058 Welschnofen,72,,6,6,12
058 Welschnofen,73,,8,3,11
058 Welschnofen,74,,5,12,17
058 Welschnofen,75,,7,6,13
058 Welschnofen,76,,10,10,20
058 Welschnofen,77,,7,14,21
058 Welschnofen,78,,7,6,13
058 Welschnofen,79,,3,7,10
058 Welschnofen,80,,4,8,12
058 Welschnofen,81,,2,12,14
058 Welschnofen,82,,6,4,10
058 Welschnofen,83,,2,3,5
058 Welschnofen,84,,1,5,6
058 Welschnofen,85,,4,4,8
058 Welschnofen,86,,2,7,9
058 Welschnofen,87,,3,5,8
058 Welschnofen,88,,4,4,8
058 Welschnofen,89,,-,8,8
058 Welschnofen,90,,1,2,3
058 Welschnofen,91,,1,2,3
058 Welschnofen,92,,1,-,1
058 Welschnofen,93,,1,-,1
058 Welschnofen,94,,1,2,3
058 Welschnofen,98,,-,2,2
059 Deutschnofen,0,,20,19,39
059 Deutschnofen,1,,26,19,45
059 Deutschnofen,2,,19,20,39
059 Deutschnofen,3,,17,17,34
059 Deutschnofen,4,,20,25,45
059 Deutschnofen,5,,28,32,60
059 Deutschnofen,6,,18,31,49
059 Deutschnofen,7,,17,35,52
059 Deutschnofen,8,,32,13,45
059 Deutschnofen,9,,23,33,56
059 Deutschnofen,10,,24,26,50
059 Deutschnofen,11,,30,24,54
059 Deutschnofen,12,,33,12,45
059 Deutschnofen,13,,23,30,53
059 Deutschnofen,14,,20,29,49
059 Deutschnofen,15,,27,24,51
059 Deutschnofen,16,,28,14,42
059 Deutschnofen,17,,25,26,51
059 Deutschnofen,18,,35,28,63
059 Deutschnofen,19,,23,18,41
059 Deutschnofen,20,,35,29,64
059 Deutschnofen,21,,26,21,47
059 Deutschnofen,22,,20,35,55
059 Deutschnofen,23,,24,29,53
059 Deutschnofen,24,,31,19,50
059 Deutschnofen,25,,26,22,48
059 Deutschnofen,26,,33,29,62
059 Deutschnofen,27,,27,24,51
059 Deutschnofen,28,,22,34,56
059 Deutschnofen,29,,26,19,45
059 Deutschnofen,30,,29,27,56
059 Deutschnofen,31,,23,23,46
059 Deutschnofen,32,,24,21,45
059 Deutschnofen,33,,34,24,58
059 Deutschnofen,34,,20,22,42
059 Deutschnofen,35,,21,25,46
059 Deutschnofen,36,,29,33,62
059 Deutschnofen,37,,24,29,53
059 Deutschnofen,38,,31,36,67
059 Deutschnofen,39,,29,25,54
059 Deutschnofen,40,,29,30,59
059 Deutschnofen,41,,42,28,70
059 Deutschnofen,42,,23,36,59
059 Deutschnofen,43,,30,28,58
059 Deutschnofen,44,,35,34,69
059 Deutschnofen,45,,35,22,57
059 Deutschnofen,46,,32,31,63
059 Deutschnofen,47,,34,25,59
059 Deutschnofen,48,,25,28,53
059 Deutschnofen,49,,35,21,56
059 Deutschnofen,50,,42,26,68
059 Deutschnofen,51,,31,19,50
059 Deutschnofen,52,,21,28,49
059 Deutschnofen,53,,20,24,44
059 Deutschnofen,54,,32,27,59
059 Deutschnofen,55,,31,21,52
059 Deutschnofen,56,,29,22,51
059 Deutschnofen,57,,22,21,43
059 Deutschnofen,58,,24,21,45
059 Deutschnofen,59,,22,15,37
059 Deutschnofen,60,,18,19,37
059 Deutschnofen,61,,20,15,35
059 Deutschnofen,62,,23,17,40
059 Deutschnofen,63,,13,12,25
059 Deutschnofen,64,,17,21,38
059 Deutschnofen,65,,16,13,29
059 Deutschnofen,66,,16,16,32
059 Deutschnofen,67,,22,21,43
059 Deutschnofen,68,,16,18,34
059 Deutschnofen,69,,16,25,41
059 Deutschnofen,70,,14,17,31
059 Deutschnofen,71,,23,14,37
059 Deutschnofen,72,,14,19,33
059 Deutschnofen,73,,12,7,19
059 Deutschnofen,74,,13,10,23
059 Deutschnofen,75,,9,11,20
059 Deutschnofen,76,,14,10,24
059 Deutschnofen,77,,7,13,20
059 Deutschnofen,78,,13,14,27
059 Deutschnofen,79,,8,9,17
059 Deutschnofen,80,,6,9,15
059 Deutschnofen,81,,6,6,12
059 Deutschnofen,82,,5,19,24
059 Deutschnofen,83,,6,12,18
059 Deutschnofen,84,,9,8,17
059 Deutschnofen,85,,3,16,19
059 Deutschnofen,86,,2,9,11
059 Deutschnofen,87,,3,7,10
059 Deutschnofen,88,,4,9,13
059 Deutschnofen,89,,2,8,10
059 Deutschnofen,90,,1,4,5
059 Deutschnofen,91,,1,2,3
059 Deutschnofen,92,,-,2,2
059 Deutschnofen,93,,-,2,2
059 Deutschnofen,94,,1,1,2
059 Deutschnofen,95,,2,2,4
059 Deutschnofen,96,,-,2,2
059 Deutschnofen,97,,-,2,2
059 Deutschnofen,99,,-,1,1
059 Deutschnofen,100,,1,-,1
060 Auer,0,,22,13,35
060 Auer,1,,21,27,48
060 Auer,2,,12,19,31
060 Auer,3,,21,12,33
060 Auer,4,,15,14,29
060 Auer,5,,28,22,50
060 Auer,6,,22,17,39
060 Auer,7,,21,15,36
060 Auer,8,,31,17,48
060 Auer,9,,18,24,42
060 Auer,10,,21,22,43
060 Auer,11,,18,24,42
060 Auer,12,,21,24,45
060 Auer,13,,20,17,37
060 Auer,14,,21,21,42
060 Auer,15,,17,16,33
060 Auer,16,,23,23,46
060 Auer,17,,12,22,34
060 Auer,18,,18,20,38
060 Auer,19,,28,17,45
060 Auer,20,,16,20,36
060 Auer,21,,18,25,43
060 Auer,22,,20,29,49
060 Auer,23,,27,19,46
060 Auer,24,,20,16,36
060 Auer,25,,25,23,48
060 Auer,26,,20,17,37
060 Auer,27,,20,19,39
060 Auer,28,,23,27,50
060 Auer,29,,21,19,40
060 Auer,30,,19,20,39
060 Auer,31,,23,19,42
060 Auer,32,,15,20,35
060 Auer,33,,19,33,52
060 Auer,34,,22,30,52
060 Auer,35,,22,18,40
060 Auer,36,,32,28,60
060 Auer,37,,27,28,55
060 Auer,38,,18,27,45
060 Auer,39,,45,28,73
060 Auer,40,,29,28,57
060 Auer,41,,23,34,57
060 Auer,42,,34,35,69
060 Auer,43,,28,27,55
060 Auer,44,,40,45,85
060 Auer,45,,34,26,60
060 Auer,46,,32,23,55
060 Auer,47,,32,38,70
060 Auer,48,,27,22,49
060 Auer,49,,33,32,65
060 Auer,50,,28,34,62
060 Auer,51,,38,31,69
060 Auer,52,,35,23,58
060 Auer,53,,19,25,44
060 Auer,54,,28,31,59
060 Auer,55,,12,22,34
060 Auer,56,,23,13,36
060 Auer,57,,17,26,43
060 Auer,58,,17,21,38
060 Auer,59,,15,18,33
060 Auer,60,,17,20,37
060 Auer,61,,14,13,27
060 Auer,62,,30,15,45
060 Auer,63,,17,19,36
060 Auer,64,,17,25,42
060 Auer,65,,12,13,25
060 Auer,66,,22,17,39
060 Auer,67,,13,17,30
060 Auer,68,,14,19,33
060 Auer,69,,19,13,32
060 Auer,70,,10,10,20
060 Auer,71,,12,21,33
060 Auer,72,,17,17,34
060 Auer,73,,8,11,19
060 Auer,74,,12,7,19
060 Auer,75,,9,16,25
060 Auer,76,,14,12,26
060 Auer,77,,3,8,11
060 Auer,78,,3,14,17
060 Auer,79,,8,10,18
060 Auer,80,,6,7,13
060 Auer,81,,8,11,19
060 Auer,82,,8,6,14
060 Auer,83,,5,15,20
060 Auer,84,,-,15,15
060 Auer,85,,10,9,19
060 Auer,86,,6,9,15
060 Auer,87,,7,9,16
060 Auer,88,,2,8,10
060 Auer,89,,2,7,9
060 Auer,90,,2,5,7
060 Auer,91,,2,2,4
060 Auer,92,,-,3,3
060 Auer,93,,-,1,1
060 Auer,94,,-,1,1
060 Auer,97,,1,2,3
061 St.Ulrich,0,,22,23,45
061 St.Ulrich,1,,24,18,42
061 St.Ulrich,2,,33,23,56
061 St.Ulrich,3,,31,33,64
061 St.Ulrich,4,,35,27,62
061 St.Ulrich,5,,32,20,52
061 St.Ulrich,6,,22,30,52
061 St.Ulrich,7,,24,33,57
061 St.Ulrich,8,,25,35,60
061 St.Ulrich,9,,21,22,43
061 St.Ulrich,10,,27,34,61
061 St.Ulrich,11,,43,32,75
061 St.Ulrich,12,,45,36,81
061 St.Ulrich,13,,31,27,58
061 St.Ulrich,14,,31,24,55
061 St.Ulrich,15,,32,30,62
061 St.Ulrich,16,,29,29,58
061 St.Ulrich,17,,23,29,52
061 St.Ulrich,18,,35,30,65
061 St.Ulrich,19,,33,31,64
061 St.Ulrich,20,,26,25,51
061 St.Ulrich,21,,17,20,37
061 St.Ulrich,22,,18,23,41
061 St.Ulrich,23,,27,19,46
061 St.Ulrich,24,,22,19,41
061 St.Ulrich,25,,22,20,42
061 St.Ulrich,26,,20,19,39
061 St.Ulrich,27,,16,17,33
061 St.Ulrich,28,,22,35,57
061 St.Ulrich,29,,24,32,56
061 St.Ulrich,30,,23,34,57
061 St.Ulrich,31,,34,30,64
061 St.Ulrich,32,,24,28,52
061 St.Ulrich,33,,21,20,41
061 St.Ulrich,34,,36,34,70
061 St.Ulrich,35,,40,26,66
061 St.Ulrich,36,,35,34,69
061 St.Ulrich,37,,37,29,66
061 St.Ulrich,38,,39,32,71
061 St.Ulrich,39,,38,38,76
061 St.Ulrich,40,,35,33,68
061 St.Ulrich,41,,42,45,87
061 St.Ulrich,42,,42,47,89
061 St.Ulrich,43,,38,40,78
061 St.Ulrich,44,,34,38,72
061 St.Ulrich,45,,38,33,71
061 St.Ulrich,46,,39,40,79
061 St.Ulrich,47,,37,34,71
061 St.Ulrich,48,,29,34,63
061 St.Ulrich,49,,28,23,51
061 St.Ulrich,50,,33,28,61
061 St.Ulrich,51,,37,27,64
061 St.Ulrich,52,,23,18,41
061 St.Ulrich,53,,24,30,54
061 St.Ulrich,54,,19,28,47
061 St.Ulrich,55,,25,36,61
061 St.Ulrich,56,,27,33,60
061 St.Ulrich,57,,27,21,48
061 St.Ulrich,58,,12,29,41
061 St.Ulrich,59,,25,24,49
061 St.Ulrich,60,,19,26,45
061 St.Ulrich,61,,16,29,45
061 St.Ulrich,62,,29,29,58
061 St.Ulrich,63,,21,25,46
061 St.Ulrich,64,,31,24,55
061 St.Ulrich,65,,17,17,34
061 St.Ulrich,66,,28,32,60
061 St.Ulrich,67,,36,35,71
061 St.Ulrich,68,,29,34,63
061 St.Ulrich,69,,33,43,76
061 St.Ulrich,70,,28,28,56
061 St.Ulrich,71,,16,18,34
061 St.Ulrich,72,,22,23,45
061 St.Ulrich,73,,21,25,46
061 St.Ulrich,74,,22,16,38
061 St.Ulrich,75,,12,25,37
061 St.Ulrich,76,,16,9,25
061 St.Ulrich,77,,15,12,27
061 St.Ulrich,78,,13,21,34
061 St.Ulrich,79,,15,13,28
061 St.Ulrich,80,,19,9,28
061 St.Ulrich,81,,11,4,15
061 St.Ulrich,82,,12,11,23
061 St.Ulrich,83,,11,12,23
061 St.Ulrich,84,,5,12,17
061 St.Ulrich,85,,8,9,17
061 St.Ulrich,86,,3,13,16
061 St.Ulrich,87,,2,13,15
061 St.Ulrich,88,,3,10,13
061 St.Ulrich,89,,4,11,15
061 St.Ulrich,90,,3,9,12
061 St.Ulrich,91,,2,4,6
061 St.Ulrich,92,,1,4,5
061 St.Ulrich,94,,1,1,2
061 St.Ulrich,95,,1,3,4
061 St.Ulrich,96,,1,1,2
061 St.Ulrich,97,,-,4,4
061 St.Ulrich,98,,-,1,1
061 St.Ulrich,100,,-,1,1
062 Partschins,0,,20,20,40
062 Partschins,1,,18,18,36
062 Partschins,2,,24,12,36
062 Partschins,3,,17,20,37
062 Partschins,4,,16,16,32
062 Partschins,5,,18,25,43
062 Partschins,6,,14,23,37
062 Partschins,7,,23,16,39
062 Partschins,8,,27,19,46
062 Partschins,9,,13,16,29
062 Partschins,10,,22,16,38
062 Partschins,11,,14,19,33
062 Partschins,12,,20,10,30
062 Partschins,13,,23,23,46
062 Partschins,14,,12,18,30
062 Partschins,15,,25,17,42
062 Partschins,16,,22,19,41
062 Partschins,17,,25,19,44
062 Partschins,18,,24,16,40
062 Partschins,19,,25,30,55
062 Partschins,20,,21,24,45
062 Partschins,21,,10,27,37
062 Partschins,22,,18,28,46
062 Partschins,23,,17,18,35
062 Partschins,24,,25,17,42
062 Partschins,25,,14,15,29
062 Partschins,26,,18,26,44
062 Partschins,27,,15,25,40
062 Partschins,28,,16,24,40
062 Partschins,29,,23,28,51
062 Partschins,30,,25,28,53
062 Partschins,31,,20,24,44
062 Partschins,32,,21,13,34
062 Partschins,33,,27,18,45
062 Partschins,34,,21,19,40
062 Partschins,35,,29,19,48
062 Partschins,36,,30,26,56
062 Partschins,37,,32,26,58
062 Partschins,38,,27,28,55
062 Partschins,39,,24,33,57
062 Partschins,40,,24,35,59
062 Partschins,41,,38,27,65
062 Partschins,42,,25,35,60
062 Partschins,43,,36,25,61
062 Partschins,44,,37,38,75
062 Partschins,45,,27,28,55
062 Partschins,46,,30,37,67
062 Partschins,47,,36,24,60
062 Partschins,48,,33,23,56
062 Partschins,49,,21,23,44
062 Partschins,50,,26,38,64
062 Partschins,51,,28,23,51
062 Partschins,52,,20,17,37
062 Partschins,53,,26,26,52
062 Partschins,54,,23,20,43
062 Partschins,55,,28,24,52
062 Partschins,56,,14,28,42
062 Partschins,57,,21,19,40
062 Partschins,58,,14,15,29
062 Partschins,59,,20,17,37
062 Partschins,60,,19,21,40
062 Partschins,61,,11,14,25
062 Partschins,62,,17,20,37
062 Partschins,63,,16,19,35
062 Partschins,64,,25,27,52
062 Partschins,65,,13,17,30
062 Partschins,66,,18,15,33
062 Partschins,67,,21,25,46
062 Partschins,68,,14,17,31
062 Partschins,69,,24,28,52
062 Partschins,70,,13,13,26
062 Partschins,71,,12,13,25
062 Partschins,72,,17,15,32
062 Partschins,73,,14,16,30
062 Partschins,74,,13,16,29
062 Partschins,75,,10,9,19
062 Partschins,76,,9,17,26
062 Partschins,77,,10,16,26
062 Partschins,78,,13,10,23
062 Partschins,79,,12,18,30
062 Partschins,80,,9,9,18
062 Partschins,81,,12,8,20
062 Partschins,82,,9,8,17
062 Partschins,83,,10,10,20
062 Partschins,84,,6,8,14
062 Partschins,85,,3,10,13
062 Partschins,86,,3,11,14
062 Partschins,87,,5,7,12
062 Partschins,88,,3,4,7
062 Partschins,89,,9,4,13
062 Partschins,90,,-,3,3
062 Partschins,91,,2,4,6
062 Partschins,92,,1,-,1
062 Partschins,93,,-,2,2
062 Partschins,94,,-,1,1
062 Partschins,95,,-,1,1
062 Partschins,96,,-,1,1
062 Partschins,97,,-,1,1
063 Percha,0,,6,10,16
063 Percha,1,,11,7,18
063 Percha,2,,9,8,17
063 Percha,3,,10,7,17
063 Percha,4,,4,3,7
063 Percha,5,,6,11,17
063 Percha,6,,9,15,24
063 Percha,7,,9,7,16
063 Percha,8,,10,7,17
063 Percha,9,,4,5,9
063 Percha,10,,10,9,19
063 Percha,11,,6,7,13
063 Percha,12,,8,8,16
063 Percha,13,,12,15,27
063 Percha,14,,9,5,14
063 Percha,15,,7,8,15
063 Percha,16,,9,12,21
063 Percha,17,,7,8,15
063 Percha,18,,12,6,18
063 Percha,19,,10,10,20
063 Percha,20,,8,7,15
063 Percha,21,,6,11,17
063 Percha,22,,6,5,11
063 Percha,23,,9,19,28
063 Percha,24,,6,9,15
063 Percha,25,,7,13,20
063 Percha,26,,16,5,21
063 Percha,27,,15,12,27
063 Percha,28,,7,13,20
063 Percha,29,,11,7,18
063 Percha,30,,12,10,22
063 Percha,31,,7,13,20
063 Percha,32,,14,14,28
063 Percha,33,,9,7,16
063 Percha,34,,11,16,27
063 Percha,35,,8,11,19
063 Percha,36,,9,14,23
063 Percha,37,,14,11,25
063 Percha,38,,13,9,22
063 Percha,39,,19,17,36
063 Percha,40,,9,9,18
063 Percha,41,,20,13,33
063 Percha,42,,17,14,31
063 Percha,43,,9,9,18
063 Percha,44,,18,6,24
063 Percha,45,,14,19,33
063 Percha,46,,16,7,23
063 Percha,47,,11,15,26
063 Percha,48,,17,10,27
063 Percha,49,,9,13,22
063 Percha,50,,12,6,18
063 Percha,51,,6,9,15
063 Percha,52,,10,9,19
063 Percha,53,,10,5,15
063 Percha,54,,7,14,21
063 Percha,55,,9,9,18
063 Percha,56,,5,6,11
063 Percha,57,,8,6,14
063 Percha,58,,5,9,14
063 Percha,59,,7,7,14
063 Percha,60,,6,8,14
063 Percha,61,,9,6,15
063 Percha,62,,5,5,10
063 Percha,63,,5,6,11
063 Percha,64,,7,8,15
063 Percha,65,,9,5,14
063 Percha,66,,12,4,16
063 Percha,67,,8,8,16
063 Percha,68,,8,7,15
063 Percha,69,,7,7,14
063 Percha,70,,4,5,9
063 Percha,71,,7,5,12
063 Percha,72,,5,9,14
063 Percha,73,,2,5,7
063 Percha,74,,3,2,5
063 Percha,75,,3,4,7
063 Percha,76,,7,5,12
063 Percha,77,,4,5,9
063 Percha,78,,5,3,8
063 Percha,79,,5,1,6
063 Percha,80,,7,3,10
063 Percha,81,,1,3,4
063 Percha,82,,2,3,5
063 Percha,83,,4,2,6
063 Percha,84,,2,5,7
063 Percha,85,,2,4,6
063 Percha,86,,-,1,1
063 Percha,87,,1,2,3
063 Percha,88,,1,-,1
063 Percha,89,,-,1,1
063 Percha,90,,-,1,1
063 Percha,96,,-,1,1
064 Plaus,0,,5,4,9
064 Plaus,1,,4,4,8
064 Plaus,2,,4,4,8
064 Plaus,3,,4,2,6
064 Plaus,4,,4,1,5
064 Plaus,5,,4,1,5
064 Plaus,6,,5,3,8
064 Plaus,7,,3,3,6
064 Plaus,8,,4,7,11
064 Plaus,9,,8,4,12
064 Plaus,10,,11,4,15
064 Plaus,11,,12,6,18
064 Plaus,12,,6,7,13
064 Plaus,13,,7,5,12
064 Plaus,14,,4,3,7
064 Plaus,15,,2,2,4
064 Plaus,16,,7,1,8
064 Plaus,17,,9,4,13
064 Plaus,18,,7,7,14
064 Plaus,19,,3,9,12
064 Plaus,20,,4,3,7
064 Plaus,21,,5,5,10
064 Plaus,22,,5,3,8
064 Plaus,23,,5,2,7
064 Plaus,24,,1,5,6
064 Plaus,25,,1,5,6
064 Plaus,26,,6,2,8
064 Plaus,27,,1,3,4
064 Plaus,28,,-,4,4
064 Plaus,29,,2,7,9
064 Plaus,30,,6,4,10
064 Plaus,31,,3,5,8
064 Plaus,32,,3,4,7
064 Plaus,33,,2,7,9
064 Plaus,34,,5,3,8
064 Plaus,35,,13,4,17
064 Plaus,36,,6,10,16
064 Plaus,37,,10,5,15
064 Plaus,38,,7,6,13
064 Plaus,39,,7,8,15
064 Plaus,40,,9,4,13
064 Plaus,41,,7,10,17
064 Plaus,42,,4,7,11
064 Plaus,43,,8,10,18
064 Plaus,44,,4,5,9
064 Plaus,45,,14,2,16
064 Plaus,46,,7,9,16
064 Plaus,47,,3,4,7
064 Plaus,48,,9,5,14
064 Plaus,49,,7,3,10
064 Plaus,50,,2,8,10
064 Plaus,51,,7,2,9
064 Plaus,52,,3,3,6
064 Plaus,53,,2,4,6
064 Plaus,54,,3,2,5
064 Plaus,55,,2,5,7
064 Plaus,56,,2,1,3
064 Plaus,57,,3,5,8
064 Plaus,58,,4,2,6
064 Plaus,59,,5,3,8
064 Plaus,60,,2,2,4
064 Plaus,61,,5,3,8
064 Plaus,62,,1,4,5
064 Plaus,63,,2,4,6
064 Plaus,64,,5,1,6
064 Plaus,65,,4,1,5
064 Plaus,66,,2,2,4
064 Plaus,67,,5,1,6
064 Plaus,68,,1,4,5
064 Plaus,69,,3,2,5
064 Plaus,70,,3,1,4
064 Plaus,71,,4,2,6
064 Plaus,72,,1,1,2
064 Plaus,73,,3,3,6
064 Plaus,75,,1,2,3
064 Plaus,76,,4,1,5
064 Plaus,77,,2,3,5
064 Plaus,78,,2,3,5
064 Plaus,79,,-,1,1
064 Plaus,81,,1,1,2
064 Plaus,82,,-,1,1
064 Plaus,83,,1,1,2
064 Plaus,84,,-,1,1
064 Plaus,85,,1,-,1
064 Plaus,86,,-,3,3
064 Plaus,87,,-,1,1
064 Plaus,91,,-,2,2
064 Plaus,92,,-,1,1
064 Plaus,95,,-,1,1
065 Waidbruck,1,,2,3,5
065 Waidbruck,3,,2,-,2
065 Waidbruck,4,,2,-,2
065 Waidbruck,6,,1,1,2
065 Waidbruck,7,,-,2,2
065 Waidbruck,8,,1,1,2
065 Waidbruck,9,,1,-,1
065 Waidbruck,10,,1,2,3
065 Waidbruck,11,,2,1,3
065 Waidbruck,13,,4,3,7
065 Waidbruck,14,,4,1,5
065 Waidbruck,15,,1,2,3
065 Waidbruck,16,,3,2,5
065 Waidbruck,17,,1,1,2
065 Waidbruck,18,,-,4,4
065 Waidbruck,19,,1,-,1
065 Waidbruck,20,,-,2,2
065 Waidbruck,21,,3,1,4
065 Waidbruck,22,,-,1,1
065 Waidbruck,23,,1,-,1
065 Waidbruck,24,,-,1,1
065 Waidbruck,25,,1,2,3
065 Waidbruck,26,,2,1,3
065 Waidbruck,27,,2,-,2
065 Waidbruck,28,,1,-,1
065 Waidbruck,29,,2,2,4
065 Waidbruck,30,,1,1,2
065 Waidbruck,32,,4,-,4
065 Waidbruck,33,,-,1,1
065 Waidbruck,35,,1,1,2
065 Waidbruck,36,,4,2,6
065 Waidbruck,37,,-,1,1
065 Waidbruck,38,,1,2,3
065 Waidbruck,39,,1,-,1
065 Waidbruck,40,,1,2,3
065 Waidbruck,41,,3,2,5
065 Waidbruck,42,,2,1,3
065 Waidbruck,43,,2,4,6
065 Waidbruck,44,,3,3,6
065 Waidbruck,45,,3,1,4
065 Waidbruck,46,,3,-,3
065 Waidbruck,47,,-,2,2
065 Waidbruck,48,,1,-,1
065 Waidbruck,49,,1,2,3
065 Waidbruck,50,,5,1,6
065 Waidbruck,51,,2,1,3
065 Waidbruck,52,,-,1,1
065 Waidbruck,53,,4,1,5
065 Waidbruck,54,,2,-,2
065 Waidbruck,55,,3,-,3
065 Waidbruck,58,,1,1,2
065 Waidbruck,59,,-,1,1
065 Waidbruck,64,,-,3,3
065 Waidbruck,65,,1,1,2
065 Waidbruck,66,,2,1,3
065 Waidbruck,68,,1,1,2
065 Waidbruck,69,,-,2,2
065 Waidbruck,70,,-,3,3
065 Waidbruck,71,,1,-,1
065 Waidbruck,72,,-,2,2
065 Waidbruck,73,,1,-,1
065 Waidbruck,74,,2,1,3
065 Waidbruck,75,,-,3,3
065 Waidbruck,76,,2,1,3
065 Waidbruck,77,,1,-,1
065 Waidbruck,78,,-,3,3
065 Waidbruck,79,,1,-,1
065 Waidbruck,80,,1,-,1
065 Waidbruck,81,,-,2,2
065 Waidbruck,82,,1,-,1
065 Waidbruck,83,,2,1,3
065 Waidbruck,84,,-,1,1
065 Waidbruck,85,,1,-,1
065 Waidbruck,87,,-,2,2
065 Waidbruck,90,,-,1,1
065 Waidbruck,91,,-,2,2
065 Waidbruck,96,,-,1,1
066 Burgstall,0,,12,12,24
066 Burgstall,1,,18,6,24
066 Burgstall,2,,14,15,29
066 Burgstall,3,,14,6,20
066 Burgstall,4,,9,13,22
066 Burgstall,5,,6,8,14
066 Burgstall,6,,14,7,21
066 Burgstall,7,,7,10,17
066 Burgstall,8,,8,12,20
066 Burgstall,9,,10,8,18
066 Burgstall,10,,12,11,23
066 Burgstall,11,,9,9,18
066 Burgstall,12,,10,9,19
066 Burgstall,13,,9,6,15
066 Burgstall,14,,7,7,14
066 Burgstall,15,,11,6,17
066 Burgstall,16,,6,4,10
066 Burgstall,17,,7,9,16
066 Burgstall,18,,5,7,12
066 Burgstall,19,,7,9,16
066 Burgstall,20,,14,11,25
066 Burgstall,21,,13,8,21
066 Burgstall,22,,7,11,18
066 Burgstall,23,,10,11,21
066 Burgstall,24,,10,6,16
066 Burgstall,25,,11,12,23
066 Burgstall,26,,8,17,25
066 Burgstall,27,,12,14,26
066 Burgstall,28,,8,11,19
066 Burgstall,29,,8,10,18
066 Burgstall,30,,12,11,23
066 Burgstall,31,,14,10,24
066 Burgstall,32,,6,10,16
066 Burgstall,33,,12,20,32
066 Burgstall,34,,8,10,18
066 Burgstall,35,,19,17,36
066 Burgstall,36,,8,13,21
066 Burgstall,37,,10,18,28
066 Burgstall,38,,14,21,35
066 Burgstall,39,,16,13,29
066 Burgstall,40,,18,15,33
066 Burgstall,41,,16,11,27
066 Burgstall,42,,21,16,37
066 Burgstall,43,,12,13,25
066 Burgstall,44,,16,19,35
066 Burgstall,45,,19,17,36
066 Burgstall,46,,13,12,25
066 Burgstall,47,,18,16,34
066 Burgstall,48,,15,11,26
066 Burgstall,49,,14,18,32
066 Burgstall,50,,16,12,28
066 Burgstall,51,,10,8,18
066 Burgstall,52,,15,9,24
066 Burgstall,53,,9,8,17
066 Burgstall,54,,12,10,22
066 Burgstall,55,,8,11,19
066 Burgstall,56,,10,17,27
066 Burgstall,57,,9,11,20
066 Burgstall,58,,12,13,25
066 Burgstall,59,,13,7,20
066 Burgstall,60,,9,10,19
066 Burgstall,61,,9,7,16
066 Burgstall,62,,7,11,18
066 Burgstall,63,,6,10,16
066 Burgstall,64,,9,9,18
066 Burgstall,65,,7,9,16
066 Burgstall,66,,8,10,18
066 Burgstall,67,,11,8,19
066 Burgstall,68,,5,5,10
066 Burgstall,69,,8,4,12
066 Burgstall,70,,5,12,17
066 Burgstall,71,,6,8,14
066 Burgstall,72,,10,12,22
066 Burgstall,73,,5,9,14
066 Burgstall,74,,5,6,11
066 Burgstall,75,,7,3,10
066 Burgstall,76,,6,8,14
066 Burgstall,77,,8,4,12
066 Burgstall,78,,2,7,9
066 Burgstall,79,,6,3,9
066 Burgstall,80,,4,6,10
066 Burgstall,81,,1,4,5
066 Burgstall,82,,3,5,8
066 Burgstall,83,,1,9,10
066 Burgstall,84,,4,7,11
066 Burgstall,85,,4,3,7
066 Burgstall,86,,1,5,6
066 Burgstall,87,,4,1,5
066 Burgstall,88,,1,5,6
066 Burgstall,90,,1,1,2
066 Burgstall,91,,-,1,1
066 Burgstall,92,,-,1,1
066 Burgstall,93,,1,-,1
066 Burgstall,94,,-,1,1
066 Burgstall,95,,1,1,2
067 Prad am Stilfser Joch,0,,18,10,28
067 Prad am Stilfser Joch,1,,15,14,29
067 Prad am Stilfser Joch,2,,16,17,33
067 Prad am Stilfser Joch,3,,15,10,25
067 Prad am Stilfser Joch,4,,16,18,34
067 Prad am Stilfser Joch,5,,22,16,38
067 Prad am Stilfser Joch,6,,20,21,41
067 Prad am Stilfser Joch,7,,14,15,29
067 Prad am Stilfser Joch,8,,11,17,28
067 Prad am Stilfser Joch,9,,24,16,40
067 Prad am Stilfser Joch,10,,17,17,34
067 Prad am Stilfser Joch,11,,19,21,40
067 Prad am Stilfser Joch,12,,19,23,42
067 Prad am Stilfser Joch,13,,26,17,43
067 Prad am Stilfser Joch,14,,22,21,43
067 Prad am Stilfser Joch,15,,20,13,33
067 Prad am Stilfser Joch,16,,23,28,51
067 Prad am Stilfser Joch,17,,23,29,52
067 Prad am Stilfser Joch,18,,18,21,39
067 Prad am Stilfser Joch,19,,21,11,32
067 Prad am Stilfser Joch,20,,20,22,42
067 Prad am Stilfser Joch,21,,20,20,40
067 Prad am Stilfser Joch,22,,30,17,47
067 Prad am Stilfser Joch,23,,13,20,33
067 Prad am Stilfser Joch,24,,25,28,53
067 Prad am Stilfser Joch,25,,29,24,53
067 Prad am Stilfser Joch,26,,32,26,58
067 Prad am Stilfser Joch,27,,28,27,55
067 Prad am Stilfser Joch,28,,27,22,49
067 Prad am Stilfser Joch,29,,21,24,45
067 Prad am Stilfser Joch,30,,29,21,50
067 Prad am Stilfser Joch,31,,18,20,38
067 Prad am Stilfser Joch,32,,20,19,39
067 Prad am Stilfser Joch,33,,22,29,51
067 Prad am Stilfser Joch,34,,26,22,48
067 Prad am Stilfser Joch,35,,21,20,41
067 Prad am Stilfser Joch,36,,31,15,46
067 Prad am Stilfser Joch,37,,20,41,61
067 Prad am Stilfser Joch,38,,25,25,50
067 Prad am Stilfser Joch,39,,27,26,53
067 Prad am Stilfser Joch,40,,27,24,51
067 Prad am Stilfser Joch,41,,29,29,58
067 Prad am Stilfser Joch,42,,32,34,66
067 Prad am Stilfser Joch,43,,26,23,49
067 Prad am Stilfser Joch,44,,36,26,62
067 Prad am Stilfser Joch,45,,34,26,60
067 Prad am Stilfser Joch,46,,24,26,50
067 Prad am Stilfser Joch,47,,27,10,37
067 Prad am Stilfser Joch,48,,28,32,60
067 Prad am Stilfser Joch,49,,22,26,48
067 Prad am Stilfser Joch,50,,18,26,44
067 Prad am Stilfser Joch,51,,34,16,50
067 Prad am Stilfser Joch,52,,19,28,47
067 Prad am Stilfser Joch,53,,27,26,53
067 Prad am Stilfser Joch,54,,24,25,49
067 Prad am Stilfser Joch,55,,24,18,42
067 Prad am Stilfser Joch,56,,28,16,44
067 Prad am Stilfser Joch,57,,26,18,44
067 Prad am Stilfser Joch,58,,14,20,34
067 Prad am Stilfser Joch,59,,18,24,42
067 Prad am Stilfser Joch,60,,19,17,36
067 Prad am Stilfser Joch,61,,21,21,42
067 Prad am Stilfser Joch,62,,20,11,31
067 Prad am Stilfser Joch,63,,15,12,27
067 Prad am Stilfser Joch,64,,17,14,31
067 Prad am Stilfser Joch,65,,15,11,26
067 Prad am Stilfser Joch,66,,11,15,26
067 Prad am Stilfser Joch,67,,23,17,40
067 Prad am Stilfser Joch,68,,14,16,30
067 Prad am Stilfser Joch,69,,25,8,33
067 Prad am Stilfser Joch,70,,7,17,24
067 Prad am Stilfser Joch,71,,13,16,29
067 Prad am Stilfser Joch,72,,16,15,31
067 Prad am Stilfser Joch,73,,8,11,19
067 Prad am Stilfser Joch,74,,9,10,19
067 Prad am Stilfser Joch,75,,15,12,27
067 Prad am Stilfser Joch,76,,6,21,27
067 Prad am Stilfser Joch,77,,12,10,22
067 Prad am Stilfser Joch,78,,8,18,26
067 Prad am Stilfser Joch,79,,6,12,18
067 Prad am Stilfser Joch,80,,11,10,21
067 Prad am Stilfser Joch,81,,10,13,23
067 Prad am Stilfser Joch,82,,6,7,13
067 Prad am Stilfser Joch,83,,4,10,14
067 Prad am Stilfser Joch,84,,4,7,11
067 Prad am Stilfser Joch,85,,5,4,9
067 Prad am Stilfser Joch,86,,2,5,7
067 Prad am Stilfser Joch,87,,2,9,11
067 Prad am Stilfser Joch,88,,1,8,9
067 Prad am Stilfser Joch,89,,2,4,6
067 Prad am Stilfser Joch,90,,1,3,4
067 Prad am Stilfser Joch,91,,3,2,5
067 Prad am Stilfser Joch,92,,-,2,2
067 Prad am Stilfser Joch,93,,-,2,2
067 Prad am Stilfser Joch,94,,-,1,1
067 Prad am Stilfser Joch,95,,1,-,1
067 Prad am Stilfser Joch,96,,-,1,1
067 Prad am Stilfser Joch,98,,1,-,1
068 Prettau,0,,3,1,4
068 Prettau,1,,1,1,2
068 Prettau,2,,7,3,10
068 Prettau,3,,5,2,7
068 Prettau,4,,4,5,9
068 Prettau,5,,2,1,3
068 Prettau,6,,4,5,9
068 Prettau,7,,2,4,6
068 Prettau,8,,1,2,3
068 Prettau,9,,3,5,8
068 Prettau,10,,1,3,4
068 Prettau,11,,6,6,12
068 Prettau,12,,6,3,9
068 Prettau,13,,1,6,7
068 Prettau,14,,1,2,3
068 Prettau,15,,4,4,8
068 Prettau,16,,4,7,11
068 Prettau,17,,3,5,8
068 Prettau,18,,2,3,5
068 Prettau,19,,1,4,5
068 Prettau,20,,1,7,8
068 Prettau,21,,-,3,3
068 Prettau,22,,4,3,7
068 Prettau,23,,4,2,6
068 Prettau,24,,1,2,3
068 Prettau,25,,2,1,3
068 Prettau,26,,3,7,10
068 Prettau,27,,4,1,5
068 Prettau,28,,3,2,5
068 Prettau,29,,2,-,2
068 Prettau,30,,4,4,8
068 Prettau,31,,5,2,7
068 Prettau,32,,2,2,4
068 Prettau,33,,3,4,7
068 Prettau,34,,1,2,3
068 Prettau,35,,4,2,6
068 Prettau,36,,4,1,5
068 Prettau,37,,5,6,11
068 Prettau,38,,9,4,13
068 Prettau,39,,4,6,10
068 Prettau,40,,3,6,9
068 Prettau,41,,6,6,12
068 Prettau,42,,3,1,4
068 Prettau,43,,10,3,13
068 Prettau,44,,7,1,8
068 Prettau,45,,4,8,12
068 Prettau,46,,7,6,13
068 Prettau,47,,5,6,11
068 Prettau,48,,2,5,7
068 Prettau,49,,5,5,10
068 Prettau,50,,7,4,11
068 Prettau,51,,5,2,7
068 Prettau,52,,7,-,7
068 Prettau,53,,4,1,5
068 Prettau,54,,5,5,10
068 Prettau,55,,6,5,11
068 Prettau,56,,5,2,7
068 Prettau,57,,3,3,6
068 Prettau,58,,4,3,7
068 Prettau,59,,3,2,5
068 Prettau,60,,2,2,4
068 Prettau,61,,2,3,5
068 Prettau,62,,2,1,3
068 Prettau,63,,4,6,10
068 Prettau,64,,6,4,10
068 Prettau,65,,1,3,4
068 Prettau,66,,6,5,11
068 Prettau,67,,4,3,7
068 Prettau,68,,3,2,5
068 Prettau,69,,3,2,5
068 Prettau,70,,4,4,8
068 Prettau,71,,5,3,8
068 Prettau,72,,5,6,11
068 Prettau,73,,2,6,8
068 Prettau,74,,3,3,6
068 Prettau,75,,3,2,5
068 Prettau,76,,1,3,4
068 Prettau,77,,3,3,6
068 Prettau,78,,3,-,3
068 Prettau,79,,1,1,2
068 Prettau,80,,4,4,8
068 Prettau,81,,4,5,9
068 Prettau,82,,-,1,1
068 Prettau,83,,3,1,4
068 Prettau,84,,1,5,6
068 Prettau,85,,-,1,1
068 Prettau,87,,-,1,1
068 Prettau,88,,2,-,2
068 Prettau,89,,-,1,1
068 Prettau,92,,1,1,2
068 Prettau,94,,-,2,2
068 Prettau,97,,-,1,1
069 Proveis,0,,1,1,2
069 Proveis,1,,3,2,5
069 Proveis,2,,-,1,1
069 Proveis,3,,1,1,2
069 Proveis,4,,2,-,2
069 Proveis,5,,-,4,4
069 Proveis,6,,2,2,4
069 Proveis,7,,3,1,4
069 Proveis,8,,4,-,4
069 Proveis,9,,1,1,2
069 Proveis,10,,-,1,1
069 Proveis,11,,4,1,5
069 Proveis,12,,2,2,4
069 Proveis,13,,1,3,4
069 Proveis,14,,1,1,2
069 Proveis,15,,-,5,5
069 Proveis,16,,2,-,2
069 Proveis,17,,2,1,3
069 Proveis,18,,3,1,4
069 Proveis,19,,3,2,5
069 Proveis,20,,-,1,1
069 Proveis,21,,1,1,2
069 Proveis,22,,2,3,5
069 Proveis,23,,2,2,4
069 Proveis,24,,3,1,4
069 Proveis,25,,5,-,5
069 Proveis,26,,4,4,8
069 Proveis,27,,3,2,5
069 Proveis,28,,3,-,3
069 Proveis,29,,3,3,6
069 Proveis,31,,3,1,4
069 Proveis,32,,1,2,3
069 Proveis,33,,2,1,3
069 Proveis,34,,1,1,2
069 Proveis,35,,2,1,3
069 Proveis,36,,3,2,5
069 Proveis,37,,2,-,2
069 Proveis,38,,1,1,2
069 Proveis,39,,-,1,1
069 Proveis,40,,3,2,5
069 Proveis,41,,3,4,7
069 Proveis,42,,3,1,4
069 Proveis,43,,2,1,3
069 Proveis,44,,2,2,4
069 Proveis,45,,1,1,2
069 Proveis,46,,2,-,2
069 Proveis,47,,4,2,6
069 Proveis,48,,4,2,6
069 Proveis,49,,3,1,4
069 Proveis,50,,-,4,4
069 Proveis,51,,4,-,4
069 Proveis,52,,1,3,4
069 Proveis,53,,2,2,4
069 Proveis,54,,4,2,6
069 Proveis,55,,4,4,8
069 Proveis,56,,3,2,5
069 Proveis,57,,1,1,2
069 Proveis,58,,2,3,5
069 Proveis,59,,2,-,2
069 Proveis,60,,1,1,2
069 Proveis,61,,1,-,1
069 Proveis,62,,2,1,3
069 Proveis,63,,2,2,4
069 Proveis,64,,3,-,3
069 Proveis,65,,1,-,1
069 Proveis,66,,2,-,2
069 Proveis,67,,2,1,3
069 Proveis,68,,1,1,2
069 Proveis,69,,1,1,2
069 Proveis,70,,2,-,2
069 Proveis,71,,1,3,4
069 Proveis,72,,-,2,2
069 Proveis,73,,1,1,2
069 Proveis,74,,1,1,2
069 Proveis,75,,1,1,2
069 Proveis,77,,-,2,2
069 Proveis,78,,-,1,1
069 Proveis,79,,1,1,2
069 Proveis,81,,2,3,5
069 Proveis,82,,2,1,3
069 Proveis,83,,-,1,1
069 Proveis,86,,1,-,1
069 Proveis,88,,-,1,1
069 Proveis,90,,-,1,1
070 Ratschings,0,,27,28,55
070 Ratschings,1,,23,22,45
070 Ratschings,2,,21,18,39
070 Ratschings,3,,30,24,54
070 Ratschings,4,,28,27,55
070 Ratschings,5,,24,29,53
070 Ratschings,6,,34,25,59
070 Ratschings,7,,34,24,58
070 Ratschings,8,,16,28,44
070 Ratschings,9,,25,36,61
070 Ratschings,10,,37,26,63
070 Ratschings,11,,28,21,49
070 Ratschings,12,,34,19,53
070 Ratschings,13,,38,34,72
070 Ratschings,14,,30,34,64
070 Ratschings,15,,27,26,53
070 Ratschings,16,,24,28,52
070 Ratschings,17,,26,21,47
070 Ratschings,18,,40,30,70
070 Ratschings,19,,24,24,48
070 Ratschings,20,,31,28,59
070 Ratschings,21,,25,20,45
070 Ratschings,22,,32,27,59
070 Ratschings,23,,29,27,56
070 Ratschings,24,,29,29,58
070 Ratschings,25,,31,31,62
070 Ratschings,26,,22,23,45
070 Ratschings,27,,34,22,56
070 Ratschings,28,,34,32,66
070 Ratschings,29,,30,23,53
070 Ratschings,30,,28,33,61
070 Ratschings,31,,33,30,63
070 Ratschings,32,,29,23,52
070 Ratschings,33,,34,25,59
070 Ratschings,34,,19,23,42
070 Ratschings,35,,38,35,73
070 Ratschings,36,,38,27,65
070 Ratschings,37,,36,36,72
070 Ratschings,38,,42,38,80
070 Ratschings,39,,40,42,82
070 Ratschings,40,,33,42,75
070 Ratschings,41,,38,44,82
070 Ratschings,42,,51,41,92
070 Ratschings,43,,36,40,76
070 Ratschings,44,,44,47,91
070 Ratschings,45,,35,43,78
070 Ratschings,46,,51,39,90
070 Ratschings,47,,47,25,72
070 Ratschings,48,,36,43,79
070 Ratschings,49,,35,26,61
070 Ratschings,50,,42,24,66
070 Ratschings,51,,40,25,65
070 Ratschings,52,,29,27,56
070 Ratschings,53,,32,19,51
070 Ratschings,54,,36,23,59
070 Ratschings,55,,13,33,46
070 Ratschings,56,,26,15,41
070 Ratschings,57,,21,24,45
070 Ratschings,58,,19,19,38
070 Ratschings,59,,19,14,33
070 Ratschings,60,,27,21,48
070 Ratschings,61,,21,24,45
070 Ratschings,62,,29,19,48
070 Ratschings,63,,17,17,34
070 Ratschings,64,,21,7,28
070 Ratschings,65,,19,18,37
070 Ratschings,66,,16,11,27
070 Ratschings,67,,16,13,29
070 Ratschings,68,,18,17,35
070 Ratschings,69,,18,17,35
070 Ratschings,70,,15,16,31
070 Ratschings,71,,13,17,30
070 Ratschings,72,,14,19,33
070 Ratschings,73,,14,9,23
070 Ratschings,74,,10,10,20
070 Ratschings,75,,12,15,27
070 Ratschings,76,,10,9,19
070 Ratschings,77,,11,18,29
070 Ratschings,78,,13,11,24
070 Ratschings,79,,9,11,20
070 Ratschings,80,,7,15,22
070 Ratschings,81,,8,19,27
070 Ratschings,82,,6,10,16
070 Ratschings,83,,7,11,18
070 Ratschings,84,,5,9,14
070 Ratschings,85,,5,6,11
070 Ratschings,86,,4,7,11
070 Ratschings,87,,3,5,8
070 Ratschings,88,,1,4,5
070 Ratschings,89,,1,6,7
070 Ratschings,90,,-,5,5
070 Ratschings,91,,1,-,1
070 Ratschings,92,,-,2,2
070 Ratschings,95,,-,1,1
070 Ratschings,96,,-,1,1
071 Rasen-Antholz,0,,12,8,20
071 Rasen-Antholz,1,,19,18,37
071 Rasen-Antholz,2,,19,7,26
071 Rasen-Antholz,3,,19,18,37
071 Rasen-Antholz,4,,17,21,38
071 Rasen-Antholz,5,,26,16,42
071 Rasen-Antholz,6,,14,23,37
071 Rasen-Antholz,7,,11,23,34
071 Rasen-Antholz,8,,14,21,35
071 Rasen-Antholz,9,,20,20,40
071 Rasen-Antholz,10,,25,22,47
071 Rasen-Antholz,11,,14,19,33
071 Rasen-Antholz,12,,20,15,35
071 Rasen-Antholz,13,,27,22,49
071 Rasen-Antholz,14,,26,18,44
071 Rasen-Antholz,15,,8,15,23
071 Rasen-Antholz,16,,20,11,31
071 Rasen-Antholz,17,,17,14,31
071 Rasen-Antholz,18,,25,20,45
071 Rasen-Antholz,19,,15,15,30
071 Rasen-Antholz,20,,14,24,38
071 Rasen-Antholz,21,,20,17,37
071 Rasen-Antholz,22,,18,21,39
071 Rasen-Antholz,23,,26,10,36
071 Rasen-Antholz,24,,17,20,37
071 Rasen-Antholz,25,,24,15,39
071 Rasen-Antholz,26,,21,21,42
071 Rasen-Antholz,27,,15,17,32
071 Rasen-Antholz,28,,23,17,40
071 Rasen-Antholz,29,,15,19,34
071 Rasen-Antholz,30,,18,16,34
071 Rasen-Antholz,31,,19,22,41
071 Rasen-Antholz,32,,16,24,40
071 Rasen-Antholz,33,,13,18,31
071 Rasen-Antholz,34,,25,14,39
071 Rasen-Antholz,35,,17,27,44
071 Rasen-Antholz,36,,24,21,45
071 Rasen-Antholz,37,,30,25,55
071 Rasen-Antholz,38,,25,20,45
071 Rasen-Antholz,39,,24,22,46
071 Rasen-Antholz,40,,25,23,48
071 Rasen-Antholz,41,,26,25,51
071 Rasen-Antholz,42,,23,28,51
071 Rasen-Antholz,43,,27,27,54
071 Rasen-Antholz,44,,29,19,48
071 Rasen-Antholz,45,,35,23,58
071 Rasen-Antholz,46,,31,23,54
071 Rasen-Antholz,47,,18,22,40
071 Rasen-Antholz,48,,28,20,48
071 Rasen-Antholz,49,,20,25,45
071 Rasen-Antholz,50,,21,23,44
071 Rasen-Antholz,51,,27,18,45
071 Rasen-Antholz,52,,23,15,38
071 Rasen-Antholz,53,,21,9,30
071 Rasen-Antholz,54,,19,13,32
071 Rasen-Antholz,55,,19,14,33
071 Rasen-Antholz,56,,14,13,27
071 Rasen-Antholz,57,,14,9,23
071 Rasen-Antholz,58,,12,15,27
071 Rasen-Antholz,59,,12,11,23
071 Rasen-Antholz,60,,13,8,21
071 Rasen-Antholz,61,,14,8,22
071 Rasen-Antholz,62,,14,11,25
071 Rasen-Antholz,63,,9,14,23
071 Rasen-Antholz,64,,9,14,23
071 Rasen-Antholz,65,,11,9,20
071 Rasen-Antholz,66,,10,8,18
071 Rasen-Antholz,67,,13,12,25
071 Rasen-Antholz,68,,11,14,25
071 Rasen-Antholz,69,,14,12,26
071 Rasen-Antholz,70,,10,17,27
071 Rasen-Antholz,71,,15,13,28
071 Rasen-Antholz,72,,13,7,20
071 Rasen-Antholz,73,,8,10,18
071 Rasen-Antholz,74,,9,12,21
071 Rasen-Antholz,75,,8,8,16
071 Rasen-Antholz,76,,11,10,21
071 Rasen-Antholz,77,,8,13,21
071 Rasen-Antholz,78,,10,11,21
071 Rasen-Antholz,79,,11,14,25
071 Rasen-Antholz,80,,4,9,13
071 Rasen-Antholz,81,,9,3,12
071 Rasen-Antholz,82,,2,3,5
071 Rasen-Antholz,83,,4,5,9
071 Rasen-Antholz,84,,4,5,9
071 Rasen-Antholz,85,,7,7,14
071 Rasen-Antholz,86,,4,8,12
071 Rasen-Antholz,87,,-,7,7
071 Rasen-Antholz,88,,1,4,5
071 Rasen-Antholz,89,,4,1,5
071 Rasen-Antholz,90,,1,2,3
071 Rasen-Antholz,91,,-,3,3
071 Rasen-Antholz,92,,-,1,1
071 Rasen-Antholz,93,,-,2,2
071 Rasen-Antholz,94,,-,1,1
071 Rasen-Antholz,95,,1,-,1
071 Rasen-Antholz,96,,1,-,1
072 Ritten,0,,47,38,85
072 Ritten,1,,41,47,88
072 Ritten,2,,35,57,92
072 Ritten,3,,46,49,95
072 Ritten,4,,57,48,105
072 Ritten,5,,47,50,97
072 Ritten,6,,48,52,100
072 Ritten,7,,48,40,88
072 Ritten,8,,36,50,86
072 Ritten,9,,50,46,96
072 Ritten,10,,46,45,91
072 Ritten,11,,51,53,104
072 Ritten,12,,43,43,86
072 Ritten,13,,58,55,113
072 Ritten,14,,41,51,92
072 Ritten,15,,57,42,99
072 Ritten,16,,60,45,105
072 Ritten,17,,59,48,107
072 Ritten,18,,47,69,116
072 Ritten,19,,63,53,116
072 Ritten,20,,62,47,109
072 Ritten,21,,54,42,96
072 Ritten,22,,55,51,106
072 Ritten,23,,49,39,88
072 Ritten,24,,49,44,93
072 Ritten,25,,46,55,101
072 Ritten,26,,48,24,72
072 Ritten,27,,49,53,102
072 Ritten,28,,42,53,95
072 Ritten,29,,50,54,104
072 Ritten,30,,49,51,100
072 Ritten,31,,50,52,102
072 Ritten,32,,46,46,92
072 Ritten,33,,64,36,100
072 Ritten,34,,50,54,104
072 Ritten,35,,58,47,105
072 Ritten,36,,60,64,124
072 Ritten,37,,60,48,108
072 Ritten,38,,53,62,115
072 Ritten,39,,54,63,117
072 Ritten,40,,51,72,123
072 Ritten,41,,49,74,123
072 Ritten,42,,70,62,132
072 Ritten,43,,74,48,122
072 Ritten,44,,62,48,110
072 Ritten,45,,77,42,119
072 Ritten,46,,68,61,129
072 Ritten,47,,62,49,111
072 Ritten,48,,54,60,114
072 Ritten,49,,47,56,103
072 Ritten,50,,64,57,121
072 Ritten,51,,70,54,124
072 Ritten,52,,35,46,81
072 Ritten,53,,41,40,81
072 Ritten,54,,53,46,99
072 Ritten,55,,52,41,93
072 Ritten,56,,37,34,71
072 Ritten,57,,47,33,80
072 Ritten,58,,43,44,87
072 Ritten,59,,43,36,79
072 Ritten,60,,33,42,75
072 Ritten,61,,32,49,81
072 Ritten,62,,49,37,86
072 Ritten,63,,33,30,63
072 Ritten,64,,26,37,63
072 Ritten,65,,20,29,49
072 Ritten,66,,35,40,75
072 Ritten,67,,34,39,73
072 Ritten,68,,41,34,75
072 Ritten,69,,37,37,74
072 Ritten,70,,34,23,57
072 Ritten,71,,37,31,68
072 Ritten,72,,30,33,63
072 Ritten,73,,24,24,48
072 Ritten,74,,19,24,43
072 Ritten,75,,21,27,48
072 Ritten,76,,24,27,51
072 Ritten,77,,12,26,38
072 Ritten,78,,14,20,34
072 Ritten,79,,11,29,40
072 Ritten,80,,9,20,29
072 Ritten,81,,17,17,34
072 Ritten,82,,9,12,21
072 Ritten,83,,12,12,24
072 Ritten,84,,10,14,24
072 Ritten,85,,4,27,31
072 Ritten,86,,11,16,27
072 Ritten,87,,12,22,34
072 Ritten,88,,1,12,13
072 Ritten,89,,4,15,19
072 Ritten,90,,5,12,17
072 Ritten,91,,1,5,6
072 Ritten,92,,-,3,3
072 Ritten,93,,2,2,4
072 Ritten,94,,-,1,1
072 Ritten,95,,2,3,5
072 Ritten,96,,-,2,2
072 Ritten,97,,-,1,1
072 Ritten,98,,1,-,1
072 Ritten,99,,1,1,2
073 Riffian,0,,5,7,12
073 Riffian,1,,6,10,16
073 Riffian,2,,12,6,18
073 Riffian,3,,11,9,20
073 Riffian,4,,4,7,11
073 Riffian,5,,9,8,17
073 Riffian,6,,7,3,10
073 Riffian,7,,8,8,16
073 Riffian,8,,9,6,15
073 Riffian,9,,11,9,20
073 Riffian,10,,10,7,17
073 Riffian,11,,10,9,19
073 Riffian,12,,11,7,18
073 Riffian,13,,10,8,18
073 Riffian,14,,6,8,14
073 Riffian,15,,5,10,15
073 Riffian,16,,6,8,14
073 Riffian,17,,6,7,13
073 Riffian,18,,10,9,19
073 Riffian,19,,11,16,27
073 Riffian,20,,7,7,14
073 Riffian,21,,14,5,19
073 Riffian,22,,8,9,17
073 Riffian,23,,6,9,15
073 Riffian,24,,7,5,12
073 Riffian,25,,9,3,12
073 Riffian,26,,8,8,16
073 Riffian,27,,11,9,20
073 Riffian,28,,11,13,24
073 Riffian,29,,6,8,14
073 Riffian,30,,3,8,11
073 Riffian,31,,8,8,16
073 Riffian,32,,13,6,19
073 Riffian,33,,14,13,27
073 Riffian,34,,10,2,12
073 Riffian,35,,8,15,23
073 Riffian,36,,11,11,22
073 Riffian,37,,9,10,19
073 Riffian,38,,11,24,35
073 Riffian,39,,13,14,27
073 Riffian,40,,7,10,17
073 Riffian,41,,14,14,28
073 Riffian,42,,8,13,21
073 Riffian,43,,12,13,25
073 Riffian,44,,13,5,18
073 Riffian,45,,10,5,15
073 Riffian,46,,11,8,19
073 Riffian,47,,16,13,29
073 Riffian,48,,11,12,23
073 Riffian,49,,9,8,17
073 Riffian,50,,13,6,19
073 Riffian,51,,7,13,20
073 Riffian,52,,8,7,15
073 Riffian,53,,6,9,15
073 Riffian,54,,10,5,15
073 Riffian,55,,3,7,10
073 Riffian,56,,11,6,17
073 Riffian,57,,7,5,12
073 Riffian,58,,7,4,11
073 Riffian,59,,6,10,16
073 Riffian,60,,4,3,7
073 Riffian,61,,6,6,12
073 Riffian,62,,6,2,8
073 Riffian,63,,3,4,7
073 Riffian,64,,2,7,9
073 Riffian,65,,6,3,9
073 Riffian,66,,8,8,16
073 Riffian,67,,6,7,13
073 Riffian,68,,14,7,21
073 Riffian,69,,7,3,10
073 Riffian,70,,4,3,7
073 Riffian,71,,3,9,12
073 Riffian,72,,8,4,12
073 Riffian,73,,4,5,9
073 Riffian,74,,3,4,7
073 Riffian,75,,-,3,3
073 Riffian,76,,-,3,3
073 Riffian,77,,4,5,9
073 Riffian,78,,1,4,5
073 Riffian,79,,3,8,11
073 Riffian,80,,4,4,8
073 Riffian,81,,1,7,8
073 Riffian,82,,2,5,7
073 Riffian,83,,3,4,7
073 Riffian,84,,4,3,7
073 Riffian,85,,3,1,4
073 Riffian,86,,2,2,4
073 Riffian,87,,2,5,7
073 Riffian,88,,1,-,1
073 Riffian,89,,-,4,4
073 Riffian,90,,-,2,2
073 Riffian,93,,-,1,1
073 Riffian,95,,-,1,1
073 Riffian,96,,-,1,1
074 Mühlbach,0,,16,25,41
074 Mühlbach,1,,16,12,28
074 Mühlbach,2,,19,16,35
074 Mühlbach,3,,20,23,43
074 Mühlbach,4,,15,9,24
074 Mühlbach,5,,15,9,24
074 Mühlbach,6,,15,20,35
074 Mühlbach,7,,22,10,32
074 Mühlbach,8,,19,18,37
074 Mühlbach,9,,14,19,33
074 Mühlbach,10,,15,19,34
074 Mühlbach,11,,18,14,32
074 Mühlbach,12,,20,20,40
074 Mühlbach,13,,21,17,38
074 Mühlbach,14,,18,17,35
074 Mühlbach,15,,13,14,27
074 Mühlbach,16,,24,14,38
074 Mühlbach,17,,17,22,39
074 Mühlbach,18,,16,25,41
074 Mühlbach,19,,15,19,34
074 Mühlbach,20,,13,19,32
074 Mühlbach,21,,13,19,32
074 Mühlbach,22,,21,17,38
074 Mühlbach,23,,21,15,36
074 Mühlbach,24,,17,10,27
074 Mühlbach,25,,19,26,45
074 Mühlbach,26,,19,22,41
074 Mühlbach,27,,22,23,45
074 Mühlbach,28,,27,35,62
074 Mühlbach,29,,25,19,44
074 Mühlbach,30,,22,20,42
074 Mühlbach,31,,23,20,43
074 Mühlbach,32,,29,28,57
074 Mühlbach,33,,29,20,49
074 Mühlbach,34,,18,24,42
074 Mühlbach,35,,18,19,37
074 Mühlbach,36,,22,17,39
074 Mühlbach,37,,25,17,42
074 Mühlbach,38,,23,22,45
074 Mühlbach,39,,32,28,60
074 Mühlbach,40,,25,15,40
074 Mühlbach,41,,26,34,60
074 Mühlbach,42,,37,18,55
074 Mühlbach,43,,25,20,45
074 Mühlbach,44,,28,16,44
074 Mühlbach,45,,23,22,45
074 Mühlbach,46,,15,24,39
074 Mühlbach,47,,21,20,41
074 Mühlbach,48,,21,18,39
074 Mühlbach,49,,24,23,47
074 Mühlbach,50,,22,16,38
074 Mühlbach,51,,23,19,42
074 Mühlbach,52,,18,13,31
074 Mühlbach,53,,17,21,38
074 Mühlbach,54,,22,24,46
074 Mühlbach,55,,22,18,40
074 Mühlbach,56,,13,21,34
074 Mühlbach,57,,18,18,36
074 Mühlbach,58,,17,22,39
074 Mühlbach,59,,13,20,33
074 Mühlbach,60,,21,17,38
074 Mühlbach,61,,15,13,28
074 Mühlbach,62,,16,14,30
074 Mühlbach,63,,10,19,29
074 Mühlbach,64,,20,11,31
074 Mühlbach,65,,9,7,16
074 Mühlbach,66,,14,12,26
074 Mühlbach,67,,11,11,22
074 Mühlbach,68,,15,13,28
074 Mühlbach,69,,17,17,34
074 Mühlbach,70,,11,11,22
074 Mühlbach,71,,10,17,27
074 Mühlbach,72,,12,7,19
074 Mühlbach,73,,5,11,16
074 Mühlbach,74,,6,6,12
074 Mühlbach,75,,7,9,16
074 Mühlbach,76,,11,13,24
074 Mühlbach,77,,9,10,19
074 Mühlbach,78,,5,7,12
074 Mühlbach,79,,6,10,16
074 Mühlbach,80,,7,7,14
074 Mühlbach,81,,6,2,8
074 Mühlbach,82,,3,16,19
074 Mühlbach,83,,4,7,11
074 Mühlbach,84,,4,7,11
074 Mühlbach,85,,4,6,10
074 Mühlbach,86,,4,5,9
074 Mühlbach,87,,3,4,7
074 Mühlbach,88,,1,8,9
074 Mühlbach,89,,-,3,3
074 Mühlbach,90,,2,7,9
074 Mühlbach,91,,-,4,4
074 Mühlbach,92,,-,1,1
074 Mühlbach,96,,-,1,1
075 Rodeneck,0,,8,5,13
075 Rodeneck,1,,4,7,11
075 Rodeneck,2,,8,10,18
075 Rodeneck,3,,7,7,14
075 Rodeneck,4,,3,3,6
075 Rodeneck,5,,9,8,17
075 Rodeneck,6,,7,4,11
075 Rodeneck,7,,8,7,15
075 Rodeneck,8,,8,3,11
075 Rodeneck,9,,10,3,13
075 Rodeneck,10,,7,14,21
075 Rodeneck,11,,8,11,19
075 Rodeneck,12,,12,7,19
075 Rodeneck,13,,10,8,18
075 Rodeneck,14,,13,8,21
075 Rodeneck,15,,5,9,14
075 Rodeneck,16,,6,12,18
075 Rodeneck,17,,6,7,13
075 Rodeneck,18,,12,10,22
075 Rodeneck,19,,6,7,13
075 Rodeneck,20,,13,8,21
075 Rodeneck,21,,7,6,13
075 Rodeneck,22,,12,8,20
075 Rodeneck,23,,6,6,12
075 Rodeneck,24,,7,11,18
075 Rodeneck,25,,13,9,22
075 Rodeneck,26,,14,9,23
075 Rodeneck,27,,10,9,19
075 Rodeneck,28,,6,3,9
075 Rodeneck,29,,10,5,15
075 Rodeneck,30,,8,11,19
075 Rodeneck,31,,9,4,13
075 Rodeneck,32,,5,7,12
075 Rodeneck,33,,6,6,12
075 Rodeneck,34,,9,8,17
075 Rodeneck,35,,8,8,16
075 Rodeneck,36,,6,5,11
075 Rodeneck,37,,16,9,25
075 Rodeneck,38,,7,9,16
075 Rodeneck,39,,14,5,19
075 Rodeneck,40,,8,10,18
075 Rodeneck,41,,15,12,27
075 Rodeneck,42,,8,11,19
075 Rodeneck,43,,11,10,21
075 Rodeneck,44,,16,8,24
075 Rodeneck,45,,7,8,15
075 Rodeneck,46,,11,13,24
075 Rodeneck,47,,9,10,19
075 Rodeneck,48,,10,12,22
075 Rodeneck,49,,9,12,21
075 Rodeneck,50,,6,10,16
075 Rodeneck,51,,10,6,16
075 Rodeneck,52,,8,4,12
075 Rodeneck,53,,6,7,13
075 Rodeneck,54,,7,4,11
075 Rodeneck,55,,7,6,13
075 Rodeneck,56,,11,4,15
075 Rodeneck,57,,3,1,4
075 Rodeneck,58,,7,4,11
075 Rodeneck,59,,3,3,6
075 Rodeneck,60,,2,8,10
075 Rodeneck,61,,2,5,7
075 Rodeneck,62,,4,7,11
075 Rodeneck,63,,5,4,9
075 Rodeneck,64,,10,7,17
075 Rodeneck,65,,2,5,7
075 Rodeneck,66,,3,5,8
075 Rodeneck,67,,2,2,4
075 Rodeneck,68,,2,6,8
075 Rodeneck,69,,10,3,13
075 Rodeneck,70,,5,4,9
075 Rodeneck,71,,3,9,12
075 Rodeneck,72,,3,3,6
075 Rodeneck,73,,2,4,6
075 Rodeneck,74,,1,4,5
075 Rodeneck,75,,3,2,5
075 Rodeneck,76,,1,10,11
075 Rodeneck,77,,3,-,3
075 Rodeneck,78,,6,5,11
075 Rodeneck,79,,4,2,6
075 Rodeneck,80,,4,5,9
075 Rodeneck,81,,6,1,7
075 Rodeneck,82,,3,4,7
075 Rodeneck,83,,1,3,4
075 Rodeneck,84,,1,4,5
075 Rodeneck,85,,1,5,6
075 Rodeneck,86,,3,2,5
075 Rodeneck,87,,2,1,3
075 Rodeneck,88,,-,2,2
075 Rodeneck,89,,2,-,2
075 Rodeneck,90,,2,-,2
075 Rodeneck,91,,2,-,2
075 Rodeneck,92,,-,2,2
076 Salurn,0,,28,14,42
076 Salurn,1,,19,31,50
076 Salurn,2,,28,21,49
076 Salurn,3,,23,27,50
076 Salurn,4,,23,20,43
076 Salurn,5,,16,25,41
076 Salurn,6,,22,18,40
076 Salurn,7,,27,18,45
076 Salurn,8,,17,17,34
076 Salurn,9,,13,19,32
076 Salurn,10,,19,19,38
076 Salurn,11,,22,13,35
076 Salurn,12,,19,25,44
076 Salurn,13,,13,13,26
076 Salurn,14,,26,24,50
076 Salurn,15,,20,18,38
076 Salurn,16,,21,20,41
076 Salurn,17,,18,18,36
076 Salurn,18,,26,20,46
076 Salurn,19,,13,22,35
076 Salurn,20,,13,16,29
076 Salurn,21,,20,21,41
076 Salurn,22,,19,24,43
076 Salurn,23,,24,21,45
076 Salurn,24,,15,18,33
076 Salurn,25,,16,25,41
076 Salurn,26,,15,22,37
076 Salurn,27,,21,25,46
076 Salurn,28,,23,19,42
076 Salurn,29,,16,28,44
076 Salurn,30,,22,29,51
076 Salurn,31,,17,27,44
076 Salurn,32,,21,24,45
076 Salurn,33,,31,25,56
076 Salurn,34,,25,20,45
076 Salurn,35,,30,25,55
076 Salurn,36,,25,22,47
076 Salurn,37,,26,32,58
076 Salurn,38,,30,26,56
076 Salurn,39,,42,27,69
076 Salurn,40,,28,31,59
076 Salurn,41,,27,29,56
076 Salurn,42,,34,26,60
076 Salurn,43,,25,24,49
076 Salurn,44,,25,26,51
076 Salurn,45,,28,33,61
076 Salurn,46,,34,31,65
076 Salurn,47,,40,28,68
076 Salurn,48,,31,30,61
076 Salurn,49,,30,31,61
076 Salurn,50,,21,28,49
076 Salurn,51,,30,30,60
076 Salurn,52,,31,17,48
076 Salurn,53,,21,23,44
076 Salurn,54,,20,13,33
076 Salurn,55,,20,20,40
076 Salurn,56,,20,18,38
076 Salurn,57,,16,19,35
076 Salurn,58,,29,18,47
076 Salurn,59,,28,19,47
076 Salurn,60,,22,16,38
076 Salurn,61,,26,11,37
076 Salurn,62,,13,23,36
076 Salurn,63,,17,21,38
076 Salurn,64,,22,16,38
076 Salurn,65,,12,10,22
076 Salurn,66,,19,18,37
076 Salurn,67,,16,17,33
076 Salurn,68,,20,16,36
076 Salurn,69,,16,16,32
076 Salurn,70,,14,10,24
076 Salurn,71,,12,9,21
076 Salurn,72,,5,10,15
076 Salurn,73,,12,12,24
076 Salurn,74,,13,20,33
076 Salurn,75,,12,17,29
076 Salurn,76,,10,8,18
076 Salurn,77,,10,7,17
076 Salurn,78,,8,17,25
076 Salurn,79,,5,10,15
076 Salurn,80,,11,10,21
076 Salurn,81,,13,11,24
076 Salurn,82,,6,16,22
076 Salurn,83,,2,15,17
076 Salurn,84,,6,11,17
076 Salurn,85,,5,13,18
076 Salurn,86,,3,11,14
076 Salurn,87,,3,4,7
076 Salurn,88,,4,10,14
076 Salurn,89,,1,6,7
076 Salurn,90,,6,7,13
076 Salurn,91,,1,7,8
076 Salurn,92,,-,3,3
076 Salurn,93,,-,2,2
076 Salurn,95,,1,2,3
076 Salurn,96,,-,1,1
076 Salurn,98,,1,-,1
076 Salurn,99,,-,2,2
077 Innichen,0,,17,10,27
077 Innichen,1,,11,15,26
077 Innichen,2,,22,13,35
077 Innichen,3,,15,16,31
077 Innichen,4,,12,14,26
077 Innichen,5,,14,18,32
077 Innichen,6,,13,12,25
077 Innichen,7,,18,15,33
077 Innichen,8,,16,16,32
077 Innichen,9,,24,17,41
077 Innichen,10,,16,17,33
077 Innichen,11,,11,16,27
077 Innichen,12,,21,14,35
077 Innichen,13,,20,16,36
077 Innichen,14,,16,18,34
077 Innichen,15,,21,11,32
077 Innichen,16,,18,16,34
077 Innichen,17,,23,21,44
077 Innichen,18,,21,16,37
077 Innichen,19,,19,26,45
077 Innichen,20,,17,14,31
077 Innichen,21,,18,20,38
077 Innichen,22,,26,19,45
077 Innichen,23,,20,22,42
077 Innichen,24,,20,17,37
077 Innichen,25,,22,20,42
077 Innichen,26,,21,19,40
077 Innichen,27,,23,22,45
077 Innichen,28,,25,24,49
077 Innichen,29,,15,17,32
077 Innichen,30,,26,18,44
077 Innichen,31,,28,27,55
077 Innichen,32,,12,18,30
077 Innichen,33,,22,24,46
077 Innichen,34,,17,27,44
077 Innichen,35,,19,14,33
077 Innichen,36,,24,16,40
077 Innichen,37,,23,17,40
077 Innichen,38,,23,25,48
077 Innichen,39,,22,19,41
077 Innichen,40,,24,29,53
077 Innichen,41,,20,29,49
077 Innichen,42,,24,23,47
077 Innichen,43,,27,28,55
077 Innichen,44,,27,31,58
077 Innichen,45,,37,31,68
077 Innichen,46,,30,31,61
077 Innichen,47,,28,24,52
077 Innichen,48,,29,23,52
077 Innichen,49,,24,26,50
077 Innichen,50,,30,19,49
077 Innichen,51,,25,21,46
077 Innichen,52,,21,25,46
077 Innichen,53,,17,26,43
077 Innichen,54,,25,14,39
077 Innichen,55,,27,21,48
077 Innichen,56,,23,10,33
077 Innichen,57,,24,17,41
077 Innichen,58,,11,24,35
077 Innichen,59,,12,19,31
077 Innichen,60,,15,20,35
077 Innichen,61,,19,16,35
077 Innichen,62,,16,11,27
077 Innichen,63,,11,15,26
077 Innichen,64,,14,16,30
077 Innichen,65,,10,9,19
077 Innichen,66,,8,13,21
077 Innichen,67,,23,9,32
077 Innichen,68,,17,21,38
077 Innichen,69,,13,20,33
077 Innichen,70,,9,23,32
077 Innichen,71,,12,12,24
077 Innichen,72,,7,11,18
077 Innichen,73,,11,11,22
077 Innichen,74,,8,19,27
077 Innichen,75,,6,19,25
077 Innichen,76,,11,13,24
077 Innichen,77,,9,9,18
077 Innichen,78,,10,18,28
077 Innichen,79,,11,18,29
077 Innichen,80,,15,12,27
077 Innichen,81,,12,14,26
077 Innichen,82,,10,13,23
077 Innichen,83,,3,11,14
077 Innichen,84,,10,10,20
077 Innichen,85,,3,16,19
077 Innichen,86,,5,2,7
077 Innichen,87,,4,9,13
077 Innichen,88,,2,8,10
077 Innichen,89,,3,7,10
077 Innichen,90,,1,7,8
077 Innichen,91,,2,1,3
077 Innichen,92,,-,2,2
077 Innichen,93,,1,-,1
077 Innichen,94,,1,-,1
077 Innichen,95,,-,3,3
077 Innichen,98,,1,1,2
079 Jenesien,0,,16,18,34
079 Jenesien,1,,17,17,34
079 Jenesien,2,,20,22,42
079 Jenesien,3,,21,16,37
079 Jenesien,4,,21,23,44
079 Jenesien,5,,15,17,32
079 Jenesien,6,,18,18,36
079 Jenesien,7,,17,22,39
079 Jenesien,8,,13,17,30
079 Jenesien,9,,17,22,39
079 Jenesien,10,,18,19,37
079 Jenesien,11,,26,23,49
079 Jenesien,12,,17,28,45
079 Jenesien,13,,21,18,39
079 Jenesien,14,,24,11,35
079 Jenesien,15,,25,17,42
079 Jenesien,16,,21,21,42
079 Jenesien,17,,15,18,33
079 Jenesien,18,,27,22,49
079 Jenesien,19,,18,20,38
079 Jenesien,20,,18,13,31
079 Jenesien,21,,18,14,32
079 Jenesien,22,,24,14,38
079 Jenesien,23,,15,22,37
079 Jenesien,24,,17,17,34
079 Jenesien,25,,16,10,26
079 Jenesien,26,,17,14,31
079 Jenesien,27,,18,19,37
079 Jenesien,28,,17,17,34
079 Jenesien,29,,13,16,29
079 Jenesien,30,,17,17,34
079 Jenesien,31,,20,14,34
079 Jenesien,32,,13,17,30
079 Jenesien,33,,17,16,33
079 Jenesien,34,,17,18,35
079 Jenesien,35,,11,19,30
079 Jenesien,36,,21,25,46
079 Jenesien,37,,20,31,51
079 Jenesien,38,,25,26,51
079 Jenesien,39,,30,25,55
079 Jenesien,40,,32,33,65
079 Jenesien,41,,32,19,51
079 Jenesien,42,,18,25,43
079 Jenesien,43,,17,23,40
079 Jenesien,44,,37,29,66
079 Jenesien,45,,36,30,66
079 Jenesien,46,,34,34,68
079 Jenesien,47,,26,25,51
079 Jenesien,48,,25,21,46
079 Jenesien,49,,30,21,51
079 Jenesien,50,,25,12,37
079 Jenesien,51,,23,16,39
079 Jenesien,52,,22,9,31
079 Jenesien,53,,13,18,31
079 Jenesien,54,,16,11,27
079 Jenesien,55,,11,12,23
079 Jenesien,56,,20,13,33
079 Jenesien,57,,13,10,23
079 Jenesien,58,,11,20,31
079 Jenesien,59,,13,9,22
079 Jenesien,60,,12,21,33
079 Jenesien,61,,11,13,24
079 Jenesien,62,,12,7,19
079 Jenesien,63,,13,12,25
079 Jenesien,64,,9,9,18
079 Jenesien,65,,7,14,21
079 Jenesien,66,,13,11,24
079 Jenesien,67,,17,9,26
079 Jenesien,68,,14,10,24
079 Jenesien,69,,15,22,37
079 Jenesien,70,,16,11,27
079 Jenesien,71,,14,18,32
079 Jenesien,72,,16,9,25
079 Jenesien,73,,10,16,26
079 Jenesien,74,,5,18,23
079 Jenesien,75,,6,8,14
079 Jenesien,76,,8,7,15
079 Jenesien,77,,16,10,26
079 Jenesien,78,,5,9,14
079 Jenesien,79,,7,7,14
079 Jenesien,80,,6,13,19
079 Jenesien,81,,4,15,19
079 Jenesien,82,,7,8,15
079 Jenesien,83,,3,8,11
079 Jenesien,84,,7,9,16
079 Jenesien,85,,-,6,6
079 Jenesien,86,,5,4,9
079 Jenesien,87,,3,4,7
079 Jenesien,88,,3,6,9
079 Jenesien,89,,1,1,2
079 Jenesien,90,,3,2,5
079 Jenesien,91,,-,2,2
079 Jenesien,92,,-,1,1
079 Jenesien,94,,-,1,1
079 Jenesien,95,,-,1,1
079 Jenesien,97,,-,1,1
079 Jenesien,102,,-,1,1
080 St.Leonhard in Pass.,0,,23,26,49
080 St.Leonhard in Pass.,1,,20,20,40
080 St.Leonhard in Pass.,2,,24,22,46
080 St.Leonhard in Pass.,3,,21,23,44
080 St.Leonhard in Pass.,4,,19,24,43
080 St.Leonhard in Pass.,5,,26,20,46
080 St.Leonhard in Pass.,6,,18,22,40
080 St.Leonhard in Pass.,7,,26,13,39
080 St.Leonhard in Pass.,8,,21,18,39
080 St.Leonhard in Pass.,9,,26,13,39
080 St.Leonhard in Pass.,10,,22,17,39
080 St.Leonhard in Pass.,11,,21,23,44
080 St.Leonhard in Pass.,12,,20,22,42
080 St.Leonhard in Pass.,13,,23,20,43
080 St.Leonhard in Pass.,14,,23,20,43
080 St.Leonhard in Pass.,15,,23,13,36
080 St.Leonhard in Pass.,16,,21,19,40
080 St.Leonhard in Pass.,17,,27,23,50
080 St.Leonhard in Pass.,18,,24,20,44
080 St.Leonhard in Pass.,19,,19,21,40
080 St.Leonhard in Pass.,20,,24,20,44
080 St.Leonhard in Pass.,21,,37,31,68
080 St.Leonhard in Pass.,22,,21,30,51
080 St.Leonhard in Pass.,23,,29,21,50
080 St.Leonhard in Pass.,24,,35,32,67
080 St.Leonhard in Pass.,25,,21,28,49
080 St.Leonhard in Pass.,26,,26,20,46
080 St.Leonhard in Pass.,27,,29,25,54
080 St.Leonhard in Pass.,28,,27,26,53
080 St.Leonhard in Pass.,29,,25,31,56
080 St.Leonhard in Pass.,30,,20,29,49
080 St.Leonhard in Pass.,31,,27,26,53
080 St.Leonhard in Pass.,32,,32,29,61
080 St.Leonhard in Pass.,33,,31,26,57
080 St.Leonhard in Pass.,34,,14,28,42
080 St.Leonhard in Pass.,35,,29,14,43
080 St.Leonhard in Pass.,36,,36,22,58
080 St.Leonhard in Pass.,37,,30,26,56
080 St.Leonhard in Pass.,38,,28,26,54
080 St.Leonhard in Pass.,39,,33,22,55
080 St.Leonhard in Pass.,40,,22,25,47
080 St.Leonhard in Pass.,41,,25,23,48
080 St.Leonhard in Pass.,42,,33,21,54
080 St.Leonhard in Pass.,43,,28,26,54
080 St.Leonhard in Pass.,44,,33,30,63
080 St.Leonhard in Pass.,45,,30,32,62
080 St.Leonhard in Pass.,46,,26,30,56
080 St.Leonhard in Pass.,47,,22,22,44
080 St.Leonhard in Pass.,48,,23,31,54
080 St.Leonhard in Pass.,49,,28,21,49
080 St.Leonhard in Pass.,50,,31,19,50
080 St.Leonhard in Pass.,51,,27,26,53
080 St.Leonhard in Pass.,52,,24,20,44
080 St.Leonhard in Pass.,53,,21,28,49
080 St.Leonhard in Pass.,54,,25,16,41
080 St.Leonhard in Pass.,55,,23,17,40
080 St.Leonhard in Pass.,56,,18,14,32
080 St.Leonhard in Pass.,57,,29,24,53
080 St.Leonhard in Pass.,58,,20,24,44
080 St.Leonhard in Pass.,59,,24,16,40
080 St.Leonhard in Pass.,60,,16,14,30
080 St.Leonhard in Pass.,61,,22,10,32
080 St.Leonhard in Pass.,62,,23,11,34
080 St.Leonhard in Pass.,63,,17,15,32
080 St.Leonhard in Pass.,64,,16,18,34
080 St.Leonhard in Pass.,65,,9,10,19
080 St.Leonhard in Pass.,66,,13,12,25
080 St.Leonhard in Pass.,67,,9,23,32
080 St.Leonhard in Pass.,68,,8,14,22
080 St.Leonhard in Pass.,69,,13,14,27
080 St.Leonhard in Pass.,70,,18,12,30
080 St.Leonhard in Pass.,71,,19,18,37
080 St.Leonhard in Pass.,72,,11,14,25
080 St.Leonhard in Pass.,73,,16,7,23
080 St.Leonhard in Pass.,74,,18,11,29
080 St.Leonhard in Pass.,75,,9,11,20
080 St.Leonhard in Pass.,76,,8,14,22
080 St.Leonhard in Pass.,77,,10,12,22
080 St.Leonhard in Pass.,78,,7,12,19
080 St.Leonhard in Pass.,79,,5,13,18
080 St.Leonhard in Pass.,80,,6,10,16
080 St.Leonhard in Pass.,81,,7,6,13
080 St.Leonhard in Pass.,82,,5,12,17
080 St.Leonhard in Pass.,83,,3,10,13
080 St.Leonhard in Pass.,84,,4,8,12
080 St.Leonhard in Pass.,85,,4,9,13
080 St.Leonhard in Pass.,86,,4,7,11
080 St.Leonhard in Pass.,87,,5,5,10
080 St.Leonhard in Pass.,88,,2,6,8
080 St.Leonhard in Pass.,89,,1,4,5
080 St.Leonhard in Pass.,90,,1,3,4
080 St.Leonhard in Pass.,91,,-,2,2
080 St.Leonhard in Pass.,93,,-,1,1
080 St.Leonhard in Pass.,95,,1,-,1
080 St.Leonhard in Pass.,96,,-,2,2
080 St.Leonhard in Pass.,98,,-,2,2
081 St.Lorenzen,0,,29,21,50
081 St.Lorenzen,1,,23,23,46
081 St.Lorenzen,2,,23,18,41
081 St.Lorenzen,3,,25,20,45
081 St.Lorenzen,4,,14,18,32
081 St.Lorenzen,5,,27,19,46
081 St.Lorenzen,6,,26,22,48
081 St.Lorenzen,7,,25,19,44
081 St.Lorenzen,8,,18,19,37
081 St.Lorenzen,9,,29,20,49
081 St.Lorenzen,10,,20,30,50
081 St.Lorenzen,11,,28,26,54
081 St.Lorenzen,12,,32,27,59
081 St.Lorenzen,13,,17,30,47
081 St.Lorenzen,14,,30,30,60
081 St.Lorenzen,15,,23,15,38
081 St.Lorenzen,16,,31,20,51
081 St.Lorenzen,17,,25,30,55
081 St.Lorenzen,18,,27,20,47
081 St.Lorenzen,19,,25,15,40
081 St.Lorenzen,20,,26,22,48
081 St.Lorenzen,21,,17,17,34
081 St.Lorenzen,22,,18,29,47
081 St.Lorenzen,23,,22,24,46
081 St.Lorenzen,24,,25,27,52
081 St.Lorenzen,25,,25,24,49
081 St.Lorenzen,26,,31,25,56
081 St.Lorenzen,27,,24,21,45
081 St.Lorenzen,28,,35,21,56
081 St.Lorenzen,29,,25,20,45
081 St.Lorenzen,30,,17,24,41
081 St.Lorenzen,31,,29,31,60
081 St.Lorenzen,32,,27,23,50
081 St.Lorenzen,33,,27,21,48
081 St.Lorenzen,34,,26,15,41
081 St.Lorenzen,35,,25,30,55
081 St.Lorenzen,36,,27,32,59
081 St.Lorenzen,37,,35,31,66
081 St.Lorenzen,38,,35,38,73
081 St.Lorenzen,39,,32,30,62
081 St.Lorenzen,40,,30,30,60
081 St.Lorenzen,41,,23,32,55
081 St.Lorenzen,42,,44,36,80
081 St.Lorenzen,43,,32,39,71
081 St.Lorenzen,44,,37,31,68
081 St.Lorenzen,45,,34,26,60
081 St.Lorenzen,46,,33,23,56
081 St.Lorenzen,47,,35,31,66
081 St.Lorenzen,48,,28,39,67
081 St.Lorenzen,49,,25,37,62
081 St.Lorenzen,50,,32,19,51
081 St.Lorenzen,51,,31,27,58
081 St.Lorenzen,52,,31,32,63
081 St.Lorenzen,53,,22,27,49
081 St.Lorenzen,54,,26,28,54
081 St.Lorenzen,55,,18,17,35
081 St.Lorenzen,56,,15,19,34
081 St.Lorenzen,57,,23,18,41
081 St.Lorenzen,58,,17,10,27
081 St.Lorenzen,59,,17,16,33
081 St.Lorenzen,60,,16,19,35
081 St.Lorenzen,61,,11,22,33
081 St.Lorenzen,62,,15,14,29
081 St.Lorenzen,63,,19,8,27
081 St.Lorenzen,64,,17,10,27
081 St.Lorenzen,65,,11,18,29
081 St.Lorenzen,66,,17,15,32
081 St.Lorenzen,67,,14,16,30
081 St.Lorenzen,68,,17,20,37
081 St.Lorenzen,69,,17,17,34
081 St.Lorenzen,70,,14,12,26
081 St.Lorenzen,71,,12,19,31
081 St.Lorenzen,72,,12,13,25
081 St.Lorenzen,73,,18,16,34
081 St.Lorenzen,74,,12,14,26
081 St.Lorenzen,75,,9,13,22
081 St.Lorenzen,76,,14,10,24
081 St.Lorenzen,77,,11,8,19
081 St.Lorenzen,78,,8,10,18
081 St.Lorenzen,79,,9,13,22
081 St.Lorenzen,80,,7,6,13
081 St.Lorenzen,81,,9,16,25
081 St.Lorenzen,82,,6,14,20
081 St.Lorenzen,83,,4,6,10
081 St.Lorenzen,84,,7,6,13
081 St.Lorenzen,85,,2,9,11
081 St.Lorenzen,86,,2,8,10
081 St.Lorenzen,87,,5,7,12
081 St.Lorenzen,88,,1,4,5
081 St.Lorenzen,89,,2,4,6
081 St.Lorenzen,90,,-,3,3
081 St.Lorenzen,91,,1,2,3
081 St.Lorenzen,92,,-,1,1
081 St.Lorenzen,93,,-,1,1
081 St.Lorenzen,96,,-,1,1
082 St.Martin in Thurn,0,,7,8,15
082 St.Martin in Thurn,1,,6,5,11
082 St.Martin in Thurn,2,,8,3,11
082 St.Martin in Thurn,3,,3,10,13
082 St.Martin in Thurn,4,,9,14,23
082 St.Martin in Thurn,5,,10,9,19
082 St.Martin in Thurn,6,,17,13,30
082 St.Martin in Thurn,7,,4,6,10
082 St.Martin in Thurn,8,,15,8,23
082 St.Martin in Thurn,9,,8,14,22
082 St.Martin in Thurn,10,,7,9,16
082 St.Martin in Thurn,11,,9,19,28
082 St.Martin in Thurn,12,,11,11,22
082 St.Martin in Thurn,13,,16,11,27
082 St.Martin in Thurn,14,,24,14,38
082 St.Martin in Thurn,15,,15,11,26
082 St.Martin in Thurn,16,,15,9,24
082 St.Martin in Thurn,17,,9,9,18
082 St.Martin in Thurn,18,,17,14,31
082 St.Martin in Thurn,19,,11,11,22
082 St.Martin in Thurn,20,,6,16,22
082 St.Martin in Thurn,21,,15,13,28
082 St.Martin in Thurn,22,,7,4,11
082 St.Martin in Thurn,23,,14,11,25
082 St.Martin in Thurn,24,,13,9,22
082 St.Martin in Thurn,25,,11,17,28
082 St.Martin in Thurn,26,,8,5,13
082 St.Martin in Thurn,27,,14,12,26
082 St.Martin in Thurn,28,,14,13,27
082 St.Martin in Thurn,29,,15,7,22
082 St.Martin in Thurn,30,,11,11,22
082 St.Martin in Thurn,31,,9,9,18
082 St.Martin in Thurn,32,,18,10,28
082 St.Martin in Thurn,33,,13,9,22
082 St.Martin in Thurn,34,,13,11,24
082 St.Martin in Thurn,35,,7,9,16
082 St.Martin in Thurn,36,,8,13,21
082 St.Martin in Thurn,37,,11,10,21
082 St.Martin in Thurn,38,,12,9,21
082 St.Martin in Thurn,39,,17,13,30
082 St.Martin in Thurn,40,,12,13,25
082 St.Martin in Thurn,41,,15,16,31
082 St.Martin in Thurn,42,,17,14,31
082 St.Martin in Thurn,43,,10,11,21
082 St.Martin in Thurn,44,,16,26,42
082 St.Martin in Thurn,45,,16,21,37
082 St.Martin in Thurn,46,,11,16,27
082 St.Martin in Thurn,47,,16,14,30
082 St.Martin in Thurn,48,,15,16,31
082 St.Martin in Thurn,49,,14,19,33
082 St.Martin in Thurn,50,,16,5,21
082 St.Martin in Thurn,51,,12,10,22
082 St.Martin in Thurn,52,,12,8,20
082 St.Martin in Thurn,53,,12,9,21
082 St.Martin in Thurn,54,,8,5,13
082 St.Martin in Thurn,55,,13,9,22
082 St.Martin in Thurn,56,,8,8,16
082 St.Martin in Thurn,57,,5,10,15
082 St.Martin in Thurn,58,,3,4,7
082 St.Martin in Thurn,59,,8,8,16
082 St.Martin in Thurn,60,,9,6,15
082 St.Martin in Thurn,61,,3,7,10
082 St.Martin in Thurn,62,,8,6,14
082 St.Martin in Thurn,63,,9,6,15
082 St.Martin in Thurn,64,,8,7,15
082 St.Martin in Thurn,65,,6,4,10
082 St.Martin in Thurn,66,,10,8,18
082 St.Martin in Thurn,67,,4,8,12
082 St.Martin in Thurn,68,,6,6,12
082 St.Martin in Thurn,69,,7,6,13
082 St.Martin in Thurn,70,,4,5,9
082 St.Martin in Thurn,71,,5,7,12
082 St.Martin in Thurn,72,,8,8,16
082 St.Martin in Thurn,73,,5,12,17
082 St.Martin in Thurn,74,,4,6,10
082 St.Martin in Thurn,75,,8,6,14
082 St.Martin in Thurn,76,,6,5,11
082 St.Martin in Thurn,77,,3,9,12
082 St.Martin in Thurn,78,,6,7,13
082 St.Martin in Thurn,79,,7,8,15
082 St.Martin in Thurn,80,,5,6,11
082 St.Martin in Thurn,81,,6,8,14
082 St.Martin in Thurn,82,,2,3,5
082 St.Martin in Thurn,83,,2,5,7
082 St.Martin in Thurn,84,,6,3,9
082 St.Martin in Thurn,85,,6,4,10
082 St.Martin in Thurn,86,,6,7,13
082 St.Martin in Thurn,87,,2,6,8
082 St.Martin in Thurn,88,,6,4,10
082 St.Martin in Thurn,89,,3,1,4
082 St.Martin in Thurn,90,,2,7,9
082 St.Martin in Thurn,91,,1,3,4
082 St.Martin in Thurn,93,,-,1,1
083 St.Martin in Passeier,0,,26,14,40
083 St.Martin in Passeier,1,,15,18,33
083 St.Martin in Passeier,2,,19,25,44
083 St.Martin in Passeier,3,,15,21,36
083 St.Martin in Passeier,4,,24,21,45
083 St.Martin in Passeier,5,,18,19,37
083 St.Martin in Passeier,6,,22,21,43
083 St.Martin in Passeier,7,,18,19,37
083 St.Martin in Passeier,8,,17,14,31
083 St.Martin in Passeier,9,,20,17,37
083 St.Martin in Passeier,10,,12,22,34
083 St.Martin in Passeier,11,,9,21,30
083 St.Martin in Passeier,12,,22,19,41
083 St.Martin in Passeier,13,,26,24,50
083 St.Martin in Passeier,14,,22,20,42
083 St.Martin in Passeier,15,,20,17,37
083 St.Martin in Passeier,16,,21,24,45
083 St.Martin in Passeier,17,,20,23,43
083 St.Martin in Passeier,18,,23,19,42
083 St.Martin in Passeier,19,,23,23,46
083 St.Martin in Passeier,20,,20,25,45
083 St.Martin in Passeier,21,,18,21,39
083 St.Martin in Passeier,22,,16,15,31
083 St.Martin in Passeier,23,,18,28,46
083 St.Martin in Passeier,24,,22,24,46
083 St.Martin in Passeier,25,,19,22,41
083 St.Martin in Passeier,26,,23,29,52
083 St.Martin in Passeier,27,,19,15,34
083 St.Martin in Passeier,28,,22,16,38
083 St.Martin in Passeier,29,,27,22,49
083 St.Martin in Passeier,30,,20,25,45
083 St.Martin in Passeier,31,,19,10,29
083 St.Martin in Passeier,32,,31,16,47
083 St.Martin in Passeier,33,,22,24,46
083 St.Martin in Passeier,34,,21,19,40
083 St.Martin in Passeier,35,,21,20,41
083 St.Martin in Passeier,36,,23,20,43
083 St.Martin in Passeier,37,,24,30,54
083 St.Martin in Passeier,38,,19,21,40
083 St.Martin in Passeier,39,,27,25,52
083 St.Martin in Passeier,40,,30,26,56
083 St.Martin in Passeier,41,,32,27,59
083 St.Martin in Passeier,42,,27,25,52
083 St.Martin in Passeier,43,,23,24,47
083 St.Martin in Passeier,44,,28,32,60
083 St.Martin in Passeier,45,,34,24,58
083 St.Martin in Passeier,46,,17,18,35
083 St.Martin in Passeier,47,,33,21,54
083 St.Martin in Passeier,48,,23,30,53
083 St.Martin in Passeier,49,,34,24,58
083 St.Martin in Passeier,50,,24,23,47
083 St.Martin in Passeier,51,,26,23,49
083 St.Martin in Passeier,52,,26,19,45
083 St.Martin in Passeier,53,,25,12,37
083 St.Martin in Passeier,54,,21,17,38
083 St.Martin in Passeier,55,,30,14,44
083 St.Martin in Passeier,56,,12,11,23
083 St.Martin in Passeier,57,,21,16,37
083 St.Martin in Passeier,58,,6,18,24
083 St.Martin in Passeier,59,,21,14,35
083 St.Martin in Passeier,60,,11,15,26
083 St.Martin in Passeier,61,,14,11,25
083 St.Martin in Passeier,62,,11,12,23
083 St.Martin in Passeier,63,,15,13,28
083 St.Martin in Passeier,64,,12,9,21
083 St.Martin in Passeier,65,,13,11,24
083 St.Martin in Passeier,66,,18,13,31
083 St.Martin in Passeier,67,,12,12,24
083 St.Martin in Passeier,68,,14,14,28
083 St.Martin in Passeier,69,,9,15,24
083 St.Martin in Passeier,70,,4,12,16
083 St.Martin in Passeier,71,,7,13,20
083 St.Martin in Passeier,72,,12,8,20
083 St.Martin in Passeier,73,,14,20,34
083 St.Martin in Passeier,74,,12,14,26
083 St.Martin in Passeier,75,,7,14,21
083 St.Martin in Passeier,76,,16,9,25
083 St.Martin in Passeier,77,,11,9,20
083 St.Martin in Passeier,78,,3,9,12
083 St.Martin in Passeier,79,,4,11,15
083 St.Martin in Passeier,80,,4,10,14
083 St.Martin in Passeier,81,,9,10,19
083 St.Martin in Passeier,82,,5,6,11
083 St.Martin in Passeier,83,,7,3,10
083 St.Martin in Passeier,84,,1,10,11
083 St.Martin in Passeier,85,,4,3,7
083 St.Martin in Passeier,86,,2,10,12
083 St.Martin in Passeier,87,,1,6,7
083 St.Martin in Passeier,88,,-,4,4
083 St.Martin in Passeier,89,,-,8,8
083 St.Martin in Passeier,90,,1,3,4
083 St.Martin in Passeier,91,,1,2,3
083 St.Martin in Passeier,92,,-,2,2
083 St.Martin in Passeier,93,,-,2,2
083 St.Martin in Passeier,94,,-,1,1
083 St.Martin in Passeier,95,,1,-,1
083 St.Martin in Passeier,96,,-,1,1
083 St.Martin in Passeier,99,,1,-,1
084 St.Pankraz,0,,8,5,13
084 St.Pankraz,1,,9,11,20
084 St.Pankraz,2,,8,11,19
084 St.Pankraz,3,,9,12,21
084 St.Pankraz,4,,8,13,21
084 St.Pankraz,5,,13,9,22
084 St.Pankraz,6,,13,9,22
084 St.Pankraz,7,,13,7,20
084 St.Pankraz,8,,7,3,10
084 St.Pankraz,9,,14,14,28
084 St.Pankraz,10,,11,12,23
084 St.Pankraz,11,,8,4,12
084 St.Pankraz,12,,12,7,19
084 St.Pankraz,13,,8,11,19
084 St.Pankraz,14,,10,8,18
084 St.Pankraz,15,,9,5,14
084 St.Pankraz,16,,9,10,19
084 St.Pankraz,17,,5,11,16
084 St.Pankraz,18,,7,10,17
084 St.Pankraz,19,,10,11,21
084 St.Pankraz,20,,12,3,15
084 St.Pankraz,21,,12,16,28
084 St.Pankraz,22,,14,7,21
084 St.Pankraz,23,,9,7,16
084 St.Pankraz,24,,10,5,15
084 St.Pankraz,25,,10,7,17
084 St.Pankraz,26,,10,5,15
084 St.Pankraz,27,,10,7,17
084 St.Pankraz,28,,10,7,17
084 St.Pankraz,29,,8,14,22
084 St.Pankraz,30,,15,9,24
084 St.Pankraz,31,,3,5,8
084 St.Pankraz,32,,12,8,20
084 St.Pankraz,33,,9,8,17
084 St.Pankraz,34,,4,11,15
084 St.Pankraz,35,,8,12,20
084 St.Pankraz,36,,13,13,26
084 St.Pankraz,37,,12,6,18
084 St.Pankraz,38,,10,19,29
084 St.Pankraz,39,,15,11,26
084 St.Pankraz,40,,13,12,25
084 St.Pankraz,41,,17,10,27
084 St.Pankraz,42,,17,14,31
084 St.Pankraz,43,,8,15,23
084 St.Pankraz,44,,14,6,20
084 St.Pankraz,45,,22,14,36
084 St.Pankraz,46,,14,12,26
084 St.Pankraz,47,,9,9,18
084 St.Pankraz,48,,17,9,26
084 St.Pankraz,49,,14,13,27
084 St.Pankraz,50,,13,4,17
084 St.Pankraz,51,,15,12,27
084 St.Pankraz,52,,5,9,14
084 St.Pankraz,53,,11,9,20
084 St.Pankraz,54,,10,16,26
084 St.Pankraz,55,,6,3,9
084 St.Pankraz,56,,11,9,20
084 St.Pankraz,57,,9,10,19
084 St.Pankraz,58,,14,9,23
084 St.Pankraz,59,,6,2,8
084 St.Pankraz,60,,10,6,16
084 St.Pankraz,61,,7,6,13
084 St.Pankraz,62,,8,2,10
084 St.Pankraz,63,,7,6,13
084 St.Pankraz,64,,4,7,11
084 St.Pankraz,65,,3,6,9
084 St.Pankraz,66,,5,7,12
084 St.Pankraz,67,,12,14,26
084 St.Pankraz,68,,9,15,24
084 St.Pankraz,69,,8,10,18
084 St.Pankraz,70,,9,6,15
084 St.Pankraz,71,,8,7,15
084 St.Pankraz,72,,5,10,15
084 St.Pankraz,73,,9,8,17
084 St.Pankraz,74,,5,3,8
084 St.Pankraz,75,,5,3,8
084 St.Pankraz,76,,6,6,12
084 St.Pankraz,77,,8,3,11
084 St.Pankraz,78,,6,10,16
084 St.Pankraz,79,,6,4,10
084 St.Pankraz,80,,3,6,9
084 St.Pankraz,81,,5,9,14
084 St.Pankraz,82,,6,8,14
084 St.Pankraz,83,,7,3,10
084 St.Pankraz,84,,2,6,8
084 St.Pankraz,85,,4,5,9
084 St.Pankraz,86,,1,7,8
084 St.Pankraz,87,,6,4,10
084 St.Pankraz,88,,3,5,8
084 St.Pankraz,89,,2,5,7
084 St.Pankraz,90,,-,6,6
084 St.Pankraz,91,,-,1,1
084 St.Pankraz,93,,-,1,1
084 St.Pankraz,96,,-,1,1
084 St.Pankraz,98,,1,-,1
085 St.Christina in Gröden,0,,9,9,18
085 St.Christina in Gröden,1,,12,7,19
085 St.Christina in Gröden,2,,11,7,18
085 St.Christina in Gröden,3,,9,9,18
085 St.Christina in Gröden,4,,9,8,17
085 St.Christina in Gröden,5,,16,13,29
085 St.Christina in Gröden,6,,15,12,27
085 St.Christina in Gröden,7,,8,7,15
085 St.Christina in Gröden,8,,11,14,25
085 St.Christina in Gröden,9,,9,11,20
085 St.Christina in Gröden,10,,20,12,32
085 St.Christina in Gröden,11,,20,10,30
085 St.Christina in Gröden,12,,10,15,25
085 St.Christina in Gröden,13,,10,12,22
085 St.Christina in Gröden,14,,12,5,17
085 St.Christina in Gröden,15,,15,10,25
085 St.Christina in Gröden,16,,8,14,22
085 St.Christina in Gröden,17,,13,13,26
085 St.Christina in Gröden,18,,15,14,29
085 St.Christina in Gröden,19,,13,17,30
085 St.Christina in Gröden,20,,8,14,22
085 St.Christina in Gröden,21,,7,9,16
085 St.Christina in Gröden,22,,9,7,16
085 St.Christina in Gröden,23,,12,5,17
085 St.Christina in Gröden,24,,13,10,23
085 St.Christina in Gröden,25,,7,10,17
085 St.Christina in Gröden,26,,10,5,15
085 St.Christina in Gröden,27,,21,14,35
085 St.Christina in Gröden,28,,9,5,14
085 St.Christina in Gröden,29,,10,11,21
085 St.Christina in Gröden,30,,12,19,31
085 St.Christina in Gröden,31,,10,10,20
085 St.Christina in Gröden,32,,6,18,24
085 St.Christina in Gröden,33,,6,12,18
085 St.Christina in Gröden,34,,15,10,25
085 St.Christina in Gröden,35,,13,15,28
085 St.Christina in Gröden,36,,11,22,33
085 St.Christina in Gröden,37,,10,13,23
085 St.Christina in Gröden,38,,17,11,28
085 St.Christina in Gröden,39,,12,16,28
085 St.Christina in Gröden,40,,24,20,44
085 St.Christina in Gröden,41,,24,13,37
085 St.Christina in Gröden,42,,25,24,49
085 St.Christina in Gröden,43,,17,15,32
085 St.Christina in Gröden,44,,22,8,30
085 St.Christina in Gröden,45,,13,14,27
085 St.Christina in Gröden,46,,13,24,37
085 St.Christina in Gröden,47,,13,18,31
085 St.Christina in Gröden,48,,18,13,31
085 St.Christina in Gröden,49,,21,16,37
085 St.Christina in Gröden,50,,21,16,37
085 St.Christina in Gröden,51,,12,9,21
085 St.Christina in Gröden,52,,9,11,20
085 St.Christina in Gröden,53,,17,11,28
085 St.Christina in Gröden,54,,11,10,21
085 St.Christina in Gröden,55,,9,9,18
085 St.Christina in Gröden,56,,12,13,25
085 St.Christina in Gröden,57,,9,10,19
085 St.Christina in Gröden,58,,5,7,12
085 St.Christina in Gröden,59,,11,6,17
085 St.Christina in Gröden,60,,7,5,12
085 St.Christina in Gröden,61,,8,9,17
085 St.Christina in Gröden,62,,8,5,13
085 St.Christina in Gröden,63,,6,8,14
085 St.Christina in Gröden,64,,9,10,19
085 St.Christina in Gröden,65,,6,7,13
085 St.Christina in Gröden,66,,5,11,16
085 St.Christina in Gröden,67,,12,15,27
085 St.Christina in Gröden,68,,8,6,14
085 St.Christina in Gröden,69,,13,8,21
085 St.Christina in Gröden,70,,9,11,20
085 St.Christina in Gröden,71,,9,10,19
085 St.Christina in Gröden,72,,8,7,15
085 St.Christina in Gröden,73,,8,4,12
085 St.Christina in Gröden,74,,10,10,20
085 St.Christina in Gröden,75,,12,3,15
085 St.Christina in Gröden,76,,7,12,19
085 St.Christina in Gröden,77,,5,12,17
085 St.Christina in Gröden,78,,7,8,15
085 St.Christina in Gröden,79,,2,6,8
085 St.Christina in Gröden,80,,11,4,15
085 St.Christina in Gröden,81,,2,9,11
085 St.Christina in Gröden,82,,2,4,6
085 St.Christina in Gröden,83,,5,6,11
085 St.Christina in Gröden,84,,7,4,11
085 St.Christina in Gröden,85,,3,6,9
085 St.Christina in Gröden,86,,-,1,1
085 St.Christina in Gröden,87,,1,4,5
085 St.Christina in Gröden,88,,-,7,7
085 St.Christina in Gröden,89,,2,3,5
085 St.Christina in Gröden,90,,1,2,3
085 St.Christina in Gröden,91,,-,1,1
085 St.Christina in Gröden,94,,-,1,1
085 St.Christina in Gröden,95,,2,-,2
085 St.Christina in Gröden,96,,-,1,1
085 St.Christina in Gröden,97,,2,-,2
086 Sarntal,0,,45,41,86
086 Sarntal,1,,35,39,74
086 Sarntal,2,,43,57,100
086 Sarntal,3,,53,38,91
086 Sarntal,4,,44,52,96
086 Sarntal,5,,40,35,75
086 Sarntal,6,,39,38,77
086 Sarntal,7,,45,36,81
086 Sarntal,8,,32,40,72
086 Sarntal,9,,50,28,78
086 Sarntal,10,,37,41,78
086 Sarntal,11,,36,36,72
086 Sarntal,12,,52,42,94
086 Sarntal,13,,45,48,93
086 Sarntal,14,,48,42,90
086 Sarntal,15,,42,44,86
086 Sarntal,16,,33,41,74
086 Sarntal,17,,32,40,72
086 Sarntal,18,,43,38,81
086 Sarntal,19,,44,43,87
086 Sarntal,20,,45,34,79
086 Sarntal,21,,57,34,91
086 Sarntal,22,,42,44,86
086 Sarntal,23,,36,32,68
086 Sarntal,24,,38,45,83
086 Sarntal,25,,44,45,89
086 Sarntal,26,,37,40,77
086 Sarntal,27,,55,43,98
086 Sarntal,28,,64,48,112
086 Sarntal,29,,47,55,102
086 Sarntal,30,,52,44,96
086 Sarntal,31,,55,50,105
086 Sarntal,32,,58,52,110
086 Sarntal,33,,57,43,100
086 Sarntal,34,,43,35,78
086 Sarntal,35,,57,49,106
086 Sarntal,36,,46,60,106
086 Sarntal,37,,58,61,119
086 Sarntal,38,,67,40,107
086 Sarntal,39,,46,48,94
086 Sarntal,40,,65,58,123
086 Sarntal,41,,64,54,118
086 Sarntal,42,,53,45,98
086 Sarntal,43,,55,45,100
086 Sarntal,44,,49,48,97
086 Sarntal,45,,65,55,120
086 Sarntal,46,,58,63,121
086 Sarntal,47,,43,43,86
086 Sarntal,48,,58,35,93
086 Sarntal,49,,42,47,89
086 Sarntal,50,,67,46,113
086 Sarntal,51,,41,42,83
086 Sarntal,52,,57,43,100
086 Sarntal,53,,35,41,76
086 Sarntal,54,,39,30,69
086 Sarntal,55,,40,41,81
086 Sarntal,56,,36,31,67
086 Sarntal,57,,43,30,73
086 Sarntal,58,,34,42,76
086 Sarntal,59,,45,33,78
086 Sarntal,60,,37,33,70
086 Sarntal,61,,50,26,76
086 Sarntal,62,,32,39,71
086 Sarntal,63,,36,27,63
086 Sarntal,64,,35,37,72
086 Sarntal,65,,29,33,62
086 Sarntal,66,,30,29,59
086 Sarntal,67,,35,38,73
086 Sarntal,68,,38,35,73
086 Sarntal,69,,34,28,62
086 Sarntal,70,,28,42,70
086 Sarntal,71,,36,30,66
086 Sarntal,72,,30,30,60
086 Sarntal,73,,24,32,56
086 Sarntal,74,,16,23,39
086 Sarntal,75,,18,21,39
086 Sarntal,76,,21,18,39
086 Sarntal,77,,18,18,36
086 Sarntal,78,,20,23,43
086 Sarntal,79,,13,22,35
086 Sarntal,80,,13,21,34
086 Sarntal,81,,16,27,43
086 Sarntal,82,,13,22,35
086 Sarntal,83,,14,30,44
086 Sarntal,84,,9,12,21
086 Sarntal,85,,14,17,31
086 Sarntal,86,,1,19,20
086 Sarntal,87,,2,13,15
086 Sarntal,88,,4,18,22
086 Sarntal,89,,3,7,10
086 Sarntal,90,,2,8,10
086 Sarntal,91,,2,9,11
086 Sarntal,92,,1,6,7
086 Sarntal,93,,-,3,3
086 Sarntal,94,,-,1,1
086 Sarntal,96,,-,1,1
086 Sarntal,97,,2,2,4
086 Sarntal,98,,-,1,1
086 Sarntal,103,,1,-,1
087 Schenna,0,,10,17,27
087 Schenna,1,,12,19,31
087 Schenna,2,,17,21,38
087 Schenna,3,,13,11,24
087 Schenna,4,,21,22,43
087 Schenna,5,,11,9,20
087 Schenna,6,,17,17,34
087 Schenna,7,,14,15,29
087 Schenna,8,,16,19,35
087 Schenna,9,,17,14,31
087 Schenna,10,,19,19,38
087 Schenna,11,,24,18,42
087 Schenna,12,,16,10,26
087 Schenna,13,,13,19,32
087 Schenna,14,,17,18,35
087 Schenna,15,,21,18,39
087 Schenna,16,,20,16,36
087 Schenna,17,,12,8,20
087 Schenna,18,,16,16,32
087 Schenna,19,,12,20,32
087 Schenna,20,,19,15,34
087 Schenna,21,,23,11,34
087 Schenna,22,,21,19,40
087 Schenna,23,,20,16,36
087 Schenna,24,,19,11,30
087 Schenna,25,,16,18,34
087 Schenna,26,,16,18,34
087 Schenna,27,,13,8,21
087 Schenna,28,,8,16,24
087 Schenna,29,,21,14,35
087 Schenna,30,,18,28,46
087 Schenna,31,,26,19,45
087 Schenna,32,,13,18,31
087 Schenna,33,,24,23,47
087 Schenna,34,,25,12,37
087 Schenna,35,,21,29,50
087 Schenna,36,,27,23,50
087 Schenna,37,,26,23,49
087 Schenna,38,,25,17,42
087 Schenna,39,,26,26,52
087 Schenna,40,,20,20,40
087 Schenna,41,,27,21,48
087 Schenna,42,,24,19,43
087 Schenna,43,,28,20,48
087 Schenna,44,,20,20,40
087 Schenna,45,,30,29,59
087 Schenna,46,,20,25,45
087 Schenna,47,,25,19,44
087 Schenna,48,,22,11,33
087 Schenna,49,,29,24,53
087 Schenna,50,,33,24,57
087 Schenna,51,,14,13,27
087 Schenna,52,,22,19,41
087 Schenna,53,,14,18,32
087 Schenna,54,,18,17,35
087 Schenna,55,,10,18,28
087 Schenna,56,,15,17,32
087 Schenna,57,,15,15,30
087 Schenna,58,,11,16,27
087 Schenna,59,,14,11,25
087 Schenna,60,,18,14,32
087 Schenna,61,,17,19,36
087 Schenna,62,,16,16,32
087 Schenna,63,,17,18,35
087 Schenna,64,,16,21,37
087 Schenna,65,,13,14,27
087 Schenna,66,,16,9,25
087 Schenna,67,,19,15,34
087 Schenna,68,,9,19,28
087 Schenna,69,,12,13,25
087 Schenna,70,,10,10,20
087 Schenna,71,,9,13,22
087 Schenna,72,,15,17,32
087 Schenna,73,,7,11,18
087 Schenna,74,,8,11,19
087 Schenna,75,,12,9,21
087 Schenna,76,,12,14,26
087 Schenna,77,,7,9,16
087 Schenna,78,,8,11,19
087 Schenna,79,,9,9,18
087 Schenna,80,,9,5,14
087 Schenna,81,,4,10,14
087 Schenna,82,,7,8,15
087 Schenna,83,,2,10,12
087 Schenna,84,,5,6,11
087 Schenna,85,,1,8,9
087 Schenna,86,,7,5,12
087 Schenna,87,,2,2,4
087 Schenna,88,,3,4,7
087 Schenna,89,,3,6,9
087 Schenna,90,,1,3,4
087 Schenna,91,,-,2,2
087 Schenna,94,,-,1,1
087 Schenna,97,,-,2,2
087 Schenna,98,,-,1,1
087 Schenna,100,,-,1,1
087 Schenna,104,,1,-,1
088 Mühlwald,0,,5,9,14
088 Mühlwald,1,,4,7,11
088 Mühlwald,2,,9,8,17
088 Mühlwald,3,,7,8,15
088 Mühlwald,4,,5,12,17
088 Mühlwald,5,,8,5,13
088 Mühlwald,6,,10,9,19
088 Mühlwald,7,,16,9,25
088 Mühlwald,8,,10,12,22
088 Mühlwald,9,,10,13,23
088 Mühlwald,10,,8,10,18
088 Mühlwald,11,,14,10,24
088 Mühlwald,12,,13,14,27
088 Mühlwald,13,,12,9,21
088 Mühlwald,14,,15,13,28
088 Mühlwald,15,,13,4,17
088 Mühlwald,16,,8,6,14
088 Mühlwald,17,,14,13,27
088 Mühlwald,18,,5,5,10
088 Mühlwald,19,,12,6,18
088 Mühlwald,20,,10,7,17
088 Mühlwald,21,,16,9,25
088 Mühlwald,22,,7,5,12
088 Mühlwald,23,,9,15,24
088 Mühlwald,24,,6,7,13
088 Mühlwald,25,,11,17,28
088 Mühlwald,26,,10,16,26
088 Mühlwald,27,,10,7,17
088 Mühlwald,28,,5,11,16
088 Mühlwald,29,,12,12,24
088 Mühlwald,30,,20,2,22
088 Mühlwald,31,,7,11,18
088 Mühlwald,32,,12,6,18
088 Mühlwald,33,,8,5,13
088 Mühlwald,34,,13,10,23
088 Mühlwald,35,,11,7,18
088 Mühlwald,36,,8,6,14
088 Mühlwald,37,,15,11,26
088 Mühlwald,38,,7,9,16
088 Mühlwald,39,,19,14,33
088 Mühlwald,40,,7,10,17
088 Mühlwald,41,,15,16,31
088 Mühlwald,42,,16,9,25
088 Mühlwald,43,,18,13,31
088 Mühlwald,44,,12,7,19
088 Mühlwald,45,,18,12,30
088 Mühlwald,46,,18,10,28
088 Mühlwald,47,,9,11,20
088 Mühlwald,48,,8,11,19
088 Mühlwald,49,,6,10,16
088 Mühlwald,50,,14,9,23
088 Mühlwald,51,,13,5,18
088 Mühlwald,52,,9,5,14
088 Mühlwald,53,,13,12,25
088 Mühlwald,54,,7,8,15
088 Mühlwald,55,,7,7,14
088 Mühlwald,56,,9,4,13
088 Mühlwald,57,,10,9,19
088 Mühlwald,58,,9,8,17
088 Mühlwald,59,,10,4,14
088 Mühlwald,60,,5,10,15
088 Mühlwald,61,,9,3,12
088 Mühlwald,62,,12,4,16
088 Mühlwald,63,,9,7,16
088 Mühlwald,64,,8,3,11
088 Mühlwald,65,,4,4,8
088 Mühlwald,66,,8,4,12
088 Mühlwald,67,,8,2,10
088 Mühlwald,68,,6,7,13
088 Mühlwald,69,,4,7,11
088 Mühlwald,70,,4,9,13
088 Mühlwald,71,,5,11,16
088 Mühlwald,72,,8,4,12
088 Mühlwald,73,,10,2,12
088 Mühlwald,74,,4,3,7
088 Mühlwald,75,,4,3,7
088 Mühlwald,76,,4,6,10
088 Mühlwald,77,,2,10,12
088 Mühlwald,78,,1,2,3
088 Mühlwald,79,,4,4,8
088 Mühlwald,80,,3,4,7
088 Mühlwald,81,,6,6,12
088 Mühlwald,82,,3,4,7
088 Mühlwald,83,,4,1,5
088 Mühlwald,84,,1,4,5
088 Mühlwald,85,,2,1,3
088 Mühlwald,86,,3,1,4
088 Mühlwald,87,,-,3,3
088 Mühlwald,88,,-,2,2
088 Mühlwald,89,,-,5,5
088 Mühlwald,91,,-,1,1
088 Mühlwald,93,,2,-,2
088 Mühlwald,95,,-,1,1
088 Mühlwald,97,,-,1,1
088 Mühlwald,102,,1,-,1
089 Wolkenstein in Gröden,0,,15,10,25
089 Wolkenstein in Gröden,1,,12,8,20
089 Wolkenstein in Gröden,2,,17,12,29
089 Wolkenstein in Gröden,3,,16,13,29
089 Wolkenstein in Gröden,4,,12,18,30
089 Wolkenstein in Gröden,5,,15,18,33
089 Wolkenstein in Gröden,6,,13,9,22
089 Wolkenstein in Gröden,7,,17,19,36
089 Wolkenstein in Gröden,8,,25,19,44
089 Wolkenstein in Gröden,9,,20,18,38
089 Wolkenstein in Gröden,10,,18,23,41
089 Wolkenstein in Gröden,11,,13,17,30
089 Wolkenstein in Gröden,12,,14,23,37
089 Wolkenstein in Gröden,13,,21,30,51
089 Wolkenstein in Gröden,14,,15,12,27
089 Wolkenstein in Gröden,15,,17,12,29
089 Wolkenstein in Gröden,16,,15,18,33
089 Wolkenstein in Gröden,17,,13,16,29
089 Wolkenstein in Gröden,18,,23,14,37
089 Wolkenstein in Gröden,19,,18,18,36
089 Wolkenstein in Gröden,20,,13,10,23
089 Wolkenstein in Gröden,21,,15,13,28
089 Wolkenstein in Gröden,22,,17,17,34
089 Wolkenstein in Gröden,23,,10,22,32
089 Wolkenstein in Gröden,24,,14,13,27
089 Wolkenstein in Gröden,25,,16,11,27
089 Wolkenstein in Gröden,26,,13,11,24
089 Wolkenstein in Gröden,27,,14,11,25
089 Wolkenstein in Gröden,28,,10,14,24
089 Wolkenstein in Gröden,29,,14,11,25
089 Wolkenstein in Gröden,30,,19,13,32
089 Wolkenstein in Gröden,31,,8,19,27
089 Wolkenstein in Gröden,32,,7,8,15
089 Wolkenstein in Gröden,33,,13,12,25
089 Wolkenstein in Gröden,34,,14,10,24
089 Wolkenstein in Gröden,35,,20,22,42
089 Wolkenstein in Gröden,36,,11,18,29
089 Wolkenstein in Gröden,37,,25,22,47
089 Wolkenstein in Gröden,38,,19,24,43
089 Wolkenstein in Gröden,39,,21,23,44
089 Wolkenstein in Gröden,40,,24,24,48
089 Wolkenstein in Gröden,41,,28,24,52
089 Wolkenstein in Gröden,42,,25,24,49
089 Wolkenstein in Gröden,43,,29,26,55
089 Wolkenstein in Gröden,44,,24,24,48
089 Wolkenstein in Gröden,45,,22,34,56
089 Wolkenstein in Gröden,46,,27,21,48
089 Wolkenstein in Gröden,47,,23,22,45
089 Wolkenstein in Gröden,48,,21,20,41
089 Wolkenstein in Gröden,49,,25,24,49
089 Wolkenstein in Gröden,50,,24,22,46
089 Wolkenstein in Gröden,51,,13,16,29
089 Wolkenstein in Gröden,52,,17,15,32
089 Wolkenstein in Gröden,53,,20,16,36
089 Wolkenstein in Gröden,54,,10,14,24
089 Wolkenstein in Gröden,55,,13,10,23
089 Wolkenstein in Gröden,56,,13,11,24
089 Wolkenstein in Gröden,57,,8,12,20
089 Wolkenstein in Gröden,58,,11,7,18
089 Wolkenstein in Gröden,59,,13,12,25
089 Wolkenstein in Gröden,60,,6,17,23
089 Wolkenstein in Gröden,61,,16,11,27
089 Wolkenstein in Gröden,62,,13,13,26
089 Wolkenstein in Gröden,63,,9,15,24
089 Wolkenstein in Gröden,64,,16,18,34
089 Wolkenstein in Gröden,65,,5,14,19
089 Wolkenstein in Gröden,66,,12,9,21
089 Wolkenstein in Gröden,67,,21,14,35
089 Wolkenstein in Gröden,68,,11,12,23
089 Wolkenstein in Gröden,69,,14,15,29
089 Wolkenstein in Gröden,70,,14,16,30
089 Wolkenstein in Gröden,71,,18,14,32
089 Wolkenstein in Gröden,72,,17,9,26
089 Wolkenstein in Gröden,73,,10,19,29
089 Wolkenstein in Gröden,74,,9,15,24
089 Wolkenstein in Gröden,75,,14,6,20
089 Wolkenstein in Gröden,76,,15,10,25
089 Wolkenstein in Gröden,77,,7,10,17
089 Wolkenstein in Gröden,78,,4,9,13
089 Wolkenstein in Gröden,79,,8,9,17
089 Wolkenstein in Gröden,80,,6,9,15
089 Wolkenstein in Gröden,81,,6,7,13
089 Wolkenstein in Gröden,82,,5,9,14
089 Wolkenstein in Gröden,83,,7,5,12
089 Wolkenstein in Gröden,84,,7,4,11
089 Wolkenstein in Gröden,85,,3,6,9
089 Wolkenstein in Gröden,86,,2,8,10
089 Wolkenstein in Gröden,87,,3,4,7
089 Wolkenstein in Gröden,88,,5,9,14
089 Wolkenstein in Gröden,89,,1,4,5
089 Wolkenstein in Gröden,90,,3,4,7
089 Wolkenstein in Gröden,91,,1,1,2
089 Wolkenstein in Gröden,93,,1,1,2
089 Wolkenstein in Gröden,95,,-,1,1
089 Wolkenstein in Gröden,98,,-,1,1
089 Wolkenstein in Gröden,99,,-,1,1
091 Schnals,0,,3,6,9
091 Schnals,1,,9,9,18
091 Schnals,2,,10,4,14
091 Schnals,3,,4,6,10
091 Schnals,4,,2,4,6
091 Schnals,5,,4,5,9
091 Schnals,6,,7,5,12
091 Schnals,7,,2,7,9
091 Schnals,8,,12,2,14
091 Schnals,9,,3,4,7
091 Schnals,10,,5,5,10
091 Schnals,11,,6,9,15
091 Schnals,12,,7,15,22
091 Schnals,13,,12,10,22
091 Schnals,14,,7,12,19
091 Schnals,15,,5,8,13
091 Schnals,16,,4,7,11
091 Schnals,17,,10,5,15
091 Schnals,18,,13,10,23
091 Schnals,19,,13,9,22
091 Schnals,20,,4,7,11
091 Schnals,21,,18,8,26
091 Schnals,22,,9,5,14
091 Schnals,23,,11,9,20
091 Schnals,24,,8,10,18
091 Schnals,25,,6,9,15
091 Schnals,26,,13,13,26
091 Schnals,27,,7,5,12
091 Schnals,28,,7,5,12
091 Schnals,29,,17,8,25
091 Schnals,30,,11,11,22
091 Schnals,31,,5,10,15
091 Schnals,32,,10,11,21
091 Schnals,33,,8,8,16
091 Schnals,34,,10,1,11
091 Schnals,35,,4,6,10
091 Schnals,36,,14,7,21
091 Schnals,37,,8,8,16
091 Schnals,38,,9,9,18
091 Schnals,39,,11,11,22
091 Schnals,40,,12,7,19
091 Schnals,41,,13,8,21
091 Schnals,42,,10,9,19
091 Schnals,43,,17,10,27
091 Schnals,44,,13,16,29
091 Schnals,45,,16,8,24
091 Schnals,46,,6,9,15
091 Schnals,47,,12,15,27
091 Schnals,48,,13,10,23
091 Schnals,49,,11,13,24
091 Schnals,50,,12,8,20
091 Schnals,51,,16,12,28
091 Schnals,52,,11,11,22
091 Schnals,53,,11,5,16
091 Schnals,54,,12,4,16
091 Schnals,55,,9,6,15
091 Schnals,56,,9,10,19
091 Schnals,57,,12,8,20
091 Schnals,58,,14,7,21
091 Schnals,59,,12,9,21
091 Schnals,60,,9,7,16
091 Schnals,61,,10,9,19
091 Schnals,62,,3,2,5
091 Schnals,63,,9,8,17
091 Schnals,64,,5,5,10
091 Schnals,65,,6,4,10
091 Schnals,66,,4,7,11
091 Schnals,67,,6,8,14
091 Schnals,68,,4,4,8
091 Schnals,69,,3,4,7
091 Schnals,70,,7,7,14
091 Schnals,71,,5,7,12
091 Schnals,72,,1,11,12
091 Schnals,73,,7,4,11
091 Schnals,74,,4,5,9
091 Schnals,75,,2,5,7
091 Schnals,76,,2,4,6
091 Schnals,77,,4,3,7
091 Schnals,78,,2,9,11
091 Schnals,79,,2,4,6
091 Schnals,80,,-,3,3
091 Schnals,81,,4,6,10
091 Schnals,82,,1,4,5
091 Schnals,83,,1,6,7
091 Schnals,84,,8,2,10
091 Schnals,85,,3,8,11
091 Schnals,86,,-,4,4
091 Schnals,87,,-,1,1
091 Schnals,88,,2,2,4
091 Schnals,89,,-,3,3
091 Schnals,90,,-,1,1
091 Schnals,92,,2,1,3
091 Schnals,94,,-,2,2
091 Schnals,95,,-,1,1
091 Schnals,97,,-,1,1
091 Schnals,98,,1,-,1
091 Schnals,99,,-,1,1
092 Sexten,0,,8,5,13
092 Sexten,1,,11,7,18
092 Sexten,2,,5,7,12
092 Sexten,3,,7,19,26
092 Sexten,4,,5,8,13
092 Sexten,5,,9,10,19
092 Sexten,6,,12,8,20
092 Sexten,7,,11,11,22
092 Sexten,8,,17,18,35
092 Sexten,9,,16,13,29
092 Sexten,10,,10,15,25
092 Sexten,11,,9,14,23
092 Sexten,12,,13,7,20
092 Sexten,13,,13,10,23
092 Sexten,14,,15,11,26
092 Sexten,15,,15,14,29
092 Sexten,16,,16,11,27
092 Sexten,17,,10,5,15
092 Sexten,18,,14,11,25
092 Sexten,19,,11,13,24
092 Sexten,20,,11,18,29
092 Sexten,21,,9,10,19
092 Sexten,22,,9,5,14
092 Sexten,23,,13,8,21
092 Sexten,24,,6,10,16
092 Sexten,25,,10,11,21
092 Sexten,26,,7,13,20
092 Sexten,27,,10,8,18
092 Sexten,28,,11,15,26
092 Sexten,29,,15,12,27
092 Sexten,30,,15,8,23
092 Sexten,31,,12,19,31
092 Sexten,32,,13,11,24
092 Sexten,33,,8,4,12
092 Sexten,34,,19,15,34
092 Sexten,35,,8,8,16
092 Sexten,36,,10,7,17
092 Sexten,37,,8,9,17
092 Sexten,38,,15,20,35
092 Sexten,39,,15,13,28
092 Sexten,40,,12,18,30
092 Sexten,41,,22,19,41
092 Sexten,42,,13,17,30
092 Sexten,43,,22,20,42
092 Sexten,44,,14,17,31
092 Sexten,45,,17,18,35
092 Sexten,46,,18,19,37
092 Sexten,47,,28,19,47
092 Sexten,48,,13,19,32
092 Sexten,49,,18,13,31
092 Sexten,50,,22,10,32
092 Sexten,51,,15,15,30
092 Sexten,52,,23,14,37
092 Sexten,53,,18,13,31
092 Sexten,54,,14,14,28
092 Sexten,55,,10,11,21
092 Sexten,56,,11,13,24
092 Sexten,57,,5,10,15
092 Sexten,58,,6,12,18
092 Sexten,59,,7,10,17
092 Sexten,60,,11,7,18
092 Sexten,61,,6,4,10
092 Sexten,62,,10,7,17
092 Sexten,63,,10,4,14
092 Sexten,64,,5,9,14
092 Sexten,65,,6,4,10
092 Sexten,66,,6,12,18
092 Sexten,67,,8,5,13
092 Sexten,68,,5,5,10
092 Sexten,69,,8,16,24
092 Sexten,70,,7,12,19
092 Sexten,71,,5,10,15
092 Sexten,72,,13,10,23
092 Sexten,73,,9,6,15
092 Sexten,74,,7,10,17
092 Sexten,75,,8,14,22
092 Sexten,76,,10,7,17
092 Sexten,77,,3,10,13
092 Sexten,78,,3,7,10
092 Sexten,79,,7,13,20
092 Sexten,80,,6,11,17
092 Sexten,81,,6,11,17
092 Sexten,82,,5,11,16
092 Sexten,83,,5,14,19
092 Sexten,84,,5,4,9
092 Sexten,85,,3,9,12
092 Sexten,86,,5,6,11
092 Sexten,87,,1,7,8
092 Sexten,88,,3,7,10
092 Sexten,89,,1,5,6
092 Sexten,90,,-,3,3
092 Sexten,91,,-,3,3
092 Sexten,93,,-,1,1
092 Sexten,98,,-,1,1
093 Schlanders,0,,30,27,57
093 Schlanders,1,,26,40,66
093 Schlanders,2,,30,26,56
093 Schlanders,3,,32,33,65
093 Schlanders,4,,26,25,51
093 Schlanders,5,,29,36,65
093 Schlanders,6,,27,35,62
093 Schlanders,7,,27,24,51
093 Schlanders,8,,26,31,57
093 Schlanders,9,,30,32,62
093 Schlanders,10,,38,37,75
093 Schlanders,11,,25,40,65
093 Schlanders,12,,43,39,82
093 Schlanders,13,,57,47,104
093 Schlanders,14,,42,35,77
093 Schlanders,15,,39,27,66
093 Schlanders,16,,43,38,81
093 Schlanders,17,,46,43,89
093 Schlanders,18,,36,47,83
093 Schlanders,19,,39,37,76
093 Schlanders,20,,50,43,93
093 Schlanders,21,,38,37,75
093 Schlanders,22,,35,47,82
093 Schlanders,23,,33,33,66
093 Schlanders,24,,40,40,80
093 Schlanders,25,,43,39,82
093 Schlanders,26,,43,44,87
093 Schlanders,27,,35,43,78
093 Schlanders,28,,49,46,95
093 Schlanders,29,,50,39,89
093 Schlanders,30,,43,35,78
093 Schlanders,31,,31,42,73
093 Schlanders,32,,44,36,80
093 Schlanders,33,,37,46,83
093 Schlanders,34,,31,25,56
093 Schlanders,35,,39,37,76
093 Schlanders,36,,47,36,83
093 Schlanders,37,,39,49,88
093 Schlanders,38,,53,36,89
093 Schlanders,39,,47,47,94
093 Schlanders,40,,46,51,97
093 Schlanders,41,,64,42,106
093 Schlanders,42,,51,38,89
093 Schlanders,43,,45,57,102
093 Schlanders,44,,45,56,101
093 Schlanders,45,,55,53,108
093 Schlanders,46,,39,41,80
093 Schlanders,47,,54,61,115
093 Schlanders,48,,51,47,98
093 Schlanders,49,,38,58,96
093 Schlanders,50,,41,44,85
093 Schlanders,51,,35,39,74
093 Schlanders,52,,49,55,104
093 Schlanders,53,,41,35,76
093 Schlanders,54,,26,36,62
093 Schlanders,55,,25,36,61
093 Schlanders,56,,31,34,65
093 Schlanders,57,,33,39,72
093 Schlanders,58,,31,23,54
093 Schlanders,59,,28,31,59
093 Schlanders,60,,23,33,56
093 Schlanders,61,,28,38,66
093 Schlanders,62,,39,26,65
093 Schlanders,63,,22,22,44
093 Schlanders,64,,26,20,46
093 Schlanders,65,,31,15,46
093 Schlanders,66,,27,32,59
093 Schlanders,67,,30,35,65
093 Schlanders,68,,34,35,69
093 Schlanders,69,,32,37,69
093 Schlanders,70,,25,26,51
093 Schlanders,71,,28,34,62
093 Schlanders,72,,12,18,30
093 Schlanders,73,,24,24,48
093 Schlanders,74,,15,26,41
093 Schlanders,75,,15,24,39
093 Schlanders,76,,15,21,36
093 Schlanders,77,,20,30,50
093 Schlanders,78,,17,14,31
093 Schlanders,79,,19,16,35
093 Schlanders,80,,15,25,40
093 Schlanders,81,,11,14,25
093 Schlanders,82,,12,17,29
093 Schlanders,83,,10,19,29
093 Schlanders,84,,6,17,23
093 Schlanders,85,,9,15,24
093 Schlanders,86,,5,12,17
093 Schlanders,87,,7,11,18
093 Schlanders,88,,3,8,11
093 Schlanders,89,,3,9,12
093 Schlanders,90,,1,11,12
093 Schlanders,91,,1,7,8
093 Schlanders,92,,3,5,8
093 Schlanders,93,,1,1,2
093 Schlanders,94,,-,1,1
093 Schlanders,95,,1,1,2
093 Schlanders,96,,1,-,1
093 Schlanders,97,,-,1,1
093 Schlanders,98,,-,2,2
093 Schlanders,99,,-,1,1
093 Schlanders,100,,-,2,2
093 Schlanders,101,,-,1,1
094 Schluderns,0,,9,4,13
094 Schluderns,1,,10,8,18
094 Schluderns,2,,8,2,10
094 Schluderns,3,,11,13,24
094 Schluderns,4,,9,8,17
094 Schluderns,5,,6,6,12
094 Schluderns,6,,6,12,18
094 Schluderns,7,,16,9,25
094 Schluderns,8,,14,8,22
094 Schluderns,9,,12,9,21
094 Schluderns,10,,19,8,27
094 Schluderns,11,,8,14,22
094 Schluderns,12,,6,10,16
094 Schluderns,13,,12,11,23
094 Schluderns,14,,12,15,27
094 Schluderns,15,,9,11,20
094 Schluderns,16,,13,18,31
094 Schluderns,17,,15,6,21
094 Schluderns,18,,8,10,18
094 Schluderns,19,,9,9,18
094 Schluderns,20,,21,5,26
094 Schluderns,21,,15,12,27
094 Schluderns,22,,11,11,22
094 Schluderns,23,,6,11,17
094 Schluderns,24,,11,19,30
094 Schluderns,25,,18,14,32
094 Schluderns,26,,12,11,23
094 Schluderns,27,,11,8,19
094 Schluderns,28,,10,14,24
094 Schluderns,29,,18,13,31
094 Schluderns,30,,8,10,18
094 Schluderns,31,,4,16,20
094 Schluderns,32,,10,13,23
094 Schluderns,33,,12,11,23
094 Schluderns,34,,11,17,28
094 Schluderns,35,,18,10,28
094 Schluderns,36,,18,13,31
094 Schluderns,37,,16,11,27
094 Schluderns,38,,13,12,25
094 Schluderns,39,,10,12,22
094 Schluderns,40,,9,12,21
094 Schluderns,41,,17,11,28
094 Schluderns,42,,17,18,35
094 Schluderns,43,,13,15,28
094 Schluderns,44,,15,16,31
094 Schluderns,45,,25,9,34
094 Schluderns,46,,25,12,37
094 Schluderns,47,,13,18,31
094 Schluderns,48,,11,18,29
094 Schluderns,49,,15,17,32
094 Schluderns,50,,10,4,14
094 Schluderns,51,,13,18,31
094 Schluderns,52,,10,13,23
094 Schluderns,53,,17,7,24
094 Schluderns,54,,10,16,26
094 Schluderns,55,,17,11,28
094 Schluderns,56,,14,7,21
094 Schluderns,57,,13,8,21
094 Schluderns,58,,7,6,13
094 Schluderns,59,,11,4,15
094 Schluderns,60,,8,14,22
094 Schluderns,61,,11,10,21
094 Schluderns,62,,9,9,18
094 Schluderns,63,,7,7,14
094 Schluderns,64,,9,9,18
094 Schluderns,65,,7,4,11
094 Schluderns,66,,5,12,17
094 Schluderns,67,,3,8,11
094 Schluderns,68,,8,7,15
094 Schluderns,69,,10,14,24
094 Schluderns,70,,6,5,11
094 Schluderns,71,,11,8,19
094 Schluderns,72,,8,8,16
094 Schluderns,73,,5,10,15
094 Schluderns,74,,4,6,10
094 Schluderns,75,,5,10,15
094 Schluderns,76,,8,10,18
094 Schluderns,77,,5,10,15
094 Schluderns,78,,9,10,19
094 Schluderns,79,,4,7,11
094 Schluderns,80,,5,9,14
094 Schluderns,81,,3,5,8
094 Schluderns,82,,4,7,11
094 Schluderns,83,,3,1,4
094 Schluderns,84,,2,10,12
094 Schluderns,85,,2,4,6
094 Schluderns,86,,1,1,2
094 Schluderns,87,,1,4,5
094 Schluderns,88,,3,2,5
094 Schluderns,89,,-,5,5
094 Schluderns,90,,-,1,1
094 Schluderns,91,,1,2,3
094 Schluderns,92,,2,1,3
094 Schluderns,93,,-,2,2
094 Schluderns,95,,-,1,1
095 Stilfs,0,,2,5,7
095 Stilfs,1,,2,3,5
095 Stilfs,2,,6,5,11
095 Stilfs,3,,2,6,8
095 Stilfs,4,,5,3,8
095 Stilfs,5,,5,5,10
095 Stilfs,6,,5,4,9
095 Stilfs,7,,5,6,11
095 Stilfs,8,,5,3,8
095 Stilfs,9,,5,11,16
095 Stilfs,10,,9,5,14
095 Stilfs,11,,2,6,8
095 Stilfs,12,,8,3,11
095 Stilfs,13,,10,11,21
095 Stilfs,14,,11,1,12
095 Stilfs,15,,7,6,13
095 Stilfs,16,,8,7,15
095 Stilfs,17,,6,14,20
095 Stilfs,18,,4,8,12
095 Stilfs,19,,10,5,15
095 Stilfs,20,,18,8,26
095 Stilfs,21,,6,6,12
095 Stilfs,22,,7,4,11
095 Stilfs,23,,6,8,14
095 Stilfs,24,,9,9,18
095 Stilfs,25,,10,4,14
095 Stilfs,26,,13,9,22
095 Stilfs,27,,9,3,12
095 Stilfs,28,,11,4,15
095 Stilfs,29,,9,6,15
095 Stilfs,30,,5,6,11
095 Stilfs,31,,6,7,13
095 Stilfs,32,,7,10,17
095 Stilfs,33,,9,4,13
095 Stilfs,34,,14,2,16
095 Stilfs,35,,9,7,16
095 Stilfs,36,,3,7,10
095 Stilfs,37,,12,17,29
095 Stilfs,38,,11,10,21
095 Stilfs,39,,12,11,23
095 Stilfs,40,,12,13,25
095 Stilfs,41,,11,11,22
095 Stilfs,42,,8,10,18
095 Stilfs,43,,7,9,16
095 Stilfs,44,,17,9,26
095 Stilfs,45,,12,12,24
095 Stilfs,46,,12,5,17
095 Stilfs,47,,9,6,15
095 Stilfs,48,,7,12,19
095 Stilfs,49,,8,2,10
095 Stilfs,50,,8,7,15
095 Stilfs,51,,9,9,18
095 Stilfs,52,,7,15,22
095 Stilfs,53,,10,6,16
095 Stilfs,54,,6,9,15
095 Stilfs,55,,4,4,8
095 Stilfs,56,,15,9,24
095 Stilfs,57,,9,4,13
095 Stilfs,58,,10,5,15
095 Stilfs,59,,14,9,23
095 Stilfs,60,,2,6,8
095 Stilfs,61,,5,3,8
095 Stilfs,62,,7,9,16
095 Stilfs,63,,7,4,11
095 Stilfs,64,,10,8,18
095 Stilfs,65,,2,4,6
095 Stilfs,66,,12,8,20
095 Stilfs,67,,8,7,15
095 Stilfs,68,,4,12,16
095 Stilfs,69,,7,4,11
095 Stilfs,70,,6,9,15
095 Stilfs,71,,3,7,10
095 Stilfs,72,,4,4,8
095 Stilfs,73,,6,5,11
095 Stilfs,74,,3,9,12
095 Stilfs,75,,2,6,8
095 Stilfs,76,,4,4,8
095 Stilfs,77,,3,6,9
095 Stilfs,78,,3,6,9
095 Stilfs,79,,2,3,5
095 Stilfs,80,,5,5,10
095 Stilfs,81,,2,1,3
095 Stilfs,82,,3,7,10
095 Stilfs,83,,4,4,8
095 Stilfs,84,,1,5,6
095 Stilfs,85,,2,3,5
095 Stilfs,86,,-,5,5
095 Stilfs,87,,-,3,3
095 Stilfs,88,,1,5,6
095 Stilfs,89,,1,5,6
095 Stilfs,90,,-,3,3
095 Stilfs,93,,-,1,1
095 Stilfs,94,,-,1,1
095 Stilfs,96,,1,-,1
096 Terenten,0,,4,7,11
096 Terenten,1,,16,7,23
096 Terenten,2,,9,5,14
096 Terenten,3,,11,10,21
096 Terenten,4,,13,9,22
096 Terenten,5,,16,10,26
096 Terenten,6,,11,17,28
096 Terenten,7,,8,12,20
096 Terenten,8,,9,8,17
096 Terenten,9,,12,14,26
096 Terenten,10,,10,10,20
096 Terenten,11,,10,18,28
096 Terenten,12,,21,19,40
096 Terenten,13,,10,7,17
096 Terenten,14,,13,11,24
096 Terenten,15,,12,7,19
096 Terenten,16,,13,13,26
096 Terenten,17,,6,12,18
096 Terenten,18,,9,8,17
096 Terenten,19,,7,16,23
096 Terenten,20,,12,16,28
096 Terenten,21,,14,7,21
096 Terenten,22,,10,7,17
096 Terenten,23,,15,7,22
096 Terenten,24,,9,9,18
096 Terenten,25,,10,12,22
096 Terenten,26,,12,11,23
096 Terenten,27,,15,17,32
096 Terenten,28,,13,10,23
096 Terenten,29,,13,14,27
096 Terenten,30,,11,13,24
096 Terenten,31,,9,10,19
096 Terenten,32,,18,19,37
096 Terenten,33,,12,5,17
096 Terenten,34,,15,11,26
096 Terenten,35,,15,9,24
096 Terenten,36,,16,16,32
096 Terenten,37,,7,16,23
096 Terenten,38,,18,10,28
096 Terenten,39,,16,16,32
096 Terenten,40,,20,11,31
096 Terenten,41,,17,14,31
096 Terenten,42,,14,14,28
096 Terenten,43,,17,18,35
096 Terenten,44,,14,18,32
096 Terenten,45,,16,9,25
096 Terenten,46,,17,13,30
096 Terenten,47,,24,13,37
096 Terenten,48,,20,11,31
096 Terenten,49,,10,16,26
096 Terenten,50,,12,9,21
096 Terenten,51,,15,12,27
096 Terenten,52,,13,10,23
096 Terenten,53,,11,8,19
096 Terenten,54,,9,12,21
096 Terenten,55,,12,10,22
096 Terenten,56,,14,10,24
096 Terenten,57,,9,7,16
096 Terenten,58,,7,7,14
096 Terenten,59,,7,6,13
096 Terenten,60,,8,7,15
096 Terenten,61,,8,6,14
096 Terenten,62,,9,8,17
096 Terenten,63,,7,3,10
096 Terenten,64,,9,3,12
096 Terenten,65,,6,4,10
096 Terenten,66,,3,6,9
096 Terenten,67,,8,5,13
096 Terenten,68,,5,5,10
096 Terenten,69,,5,4,9
096 Terenten,70,,8,5,13
096 Terenten,71,,2,6,8
096 Terenten,72,,5,10,15
096 Terenten,73,,6,4,10
096 Terenten,74,,3,10,13
096 Terenten,75,,5,5,10
096 Terenten,76,,1,3,4
096 Terenten,77,,5,3,8
096 Terenten,78,,3,3,6
096 Terenten,79,,4,9,13
096 Terenten,80,,4,5,9
096 Terenten,81,,4,3,7
096 Terenten,82,,4,5,9
096 Terenten,83,,1,2,3
096 Terenten,84,,3,5,8
096 Terenten,85,,3,2,5
096 Terenten,86,,1,3,4
096 Terenten,87,,3,2,5
096 Terenten,88,,1,-,1
096 Terenten,89,,-,2,2
096 Terenten,90,,1,3,4
096 Terenten,91,,1,-,1
096 Terenten,92,,-,1,1
096 Terenten,93,,1,-,1
097 Terlan,0,,15,15,30
097 Terlan,1,,34,23,57
097 Terlan,2,,24,26,50
097 Terlan,3,,21,19,40
097 Terlan,4,,21,32,53
097 Terlan,5,,18,25,43
097 Terlan,6,,27,20,47
097 Terlan,7,,22,23,45
097 Terlan,8,,20,18,38
097 Terlan,9,,21,28,49
097 Terlan,10,,32,25,57
097 Terlan,11,,33,21,54
097 Terlan,12,,20,22,42
097 Terlan,13,,36,29,65
097 Terlan,14,,14,27,41
097 Terlan,15,,27,27,54
097 Terlan,16,,23,19,42
097 Terlan,17,,27,24,51
097 Terlan,18,,24,32,56
097 Terlan,19,,26,19,45
097 Terlan,20,,15,23,38
097 Terlan,21,,24,30,54
097 Terlan,22,,24,19,43
097 Terlan,23,,30,15,45
097 Terlan,24,,19,23,42
097 Terlan,25,,25,19,44
097 Terlan,26,,16,17,33
097 Terlan,27,,23,16,39
097 Terlan,28,,19,22,41
097 Terlan,29,,17,19,36
097 Terlan,30,,31,28,59
097 Terlan,31,,22,27,49
097 Terlan,32,,21,33,54
097 Terlan,33,,39,26,65
097 Terlan,34,,34,37,71
097 Terlan,35,,28,35,63
097 Terlan,36,,29,48,77
097 Terlan,37,,34,38,72
097 Terlan,38,,42,26,68
097 Terlan,39,,32,26,58
097 Terlan,40,,43,42,85
097 Terlan,41,,37,32,69
097 Terlan,42,,37,32,69
097 Terlan,43,,32,41,73
097 Terlan,44,,46,36,82
097 Terlan,45,,36,27,63
097 Terlan,46,,33,30,63
097 Terlan,47,,36,32,68
097 Terlan,48,,30,36,66
097 Terlan,49,,45,27,72
097 Terlan,50,,27,38,65
097 Terlan,51,,19,28,47
097 Terlan,52,,33,22,55
097 Terlan,53,,24,27,51
097 Terlan,54,,29,33,62
097 Terlan,55,,24,21,45
097 Terlan,56,,25,20,45
097 Terlan,57,,12,21,33
097 Terlan,58,,16,25,41
097 Terlan,59,,23,17,40
097 Terlan,60,,23,24,47
097 Terlan,61,,18,15,33
097 Terlan,62,,18,22,40
097 Terlan,63,,16,19,35
097 Terlan,64,,14,24,38
097 Terlan,65,,22,23,45
097 Terlan,66,,23,23,46
097 Terlan,67,,15,28,43
097 Terlan,68,,31,20,51
097 Terlan,69,,21,26,47
097 Terlan,70,,19,15,34
097 Terlan,71,,15,20,35
097 Terlan,72,,20,16,36
097 Terlan,73,,12,16,28
097 Terlan,74,,4,11,15
097 Terlan,75,,15,23,38
097 Terlan,76,,9,23,32
097 Terlan,77,,10,15,25
097 Terlan,78,,13,12,25
097 Terlan,79,,17,12,29
097 Terlan,80,,12,15,27
097 Terlan,81,,10,11,21
097 Terlan,82,,9,10,19
097 Terlan,83,,7,9,16
097 Terlan,84,,4,15,19
097 Terlan,85,,6,10,16
097 Terlan,86,,3,10,13
097 Terlan,87,,5,22,27
097 Terlan,88,,3,11,14
097 Terlan,89,,3,6,9
097 Terlan,90,,-,6,6
097 Terlan,91,,-,4,4
097 Terlan,92,,1,2,3
097 Terlan,93,,-,3,3
097 Terlan,94,,-,3,3
097 Terlan,95,,1,3,4
097 Terlan,96,,-,2,2
097 Terlan,97,,-,2,2
098 Tramin a.d. Weinstr.,0,,18,12,30
098 Tramin a.d. Weinstr.,1,,21,14,35
098 Tramin a.d. Weinstr.,2,,19,10,29
098 Tramin a.d. Weinstr.,3,,15,11,26
098 Tramin a.d. Weinstr.,4,,15,14,29
098 Tramin a.d. Weinstr.,5,,18,11,29
098 Tramin a.d. Weinstr.,6,,15,19,34
098 Tramin a.d. Weinstr.,7,,28,16,44
098 Tramin a.d. Weinstr.,8,,14,17,31
098 Tramin a.d. Weinstr.,9,,19,19,38
098 Tramin a.d. Weinstr.,10,,24,13,37
098 Tramin a.d. Weinstr.,11,,18,18,36
098 Tramin a.d. Weinstr.,12,,14,17,31
098 Tramin a.d. Weinstr.,13,,29,15,44
098 Tramin a.d. Weinstr.,14,,20,26,46
098 Tramin a.d. Weinstr.,15,,18,20,38
098 Tramin a.d. Weinstr.,16,,21,21,42
098 Tramin a.d. Weinstr.,17,,18,18,36
098 Tramin a.d. Weinstr.,18,,20,26,46
098 Tramin a.d. Weinstr.,19,,21,9,30
098 Tramin a.d. Weinstr.,20,,23,21,44
098 Tramin a.d. Weinstr.,21,,15,28,43
098 Tramin a.d. Weinstr.,22,,13,26,39
098 Tramin a.d. Weinstr.,23,,23,27,50
098 Tramin a.d. Weinstr.,24,,11,15,26
098 Tramin a.d. Weinstr.,25,,25,21,46
098 Tramin a.d. Weinstr.,26,,22,18,40
098 Tramin a.d. Weinstr.,27,,17,18,35
098 Tramin a.d. Weinstr.,28,,26,22,48
098 Tramin a.d. Weinstr.,29,,34,18,52
098 Tramin a.d. Weinstr.,30,,22,16,38
098 Tramin a.d. Weinstr.,31,,18,15,33
098 Tramin a.d. Weinstr.,32,,11,24,35
098 Tramin a.d. Weinstr.,33,,20,19,39
098 Tramin a.d. Weinstr.,34,,26,13,39
098 Tramin a.d. Weinstr.,35,,21,23,44
098 Tramin a.d. Weinstr.,36,,25,18,43
098 Tramin a.d. Weinstr.,37,,18,13,31
098 Tramin a.d. Weinstr.,38,,18,27,45
098 Tramin a.d. Weinstr.,39,,25,35,60
098 Tramin a.d. Weinstr.,40,,28,19,47
098 Tramin a.d. Weinstr.,41,,29,30,59
098 Tramin a.d. Weinstr.,42,,27,22,49
098 Tramin a.d. Weinstr.,43,,29,33,62
098 Tramin a.d. Weinstr.,44,,30,26,56
098 Tramin a.d. Weinstr.,45,,35,30,65
098 Tramin a.d. Weinstr.,46,,28,27,55
098 Tramin a.d. Weinstr.,47,,24,22,46
098 Tramin a.d. Weinstr.,48,,23,13,36
098 Tramin a.d. Weinstr.,49,,30,26,56
098 Tramin a.d. Weinstr.,50,,27,33,60
098 Tramin a.d. Weinstr.,51,,16,31,47
098 Tramin a.d. Weinstr.,52,,26,23,49
098 Tramin a.d. Weinstr.,53,,22,22,44
098 Tramin a.d. Weinstr.,54,,24,20,44
098 Tramin a.d. Weinstr.,55,,17,19,36
098 Tramin a.d. Weinstr.,56,,21,19,40
098 Tramin a.d. Weinstr.,57,,16,16,32
098 Tramin a.d. Weinstr.,58,,18,18,36
098 Tramin a.d. Weinstr.,59,,12,14,26
098 Tramin a.d. Weinstr.,60,,15,19,34
098 Tramin a.d. Weinstr.,61,,15,16,31
098 Tramin a.d. Weinstr.,62,,17,18,35
098 Tramin a.d. Weinstr.,63,,14,21,35
098 Tramin a.d. Weinstr.,64,,18,17,35
098 Tramin a.d. Weinstr.,65,,6,9,15
098 Tramin a.d. Weinstr.,66,,23,26,49
098 Tramin a.d. Weinstr.,67,,18,21,39
098 Tramin a.d. Weinstr.,68,,20,20,40
098 Tramin a.d. Weinstr.,69,,15,24,39
098 Tramin a.d. Weinstr.,70,,20,16,36
098 Tramin a.d. Weinstr.,71,,12,12,24
098 Tramin a.d. Weinstr.,72,,6,18,24
098 Tramin a.d. Weinstr.,73,,13,14,27
098 Tramin a.d. Weinstr.,74,,14,13,27
098 Tramin a.d. Weinstr.,75,,15,12,27
098 Tramin a.d. Weinstr.,76,,8,13,21
098 Tramin a.d. Weinstr.,77,,7,13,20
098 Tramin a.d. Weinstr.,78,,10,16,26
098 Tramin a.d. Weinstr.,79,,6,15,21
098 Tramin a.d. Weinstr.,80,,16,11,27
098 Tramin a.d. Weinstr.,81,,8,14,22
098 Tramin a.d. Weinstr.,82,,13,11,24
098 Tramin a.d. Weinstr.,83,,13,12,25
098 Tramin a.d. Weinstr.,84,,9,15,24
098 Tramin a.d. Weinstr.,85,,7,15,22
098 Tramin a.d. Weinstr.,86,,4,13,17
098 Tramin a.d. Weinstr.,87,,3,11,14
098 Tramin a.d. Weinstr.,88,,-,6,6
098 Tramin a.d. Weinstr.,89,,3,7,10
098 Tramin a.d. Weinstr.,90,,1,5,6
098 Tramin a.d. Weinstr.,91,,2,4,6
098 Tramin a.d. Weinstr.,92,,1,1,2
098 Tramin a.d. Weinstr.,94,,1,-,1
098 Tramin a.d. Weinstr.,95,,-,2,2
098 Tramin a.d. Weinstr.,96,,-,1,1
098 Tramin a.d. Weinstr.,98,,1,1,2
099 Tisens,0,,9,7,16
099 Tisens,1,,7,3,10
099 Tisens,2,,12,7,19
099 Tisens,3,,11,10,21
099 Tisens,4,,9,8,17
099 Tisens,5,,12,15,27
099 Tisens,6,,12,13,25
099 Tisens,7,,10,13,23
099 Tisens,8,,12,9,21
099 Tisens,9,,11,17,28
099 Tisens,10,,9,12,21
099 Tisens,11,,10,8,18
099 Tisens,12,,13,15,28
099 Tisens,13,,4,6,10
099 Tisens,14,,10,7,17
099 Tisens,15,,10,6,16
099 Tisens,16,,11,11,22
099 Tisens,17,,5,9,14
099 Tisens,18,,6,16,22
099 Tisens,19,,16,9,25
099 Tisens,20,,10,13,23
099 Tisens,21,,11,7,18
099 Tisens,22,,8,12,20
099 Tisens,23,,14,6,20
099 Tisens,24,,15,7,22
099 Tisens,25,,10,7,17
099 Tisens,26,,9,11,20
099 Tisens,27,,16,4,20
099 Tisens,28,,14,13,27
099 Tisens,29,,6,21,27
099 Tisens,30,,15,12,27
099 Tisens,31,,12,10,22
099 Tisens,32,,9,16,25
099 Tisens,33,,12,9,21
099 Tisens,34,,8,8,16
099 Tisens,35,,16,11,27
099 Tisens,36,,14,9,23
099 Tisens,37,,7,11,18
099 Tisens,38,,10,13,23
099 Tisens,39,,16,11,27
099 Tisens,40,,15,20,35
099 Tisens,41,,19,17,36
099 Tisens,42,,18,21,39
099 Tisens,43,,23,22,45
099 Tisens,44,,23,11,34
099 Tisens,45,,17,28,45
099 Tisens,46,,16,8,24
099 Tisens,47,,19,15,34
099 Tisens,48,,21,6,27
099 Tisens,49,,14,14,28
099 Tisens,50,,16,6,22
099 Tisens,51,,11,14,25
099 Tisens,52,,9,13,22
099 Tisens,53,,14,19,33
099 Tisens,54,,10,12,22
099 Tisens,55,,18,14,32
099 Tisens,56,,8,8,16
099 Tisens,57,,10,11,21
099 Tisens,58,,7,13,20
099 Tisens,59,,12,10,22
099 Tisens,60,,9,6,15
099 Tisens,61,,5,7,12
099 Tisens,62,,13,7,20
099 Tisens,63,,9,9,18
099 Tisens,64,,7,6,13
099 Tisens,65,,3,7,10
099 Tisens,66,,9,11,20
099 Tisens,67,,10,9,19
099 Tisens,68,,7,10,17
099 Tisens,69,,7,14,21
099 Tisens,70,,6,8,14
099 Tisens,71,,12,9,21
099 Tisens,72,,6,12,18
099 Tisens,73,,6,4,10
099 Tisens,74,,7,8,15
099 Tisens,75,,3,11,14
099 Tisens,76,,7,6,13
099 Tisens,77,,2,9,11
099 Tisens,78,,7,9,16
099 Tisens,79,,5,10,15
099 Tisens,80,,2,15,17
099 Tisens,81,,6,8,14
099 Tisens,82,,5,9,14
099 Tisens,83,,5,8,13
099 Tisens,84,,4,9,13
099 Tisens,85,,3,7,10
099 Tisens,86,,1,3,4
099 Tisens,87,,1,6,7
099 Tisens,88,,3,4,7
099 Tisens,89,,3,4,7
099 Tisens,90,,2,-,2
099 Tisens,91,,2,3,5
099 Tisens,94,,-,1,1
099 Tisens,95,,-,1,1
099 Tisens,96,,1,1,2
099 Tisens,98,,-,1,1
099 Tisens,99,,-,1,1
100 Tiers,0,,12,4,16
100 Tiers,1,,3,2,5
100 Tiers,2,,10,8,18
100 Tiers,3,,9,3,12
100 Tiers,4,,3,8,11
100 Tiers,5,,3,10,13
100 Tiers,6,,4,3,7
100 Tiers,7,,4,8,12
100 Tiers,8,,6,4,10
100 Tiers,9,,3,8,11
100 Tiers,10,,2,8,10
100 Tiers,11,,4,9,13
100 Tiers,12,,4,10,14
100 Tiers,13,,9,6,15
100 Tiers,14,,6,4,10
100 Tiers,15,,7,10,17
100 Tiers,16,,5,6,11
100 Tiers,17,,5,2,7
100 Tiers,18,,6,3,9
100 Tiers,19,,6,3,9
100 Tiers,20,,8,7,15
100 Tiers,21,,4,7,11
100 Tiers,22,,6,10,16
100 Tiers,23,,5,4,9
100 Tiers,24,,9,6,15
100 Tiers,25,,6,7,13
100 Tiers,26,,5,11,16
100 Tiers,27,,6,5,11
100 Tiers,28,,6,5,11
100 Tiers,29,,4,6,10
100 Tiers,30,,4,5,9
100 Tiers,31,,2,5,7
100 Tiers,32,,9,9,18
100 Tiers,33,,7,2,9
100 Tiers,34,,2,4,6
100 Tiers,35,,9,8,17
100 Tiers,36,,5,9,14
100 Tiers,37,,8,9,17
100 Tiers,38,,9,7,16
100 Tiers,39,,5,7,12
100 Tiers,40,,7,8,15
100 Tiers,41,,16,11,27
100 Tiers,42,,7,3,10
100 Tiers,43,,10,11,21
100 Tiers,44,,10,6,16
100 Tiers,45,,5,6,11
100 Tiers,46,,8,6,14
100 Tiers,47,,7,10,17
100 Tiers,48,,6,7,13
100 Tiers,49,,6,6,12
100 Tiers,50,,4,9,13
100 Tiers,51,,12,5,17
100 Tiers,52,,7,4,11
100 Tiers,53,,5,9,14
100 Tiers,54,,10,8,18
100 Tiers,55,,5,3,8
100 Tiers,56,,6,4,10
100 Tiers,57,,6,5,11
100 Tiers,58,,3,3,6
100 Tiers,59,,1,4,5
100 Tiers,60,,7,5,12
100 Tiers,61,,3,5,8
100 Tiers,62,,3,5,8
100 Tiers,63,,1,3,4
100 Tiers,64,,6,4,10
100 Tiers,65,,8,3,11
100 Tiers,66,,2,4,6
100 Tiers,67,,9,10,19
100 Tiers,68,,2,5,7
100 Tiers,69,,4,6,10
100 Tiers,70,,2,3,5
100 Tiers,71,,5,6,11
100 Tiers,72,,6,5,11
100 Tiers,73,,5,4,9
100 Tiers,74,,4,6,10
100 Tiers,75,,6,2,8
100 Tiers,76,,2,5,7
100 Tiers,77,,5,3,8
100 Tiers,78,,2,5,7
100 Tiers,79,,3,3,6
100 Tiers,80,,2,-,2
100 Tiers,81,,2,2,4
100 Tiers,82,,2,2,4
100 Tiers,83,,3,3,6
100 Tiers,84,,3,2,5
100 Tiers,85,,5,2,7
100 Tiers,86,,1,5,6
100 Tiers,87,,1,2,3
100 Tiers,88,,1,-,1
100 Tiers,89,,-,5,5
100 Tiers,90,,1,1,2
100 Tiers,92,,1,1,2
100 Tiers,93,,-,1,1
100 Tiers,95,,1,1,2
100 Tiers,98,,-,1,1
101 Tirol,0,,13,12,25
101 Tirol,1,,10,10,20
101 Tirol,2,,11,12,23
101 Tirol,3,,15,9,24
101 Tirol,4,,9,10,19
101 Tirol,5,,14,6,20
101 Tirol,6,,11,18,29
101 Tirol,7,,12,11,23
101 Tirol,8,,16,9,25
101 Tirol,9,,19,9,28
101 Tirol,10,,20,13,33
101 Tirol,11,,13,16,29
101 Tirol,12,,17,13,30
101 Tirol,13,,19,23,42
101 Tirol,14,,18,16,34
101 Tirol,15,,9,17,26
101 Tirol,16,,14,15,29
101 Tirol,17,,21,10,31
101 Tirol,18,,14,13,27
101 Tirol,19,,7,9,16
101 Tirol,20,,15,12,27
101 Tirol,21,,11,18,29
101 Tirol,22,,13,14,27
101 Tirol,23,,16,11,27
101 Tirol,24,,10,11,21
101 Tirol,25,,9,15,24
101 Tirol,26,,18,11,29
101 Tirol,27,,17,16,33
101 Tirol,28,,15,13,28
101 Tirol,29,,19,20,39
101 Tirol,30,,23,6,29
101 Tirol,31,,13,10,23
101 Tirol,32,,8,13,21
101 Tirol,33,,12,20,32
101 Tirol,34,,16,15,31
101 Tirol,35,,19,16,35
101 Tirol,36,,14,22,36
101 Tirol,37,,27,17,44
101 Tirol,38,,27,17,44
101 Tirol,39,,22,18,40
101 Tirol,40,,20,15,35
101 Tirol,41,,23,18,41
101 Tirol,42,,23,26,49
101 Tirol,43,,24,19,43
101 Tirol,44,,22,20,42
101 Tirol,45,,22,19,41
101 Tirol,46,,25,23,48
101 Tirol,47,,18,14,32
101 Tirol,48,,18,17,35
101 Tirol,49,,18,22,40
101 Tirol,50,,23,13,36
101 Tirol,51,,16,16,32
101 Tirol,52,,11,19,30
101 Tirol,53,,16,20,36
101 Tirol,54,,8,14,22
101 Tirol,55,,15,18,33
101 Tirol,56,,14,17,31
101 Tirol,57,,19,18,37
101 Tirol,58,,14,13,27
101 Tirol,59,,15,18,33
101 Tirol,60,,12,10,22
101 Tirol,61,,16,16,32
101 Tirol,62,,20,15,35
101 Tirol,63,,9,12,21
101 Tirol,64,,14,8,22
101 Tirol,65,,11,14,25
101 Tirol,66,,14,15,29
101 Tirol,67,,11,11,22
101 Tirol,68,,13,18,31
101 Tirol,69,,11,18,29
101 Tirol,70,,10,14,24
101 Tirol,71,,9,13,22
101 Tirol,72,,8,8,16
101 Tirol,73,,8,14,22
101 Tirol,74,,6,10,16
101 Tirol,75,,7,8,15
101 Tirol,76,,13,8,21
101 Tirol,77,,5,10,15
101 Tirol,78,,6,6,12
101 Tirol,79,,6,7,13
101 Tirol,80,,4,8,12
101 Tirol,81,,7,11,18
101 Tirol,82,,6,8,14
101 Tirol,83,,8,7,15
101 Tirol,84,,3,6,9
101 Tirol,85,,6,7,13
101 Tirol,86,,3,9,12
101 Tirol,87,,2,4,6
101 Tirol,88,,2,3,5
101 Tirol,89,,3,4,7
101 Tirol,90,,2,4,6
101 Tirol,91,,1,1,2
101 Tirol,92,,1,2,3
101 Tirol,94,,1,1,2
101 Tirol,99,,-,1,1
102 Truden im Naturpark,0,,9,6,15
102 Truden im Naturpark,1,,10,8,18
102 Truden im Naturpark,2,,5,8,13
102 Truden im Naturpark,3,,9,7,16
102 Truden im Naturpark,4,,6,1,7
102 Truden im Naturpark,5,,1,5,6
102 Truden im Naturpark,6,,3,8,11
102 Truden im Naturpark,7,,6,4,10
102 Truden im Naturpark,8,,2,3,5
102 Truden im Naturpark,9,,4,2,6
102 Truden im Naturpark,10,,6,7,13
102 Truden im Naturpark,11,,-,3,3
102 Truden im Naturpark,12,,3,7,10
102 Truden im Naturpark,13,,7,6,13
102 Truden im Naturpark,14,,6,6,12
102 Truden im Naturpark,15,,5,6,11
102 Truden im Naturpark,16,,6,5,11
102 Truden im Naturpark,17,,11,6,17
102 Truden im Naturpark,18,,7,4,11
102 Truden im Naturpark,19,,7,8,15
102 Truden im Naturpark,20,,4,5,9
102 Truden im Naturpark,21,,10,9,19
102 Truden im Naturpark,22,,7,12,19
102 Truden im Naturpark,23,,8,5,13
102 Truden im Naturpark,24,,1,7,8
102 Truden im Naturpark,25,,8,6,14
102 Truden im Naturpark,26,,11,4,15
102 Truden im Naturpark,27,,5,5,10
102 Truden im Naturpark,28,,11,4,15
102 Truden im Naturpark,29,,3,12,15
102 Truden im Naturpark,30,,5,3,8
102 Truden im Naturpark,31,,9,4,13
102 Truden im Naturpark,32,,8,6,14
102 Truden im Naturpark,33,,3,6,9
102 Truden im Naturpark,34,,8,6,14
102 Truden im Naturpark,35,,7,3,10
102 Truden im Naturpark,36,,6,9,15
102 Truden im Naturpark,37,,8,10,18
102 Truden im Naturpark,38,,9,9,18
102 Truden im Naturpark,39,,3,2,5
102 Truden im Naturpark,40,,2,8,10
102 Truden im Naturpark,41,,9,9,18
102 Truden im Naturpark,42,,6,10,16
102 Truden im Naturpark,43,,12,5,17
102 Truden im Naturpark,44,,7,8,15
102 Truden im Naturpark,45,,8,8,16
102 Truden im Naturpark,46,,10,8,18
102 Truden im Naturpark,47,,12,6,18
102 Truden im Naturpark,48,,9,4,13
102 Truden im Naturpark,49,,8,6,14
102 Truden im Naturpark,50,,8,13,21
102 Truden im Naturpark,51,,5,9,14
102 Truden im Naturpark,52,,5,11,16
102 Truden im Naturpark,53,,6,8,14
102 Truden im Naturpark,54,,7,5,12
102 Truden im Naturpark,55,,7,10,17
102 Truden im Naturpark,56,,5,6,11
102 Truden im Naturpark,57,,9,6,15
102 Truden im Naturpark,58,,5,6,11
102 Truden im Naturpark,59,,8,5,13
102 Truden im Naturpark,60,,2,2,4
102 Truden im Naturpark,61,,6,3,9
102 Truden im Naturpark,62,,1,6,7
102 Truden im Naturpark,63,,7,2,9
102 Truden im Naturpark,64,,9,6,15
102 Truden im Naturpark,65,,4,3,7
102 Truden im Naturpark,66,,3,6,9
102 Truden im Naturpark,67,,4,5,9
102 Truden im Naturpark,68,,4,4,8
102 Truden im Naturpark,69,,4,5,9
102 Truden im Naturpark,70,,2,4,6
102 Truden im Naturpark,71,,8,2,10
102 Truden im Naturpark,72,,5,7,12
102 Truden im Naturpark,73,,1,4,5
102 Truden im Naturpark,74,,4,2,6
102 Truden im Naturpark,75,,3,2,5
102 Truden im Naturpark,76,,4,1,5
102 Truden im Naturpark,77,,5,7,12
102 Truden im Naturpark,78,,4,3,7
102 Truden im Naturpark,79,,3,3,6
102 Truden im Naturpark,80,,2,6,8
102 Truden im Naturpark,81,,-,6,6
102 Truden im Naturpark,82,,-,6,6
102 Truden im Naturpark,83,,3,6,9
102 Truden im Naturpark,84,,1,7,8
102 Truden im Naturpark,85,,-,4,4
102 Truden im Naturpark,86,,-,5,5
102 Truden im Naturpark,87,,1,5,6
102 Truden im Naturpark,88,,2,4,6
102 Truden im Naturpark,89,,-,3,3
102 Truden im Naturpark,90,,-,2,2
102 Truden im Naturpark,91,,-,2,2
103 Taufers im Münstertal,0,,3,-,3
103 Taufers im Münstertal,1,,7,6,13
103 Taufers im Münstertal,2,,4,5,9
103 Taufers im Münstertal,3,,5,4,9
103 Taufers im Münstertal,4,,4,8,12
103 Taufers im Münstertal,5,,2,5,7
103 Taufers im Münstertal,6,,8,4,12
103 Taufers im Münstertal,7,,3,3,6
103 Taufers im Münstertal,8,,5,5,10
103 Taufers im Münstertal,9,,5,6,11
103 Taufers im Münstertal,10,,4,4,8
103 Taufers im Münstertal,11,,3,4,7
103 Taufers im Münstertal,12,,7,8,15
103 Taufers im Münstertal,13,,4,4,8
103 Taufers im Münstertal,14,,6,4,10
103 Taufers im Münstertal,15,,9,9,18
103 Taufers im Münstertal,16,,6,8,14
103 Taufers im Münstertal,17,,5,5,10
103 Taufers im Münstertal,18,,9,8,17
103 Taufers im Münstertal,19,,6,10,16
103 Taufers im Münstertal,20,,8,7,15
103 Taufers im Münstertal,21,,8,3,11
103 Taufers im Münstertal,22,,6,5,11
103 Taufers im Münstertal,23,,4,5,9
103 Taufers im Münstertal,24,,6,5,11
103 Taufers im Münstertal,25,,8,4,12
103 Taufers im Münstertal,26,,6,6,12
103 Taufers im Münstertal,27,,3,5,8
103 Taufers im Münstertal,28,,5,10,15
103 Taufers im Münstertal,29,,8,8,16
103 Taufers im Münstertal,30,,8,5,13
103 Taufers im Münstertal,31,,5,3,8
103 Taufers im Münstertal,32,,8,3,11
103 Taufers im Münstertal,33,,4,3,7
103 Taufers im Münstertal,34,,2,7,9
103 Taufers im Münstertal,35,,11,5,16
103 Taufers im Münstertal,36,,7,6,13
103 Taufers im Münstertal,37,,1,6,7
103 Taufers im Münstertal,38,,5,7,12
103 Taufers im Münstertal,39,,6,15,21
103 Taufers im Münstertal,40,,6,9,15
103 Taufers im Münstertal,41,,9,5,14
103 Taufers im Münstertal,42,,9,12,21
103 Taufers im Münstertal,43,,4,5,9
103 Taufers im Münstertal,44,,5,11,16
103 Taufers im Münstertal,45,,11,7,18
103 Taufers im Münstertal,46,,10,12,22
103 Taufers im Münstertal,47,,9,9,18
103 Taufers im Münstertal,48,,12,8,20
103 Taufers im Münstertal,49,,10,7,17
103 Taufers im Münstertal,50,,12,7,19
103 Taufers im Münstertal,51,,6,10,16
103 Taufers im Münstertal,52,,5,6,11
103 Taufers im Münstertal,53,,8,7,15
103 Taufers im Münstertal,54,,11,10,21
103 Taufers im Münstertal,55,,5,3,8
103 Taufers im Münstertal,56,,4,6,10
103 Taufers im Münstertal,57,,7,4,11
103 Taufers im Münstertal,58,,7,2,9
103 Taufers im Münstertal,59,,5,4,9
103 Taufers im Münstertal,60,,7,2,9
103 Taufers im Münstertal,61,,5,1,6
103 Taufers im Münstertal,62,,5,-,5
103 Taufers im Münstertal,63,,4,7,11
103 Taufers im Münstertal,64,,3,3,6
103 Taufers im Münstertal,65,,3,4,7
103 Taufers im Münstertal,66,,1,-,1
103 Taufers im Münstertal,67,,6,4,10
103 Taufers im Münstertal,68,,4,5,9
103 Taufers im Münstertal,69,,3,6,9
103 Taufers im Münstertal,70,,2,3,5
103 Taufers im Münstertal,71,,4,4,8
103 Taufers im Münstertal,72,,6,8,14
103 Taufers im Münstertal,73,,3,4,7
103 Taufers im Münstertal,74,,2,8,10
103 Taufers im Münstertal,75,,4,2,6
103 Taufers im Münstertal,76,,2,7,9
103 Taufers im Münstertal,77,,3,5,8
103 Taufers im Münstertal,78,,5,1,6
103 Taufers im Münstertal,79,,7,4,11
103 Taufers im Münstertal,80,,2,3,5
103 Taufers im Münstertal,81,,4,6,10
103 Taufers im Münstertal,82,,3,4,7
103 Taufers im Münstertal,83,,2,3,5
103 Taufers im Münstertal,84,,1,4,5
103 Taufers im Münstertal,85,,1,3,4
103 Taufers im Münstertal,86,,-,3,3
103 Taufers im Münstertal,87,,3,2,5
103 Taufers im Münstertal,88,,-,1,1
103 Taufers im Münstertal,89,,1,-,1
103 Taufers im Münstertal,90,,3,-,3
103 Taufers im Münstertal,92,,-,1,1
103 Taufers im Münstertal,93,,1,1,2
103 Taufers im Münstertal,97,,-,1,1
103 Taufers im Münstertal,98,,-,1,1
104 Ulten,0,,16,12,28
104 Ulten,1,,19,11,30
104 Ulten,2,,17,10,27
104 Ulten,3,,7,10,17
104 Ulten,4,,14,11,25
104 Ulten,5,,18,21,39
104 Ulten,6,,17,12,29
104 Ulten,7,,23,19,42
104 Ulten,8,,16,19,35
104 Ulten,9,,19,17,36
104 Ulten,10,,17,18,35
104 Ulten,11,,14,14,28
104 Ulten,12,,16,16,32
104 Ulten,13,,13,19,32
104 Ulten,14,,11,14,25
104 Ulten,15,,12,16,28
104 Ulten,16,,18,15,33
104 Ulten,17,,23,14,37
104 Ulten,18,,17,17,34
104 Ulten,19,,24,29,53
104 Ulten,20,,14,16,30
104 Ulten,21,,16,29,45
104 Ulten,22,,14,21,35
104 Ulten,23,,19,15,34
104 Ulten,24,,21,11,32
104 Ulten,25,,17,16,33
104 Ulten,26,,20,15,35
104 Ulten,27,,23,15,38
104 Ulten,28,,15,21,36
104 Ulten,29,,22,20,42
104 Ulten,30,,19,20,39
104 Ulten,31,,17,18,35
104 Ulten,32,,23,15,38
104 Ulten,33,,20,15,35
104 Ulten,34,,17,18,35
104 Ulten,35,,25,22,47
104 Ulten,36,,16,22,38
104 Ulten,37,,26,14,40
104 Ulten,38,,22,19,41
104 Ulten,39,,26,21,47
104 Ulten,40,,22,25,47
104 Ulten,41,,27,21,48
104 Ulten,42,,30,25,55
104 Ulten,43,,17,20,37
104 Ulten,44,,20,18,38
104 Ulten,45,,27,27,54
104 Ulten,46,,24,20,44
104 Ulten,47,,28,25,53
104 Ulten,48,,31,21,52
104 Ulten,49,,29,16,45
104 Ulten,50,,25,20,45
104 Ulten,51,,23,23,46
104 Ulten,52,,26,16,42
104 Ulten,53,,34,22,56
104 Ulten,54,,17,15,32
104 Ulten,55,,13,12,25
104 Ulten,56,,18,16,34
104 Ulten,57,,24,13,37
104 Ulten,58,,18,13,31
104 Ulten,59,,18,17,35
104 Ulten,60,,18,12,30
104 Ulten,61,,17,9,26
104 Ulten,62,,13,12,25
104 Ulten,63,,16,9,25
104 Ulten,64,,15,14,29
104 Ulten,65,,9,13,22
104 Ulten,66,,14,21,35
104 Ulten,67,,17,16,33
104 Ulten,68,,8,14,22
104 Ulten,69,,11,10,21
104 Ulten,70,,15,8,23
104 Ulten,71,,18,16,34
104 Ulten,72,,6,10,16
104 Ulten,73,,10,9,19
104 Ulten,74,,8,9,17
104 Ulten,75,,8,10,18
104 Ulten,76,,10,13,23
104 Ulten,77,,5,12,17
104 Ulten,78,,10,8,18
104 Ulten,79,,10,8,18
104 Ulten,80,,10,15,25
104 Ulten,81,,4,11,15
104 Ulten,82,,8,11,19
104 Ulten,83,,6,17,23
104 Ulten,84,,4,13,17
104 Ulten,85,,11,10,21
104 Ulten,86,,4,8,12
104 Ulten,87,,5,22,27
104 Ulten,88,,4,6,10
104 Ulten,89,,7,8,15
104 Ulten,90,,3,5,8
104 Ulten,91,,1,6,7
104 Ulten,92,,1,-,1
104 Ulten,95,,1,-,1
104 Ulten,96,,-,1,1
104 Ulten,99,,-,3,3
105 Pfatten,0,,6,4,10
105 Pfatten,1,,5,8,13
105 Pfatten,2,,7,6,13
105 Pfatten,3,,9,7,16
105 Pfatten,4,,8,4,12
105 Pfatten,5,,5,12,17
105 Pfatten,6,,2,6,8
105 Pfatten,7,,12,6,18
105 Pfatten,8,,3,5,8
105 Pfatten,9,,4,3,7
105 Pfatten,10,,6,6,12
105 Pfatten,11,,4,7,11
105 Pfatten,12,,9,5,14
105 Pfatten,13,,4,2,6
105 Pfatten,14,,4,9,13
105 Pfatten,15,,5,7,12
105 Pfatten,16,,8,10,18
105 Pfatten,17,,4,5,9
105 Pfatten,18,,6,7,13
105 Pfatten,19,,8,5,13
105 Pfatten,20,,9,7,16
105 Pfatten,21,,6,7,13
105 Pfatten,22,,2,5,7
105 Pfatten,23,,6,3,9
105 Pfatten,24,,6,12,18
105 Pfatten,25,,5,8,13
105 Pfatten,26,,3,6,9
105 Pfatten,27,,5,7,12
105 Pfatten,28,,6,3,9
105 Pfatten,29,,9,3,12
105 Pfatten,30,,1,4,5
105 Pfatten,31,,6,12,18
105 Pfatten,32,,6,10,16
105 Pfatten,33,,8,5,13
105 Pfatten,34,,5,10,15
105 Pfatten,35,,3,10,13
105 Pfatten,36,,15,11,26
105 Pfatten,37,,12,5,17
105 Pfatten,38,,10,9,19
105 Pfatten,39,,10,6,16
105 Pfatten,40,,8,7,15
105 Pfatten,41,,7,5,12
105 Pfatten,42,,8,9,17
105 Pfatten,43,,14,7,21
105 Pfatten,44,,9,9,18
105 Pfatten,45,,11,11,22
105 Pfatten,46,,10,3,13
105 Pfatten,47,,7,8,15
105 Pfatten,48,,9,14,23
105 Pfatten,49,,10,14,24
105 Pfatten,50,,7,9,16
105 Pfatten,51,,5,13,18
105 Pfatten,52,,7,5,12
105 Pfatten,53,,15,7,22
105 Pfatten,54,,8,9,17
105 Pfatten,55,,6,5,11
105 Pfatten,56,,12,3,15
105 Pfatten,57,,6,5,11
105 Pfatten,58,,1,6,7
105 Pfatten,59,,3,5,8
105 Pfatten,60,,5,6,11
105 Pfatten,61,,9,2,11
105 Pfatten,62,,3,2,5
105 Pfatten,63,,7,7,14
105 Pfatten,64,,3,4,7
105 Pfatten,65,,7,3,10
105 Pfatten,66,,4,2,6
105 Pfatten,67,,2,3,5
105 Pfatten,68,,2,2,4
105 Pfatten,69,,4,4,8
105 Pfatten,70,,3,3,6
105 Pfatten,71,,4,2,6
105 Pfatten,72,,2,2,4
105 Pfatten,73,,4,1,5
105 Pfatten,74,,3,3,6
105 Pfatten,75,,5,3,8
105 Pfatten,76,,2,6,8
105 Pfatten,77,,1,2,3
105 Pfatten,78,,-,5,5
105 Pfatten,79,,2,3,5
105 Pfatten,80,,2,2,4
105 Pfatten,81,,-,5,5
105 Pfatten,82,,-,1,1
105 Pfatten,84,,2,2,4
105 Pfatten,85,,1,3,4
105 Pfatten,86,,1,3,4
105 Pfatten,87,,1,-,1
105 Pfatten,88,,1,-,1
105 Pfatten,89,,-,1,1
105 Pfatten,90,,1,1,2
105 Pfatten,93,,1,1,2
105 Pfatten,94,,-,1,1
106 Olang,0,,17,22,39
106 Olang,1,,12,19,31
106 Olang,2,,23,21,44
106 Olang,3,,12,21,33
106 Olang,4,,7,18,25
106 Olang,5,,21,13,34
106 Olang,6,,15,11,26
106 Olang,7,,20,12,32
106 Olang,8,,16,13,29
106 Olang,9,,17,21,38
106 Olang,10,,19,23,42
106 Olang,11,,17,13,30
106 Olang,12,,17,22,39
106 Olang,13,,24,17,41
106 Olang,14,,26,23,49
106 Olang,15,,19,10,29
106 Olang,16,,22,11,33
106 Olang,17,,21,24,45
106 Olang,18,,16,17,33
106 Olang,19,,26,19,45
106 Olang,20,,25,23,48
106 Olang,21,,23,19,42
106 Olang,22,,17,18,35
106 Olang,23,,26,18,44
106 Olang,24,,16,20,36
106 Olang,25,,13,23,36
106 Olang,26,,28,13,41
106 Olang,27,,18,20,38
106 Olang,28,,20,24,44
106 Olang,29,,13,24,37
106 Olang,30,,22,23,45
106 Olang,31,,20,27,47
106 Olang,32,,23,19,42
106 Olang,33,,31,29,60
106 Olang,34,,21,23,44
106 Olang,35,,28,27,55
106 Olang,36,,16,27,43
106 Olang,37,,28,25,53
106 Olang,38,,29,20,49
106 Olang,39,,32,19,51
106 Olang,40,,22,21,43
106 Olang,41,,22,32,54
106 Olang,42,,29,25,54
106 Olang,43,,33,24,57
106 Olang,44,,31,25,56
106 Olang,45,,18,25,43
106 Olang,46,,20,27,47
106 Olang,47,,24,23,47
106 Olang,48,,24,14,38
106 Olang,49,,15,25,40
106 Olang,50,,21,26,47
106 Olang,51,,25,15,40
106 Olang,52,,23,14,37
106 Olang,53,,28,12,40
106 Olang,54,,14,28,42
106 Olang,55,,17,18,35
106 Olang,56,,15,19,34
106 Olang,57,,16,21,37
106 Olang,58,,15,13,28
106 Olang,59,,7,14,21
106 Olang,60,,32,17,49
106 Olang,61,,22,11,33
106 Olang,62,,19,22,41
106 Olang,63,,14,24,38
106 Olang,64,,14,12,26
106 Olang,65,,17,11,28
106 Olang,66,,15,6,21
106 Olang,67,,11,16,27
106 Olang,68,,14,16,30
106 Olang,69,,12,13,25
106 Olang,70,,16,9,25
106 Olang,71,,11,8,19
106 Olang,72,,8,14,22
106 Olang,73,,6,9,15
106 Olang,74,,6,8,14
106 Olang,75,,7,14,21
106 Olang,76,,11,8,19
106 Olang,77,,9,13,22
106 Olang,78,,9,10,19
106 Olang,79,,2,6,8
106 Olang,80,,11,6,17
106 Olang,81,,8,12,20
106 Olang,82,,4,6,10
106 Olang,83,,4,6,10
106 Olang,84,,2,8,10
106 Olang,85,,3,-,3
106 Olang,86,,2,6,8
106 Olang,87,,3,2,5
106 Olang,88,,2,4,6
106 Olang,89,,2,2,4
106 Olang,90,,1,5,6
106 Olang,91,,1,1,2
106 Olang,94,,-,1,1
106 Olang,95,,-,2,2
106 Olang,96,,-,2,2
107 Pfitsch,0,,22,10,32
107 Pfitsch,1,,16,11,27
107 Pfitsch,2,,14,22,36
107 Pfitsch,3,,14,9,23
107 Pfitsch,4,,24,13,37
107 Pfitsch,5,,15,15,30
107 Pfitsch,6,,22,11,33
107 Pfitsch,7,,17,11,28
107 Pfitsch,8,,22,19,41
107 Pfitsch,9,,10,9,19
107 Pfitsch,10,,21,24,45
107 Pfitsch,11,,19,16,35
107 Pfitsch,12,,10,17,27
107 Pfitsch,13,,16,16,32
107 Pfitsch,14,,10,13,23
107 Pfitsch,15,,16,9,25
107 Pfitsch,16,,13,18,31
107 Pfitsch,17,,14,13,27
107 Pfitsch,18,,14,14,28
107 Pfitsch,19,,18,13,31
107 Pfitsch,20,,19,17,36
107 Pfitsch,21,,10,18,28
107 Pfitsch,22,,16,13,29
107 Pfitsch,23,,11,17,28
107 Pfitsch,24,,14,10,24
107 Pfitsch,25,,16,15,31
107 Pfitsch,26,,24,7,31
107 Pfitsch,27,,22,29,51
107 Pfitsch,28,,29,16,45
107 Pfitsch,29,,24,25,49
107 Pfitsch,30,,16,21,37
107 Pfitsch,31,,29,21,50
107 Pfitsch,32,,26,22,48
107 Pfitsch,33,,16,17,33
107 Pfitsch,34,,20,27,47
107 Pfitsch,35,,17,27,44
107 Pfitsch,36,,20,21,41
107 Pfitsch,37,,21,18,39
107 Pfitsch,38,,22,20,42
107 Pfitsch,39,,28,15,43
107 Pfitsch,40,,18,21,39
107 Pfitsch,41,,27,18,45
107 Pfitsch,42,,17,19,36
107 Pfitsch,43,,21,19,40
107 Pfitsch,44,,25,16,41
107 Pfitsch,45,,21,20,41
107 Pfitsch,46,,15,24,39
107 Pfitsch,47,,19,17,36
107 Pfitsch,48,,25,21,46
107 Pfitsch,49,,22,22,44
107 Pfitsch,50,,17,24,41
107 Pfitsch,51,,14,17,31
107 Pfitsch,52,,23,14,37
107 Pfitsch,53,,23,23,46
107 Pfitsch,54,,20,14,34
107 Pfitsch,55,,14,14,28
107 Pfitsch,56,,20,20,40
107 Pfitsch,57,,22,15,37
107 Pfitsch,58,,16,23,39
107 Pfitsch,59,,22,14,36
107 Pfitsch,60,,21,19,40
107 Pfitsch,61,,13,19,32
107 Pfitsch,62,,8,8,16
107 Pfitsch,63,,10,11,21
107 Pfitsch,64,,14,14,28
107 Pfitsch,65,,11,12,23
107 Pfitsch,66,,11,13,24
107 Pfitsch,67,,20,11,31
107 Pfitsch,68,,19,13,32
107 Pfitsch,69,,12,17,29
107 Pfitsch,70,,12,15,27
107 Pfitsch,71,,14,8,22
107 Pfitsch,72,,4,13,17
107 Pfitsch,73,,6,11,17
107 Pfitsch,74,,6,11,17
107 Pfitsch,75,,6,7,13
107 Pfitsch,76,,12,6,18
107 Pfitsch,77,,12,12,24
107 Pfitsch,78,,5,12,17
107 Pfitsch,79,,7,9,16
107 Pfitsch,80,,4,10,14
107 Pfitsch,81,,11,10,21
107 Pfitsch,82,,3,12,15
107 Pfitsch,83,,7,9,16
107 Pfitsch,84,,3,9,12
107 Pfitsch,85,,6,7,13
107 Pfitsch,86,,-,8,8
107 Pfitsch,87,,2,7,9
107 Pfitsch,88,,4,3,7
107 Pfitsch,89,,-,5,5
107 Pfitsch,90,,-,3,3
107 Pfitsch,91,,1,3,4
107 Pfitsch,92,,-,1,1
107 Pfitsch,93,,1,2,3
107 Pfitsch,94,,-,1,1
107 Pfitsch,95,,-,1,1
107 Pfitsch,100,,-,1,1
108 Ahrntal,0,,29,29,58
108 Ahrntal,1,,42,42,84
108 Ahrntal,2,,25,47,72
108 Ahrntal,3,,41,43,84
108 Ahrntal,4,,40,36,76
108 Ahrntal,5,,32,36,68
108 Ahrntal,6,,32,37,69
108 Ahrntal,7,,33,39,72
108 Ahrntal,8,,31,35,66
108 Ahrntal,9,,33,30,63
108 Ahrntal,10,,49,42,91
108 Ahrntal,11,,33,39,72
108 Ahrntal,12,,37,37,74
108 Ahrntal,13,,41,45,86
108 Ahrntal,14,,39,49,88
108 Ahrntal,15,,35,30,65
108 Ahrntal,16,,28,26,54
108 Ahrntal,17,,38,41,79
108 Ahrntal,18,,41,34,75
108 Ahrntal,19,,28,35,63
108 Ahrntal,20,,41,32,73
108 Ahrntal,21,,40,36,76
108 Ahrntal,22,,29,31,60
108 Ahrntal,23,,40,38,78
108 Ahrntal,24,,37,51,88
108 Ahrntal,25,,38,42,80
108 Ahrntal,26,,41,29,70
108 Ahrntal,27,,43,47,90
108 Ahrntal,28,,40,43,83
108 Ahrntal,29,,52,41,93
108 Ahrntal,30,,40,35,75
108 Ahrntal,31,,36,47,83
108 Ahrntal,32,,34,39,73
108 Ahrntal,33,,51,46,97
108 Ahrntal,34,,48,43,91
108 Ahrntal,35,,44,39,83
108 Ahrntal,36,,46,40,86
108 Ahrntal,37,,46,39,85
108 Ahrntal,38,,55,52,107
108 Ahrntal,39,,68,44,112
108 Ahrntal,40,,54,47,101
108 Ahrntal,41,,53,43,96
108 Ahrntal,42,,52,42,94
108 Ahrntal,43,,40,49,89
108 Ahrntal,44,,59,44,103
108 Ahrntal,45,,57,42,99
108 Ahrntal,46,,51,42,93
108 Ahrntal,47,,52,43,95
108 Ahrntal,48,,37,49,86
108 Ahrntal,49,,35,36,71
108 Ahrntal,50,,37,30,67
108 Ahrntal,51,,42,40,82
108 Ahrntal,52,,47,29,76
108 Ahrntal,53,,26,40,66
108 Ahrntal,54,,37,20,57
108 Ahrntal,55,,35,25,60
108 Ahrntal,56,,35,21,56
108 Ahrntal,57,,26,30,56
108 Ahrntal,58,,26,34,60
108 Ahrntal,59,,31,23,54
108 Ahrntal,60,,32,20,52
108 Ahrntal,61,,33,31,64
108 Ahrntal,62,,28,27,55
108 Ahrntal,63,,25,18,43
108 Ahrntal,64,,17,22,39
108 Ahrntal,65,,20,13,33
108 Ahrntal,66,,18,18,36
108 Ahrntal,67,,21,30,51
108 Ahrntal,68,,27,31,58
108 Ahrntal,69,,28,31,59
108 Ahrntal,70,,30,23,53
108 Ahrntal,71,,21,24,45
108 Ahrntal,72,,32,30,62
108 Ahrntal,73,,22,22,44
108 Ahrntal,74,,20,15,35
108 Ahrntal,75,,16,36,52
108 Ahrntal,76,,18,20,38
108 Ahrntal,77,,16,17,33
108 Ahrntal,78,,17,26,43
108 Ahrntal,79,,24,17,41
108 Ahrntal,80,,16,16,32
108 Ahrntal,81,,12,16,28
108 Ahrntal,82,,12,23,35
108 Ahrntal,83,,10,16,26
108 Ahrntal,84,,10,13,23
108 Ahrntal,85,,7,13,20
108 Ahrntal,86,,7,8,15
108 Ahrntal,87,,5,8,13
108 Ahrntal,88,,5,10,15
108 Ahrntal,89,,4,2,6
108 Ahrntal,90,,2,3,5
108 Ahrntal,91,,5,4,9
108 Ahrntal,92,,-,3,3
108 Ahrntal,93,,-,2,2
108 Ahrntal,94,,-,2,2
108 Ahrntal,95,,-,4,4
108 Ahrntal,96,,1,5,6
108 Ahrntal,100,,1,-,1
109 Gsies,0,,17,15,32
109 Gsies,1,,18,19,37
109 Gsies,2,,15,10,25
109 Gsies,3,,18,13,31
109 Gsies,4,,21,20,41
109 Gsies,5,,18,16,34
109 Gsies,6,,12,13,25
109 Gsies,7,,19,18,37
109 Gsies,8,,13,13,26
109 Gsies,9,,15,14,29
109 Gsies,10,,10,12,22
109 Gsies,11,,31,10,41
109 Gsies,12,,19,5,24
109 Gsies,13,,13,17,30
109 Gsies,14,,11,17,28
109 Gsies,15,,15,17,32
109 Gsies,16,,9,17,26
109 Gsies,17,,17,19,36
109 Gsies,18,,16,10,26
109 Gsies,19,,15,23,38
109 Gsies,20,,17,12,29
109 Gsies,21,,9,12,21
109 Gsies,22,,8,16,24
109 Gsies,23,,19,17,36
109 Gsies,24,,12,17,29
109 Gsies,25,,15,15,30
109 Gsies,26,,13,11,24
109 Gsies,27,,19,10,29
109 Gsies,28,,18,20,38
109 Gsies,29,,16,20,36
109 Gsies,30,,24,20,44
109 Gsies,31,,10,15,25
109 Gsies,32,,16,12,28
109 Gsies,33,,14,19,33
109 Gsies,34,,12,19,31
109 Gsies,35,,17,22,39
109 Gsies,36,,19,16,35
109 Gsies,37,,14,11,25
109 Gsies,38,,7,21,28
109 Gsies,39,,19,18,37
109 Gsies,40,,27,13,40
109 Gsies,41,,23,10,33
109 Gsies,42,,15,15,30
109 Gsies,43,,16,14,30
109 Gsies,44,,15,19,34
109 Gsies,45,,19,4,23
109 Gsies,46,,17,18,35
109 Gsies,47,,14,14,28
109 Gsies,48,,16,8,24
109 Gsies,49,,9,14,23
109 Gsies,50,,15,18,33
109 Gsies,51,,11,14,25
109 Gsies,52,,16,16,32
109 Gsies,53,,12,13,25
109 Gsies,54,,16,7,23
109 Gsies,55,,14,10,24
109 Gsies,56,,16,6,22
109 Gsies,57,,18,6,24
109 Gsies,58,,17,14,31
109 Gsies,59,,14,12,26
109 Gsies,60,,8,8,16
109 Gsies,61,,15,16,31
109 Gsies,62,,6,10,16
109 Gsies,63,,22,6,28
109 Gsies,64,,15,10,25
109 Gsies,65,,4,12,16
109 Gsies,66,,7,13,20
109 Gsies,67,,9,9,18
109 Gsies,68,,5,13,18
109 Gsies,69,,6,11,17
109 Gsies,70,,7,10,17
109 Gsies,71,,6,9,15
109 Gsies,72,,9,9,18
109 Gsies,73,,10,7,17
109 Gsies,74,,4,11,15
109 Gsies,75,,4,7,11
109 Gsies,76,,3,9,12
109 Gsies,77,,6,6,12
109 Gsies,78,,7,5,12
109 Gsies,79,,5,7,12
109 Gsies,80,,10,6,16
109 Gsies,81,,3,5,8
109 Gsies,82,,7,9,16
109 Gsies,83,,1,8,9
109 Gsies,84,,3,2,5
109 Gsies,85,,5,3,8
109 Gsies,86,,3,4,7
109 Gsies,87,,5,6,11
109 Gsies,88,,4,6,10
109 Gsies,89,,1,6,7
109 Gsies,90,,2,-,2
109 Gsies,91,,2,1,3
109 Gsies,92,,-,1,1
109 Gsies,93,,1,-,1
109 Gsies,95,,1,-,1
109 Gsies,99,,-,1,1
110 Vintl,0,,16,15,31
110 Vintl,1,,22,20,42
110 Vintl,2,,21,18,39
110 Vintl,3,,25,18,43
110 Vintl,4,,13,13,26
110 Vintl,5,,21,25,46
110 Vintl,6,,11,14,25
110 Vintl,7,,17,18,35
110 Vintl,8,,14,20,34
110 Vintl,9,,15,20,35
110 Vintl,10,,22,15,37
110 Vintl,11,,21,24,45
110 Vintl,12,,20,28,48
110 Vintl,13,,20,15,35
110 Vintl,14,,21,19,40
110 Vintl,15,,38,25,63
110 Vintl,16,,18,18,36
110 Vintl,17,,25,20,45
110 Vintl,18,,28,21,49
110 Vintl,19,,25,31,56
110 Vintl,20,,29,22,51
110 Vintl,21,,27,15,42
110 Vintl,22,,22,19,41
110 Vintl,23,,19,24,43
110 Vintl,24,,20,21,41
110 Vintl,25,,10,18,28
110 Vintl,26,,26,12,38
110 Vintl,27,,22,17,39
110 Vintl,28,,23,26,49
110 Vintl,29,,17,22,39
110 Vintl,30,,31,18,49
110 Vintl,31,,27,19,46
110 Vintl,32,,22,35,57
110 Vintl,33,,19,24,43
110 Vintl,34,,23,23,46
110 Vintl,35,,23,19,42
110 Vintl,36,,26,25,51
110 Vintl,37,,16,21,37
110 Vintl,38,,28,15,43
110 Vintl,39,,30,27,57
110 Vintl,40,,19,18,37
110 Vintl,41,,27,25,52
110 Vintl,42,,25,23,48
110 Vintl,43,,30,33,63
110 Vintl,44,,31,28,59
110 Vintl,45,,31,31,62
110 Vintl,46,,32,24,56
110 Vintl,47,,34,27,61
110 Vintl,48,,32,22,54
110 Vintl,49,,25,32,57
110 Vintl,50,,18,22,40
110 Vintl,51,,21,22,43
110 Vintl,52,,21,15,36
110 Vintl,53,,22,27,49
110 Vintl,54,,27,17,44
110 Vintl,55,,20,13,33
110 Vintl,56,,15,18,33
110 Vintl,57,,22,11,33
110 Vintl,58,,15,17,32
110 Vintl,59,,22,16,38
110 Vintl,60,,23,19,42
110 Vintl,61,,19,21,40
110 Vintl,62,,13,13,26
110 Vintl,63,,22,13,35
110 Vintl,64,,17,12,29
110 Vintl,65,,13,19,32
110 Vintl,66,,11,5,16
110 Vintl,67,,20,11,31
110 Vintl,68,,10,10,20
110 Vintl,69,,7,15,22
110 Vintl,70,,8,19,27
110 Vintl,71,,15,15,30
110 Vintl,72,,9,6,15
110 Vintl,73,,9,8,17
110 Vintl,74,,13,11,24
110 Vintl,75,,9,10,19
110 Vintl,76,,15,8,23
110 Vintl,77,,3,17,20
110 Vintl,78,,8,12,20
110 Vintl,79,,9,10,19
110 Vintl,80,,5,14,19
110 Vintl,81,,6,13,19
110 Vintl,82,,7,7,14
110 Vintl,83,,4,11,15
110 Vintl,84,,9,3,12
110 Vintl,85,,3,4,7
110 Vintl,86,,2,6,8
110 Vintl,87,,3,6,9
110 Vintl,88,,3,6,9
110 Vintl,89,,2,3,5
110 Vintl,90,,-,7,7
110 Vintl,91,,-,2,2
110 Vintl,93,,-,2,2
110 Vintl,94,,-,1,1
110 Vintl,95,,1,1,2
110 Vintl,96,,-,1,1
110 Vintl,98,,1,-,1
110 Vintl,99,,-,1,1
111 Vahrn,0,,29,24,53
111 Vahrn,1,,31,25,56
111 Vahrn,2,,21,25,46
111 Vahrn,3,,35,20,55
111 Vahrn,4,,32,31,63
111 Vahrn,5,,30,30,60
111 Vahrn,6,,30,28,58
111 Vahrn,7,,29,13,42
111 Vahrn,8,,27,31,58
111 Vahrn,9,,27,19,46
111 Vahrn,10,,27,21,48
111 Vahrn,11,,27,33,60
111 Vahrn,12,,22,23,45
111 Vahrn,13,,20,22,42
111 Vahrn,14,,35,18,53
111 Vahrn,15,,24,23,47
111 Vahrn,16,,22,21,43
111 Vahrn,17,,22,21,43
111 Vahrn,18,,17,26,43
111 Vahrn,19,,22,23,45
111 Vahrn,20,,15,26,41
111 Vahrn,21,,28,20,48
111 Vahrn,22,,24,20,44
111 Vahrn,23,,20,23,43
111 Vahrn,24,,23,15,38
111 Vahrn,25,,26,27,53
111 Vahrn,26,,22,20,42
111 Vahrn,27,,26,33,59
111 Vahrn,28,,26,31,57
111 Vahrn,29,,29,32,61
111 Vahrn,30,,25,33,58
111 Vahrn,31,,22,34,56
111 Vahrn,32,,31,33,64
111 Vahrn,33,,25,30,55
111 Vahrn,34,,45,28,73
111 Vahrn,35,,36,36,72
111 Vahrn,36,,32,41,73
111 Vahrn,37,,44,42,86
111 Vahrn,38,,40,41,81
111 Vahrn,39,,40,31,71
111 Vahrn,40,,46,43,89
111 Vahrn,41,,48,44,92
111 Vahrn,42,,33,33,66
111 Vahrn,43,,46,35,81
111 Vahrn,44,,41,33,74
111 Vahrn,45,,41,40,81
111 Vahrn,46,,34,38,72
111 Vahrn,47,,37,35,72
111 Vahrn,48,,27,36,63
111 Vahrn,49,,30,25,55
111 Vahrn,50,,34,32,66
111 Vahrn,51,,31,29,60
111 Vahrn,52,,20,19,39
111 Vahrn,53,,31,29,60
111 Vahrn,54,,21,23,44
111 Vahrn,55,,27,32,59
111 Vahrn,56,,19,30,49
111 Vahrn,57,,23,25,48
111 Vahrn,58,,22,15,37
111 Vahrn,59,,20,14,34
111 Vahrn,60,,18,20,38
111 Vahrn,61,,22,33,55
111 Vahrn,62,,18,18,36
111 Vahrn,63,,16,26,42
111 Vahrn,64,,19,23,42
111 Vahrn,65,,12,13,25
111 Vahrn,66,,17,20,37
111 Vahrn,67,,22,24,46
111 Vahrn,68,,16,22,38
111 Vahrn,69,,19,22,41
111 Vahrn,70,,20,17,37
111 Vahrn,71,,19,20,39
111 Vahrn,72,,12,9,21
111 Vahrn,73,,15,19,34
111 Vahrn,74,,10,15,25
111 Vahrn,75,,7,13,20
111 Vahrn,76,,13,13,26
111 Vahrn,77,,8,12,20
111 Vahrn,78,,7,12,19
111 Vahrn,79,,8,12,20
111 Vahrn,80,,12,10,22
111 Vahrn,81,,5,18,23
111 Vahrn,82,,7,13,20
111 Vahrn,83,,2,16,18
111 Vahrn,84,,4,3,7
111 Vahrn,85,,2,11,13
111 Vahrn,86,,4,7,11
111 Vahrn,87,,4,7,11
111 Vahrn,88,,1,6,7
111 Vahrn,89,,2,4,6
111 Vahrn,90,,1,3,4
111 Vahrn,91,,2,-,2
111 Vahrn,92,,-,1,1
111 Vahrn,93,,-,2,2
111 Vahrn,94,,1,-,1
111 Vahrn,96,,-,2,2
111 Vahrn,98,,-,1,1
111 Vahrn,99,,-,1,1
111 Vahrn,100,,-,1,1
112 Vöran,0,,9,4,13
112 Vöran,1,,4,5,9
112 Vöran,2,,7,3,10
112 Vöran,3,,6,3,9
112 Vöran,4,,8,3,11
112 Vöran,5,,3,4,7
112 Vöran,6,,2,6,8
112 Vöran,7,,8,5,13
112 Vöran,8,,5,6,11
112 Vöran,9,,8,4,12
112 Vöran,10,,11,5,16
112 Vöran,11,,5,3,8
112 Vöran,12,,4,4,8
112 Vöran,13,,11,7,18
112 Vöran,14,,9,5,14
112 Vöran,15,,5,9,14
112 Vöran,16,,7,7,14
112 Vöran,17,,8,6,14
112 Vöran,18,,6,3,9
112 Vöran,19,,7,3,10
112 Vöran,20,,5,7,12
112 Vöran,21,,10,6,16
112 Vöran,22,,8,9,17
112 Vöran,23,,11,5,16
112 Vöran,24,,6,7,13
112 Vöran,25,,9,8,17
112 Vöran,26,,8,6,14
112 Vöran,27,,5,3,8
112 Vöran,28,,7,8,15
112 Vöran,29,,10,12,22
112 Vöran,30,,5,4,9
112 Vöran,31,,3,6,9
112 Vöran,32,,7,9,16
112 Vöran,33,,9,5,14
112 Vöran,34,,6,6,12
112 Vöran,35,,8,6,14
112 Vöran,36,,16,10,26
112 Vöran,37,,5,5,10
112 Vöran,38,,9,7,16
112 Vöran,39,,7,10,17
112 Vöran,40,,7,6,13
112 Vöran,41,,6,4,10
112 Vöran,42,,14,3,17
112 Vöran,43,,3,6,9
112 Vöran,44,,10,6,16
112 Vöran,45,,4,3,7
112 Vöran,46,,11,4,15
112 Vöran,47,,8,7,15
112 Vöran,48,,13,14,27
112 Vöran,49,,4,5,9
112 Vöran,50,,6,6,12
112 Vöran,51,,3,7,10
112 Vöran,52,,6,6,12
112 Vöran,53,,5,9,14
112 Vöran,54,,2,1,3
112 Vöran,55,,5,2,7
112 Vöran,56,,5,5,10
112 Vöran,57,,5,4,9
112 Vöran,58,,9,2,11
112 Vöran,59,,4,-,4
112 Vöran,60,,7,4,11
112 Vöran,61,,7,6,13
112 Vöran,62,,2,3,5
112 Vöran,63,,5,3,8
112 Vöran,64,,4,2,6
112 Vöran,65,,-,4,4
112 Vöran,66,,4,3,7
112 Vöran,67,,3,5,8
112 Vöran,68,,5,4,9
112 Vöran,69,,4,6,10
112 Vöran,70,,2,5,7
112 Vöran,71,,2,3,5
112 Vöran,72,,8,3,11
112 Vöran,73,,2,2,4
112 Vöran,74,,3,5,8
112 Vöran,75,,2,-,2
112 Vöran,76,,1,6,7
112 Vöran,77,,6,6,12
112 Vöran,78,,2,4,6
112 Vöran,79,,3,-,3
112 Vöran,80,,5,1,6
112 Vöran,81,,1,1,2
112 Vöran,82,,3,1,4
112 Vöran,83,,-,2,2
112 Vöran,84,,-,3,3
112 Vöran,85,,2,3,5
112 Vöran,86,,-,1,1
112 Vöran,87,,1,1,2
112 Vöran,88,,1,-,1
112 Vöran,89,,1,-,1
112 Vöran,90,,-,2,2
112 Vöran,99,,-,1,1
113 Niederdorf,0,,9,5,14
113 Niederdorf,1,,12,9,21
113 Niederdorf,2,,8,7,15
113 Niederdorf,3,,8,12,20
113 Niederdorf,4,,7,7,14
113 Niederdorf,5,,16,7,23
113 Niederdorf,6,,10,18,28
113 Niederdorf,7,,7,12,19
113 Niederdorf,8,,6,12,18
113 Niederdorf,9,,9,10,19
113 Niederdorf,10,,13,11,24
113 Niederdorf,11,,4,5,9
113 Niederdorf,12,,7,12,19
113 Niederdorf,13,,9,9,18
113 Niederdorf,14,,6,7,13
113 Niederdorf,15,,6,10,16
113 Niederdorf,16,,13,8,21
113 Niederdorf,17,,9,6,15
113 Niederdorf,18,,8,9,17
113 Niederdorf,19,,7,13,20
113 Niederdorf,20,,14,11,25
113 Niederdorf,21,,10,7,17
113 Niederdorf,22,,9,8,17
113 Niederdorf,23,,2,9,11
113 Niederdorf,24,,4,7,11
113 Niederdorf,25,,8,8,16
113 Niederdorf,26,,8,4,12
113 Niederdorf,27,,9,9,18
113 Niederdorf,28,,3,16,19
113 Niederdorf,29,,10,7,17
113 Niederdorf,30,,10,5,15
113 Niederdorf,31,,10,7,17
113 Niederdorf,32,,5,1,6
113 Niederdorf,33,,7,8,15
113 Niederdorf,34,,10,10,20
113 Niederdorf,35,,8,12,20
113 Niederdorf,36,,11,9,20
113 Niederdorf,37,,12,11,23
113 Niederdorf,38,,16,8,24
113 Niederdorf,39,,6,14,20
113 Niederdorf,40,,8,12,20
113 Niederdorf,41,,23,16,39
113 Niederdorf,42,,15,12,27
113 Niederdorf,43,,13,18,31
113 Niederdorf,44,,23,10,33
113 Niederdorf,45,,9,16,25
113 Niederdorf,46,,19,16,35
113 Niederdorf,47,,10,10,20
113 Niederdorf,48,,23,11,34
113 Niederdorf,49,,14,10,24
113 Niederdorf,50,,8,10,18
113 Niederdorf,51,,12,8,20
113 Niederdorf,52,,6,5,11
113 Niederdorf,53,,9,11,20
113 Niederdorf,54,,7,11,18
113 Niederdorf,55,,10,8,18
113 Niederdorf,56,,11,6,17
113 Niederdorf,57,,7,4,11
113 Niederdorf,58,,8,5,13
113 Niederdorf,59,,2,2,4
113 Niederdorf,60,,5,5,10
113 Niederdorf,61,,9,4,13
113 Niederdorf,62,,5,10,15
113 Niederdorf,63,,7,7,14
113 Niederdorf,64,,6,7,13
113 Niederdorf,65,,2,6,8
113 Niederdorf,66,,6,7,13
113 Niederdorf,67,,5,9,14
113 Niederdorf,68,,5,8,13
113 Niederdorf,69,,4,5,9
113 Niederdorf,70,,4,7,11
113 Niederdorf,71,,2,3,5
113 Niederdorf,72,,8,5,13
113 Niederdorf,73,,6,7,13
113 Niederdorf,74,,4,8,12
113 Niederdorf,75,,7,7,14
113 Niederdorf,76,,1,12,13
113 Niederdorf,77,,6,7,13
113 Niederdorf,78,,8,6,14
113 Niederdorf,79,,6,5,11
113 Niederdorf,80,,5,9,14
113 Niederdorf,81,,4,7,11
113 Niederdorf,82,,4,4,8
113 Niederdorf,83,,4,9,13
113 Niederdorf,84,,1,4,5
113 Niederdorf,85,,-,6,6
113 Niederdorf,86,,3,6,9
113 Niederdorf,87,,3,1,4
113 Niederdorf,88,,1,6,7
113 Niederdorf,89,,3,4,7
113 Niederdorf,90,,-,1,1
113 Niederdorf,93,,2,-,2
113 Niederdorf,94,,-,1,1
113 Niederdorf,95,,-,1,1
113 Niederdorf,100,,-,1,1
113 Niederdorf,105,,-,1,1
114 Villanders,0,,15,9,24
114 Villanders,1,,10,7,17
114 Villanders,2,,7,9,16
114 Villanders,3,,13,14,27
114 Villanders,4,,13,14,27
114 Villanders,5,,17,8,25
114 Villanders,6,,13,14,27
114 Villanders,7,,6,12,18
114 Villanders,8,,7,10,17
114 Villanders,9,,13,11,24
114 Villanders,10,,10,17,27
114 Villanders,11,,13,11,24
114 Villanders,12,,13,8,21
114 Villanders,13,,10,13,23
114 Villanders,14,,14,8,22
114 Villanders,15,,18,6,24
114 Villanders,16,,11,12,23
114 Villanders,17,,7,19,26
114 Villanders,18,,14,8,22
114 Villanders,19,,16,14,30
114 Villanders,20,,16,15,31
114 Villanders,21,,14,10,24
114 Villanders,22,,11,13,24
114 Villanders,23,,7,11,18
114 Villanders,24,,10,10,20
114 Villanders,25,,8,13,21
114 Villanders,26,,15,15,30
114 Villanders,27,,14,3,17
114 Villanders,28,,15,11,26
114 Villanders,29,,21,14,35
114 Villanders,30,,10,17,27
114 Villanders,31,,16,6,22
114 Villanders,32,,12,9,21
114 Villanders,33,,18,13,31
114 Villanders,34,,15,9,24
114 Villanders,35,,13,12,25
114 Villanders,36,,15,17,32
114 Villanders,37,,11,18,29
114 Villanders,38,,17,20,37
114 Villanders,39,,16,18,34
114 Villanders,40,,14,11,25
114 Villanders,41,,26,18,44
114 Villanders,42,,23,11,34
114 Villanders,43,,20,13,33
114 Villanders,44,,21,17,38
114 Villanders,45,,23,18,41
114 Villanders,46,,19,16,35
114 Villanders,47,,15,12,27
114 Villanders,48,,17,10,27
114 Villanders,49,,15,12,27
114 Villanders,50,,18,6,24
114 Villanders,51,,15,11,26
114 Villanders,52,,17,7,24
114 Villanders,53,,10,7,17
114 Villanders,54,,10,8,18
114 Villanders,55,,11,17,28
114 Villanders,56,,7,7,14
114 Villanders,57,,10,11,21
114 Villanders,58,,12,7,19
114 Villanders,59,,10,7,17
114 Villanders,60,,12,8,20
114 Villanders,61,,11,5,16
114 Villanders,62,,7,12,19
114 Villanders,63,,5,8,13
114 Villanders,64,,8,10,18
114 Villanders,65,,6,3,9
114 Villanders,66,,3,9,12
114 Villanders,67,,7,7,14
114 Villanders,68,,10,8,18
114 Villanders,69,,7,9,16
114 Villanders,70,,9,11,20
114 Villanders,71,,7,5,12
114 Villanders,72,,7,6,13
114 Villanders,73,,3,9,12
114 Villanders,74,,6,7,13
114 Villanders,75,,2,8,10
114 Villanders,76,,1,9,10
114 Villanders,77,,7,9,16
114 Villanders,78,,8,9,17
114 Villanders,79,,5,8,13
114 Villanders,80,,6,5,11
114 Villanders,81,,3,8,11
114 Villanders,82,,2,7,9
114 Villanders,83,,4,4,8
114 Villanders,84,,2,3,5
114 Villanders,85,,2,6,8
114 Villanders,86,,3,1,4
114 Villanders,87,,4,2,6
114 Villanders,88,,1,3,4
114 Villanders,89,,1,8,9
114 Villanders,90,,1,4,5
114 Villanders,91,,-,2,2
114 Villanders,97,,-,1,1
114 Villanders,98,,-,1,1
115 Sterzing,0,,30,36,66
115 Sterzing,1,,34,33,67
115 Sterzing,2,,38,35,73
115 Sterzing,3,,34,32,66
115 Sterzing,4,,36,30,66
115 Sterzing,5,,32,27,59
115 Sterzing,6,,27,34,61
115 Sterzing,7,,31,38,69
115 Sterzing,8,,34,29,63
115 Sterzing,9,,33,30,63
115 Sterzing,10,,31,34,65
115 Sterzing,11,,30,27,57
115 Sterzing,12,,27,28,55
115 Sterzing,13,,32,38,70
115 Sterzing,14,,30,38,68
115 Sterzing,15,,36,27,63
115 Sterzing,16,,32,24,56
115 Sterzing,17,,34,29,63
115 Sterzing,18,,32,34,66
115 Sterzing,19,,36,32,68
115 Sterzing,20,,27,37,64
115 Sterzing,21,,36,26,62
115 Sterzing,22,,37,29,66
115 Sterzing,23,,37,33,70
115 Sterzing,24,,47,38,85
115 Sterzing,25,,27,38,65
115 Sterzing,26,,49,43,92
115 Sterzing,27,,60,43,103
115 Sterzing,28,,82,52,134
115 Sterzing,29,,88,42,130
115 Sterzing,30,,50,53,103
115 Sterzing,31,,54,47,101
115 Sterzing,32,,71,35,106
115 Sterzing,33,,39,37,76
115 Sterzing,34,,43,42,85
115 Sterzing,35,,52,42,94
115 Sterzing,36,,50,41,91
115 Sterzing,37,,49,61,110
115 Sterzing,38,,53,55,108
115 Sterzing,39,,48,51,99
115 Sterzing,40,,59,61,120
115 Sterzing,41,,51,37,88
115 Sterzing,42,,57,56,113
115 Sterzing,43,,69,47,116
115 Sterzing,44,,56,53,109
115 Sterzing,45,,58,44,102
115 Sterzing,46,,48,44,92
115 Sterzing,47,,51,53,104
115 Sterzing,48,,42,46,88
115 Sterzing,49,,40,39,79
115 Sterzing,50,,43,48,91
115 Sterzing,51,,56,41,97
115 Sterzing,52,,41,41,82
115 Sterzing,53,,35,48,83
115 Sterzing,54,,41,26,67
115 Sterzing,55,,37,45,82
115 Sterzing,56,,35,36,71
115 Sterzing,57,,30,43,73
115 Sterzing,58,,42,38,80
115 Sterzing,59,,35,42,77
115 Sterzing,60,,36,35,71
115 Sterzing,61,,36,47,83
115 Sterzing,62,,38,45,83
115 Sterzing,63,,29,26,55
115 Sterzing,64,,42,43,85
115 Sterzing,65,,37,37,74
115 Sterzing,66,,32,29,61
115 Sterzing,67,,38,47,85
115 Sterzing,68,,26,37,63
115 Sterzing,69,,28,29,57
115 Sterzing,70,,35,32,67
115 Sterzing,71,,23,31,54
115 Sterzing,72,,28,27,55
115 Sterzing,73,,20,36,56
115 Sterzing,74,,19,40,59
115 Sterzing,75,,19,25,44
115 Sterzing,76,,14,23,37
115 Sterzing,77,,25,27,52
115 Sterzing,78,,14,14,28
115 Sterzing,79,,18,31,49
115 Sterzing,80,,7,18,25
115 Sterzing,81,,11,16,27
115 Sterzing,82,,15,24,39
115 Sterzing,83,,11,18,29
115 Sterzing,84,,9,19,28
115 Sterzing,85,,4,15,19
115 Sterzing,86,,5,17,22
115 Sterzing,87,,6,14,20
115 Sterzing,88,,6,15,21
115 Sterzing,89,,2,10,12
115 Sterzing,90,,2,3,5
115 Sterzing,91,,1,2,3
115 Sterzing,92,,1,2,3
115 Sterzing,94,,-,1,1
115 Sterzing,95,,-,3,3
115 Sterzing,96,,-,1,1
115 Sterzing,98,,-,1,1
116 Feldthurns,0,,18,20,38
116 Feldthurns,1,,16,18,34
116 Feldthurns,2,,18,19,37
116 Feldthurns,3,,25,17,42
116 Feldthurns,4,,28,24,52
116 Feldthurns,5,,25,17,42
116 Feldthurns,6,,20,16,36
116 Feldthurns,7,,12,13,25
116 Feldthurns,8,,23,20,43
116 Feldthurns,9,,16,20,36
116 Feldthurns,10,,25,14,39
116 Feldthurns,11,,19,19,38
116 Feldthurns,12,,22,20,42
116 Feldthurns,13,,22,16,38
116 Feldthurns,14,,16,20,36
116 Feldthurns,15,,18,20,38
116 Feldthurns,16,,15,19,34
116 Feldthurns,17,,26,20,46
116 Feldthurns,18,,20,19,39
116 Feldthurns,19,,13,12,25
116 Feldthurns,20,,13,14,27
116 Feldthurns,21,,21,13,34
116 Feldthurns,22,,14,19,33
116 Feldthurns,23,,24,11,35
116 Feldthurns,24,,16,18,34
116 Feldthurns,25,,15,20,35
116 Feldthurns,26,,17,21,38
116 Feldthurns,27,,23,24,47
116 Feldthurns,28,,16,17,33
116 Feldthurns,29,,21,18,39
116 Feldthurns,30,,15,21,36
116 Feldthurns,31,,12,19,31
116 Feldthurns,32,,32,20,52
116 Feldthurns,33,,22,13,35
116 Feldthurns,34,,25,23,48
116 Feldthurns,35,,22,18,40
116 Feldthurns,36,,27,26,53
116 Feldthurns,37,,21,18,39
116 Feldthurns,38,,28,22,50
116 Feldthurns,39,,19,27,46
116 Feldthurns,40,,20,19,39
116 Feldthurns,41,,26,25,51
116 Feldthurns,42,,21,27,48
116 Feldthurns,43,,23,22,45
116 Feldthurns,44,,22,22,44
116 Feldthurns,45,,25,26,51
116 Feldthurns,46,,23,20,43
116 Feldthurns,47,,29,20,49
116 Feldthurns,48,,13,18,31
116 Feldthurns,49,,17,17,34
116 Feldthurns,50,,16,13,29
116 Feldthurns,51,,16,16,32
116 Feldthurns,52,,14,19,33
116 Feldthurns,53,,15,13,28
116 Feldthurns,54,,11,19,30
116 Feldthurns,55,,13,13,26
116 Feldthurns,56,,14,14,28
116 Feldthurns,57,,17,12,29
116 Feldthurns,58,,22,15,37
116 Feldthurns,59,,13,12,25
116 Feldthurns,60,,14,14,28
116 Feldthurns,61,,7,15,22
116 Feldthurns,62,,12,11,23
116 Feldthurns,63,,14,9,23
116 Feldthurns,64,,11,10,21
116 Feldthurns,65,,13,12,25
116 Feldthurns,66,,18,10,28
116 Feldthurns,67,,10,11,21
116 Feldthurns,68,,8,7,15
116 Feldthurns,69,,6,4,10
116 Feldthurns,70,,9,6,15
116 Feldthurns,71,,8,11,19
116 Feldthurns,72,,11,8,19
116 Feldthurns,73,,4,9,13
116 Feldthurns,74,,6,8,14
116 Feldthurns,75,,9,11,20
116 Feldthurns,76,,2,5,7
116 Feldthurns,77,,6,4,10
116 Feldthurns,78,,6,8,14
116 Feldthurns,79,,4,7,11
116 Feldthurns,80,,4,14,18
116 Feldthurns,81,,3,9,12
116 Feldthurns,82,,7,4,11
116 Feldthurns,83,,2,3,5
116 Feldthurns,84,,1,7,8
116 Feldthurns,85,,4,7,11
116 Feldthurns,86,,1,8,9
116 Feldthurns,87,,4,6,10
116 Feldthurns,88,,1,5,6
116 Feldthurns,89,,1,5,6
116 Feldthurns,90,,1,7,8
116 Feldthurns,91,,2,2,4
116 Feldthurns,94,,-,2,2
116 Feldthurns,95,,-,3,3
116 Feldthurns,98,,-,1,1
117 Wengen,0,,12,15,27
117 Wengen,1,,7,7,14
117 Wengen,2,,6,9,15
117 Wengen,3,,11,11,22
117 Wengen,4,,7,9,16
117 Wengen,5,,9,5,14
117 Wengen,6,,5,9,14
117 Wengen,7,,5,7,12
117 Wengen,8,,10,4,14
117 Wengen,9,,5,10,15
117 Wengen,10,,10,6,16
117 Wengen,11,,9,5,14
117 Wengen,12,,7,8,15
117 Wengen,13,,12,8,20
117 Wengen,14,,9,8,17
117 Wengen,15,,11,9,20
117 Wengen,16,,12,7,19
117 Wengen,17,,10,7,17
117 Wengen,18,,10,7,17
117 Wengen,19,,17,8,25
117 Wengen,20,,12,7,19
117 Wengen,21,,6,6,12
117 Wengen,22,,6,11,17
117 Wengen,23,,11,5,16
117 Wengen,24,,8,8,16
117 Wengen,25,,9,6,15
117 Wengen,26,,14,10,24
117 Wengen,27,,13,4,17
117 Wengen,28,,11,7,18
117 Wengen,29,,6,6,12
117 Wengen,30,,8,14,22
117 Wengen,31,,13,5,18
117 Wengen,32,,5,6,11
117 Wengen,33,,11,8,19
117 Wengen,34,,6,5,11
117 Wengen,35,,18,11,29
117 Wengen,36,,11,6,17
117 Wengen,37,,18,11,29
117 Wengen,38,,12,11,23
117 Wengen,39,,13,14,27
117 Wengen,40,,11,14,25
117 Wengen,41,,7,9,16
117 Wengen,42,,17,10,27
117 Wengen,43,,10,13,23
117 Wengen,44,,13,6,19
117 Wengen,45,,8,9,17
117 Wengen,46,,11,6,17
117 Wengen,47,,14,12,26
117 Wengen,48,,14,7,21
117 Wengen,49,,7,9,16
117 Wengen,50,,10,12,22
117 Wengen,51,,7,6,13
117 Wengen,52,,6,7,13
117 Wengen,53,,6,11,17
117 Wengen,54,,4,6,10
117 Wengen,55,,7,6,13
117 Wengen,56,,9,4,13
117 Wengen,57,,6,2,8
117 Wengen,58,,6,6,12
117 Wengen,59,,9,6,15
117 Wengen,60,,2,6,8
117 Wengen,61,,4,8,12
117 Wengen,62,,2,11,13
117 Wengen,63,,6,3,9
117 Wengen,64,,5,3,8
117 Wengen,65,,6,3,9
117 Wengen,66,,8,8,16
117 Wengen,67,,3,6,9
117 Wengen,68,,7,6,13
117 Wengen,69,,4,4,8
117 Wengen,70,,6,9,15
117 Wengen,71,,6,3,9
117 Wengen,72,,5,4,9
117 Wengen,73,,7,7,14
117 Wengen,74,,-,1,1
117 Wengen,75,,1,6,7
117 Wengen,76,,2,7,9
117 Wengen,77,,3,2,5
117 Wengen,78,,1,7,8
117 Wengen,79,,5,2,7
117 Wengen,80,,4,2,6
117 Wengen,81,,2,7,9
117 Wengen,82,,1,2,3
117 Wengen,83,,1,3,4
117 Wengen,84,,1,3,4
117 Wengen,85,,-,3,3
117 Wengen,86,,-,4,4
117 Wengen,87,,2,3,5
117 Wengen,88,,2,2,4
117 Wengen,89,,2,6,8
117 Wengen,90,,1,1,2
117 Wengen,93,,1,-,1
117 Wengen,95,,1,-,1
117 Wengen,98,,1,-,1
118 U.L.Frau i.W.-St.Felix,0,,3,4,7
118 U.L.Frau i.W.-St.Felix,1,,5,3,8
118 U.L.Frau i.W.-St.Felix,2,,1,8,9
118 U.L.Frau i.W.-St.Felix,3,,3,-,3
118 U.L.Frau i.W.-St.Felix,4,,3,2,5
118 U.L.Frau i.W.-St.Felix,5,,5,7,12
118 U.L.Frau i.W.-St.Felix,6,,5,3,8
118 U.L.Frau i.W.-St.Felix,7,,8,6,14
118 U.L.Frau i.W.-St.Felix,8,,7,3,10
118 U.L.Frau i.W.-St.Felix,9,,9,5,14
118 U.L.Frau i.W.-St.Felix,10,,3,2,5
118 U.L.Frau i.W.-St.Felix,11,,5,5,10
118 U.L.Frau i.W.-St.Felix,12,,6,9,15
118 U.L.Frau i.W.-St.Felix,13,,5,4,9
118 U.L.Frau i.W.-St.Felix,14,,8,5,13
118 U.L.Frau i.W.-St.Felix,15,,3,10,13
118 U.L.Frau i.W.-St.Felix,16,,7,7,14
118 U.L.Frau i.W.-St.Felix,17,,9,5,14
118 U.L.Frau i.W.-St.Felix,18,,7,4,11
118 U.L.Frau i.W.-St.Felix,19,,11,7,18
118 U.L.Frau i.W.-St.Felix,20,,6,3,9
118 U.L.Frau i.W.-St.Felix,21,,8,5,13
118 U.L.Frau i.W.-St.Felix,22,,8,5,13
118 U.L.Frau i.W.-St.Felix,23,,3,7,10
118 U.L.Frau i.W.-St.Felix,24,,7,3,10
118 U.L.Frau i.W.-St.Felix,25,,6,4,10
118 U.L.Frau i.W.-St.Felix,26,,6,1,7
118 U.L.Frau i.W.-St.Felix,27,,1,9,10
118 U.L.Frau i.W.-St.Felix,28,,3,6,9
118 U.L.Frau i.W.-St.Felix,29,,7,1,8
118 U.L.Frau i.W.-St.Felix,30,,3,5,8
118 U.L.Frau i.W.-St.Felix,31,,1,2,3
118 U.L.Frau i.W.-St.Felix,32,,-,3,3
118 U.L.Frau i.W.-St.Felix,33,,5,3,8
118 U.L.Frau i.W.-St.Felix,34,,4,8,12
118 U.L.Frau i.W.-St.Felix,35,,8,1,9
118 U.L.Frau i.W.-St.Felix,36,,4,6,10
118 U.L.Frau i.W.-St.Felix,37,,2,3,5
118 U.L.Frau i.W.-St.Felix,38,,7,5,12
118 U.L.Frau i.W.-St.Felix,39,,4,4,8
118 U.L.Frau i.W.-St.Felix,40,,5,9,14
118 U.L.Frau i.W.-St.Felix,41,,7,4,11
118 U.L.Frau i.W.-St.Felix,42,,4,9,13
118 U.L.Frau i.W.-St.Felix,43,,3,4,7
118 U.L.Frau i.W.-St.Felix,44,,9,7,16
118 U.L.Frau i.W.-St.Felix,45,,9,6,15
118 U.L.Frau i.W.-St.Felix,46,,4,8,12
118 U.L.Frau i.W.-St.Felix,47,,16,8,24
118 U.L.Frau i.W.-St.Felix,48,,8,9,17
118 U.L.Frau i.W.-St.Felix,49,,4,4,8
118 U.L.Frau i.W.-St.Felix,50,,8,9,17
118 U.L.Frau i.W.-St.Felix,51,,5,4,9
118 U.L.Frau i.W.-St.Felix,52,,4,2,6
118 U.L.Frau i.W.-St.Felix,53,,3,6,9
118 U.L.Frau i.W.-St.Felix,54,,5,6,11
118 U.L.Frau i.W.-St.Felix,55,,3,4,7
118 U.L.Frau i.W.-St.Felix,56,,6,3,9
118 U.L.Frau i.W.-St.Felix,57,,2,2,4
118 U.L.Frau i.W.-St.Felix,58,,6,3,9
118 U.L.Frau i.W.-St.Felix,59,,6,3,9
118 U.L.Frau i.W.-St.Felix,60,,3,4,7
118 U.L.Frau i.W.-St.Felix,61,,4,-,4
118 U.L.Frau i.W.-St.Felix,62,,4,-,4
118 U.L.Frau i.W.-St.Felix,63,,1,7,8
118 U.L.Frau i.W.-St.Felix,64,,1,4,5
118 U.L.Frau i.W.-St.Felix,65,,3,1,4
118 U.L.Frau i.W.-St.Felix,66,,5,1,6
118 U.L.Frau i.W.-St.Felix,67,,6,4,10
118 U.L.Frau i.W.-St.Felix,68,,2,3,5
118 U.L.Frau i.W.-St.Felix,69,,4,8,12
118 U.L.Frau i.W.-St.Felix,70,,2,-,2
118 U.L.Frau i.W.-St.Felix,71,,1,3,4
118 U.L.Frau i.W.-St.Felix,72,,2,4,6
118 U.L.Frau i.W.-St.Felix,73,,3,-,3
118 U.L.Frau i.W.-St.Felix,74,,4,2,6
118 U.L.Frau i.W.-St.Felix,75,,3,4,7
118 U.L.Frau i.W.-St.Felix,76,,3,3,6
118 U.L.Frau i.W.-St.Felix,77,,5,4,9
118 U.L.Frau i.W.-St.Felix,78,,5,1,6
118 U.L.Frau i.W.-St.Felix,79,,2,-,2
118 U.L.Frau i.W.-St.Felix,80,,4,5,9
118 U.L.Frau i.W.-St.Felix,81,,1,3,4
118 U.L.Frau i.W.-St.Felix,82,,1,4,5
118 U.L.Frau i.W.-St.Felix,83,,2,4,6
118 U.L.Frau i.W.-St.Felix,84,,2,3,5
118 U.L.Frau i.W.-St.Felix,85,,3,5,8
118 U.L.Frau i.W.-St.Felix,86,,1,1,2
118 U.L.Frau i.W.-St.Felix,87,,2,4,6
118 U.L.Frau i.W.-St.Felix,88,,1,-,1
118 U.L.Frau i.W.-St.Felix,89,,-,1,1
118 U.L.Frau i.W.-St.Felix,93,,-,1,1
118 U.L.Frau i.W.-St.Felix,97,,1,-,1

