Gemeinde,Altersklassen,Geschlecht,Männer,Frauen,Insgesamt
001 Aldein,0,,10,3,13
001 Aldein,1,,12,10,22
001 Aldein,2,,6,10,16
001 Aldein,3,,7,12,19
001 Aldein,4,,8,13,21
001 Aldein,5,,8,15,23
001 Aldein,6,,9,8,17
001 Aldein,7,,17,8,25
001 Aldein,8,,15,9,24
001 Aldein,9,,13,8,21
001 Aldein,10,,16,8,24
001 Aldein,11,,12,4,16
001 Aldein,12,,16,14,30
001 Aldein,13,,11,16,27
001 Aldein,14,,15,8,23
001 Aldein,15,,7,8,15
001 Aldein,16,,8,12,20
001 Aldein,17,,14,7,21
001 Aldein,18,,13,11,24
001 Aldein,19,,9,13,22
001 Aldein,20,,7,8,15
001 Aldein,21,,7,6,13
001 Aldein,22,,10,16,26
001 Aldein,23,,11,9,20
001 Aldein,24,,11,6,17
001 Aldein,25,,10,8,18
001 Aldein,26,,14,14,28
001 Aldein,27,,9,7,16
001 Aldein,28,,10,11,21
001 Aldein,29,,13,5,18
001 Aldein,30,,10,10,20
001 Aldein,31,,8,13,21
001 Aldein,32,,9,13,22
001 Aldein,33,,10,10,20
001 Aldein,34,,8,19,27
001 Aldein,35,,8,13,21
001 Aldein,36,,18,14,32
001 Aldein,37,,14,11,25
001 Aldein,38,,13,10,23
001 Aldein,39,,17,9,26
001 Aldein,40,,16,14,30
001 Aldein,41,,13,15,28
001 Aldein,42,,19,7,26
001 Aldein,43,,12,17,29
001 Aldein,44,,6,14,20
001 Aldein,45,,5,20,25
001 Aldein,46,,16,10,26
001 Aldein,47,,14,11,25
001 Aldein,48,,14,6,20
001 Aldein,49,,8,17,25
001 Aldein,50,,17,15,32
001 Aldein,51,,14,9,23
001 Aldein,52,,11,13,24
001 Aldein,53,,7,5,12
001 Aldein,54,,9,10,19
001 Aldein,55,,9,8,17
001 Aldein,56,,9,9,18
001 Aldein,57,,9,6,15
001 Aldein,58,,9,9,18
001 Aldein,59,,7,5,12
001 Aldein,60,,16,10,26
001 Aldein,61,,5,13,18
001 Aldein,62,,9,6,15
001 Aldein,63,,9,9,18
001 Aldein,64,,5,10,15
001 Aldein,65,,6,10,16
001 Aldein,66,,10,5,15
001 Aldein,67,,5,7,12
001 Aldein,68,,10,10,20
001 Aldein,69,,6,11,17
001 Aldein,70,,5,12,17
001 Aldein,71,,4,8,12
001 Aldein,72,,5,9,14
001 Aldein,73,,7,7,14
001 Aldein,74,,5,9,14
001 Aldein,75,,5,6,11
001 Aldein,76,,4,4,8
001 Aldein,77,,12,4,16
001 Aldein,78,,6,4,10
001 Aldein,79,,2,7,9
001 Aldein,80,,6,2,8
001 Aldein,81,,1,3,4
001 Aldein,82,,6,7,13
001 Aldein,83,,3,1,4
001 Aldein,84,,5,4,9
001 Aldein,85,,-,2,2
001 Aldein,86,,1,4,5
001 Aldein,87,,-,6,6
001 Aldein,88,,1,4,5
001 Aldein,89,,-,7,7
001 Aldein,90,,1,7,8
001 Aldein,91,,1,1,2
001 Aldein,92,,-,2,2
001 Aldein,95,,1,-,1
002 Andrian,0,,7,4,11
002 Andrian,1,,6,6,12
002 Andrian,2,,8,10,18
002 Andrian,3,,6,6,12
002 Andrian,4,,4,6,10
002 Andrian,5,,9,3,12
002 Andrian,6,,6,6,12
002 Andrian,7,,9,4,13
002 Andrian,8,,7,10,17
002 Andrian,9,,3,3,6
002 Andrian,10,,3,4,7
002 Andrian,11,,6,5,11
002 Andrian,12,,4,5,9
002 Andrian,13,,8,3,11
002 Andrian,14,,8,7,15
002 Andrian,15,,3,10,13
002 Andrian,16,,8,4,12
002 Andrian,17,,7,6,13
002 Andrian,18,,4,4,8
002 Andrian,19,,7,6,13
002 Andrian,20,,6,8,14
002 Andrian,21,,5,6,11
002 Andrian,22,,5,5,10
002 Andrian,23,,13,6,19
002 Andrian,24,,6,8,14
002 Andrian,25,,8,6,14
002 Andrian,26,,2,5,7
002 Andrian,27,,8,5,13
002 Andrian,28,,9,4,13
002 Andrian,29,,11,6,17
002 Andrian,30,,7,6,13
002 Andrian,31,,6,5,11
002 Andrian,32,,7,10,17
002 Andrian,33,,8,7,15
002 Andrian,34,,7,9,16
002 Andrian,35,,10,10,20
002 Andrian,36,,10,4,14
002 Andrian,37,,5,9,14
002 Andrian,38,,15,11,26
002 Andrian,39,,7,11,18
002 Andrian,40,,11,11,22
002 Andrian,41,,11,5,16
002 Andrian,42,,5,7,12
002 Andrian,43,,9,9,18
002 Andrian,44,,9,9,18
002 Andrian,45,,10,9,19
002 Andrian,46,,11,12,23
002 Andrian,47,,9,8,17
002 Andrian,48,,7,15,22
002 Andrian,49,,12,7,19
002 Andrian,50,,8,3,11
002 Andrian,51,,7,6,13
002 Andrian,52,,8,4,12
002 Andrian,53,,7,8,15
002 Andrian,54,,8,7,15
002 Andrian,55,,4,10,14
002 Andrian,56,,3,4,7
002 Andrian,57,,6,3,9
002 Andrian,58,,6,7,13
002 Andrian,59,,2,3,5
002 Andrian,60,,3,3,6
002 Andrian,61,,6,5,11
002 Andrian,62,,3,2,5
002 Andrian,63,,4,4,8
002 Andrian,64,,5,4,9
002 Andrian,65,,7,8,15
002 Andrian,66,,2,3,5
002 Andrian,67,,1,4,5
002 Andrian,68,,6,7,13
002 Andrian,69,,2,4,6
002 Andrian,70,,5,4,9
002 Andrian,71,,3,7,10
002 Andrian,72,,1,7,8
002 Andrian,73,,4,3,7
002 Andrian,74,,4,4,8
002 Andrian,75,,2,3,5
002 Andrian,76,,4,2,6
002 Andrian,77,,5,1,6
002 Andrian,78,,3,4,7
002 Andrian,79,,7,4,11
002 Andrian,80,,2,4,6
002 Andrian,81,,4,1,5
002 Andrian,82,,2,1,3
002 Andrian,83,,1,3,4
002 Andrian,84,,-,2,2
002 Andrian,85,,3,4,7
002 Andrian,86,,1,1,2
002 Andrian,87,,1,3,4
002 Andrian,89,,1,2,3
002 Andrian,90,,1,3,4
002 Andrian,91,,1,-,1
002 Andrian,92,,1,1,2
002 Andrian,96,,-,1,1
002 Andrian,97,,1,1,2
003 Altrei,0,,-,1,1
003 Altrei,2,,2,2,4
003 Altrei,3,,1,5,6
003 Altrei,4,,6,4,10
003 Altrei,5,,2,-,2
003 Altrei,6,,4,1,5
003 Altrei,7,,1,1,2
003 Altrei,8,,-,1,1
003 Altrei,9,,2,1,3
003 Altrei,10,,4,1,5
003 Altrei,11,,1,1,2
003 Altrei,12,,3,-,3
003 Altrei,13,,3,1,4
003 Altrei,14,,-,1,1
003 Altrei,15,,-,2,2
003 Altrei,16,,1,2,3
003 Altrei,17,,3,2,5
003 Altrei,18,,3,-,3
003 Altrei,19,,6,3,9
003 Altrei,20,,1,-,1
003 Altrei,21,,3,2,5
003 Altrei,22,,1,2,3
003 Altrei,23,,3,5,8
003 Altrei,24,,2,1,3
003 Altrei,25,,3,2,5
003 Altrei,26,,3,1,4
003 Altrei,27,,3,-,3
003 Altrei,28,,4,1,5
003 Altrei,29,,2,2,4
003 Altrei,30,,3,3,6
003 Altrei,31,,2,2,4
003 Altrei,32,,1,2,3
003 Altrei,33,,2,4,6
003 Altrei,34,,-,2,2
003 Altrei,35,,2,3,5
003 Altrei,36,,2,2,4
003 Altrei,37,,1,-,1
003 Altrei,38,,2,3,5
003 Altrei,39,,4,-,4
003 Altrei,40,,4,3,7
003 Altrei,41,,2,2,4
003 Altrei,42,,3,5,8
003 Altrei,43,,1,4,5
003 Altrei,44,,3,1,4
003 Altrei,45,,2,4,6
003 Altrei,46,,2,4,6
003 Altrei,47,,3,6,9
003 Altrei,48,,2,2,4
003 Altrei,49,,10,2,12
003 Altrei,50,,2,3,5
003 Altrei,51,,4,2,6
003 Altrei,52,,5,4,9
003 Altrei,53,,2,3,5
003 Altrei,54,,1,2,3
003 Altrei,55,,5,1,6
003 Altrei,56,,2,3,5
003 Altrei,57,,2,1,3
003 Altrei,58,,2,2,4
003 Altrei,59,,6,3,9
003 Altrei,60,,5,3,8
003 Altrei,61,,1,3,4
003 Altrei,62,,1,-,1
003 Altrei,63,,3,2,5
003 Altrei,64,,3,2,5
003 Altrei,65,,2,3,5
003 Altrei,66,,3,1,4
003 Altrei,67,,2,3,5
003 Altrei,68,,1,3,4
003 Altrei,69,,3,1,4
003 Altrei,70,,1,3,4
003 Altrei,71,,3,4,7
003 Altrei,72,,2,3,5
003 Altrei,73,,1,1,2
003 Altrei,74,,3,1,4
003 Altrei,75,,3,1,4
003 Altrei,76,,3,2,5
003 Altrei,77,,-,2,2
003 Altrei,78,,2,2,4
003 Altrei,79,,-,2,2
003 Altrei,80,,-,2,2
003 Altrei,81,,1,1,2
003 Altrei,82,,2,2,4
003 Altrei,83,,-,2,2
003 Altrei,84,,2,3,5
003 Altrei,85,,1,4,5
003 Altrei,87,,-,2,2
003 Altrei,88,,-,1,1
003 Altrei,89,,-,1,1
003 Altrei,90,,-,1,1
003 Altrei,96,,-,1,1
003 Altrei,100,,-,1,1
004 Eppan a.d. Weinstr.,0,,73,66,139
004 Eppan a.d. Weinstr.,1,,84,72,156
004 Eppan a.d. Weinstr.,2,,72,67,139
004 Eppan a.d. Weinstr.,3,,82,95,177
004 Eppan a.d. Weinstr.,4,,77,68,145
004 Eppan a.d. Weinstr.,5,,105,80,185
004 Eppan a.d. Weinstr.,6,,79,110,189
004 Eppan a.d. Weinstr.,7,,88,72,160
004 Eppan a.d. Weinstr.,8,,83,71,154
004 Eppan a.d. Weinstr.,9,,76,76,152
004 Eppan a.d. Weinstr.,10,,84,73,157
004 Eppan a.d. Weinstr.,11,,71,81,152
004 Eppan a.d. Weinstr.,12,,89,61,150
004 Eppan a.d. Weinstr.,13,,83,84,167
004 Eppan a.d. Weinstr.,14,,73,72,145
004 Eppan a.d. Weinstr.,15,,74,76,150
004 Eppan a.d. Weinstr.,16,,70,66,136
004 Eppan a.d. Weinstr.,17,,78,76,154
004 Eppan a.d. Weinstr.,18,,85,86,171
004 Eppan a.d. Weinstr.,19,,72,71,143
004 Eppan a.d. Weinstr.,20,,85,67,152
004 Eppan a.d. Weinstr.,21,,86,65,151
004 Eppan a.d. Weinstr.,22,,79,66,145
004 Eppan a.d. Weinstr.,23,,84,82,166
004 Eppan a.d. Weinstr.,24,,80,67,147
004 Eppan a.d. Weinstr.,25,,97,87,184
004 Eppan a.d. Weinstr.,26,,85,62,147
004 Eppan a.d. Weinstr.,27,,85,82,167
004 Eppan a.d. Weinstr.,28,,80,88,168
004 Eppan a.d. Weinstr.,29,,83,92,175
004 Eppan a.d. Weinstr.,30,,79,104,183
004 Eppan a.d. Weinstr.,31,,87,97,184
004 Eppan a.d. Weinstr.,32,,92,95,187
004 Eppan a.d. Weinstr.,33,,113,94,207
004 Eppan a.d. Weinstr.,34,,95,87,182
004 Eppan a.d. Weinstr.,35,,93,88,181
004 Eppan a.d. Weinstr.,36,,104,106,210
004 Eppan a.d. Weinstr.,37,,102,110,212
004 Eppan a.d. Weinstr.,38,,114,113,227
004 Eppan a.d. Weinstr.,39,,113,138,251
004 Eppan a.d. Weinstr.,40,,122,104,226
004 Eppan a.d. Weinstr.,41,,136,120,256
004 Eppan a.d. Weinstr.,42,,144,130,274
004 Eppan a.d. Weinstr.,43,,125,125,250
004 Eppan a.d. Weinstr.,44,,129,134,263
004 Eppan a.d. Weinstr.,45,,134,144,278
004 Eppan a.d. Weinstr.,46,,115,116,231
004 Eppan a.d. Weinstr.,47,,142,113,255
004 Eppan a.d. Weinstr.,48,,113,122,235
004 Eppan a.d. Weinstr.,49,,129,115,244
004 Eppan a.d. Weinstr.,50,,131,105,236
004 Eppan a.d. Weinstr.,51,,111,123,234
004 Eppan a.d. Weinstr.,52,,114,106,220
004 Eppan a.d. Weinstr.,53,,101,101,202
004 Eppan a.d. Weinstr.,54,,94,92,186
004 Eppan a.d. Weinstr.,55,,90,81,171
004 Eppan a.d. Weinstr.,56,,87,85,172
004 Eppan a.d. Weinstr.,57,,73,90,163
004 Eppan a.d. Weinstr.,58,,91,84,175
004 Eppan a.d. Weinstr.,59,,71,86,157
004 Eppan a.d. Weinstr.,60,,84,70,154
004 Eppan a.d. Weinstr.,61,,60,82,142
004 Eppan a.d. Weinstr.,62,,64,59,123
004 Eppan a.d. Weinstr.,63,,76,74,150
004 Eppan a.d. Weinstr.,64,,61,83,144
004 Eppan a.d. Weinstr.,65,,79,71,150
004 Eppan a.d. Weinstr.,66,,53,53,106
004 Eppan a.d. Weinstr.,67,,69,79,148
004 Eppan a.d. Weinstr.,68,,89,83,172
004 Eppan a.d. Weinstr.,69,,89,78,167
004 Eppan a.d. Weinstr.,70,,60,106,166
004 Eppan a.d. Weinstr.,71,,70,53,123
004 Eppan a.d. Weinstr.,72,,58,77,135
004 Eppan a.d. Weinstr.,73,,49,49,98
004 Eppan a.d. Weinstr.,74,,43,53,96
004 Eppan a.d. Weinstr.,75,,45,43,88
004 Eppan a.d. Weinstr.,76,,32,44,76
004 Eppan a.d. Weinstr.,77,,29,47,76
004 Eppan a.d. Weinstr.,78,,45,51,96
004 Eppan a.d. Weinstr.,79,,38,46,84
004 Eppan a.d. Weinstr.,80,,26,54,80
004 Eppan a.d. Weinstr.,81,,34,51,85
004 Eppan a.d. Weinstr.,82,,28,46,74
004 Eppan a.d. Weinstr.,83,,28,34,62
004 Eppan a.d. Weinstr.,84,,19,40,59
004 Eppan a.d. Weinstr.,85,,19,44,63
004 Eppan a.d. Weinstr.,86,,18,38,56
004 Eppan a.d. Weinstr.,87,,9,36,45
004 Eppan a.d. Weinstr.,88,,6,28,34
004 Eppan a.d. Weinstr.,89,,7,30,37
004 Eppan a.d. Weinstr.,90,,11,20,31
004 Eppan a.d. Weinstr.,91,,5,15,20
004 Eppan a.d. Weinstr.,92,,4,9,13
004 Eppan a.d. Weinstr.,93,,3,6,9
004 Eppan a.d. Weinstr.,94,,3,2,5
004 Eppan a.d. Weinstr.,95,,1,2,3
004 Eppan a.d. Weinstr.,96,,1,1,2
004 Eppan a.d. Weinstr.,97,,-,3,3
004 Eppan a.d. Weinstr.,98,,2,1,3
004 Eppan a.d. Weinstr.,99,,-,3,3
004 Eppan a.d. Weinstr.,100,,-,4,4
004 Eppan a.d. Weinstr.,101,,-,1,1
004 Eppan a.d. Weinstr.,102,,1,1,2
004 Eppan a.d. Weinstr.,103,,-,1,1
005 Hafling,0,,1,3,4
005 Hafling,1,,3,4,7
005 Hafling,2,,3,8,11
005 Hafling,3,,5,5,10
005 Hafling,4,,4,2,6
005 Hafling,5,,6,6,12
005 Hafling,6,,4,2,6
005 Hafling,7,,1,6,7
005 Hafling,8,,-,6,6
005 Hafling,9,,6,2,8
005 Hafling,10,,4,3,7
005 Hafling,11,,5,7,12
005 Hafling,12,,4,3,7
005 Hafling,13,,2,7,9
005 Hafling,14,,2,9,11
005 Hafling,15,,12,4,16
005 Hafling,16,,6,4,10
005 Hafling,17,,4,5,9
005 Hafling,18,,2,7,9
005 Hafling,19,,2,4,6
005 Hafling,20,,8,3,11
005 Hafling,21,,5,6,11
005 Hafling,22,,3,2,5
005 Hafling,23,,2,7,9
005 Hafling,24,,4,3,7
005 Hafling,25,,5,2,7
005 Hafling,26,,4,6,10
005 Hafling,27,,3,10,13
005 Hafling,28,,1,-,1
005 Hafling,29,,4,3,7
005 Hafling,30,,4,8,12
005 Hafling,31,,4,11,15
005 Hafling,32,,7,4,11
005 Hafling,33,,4,5,9
005 Hafling,34,,6,8,14
005 Hafling,35,,6,7,13
005 Hafling,36,,6,4,10
005 Hafling,37,,7,6,13
005 Hafling,38,,9,1,10
005 Hafling,39,,10,1,11
005 Hafling,40,,12,6,18
005 Hafling,41,,10,11,21
005 Hafling,42,,8,12,20
005 Hafling,43,,2,10,12
005 Hafling,44,,3,1,4
005 Hafling,45,,11,7,18
005 Hafling,46,,7,11,18
005 Hafling,47,,3,2,5
005 Hafling,48,,7,3,10
005 Hafling,49,,7,2,9
005 Hafling,50,,8,4,12
005 Hafling,51,,9,7,16
005 Hafling,52,,6,5,11
005 Hafling,53,,4,4,8
005 Hafling,54,,3,4,7
005 Hafling,55,,3,9,12
005 Hafling,56,,6,3,9
005 Hafling,57,,3,2,5
005 Hafling,58,,2,3,5
005 Hafling,59,,7,2,9
005 Hafling,60,,2,3,5
005 Hafling,61,,5,4,9
005 Hafling,62,,4,4,8
005 Hafling,63,,7,2,9
005 Hafling,64,,2,4,6
005 Hafling,65,,1,3,4
005 Hafling,66,,3,2,5
005 Hafling,67,,3,2,5
005 Hafling,68,,4,5,9
005 Hafling,69,,6,3,9
005 Hafling,70,,3,4,7
005 Hafling,71,,2,1,3
005 Hafling,72,,4,5,9
005 Hafling,73,,2,3,5
005 Hafling,74,,2,1,3
005 Hafling,75,,1,1,2
005 Hafling,76,,2,2,4
005 Hafling,77,,-,2,2
005 Hafling,78,,4,3,7
005 Hafling,79,,3,4,7
005 Hafling,80,,2,5,7
005 Hafling,81,,1,4,5
005 Hafling,82,,2,1,3
005 Hafling,83,,-,2,2
005 Hafling,84,,3,2,5
005 Hafling,85,,-,2,2
005 Hafling,86,,1,-,1
005 Hafling,87,,1,-,1
005 Hafling,89,,-,1,1
005 Hafling,90,,-,1,1
005 Hafling,91,,3,1,4
005 Hafling,92,,-,1,1
005 Hafling,94,,-,1,1
006 Abtei,0,,18,11,29
006 Abtei,1,,24,17,41
006 Abtei,2,,23,20,43
006 Abtei,3,,23,19,42
006 Abtei,4,,27,23,50
006 Abtei,5,,30,22,52
006 Abtei,6,,22,28,50
006 Abtei,7,,28,14,42
006 Abtei,8,,21,18,39
006 Abtei,9,,12,30,42
006 Abtei,10,,25,23,48
006 Abtei,11,,23,32,55
006 Abtei,12,,21,26,47
006 Abtei,13,,14,14,28
006 Abtei,14,,26,22,48
006 Abtei,15,,26,15,41
006 Abtei,16,,24,29,53
006 Abtei,17,,19,15,34
006 Abtei,18,,16,19,35
006 Abtei,19,,24,15,39
006 Abtei,20,,22,13,35
006 Abtei,21,,24,15,39
006 Abtei,22,,14,16,30
006 Abtei,23,,15,11,26
006 Abtei,24,,19,13,32
006 Abtei,25,,18,20,38
006 Abtei,26,,12,12,24
006 Abtei,27,,14,16,30
006 Abtei,28,,14,14,28
006 Abtei,29,,23,18,41
006 Abtei,30,,20,18,38
006 Abtei,31,,24,18,42
006 Abtei,32,,16,25,41
006 Abtei,33,,22,34,56
006 Abtei,34,,23,33,56
006 Abtei,35,,25,23,48
006 Abtei,36,,14,33,47
006 Abtei,37,,20,29,49
006 Abtei,38,,27,22,49
006 Abtei,39,,43,34,77
006 Abtei,40,,19,33,52
006 Abtei,41,,30,34,64
006 Abtei,42,,29,34,63
006 Abtei,43,,29,35,64
006 Abtei,44,,38,34,72
006 Abtei,45,,23,30,53
006 Abtei,46,,36,24,60
006 Abtei,47,,26,32,58
006 Abtei,48,,30,27,57
006 Abtei,49,,26,31,57
006 Abtei,50,,25,26,51
006 Abtei,51,,26,24,50
006 Abtei,52,,28,23,51
006 Abtei,53,,19,21,40
006 Abtei,54,,19,15,34
006 Abtei,55,,19,17,36
006 Abtei,56,,17,16,33
006 Abtei,57,,11,15,26
006 Abtei,58,,14,20,34
006 Abtei,59,,11,13,24
006 Abtei,60,,11,13,24
006 Abtei,61,,15,20,35
006 Abtei,62,,10,18,28
006 Abtei,63,,23,17,40
006 Abtei,64,,15,16,31
006 Abtei,65,,23,18,41
006 Abtei,66,,15,20,35
006 Abtei,67,,12,16,28
006 Abtei,68,,11,11,22
006 Abtei,69,,20,12,32
006 Abtei,70,,14,23,37
006 Abtei,71,,16,16,32
006 Abtei,72,,13,13,26
006 Abtei,73,,15,17,32
006 Abtei,74,,6,17,23
006 Abtei,75,,15,9,24
006 Abtei,76,,9,17,26
006 Abtei,77,,11,13,24
006 Abtei,78,,7,15,22
006 Abtei,79,,5,5,10
006 Abtei,80,,8,11,19
006 Abtei,81,,12,10,22
006 Abtei,82,,5,7,12
006 Abtei,83,,3,11,14
006 Abtei,84,,5,7,12
006 Abtei,85,,3,3,6
006 Abtei,86,,5,4,9
006 Abtei,87,,4,8,12
006 Abtei,88,,4,6,10
006 Abtei,89,,4,2,6
006 Abtei,90,,1,1,2
006 Abtei,91,,1,5,6
006 Abtei,92,,-,2,2
006 Abtei,93,,-,2,2
006 Abtei,95,,1,2,3
006 Abtei,96,,-,1,1
006 Abtei,97,,-,1,1
006 Abtei,99,,-,1,1
007 Barbian,0,,10,9,19
007 Barbian,1,,7,9,16
007 Barbian,2,,9,16,25
007 Barbian,3,,13,4,17
007 Barbian,4,,9,10,19
007 Barbian,5,,5,2,7
007 Barbian,6,,16,5,21
007 Barbian,7,,6,5,11
007 Barbian,8,,8,16,24
007 Barbian,9,,6,7,13
007 Barbian,10,,12,15,27
007 Barbian,11,,14,6,20
007 Barbian,12,,11,10,21
007 Barbian,13,,14,7,21
007 Barbian,14,,9,9,18
007 Barbian,15,,12,10,22
007 Barbian,16,,11,8,19
007 Barbian,17,,8,4,12
007 Barbian,18,,10,13,23
007 Barbian,19,,13,6,19
007 Barbian,20,,13,12,25
007 Barbian,21,,15,12,27
007 Barbian,22,,7,12,19
007 Barbian,23,,13,7,20
007 Barbian,24,,8,7,15
007 Barbian,25,,14,9,23
007 Barbian,26,,6,9,15
007 Barbian,27,,10,7,17
007 Barbian,28,,11,11,22
007 Barbian,29,,9,12,21
007 Barbian,30,,11,15,26
007 Barbian,31,,13,6,19
007 Barbian,32,,17,11,28
007 Barbian,33,,10,9,19
007 Barbian,34,,10,18,28
007 Barbian,35,,7,13,20
007 Barbian,36,,9,10,19
007 Barbian,37,,13,10,23
007 Barbian,38,,12,19,31
007 Barbian,39,,18,14,32
007 Barbian,40,,16,8,24
007 Barbian,41,,13,13,26
007 Barbian,42,,15,6,21
007 Barbian,43,,15,10,25
007 Barbian,44,,9,8,17
007 Barbian,45,,12,12,24
007 Barbian,46,,7,13,20
007 Barbian,47,,15,14,29
007 Barbian,48,,15,14,29
007 Barbian,49,,15,14,29
007 Barbian,50,,16,11,27
007 Barbian,51,,13,15,28
007 Barbian,52,,12,9,21
007 Barbian,53,,8,9,17
007 Barbian,54,,15,7,22
007 Barbian,55,,5,9,14
007 Barbian,56,,7,7,14
007 Barbian,57,,7,15,22
007 Barbian,58,,8,10,18
007 Barbian,59,,8,6,14
007 Barbian,60,,8,10,18
007 Barbian,61,,10,11,21
007 Barbian,62,,5,6,11
007 Barbian,63,,3,5,8
007 Barbian,64,,5,11,16
007 Barbian,65,,17,6,23
007 Barbian,66,,5,6,11
007 Barbian,67,,10,9,19
007 Barbian,68,,8,7,15
007 Barbian,69,,11,10,21
007 Barbian,70,,8,12,20
007 Barbian,71,,10,5,15
007 Barbian,72,,5,4,9
007 Barbian,73,,5,11,16
007 Barbian,74,,8,9,17
007 Barbian,75,,3,5,8
007 Barbian,76,,2,6,8
007 Barbian,77,,5,5,10
007 Barbian,78,,7,4,11
007 Barbian,79,,6,6,12
007 Barbian,80,,2,6,8
007 Barbian,81,,5,4,9
007 Barbian,82,,5,7,12
007 Barbian,83,,4,6,10
007 Barbian,84,,3,-,3
007 Barbian,85,,3,1,4
007 Barbian,86,,3,2,5
007 Barbian,87,,1,3,4
007 Barbian,88,,-,3,3
007 Barbian,89,,1,2,3
007 Barbian,90,,1,1,2
007 Barbian,91,,-,1,1
007 Barbian,92,,-,1,1
007 Barbian,93,,1,-,1
008 Bozen,0,,476,472,948
008 Bozen,1,,501,481,982
008 Bozen,2,,507,453,960
008 Bozen,3,,529,503,1.032
008 Bozen,4,,566,488,1.054
008 Bozen,5,,481,492,973
008 Bozen,6,,540,494,1.034
008 Bozen,7,,537,497,1.034
008 Bozen,8,,532,515,1.047
008 Bozen,9,,526,467,993
008 Bozen,10,,513,473,986
008 Bozen,11,,467,496,963
008 Bozen,12,,513,494,1.007
008 Bozen,13,,507,479,986
008 Bozen,14,,491,440,931
008 Bozen,15,,467,507,974
008 Bozen,16,,462,432,894
008 Bozen,17,,492,483,975
008 Bozen,18,,451,474,925
008 Bozen,19,,498,443,941
008 Bozen,20,,535,459,994
008 Bozen,21,,525,470,995
008 Bozen,22,,525,493,1.018
008 Bozen,23,,535,496,1.031
008 Bozen,24,,431,481,912
008 Bozen,25,,503,497,1.000
008 Bozen,26,,527,508,1.035
008 Bozen,27,,540,541,1.081
008 Bozen,28,,593,545,1.138
008 Bozen,29,,578,550,1.128
008 Bozen,30,,600,562,1.162
008 Bozen,31,,669,586,1.255
008 Bozen,32,,614,597,1.211
008 Bozen,33,,609,622,1.231
008 Bozen,34,,659,644,1.303
008 Bozen,35,,680,699,1.379
008 Bozen,36,,707,737,1.444
008 Bozen,37,,773,777,1.550
008 Bozen,38,,720,831,1.551
008 Bozen,39,,831,859,1.690
008 Bozen,40,,890,902,1.792
008 Bozen,41,,854,826,1.680
008 Bozen,42,,915,885,1.800
008 Bozen,43,,841,809,1.650
008 Bozen,44,,807,885,1.692
008 Bozen,45,,898,899,1.797
008 Bozen,46,,909,914,1.823
008 Bozen,47,,915,927,1.842
008 Bozen,48,,777,866,1.643
008 Bozen,49,,779,812,1.591
008 Bozen,50,,774,758,1.532
008 Bozen,51,,712,750,1.462
008 Bozen,52,,711,724,1.435
008 Bozen,53,,706,737,1.443
008 Bozen,54,,624,735,1.359
008 Bozen,55,,625,688,1.313
008 Bozen,56,,589,666,1.255
008 Bozen,57,,590,625,1.215
008 Bozen,58,,533,629,1.162
008 Bozen,59,,522,646,1.168
008 Bozen,60,,524,632,1.156
008 Bozen,61,,552,672,1.224
008 Bozen,62,,565,641,1.206
008 Bozen,63,,610,719,1.329
008 Bozen,64,,577,792,1.369
008 Bozen,65,,656,855,1.511
008 Bozen,66,,485,573,1.058
008 Bozen,67,,542,694,1.236
008 Bozen,68,,579,704,1.283
008 Bozen,69,,604,691,1.295
008 Bozen,70,,635,725,1.360
008 Bozen,71,,598,700,1.298
008 Bozen,72,,540,697,1.237
008 Bozen,73,,555,637,1.192
008 Bozen,74,,472,542,1.014
008 Bozen,75,,421,535,956
008 Bozen,76,,402,538,940
008 Bozen,77,,412,522,934
008 Bozen,78,,349,515,864
008 Bozen,79,,350,520,870
008 Bozen,80,,335,484,819
008 Bozen,81,,327,472,799
008 Bozen,82,,222,410,632
008 Bozen,83,,252,411,663
008 Bozen,84,,213,384,597
008 Bozen,85,,235,352,587
008 Bozen,86,,171,358,529
008 Bozen,87,,158,299,457
008 Bozen,88,,116,314,430
008 Bozen,89,,99,297,396
008 Bozen,90,,83,231,314
008 Bozen,91,,65,200,265
008 Bozen,92,,25,117,142
008 Bozen,93,,13,57,70
008 Bozen,94,,13,40,53
008 Bozen,95,,13,55,68
008 Bozen,96,,4,52,56
008 Bozen,97,,12,36,48
008 Bozen,98,,8,23,31
008 Bozen,99,,8,23,31
008 Bozen,100,,4,15,19
008 Bozen,101,,1,7,8
008 Bozen,102,,1,-,1
008 Bozen,103,,-,3,3
008 Bozen,104,,-,2,2
008 Bozen,105,,-,1,1
008 Bozen,106,,-,1,1
009 Prags,0,,5,2,7
009 Prags,1,,1,4,5
009 Prags,2,,2,2,4
009 Prags,3,,4,6,10
009 Prags,4,,4,6,10
009 Prags,5,,4,3,7
009 Prags,6,,4,1,5
009 Prags,7,,3,3,6
009 Prags,8,,2,5,7
009 Prags,9,,2,6,8
009 Prags,10,,8,6,14
009 Prags,11,,2,3,5
009 Prags,12,,5,9,14
009 Prags,13,,1,4,5
009 Prags,14,,3,5,8
009 Prags,15,,3,6,9
009 Prags,16,,3,1,4
009 Prags,17,,4,5,9
009 Prags,18,,7,2,9
009 Prags,19,,6,2,8
009 Prags,20,,8,1,9
009 Prags,21,,4,2,6
009 Prags,22,,8,3,11
009 Prags,23,,2,5,7
009 Prags,24,,3,3,6
009 Prags,25,,7,4,11
009 Prags,26,,8,2,10
009 Prags,27,,5,3,8
009 Prags,28,,3,4,7
009 Prags,29,,3,7,10
009 Prags,30,,2,5,7
009 Prags,31,,5,1,6
009 Prags,32,,2,2,4
009 Prags,33,,5,7,12
009 Prags,34,,3,3,6
009 Prags,35,,5,4,9
009 Prags,36,,2,5,7
009 Prags,37,,2,5,7
009 Prags,38,,8,3,11
009 Prags,39,,3,3,6
009 Prags,40,,6,4,10
009 Prags,41,,5,6,11
009 Prags,42,,9,5,14
009 Prags,43,,8,8,16
009 Prags,44,,7,6,13
009 Prags,45,,8,5,13
009 Prags,46,,7,7,14
009 Prags,47,,5,4,9
009 Prags,48,,6,5,11
009 Prags,49,,3,5,8
009 Prags,50,,5,12,17
009 Prags,51,,5,4,9
009 Prags,52,,11,5,16
009 Prags,53,,6,2,8
009 Prags,54,,6,4,10
009 Prags,55,,1,6,7
009 Prags,56,,4,5,9
009 Prags,57,,6,4,10
009 Prags,58,,4,1,5
009 Prags,59,,2,5,7
009 Prags,60,,3,1,4
009 Prags,61,,4,1,5
009 Prags,62,,1,1,2
009 Prags,63,,4,1,5
009 Prags,64,,1,-,1
009 Prags,65,,2,4,6
009 Prags,66,,2,2,4
009 Prags,67,,4,4,8
009 Prags,68,,1,3,4
009 Prags,69,,4,4,8
009 Prags,70,,5,2,7
009 Prags,71,,1,3,4
009 Prags,72,,3,5,8
009 Prags,73,,3,2,5
009 Prags,74,,-,2,2
009 Prags,75,,1,3,4
009 Prags,76,,1,3,4
009 Prags,77,,2,2,4
009 Prags,78,,3,2,5
009 Prags,79,,3,4,7
009 Prags,80,,-,3,3
009 Prags,81,,1,1,2
009 Prags,82,,1,1,2
009 Prags,83,,-,2,2
009 Prags,84,,1,5,6
009 Prags,85,,1,4,5
009 Prags,86,,1,4,5
009 Prags,87,,3,2,5
009 Prags,88,,-,2,2
009 Prags,89,,2,1,3
009 Prags,90,,1,2,3
009 Prags,91,,1,-,1
009 Prags,92,,-,2,2
010 Brenner,0,,5,14,19
010 Brenner,1,,13,14,27
010 Brenner,2,,12,9,21
010 Brenner,3,,9,16,25
010 Brenner,4,,9,11,20
010 Brenner,5,,6,13,19
010 Brenner,6,,13,10,23
010 Brenner,7,,11,19,30
010 Brenner,8,,10,9,19
010 Brenner,9,,13,12,25
010 Brenner,10,,6,7,13
010 Brenner,11,,16,12,28
010 Brenner,12,,12,14,26
010 Brenner,13,,15,5,20
010 Brenner,14,,16,8,24
010 Brenner,15,,7,11,18
010 Brenner,16,,6,9,15
010 Brenner,17,,21,11,32
010 Brenner,18,,14,7,21
010 Brenner,19,,14,10,24
010 Brenner,20,,11,16,27
010 Brenner,21,,14,10,24
010 Brenner,22,,11,8,19
010 Brenner,23,,12,8,20
010 Brenner,24,,8,11,19
010 Brenner,25,,11,11,22
010 Brenner,26,,20,8,28
010 Brenner,27,,18,17,35
010 Brenner,28,,16,15,31
010 Brenner,29,,17,14,31
010 Brenner,30,,18,19,37
010 Brenner,31,,15,17,32
010 Brenner,32,,17,14,31
010 Brenner,33,,17,14,31
010 Brenner,34,,24,10,34
010 Brenner,35,,13,10,23
010 Brenner,36,,16,21,37
010 Brenner,37,,18,7,25
010 Brenner,38,,13,6,19
010 Brenner,39,,22,24,46
010 Brenner,40,,24,13,37
010 Brenner,41,,20,15,35
010 Brenner,42,,11,17,28
010 Brenner,43,,14,18,32
010 Brenner,44,,17,14,31
010 Brenner,45,,21,17,38
010 Brenner,46,,22,17,39
010 Brenner,47,,22,16,38
010 Brenner,48,,13,20,33
010 Brenner,49,,17,12,29
010 Brenner,50,,19,12,31
010 Brenner,51,,20,13,33
010 Brenner,52,,13,12,25
010 Brenner,53,,16,10,26
010 Brenner,54,,14,19,33
010 Brenner,55,,17,13,30
010 Brenner,56,,13,9,22
010 Brenner,57,,10,14,24
010 Brenner,58,,7,15,22
010 Brenner,59,,19,7,26
010 Brenner,60,,13,11,24
010 Brenner,61,,12,12,24
010 Brenner,62,,15,13,28
010 Brenner,63,,6,8,14
010 Brenner,64,,20,11,31
010 Brenner,65,,9,16,25
010 Brenner,66,,4,8,12
010 Brenner,67,,16,12,28
010 Brenner,68,,15,12,27
010 Brenner,69,,7,10,17
010 Brenner,70,,11,12,23
010 Brenner,71,,8,12,20
010 Brenner,72,,7,10,17
010 Brenner,73,,8,15,23
010 Brenner,74,,8,13,21
010 Brenner,75,,11,6,17
010 Brenner,76,,3,5,8
010 Brenner,77,,8,7,15
010 Brenner,78,,5,4,9
010 Brenner,79,,-,4,4
010 Brenner,80,,5,8,13
010 Brenner,81,,7,10,17
010 Brenner,82,,5,6,11
010 Brenner,83,,5,5,10
010 Brenner,84,,5,2,7
010 Brenner,85,,4,4,8
010 Brenner,86,,2,5,7
010 Brenner,87,,2,4,6
010 Brenner,88,,2,5,7
010 Brenner,89,,-,3,3
010 Brenner,91,,1,2,3
010 Brenner,92,,1,1,2
010 Brenner,100,,1,-,1
011 Brixen,0,,79,80,159
011 Brixen,1,,122,116,238
011 Brixen,2,,125,112,237
011 Brixen,3,,115,100,215
011 Brixen,4,,126,102,228
011 Brixen,5,,129,104,233
011 Brixen,6,,130,120,250
011 Brixen,7,,120,117,237
011 Brixen,8,,112,106,218
011 Brixen,9,,115,115,230
011 Brixen,10,,129,126,255
011 Brixen,11,,123,106,229
011 Brixen,12,,145,127,272
011 Brixen,13,,111,134,245
011 Brixen,14,,124,109,233
011 Brixen,15,,118,117,235
011 Brixen,16,,119,121,240
011 Brixen,17,,129,124,253
011 Brixen,18,,118,108,226
011 Brixen,19,,113,121,234
011 Brixen,20,,123,108,231
011 Brixen,21,,107,116,223
011 Brixen,22,,119,101,220
011 Brixen,23,,126,99,225
011 Brixen,24,,117,118,235
011 Brixen,25,,105,130,235
011 Brixen,26,,128,101,229
011 Brixen,27,,123,106,229
011 Brixen,28,,133,146,279
011 Brixen,29,,133,116,249
011 Brixen,30,,136,135,271
011 Brixen,31,,116,120,236
011 Brixen,32,,150,136,286
011 Brixen,33,,111,145,256
011 Brixen,34,,148,144,292
011 Brixen,35,,143,160,303
011 Brixen,36,,137,128,265
011 Brixen,37,,142,158,300
011 Brixen,38,,155,167,322
011 Brixen,39,,161,170,331
011 Brixen,40,,162,174,336
011 Brixen,41,,173,165,338
011 Brixen,42,,193,193,386
011 Brixen,43,,178,203,381
011 Brixen,44,,177,167,344
011 Brixen,45,,175,197,372
011 Brixen,46,,184,162,346
011 Brixen,47,,190,190,380
011 Brixen,48,,151,165,316
011 Brixen,49,,169,168,337
011 Brixen,50,,140,168,308
011 Brixen,51,,141,152,293
011 Brixen,52,,150,144,294
011 Brixen,53,,147,126,273
011 Brixen,54,,138,147,285
011 Brixen,55,,115,143,258
011 Brixen,56,,125,101,226
011 Brixen,57,,94,119,213
011 Brixen,58,,90,111,201
011 Brixen,59,,103,109,212
011 Brixen,60,,95,109,204
011 Brixen,61,,116,107,223
011 Brixen,62,,83,127,210
011 Brixen,63,,109,117,226
011 Brixen,64,,92,111,203
011 Brixen,65,,100,105,205
011 Brixen,66,,65,101,166
011 Brixen,67,,112,114,226
011 Brixen,68,,120,116,236
011 Brixen,69,,88,98,186
011 Brixen,70,,102,119,221
011 Brixen,71,,83,115,198
011 Brixen,72,,88,97,185
011 Brixen,73,,81,91,172
011 Brixen,74,,82,89,171
011 Brixen,75,,60,93,153
011 Brixen,76,,70,84,154
011 Brixen,77,,62,83,145
011 Brixen,78,,63,64,127
011 Brixen,79,,63,74,137
011 Brixen,80,,55,73,128
011 Brixen,81,,42,81,123
011 Brixen,82,,37,77,114
011 Brixen,83,,42,61,103
011 Brixen,84,,25,79,104
011 Brixen,85,,31,59,90
011 Brixen,86,,28,60,88
011 Brixen,87,,21,54,75
011 Brixen,88,,27,38,65
011 Brixen,89,,12,45,57
011 Brixen,90,,10,37,47
011 Brixen,91,,9,33,42
011 Brixen,92,,5,16,21
011 Brixen,93,,3,11,14
011 Brixen,94,,8,13,21
011 Brixen,95,,1,6,7
011 Brixen,96,,-,6,6
011 Brixen,97,,2,6,8
011 Brixen,98,,1,1,2
011 Brixen,99,,1,4,5
011 Brixen,100,,-,4,4
011 Brixen,101,,-,1,1
011 Brixen,104,,-,1,1
012 Branzoll,0,,18,12,30
012 Branzoll,1,,13,23,36
012 Branzoll,2,,16,19,35
012 Branzoll,3,,13,15,28
012 Branzoll,4,,14,16,30
012 Branzoll,5,,14,9,23
012 Branzoll,6,,10,9,19
012 Branzoll,7,,16,16,32
012 Branzoll,8,,16,22,38
012 Branzoll,9,,14,12,26
012 Branzoll,10,,10,11,21
012 Branzoll,11,,22,8,30
012 Branzoll,12,,10,13,23
012 Branzoll,13,,14,5,19
012 Branzoll,14,,15,22,37
012 Branzoll,15,,17,7,24
012 Branzoll,16,,14,12,26
012 Branzoll,17,,18,8,26
012 Branzoll,18,,20,14,34
012 Branzoll,19,,15,12,27
012 Branzoll,20,,12,17,29
012 Branzoll,21,,14,19,33
012 Branzoll,22,,10,12,22
012 Branzoll,23,,15,14,29
012 Branzoll,24,,13,11,24
012 Branzoll,25,,14,17,31
012 Branzoll,26,,16,14,30
012 Branzoll,27,,14,15,29
012 Branzoll,28,,13,13,26
012 Branzoll,29,,20,16,36
012 Branzoll,30,,14,15,29
012 Branzoll,31,,16,18,34
012 Branzoll,32,,16,11,27
012 Branzoll,33,,13,23,36
012 Branzoll,34,,14,22,36
012 Branzoll,35,,17,19,36
012 Branzoll,36,,21,16,37
012 Branzoll,37,,21,28,49
012 Branzoll,38,,26,18,44
012 Branzoll,39,,25,15,40
012 Branzoll,40,,26,28,54
012 Branzoll,41,,21,20,41
012 Branzoll,42,,26,28,54
012 Branzoll,43,,21,23,44
012 Branzoll,44,,20,21,41
012 Branzoll,45,,19,19,38
012 Branzoll,46,,23,22,45
012 Branzoll,47,,29,25,54
012 Branzoll,48,,18,20,38
012 Branzoll,49,,15,17,32
012 Branzoll,50,,26,27,53
012 Branzoll,51,,28,20,48
012 Branzoll,52,,20,22,42
012 Branzoll,53,,20,18,38
012 Branzoll,54,,20,15,35
012 Branzoll,55,,14,18,32
012 Branzoll,56,,18,18,36
012 Branzoll,57,,21,16,37
012 Branzoll,58,,12,21,33
012 Branzoll,59,,15,20,35
012 Branzoll,60,,15,13,28
012 Branzoll,61,,17,16,33
012 Branzoll,62,,16,16,32
012 Branzoll,63,,15,15,30
012 Branzoll,64,,15,17,32
012 Branzoll,65,,14,20,34
012 Branzoll,66,,14,10,24
012 Branzoll,67,,11,10,21
012 Branzoll,68,,14,10,24
012 Branzoll,69,,19,12,31
012 Branzoll,70,,19,12,31
012 Branzoll,71,,11,14,25
012 Branzoll,72,,14,12,26
012 Branzoll,73,,9,9,18
012 Branzoll,74,,3,7,10
012 Branzoll,75,,6,8,14
012 Branzoll,76,,8,8,16
012 Branzoll,77,,5,10,15
012 Branzoll,78,,17,10,27
012 Branzoll,79,,8,9,17
012 Branzoll,80,,1,10,11
012 Branzoll,81,,5,13,18
012 Branzoll,82,,2,10,12
012 Branzoll,83,,3,9,12
012 Branzoll,84,,3,5,8
012 Branzoll,85,,4,9,13
012 Branzoll,86,,1,4,5
012 Branzoll,87,,1,4,5
012 Branzoll,88,,2,6,8
012 Branzoll,89,,-,1,1
012 Branzoll,90,,1,4,5
012 Branzoll,91,,1,4,5
012 Branzoll,92,,1,2,3
012 Branzoll,93,,2,-,2
012 Branzoll,97,,-,2,2
013 Bruneck,0,,79,61,140
013 Bruneck,1,,83,76,159
013 Bruneck,2,,91,63,154
013 Bruneck,3,,79,65,144
013 Bruneck,4,,87,63,150
013 Bruneck,5,,106,72,178
013 Bruneck,6,,83,85,168
013 Bruneck,7,,89,102,191
013 Bruneck,8,,97,79,176
013 Bruneck,9,,81,92,173
013 Bruneck,10,,95,77,172
013 Bruneck,11,,87,87,174
013 Bruneck,12,,92,98,190
013 Bruneck,13,,97,91,188
013 Bruneck,14,,112,72,184
013 Bruneck,15,,82,98,180
013 Bruneck,16,,67,82,149
013 Bruneck,17,,87,75,162
013 Bruneck,18,,91,67,158
013 Bruneck,19,,96,78,174
013 Bruneck,20,,87,72,159
013 Bruneck,21,,95,81,176
013 Bruneck,22,,89,94,183
013 Bruneck,23,,79,84,163
013 Bruneck,24,,70,69,139
013 Bruneck,25,,116,90,206
013 Bruneck,26,,91,83,174
013 Bruneck,27,,91,87,178
013 Bruneck,28,,101,95,196
013 Bruneck,29,,109,111,220
013 Bruneck,30,,110,112,222
013 Bruneck,31,,103,106,209
013 Bruneck,32,,94,105,199
013 Bruneck,33,,127,125,252
013 Bruneck,34,,116,112,228
013 Bruneck,35,,110,129,239
013 Bruneck,36,,126,121,247
013 Bruneck,37,,133,114,247
013 Bruneck,38,,133,116,249
013 Bruneck,39,,121,128,249
013 Bruneck,40,,141,114,255
013 Bruneck,41,,123,144,267
013 Bruneck,42,,144,120,264
013 Bruneck,43,,121,149,270
013 Bruneck,44,,141,131,272
013 Bruneck,45,,125,128,253
013 Bruneck,46,,155,146,301
013 Bruneck,47,,140,135,275
013 Bruneck,48,,138,115,253
013 Bruneck,49,,128,120,248
013 Bruneck,50,,117,101,218
013 Bruneck,51,,107,115,222
013 Bruneck,52,,110,104,214
013 Bruneck,53,,105,115,220
013 Bruneck,54,,88,102,190
013 Bruneck,55,,85,93,178
013 Bruneck,56,,75,82,157
013 Bruneck,57,,88,80,168
013 Bruneck,58,,76,102,178
013 Bruneck,59,,90,96,186
013 Bruneck,60,,68,102,170
013 Bruneck,61,,79,95,174
013 Bruneck,62,,82,93,175
013 Bruneck,63,,78,110,188
013 Bruneck,64,,95,71,166
013 Bruneck,65,,99,83,182
013 Bruneck,66,,62,67,129
013 Bruneck,67,,82,93,175
013 Bruneck,68,,93,83,176
013 Bruneck,69,,81,86,167
013 Bruneck,70,,72,97,169
013 Bruneck,71,,73,83,156
013 Bruneck,72,,73,89,162
013 Bruneck,73,,51,49,100
013 Bruneck,74,,50,53,103
013 Bruneck,75,,50,58,108
013 Bruneck,76,,42,47,89
013 Bruneck,77,,34,51,85
013 Bruneck,78,,42,56,98
013 Bruneck,79,,41,49,90
013 Bruneck,80,,32,42,74
013 Bruneck,81,,28,50,78
013 Bruneck,82,,21,48,69
013 Bruneck,83,,31,52,83
013 Bruneck,84,,21,35,56
013 Bruneck,85,,16,26,42
013 Bruneck,86,,15,33,48
013 Bruneck,87,,8,41,49
013 Bruneck,88,,13,31,44
013 Bruneck,89,,15,18,33
013 Bruneck,90,,3,17,20
013 Bruneck,91,,3,16,19
013 Bruneck,92,,6,9,15
013 Bruneck,93,,-,6,6
013 Bruneck,94,,2,8,10
013 Bruneck,95,,-,9,9
013 Bruneck,96,,1,4,5
013 Bruneck,97,,2,4,6
013 Bruneck,98,,-,7,7
013 Bruneck,99,,1,2,3
013 Bruneck,100,,-,2,2
013 Bruneck,101,,-,1,1
013 Bruneck,102,,-,1,1
014 Kuens,0,,3,6,9
014 Kuens,1,,1,1,2
014 Kuens,2,,4,4,8
014 Kuens,3,,4,4,8
014 Kuens,4,,2,5,7
014 Kuens,5,,2,1,3
014 Kuens,6,,6,2,8
014 Kuens,7,,2,3,5
014 Kuens,8,,5,4,9
014 Kuens,9,,2,1,3
014 Kuens,10,,5,2,7
014 Kuens,11,,2,6,8
014 Kuens,12,,2,3,5
014 Kuens,13,,2,6,8
014 Kuens,14,,2,1,3
014 Kuens,15,,5,2,7
014 Kuens,16,,2,3,5
014 Kuens,17,,1,4,5
014 Kuens,18,,3,2,5
014 Kuens,19,,4,2,6
014 Kuens,20,,2,2,4
014 Kuens,21,,4,2,6
014 Kuens,22,,2,2,4
014 Kuens,23,,1,4,5
014 Kuens,24,,2,1,3
014 Kuens,25,,2,-,2
014 Kuens,26,,1,1,2
014 Kuens,27,,-,3,3
014 Kuens,28,,1,1,2
014 Kuens,29,,2,1,3
014 Kuens,30,,1,3,4
014 Kuens,31,,4,6,10
014 Kuens,32,,-,1,1
014 Kuens,33,,3,3,6
014 Kuens,34,,2,2,4
014 Kuens,35,,3,2,5
014 Kuens,36,,4,6,10
014 Kuens,37,,3,7,10
014 Kuens,38,,1,3,4
014 Kuens,39,,6,1,7
014 Kuens,40,,2,4,6
014 Kuens,41,,7,5,12
014 Kuens,42,,4,1,5
014 Kuens,43,,4,4,8
014 Kuens,44,,6,11,17
014 Kuens,45,,1,5,6
014 Kuens,46,,7,1,8
014 Kuens,47,,6,6,12
014 Kuens,48,,10,2,12
014 Kuens,49,,5,1,6
014 Kuens,50,,-,5,5
014 Kuens,52,,2,-,2
014 Kuens,53,,-,4,4
014 Kuens,54,,3,-,3
014 Kuens,55,,3,-,3
014 Kuens,56,,-,2,2
014 Kuens,57,,-,1,1
014 Kuens,58,,1,2,3
014 Kuens,59,,1,3,4
014 Kuens,61,,-,3,3
014 Kuens,62,,-,3,3
014 Kuens,63,,3,1,4
014 Kuens,64,,1,2,3
014 Kuens,65,,1,2,3
014 Kuens,66,,3,1,4
014 Kuens,67,,1,-,1
014 Kuens,68,,-,2,2
014 Kuens,69,,1,3,4
014 Kuens,70,,1,2,3
014 Kuens,71,,-,1,1
014 Kuens,72,,5,2,7
014 Kuens,73,,3,2,5
014 Kuens,74,,1,3,4
014 Kuens,75,,2,2,4
014 Kuens,76,,1,3,4
014 Kuens,77,,-,1,1
014 Kuens,78,,-,1,1
014 Kuens,79,,4,2,6
014 Kuens,80,,2,2,4
014 Kuens,81,,2,2,4
014 Kuens,82,,1,-,1
014 Kuens,83,,1,-,1
014 Kuens,84,,1,-,1
014 Kuens,85,,1,1,2
014 Kuens,89,,-,2,2
014 Kuens,95,,-,1,1
015 Kaltern a.d. Weinstr.,0,,44,50,94
015 Kaltern a.d. Weinstr.,1,,53,33,86
015 Kaltern a.d. Weinstr.,2,,46,34,80
015 Kaltern a.d. Weinstr.,3,,40,44,84
015 Kaltern a.d. Weinstr.,4,,42,40,82
015 Kaltern a.d. Weinstr.,5,,45,39,84
015 Kaltern a.d. Weinstr.,6,,45,43,88
015 Kaltern a.d. Weinstr.,7,,47,46,93
015 Kaltern a.d. Weinstr.,8,,46,35,81
015 Kaltern a.d. Weinstr.,9,,43,37,80
015 Kaltern a.d. Weinstr.,10,,30,51,81
015 Kaltern a.d. Weinstr.,11,,37,38,75
015 Kaltern a.d. Weinstr.,12,,44,37,81
015 Kaltern a.d. Weinstr.,13,,42,51,93
015 Kaltern a.d. Weinstr.,14,,46,44,90
015 Kaltern a.d. Weinstr.,15,,44,43,87
015 Kaltern a.d. Weinstr.,16,,46,39,85
015 Kaltern a.d. Weinstr.,17,,33,40,73
015 Kaltern a.d. Weinstr.,18,,29,42,71
015 Kaltern a.d. Weinstr.,19,,37,42,79
015 Kaltern a.d. Weinstr.,20,,38,45,83
015 Kaltern a.d. Weinstr.,21,,40,36,76
015 Kaltern a.d. Weinstr.,22,,56,32,88
015 Kaltern a.d. Weinstr.,23,,40,37,77
015 Kaltern a.d. Weinstr.,24,,38,39,77
015 Kaltern a.d. Weinstr.,25,,56,39,95
015 Kaltern a.d. Weinstr.,26,,53,43,96
015 Kaltern a.d. Weinstr.,27,,44,43,87
015 Kaltern a.d. Weinstr.,28,,44,46,90
015 Kaltern a.d. Weinstr.,29,,54,53,107
015 Kaltern a.d. Weinstr.,30,,42,43,85
015 Kaltern a.d. Weinstr.,31,,51,51,102
015 Kaltern a.d. Weinstr.,32,,52,48,100
015 Kaltern a.d. Weinstr.,33,,58,47,105
015 Kaltern a.d. Weinstr.,34,,40,56,96
015 Kaltern a.d. Weinstr.,35,,48,53,101
015 Kaltern a.d. Weinstr.,36,,52,69,121
015 Kaltern a.d. Weinstr.,37,,51,57,108
015 Kaltern a.d. Weinstr.,38,,48,57,105
015 Kaltern a.d. Weinstr.,39,,67,70,137
015 Kaltern a.d. Weinstr.,40,,65,63,128
015 Kaltern a.d. Weinstr.,41,,58,65,123
015 Kaltern a.d. Weinstr.,42,,65,64,129
015 Kaltern a.d. Weinstr.,43,,81,70,151
015 Kaltern a.d. Weinstr.,44,,65,68,133
015 Kaltern a.d. Weinstr.,45,,63,71,134
015 Kaltern a.d. Weinstr.,46,,59,60,119
015 Kaltern a.d. Weinstr.,47,,85,55,140
015 Kaltern a.d. Weinstr.,48,,51,57,108
015 Kaltern a.d. Weinstr.,49,,58,64,122
015 Kaltern a.d. Weinstr.,50,,66,69,135
015 Kaltern a.d. Weinstr.,51,,51,66,117
015 Kaltern a.d. Weinstr.,52,,53,58,111
015 Kaltern a.d. Weinstr.,53,,58,67,125
015 Kaltern a.d. Weinstr.,54,,50,61,111
015 Kaltern a.d. Weinstr.,55,,64,41,105
015 Kaltern a.d. Weinstr.,56,,49,42,91
015 Kaltern a.d. Weinstr.,57,,39,50,89
015 Kaltern a.d. Weinstr.,58,,38,37,75
015 Kaltern a.d. Weinstr.,59,,40,58,98
015 Kaltern a.d. Weinstr.,60,,33,36,69
015 Kaltern a.d. Weinstr.,61,,42,34,76
015 Kaltern a.d. Weinstr.,62,,30,38,68
015 Kaltern a.d. Weinstr.,63,,35,35,70
015 Kaltern a.d. Weinstr.,64,,37,56,93
015 Kaltern a.d. Weinstr.,65,,49,48,97
015 Kaltern a.d. Weinstr.,66,,37,38,75
015 Kaltern a.d. Weinstr.,67,,33,43,76
015 Kaltern a.d. Weinstr.,68,,33,37,70
015 Kaltern a.d. Weinstr.,69,,40,40,80
015 Kaltern a.d. Weinstr.,70,,43,42,85
015 Kaltern a.d. Weinstr.,71,,30,43,73
015 Kaltern a.d. Weinstr.,72,,23,35,58
015 Kaltern a.d. Weinstr.,73,,36,37,73
015 Kaltern a.d. Weinstr.,74,,26,29,55
015 Kaltern a.d. Weinstr.,75,,25,22,47
015 Kaltern a.d. Weinstr.,76,,24,26,50
015 Kaltern a.d. Weinstr.,77,,20,25,45
015 Kaltern a.d. Weinstr.,78,,22,37,59
015 Kaltern a.d. Weinstr.,79,,21,32,53
015 Kaltern a.d. Weinstr.,80,,14,29,43
015 Kaltern a.d. Weinstr.,81,,20,31,51
015 Kaltern a.d. Weinstr.,82,,19,29,48
015 Kaltern a.d. Weinstr.,83,,15,24,39
015 Kaltern a.d. Weinstr.,84,,14,27,41
015 Kaltern a.d. Weinstr.,85,,8,19,27
015 Kaltern a.d. Weinstr.,86,,13,28,41
015 Kaltern a.d. Weinstr.,87,,7,16,23
015 Kaltern a.d. Weinstr.,88,,2,14,16
015 Kaltern a.d. Weinstr.,89,,6,20,26
015 Kaltern a.d. Weinstr.,90,,4,14,18
015 Kaltern a.d. Weinstr.,91,,1,13,14
015 Kaltern a.d. Weinstr.,92,,3,4,7
015 Kaltern a.d. Weinstr.,93,,1,4,5
015 Kaltern a.d. Weinstr.,94,,1,3,4
015 Kaltern a.d. Weinstr.,95,,1,-,1
015 Kaltern a.d. Weinstr.,96,,1,2,3
015 Kaltern a.d. Weinstr.,97,,-,5,5
015 Kaltern a.d. Weinstr.,98,,1,3,4
015 Kaltern a.d. Weinstr.,99,,-,4,4
015 Kaltern a.d. Weinstr.,100,,-,1,1
016 Freienfeld,0,,15,21,36
016 Freienfeld,1,,15,11,26
016 Freienfeld,2,,16,17,33
016 Freienfeld,3,,12,13,25
016 Freienfeld,4,,21,12,33
016 Freienfeld,5,,16,15,31
016 Freienfeld,6,,19,18,37
016 Freienfeld,7,,16,10,26
016 Freienfeld,8,,21,15,36
016 Freienfeld,9,,19,20,39
016 Freienfeld,10,,18,18,36
016 Freienfeld,11,,14,14,28
016 Freienfeld,12,,17,21,38
016 Freienfeld,13,,14,20,34
016 Freienfeld,14,,18,16,34
016 Freienfeld,15,,22,13,35
016 Freienfeld,16,,17,16,33
016 Freienfeld,17,,14,12,26
016 Freienfeld,18,,14,12,26
016 Freienfeld,19,,18,21,39
016 Freienfeld,20,,10,11,21
016 Freienfeld,21,,20,19,39
016 Freienfeld,22,,28,20,48
016 Freienfeld,23,,21,16,37
016 Freienfeld,24,,16,16,32
016 Freienfeld,25,,17,13,30
016 Freienfeld,26,,14,15,29
016 Freienfeld,27,,26,14,40
016 Freienfeld,28,,23,23,46
016 Freienfeld,29,,20,18,38
016 Freienfeld,30,,22,19,41
016 Freienfeld,31,,19,14,33
016 Freienfeld,32,,16,23,39
016 Freienfeld,33,,16,12,28
016 Freienfeld,34,,21,23,44
016 Freienfeld,35,,14,17,31
016 Freienfeld,36,,20,16,36
016 Freienfeld,37,,22,21,43
016 Freienfeld,38,,21,18,39
016 Freienfeld,39,,19,24,43
016 Freienfeld,40,,23,25,48
016 Freienfeld,41,,23,18,41
016 Freienfeld,42,,24,25,49
016 Freienfeld,43,,25,19,44
016 Freienfeld,44,,20,28,48
016 Freienfeld,45,,25,21,46
016 Freienfeld,46,,26,22,48
016 Freienfeld,47,,25,18,43
016 Freienfeld,48,,22,17,39
016 Freienfeld,49,,26,28,54
016 Freienfeld,50,,25,16,41
016 Freienfeld,51,,27,22,49
016 Freienfeld,52,,25,14,39
016 Freienfeld,53,,18,22,40
016 Freienfeld,54,,15,21,36
016 Freienfeld,55,,20,18,38
016 Freienfeld,56,,21,10,31
016 Freienfeld,57,,17,18,35
016 Freienfeld,58,,18,11,29
016 Freienfeld,59,,15,18,33
016 Freienfeld,60,,12,11,23
016 Freienfeld,61,,18,9,27
016 Freienfeld,62,,16,13,29
016 Freienfeld,63,,19,13,32
016 Freienfeld,64,,5,10,15
016 Freienfeld,65,,11,16,27
016 Freienfeld,66,,9,2,11
016 Freienfeld,67,,8,5,13
016 Freienfeld,68,,11,8,19
016 Freienfeld,69,,11,9,20
016 Freienfeld,70,,10,10,20
016 Freienfeld,71,,10,4,14
016 Freienfeld,72,,7,9,16
016 Freienfeld,73,,12,12,24
016 Freienfeld,74,,4,11,15
016 Freienfeld,75,,8,11,19
016 Freienfeld,76,,6,11,17
016 Freienfeld,77,,4,4,8
016 Freienfeld,78,,6,8,14
016 Freienfeld,79,,7,9,16
016 Freienfeld,80,,5,7,12
016 Freienfeld,81,,6,5,11
016 Freienfeld,82,,2,4,6
016 Freienfeld,83,,5,3,8
016 Freienfeld,84,,4,5,9
016 Freienfeld,85,,6,8,14
016 Freienfeld,86,,3,3,6
016 Freienfeld,87,,1,2,3
016 Freienfeld,88,,-,7,7
016 Freienfeld,89,,1,5,6
016 Freienfeld,91,,1,1,2
016 Freienfeld,92,,1,-,1
016 Freienfeld,97,,-,1,1
016 Freienfeld,100,,-,1,1
017 Sand in Taufers,0,,23,26,49
017 Sand in Taufers,1,,24,25,49
017 Sand in Taufers,2,,36,42,78
017 Sand in Taufers,3,,29,30,59
017 Sand in Taufers,4,,49,42,91
017 Sand in Taufers,5,,35,23,58
017 Sand in Taufers,6,,37,30,67
017 Sand in Taufers,7,,36,21,57
017 Sand in Taufers,8,,33,27,60
017 Sand in Taufers,9,,28,29,57
017 Sand in Taufers,10,,30,38,68
017 Sand in Taufers,11,,45,21,66
017 Sand in Taufers,12,,36,38,74
017 Sand in Taufers,13,,27,35,62
017 Sand in Taufers,14,,35,36,71
017 Sand in Taufers,15,,29,31,60
017 Sand in Taufers,16,,31,27,58
017 Sand in Taufers,17,,41,36,77
017 Sand in Taufers,18,,24,35,59
017 Sand in Taufers,19,,34,36,70
017 Sand in Taufers,20,,27,31,58
017 Sand in Taufers,21,,24,34,58
017 Sand in Taufers,22,,28,31,59
017 Sand in Taufers,23,,30,33,63
017 Sand in Taufers,24,,21,27,48
017 Sand in Taufers,25,,25,18,43
017 Sand in Taufers,26,,25,30,55
017 Sand in Taufers,27,,32,26,58
017 Sand in Taufers,28,,35,31,66
017 Sand in Taufers,29,,26,37,63
017 Sand in Taufers,30,,33,30,63
017 Sand in Taufers,31,,37,37,74
017 Sand in Taufers,32,,34,42,76
017 Sand in Taufers,33,,44,36,80
017 Sand in Taufers,34,,34,37,71
017 Sand in Taufers,35,,39,32,71
017 Sand in Taufers,36,,44,37,81
017 Sand in Taufers,37,,56,47,103
017 Sand in Taufers,38,,52,43,95
017 Sand in Taufers,39,,49,53,102
017 Sand in Taufers,40,,43,49,92
017 Sand in Taufers,41,,42,63,105
017 Sand in Taufers,42,,56,47,103
017 Sand in Taufers,43,,55,40,95
017 Sand in Taufers,44,,34,41,75
017 Sand in Taufers,45,,52,35,87
017 Sand in Taufers,46,,53,37,90
017 Sand in Taufers,47,,51,40,91
017 Sand in Taufers,48,,46,44,90
017 Sand in Taufers,49,,37,45,82
017 Sand in Taufers,50,,48,40,88
017 Sand in Taufers,51,,40,33,73
017 Sand in Taufers,52,,36,35,71
017 Sand in Taufers,53,,30,21,51
017 Sand in Taufers,54,,24,39,63
017 Sand in Taufers,55,,25,33,58
017 Sand in Taufers,56,,26,23,49
017 Sand in Taufers,57,,26,29,55
017 Sand in Taufers,58,,29,23,52
017 Sand in Taufers,59,,17,30,47
017 Sand in Taufers,60,,26,22,48
017 Sand in Taufers,61,,33,31,64
017 Sand in Taufers,62,,29,22,51
017 Sand in Taufers,63,,21,26,47
017 Sand in Taufers,64,,25,29,54
017 Sand in Taufers,65,,28,23,51
017 Sand in Taufers,66,,28,8,36
017 Sand in Taufers,67,,17,30,47
017 Sand in Taufers,68,,25,28,53
017 Sand in Taufers,69,,28,32,60
017 Sand in Taufers,70,,25,31,56
017 Sand in Taufers,71,,22,18,40
017 Sand in Taufers,72,,24,30,54
017 Sand in Taufers,73,,17,25,42
017 Sand in Taufers,74,,25,12,37
017 Sand in Taufers,75,,15,25,40
017 Sand in Taufers,76,,24,18,42
017 Sand in Taufers,77,,14,11,25
017 Sand in Taufers,78,,12,15,27
017 Sand in Taufers,79,,8,16,24
017 Sand in Taufers,80,,10,11,21
017 Sand in Taufers,81,,11,18,29
017 Sand in Taufers,82,,9,11,20
017 Sand in Taufers,83,,6,11,17
017 Sand in Taufers,84,,6,7,13
017 Sand in Taufers,85,,5,14,19
017 Sand in Taufers,86,,3,8,11
017 Sand in Taufers,87,,5,10,15
017 Sand in Taufers,88,,5,5,10
017 Sand in Taufers,89,,2,9,11
017 Sand in Taufers,90,,1,10,11
017 Sand in Taufers,91,,2,3,5
017 Sand in Taufers,92,,1,4,5
017 Sand in Taufers,93,,2,2,4
017 Sand in Taufers,94,,-,1,1
017 Sand in Taufers,96,,1,3,4
017 Sand in Taufers,97,,1,1,2
017 Sand in Taufers,98,,-,1,1
017 Sand in Taufers,99,,-,1,1
017 Sand in Taufers,100,,-,1,1
018 Kastelbell-Tschars,0,,13,12,25
018 Kastelbell-Tschars,1,,11,20,31
018 Kastelbell-Tschars,2,,11,11,22
018 Kastelbell-Tschars,3,,12,4,16
018 Kastelbell-Tschars,4,,12,11,23
018 Kastelbell-Tschars,5,,19,7,26
018 Kastelbell-Tschars,6,,10,8,18
018 Kastelbell-Tschars,7,,12,11,23
018 Kastelbell-Tschars,8,,11,9,20
018 Kastelbell-Tschars,9,,7,9,16
018 Kastelbell-Tschars,10,,14,15,29
018 Kastelbell-Tschars,11,,12,9,21
018 Kastelbell-Tschars,12,,25,12,37
018 Kastelbell-Tschars,13,,16,7,23
018 Kastelbell-Tschars,14,,10,11,21
018 Kastelbell-Tschars,15,,15,18,33
018 Kastelbell-Tschars,16,,15,10,25
018 Kastelbell-Tschars,17,,14,15,29
018 Kastelbell-Tschars,18,,14,14,28
018 Kastelbell-Tschars,19,,13,14,27
018 Kastelbell-Tschars,20,,16,12,28
018 Kastelbell-Tschars,21,,18,11,29
018 Kastelbell-Tschars,22,,17,9,26
018 Kastelbell-Tschars,23,,21,6,27
018 Kastelbell-Tschars,24,,19,17,36
018 Kastelbell-Tschars,25,,19,20,39
018 Kastelbell-Tschars,26,,22,17,39
018 Kastelbell-Tschars,27,,6,13,19
018 Kastelbell-Tschars,28,,16,18,34
018 Kastelbell-Tschars,29,,27,12,39
018 Kastelbell-Tschars,30,,13,17,30
018 Kastelbell-Tschars,31,,11,14,25
018 Kastelbell-Tschars,32,,13,14,27
018 Kastelbell-Tschars,33,,16,16,32
018 Kastelbell-Tschars,34,,11,16,27
018 Kastelbell-Tschars,35,,22,19,41
018 Kastelbell-Tschars,36,,17,12,29
018 Kastelbell-Tschars,37,,21,11,32
018 Kastelbell-Tschars,38,,14,25,39
018 Kastelbell-Tschars,39,,13,22,35
018 Kastelbell-Tschars,40,,17,16,33
018 Kastelbell-Tschars,41,,15,15,30
018 Kastelbell-Tschars,42,,24,26,50
018 Kastelbell-Tschars,43,,16,17,33
018 Kastelbell-Tschars,44,,15,20,35
018 Kastelbell-Tschars,45,,19,12,31
018 Kastelbell-Tschars,46,,19,12,31
018 Kastelbell-Tschars,47,,23,14,37
018 Kastelbell-Tschars,48,,24,21,45
018 Kastelbell-Tschars,49,,7,21,28
018 Kastelbell-Tschars,50,,20,18,38
018 Kastelbell-Tschars,51,,25,19,44
018 Kastelbell-Tschars,52,,23,19,42
018 Kastelbell-Tschars,53,,19,13,32
018 Kastelbell-Tschars,54,,17,10,27
018 Kastelbell-Tschars,55,,14,14,28
018 Kastelbell-Tschars,56,,22,18,40
018 Kastelbell-Tschars,57,,9,14,23
018 Kastelbell-Tschars,58,,9,16,25
018 Kastelbell-Tschars,59,,13,15,28
018 Kastelbell-Tschars,60,,15,13,28
018 Kastelbell-Tschars,61,,10,13,23
018 Kastelbell-Tschars,62,,16,10,26
018 Kastelbell-Tschars,63,,12,12,24
018 Kastelbell-Tschars,64,,9,8,17
018 Kastelbell-Tschars,65,,11,13,24
018 Kastelbell-Tschars,66,,11,4,15
018 Kastelbell-Tschars,67,,12,6,18
018 Kastelbell-Tschars,68,,7,7,14
018 Kastelbell-Tschars,69,,12,11,23
018 Kastelbell-Tschars,70,,9,8,17
018 Kastelbell-Tschars,71,,8,9,17
018 Kastelbell-Tschars,72,,11,11,22
018 Kastelbell-Tschars,73,,8,16,24
018 Kastelbell-Tschars,74,,11,11,22
018 Kastelbell-Tschars,75,,9,15,24
018 Kastelbell-Tschars,76,,10,9,19
018 Kastelbell-Tschars,77,,5,13,18
018 Kastelbell-Tschars,78,,14,12,26
018 Kastelbell-Tschars,79,,7,12,19
018 Kastelbell-Tschars,80,,8,11,19
018 Kastelbell-Tschars,81,,16,13,29
018 Kastelbell-Tschars,82,,9,10,19
018 Kastelbell-Tschars,83,,5,10,15
018 Kastelbell-Tschars,84,,4,6,10
018 Kastelbell-Tschars,85,,6,12,18
018 Kastelbell-Tschars,86,,9,6,15
018 Kastelbell-Tschars,87,,2,6,8
018 Kastelbell-Tschars,88,,2,7,9
018 Kastelbell-Tschars,89,,-,5,5
018 Kastelbell-Tschars,90,,1,2,3
018 Kastelbell-Tschars,91,,3,3,6
018 Kastelbell-Tschars,93,,-,1,1
018 Kastelbell-Tschars,94,,-,1,1
018 Kastelbell-Tschars,100,,-,1,1
018 Kastelbell-Tschars,102,,1,-,1
019 Kastelruth,0,,36,31,67
019 Kastelruth,1,,42,35,77
019 Kastelruth,2,,28,37,65
019 Kastelruth,3,,56,34,90
019 Kastelruth,4,,42,38,80
019 Kastelruth,5,,45,35,80
019 Kastelruth,6,,46,35,81
019 Kastelruth,7,,44,38,82
019 Kastelruth,8,,44,40,84
019 Kastelruth,9,,40,33,73
019 Kastelruth,10,,42,34,76
019 Kastelruth,11,,37,26,63
019 Kastelruth,12,,32,41,73
019 Kastelruth,13,,49,42,91
019 Kastelruth,14,,45,46,91
019 Kastelruth,15,,43,37,80
019 Kastelruth,16,,50,40,90
019 Kastelruth,17,,35,29,64
019 Kastelruth,18,,38,36,74
019 Kastelruth,19,,38,53,91
019 Kastelruth,20,,36,38,74
019 Kastelruth,21,,40,40,80
019 Kastelruth,22,,47,40,87
019 Kastelruth,23,,27,25,52
019 Kastelruth,24,,36,39,75
019 Kastelruth,25,,34,23,57
019 Kastelruth,26,,29,37,66
019 Kastelruth,27,,26,36,62
019 Kastelruth,28,,40,34,74
019 Kastelruth,29,,47,41,88
019 Kastelruth,30,,36,41,77
019 Kastelruth,31,,46,34,80
019 Kastelruth,32,,37,38,75
019 Kastelruth,33,,29,44,73
019 Kastelruth,34,,32,40,72
019 Kastelruth,35,,44,63,107
019 Kastelruth,36,,50,43,93
019 Kastelruth,37,,59,43,102
019 Kastelruth,38,,41,64,105
019 Kastelruth,39,,66,43,109
019 Kastelruth,40,,53,45,98
019 Kastelruth,41,,58,54,112
019 Kastelruth,42,,59,43,102
019 Kastelruth,43,,59,58,117
019 Kastelruth,44,,69,53,122
019 Kastelruth,45,,72,50,122
019 Kastelruth,46,,50,73,123
019 Kastelruth,47,,53,37,90
019 Kastelruth,48,,53,35,88
019 Kastelruth,49,,34,52,86
019 Kastelruth,50,,56,40,96
019 Kastelruth,51,,49,40,89
019 Kastelruth,52,,45,47,92
019 Kastelruth,53,,48,43,91
019 Kastelruth,54,,39,41,80
019 Kastelruth,55,,38,30,68
019 Kastelruth,56,,40,40,80
019 Kastelruth,57,,37,31,68
019 Kastelruth,58,,29,29,58
019 Kastelruth,59,,34,25,59
019 Kastelruth,60,,29,24,53
019 Kastelruth,61,,44,26,70
019 Kastelruth,62,,19,36,55
019 Kastelruth,63,,28,42,70
019 Kastelruth,64,,33,32,65
019 Kastelruth,65,,23,38,61
019 Kastelruth,66,,22,21,43
019 Kastelruth,67,,21,43,64
019 Kastelruth,68,,38,39,77
019 Kastelruth,69,,33,26,59
019 Kastelruth,70,,29,44,73
019 Kastelruth,71,,27,34,61
019 Kastelruth,72,,26,28,54
019 Kastelruth,73,,24,25,49
019 Kastelruth,74,,25,23,48
019 Kastelruth,75,,27,17,44
019 Kastelruth,76,,23,25,48
019 Kastelruth,77,,18,22,40
019 Kastelruth,78,,29,27,56
019 Kastelruth,79,,15,35,50
019 Kastelruth,80,,33,21,54
019 Kastelruth,81,,8,23,31
019 Kastelruth,82,,17,22,39
019 Kastelruth,83,,8,13,21
019 Kastelruth,84,,13,25,38
019 Kastelruth,85,,9,15,24
019 Kastelruth,86,,8,13,21
019 Kastelruth,87,,7,14,21
019 Kastelruth,88,,5,13,18
019 Kastelruth,89,,7,8,15
019 Kastelruth,90,,4,9,13
019 Kastelruth,91,,2,8,10
019 Kastelruth,92,,1,3,4
019 Kastelruth,93,,1,1,2
019 Kastelruth,94,,-,1,1
019 Kastelruth,95,,-,2,2
019 Kastelruth,96,,1,4,5
019 Kastelruth,97,,-,1,1
019 Kastelruth,99,,-,1,1
019 Kastelruth,100,,-,1,1
020 Tscherms,0,,19,5,24
020 Tscherms,1,,6,6,12
020 Tscherms,2,,5,6,11
020 Tscherms,3,,7,13,20
020 Tscherms,4,,7,10,17
020 Tscherms,5,,5,6,11
020 Tscherms,6,,3,9,12
020 Tscherms,7,,8,7,15
020 Tscherms,8,,9,7,16
020 Tscherms,9,,8,8,16
020 Tscherms,10,,5,9,14
020 Tscherms,11,,9,7,16
020 Tscherms,12,,8,8,16
020 Tscherms,13,,4,8,12
020 Tscherms,14,,9,8,17
020 Tscherms,15,,8,3,11
020 Tscherms,16,,12,10,22
020 Tscherms,17,,9,18,27
020 Tscherms,18,,7,10,17
020 Tscherms,19,,12,7,19
020 Tscherms,20,,7,8,15
020 Tscherms,21,,8,6,14
020 Tscherms,22,,7,7,14
020 Tscherms,23,,4,17,21
020 Tscherms,24,,7,8,15
020 Tscherms,25,,12,5,17
020 Tscherms,26,,13,13,26
020 Tscherms,27,,14,9,23
020 Tscherms,28,,12,13,25
020 Tscherms,29,,7,8,15
020 Tscherms,30,,10,13,23
020 Tscherms,31,,9,11,20
020 Tscherms,32,,6,8,14
020 Tscherms,33,,8,11,19
020 Tscherms,34,,11,5,16
020 Tscherms,35,,6,10,16
020 Tscherms,36,,13,8,21
020 Tscherms,37,,9,8,17
020 Tscherms,38,,10,15,25
020 Tscherms,39,,11,11,22
020 Tscherms,40,,10,11,21
020 Tscherms,41,,12,7,19
020 Tscherms,42,,11,14,25
020 Tscherms,43,,12,7,19
020 Tscherms,44,,12,13,25
020 Tscherms,45,,16,7,23
020 Tscherms,46,,16,16,32
020 Tscherms,47,,13,15,28
020 Tscherms,48,,15,15,30
020 Tscherms,49,,17,16,33
020 Tscherms,50,,13,11,24
020 Tscherms,51,,9,15,24
020 Tscherms,52,,7,18,25
020 Tscherms,53,,8,6,14
020 Tscherms,54,,8,9,17
020 Tscherms,55,,9,6,15
020 Tscherms,56,,9,7,16
020 Tscherms,57,,7,9,16
020 Tscherms,58,,10,10,20
020 Tscherms,59,,12,6,18
020 Tscherms,60,,5,9,14
020 Tscherms,61,,10,6,16
020 Tscherms,62,,3,3,6
020 Tscherms,63,,6,5,11
020 Tscherms,64,,7,8,15
020 Tscherms,65,,5,8,13
020 Tscherms,66,,4,7,11
020 Tscherms,67,,5,8,13
020 Tscherms,68,,5,3,8
020 Tscherms,69,,8,4,12
020 Tscherms,70,,10,8,18
020 Tscherms,71,,5,4,9
020 Tscherms,72,,5,6,11
020 Tscherms,73,,6,3,9
020 Tscherms,74,,6,8,14
020 Tscherms,75,,6,7,13
020 Tscherms,76,,3,4,7
020 Tscherms,77,,2,8,10
020 Tscherms,78,,4,3,7
020 Tscherms,79,,5,4,9
020 Tscherms,80,,2,3,5
020 Tscherms,81,,3,5,8
020 Tscherms,82,,2,2,4
020 Tscherms,83,,4,3,7
020 Tscherms,84,,3,3,6
020 Tscherms,85,,3,2,5
020 Tscherms,86,,3,5,8
020 Tscherms,87,,3,4,7
020 Tscherms,88,,-,3,3
020 Tscherms,89,,1,5,6
020 Tscherms,90,,-,2,2
020 Tscherms,91,,2,1,3
020 Tscherms,92,,-,1,1
020 Tscherms,93,,-,1,1
020 Tscherms,97,,-,1,1
020 Tscherms,99,,1,-,1
021 Kiens,0,,13,11,24
021 Kiens,1,,15,14,29
021 Kiens,2,,9,20,29
021 Kiens,3,,15,9,24
021 Kiens,4,,14,11,25
021 Kiens,5,,14,10,24
021 Kiens,6,,16,19,35
021 Kiens,7,,16,10,26
021 Kiens,8,,14,19,33
021 Kiens,9,,9,14,23
021 Kiens,10,,20,19,39
021 Kiens,11,,9,22,31
021 Kiens,12,,15,17,32
021 Kiens,13,,20,9,29
021 Kiens,14,,16,14,30
021 Kiens,15,,15,18,33
021 Kiens,16,,13,20,33
021 Kiens,17,,18,16,34
021 Kiens,18,,17,18,35
021 Kiens,19,,26,19,45
021 Kiens,20,,12,25,37
021 Kiens,21,,14,22,36
021 Kiens,22,,14,23,37
021 Kiens,23,,14,16,30
021 Kiens,24,,10,17,27
021 Kiens,25,,20,10,30
021 Kiens,26,,20,13,33
021 Kiens,27,,16,11,27
021 Kiens,28,,14,21,35
021 Kiens,29,,21,20,41
021 Kiens,30,,15,14,29
021 Kiens,31,,22,19,41
021 Kiens,32,,12,14,26
021 Kiens,33,,30,18,48
021 Kiens,34,,20,15,35
021 Kiens,35,,23,24,47
021 Kiens,36,,19,18,37
021 Kiens,37,,23,20,43
021 Kiens,38,,34,23,57
021 Kiens,39,,21,17,38
021 Kiens,40,,24,22,46
021 Kiens,41,,24,28,52
021 Kiens,42,,32,22,54
021 Kiens,43,,37,19,56
021 Kiens,44,,20,23,43
021 Kiens,45,,30,25,55
021 Kiens,46,,21,22,43
021 Kiens,47,,31,23,54
021 Kiens,48,,18,21,39
021 Kiens,49,,30,18,48
021 Kiens,50,,20,24,44
021 Kiens,51,,22,19,41
021 Kiens,52,,25,16,41
021 Kiens,53,,15,13,28
021 Kiens,54,,12,17,29
021 Kiens,55,,19,15,34
021 Kiens,56,,14,8,22
021 Kiens,57,,11,16,27
021 Kiens,58,,15,23,38
021 Kiens,59,,11,9,20
021 Kiens,60,,13,11,24
021 Kiens,61,,16,10,26
021 Kiens,62,,10,13,23
021 Kiens,63,,14,18,32
021 Kiens,64,,12,15,27
021 Kiens,65,,21,14,35
021 Kiens,66,,8,11,19
021 Kiens,67,,9,12,21
021 Kiens,68,,18,10,28
021 Kiens,69,,16,9,25
021 Kiens,70,,15,11,26
021 Kiens,71,,10,16,26
021 Kiens,72,,11,9,20
021 Kiens,73,,9,12,21
021 Kiens,74,,10,11,21
021 Kiens,75,,9,10,19
021 Kiens,76,,3,17,20
021 Kiens,77,,7,9,16
021 Kiens,78,,10,8,18
021 Kiens,79,,12,10,22
021 Kiens,80,,11,7,18
021 Kiens,81,,6,11,17
021 Kiens,82,,2,7,9
021 Kiens,83,,1,3,4
021 Kiens,84,,3,4,7
021 Kiens,85,,-,4,4
021 Kiens,86,,2,3,5
021 Kiens,87,,1,5,6
021 Kiens,88,,2,3,5
021 Kiens,89,,2,1,3
021 Kiens,90,,-,3,3
021 Kiens,91,,1,2,3
021 Kiens,97,,-,1,1
021 Kiens,98,,-,1,1
022 Klausen,0,,32,33,65
022 Klausen,1,,21,33,54
022 Klausen,2,,30,20,50
022 Klausen,3,,23,25,48
022 Klausen,4,,27,29,56
022 Klausen,5,,39,39,78
022 Klausen,6,,35,33,68
022 Klausen,7,,39,35,74
022 Klausen,8,,29,29,58
022 Klausen,9,,41,27,68
022 Klausen,10,,31,29,60
022 Klausen,11,,30,32,62
022 Klausen,12,,27,30,57
022 Klausen,13,,24,28,52
022 Klausen,14,,39,32,71
022 Klausen,15,,30,26,56
022 Klausen,16,,31,27,58
022 Klausen,17,,18,36,54
022 Klausen,18,,32,26,58
022 Klausen,19,,40,26,66
022 Klausen,20,,38,37,75
022 Klausen,21,,40,29,69
022 Klausen,22,,27,31,58
022 Klausen,23,,33,35,68
022 Klausen,24,,30,32,62
022 Klausen,25,,35,29,64
022 Klausen,26,,39,36,75
022 Klausen,27,,30,30,60
022 Klausen,28,,26,36,62
022 Klausen,29,,40,41,81
022 Klausen,30,,40,31,71
022 Klausen,31,,32,41,73
022 Klausen,32,,32,29,61
022 Klausen,33,,42,40,82
022 Klausen,34,,32,30,62
022 Klausen,35,,38,30,68
022 Klausen,36,,34,44,78
022 Klausen,37,,38,34,72
022 Klausen,38,,45,30,75
022 Klausen,39,,37,42,79
022 Klausen,40,,41,45,86
022 Klausen,41,,43,42,85
022 Klausen,42,,46,46,92
022 Klausen,43,,49,45,94
022 Klausen,44,,54,45,99
022 Klausen,45,,66,43,109
022 Klausen,46,,40,49,89
022 Klausen,47,,46,47,93
022 Klausen,48,,39,39,78
022 Klausen,49,,35,40,75
022 Klausen,50,,50,45,95
022 Klausen,51,,40,25,65
022 Klausen,52,,35,40,75
022 Klausen,53,,30,29,59
022 Klausen,54,,32,23,55
022 Klausen,55,,30,25,55
022 Klausen,56,,26,33,59
022 Klausen,57,,33,41,74
022 Klausen,58,,20,29,49
022 Klausen,59,,28,17,45
022 Klausen,60,,33,25,58
022 Klausen,61,,28,23,51
022 Klausen,62,,30,25,55
022 Klausen,63,,27,28,55
022 Klausen,64,,24,20,44
022 Klausen,65,,30,22,52
022 Klausen,66,,12,16,28
022 Klausen,67,,23,18,41
022 Klausen,68,,17,28,45
022 Klausen,69,,21,25,46
022 Klausen,70,,26,19,45
022 Klausen,71,,19,21,40
022 Klausen,72,,21,18,39
022 Klausen,73,,15,20,35
022 Klausen,74,,16,17,33
022 Klausen,75,,15,22,37
022 Klausen,76,,10,17,27
022 Klausen,77,,16,13,29
022 Klausen,78,,20,15,35
022 Klausen,79,,9,18,27
022 Klausen,80,,12,12,24
022 Klausen,81,,9,15,24
022 Klausen,82,,13,15,28
022 Klausen,83,,3,15,18
022 Klausen,84,,3,15,18
022 Klausen,85,,7,7,14
022 Klausen,86,,4,5,9
022 Klausen,87,,5,11,16
022 Klausen,88,,2,7,9
022 Klausen,89,,3,4,7
022 Klausen,90,,-,4,4
022 Klausen,91,,1,5,6
022 Klausen,92,,1,4,5
022 Klausen,93,,1,2,3
022 Klausen,94,,1,4,5
022 Klausen,95,,-,1,1
022 Klausen,97,,1,-,1
022 Klausen,98,,-,1,1
023 Karneid,0,,27,17,44
023 Karneid,1,,12,17,29
023 Karneid,2,,17,17,34
023 Karneid,3,,27,15,42
023 Karneid,4,,23,21,44
023 Karneid,5,,23,17,40
023 Karneid,6,,24,19,43
023 Karneid,7,,20,25,45
023 Karneid,8,,27,17,44
023 Karneid,9,,17,16,33
023 Karneid,10,,21,20,41
023 Karneid,11,,16,19,35
023 Karneid,12,,24,24,48
023 Karneid,13,,18,18,36
023 Karneid,14,,27,18,45
023 Karneid,15,,19,24,43
023 Karneid,16,,27,20,47
023 Karneid,17,,22,21,43
023 Karneid,18,,22,20,42
023 Karneid,19,,23,18,41
023 Karneid,20,,16,20,36
023 Karneid,21,,22,16,38
023 Karneid,22,,15,19,34
023 Karneid,23,,15,17,32
023 Karneid,24,,14,25,39
023 Karneid,25,,19,19,38
023 Karneid,26,,21,15,36
023 Karneid,27,,26,20,46
023 Karneid,28,,17,16,33
023 Karneid,29,,19,16,35
023 Karneid,30,,32,28,60
023 Karneid,31,,22,21,43
023 Karneid,32,,27,27,54
023 Karneid,33,,23,13,36
023 Karneid,34,,19,25,44
023 Karneid,35,,27,25,52
023 Karneid,36,,23,16,39
023 Karneid,37,,26,28,54
023 Karneid,38,,30,31,61
023 Karneid,39,,31,26,57
023 Karneid,40,,30,39,69
023 Karneid,41,,35,23,58
023 Karneid,42,,26,27,53
023 Karneid,43,,37,31,68
023 Karneid,44,,32,30,62
023 Karneid,45,,35,33,68
023 Karneid,46,,31,25,56
023 Karneid,47,,36,25,61
023 Karneid,48,,37,22,59
023 Karneid,49,,28,39,67
023 Karneid,50,,27,22,49
023 Karneid,51,,31,26,57
023 Karneid,52,,26,18,44
023 Karneid,53,,24,18,42
023 Karneid,54,,16,13,29
023 Karneid,55,,20,18,38
023 Karneid,56,,16,11,27
023 Karneid,57,,13,13,26
023 Karneid,58,,16,14,30
023 Karneid,59,,11,21,32
023 Karneid,60,,16,11,27
023 Karneid,61,,22,14,36
023 Karneid,62,,10,14,24
023 Karneid,63,,15,26,41
023 Karneid,64,,9,15,24
023 Karneid,65,,12,22,34
023 Karneid,66,,12,14,26
023 Karneid,67,,11,14,25
023 Karneid,68,,19,15,34
023 Karneid,69,,16,25,41
023 Karneid,70,,18,14,32
023 Karneid,71,,10,14,24
023 Karneid,72,,16,14,30
023 Karneid,73,,18,12,30
023 Karneid,74,,8,8,16
023 Karneid,75,,13,11,24
023 Karneid,76,,9,9,18
023 Karneid,77,,9,15,24
023 Karneid,78,,6,13,19
023 Karneid,79,,12,5,17
023 Karneid,80,,12,11,23
023 Karneid,81,,6,8,14
023 Karneid,82,,7,8,15
023 Karneid,83,,7,7,14
023 Karneid,84,,2,7,9
023 Karneid,85,,5,6,11
023 Karneid,86,,1,5,6
023 Karneid,87,,3,4,7
023 Karneid,88,,1,1,2
023 Karneid,89,,-,4,4
023 Karneid,90,,-,4,4
023 Karneid,91,,1,3,4
023 Karneid,92,,2,1,3
023 Karneid,93,,-,1,1
023 Karneid,99,,-,2,2
024 Kurtatsch a.d.Weinstr.,0,,8,9,17
024 Kurtatsch a.d.Weinstr.,1,,6,10,16
024 Kurtatsch a.d.Weinstr.,2,,10,11,21
024 Kurtatsch a.d.Weinstr.,3,,15,7,22
024 Kurtatsch a.d.Weinstr.,4,,6,4,10
024 Kurtatsch a.d.Weinstr.,5,,8,16,24
024 Kurtatsch a.d.Weinstr.,6,,13,16,29
024 Kurtatsch a.d.Weinstr.,7,,11,11,22
024 Kurtatsch a.d.Weinstr.,8,,12,12,24
024 Kurtatsch a.d.Weinstr.,9,,12,17,29
024 Kurtatsch a.d.Weinstr.,10,,17,12,29
024 Kurtatsch a.d.Weinstr.,11,,18,14,32
024 Kurtatsch a.d.Weinstr.,12,,18,12,30
024 Kurtatsch a.d.Weinstr.,13,,17,14,31
024 Kurtatsch a.d.Weinstr.,14,,13,15,28
024 Kurtatsch a.d.Weinstr.,15,,24,19,43
024 Kurtatsch a.d.Weinstr.,16,,19,11,30
024 Kurtatsch a.d.Weinstr.,17,,14,6,20
024 Kurtatsch a.d.Weinstr.,18,,24,18,42
024 Kurtatsch a.d.Weinstr.,19,,20,11,31
024 Kurtatsch a.d.Weinstr.,20,,17,16,33
024 Kurtatsch a.d.Weinstr.,21,,12,8,20
024 Kurtatsch a.d.Weinstr.,22,,9,16,25
024 Kurtatsch a.d.Weinstr.,23,,7,14,21
024 Kurtatsch a.d.Weinstr.,24,,11,13,24
024 Kurtatsch a.d.Weinstr.,25,,9,14,23
024 Kurtatsch a.d.Weinstr.,26,,14,12,26
024 Kurtatsch a.d.Weinstr.,27,,13,9,22
024 Kurtatsch a.d.Weinstr.,28,,15,6,21
024 Kurtatsch a.d.Weinstr.,29,,11,18,29
024 Kurtatsch a.d.Weinstr.,30,,13,11,24
024 Kurtatsch a.d.Weinstr.,31,,12,11,23
024 Kurtatsch a.d.Weinstr.,32,,9,13,22
024 Kurtatsch a.d.Weinstr.,33,,10,10,20
024 Kurtatsch a.d.Weinstr.,34,,8,17,25
024 Kurtatsch a.d.Weinstr.,35,,11,13,24
024 Kurtatsch a.d.Weinstr.,36,,11,13,24
024 Kurtatsch a.d.Weinstr.,37,,16,19,35
024 Kurtatsch a.d.Weinstr.,38,,19,19,38
024 Kurtatsch a.d.Weinstr.,39,,13,15,28
024 Kurtatsch a.d.Weinstr.,40,,18,20,38
024 Kurtatsch a.d.Weinstr.,41,,15,23,38
024 Kurtatsch a.d.Weinstr.,42,,26,25,51
024 Kurtatsch a.d.Weinstr.,43,,28,14,42
024 Kurtatsch a.d.Weinstr.,44,,18,19,37
024 Kurtatsch a.d.Weinstr.,45,,29,16,45
024 Kurtatsch a.d.Weinstr.,46,,25,26,51
024 Kurtatsch a.d.Weinstr.,47,,16,25,41
024 Kurtatsch a.d.Weinstr.,48,,22,20,42
024 Kurtatsch a.d.Weinstr.,49,,24,13,37
024 Kurtatsch a.d.Weinstr.,50,,19,15,34
024 Kurtatsch a.d.Weinstr.,51,,18,22,40
024 Kurtatsch a.d.Weinstr.,52,,19,9,28
024 Kurtatsch a.d.Weinstr.,53,,14,16,30
024 Kurtatsch a.d.Weinstr.,54,,12,11,23
024 Kurtatsch a.d.Weinstr.,55,,12,8,20
024 Kurtatsch a.d.Weinstr.,56,,13,20,33
024 Kurtatsch a.d.Weinstr.,57,,14,7,21
024 Kurtatsch a.d.Weinstr.,58,,17,20,37
024 Kurtatsch a.d.Weinstr.,59,,11,8,19
024 Kurtatsch a.d.Weinstr.,60,,8,14,22
024 Kurtatsch a.d.Weinstr.,61,,14,4,18
024 Kurtatsch a.d.Weinstr.,62,,11,9,20
024 Kurtatsch a.d.Weinstr.,63,,10,9,19
024 Kurtatsch a.d.Weinstr.,64,,10,8,18
024 Kurtatsch a.d.Weinstr.,65,,12,8,20
024 Kurtatsch a.d.Weinstr.,66,,7,8,15
024 Kurtatsch a.d.Weinstr.,67,,5,8,13
024 Kurtatsch a.d.Weinstr.,68,,9,6,15
024 Kurtatsch a.d.Weinstr.,69,,10,11,21
024 Kurtatsch a.d.Weinstr.,70,,8,12,20
024 Kurtatsch a.d.Weinstr.,71,,11,11,22
024 Kurtatsch a.d.Weinstr.,72,,3,16,19
024 Kurtatsch a.d.Weinstr.,73,,10,12,22
024 Kurtatsch a.d.Weinstr.,74,,4,9,13
024 Kurtatsch a.d.Weinstr.,75,,8,8,16
024 Kurtatsch a.d.Weinstr.,76,,3,7,10
024 Kurtatsch a.d.Weinstr.,77,,3,9,12
024 Kurtatsch a.d.Weinstr.,78,,7,7,14
024 Kurtatsch a.d.Weinstr.,79,,10,14,24
024 Kurtatsch a.d.Weinstr.,80,,6,9,15
024 Kurtatsch a.d.Weinstr.,81,,7,15,22
024 Kurtatsch a.d.Weinstr.,82,,6,6,12
024 Kurtatsch a.d.Weinstr.,83,,7,8,15
024 Kurtatsch a.d.Weinstr.,84,,6,4,10
024 Kurtatsch a.d.Weinstr.,85,,2,3,5
024 Kurtatsch a.d.Weinstr.,86,,4,7,11
024 Kurtatsch a.d.Weinstr.,87,,2,6,8
024 Kurtatsch a.d.Weinstr.,88,,4,13,17
024 Kurtatsch a.d.Weinstr.,89,,-,2,2
024 Kurtatsch a.d.Weinstr.,90,,-,6,6
024 Kurtatsch a.d.Weinstr.,91,,3,4,7
024 Kurtatsch a.d.Weinstr.,94,,-,1,1
024 Kurtatsch a.d.Weinstr.,96,,1,-,1
024 Kurtatsch a.d.Weinstr.,99,,1,-,1
024 Kurtatsch a.d.Weinstr.,100,,-,1,1
025 Kurtinig a.d. Weinstr.,0,,4,4,8
025 Kurtinig a.d. Weinstr.,1,,5,4,9
025 Kurtinig a.d. Weinstr.,2,,5,2,7
025 Kurtinig a.d. Weinstr.,3,,5,-,5
025 Kurtinig a.d. Weinstr.,4,,5,2,7
025 Kurtinig a.d. Weinstr.,5,,3,2,5
025 Kurtinig a.d. Weinstr.,6,,-,3,3
025 Kurtinig a.d. Weinstr.,7,,1,2,3
025 Kurtinig a.d. Weinstr.,8,,5,2,7
025 Kurtinig a.d. Weinstr.,9,,3,3,6
025 Kurtinig a.d. Weinstr.,10,,1,8,9
025 Kurtinig a.d. Weinstr.,11,,3,5,8
025 Kurtinig a.d. Weinstr.,12,,3,2,5
025 Kurtinig a.d. Weinstr.,13,,3,5,8
025 Kurtinig a.d. Weinstr.,14,,3,5,8
025 Kurtinig a.d. Weinstr.,15,,1,2,3
025 Kurtinig a.d. Weinstr.,16,,6,3,9
025 Kurtinig a.d. Weinstr.,17,,3,2,5
025 Kurtinig a.d. Weinstr.,18,,4,4,8
025 Kurtinig a.d. Weinstr.,19,,2,4,6
025 Kurtinig a.d. Weinstr.,20,,7,1,8
025 Kurtinig a.d. Weinstr.,21,,3,2,5
025 Kurtinig a.d. Weinstr.,22,,6,4,10
025 Kurtinig a.d. Weinstr.,23,,5,5,10
025 Kurtinig a.d. Weinstr.,24,,7,6,13
025 Kurtinig a.d. Weinstr.,25,,6,4,10
025 Kurtinig a.d. Weinstr.,26,,3,6,9
025 Kurtinig a.d. Weinstr.,27,,3,5,8
025 Kurtinig a.d. Weinstr.,28,,6,2,8
025 Kurtinig a.d. Weinstr.,29,,6,5,11
025 Kurtinig a.d. Weinstr.,30,,7,4,11
025 Kurtinig a.d. Weinstr.,31,,8,4,12
025 Kurtinig a.d. Weinstr.,32,,6,6,12
025 Kurtinig a.d. Weinstr.,33,,3,3,6
025 Kurtinig a.d. Weinstr.,34,,2,3,5
025 Kurtinig a.d. Weinstr.,35,,1,-,1
025 Kurtinig a.d. Weinstr.,36,,2,7,9
025 Kurtinig a.d. Weinstr.,37,,4,4,8
025 Kurtinig a.d. Weinstr.,38,,7,5,12
025 Kurtinig a.d. Weinstr.,39,,2,7,9
025 Kurtinig a.d. Weinstr.,40,,3,3,6
025 Kurtinig a.d. Weinstr.,41,,6,4,10
025 Kurtinig a.d. Weinstr.,42,,6,5,11
025 Kurtinig a.d. Weinstr.,43,,4,3,7
025 Kurtinig a.d. Weinstr.,44,,6,4,10
025 Kurtinig a.d. Weinstr.,45,,2,5,7
025 Kurtinig a.d. Weinstr.,46,,4,4,8
025 Kurtinig a.d. Weinstr.,47,,6,5,11
025 Kurtinig a.d. Weinstr.,48,,9,5,14
025 Kurtinig a.d. Weinstr.,49,,4,4,8
025 Kurtinig a.d. Weinstr.,50,,7,10,17
025 Kurtinig a.d. Weinstr.,51,,6,4,10
025 Kurtinig a.d. Weinstr.,52,,11,6,17
025 Kurtinig a.d. Weinstr.,53,,3,8,11
025 Kurtinig a.d. Weinstr.,54,,7,9,16
025 Kurtinig a.d. Weinstr.,55,,5,1,6
025 Kurtinig a.d. Weinstr.,56,,3,1,4
025 Kurtinig a.d. Weinstr.,57,,7,3,10
025 Kurtinig a.d. Weinstr.,58,,4,7,11
025 Kurtinig a.d. Weinstr.,59,,2,4,6
025 Kurtinig a.d. Weinstr.,60,,2,4,6
025 Kurtinig a.d. Weinstr.,61,,1,3,4
025 Kurtinig a.d. Weinstr.,62,,3,3,6
025 Kurtinig a.d. Weinstr.,63,,4,4,8
025 Kurtinig a.d. Weinstr.,64,,5,2,7
025 Kurtinig a.d. Weinstr.,65,,-,5,5
025 Kurtinig a.d. Weinstr.,66,,3,3,6
025 Kurtinig a.d. Weinstr.,67,,3,2,5
025 Kurtinig a.d. Weinstr.,68,,4,2,6
025 Kurtinig a.d. Weinstr.,69,,2,2,4
025 Kurtinig a.d. Weinstr.,70,,4,2,6
025 Kurtinig a.d. Weinstr.,71,,2,2,4
025 Kurtinig a.d. Weinstr.,72,,5,3,8
025 Kurtinig a.d. Weinstr.,73,,2,2,4
025 Kurtinig a.d. Weinstr.,74,,2,3,5
025 Kurtinig a.d. Weinstr.,75,,4,3,7
025 Kurtinig a.d. Weinstr.,76,,-,6,6
025 Kurtinig a.d. Weinstr.,77,,2,4,6
025 Kurtinig a.d. Weinstr.,78,,1,2,3
025 Kurtinig a.d. Weinstr.,79,,3,3,6
025 Kurtinig a.d. Weinstr.,80,,2,2,4
025 Kurtinig a.d. Weinstr.,81,,2,3,5
025 Kurtinig a.d. Weinstr.,82,,1,3,4
025 Kurtinig a.d. Weinstr.,83,,1,3,4
025 Kurtinig a.d. Weinstr.,84,,2,1,3
025 Kurtinig a.d. Weinstr.,85,,1,1,2
025 Kurtinig a.d. Weinstr.,86,,-,5,5
025 Kurtinig a.d. Weinstr.,87,,-,2,2
025 Kurtinig a.d. Weinstr.,88,,-,1,1
025 Kurtinig a.d. Weinstr.,90,,1,1,2
025 Kurtinig a.d. Weinstr.,93,,-,1,1
025 Kurtinig a.d. Weinstr.,96,,-,1,1
025 Kurtinig a.d. Weinstr.,97,,-,2,2
026 Corvara,0,,8,4,12
026 Corvara,1,,13,7,20
026 Corvara,2,,8,8,16
026 Corvara,3,,7,7,14
026 Corvara,4,,5,8,13
026 Corvara,5,,7,3,10
026 Corvara,6,,7,6,13
026 Corvara,7,,7,3,10
026 Corvara,8,,12,6,18
026 Corvara,9,,4,4,8
026 Corvara,10,,5,7,12
026 Corvara,11,,8,4,12
026 Corvara,12,,8,7,15
026 Corvara,13,,10,10,20
026 Corvara,14,,3,5,8
026 Corvara,15,,10,4,14
026 Corvara,16,,7,7,14
026 Corvara,17,,8,5,13
026 Corvara,18,,5,3,8
026 Corvara,19,,6,10,16
026 Corvara,20,,3,5,8
026 Corvara,21,,10,9,19
026 Corvara,22,,5,5,10
026 Corvara,23,,5,4,9
026 Corvara,24,,9,7,16
026 Corvara,25,,4,-,4
026 Corvara,26,,6,8,14
026 Corvara,27,,6,5,11
026 Corvara,28,,7,9,16
026 Corvara,29,,8,13,21
026 Corvara,30,,15,4,19
026 Corvara,31,,12,10,22
026 Corvara,32,,9,8,17
026 Corvara,33,,11,3,14
026 Corvara,34,,16,11,27
026 Corvara,35,,12,6,18
026 Corvara,36,,8,23,31
026 Corvara,37,,6,13,19
026 Corvara,38,,10,11,21
026 Corvara,39,,9,8,17
026 Corvara,40,,11,5,16
026 Corvara,41,,10,13,23
026 Corvara,42,,16,13,29
026 Corvara,43,,8,15,23
026 Corvara,44,,15,21,36
026 Corvara,45,,12,19,31
026 Corvara,46,,16,17,33
026 Corvara,47,,8,8,16
026 Corvara,48,,15,10,25
026 Corvara,49,,12,11,23
026 Corvara,50,,8,8,16
026 Corvara,51,,16,14,30
026 Corvara,52,,7,7,14
026 Corvara,53,,11,7,18
026 Corvara,54,,8,4,12
026 Corvara,55,,4,7,11
026 Corvara,56,,11,7,18
026 Corvara,57,,9,9,18
026 Corvara,58,,6,12,18
026 Corvara,59,,5,8,13
026 Corvara,60,,5,8,13
026 Corvara,61,,7,8,15
026 Corvara,62,,3,9,12
026 Corvara,63,,4,5,9
026 Corvara,64,,4,10,14
026 Corvara,65,,12,10,22
026 Corvara,66,,5,4,9
026 Corvara,67,,6,8,14
026 Corvara,68,,5,10,15
026 Corvara,69,,6,8,14
026 Corvara,70,,10,10,20
026 Corvara,71,,8,6,14
026 Corvara,72,,6,5,11
026 Corvara,73,,3,7,10
026 Corvara,74,,6,9,15
026 Corvara,75,,4,6,10
026 Corvara,76,,6,4,10
026 Corvara,77,,3,9,12
026 Corvara,78,,3,3,6
026 Corvara,79,,4,4,8
026 Corvara,80,,4,9,13
026 Corvara,81,,2,3,5
026 Corvara,82,,3,4,7
026 Corvara,83,,1,2,3
026 Corvara,84,,5,2,7
026 Corvara,85,,2,1,3
026 Corvara,86,,1,2,3
026 Corvara,87,,2,-,2
026 Corvara,88,,3,1,4
026 Corvara,89,,1,2,3
026 Corvara,90,,2,-,2
026 Corvara,91,,1,-,1
026 Corvara,92,,1,2,3
026 Corvara,93,,-,1,1
026 Corvara,97,,-,1,1
027 Graun im Vinschgau,0,,19,14,33
027 Graun im Vinschgau,1,,10,12,22
027 Graun im Vinschgau,2,,18,21,39
027 Graun im Vinschgau,3,,14,7,21
027 Graun im Vinschgau,4,,19,14,33
027 Graun im Vinschgau,5,,15,21,36
027 Graun im Vinschgau,6,,13,14,27
027 Graun im Vinschgau,7,,11,15,26
027 Graun im Vinschgau,8,,10,12,22
027 Graun im Vinschgau,9,,12,12,24
027 Graun im Vinschgau,10,,17,12,29
027 Graun im Vinschgau,11,,17,16,33
027 Graun im Vinschgau,12,,15,10,25
027 Graun im Vinschgau,13,,10,14,24
027 Graun im Vinschgau,14,,19,17,36
027 Graun im Vinschgau,15,,22,15,37
027 Graun im Vinschgau,16,,18,16,34
027 Graun im Vinschgau,17,,18,12,30
027 Graun im Vinschgau,18,,20,14,34
027 Graun im Vinschgau,19,,18,14,32
027 Graun im Vinschgau,20,,8,12,20
027 Graun im Vinschgau,21,,19,20,39
027 Graun im Vinschgau,22,,26,18,44
027 Graun im Vinschgau,23,,22,10,32
027 Graun im Vinschgau,24,,16,7,23
027 Graun im Vinschgau,25,,7,6,13
027 Graun im Vinschgau,26,,19,9,28
027 Graun im Vinschgau,27,,17,12,29
027 Graun im Vinschgau,28,,9,19,28
027 Graun im Vinschgau,29,,17,13,30
027 Graun im Vinschgau,30,,22,21,43
027 Graun im Vinschgau,31,,19,17,36
027 Graun im Vinschgau,32,,14,18,32
027 Graun im Vinschgau,33,,14,16,30
027 Graun im Vinschgau,34,,15,18,33
027 Graun im Vinschgau,35,,14,19,33
027 Graun im Vinschgau,36,,21,18,39
027 Graun im Vinschgau,37,,19,15,34
027 Graun im Vinschgau,38,,18,20,38
027 Graun im Vinschgau,39,,22,17,39
027 Graun im Vinschgau,40,,20,12,32
027 Graun im Vinschgau,41,,21,16,37
027 Graun im Vinschgau,42,,25,19,44
027 Graun im Vinschgau,43,,15,21,36
027 Graun im Vinschgau,44,,23,22,45
027 Graun im Vinschgau,45,,18,22,40
027 Graun im Vinschgau,46,,18,19,37
027 Graun im Vinschgau,47,,20,21,41
027 Graun im Vinschgau,48,,23,17,40
027 Graun im Vinschgau,49,,22,24,46
027 Graun im Vinschgau,50,,20,12,32
027 Graun im Vinschgau,51,,22,20,42
027 Graun im Vinschgau,52,,21,12,33
027 Graun im Vinschgau,53,,19,17,36
027 Graun im Vinschgau,54,,12,13,25
027 Graun im Vinschgau,55,,14,10,24
027 Graun im Vinschgau,56,,13,8,21
027 Graun im Vinschgau,57,,15,14,29
027 Graun im Vinschgau,58,,13,6,19
027 Graun im Vinschgau,59,,16,11,27
027 Graun im Vinschgau,60,,11,16,27
027 Graun im Vinschgau,61,,10,12,22
027 Graun im Vinschgau,62,,7,20,27
027 Graun im Vinschgau,63,,14,12,26
027 Graun im Vinschgau,64,,5,9,14
027 Graun im Vinschgau,65,,10,8,18
027 Graun im Vinschgau,66,,7,8,15
027 Graun im Vinschgau,67,,10,9,19
027 Graun im Vinschgau,68,,9,11,20
027 Graun im Vinschgau,69,,9,12,21
027 Graun im Vinschgau,70,,15,10,25
027 Graun im Vinschgau,71,,12,10,22
027 Graun im Vinschgau,72,,10,11,21
027 Graun im Vinschgau,73,,8,11,19
027 Graun im Vinschgau,74,,11,3,14
027 Graun im Vinschgau,75,,12,14,26
027 Graun im Vinschgau,76,,7,7,14
027 Graun im Vinschgau,77,,10,9,19
027 Graun im Vinschgau,78,,6,7,13
027 Graun im Vinschgau,79,,9,6,15
027 Graun im Vinschgau,80,,9,9,18
027 Graun im Vinschgau,81,,3,5,8
027 Graun im Vinschgau,82,,5,12,17
027 Graun im Vinschgau,83,,5,9,14
027 Graun im Vinschgau,84,,4,7,11
027 Graun im Vinschgau,85,,4,11,15
027 Graun im Vinschgau,86,,1,3,4
027 Graun im Vinschgau,87,,4,5,9
027 Graun im Vinschgau,88,,4,7,11
027 Graun im Vinschgau,89,,2,4,6
027 Graun im Vinschgau,90,,2,6,8
027 Graun im Vinschgau,91,,1,1,2
027 Graun im Vinschgau,92,,-,2,2
027 Graun im Vinschgau,93,,-,1,1
027 Graun im Vinschgau,97,,-,1,1
028 Toblach,0,,13,24,37
028 Toblach,1,,23,23,46
028 Toblach,2,,15,18,33
028 Toblach,3,,23,21,44
028 Toblach,4,,21,15,36
028 Toblach,5,,22,10,32
028 Toblach,6,,14,18,32
028 Toblach,7,,18,23,41
028 Toblach,8,,20,27,47
028 Toblach,9,,13,18,31
028 Toblach,10,,25,17,42
028 Toblach,11,,22,18,40
028 Toblach,12,,16,22,38
028 Toblach,13,,18,13,31
028 Toblach,14,,23,16,39
028 Toblach,15,,26,20,46
028 Toblach,16,,17,9,26
028 Toblach,17,,20,18,38
028 Toblach,18,,19,20,39
028 Toblach,19,,14,16,30
028 Toblach,20,,17,28,45
028 Toblach,21,,13,24,37
028 Toblach,22,,10,15,25
028 Toblach,23,,14,21,35
028 Toblach,24,,32,16,48
028 Toblach,25,,15,20,35
028 Toblach,26,,25,24,49
028 Toblach,27,,20,27,47
028 Toblach,28,,20,20,40
028 Toblach,29,,25,28,53
028 Toblach,30,,25,25,50
028 Toblach,31,,21,22,43
028 Toblach,32,,27,25,52
028 Toblach,33,,16,18,34
028 Toblach,34,,15,22,37
028 Toblach,35,,25,31,56
028 Toblach,36,,18,23,41
028 Toblach,37,,26,20,46
028 Toblach,38,,30,24,54
028 Toblach,39,,24,31,55
028 Toblach,40,,28,23,51
028 Toblach,41,,19,25,44
028 Toblach,42,,43,26,69
028 Toblach,43,,32,26,58
028 Toblach,44,,25,19,44
028 Toblach,45,,32,29,61
028 Toblach,46,,32,27,59
028 Toblach,47,,37,29,66
028 Toblach,48,,29,27,56
028 Toblach,49,,37,29,66
028 Toblach,50,,22,32,54
028 Toblach,51,,20,17,37
028 Toblach,52,,33,25,58
028 Toblach,53,,21,16,37
028 Toblach,54,,28,22,50
028 Toblach,55,,16,23,39
028 Toblach,56,,16,27,43
028 Toblach,57,,20,18,38
028 Toblach,58,,21,24,45
028 Toblach,59,,20,16,36
028 Toblach,60,,25,12,37
028 Toblach,61,,14,15,29
028 Toblach,62,,21,15,36
028 Toblach,63,,14,24,38
028 Toblach,64,,17,16,33
028 Toblach,65,,13,14,27
028 Toblach,66,,9,18,27
028 Toblach,67,,16,10,26
028 Toblach,68,,13,18,31
028 Toblach,69,,14,18,32
028 Toblach,70,,17,12,29
028 Toblach,71,,11,13,24
028 Toblach,72,,13,12,25
028 Toblach,73,,13,7,20
028 Toblach,74,,4,10,14
028 Toblach,75,,6,14,20
028 Toblach,76,,6,15,21
028 Toblach,77,,13,15,28
028 Toblach,78,,8,9,17
028 Toblach,79,,10,14,24
028 Toblach,80,,10,10,20
028 Toblach,81,,7,8,15
028 Toblach,82,,7,10,17
028 Toblach,83,,9,8,17
028 Toblach,84,,6,9,15
028 Toblach,85,,5,9,14
028 Toblach,86,,4,4,8
028 Toblach,87,,5,7,12
028 Toblach,88,,4,2,6
028 Toblach,89,,2,4,6
028 Toblach,90,,-,4,4
028 Toblach,91,,2,1,3
028 Toblach,92,,2,3,5
028 Toblach,94,,-,1,1
028 Toblach,96,,-,1,1
028 Toblach,98,,-,1,1
028 Toblach,104,,1,-,1
029 Neumarkt,0,,24,20,44
029 Neumarkt,1,,30,29,59
029 Neumarkt,2,,32,22,54
029 Neumarkt,3,,26,24,50
029 Neumarkt,4,,34,26,60
029 Neumarkt,5,,25,28,53
029 Neumarkt,6,,39,35,74
029 Neumarkt,7,,23,17,40
029 Neumarkt,8,,36,30,66
029 Neumarkt,9,,28,22,50
029 Neumarkt,10,,34,33,67
029 Neumarkt,11,,33,25,58
029 Neumarkt,12,,26,28,54
029 Neumarkt,13,,22,43,65
029 Neumarkt,14,,20,19,39
029 Neumarkt,15,,19,27,46
029 Neumarkt,16,,28,26,54
029 Neumarkt,17,,24,22,46
029 Neumarkt,18,,25,37,62
029 Neumarkt,19,,28,25,53
029 Neumarkt,20,,26,24,50
029 Neumarkt,21,,27,28,55
029 Neumarkt,22,,27,31,58
029 Neumarkt,23,,21,27,48
029 Neumarkt,24,,25,27,52
029 Neumarkt,25,,28,23,51
029 Neumarkt,26,,24,15,39
029 Neumarkt,27,,24,25,49
029 Neumarkt,28,,22,30,52
029 Neumarkt,29,,30,31,61
029 Neumarkt,30,,28,29,57
029 Neumarkt,31,,29,47,76
029 Neumarkt,32,,34,30,64
029 Neumarkt,33,,38,41,79
029 Neumarkt,34,,28,28,56
029 Neumarkt,35,,29,34,63
029 Neumarkt,36,,41,42,83
029 Neumarkt,37,,37,42,79
029 Neumarkt,38,,30,34,64
029 Neumarkt,39,,37,34,71
029 Neumarkt,40,,31,49,80
029 Neumarkt,41,,41,40,81
029 Neumarkt,42,,41,39,80
029 Neumarkt,43,,30,50,80
029 Neumarkt,44,,49,46,95
029 Neumarkt,45,,50,51,101
029 Neumarkt,46,,55,42,97
029 Neumarkt,47,,49,50,99
029 Neumarkt,48,,52,50,102
029 Neumarkt,49,,46,39,85
029 Neumarkt,50,,37,45,82
029 Neumarkt,51,,50,42,92
029 Neumarkt,52,,46,31,77
029 Neumarkt,53,,30,35,65
029 Neumarkt,54,,39,29,68
029 Neumarkt,55,,29,30,59
029 Neumarkt,56,,45,41,86
029 Neumarkt,57,,34,27,61
029 Neumarkt,58,,19,16,35
029 Neumarkt,59,,29,21,50
029 Neumarkt,60,,25,25,50
029 Neumarkt,61,,23,23,46
029 Neumarkt,62,,14,26,40
029 Neumarkt,63,,18,23,41
029 Neumarkt,64,,27,31,58
029 Neumarkt,65,,31,34,65
029 Neumarkt,66,,22,21,43
029 Neumarkt,67,,21,18,39
029 Neumarkt,68,,19,24,43
029 Neumarkt,69,,25,23,48
029 Neumarkt,70,,35,26,61
029 Neumarkt,71,,23,30,53
029 Neumarkt,72,,17,28,45
029 Neumarkt,73,,21,15,36
029 Neumarkt,74,,19,13,32
029 Neumarkt,75,,16,18,34
029 Neumarkt,76,,15,23,38
029 Neumarkt,77,,15,20,35
029 Neumarkt,78,,17,16,33
029 Neumarkt,79,,13,21,34
029 Neumarkt,80,,20,28,48
029 Neumarkt,81,,10,21,31
029 Neumarkt,82,,12,16,28
029 Neumarkt,83,,1,15,16
029 Neumarkt,84,,11,9,20
029 Neumarkt,85,,9,17,26
029 Neumarkt,86,,8,12,20
029 Neumarkt,87,,4,14,18
029 Neumarkt,88,,12,13,25
029 Neumarkt,89,,3,7,10
029 Neumarkt,90,,3,13,16
029 Neumarkt,91,,1,7,8
029 Neumarkt,92,,2,3,5
029 Neumarkt,94,,-,3,3
029 Neumarkt,96,,-,2,2
029 Neumarkt,97,,1,1,2
030 Pfalzen,0,,17,21,38
030 Pfalzen,1,,22,15,37
030 Pfalzen,2,,18,18,36
030 Pfalzen,3,,16,21,37
030 Pfalzen,4,,13,9,22
030 Pfalzen,5,,20,20,40
030 Pfalzen,6,,20,17,37
030 Pfalzen,7,,13,21,34
030 Pfalzen,8,,23,13,36
030 Pfalzen,9,,14,17,31
030 Pfalzen,10,,19,15,34
030 Pfalzen,11,,16,18,34
030 Pfalzen,12,,19,19,38
030 Pfalzen,13,,17,16,33
030 Pfalzen,14,,13,17,30
030 Pfalzen,15,,15,14,29
030 Pfalzen,16,,22,17,39
030 Pfalzen,17,,14,18,32
030 Pfalzen,18,,12,20,32
030 Pfalzen,19,,14,22,36
030 Pfalzen,20,,14,19,33
030 Pfalzen,21,,18,13,31
030 Pfalzen,22,,18,22,40
030 Pfalzen,23,,14,12,26
030 Pfalzen,24,,14,23,37
030 Pfalzen,25,,19,20,39
030 Pfalzen,26,,25,19,44
030 Pfalzen,27,,18,11,29
030 Pfalzen,28,,13,13,26
030 Pfalzen,29,,20,20,40
030 Pfalzen,30,,19,19,38
030 Pfalzen,31,,22,24,46
030 Pfalzen,32,,19,19,38
030 Pfalzen,33,,18,20,38
030 Pfalzen,34,,22,26,48
030 Pfalzen,35,,19,13,32
030 Pfalzen,36,,16,15,31
030 Pfalzen,37,,25,15,40
030 Pfalzen,38,,16,25,41
030 Pfalzen,39,,23,25,48
030 Pfalzen,40,,30,28,58
030 Pfalzen,41,,23,24,47
030 Pfalzen,42,,27,14,41
030 Pfalzen,43,,23,34,57
030 Pfalzen,44,,20,22,42
030 Pfalzen,45,,25,23,48
030 Pfalzen,46,,24,28,52
030 Pfalzen,47,,19,23,42
030 Pfalzen,48,,30,21,51
030 Pfalzen,49,,21,31,52
030 Pfalzen,50,,26,20,46
030 Pfalzen,51,,23,15,38
030 Pfalzen,52,,16,14,30
030 Pfalzen,53,,15,21,36
030 Pfalzen,54,,25,18,43
030 Pfalzen,55,,16,14,30
030 Pfalzen,56,,17,13,30
030 Pfalzen,57,,14,11,25
030 Pfalzen,58,,13,11,24
030 Pfalzen,59,,10,10,20
030 Pfalzen,60,,15,17,32
030 Pfalzen,61,,10,11,21
030 Pfalzen,62,,16,6,22
030 Pfalzen,63,,9,11,20
030 Pfalzen,64,,12,3,15
030 Pfalzen,65,,8,10,18
030 Pfalzen,66,,6,9,15
030 Pfalzen,67,,10,6,16
030 Pfalzen,68,,8,10,18
030 Pfalzen,69,,7,12,19
030 Pfalzen,70,,12,8,20
030 Pfalzen,71,,13,9,22
030 Pfalzen,72,,8,5,13
030 Pfalzen,73,,11,10,21
030 Pfalzen,74,,5,5,10
030 Pfalzen,75,,2,8,10
030 Pfalzen,76,,6,7,13
030 Pfalzen,77,,8,11,19
030 Pfalzen,78,,5,8,13
030 Pfalzen,79,,6,4,10
030 Pfalzen,80,,9,7,16
030 Pfalzen,81,,7,7,14
030 Pfalzen,82,,8,4,12
030 Pfalzen,83,,2,4,6
030 Pfalzen,84,,4,5,9
030 Pfalzen,85,,3,2,5
030 Pfalzen,86,,3,2,5
030 Pfalzen,87,,2,6,8
030 Pfalzen,88,,3,2,5
030 Pfalzen,89,,2,-,2
030 Pfalzen,90,,-,4,4
030 Pfalzen,91,,-,3,3
030 Pfalzen,92,,-,1,1
030 Pfalzen,95,,-,1,1
030 Pfalzen,97,,1,-,1
030 Pfalzen,98,,1,-,1
031 Völs am Schlern,0,,14,20,34
031 Völs am Schlern,1,,28,18,46
031 Völs am Schlern,2,,21,17,38
031 Völs am Schlern,3,,21,32,53
031 Völs am Schlern,4,,19,23,42
031 Völs am Schlern,5,,22,25,47
031 Völs am Schlern,6,,36,15,51
031 Völs am Schlern,7,,21,12,33
031 Völs am Schlern,8,,15,22,37
031 Völs am Schlern,9,,16,30,46
031 Völs am Schlern,10,,18,26,44
031 Völs am Schlern,11,,24,28,52
031 Völs am Schlern,12,,18,20,38
031 Völs am Schlern,13,,24,30,54
031 Völs am Schlern,14,,18,26,44
031 Völs am Schlern,15,,15,20,35
031 Völs am Schlern,16,,24,23,47
031 Völs am Schlern,17,,21,11,32
031 Völs am Schlern,18,,16,15,31
031 Völs am Schlern,19,,20,18,38
031 Völs am Schlern,20,,12,21,33
031 Völs am Schlern,21,,22,17,39
031 Völs am Schlern,22,,20,13,33
031 Völs am Schlern,23,,17,18,35
031 Völs am Schlern,24,,19,21,40
031 Völs am Schlern,25,,21,21,42
031 Völs am Schlern,26,,16,20,36
031 Völs am Schlern,27,,21,7,28
031 Völs am Schlern,28,,14,28,42
031 Völs am Schlern,29,,23,28,51
031 Völs am Schlern,30,,30,20,50
031 Völs am Schlern,31,,30,15,45
031 Völs am Schlern,32,,28,29,57
031 Völs am Schlern,33,,30,29,59
031 Völs am Schlern,34,,26,24,50
031 Völs am Schlern,35,,33,21,54
031 Völs am Schlern,36,,27,19,46
031 Völs am Schlern,37,,24,25,49
031 Völs am Schlern,38,,27,34,61
031 Völs am Schlern,39,,39,28,67
031 Völs am Schlern,40,,39,43,82
031 Völs am Schlern,41,,30,40,70
031 Völs am Schlern,42,,38,30,68
031 Völs am Schlern,43,,39,36,75
031 Völs am Schlern,44,,26,27,53
031 Völs am Schlern,45,,36,34,70
031 Völs am Schlern,46,,29,31,60
031 Völs am Schlern,47,,30,24,54
031 Völs am Schlern,48,,27,22,49
031 Völs am Schlern,49,,28,20,48
031 Völs am Schlern,50,,26,22,48
031 Völs am Schlern,51,,21,17,38
031 Völs am Schlern,52,,24,12,36
031 Völs am Schlern,53,,21,15,36
031 Völs am Schlern,54,,18,18,36
031 Völs am Schlern,55,,16,20,36
031 Völs am Schlern,56,,16,15,31
031 Völs am Schlern,57,,16,25,41
031 Völs am Schlern,58,,16,26,42
031 Völs am Schlern,59,,18,19,37
031 Völs am Schlern,60,,19,20,39
031 Völs am Schlern,61,,20,18,38
031 Völs am Schlern,62,,15,9,24
031 Völs am Schlern,63,,17,14,31
031 Völs am Schlern,64,,14,21,35
031 Völs am Schlern,65,,16,12,28
031 Völs am Schlern,66,,8,14,22
031 Völs am Schlern,67,,14,9,23
031 Völs am Schlern,68,,15,21,36
031 Völs am Schlern,69,,15,17,32
031 Völs am Schlern,70,,17,19,36
031 Völs am Schlern,71,,11,22,33
031 Völs am Schlern,72,,12,11,23
031 Völs am Schlern,73,,11,15,26
031 Völs am Schlern,74,,9,9,18
031 Völs am Schlern,75,,8,18,26
031 Völs am Schlern,76,,14,12,26
031 Völs am Schlern,77,,12,7,19
031 Völs am Schlern,78,,5,14,19
031 Völs am Schlern,79,,15,9,24
031 Völs am Schlern,80,,9,13,22
031 Völs am Schlern,81,,3,11,14
031 Völs am Schlern,82,,3,10,13
031 Völs am Schlern,83,,4,11,15
031 Völs am Schlern,84,,4,10,14
031 Völs am Schlern,85,,4,5,9
031 Völs am Schlern,86,,6,9,15
031 Völs am Schlern,87,,7,8,15
031 Völs am Schlern,88,,2,3,5
031 Völs am Schlern,89,,1,3,4
031 Völs am Schlern,90,,-,7,7
031 Völs am Schlern,91,,1,3,4
031 Völs am Schlern,92,,-,2,2
031 Völs am Schlern,93,,1,3,4
031 Völs am Schlern,94,,1,2,3
031 Völs am Schlern,96,,1,1,2
032 Franzensfeste,0,,8,7,15
032 Franzensfeste,1,,8,6,14
032 Franzensfeste,2,,3,4,7
032 Franzensfeste,3,,4,7,11
032 Franzensfeste,4,,8,5,13
032 Franzensfeste,5,,4,4,8
032 Franzensfeste,6,,3,5,8
032 Franzensfeste,7,,8,4,12
032 Franzensfeste,8,,7,4,11
032 Franzensfeste,9,,11,1,12
032 Franzensfeste,10,,3,6,9
032 Franzensfeste,11,,3,5,8
032 Franzensfeste,12,,5,5,10
032 Franzensfeste,13,,7,6,13
032 Franzensfeste,14,,4,5,9
032 Franzensfeste,15,,7,4,11
032 Franzensfeste,16,,4,1,5
032 Franzensfeste,17,,6,6,12
032 Franzensfeste,18,,8,5,13
032 Franzensfeste,19,,7,5,12
032 Franzensfeste,20,,5,6,11
032 Franzensfeste,21,,1,9,10
032 Franzensfeste,22,,8,3,11
032 Franzensfeste,23,,3,4,7
032 Franzensfeste,24,,8,6,14
032 Franzensfeste,25,,8,4,12
032 Franzensfeste,26,,6,8,14
032 Franzensfeste,27,,4,10,14
032 Franzensfeste,28,,7,7,14
032 Franzensfeste,29,,3,9,12
032 Franzensfeste,30,,9,5,14
032 Franzensfeste,31,,7,11,18
032 Franzensfeste,32,,13,1,14
032 Franzensfeste,33,,8,7,15
032 Franzensfeste,34,,4,6,10
032 Franzensfeste,35,,3,5,8
032 Franzensfeste,36,,9,11,20
032 Franzensfeste,37,,11,7,18
032 Franzensfeste,38,,3,7,10
032 Franzensfeste,39,,7,10,17
032 Franzensfeste,40,,6,4,10
032 Franzensfeste,41,,8,6,14
032 Franzensfeste,42,,10,8,18
032 Franzensfeste,43,,8,11,19
032 Franzensfeste,44,,9,4,13
032 Franzensfeste,45,,10,5,15
032 Franzensfeste,46,,11,10,21
032 Franzensfeste,47,,14,8,22
032 Franzensfeste,48,,8,11,19
032 Franzensfeste,49,,12,4,16
032 Franzensfeste,50,,5,7,12
032 Franzensfeste,51,,3,10,13
032 Franzensfeste,52,,6,9,15
032 Franzensfeste,53,,10,3,13
032 Franzensfeste,54,,5,5,10
032 Franzensfeste,55,,5,7,12
032 Franzensfeste,56,,9,6,15
032 Franzensfeste,57,,7,7,14
032 Franzensfeste,58,,5,8,13
032 Franzensfeste,59,,5,4,9
032 Franzensfeste,60,,7,1,8
032 Franzensfeste,61,,12,3,15
032 Franzensfeste,62,,2,5,7
032 Franzensfeste,63,,4,3,7
032 Franzensfeste,64,,2,3,5
032 Franzensfeste,65,,8,5,13
032 Franzensfeste,66,,4,6,10
032 Franzensfeste,67,,4,8,12
032 Franzensfeste,68,,4,2,6
032 Franzensfeste,69,,4,1,5
032 Franzensfeste,70,,4,3,7
032 Franzensfeste,71,,3,4,7
032 Franzensfeste,72,,4,2,6
032 Franzensfeste,73,,1,3,4
032 Franzensfeste,74,,6,6,12
032 Franzensfeste,75,,1,1,2
032 Franzensfeste,76,,1,2,3
032 Franzensfeste,77,,3,3,6
032 Franzensfeste,78,,1,4,5
032 Franzensfeste,79,,3,4,7
032 Franzensfeste,80,,1,6,7
032 Franzensfeste,81,,6,3,9
032 Franzensfeste,82,,2,5,7
032 Franzensfeste,83,,1,4,5
032 Franzensfeste,84,,3,3,6
032 Franzensfeste,85,,-,6,6
032 Franzensfeste,86,,1,1,2
032 Franzensfeste,87,,3,4,7
032 Franzensfeste,88,,2,6,8
032 Franzensfeste,89,,2,2,4
032 Franzensfeste,90,,-,2,2
032 Franzensfeste,91,,-,1,1
032 Franzensfeste,93,,-,1,1
033 Villnöss,0,,8,22,30
033 Villnöss,1,,16,17,33
033 Villnöss,2,,19,14,33
033 Villnöss,3,,17,9,26
033 Villnöss,4,,15,15,30
033 Villnöss,5,,14,24,38
033 Villnöss,6,,19,22,41
033 Villnöss,7,,11,17,28
033 Villnöss,8,,17,14,31
033 Villnöss,9,,21,14,35
033 Villnöss,10,,15,23,38
033 Villnöss,11,,18,14,32
033 Villnöss,12,,16,30,46
033 Villnöss,13,,25,19,44
033 Villnöss,14,,18,23,41
033 Villnöss,15,,21,17,38
033 Villnöss,16,,17,13,30
033 Villnöss,17,,14,12,26
033 Villnöss,18,,16,11,27
033 Villnöss,19,,13,14,27
033 Villnöss,20,,21,17,38
033 Villnöss,21,,15,11,26
033 Villnöss,22,,14,9,23
033 Villnöss,23,,15,21,36
033 Villnöss,24,,18,21,39
033 Villnöss,25,,14,13,27
033 Villnöss,26,,15,18,33
033 Villnöss,27,,18,14,32
033 Villnöss,28,,16,14,30
033 Villnöss,29,,12,13,25
033 Villnöss,30,,13,18,31
033 Villnöss,31,,23,10,33
033 Villnöss,32,,8,11,19
033 Villnöss,33,,16,15,31
033 Villnöss,34,,13,13,26
033 Villnöss,35,,16,13,29
033 Villnöss,36,,21,17,38
033 Villnöss,37,,21,15,36
033 Villnöss,38,,13,19,32
033 Villnöss,39,,17,25,42
033 Villnöss,40,,25,26,51
033 Villnöss,41,,17,27,44
033 Villnöss,42,,28,22,50
033 Villnöss,43,,27,19,46
033 Villnöss,44,,17,20,37
033 Villnöss,45,,26,19,45
033 Villnöss,46,,28,22,50
033 Villnöss,47,,30,26,56
033 Villnöss,48,,30,21,51
033 Villnöss,49,,28,21,49
033 Villnöss,50,,21,14,35
033 Villnöss,51,,21,11,32
033 Villnöss,52,,11,10,21
033 Villnöss,53,,12,14,26
033 Villnöss,54,,13,12,25
033 Villnöss,55,,15,16,31
033 Villnöss,56,,12,3,15
033 Villnöss,57,,16,14,30
033 Villnöss,58,,13,16,29
033 Villnöss,59,,13,14,27
033 Villnöss,60,,11,9,20
033 Villnöss,61,,7,9,16
033 Villnöss,62,,7,14,21
033 Villnöss,63,,8,10,18
033 Villnöss,64,,13,11,24
033 Villnöss,65,,9,5,14
033 Villnöss,66,,8,4,12
033 Villnöss,67,,6,13,19
033 Villnöss,68,,11,9,20
033 Villnöss,69,,12,19,31
033 Villnöss,70,,11,9,20
033 Villnöss,71,,6,17,23
033 Villnöss,72,,12,13,25
033 Villnöss,73,,10,8,18
033 Villnöss,74,,8,15,23
033 Villnöss,75,,4,16,20
033 Villnöss,76,,2,8,10
033 Villnöss,77,,7,8,15
033 Villnöss,78,,9,10,19
033 Villnöss,79,,11,12,23
033 Villnöss,80,,8,11,19
033 Villnöss,81,,7,10,17
033 Villnöss,82,,7,9,16
033 Villnöss,83,,12,7,19
033 Villnöss,84,,5,8,13
033 Villnöss,85,,2,7,9
033 Villnöss,86,,4,6,10
033 Villnöss,87,,1,7,8
033 Villnöss,88,,4,10,14
033 Villnöss,89,,2,4,6
033 Villnöss,90,,1,3,4
033 Villnöss,91,,-,3,3
033 Villnöss,92,,1,1,2
033 Villnöss,94,,-,2,2
033 Villnöss,98,,-,1,1
034 Gais,0,,17,20,37
034 Gais,1,,28,14,42
034 Gais,2,,24,14,38
034 Gais,3,,13,17,30
034 Gais,4,,16,19,35
034 Gais,5,,23,16,39
034 Gais,6,,27,19,46
034 Gais,7,,14,27,41
034 Gais,8,,18,17,35
034 Gais,9,,20,22,42
034 Gais,10,,21,18,39
034 Gais,11,,21,16,37
034 Gais,12,,21,25,46
034 Gais,13,,25,21,46
034 Gais,14,,29,12,41
034 Gais,15,,8,16,24
034 Gais,16,,29,19,48
034 Gais,17,,25,26,51
034 Gais,18,,14,20,34
034 Gais,19,,21,28,49
034 Gais,20,,25,30,55
034 Gais,21,,13,19,32
034 Gais,22,,17,11,28
034 Gais,23,,14,17,31
034 Gais,24,,19,18,37
034 Gais,25,,18,24,42
034 Gais,26,,17,15,32
034 Gais,27,,25,18,43
034 Gais,28,,18,25,43
034 Gais,29,,21,17,38
034 Gais,30,,22,24,46
034 Gais,31,,26,27,53
034 Gais,32,,25,14,39
034 Gais,33,,19,21,40
034 Gais,34,,20,26,46
034 Gais,35,,23,24,47
034 Gais,36,,23,22,45
034 Gais,37,,33,30,63
034 Gais,38,,26,25,51
034 Gais,39,,32,41,73
034 Gais,40,,38,27,65
034 Gais,41,,28,25,53
034 Gais,42,,40,31,71
034 Gais,43,,24,22,46
034 Gais,44,,26,31,57
034 Gais,45,,33,21,54
034 Gais,46,,23,24,47
034 Gais,47,,30,32,62
034 Gais,48,,18,18,36
034 Gais,49,,29,20,49
034 Gais,50,,22,31,53
034 Gais,51,,17,11,28
034 Gais,52,,17,21,38
034 Gais,53,,25,18,43
034 Gais,54,,13,15,28
034 Gais,55,,22,21,43
034 Gais,56,,20,10,30
034 Gais,57,,16,13,29
034 Gais,58,,13,12,25
034 Gais,59,,14,17,31
034 Gais,60,,14,20,34
034 Gais,61,,22,22,44
034 Gais,62,,15,11,26
034 Gais,63,,22,13,35
034 Gais,64,,19,11,30
034 Gais,65,,17,15,32
034 Gais,66,,13,8,21
034 Gais,67,,13,13,26
034 Gais,68,,11,16,27
034 Gais,69,,12,13,25
034 Gais,70,,18,12,30
034 Gais,71,,16,12,28
034 Gais,72,,11,14,25
034 Gais,73,,13,13,26
034 Gais,74,,16,16,32
034 Gais,75,,9,13,22
034 Gais,76,,11,12,23
034 Gais,77,,5,6,11
034 Gais,78,,5,10,15
034 Gais,79,,3,7,10
034 Gais,80,,8,6,14
034 Gais,81,,4,10,14
034 Gais,82,,1,3,4
034 Gais,83,,6,7,13
034 Gais,84,,6,7,13
034 Gais,85,,6,4,10
034 Gais,86,,2,3,5
034 Gais,87,,1,2,3
034 Gais,88,,2,5,7
034 Gais,89,,1,2,3
034 Gais,90,,-,2,2
034 Gais,91,,1,-,1
034 Gais,92,,-,1,1
034 Gais,93,,1,1,2
034 Gais,94,,1,-,1
034 Gais,96,,-,1,1
035 Gargazon,0,,8,8,16
035 Gargazon,1,,8,13,21
035 Gargazon,2,,7,9,16
035 Gargazon,3,,15,8,23
035 Gargazon,4,,7,6,13
035 Gargazon,5,,9,14,23
035 Gargazon,6,,8,7,15
035 Gargazon,7,,8,6,14
035 Gargazon,8,,7,15,22
035 Gargazon,9,,8,12,20
035 Gargazon,10,,4,8,12
035 Gargazon,11,,12,5,17
035 Gargazon,12,,14,9,23
035 Gargazon,13,,15,9,24
035 Gargazon,14,,5,14,19
035 Gargazon,15,,11,8,19
035 Gargazon,16,,12,4,16
035 Gargazon,17,,4,7,11
035 Gargazon,18,,9,7,16
035 Gargazon,19,,14,10,24
035 Gargazon,20,,17,11,28
035 Gargazon,21,,8,15,23
035 Gargazon,22,,10,5,15
035 Gargazon,23,,9,3,12
035 Gargazon,24,,8,7,15
035 Gargazon,25,,5,13,18
035 Gargazon,26,,13,8,21
035 Gargazon,27,,10,6,16
035 Gargazon,28,,7,13,20
035 Gargazon,29,,7,6,13
035 Gargazon,30,,11,11,22
035 Gargazon,31,,13,15,28
035 Gargazon,32,,6,6,12
035 Gargazon,33,,5,16,21
035 Gargazon,34,,11,11,22
035 Gargazon,35,,5,13,18
035 Gargazon,36,,10,10,20
035 Gargazon,37,,15,18,33
035 Gargazon,38,,15,11,26
035 Gargazon,39,,14,18,32
035 Gargazon,40,,17,17,34
035 Gargazon,41,,16,14,30
035 Gargazon,42,,22,17,39
035 Gargazon,43,,18,18,36
035 Gargazon,44,,13,14,27
035 Gargazon,45,,13,17,30
035 Gargazon,46,,15,8,23
035 Gargazon,47,,17,17,34
035 Gargazon,48,,19,21,40
035 Gargazon,49,,14,13,27
035 Gargazon,50,,11,15,26
035 Gargazon,51,,10,11,21
035 Gargazon,52,,19,13,32
035 Gargazon,53,,7,10,17
035 Gargazon,54,,15,12,27
035 Gargazon,55,,14,6,20
035 Gargazon,56,,10,4,14
035 Gargazon,57,,10,12,22
035 Gargazon,58,,16,11,27
035 Gargazon,59,,4,9,13
035 Gargazon,60,,10,8,18
035 Gargazon,61,,8,7,15
035 Gargazon,62,,6,9,15
035 Gargazon,63,,7,9,16
035 Gargazon,64,,5,6,11
035 Gargazon,65,,10,14,24
035 Gargazon,66,,9,6,15
035 Gargazon,67,,2,4,6
035 Gargazon,68,,6,9,15
035 Gargazon,69,,5,9,14
035 Gargazon,70,,9,8,17
035 Gargazon,71,,5,16,21
035 Gargazon,72,,8,6,14
035 Gargazon,73,,8,8,16
035 Gargazon,74,,7,12,19
035 Gargazon,75,,3,3,6
035 Gargazon,76,,12,2,14
035 Gargazon,77,,5,6,11
035 Gargazon,78,,1,10,11
035 Gargazon,79,,5,2,7
035 Gargazon,80,,3,7,10
035 Gargazon,81,,3,4,7
035 Gargazon,82,,2,4,6
035 Gargazon,83,,2,2,4
035 Gargazon,84,,2,5,7
035 Gargazon,85,,3,2,5
035 Gargazon,86,,1,3,4
035 Gargazon,87,,-,3,3
035 Gargazon,88,,3,4,7
035 Gargazon,89,,1,5,6
035 Gargazon,90,,1,2,3
035 Gargazon,95,,-,1,1
035 Gargazon,96,,-,2,2
035 Gargazon,97,,1,-,1
035 Gargazon,98,,-,2,2
036 Glurns,0,,4,6,10
036 Glurns,1,,3,4,7
036 Glurns,2,,2,4,6
036 Glurns,3,,9,2,11
036 Glurns,4,,5,3,8
036 Glurns,5,,4,9,13
036 Glurns,6,,6,5,11
036 Glurns,7,,4,5,9
036 Glurns,8,,6,6,12
036 Glurns,9,,4,4,8
036 Glurns,10,,5,1,6
036 Glurns,11,,4,3,7
036 Glurns,12,,3,2,5
036 Glurns,13,,10,3,13
036 Glurns,14,,4,7,11
036 Glurns,15,,7,4,11
036 Glurns,16,,7,4,11
036 Glurns,17,,2,3,5
036 Glurns,18,,7,7,14
036 Glurns,19,,5,8,13
036 Glurns,20,,8,2,10
036 Glurns,21,,8,5,13
036 Glurns,22,,4,3,7
036 Glurns,23,,6,7,13
036 Glurns,24,,4,5,9
036 Glurns,25,,5,7,12
036 Glurns,26,,3,2,5
036 Glurns,27,,7,5,12
036 Glurns,28,,10,7,17
036 Glurns,29,,11,8,19
036 Glurns,30,,6,2,8
036 Glurns,31,,12,4,16
036 Glurns,32,,3,8,11
036 Glurns,33,,6,6,12
036 Glurns,34,,2,3,5
036 Glurns,35,,12,5,17
036 Glurns,36,,7,11,18
036 Glurns,37,,8,11,19
036 Glurns,38,,4,3,7
036 Glurns,39,,5,8,13
036 Glurns,40,,6,5,11
036 Glurns,41,,5,1,6
036 Glurns,42,,2,6,8
036 Glurns,43,,7,4,11
036 Glurns,44,,4,9,13
036 Glurns,45,,6,8,14
036 Glurns,46,,2,6,8
036 Glurns,47,,10,5,15
036 Glurns,48,,5,9,14
036 Glurns,49,,5,5,10
036 Glurns,50,,6,6,12
036 Glurns,51,,7,9,16
036 Glurns,52,,12,6,18
036 Glurns,53,,4,9,13
036 Glurns,54,,6,12,18
036 Glurns,55,,6,6,12
036 Glurns,56,,8,7,15
036 Glurns,57,,12,4,16
036 Glurns,58,,8,10,18
036 Glurns,59,,4,8,12
036 Glurns,60,,8,10,18
036 Glurns,61,,6,5,11
036 Glurns,62,,6,3,9
036 Glurns,63,,7,5,12
036 Glurns,64,,10,7,17
036 Glurns,65,,8,2,10
036 Glurns,66,,6,1,7
036 Glurns,67,,5,4,9
036 Glurns,68,,1,4,5
036 Glurns,69,,4,6,10
036 Glurns,70,,3,2,5
036 Glurns,71,,6,1,7
036 Glurns,72,,1,3,4
036 Glurns,73,,4,3,7
036 Glurns,74,,4,4,8
036 Glurns,75,,-,2,2
036 Glurns,76,,2,4,6
036 Glurns,77,,1,5,6
036 Glurns,78,,1,1,2
036 Glurns,79,,5,2,7
036 Glurns,80,,4,1,5
036 Glurns,81,,1,2,3
036 Glurns,82,,2,6,8
036 Glurns,83,,-,1,1
036 Glurns,84,,-,2,2
036 Glurns,85,,-,1,1
036 Glurns,86,,1,5,6
036 Glurns,87,,-,2,2
036 Glurns,88,,-,1,1
036 Glurns,90,,2,-,2
036 Glurns,94,,-,1,1
036 Glurns,96,,-,1,1
037 Latsch,0,,26,18,44
037 Latsch,1,,22,19,41
037 Latsch,2,,20,31,51
037 Latsch,3,,19,22,41
037 Latsch,4,,30,30,60
037 Latsch,5,,30,23,53
037 Latsch,6,,20,28,48
037 Latsch,7,,31,24,55
037 Latsch,8,,25,22,47
037 Latsch,9,,27,27,54
037 Latsch,10,,37,19,56
037 Latsch,11,,36,33,69
037 Latsch,12,,32,19,51
037 Latsch,13,,26,23,49
037 Latsch,14,,36,39,75
037 Latsch,15,,39,33,72
037 Latsch,16,,47,33,80
037 Latsch,17,,41,22,63
037 Latsch,18,,32,37,69
037 Latsch,19,,34,37,71
037 Latsch,20,,31,38,69
037 Latsch,21,,37,49,86
037 Latsch,22,,35,34,69
037 Latsch,23,,40,37,77
037 Latsch,24,,31,35,66
037 Latsch,25,,41,32,73
037 Latsch,26,,32,38,70
037 Latsch,27,,39,31,70
037 Latsch,28,,24,33,57
037 Latsch,29,,34,40,74
037 Latsch,30,,31,43,74
037 Latsch,31,,33,38,71
037 Latsch,32,,37,35,72
037 Latsch,33,,35,22,57
037 Latsch,34,,32,35,67
037 Latsch,35,,31,27,58
037 Latsch,36,,35,36,71
037 Latsch,37,,28,27,55
037 Latsch,38,,33,35,68
037 Latsch,39,,34,42,76
037 Latsch,40,,44,40,84
037 Latsch,41,,33,36,69
037 Latsch,42,,43,40,83
037 Latsch,43,,50,52,102
037 Latsch,44,,52,50,102
037 Latsch,45,,28,49,77
037 Latsch,46,,56,46,102
037 Latsch,47,,59,47,106
037 Latsch,48,,54,48,102
037 Latsch,49,,42,49,91
037 Latsch,50,,45,42,87
037 Latsch,51,,39,49,88
037 Latsch,52,,44,48,92
037 Latsch,53,,39,30,69
037 Latsch,54,,28,36,64
037 Latsch,55,,31,33,64
037 Latsch,56,,36,25,61
037 Latsch,57,,28,16,44
037 Latsch,58,,24,23,47
037 Latsch,59,,38,21,59
037 Latsch,60,,20,32,52
037 Latsch,61,,32,16,48
037 Latsch,62,,16,20,36
037 Latsch,63,,13,20,33
037 Latsch,64,,17,16,33
037 Latsch,65,,18,21,39
037 Latsch,66,,15,20,35
037 Latsch,67,,22,12,34
037 Latsch,68,,22,22,44
037 Latsch,69,,23,25,48
037 Latsch,70,,16,23,39
037 Latsch,71,,20,24,44
037 Latsch,72,,18,18,36
037 Latsch,73,,14,26,40
037 Latsch,74,,11,23,34
037 Latsch,75,,15,12,27
037 Latsch,76,,23,13,36
037 Latsch,77,,15,25,40
037 Latsch,78,,14,23,37
037 Latsch,79,,19,19,38
037 Latsch,80,,14,19,33
037 Latsch,81,,17,16,33
037 Latsch,82,,15,13,28
037 Latsch,83,,15,16,31
037 Latsch,84,,8,20,28
037 Latsch,85,,10,14,24
037 Latsch,86,,10,13,23
037 Latsch,87,,3,8,11
037 Latsch,88,,4,8,12
037 Latsch,89,,5,8,13
037 Latsch,90,,5,6,11
037 Latsch,91,,3,2,5
037 Latsch,92,,1,1,2
037 Latsch,93,,1,-,1
037 Latsch,94,,-,1,1
037 Latsch,95,,1,-,1
037 Latsch,96,,-,1,1
037 Latsch,97,,-,1,1
037 Latsch,98,,-,1,1
037 Latsch,100,,-,1,1
037 Latsch,102,,-,1,1
038 Algund,0,,23,15,38
038 Algund,1,,29,22,51
038 Algund,2,,20,34,54
038 Algund,3,,18,22,40
038 Algund,4,,23,22,45
038 Algund,5,,25,20,45
038 Algund,6,,24,25,49
038 Algund,7,,24,22,46
038 Algund,8,,31,26,57
038 Algund,9,,24,28,52
038 Algund,10,,34,25,59
038 Algund,11,,21,34,55
038 Algund,12,,42,27,69
038 Algund,13,,25,24,49
038 Algund,14,,26,21,47
038 Algund,15,,20,24,44
038 Algund,16,,29,22,51
038 Algund,17,,28,25,53
038 Algund,18,,27,19,46
038 Algund,19,,34,22,56
038 Algund,20,,28,20,48
038 Algund,21,,33,22,55
038 Algund,22,,23,32,55
038 Algund,23,,24,28,52
038 Algund,24,,28,29,57
038 Algund,25,,28,34,62
038 Algund,26,,27,28,55
038 Algund,27,,26,25,51
038 Algund,28,,24,38,62
038 Algund,29,,27,25,52
038 Algund,30,,35,31,66
038 Algund,31,,33,38,71
038 Algund,32,,25,39,64
038 Algund,33,,30,32,62
038 Algund,34,,33,43,76
038 Algund,35,,31,35,66
038 Algund,36,,40,40,80
038 Algund,37,,31,40,71
038 Algund,38,,36,34,70
038 Algund,39,,45,41,86
038 Algund,40,,44,42,86
038 Algund,41,,49,43,92
038 Algund,42,,45,50,95
038 Algund,43,,44,34,78
038 Algund,44,,37,45,82
038 Algund,45,,40,39,79
038 Algund,46,,40,48,88
038 Algund,47,,56,25,81
038 Algund,48,,40,40,80
038 Algund,49,,39,44,83
038 Algund,50,,31,51,82
038 Algund,51,,39,43,82
038 Algund,52,,38,38,76
038 Algund,53,,45,31,76
038 Algund,54,,26,37,63
038 Algund,55,,35,28,63
038 Algund,56,,25,30,55
038 Algund,57,,38,24,62
038 Algund,58,,18,28,46
038 Algund,59,,28,26,54
038 Algund,60,,28,29,57
038 Algund,61,,24,28,52
038 Algund,62,,21,27,48
038 Algund,63,,27,21,48
038 Algund,64,,19,20,39
038 Algund,65,,29,30,59
038 Algund,66,,25,25,50
038 Algund,67,,22,28,50
038 Algund,68,,22,20,42
038 Algund,69,,16,33,49
038 Algund,70,,18,21,39
038 Algund,71,,17,23,40
038 Algund,72,,20,28,48
038 Algund,73,,17,21,38
038 Algund,74,,17,14,31
038 Algund,75,,14,25,39
038 Algund,76,,13,18,31
038 Algund,77,,21,24,45
038 Algund,78,,18,20,38
038 Algund,79,,13,19,32
038 Algund,80,,10,21,31
038 Algund,81,,10,20,30
038 Algund,82,,7,20,27
038 Algund,83,,7,14,21
038 Algund,84,,8,13,21
038 Algund,85,,11,11,22
038 Algund,86,,8,10,18
038 Algund,87,,4,11,15
038 Algund,88,,-,4,4
038 Algund,89,,2,13,15
038 Algund,90,,2,6,8
038 Algund,91,,4,3,7
038 Algund,92,,1,5,6
038 Algund,93,,-,2,2
038 Algund,94,,-,1,1
038 Algund,95,,1,1,2
038 Algund,96,,-,1,1
038 Algund,97,,-,1,1
038 Algund,99,,1,2,3
038 Algund,100,,-,1,1
038 Algund,101,,-,1,1
038 Algund,103,,-,1,1
039 Lajen,0,,20,15,35
039 Lajen,1,,18,21,39
039 Lajen,2,,18,6,24
039 Lajen,3,,18,18,36
039 Lajen,4,,17,21,38
039 Lajen,5,,13,21,34
039 Lajen,6,,17,14,31
039 Lajen,7,,17,24,41
039 Lajen,8,,21,23,44
039 Lajen,9,,22,9,31
039 Lajen,10,,21,22,43
039 Lajen,11,,27,16,43
039 Lajen,12,,17,16,33
039 Lajen,13,,18,16,34
039 Lajen,14,,15,23,38
039 Lajen,15,,15,11,26
039 Lajen,16,,9,12,21
039 Lajen,17,,13,14,27
039 Lajen,18,,14,13,27
039 Lajen,19,,15,9,24
039 Lajen,20,,20,18,38
039 Lajen,21,,8,10,18
039 Lajen,22,,18,15,33
039 Lajen,23,,12,13,25
039 Lajen,24,,13,9,22
039 Lajen,25,,17,18,35
039 Lajen,26,,20,12,32
039 Lajen,27,,12,14,26
039 Lajen,28,,10,24,34
039 Lajen,29,,20,19,39
039 Lajen,30,,11,21,32
039 Lajen,31,,20,18,38
039 Lajen,32,,22,21,43
039 Lajen,33,,22,27,49
039 Lajen,34,,22,16,38
039 Lajen,35,,29,20,49
039 Lajen,36,,21,24,45
039 Lajen,37,,36,17,53
039 Lajen,38,,21,23,44
039 Lajen,39,,21,26,47
039 Lajen,40,,16,23,39
039 Lajen,41,,18,28,46
039 Lajen,42,,35,25,60
039 Lajen,43,,23,22,45
039 Lajen,44,,24,25,49
039 Lajen,45,,22,14,36
039 Lajen,46,,26,20,46
039 Lajen,47,,24,20,44
039 Lajen,48,,17,14,31
039 Lajen,49,,32,20,52
039 Lajen,50,,10,18,28
039 Lajen,51,,13,8,21
039 Lajen,52,,19,25,44
039 Lajen,53,,22,13,35
039 Lajen,54,,14,12,26
039 Lajen,55,,10,13,23
039 Lajen,56,,13,12,25
039 Lajen,57,,5,14,19
039 Lajen,58,,10,7,17
039 Lajen,59,,8,10,18
039 Lajen,60,,9,11,20
039 Lajen,61,,14,11,25
039 Lajen,62,,4,14,18
039 Lajen,63,,9,15,24
039 Lajen,64,,15,8,23
039 Lajen,65,,13,14,27
039 Lajen,66,,9,12,21
039 Lajen,67,,13,8,21
039 Lajen,68,,12,13,25
039 Lajen,69,,16,13,29
039 Lajen,70,,17,16,33
039 Lajen,71,,16,9,25
039 Lajen,72,,14,9,23
039 Lajen,73,,6,16,22
039 Lajen,74,,7,10,17
039 Lajen,75,,6,7,13
039 Lajen,76,,6,6,12
039 Lajen,77,,6,6,12
039 Lajen,78,,5,11,16
039 Lajen,79,,10,3,13
039 Lajen,80,,2,7,9
039 Lajen,81,,6,5,11
039 Lajen,82,,4,6,10
039 Lajen,83,,7,7,14
039 Lajen,84,,6,8,14
039 Lajen,85,,5,6,11
039 Lajen,86,,1,6,7
039 Lajen,87,,1,7,8
039 Lajen,88,,1,6,7
039 Lajen,89,,1,4,5
039 Lajen,90,,1,2,3
039 Lajen,91,,-,3,3
039 Lajen,92,,-,2,2
039 Lajen,93,,-,1,1
039 Lajen,98,,1,-,1
039 Lajen,101,,-,1,1
040 Leifers,0,,104,86,190
040 Leifers,1,,103,95,198
040 Leifers,2,,93,89,182
040 Leifers,3,,109,95,204
040 Leifers,4,,91,92,183
040 Leifers,5,,89,88,177
040 Leifers,6,,97,75,172
040 Leifers,7,,90,75,165
040 Leifers,8,,104,89,193
040 Leifers,9,,90,91,181
040 Leifers,10,,87,81,168
040 Leifers,11,,97,93,190
040 Leifers,12,,93,90,183
040 Leifers,13,,80,112,192
040 Leifers,14,,112,79,191
040 Leifers,15,,107,88,195
040 Leifers,16,,100,94,194
040 Leifers,17,,97,96,193
040 Leifers,18,,89,78,167
040 Leifers,19,,90,88,178
040 Leifers,20,,95,84,179
040 Leifers,21,,87,92,179
040 Leifers,22,,72,90,162
040 Leifers,23,,85,92,177
040 Leifers,24,,93,81,174
040 Leifers,25,,91,102,193
040 Leifers,26,,99,83,182
040 Leifers,27,,106,83,189
040 Leifers,28,,116,116,232
040 Leifers,29,,125,99,224
040 Leifers,30,,103,94,197
040 Leifers,31,,84,109,193
040 Leifers,32,,103,123,226
040 Leifers,33,,128,99,227
040 Leifers,34,,131,137,268
040 Leifers,35,,130,118,248
040 Leifers,36,,155,148,303
040 Leifers,37,,156,155,311
040 Leifers,38,,154,153,307
040 Leifers,39,,156,151,307
040 Leifers,40,,141,139,280
040 Leifers,41,,174,143,317
040 Leifers,42,,171,135,306
040 Leifers,43,,152,174,326
040 Leifers,44,,148,129,277
040 Leifers,45,,148,145,293
040 Leifers,46,,155,131,286
040 Leifers,47,,161,159,320
040 Leifers,48,,148,134,282
040 Leifers,49,,145,133,278
040 Leifers,50,,139,141,280
040 Leifers,51,,145,123,268
040 Leifers,52,,124,109,233
040 Leifers,53,,95,113,208
040 Leifers,54,,101,117,218
040 Leifers,55,,137,130,267
040 Leifers,56,,108,124,232
040 Leifers,57,,87,112,199
040 Leifers,58,,103,121,224
040 Leifers,59,,105,97,202
040 Leifers,60,,93,93,186
040 Leifers,61,,101,91,192
040 Leifers,62,,88,97,185
040 Leifers,63,,106,102,208
040 Leifers,64,,92,99,191
040 Leifers,65,,106,148,254
040 Leifers,66,,74,79,153
040 Leifers,67,,85,88,173
040 Leifers,68,,88,93,181
040 Leifers,69,,85,92,177
040 Leifers,70,,83,81,164
040 Leifers,71,,89,82,171
040 Leifers,72,,87,93,180
040 Leifers,73,,78,74,152
040 Leifers,74,,51,71,122
040 Leifers,75,,48,62,110
040 Leifers,76,,48,64,112
040 Leifers,77,,52,58,110
040 Leifers,78,,36,58,94
040 Leifers,79,,53,69,122
040 Leifers,80,,37,57,94
040 Leifers,81,,33,52,85
040 Leifers,82,,28,42,70
040 Leifers,83,,29,31,60
040 Leifers,84,,18,41,59
040 Leifers,85,,13,38,51
040 Leifers,86,,16,38,54
040 Leifers,87,,11,30,41
040 Leifers,88,,10,31,41
040 Leifers,89,,11,26,37
040 Leifers,90,,7,16,23
040 Leifers,91,,4,10,14
040 Leifers,92,,3,18,21
040 Leifers,93,,1,3,4
040 Leifers,94,,1,4,5
040 Leifers,95,,-,5,5
040 Leifers,96,,-,7,7
040 Leifers,97,,-,3,3
040 Leifers,98,,1,5,6
040 Leifers,99,,1,4,5
040 Leifers,100,,-,1,1
040 Leifers,102,,-,1,1
041 Lana,0,,64,66,130
041 Lana,1,,59,62,121
041 Lana,2,,68,46,114
041 Lana,3,,68,60,128
041 Lana,4,,73,55,128
041 Lana,5,,68,55,123
041 Lana,6,,72,66,138
041 Lana,7,,77,55,132
041 Lana,8,,61,60,121
041 Lana,9,,56,56,112
041 Lana,10,,74,55,129
041 Lana,11,,71,69,140
041 Lana,12,,72,61,133
041 Lana,13,,62,59,121
041 Lana,14,,61,67,128
041 Lana,15,,76,81,157
041 Lana,16,,68,64,132
041 Lana,17,,69,77,146
041 Lana,18,,63,63,126
041 Lana,19,,63,59,122
041 Lana,20,,61,59,120
041 Lana,21,,54,70,124
041 Lana,22,,49,82,131
041 Lana,23,,64,58,122
041 Lana,24,,78,53,131
041 Lana,25,,61,60,121
041 Lana,26,,54,66,120
041 Lana,27,,62,68,130
041 Lana,28,,90,81,171
041 Lana,29,,81,73,154
041 Lana,30,,62,82,144
041 Lana,31,,70,72,142
041 Lana,32,,77,95,172
041 Lana,33,,87,85,172
041 Lana,34,,72,71,143
041 Lana,35,,75,94,169
041 Lana,36,,69,89,158
041 Lana,37,,101,83,184
041 Lana,38,,85,92,177
041 Lana,39,,115,95,210
041 Lana,40,,93,109,202
041 Lana,41,,97,109,206
041 Lana,42,,121,80,201
041 Lana,43,,88,105,193
041 Lana,44,,97,98,195
041 Lana,45,,97,113,210
041 Lana,46,,99,90,189
041 Lana,47,,107,106,213
041 Lana,48,,107,81,188
041 Lana,49,,87,78,165
041 Lana,50,,84,93,177
041 Lana,51,,79,80,159
041 Lana,52,,82,78,160
041 Lana,53,,77,89,166
041 Lana,54,,71,75,146
041 Lana,55,,58,63,121
041 Lana,56,,60,73,133
041 Lana,57,,60,65,125
041 Lana,58,,55,58,113
041 Lana,59,,51,61,112
041 Lana,60,,50,65,115
041 Lana,61,,50,55,105
041 Lana,62,,53,55,108
041 Lana,63,,54,67,121
041 Lana,64,,58,47,105
041 Lana,65,,61,61,122
041 Lana,66,,38,51,89
041 Lana,67,,47,63,110
041 Lana,68,,56,57,113
041 Lana,69,,48,70,118
041 Lana,70,,48,43,91
041 Lana,71,,43,47,90
041 Lana,72,,49,52,101
041 Lana,73,,39,57,96
041 Lana,74,,32,36,68
041 Lana,75,,36,48,84
041 Lana,76,,32,31,63
041 Lana,77,,31,41,72
041 Lana,78,,24,42,66
041 Lana,79,,23,27,50
041 Lana,80,,22,38,60
041 Lana,81,,19,35,54
041 Lana,82,,15,31,46
041 Lana,83,,22,22,44
041 Lana,84,,20,27,47
041 Lana,85,,16,27,43
041 Lana,86,,12,34,46
041 Lana,87,,4,15,19
041 Lana,88,,11,21,32
041 Lana,89,,12,19,31
041 Lana,90,,5,20,25
041 Lana,91,,6,17,23
041 Lana,92,,2,8,10
041 Lana,93,,2,5,7
041 Lana,94,,3,6,9
041 Lana,95,,1,1,2
041 Lana,96,,-,3,3
041 Lana,97,,2,2,4
041 Lana,98,,-,3,3
041 Lana,99,,-,1,1
041 Lana,100,,-,1,1
041 Lana,101,,-,2,2
042 Laas,0,,18,25,43
042 Laas,1,,35,28,63
042 Laas,2,,20,30,50
042 Laas,3,,22,25,47
042 Laas,4,,31,14,45
042 Laas,5,,19,30,49
042 Laas,6,,35,17,52
042 Laas,7,,23,21,44
042 Laas,8,,24,19,43
042 Laas,9,,29,16,45
042 Laas,10,,17,20,37
042 Laas,11,,25,23,48
042 Laas,12,,17,13,30
042 Laas,13,,26,31,57
042 Laas,14,,28,24,52
042 Laas,15,,30,34,64
042 Laas,16,,33,25,58
042 Laas,17,,23,27,50
042 Laas,18,,22,18,40
042 Laas,19,,18,25,43
042 Laas,20,,22,23,45
042 Laas,21,,20,23,43
042 Laas,22,,22,26,48
042 Laas,23,,21,20,41
042 Laas,24,,33,20,53
042 Laas,25,,32,16,48
042 Laas,26,,30,23,53
042 Laas,27,,28,33,61
042 Laas,28,,19,44,63
042 Laas,29,,32,30,62
042 Laas,30,,23,31,54
042 Laas,31,,22,26,48
042 Laas,32,,32,29,61
042 Laas,33,,23,31,54
042 Laas,34,,22,20,42
042 Laas,35,,30,26,56
042 Laas,36,,27,20,47
042 Laas,37,,44,31,75
042 Laas,38,,36,30,66
042 Laas,39,,27,23,50
042 Laas,40,,24,26,50
042 Laas,41,,39,24,63
042 Laas,42,,32,39,71
042 Laas,43,,36,30,66
042 Laas,44,,32,24,56
042 Laas,45,,33,24,57
042 Laas,46,,34,32,66
042 Laas,47,,28,31,59
042 Laas,48,,27,28,55
042 Laas,49,,35,27,62
042 Laas,50,,24,30,54
042 Laas,51,,40,25,65
042 Laas,52,,32,26,58
042 Laas,53,,27,25,52
042 Laas,54,,18,27,45
042 Laas,55,,23,18,41
042 Laas,56,,16,16,32
042 Laas,57,,15,25,40
042 Laas,58,,22,13,35
042 Laas,59,,29,25,54
042 Laas,60,,13,16,29
042 Laas,61,,20,24,44
042 Laas,62,,18,19,37
042 Laas,63,,17,21,38
042 Laas,64,,25,11,36
042 Laas,65,,13,16,29
042 Laas,66,,14,11,25
042 Laas,67,,12,15,27
042 Laas,68,,12,15,27
042 Laas,69,,16,19,35
042 Laas,70,,13,21,34
042 Laas,71,,17,21,38
042 Laas,72,,12,24,36
042 Laas,73,,18,11,29
042 Laas,74,,11,14,25
042 Laas,75,,18,10,28
042 Laas,76,,17,22,39
042 Laas,77,,9,18,27
042 Laas,78,,15,11,26
042 Laas,79,,11,13,24
042 Laas,80,,11,20,31
042 Laas,81,,11,12,23
042 Laas,82,,10,8,18
042 Laas,83,,11,11,22
042 Laas,84,,7,12,19
042 Laas,85,,11,9,20
042 Laas,86,,3,8,11
042 Laas,87,,3,16,19
042 Laas,88,,6,6,12
042 Laas,89,,3,7,10
042 Laas,90,,1,1,2
042 Laas,91,,2,5,7
042 Laas,92,,2,-,2
042 Laas,93,,1,-,1
042 Laas,95,,1,3,4
042 Laas,98,,-,2,2
042 Laas,99,,-,1,1
042 Laas,100,,-,1,1
043 Laurein,0,,3,-,3
043 Laurein,1,,2,1,3
043 Laurein,2,,2,3,5
043 Laurein,3,,2,1,3
043 Laurein,4,,1,-,1
043 Laurein,5,,7,-,7
043 Laurein,6,,3,4,7
043 Laurein,7,,3,1,4
043 Laurein,8,,2,3,5
043 Laurein,9,,2,3,5
043 Laurein,10,,7,1,8
043 Laurein,11,,3,7,10
043 Laurein,12,,2,1,3
043 Laurein,13,,4,3,7
043 Laurein,14,,3,5,8
043 Laurein,15,,1,2,3
043 Laurein,16,,2,2,4
043 Laurein,17,,2,4,6
043 Laurein,18,,1,5,6
043 Laurein,19,,1,1,2
043 Laurein,20,,1,1,2
043 Laurein,21,,4,-,4
043 Laurein,22,,3,2,5
043 Laurein,23,,1,-,1
043 Laurein,24,,2,3,5
043 Laurein,25,,4,2,6
043 Laurein,26,,2,2,4
043 Laurein,27,,1,1,2
043 Laurein,29,,1,1,2
043 Laurein,30,,3,-,3
043 Laurein,31,,2,-,2
043 Laurein,32,,1,-,1
043 Laurein,33,,3,5,8
043 Laurein,34,,1,2,3
043 Laurein,35,,5,1,6
043 Laurein,36,,-,3,3
043 Laurein,37,,1,1,2
043 Laurein,38,,5,2,7
043 Laurein,39,,1,2,3
043 Laurein,40,,5,5,10
043 Laurein,41,,4,3,7
043 Laurein,42,,6,3,9
043 Laurein,43,,-,2,2
043 Laurein,44,,4,6,10
043 Laurein,45,,5,3,8
043 Laurein,46,,5,1,6
043 Laurein,47,,4,2,6
043 Laurein,48,,-,2,2
043 Laurein,49,,1,2,3
043 Laurein,50,,5,3,8
043 Laurein,51,,1,-,1
043 Laurein,52,,4,4,8
043 Laurein,53,,2,2,4
043 Laurein,54,,7,-,7
043 Laurein,56,,2,-,2
043 Laurein,57,,3,1,4
043 Laurein,58,,2,1,3
043 Laurein,59,,2,-,2
043 Laurein,61,,1,1,2
043 Laurein,62,,2,2,4
043 Laurein,63,,2,-,2
043 Laurein,64,,2,3,5
043 Laurein,65,,-,1,1
043 Laurein,66,,-,1,1
043 Laurein,67,,-,1,1
043 Laurein,68,,1,-,1
043 Laurein,69,,1,-,1
043 Laurein,71,,2,2,4
043 Laurein,72,,1,2,3
043 Laurein,73,,1,1,2
043 Laurein,74,,2,1,3
043 Laurein,75,,1,2,3
043 Laurein,76,,-,3,3
043 Laurein,77,,1,5,6
043 Laurein,78,,1,1,2
043 Laurein,79,,2,2,4
043 Laurein,80,,-,3,3
043 Laurein,81,,-,4,4
043 Laurein,82,,2,-,2
043 Laurein,83,,5,-,5
043 Laurein,84,,3,1,4
043 Laurein,85,,1,-,1
043 Laurein,86,,-,1,1
043 Laurein,87,,-,1,1
043 Laurein,89,,-,1,1
043 Laurein,90,,-,1,1
043 Laurein,91,,1,1,2
043 Laurein,98,,-,1,1
044 Lüsen,0,,11,7,18
044 Lüsen,1,,12,9,21
044 Lüsen,2,,11,10,21
044 Lüsen,3,,9,8,17
044 Lüsen,4,,11,12,23
044 Lüsen,5,,10,14,24
044 Lüsen,6,,9,9,18
044 Lüsen,7,,10,11,21
044 Lüsen,8,,12,9,21
044 Lüsen,9,,9,9,18
044 Lüsen,10,,10,11,21
044 Lüsen,11,,14,11,25
044 Lüsen,12,,6,9,15
044 Lüsen,13,,11,11,22
044 Lüsen,14,,15,6,21
044 Lüsen,15,,8,12,20
044 Lüsen,16,,9,12,21
044 Lüsen,17,,13,13,26
044 Lüsen,18,,9,8,17
044 Lüsen,19,,11,9,20
044 Lüsen,20,,8,9,17
044 Lüsen,21,,6,11,17
044 Lüsen,22,,15,8,23
044 Lüsen,23,,9,10,19
044 Lüsen,24,,6,8,14
044 Lüsen,25,,11,10,21
044 Lüsen,26,,3,2,5
044 Lüsen,27,,9,16,25
044 Lüsen,28,,4,7,11
044 Lüsen,29,,10,11,21
044 Lüsen,30,,10,12,22
044 Lüsen,31,,13,9,22
044 Lüsen,32,,9,8,17
044 Lüsen,33,,17,18,35
044 Lüsen,34,,7,13,20
044 Lüsen,35,,11,11,22
044 Lüsen,36,,13,13,26
044 Lüsen,37,,14,14,28
044 Lüsen,38,,8,7,15
044 Lüsen,39,,8,10,18
044 Lüsen,40,,16,9,25
044 Lüsen,41,,18,13,31
044 Lüsen,42,,10,11,21
044 Lüsen,43,,13,15,28
044 Lüsen,44,,10,19,29
044 Lüsen,45,,17,13,30
044 Lüsen,46,,18,13,31
044 Lüsen,47,,12,8,20
044 Lüsen,48,,13,13,26
044 Lüsen,49,,7,10,17
044 Lüsen,50,,12,9,21
044 Lüsen,51,,8,12,20
044 Lüsen,52,,9,6,15
044 Lüsen,53,,11,11,22
044 Lüsen,54,,10,9,19
044 Lüsen,55,,8,10,18
044 Lüsen,56,,6,6,12
044 Lüsen,57,,11,6,17
044 Lüsen,58,,6,11,17
044 Lüsen,59,,9,4,13
044 Lüsen,60,,5,7,12
044 Lüsen,61,,7,8,15
044 Lüsen,62,,7,10,17
044 Lüsen,63,,7,1,8
044 Lüsen,64,,5,5,10
044 Lüsen,65,,9,6,15
044 Lüsen,66,,3,9,12
044 Lüsen,67,,5,3,8
044 Lüsen,68,,8,8,16
044 Lüsen,69,,2,6,8
044 Lüsen,70,,6,3,9
044 Lüsen,71,,4,10,14
044 Lüsen,72,,8,7,15
044 Lüsen,73,,6,5,11
044 Lüsen,74,,7,4,11
044 Lüsen,75,,4,9,13
044 Lüsen,76,,4,4,8
044 Lüsen,77,,3,4,7
044 Lüsen,78,,7,3,10
044 Lüsen,79,,2,10,12
044 Lüsen,80,,4,5,9
044 Lüsen,81,,-,5,5
044 Lüsen,82,,2,4,6
044 Lüsen,83,,2,5,7
044 Lüsen,84,,3,2,5
044 Lüsen,85,,2,4,6
044 Lüsen,86,,1,3,4
044 Lüsen,87,,1,2,3
044 Lüsen,88,,1,3,4
044 Lüsen,89,,1,2,3
044 Lüsen,90,,1,4,5
044 Lüsen,98,,-,1,1
045 Margreid a.d. Weinstr.,0,,3,8,11
045 Margreid a.d. Weinstr.,1,,4,8,12
045 Margreid a.d. Weinstr.,2,,7,6,13
045 Margreid a.d. Weinstr.,3,,11,9,20
045 Margreid a.d. Weinstr.,4,,6,5,11
045 Margreid a.d. Weinstr.,5,,8,4,12
045 Margreid a.d. Weinstr.,6,,7,9,16
045 Margreid a.d. Weinstr.,7,,10,8,18
045 Margreid a.d. Weinstr.,8,,4,4,8
045 Margreid a.d. Weinstr.,9,,10,8,18
045 Margreid a.d. Weinstr.,10,,12,9,21
045 Margreid a.d. Weinstr.,11,,7,7,14
045 Margreid a.d. Weinstr.,12,,7,9,16
045 Margreid a.d. Weinstr.,13,,2,11,13
045 Margreid a.d. Weinstr.,14,,10,13,23
045 Margreid a.d. Weinstr.,15,,4,2,6
045 Margreid a.d. Weinstr.,16,,2,6,8
045 Margreid a.d. Weinstr.,17,,7,7,14
045 Margreid a.d. Weinstr.,18,,5,13,18
045 Margreid a.d. Weinstr.,19,,1,3,4
045 Margreid a.d. Weinstr.,20,,5,6,11
045 Margreid a.d. Weinstr.,21,,6,9,15
045 Margreid a.d. Weinstr.,22,,8,7,15
045 Margreid a.d. Weinstr.,23,,8,8,16
045 Margreid a.d. Weinstr.,24,,9,6,15
045 Margreid a.d. Weinstr.,25,,7,11,18
045 Margreid a.d. Weinstr.,26,,13,1,14
045 Margreid a.d. Weinstr.,27,,8,10,18
045 Margreid a.d. Weinstr.,28,,7,9,16
045 Margreid a.d. Weinstr.,29,,12,13,25
045 Margreid a.d. Weinstr.,30,,17,11,28
045 Margreid a.d. Weinstr.,31,,3,7,10
045 Margreid a.d. Weinstr.,32,,12,5,17
045 Margreid a.d. Weinstr.,33,,9,9,18
045 Margreid a.d. Weinstr.,34,,9,11,20
045 Margreid a.d. Weinstr.,35,,13,17,30
045 Margreid a.d. Weinstr.,36,,9,8,17
045 Margreid a.d. Weinstr.,37,,11,6,17
045 Margreid a.d. Weinstr.,38,,9,10,19
045 Margreid a.d. Weinstr.,39,,5,5,10
045 Margreid a.d. Weinstr.,40,,11,13,24
045 Margreid a.d. Weinstr.,41,,9,13,22
045 Margreid a.d. Weinstr.,42,,9,10,19
045 Margreid a.d. Weinstr.,43,,21,17,38
045 Margreid a.d. Weinstr.,44,,12,18,30
045 Margreid a.d. Weinstr.,45,,20,8,28
045 Margreid a.d. Weinstr.,46,,12,4,16
045 Margreid a.d. Weinstr.,47,,5,5,10
045 Margreid a.d. Weinstr.,48,,9,11,20
045 Margreid a.d. Weinstr.,49,,8,16,24
045 Margreid a.d. Weinstr.,50,,14,14,28
045 Margreid a.d. Weinstr.,51,,15,11,26
045 Margreid a.d. Weinstr.,52,,8,13,21
045 Margreid a.d. Weinstr.,53,,7,7,14
045 Margreid a.d. Weinstr.,54,,9,7,16
045 Margreid a.d. Weinstr.,55,,14,6,20
045 Margreid a.d. Weinstr.,56,,9,8,17
045 Margreid a.d. Weinstr.,57,,5,4,9
045 Margreid a.d. Weinstr.,58,,8,8,16
045 Margreid a.d. Weinstr.,59,,5,9,14
045 Margreid a.d. Weinstr.,60,,5,8,13
045 Margreid a.d. Weinstr.,61,,7,6,13
045 Margreid a.d. Weinstr.,62,,7,3,10
045 Margreid a.d. Weinstr.,63,,5,9,14
045 Margreid a.d. Weinstr.,64,,6,6,12
045 Margreid a.d. Weinstr.,65,,2,3,5
045 Margreid a.d. Weinstr.,66,,6,7,13
045 Margreid a.d. Weinstr.,67,,3,6,9
045 Margreid a.d. Weinstr.,68,,6,3,9
045 Margreid a.d. Weinstr.,69,,10,4,14
045 Margreid a.d. Weinstr.,70,,7,5,12
045 Margreid a.d. Weinstr.,71,,5,4,9
045 Margreid a.d. Weinstr.,72,,3,7,10
045 Margreid a.d. Weinstr.,73,,3,9,12
045 Margreid a.d. Weinstr.,74,,4,3,7
045 Margreid a.d. Weinstr.,75,,6,4,10
045 Margreid a.d. Weinstr.,76,,2,6,8
045 Margreid a.d. Weinstr.,77,,5,4,9
045 Margreid a.d. Weinstr.,78,,3,3,6
045 Margreid a.d. Weinstr.,79,,4,4,8
045 Margreid a.d. Weinstr.,80,,3,5,8
045 Margreid a.d. Weinstr.,81,,6,1,7
045 Margreid a.d. Weinstr.,82,,1,5,6
045 Margreid a.d. Weinstr.,83,,2,2,4
045 Margreid a.d. Weinstr.,84,,-,3,3
045 Margreid a.d. Weinstr.,85,,1,6,7
045 Margreid a.d. Weinstr.,86,,2,2,4
045 Margreid a.d. Weinstr.,87,,1,4,5
045 Margreid a.d. Weinstr.,88,,1,3,4
045 Margreid a.d. Weinstr.,89,,1,1,2
045 Margreid a.d. Weinstr.,90,,-,1,1
045 Margreid a.d. Weinstr.,91,,-,1,1
045 Margreid a.d. Weinstr.,92,,-,3,3
045 Margreid a.d. Weinstr.,93,,1,-,1
045 Margreid a.d. Weinstr.,95,,-,1,1
046 Mals,0,,29,15,44
046 Mals,1,,33,25,58
046 Mals,2,,30,14,44
046 Mals,3,,28,23,51
046 Mals,4,,24,30,54
046 Mals,5,,36,37,73
046 Mals,6,,27,31,58
046 Mals,7,,29,24,53
046 Mals,8,,32,21,53
046 Mals,9,,22,28,50
046 Mals,10,,30,30,60
046 Mals,11,,31,37,68
046 Mals,12,,41,30,71
046 Mals,13,,35,34,69
046 Mals,14,,30,32,62
046 Mals,15,,35,26,61
046 Mals,16,,36,41,77
046 Mals,17,,38,31,69
046 Mals,18,,37,33,70
046 Mals,19,,31,33,64
046 Mals,20,,36,34,70
046 Mals,21,,34,29,63
046 Mals,22,,41,33,74
046 Mals,23,,31,25,56
046 Mals,24,,31,32,63
046 Mals,25,,29,41,70
046 Mals,26,,35,36,71
046 Mals,27,,37,31,68
046 Mals,28,,31,27,58
046 Mals,29,,38,35,73
046 Mals,30,,37,37,74
046 Mals,31,,42,31,73
046 Mals,32,,30,30,60
046 Mals,33,,43,31,74
046 Mals,34,,36,31,67
046 Mals,35,,32,30,62
046 Mals,36,,40,31,71
046 Mals,37,,50,25,75
046 Mals,38,,34,41,75
046 Mals,39,,31,49,80
046 Mals,40,,38,47,85
046 Mals,41,,46,47,93
046 Mals,42,,48,44,92
046 Mals,43,,57,38,95
046 Mals,44,,50,33,83
046 Mals,45,,55,56,111
046 Mals,46,,51,40,91
046 Mals,47,,49,41,90
046 Mals,48,,50,54,104
046 Mals,49,,37,28,65
046 Mals,50,,49,35,84
046 Mals,51,,33,41,74
046 Mals,52,,35,33,68
046 Mals,53,,30,24,54
046 Mals,54,,37,35,72
046 Mals,55,,33,26,59
046 Mals,56,,29,24,53
046 Mals,57,,20,20,40
046 Mals,58,,33,31,64
046 Mals,59,,28,23,51
046 Mals,60,,30,21,51
046 Mals,61,,33,22,55
046 Mals,62,,19,24,43
046 Mals,63,,25,14,39
046 Mals,64,,21,19,40
046 Mals,65,,19,29,48
046 Mals,66,,10,19,29
046 Mals,67,,28,14,42
046 Mals,68,,23,19,42
046 Mals,69,,20,23,43
046 Mals,70,,16,16,32
046 Mals,71,,20,27,47
046 Mals,72,,24,27,51
046 Mals,73,,18,21,39
046 Mals,74,,11,26,37
046 Mals,75,,18,17,35
046 Mals,76,,13,18,31
046 Mals,77,,12,14,26
046 Mals,78,,11,20,31
046 Mals,79,,15,11,26
046 Mals,80,,8,16,24
046 Mals,81,,19,14,33
046 Mals,82,,13,11,24
046 Mals,83,,11,10,21
046 Mals,84,,7,14,21
046 Mals,85,,5,15,20
046 Mals,86,,4,13,17
046 Mals,87,,3,9,12
046 Mals,88,,-,7,7
046 Mals,89,,7,8,15
046 Mals,90,,3,5,8
046 Mals,91,,1,6,7
046 Mals,92,,1,8,9
046 Mals,93,,1,-,1
046 Mals,94,,2,1,3
046 Mals,96,,-,1,1
046 Mals,97,,1,-,1
046 Mals,98,,-,1,1
046 Mals,101,,-,1,1
047 Enneberg,0,,24,15,39
047 Enneberg,1,,18,12,30
047 Enneberg,2,,16,15,31
047 Enneberg,3,,16,20,36
047 Enneberg,4,,15,18,33
047 Enneberg,5,,23,19,42
047 Enneberg,6,,22,15,37
047 Enneberg,7,,14,17,31
047 Enneberg,8,,21,27,48
047 Enneberg,9,,18,14,32
047 Enneberg,10,,27,16,43
047 Enneberg,11,,19,21,40
047 Enneberg,12,,26,17,43
047 Enneberg,13,,18,9,27
047 Enneberg,14,,23,16,39
047 Enneberg,15,,17,13,30
047 Enneberg,16,,21,9,30
047 Enneberg,17,,21,15,36
047 Enneberg,18,,20,18,38
047 Enneberg,19,,15,15,30
047 Enneberg,20,,17,22,39
047 Enneberg,21,,15,17,32
047 Enneberg,22,,23,16,39
047 Enneberg,23,,19,14,33
047 Enneberg,24,,19,15,34
047 Enneberg,25,,19,10,29
047 Enneberg,26,,25,21,46
047 Enneberg,27,,21,18,39
047 Enneberg,28,,16,18,34
047 Enneberg,29,,22,19,41
047 Enneberg,30,,23,27,50
047 Enneberg,31,,21,19,40
047 Enneberg,32,,13,18,31
047 Enneberg,33,,21,24,45
047 Enneberg,34,,26,19,45
047 Enneberg,35,,14,18,32
047 Enneberg,36,,16,27,43
047 Enneberg,37,,29,32,61
047 Enneberg,38,,25,22,47
047 Enneberg,39,,25,27,52
047 Enneberg,40,,28,35,63
047 Enneberg,41,,28,20,48
047 Enneberg,42,,30,19,49
047 Enneberg,43,,22,22,44
047 Enneberg,44,,24,19,43
047 Enneberg,45,,18,21,39
047 Enneberg,46,,28,21,49
047 Enneberg,47,,23,21,44
047 Enneberg,48,,21,19,40
047 Enneberg,49,,18,16,34
047 Enneberg,50,,20,17,37
047 Enneberg,51,,14,17,31
047 Enneberg,52,,23,15,38
047 Enneberg,53,,20,11,31
047 Enneberg,54,,15,15,30
047 Enneberg,55,,15,18,33
047 Enneberg,56,,14,13,27
047 Enneberg,57,,14,11,25
047 Enneberg,58,,17,20,37
047 Enneberg,59,,14,16,30
047 Enneberg,60,,17,10,27
047 Enneberg,61,,10,15,25
047 Enneberg,62,,17,8,25
047 Enneberg,63,,15,14,29
047 Enneberg,64,,9,12,21
047 Enneberg,65,,12,18,30
047 Enneberg,66,,5,12,17
047 Enneberg,67,,17,18,35
047 Enneberg,68,,17,11,28
047 Enneberg,69,,11,20,31
047 Enneberg,70,,12,12,24
047 Enneberg,71,,9,7,16
047 Enneberg,72,,15,9,24
047 Enneberg,73,,12,18,30
047 Enneberg,74,,14,12,26
047 Enneberg,75,,9,11,20
047 Enneberg,76,,11,15,26
047 Enneberg,77,,8,10,18
047 Enneberg,78,,10,8,18
047 Enneberg,79,,7,16,23
047 Enneberg,80,,9,10,19
047 Enneberg,81,,11,12,23
047 Enneberg,82,,4,7,11
047 Enneberg,83,,7,8,15
047 Enneberg,84,,5,5,10
047 Enneberg,85,,5,6,11
047 Enneberg,86,,8,7,15
047 Enneberg,87,,2,4,6
047 Enneberg,88,,1,7,8
047 Enneberg,89,,6,5,11
047 Enneberg,90,,1,4,5
047 Enneberg,91,,2,1,3
047 Enneberg,92,,-,2,2
047 Enneberg,93,,-,3,3
047 Enneberg,94,,-,1,1
047 Enneberg,95,,-,4,4
047 Enneberg,96,,-,2,2
047 Enneberg,97,,-,3,3
048 Marling,0,,18,9,27
048 Marling,1,,17,10,27
048 Marling,2,,18,8,26
048 Marling,3,,10,12,22
048 Marling,4,,16,12,28
048 Marling,5,,11,17,28
048 Marling,6,,27,14,41
048 Marling,7,,14,14,28
048 Marling,8,,11,10,21
048 Marling,9,,17,16,33
048 Marling,10,,9,16,25
048 Marling,11,,15,16,31
048 Marling,12,,14,10,24
048 Marling,13,,12,11,23
048 Marling,14,,14,9,23
048 Marling,15,,13,15,28
048 Marling,16,,18,13,31
048 Marling,17,,11,8,19
048 Marling,18,,18,10,28
048 Marling,19,,18,17,35
048 Marling,20,,13,14,27
048 Marling,21,,13,18,31
048 Marling,22,,12,19,31
048 Marling,23,,16,12,28
048 Marling,24,,7,21,28
048 Marling,25,,12,8,20
048 Marling,26,,11,23,34
048 Marling,27,,15,9,24
048 Marling,28,,15,22,37
048 Marling,29,,16,11,27
048 Marling,30,,20,15,35
048 Marling,31,,19,16,35
048 Marling,32,,17,25,42
048 Marling,33,,18,16,34
048 Marling,34,,19,14,33
048 Marling,35,,18,26,44
048 Marling,36,,22,15,37
048 Marling,37,,18,12,30
048 Marling,38,,16,21,37
048 Marling,39,,17,19,36
048 Marling,40,,24,17,41
048 Marling,41,,21,23,44
048 Marling,42,,20,20,40
048 Marling,43,,28,20,48
048 Marling,44,,21,21,42
048 Marling,45,,27,26,53
048 Marling,46,,24,20,44
048 Marling,47,,26,21,47
048 Marling,48,,29,31,60
048 Marling,49,,21,19,40
048 Marling,50,,25,16,41
048 Marling,51,,19,22,41
048 Marling,52,,19,17,36
048 Marling,53,,17,13,30
048 Marling,54,,14,10,24
048 Marling,55,,10,12,22
048 Marling,56,,13,10,23
048 Marling,57,,16,12,28
048 Marling,58,,12,16,28
048 Marling,59,,13,15,28
048 Marling,60,,6,16,22
048 Marling,61,,15,14,29
048 Marling,62,,20,18,38
048 Marling,63,,5,15,20
048 Marling,64,,16,14,30
048 Marling,65,,12,15,27
048 Marling,66,,20,13,33
048 Marling,67,,15,16,31
048 Marling,68,,9,17,26
048 Marling,69,,9,11,20
048 Marling,70,,20,17,37
048 Marling,71,,11,12,23
048 Marling,72,,15,15,30
048 Marling,73,,8,12,20
048 Marling,74,,11,16,27
048 Marling,75,,14,8,22
048 Marling,76,,3,17,20
048 Marling,77,,9,8,17
048 Marling,78,,7,12,19
048 Marling,79,,7,10,17
048 Marling,80,,8,8,16
048 Marling,81,,3,8,11
048 Marling,82,,5,5,10
048 Marling,83,,5,1,6
048 Marling,84,,7,7,14
048 Marling,85,,1,8,9
048 Marling,86,,1,9,10
048 Marling,87,,-,5,5
048 Marling,88,,1,5,6
048 Marling,89,,1,2,3
048 Marling,90,,3,3,6
048 Marling,91,,-,1,1
048 Marling,92,,2,2,4
048 Marling,93,,1,1,2
048 Marling,95,,-,1,1
048 Marling,96,,1,1,2
048 Marling,97,,1,-,1
049 Martell,0,,8,4,12
049 Martell,1,,8,4,12
049 Martell,2,,3,3,6
049 Martell,3,,6,1,7
049 Martell,4,,7,-,7
049 Martell,5,,4,5,9
049 Martell,6,,8,2,10
049 Martell,7,,7,1,8
049 Martell,8,,5,5,10
049 Martell,9,,4,5,9
049 Martell,10,,4,7,11
049 Martell,11,,8,3,11
049 Martell,12,,3,6,9
049 Martell,13,,6,7,13
049 Martell,14,,5,9,14
049 Martell,15,,4,6,10
049 Martell,16,,6,8,14
049 Martell,17,,6,8,14
049 Martell,18,,6,5,11
049 Martell,19,,4,4,8
049 Martell,20,,8,5,13
049 Martell,21,,6,4,10
049 Martell,22,,8,4,12
049 Martell,23,,4,1,5
049 Martell,24,,8,5,13
049 Martell,25,,-,2,2
049 Martell,26,,3,4,7
049 Martell,27,,5,2,7
049 Martell,28,,8,5,13
049 Martell,29,,5,8,13
049 Martell,30,,4,6,10
049 Martell,31,,9,2,11
049 Martell,32,,8,4,12
049 Martell,33,,3,5,8
049 Martell,34,,7,4,11
049 Martell,35,,5,4,9
049 Martell,36,,1,7,8
049 Martell,37,,7,10,17
049 Martell,38,,8,5,13
049 Martell,39,,5,8,13
049 Martell,40,,9,6,15
049 Martell,41,,8,4,12
049 Martell,42,,6,13,19
049 Martell,43,,9,6,15
049 Martell,44,,4,7,11
049 Martell,45,,16,7,23
049 Martell,46,,17,11,28
049 Martell,47,,7,9,16
049 Martell,48,,14,1,15
049 Martell,49,,11,7,18
049 Martell,50,,7,5,12
049 Martell,51,,9,3,12
049 Martell,52,,7,6,13
049 Martell,53,,8,6,14
049 Martell,54,,7,3,10
049 Martell,55,,5,4,9
049 Martell,56,,7,3,10
049 Martell,57,,5,6,11
049 Martell,58,,4,5,9
049 Martell,59,,3,3,6
049 Martell,60,,5,7,12
049 Martell,61,,2,5,7
049 Martell,62,,3,1,4
049 Martell,63,,4,4,8
049 Martell,64,,4,3,7
049 Martell,65,,3,-,3
049 Martell,66,,4,1,5
049 Martell,67,,1,3,4
049 Martell,68,,3,4,7
049 Martell,69,,6,5,11
049 Martell,70,,3,4,7
049 Martell,71,,6,2,8
049 Martell,72,,2,4,6
049 Martell,73,,2,5,7
049 Martell,74,,2,4,6
049 Martell,75,,3,4,7
049 Martell,76,,4,7,11
049 Martell,77,,6,1,7
049 Martell,78,,4,6,10
049 Martell,79,,2,2,4
049 Martell,80,,4,-,4
049 Martell,81,,4,4,8
049 Martell,82,,2,2,4
049 Martell,83,,1,1,2
049 Martell,84,,2,3,5
049 Martell,85,,-,8,8
049 Martell,86,,2,1,3
049 Martell,87,,2,4,6
049 Martell,88,,-,4,4
049 Martell,89,,1,1,2
049 Martell,96,,-,1,1
049 Martell,97,,-,1,1
050 Mölten,0,,16,15,31
050 Mölten,1,,6,12,18
050 Mölten,2,,15,12,27
050 Mölten,3,,11,14,25
050 Mölten,4,,13,11,24
050 Mölten,5,,9,8,17
050 Mölten,6,,9,11,20
050 Mölten,7,,12,10,22
050 Mölten,8,,11,9,20
050 Mölten,9,,15,12,27
050 Mölten,10,,17,17,34
050 Mölten,11,,13,15,28
050 Mölten,12,,12,16,28
050 Mölten,13,,8,16,24
050 Mölten,14,,10,7,17
050 Mölten,15,,16,13,29
050 Mölten,16,,12,9,21
050 Mölten,17,,14,5,19
050 Mölten,18,,12,11,23
050 Mölten,19,,6,12,18
050 Mölten,20,,10,6,16
050 Mölten,21,,12,6,18
050 Mölten,22,,12,5,17
050 Mölten,23,,8,10,18
050 Mölten,24,,9,8,17
050 Mölten,25,,11,5,16
050 Mölten,26,,8,9,17
050 Mölten,27,,7,3,10
050 Mölten,28,,7,13,20
050 Mölten,29,,10,11,21
050 Mölten,30,,13,13,26
050 Mölten,31,,16,7,23
050 Mölten,32,,12,13,25
050 Mölten,33,,12,8,20
050 Mölten,34,,9,12,21
050 Mölten,35,,12,20,32
050 Mölten,36,,24,14,38
050 Mölten,37,,12,10,22
050 Mölten,38,,15,16,31
050 Mölten,39,,9,12,21
050 Mölten,40,,15,15,30
050 Mölten,41,,17,11,28
050 Mölten,42,,16,13,29
050 Mölten,43,,16,17,33
050 Mölten,44,,19,15,34
050 Mölten,45,,17,13,30
050 Mölten,46,,11,16,27
050 Mölten,47,,20,16,36
050 Mölten,48,,19,7,26
050 Mölten,49,,15,10,25
050 Mölten,50,,14,10,24
050 Mölten,51,,10,9,19
050 Mölten,52,,14,5,19
050 Mölten,53,,4,9,13
050 Mölten,54,,7,3,10
050 Mölten,55,,6,9,15
050 Mölten,56,,12,7,19
050 Mölten,57,,6,8,14
050 Mölten,58,,7,7,14
050 Mölten,59,,7,6,13
050 Mölten,60,,5,6,11
050 Mölten,61,,10,9,19
050 Mölten,62,,8,6,14
050 Mölten,63,,7,4,11
050 Mölten,64,,3,7,10
050 Mölten,65,,8,4,12
050 Mölten,66,,7,5,12
050 Mölten,67,,2,7,9
050 Mölten,68,,12,8,20
050 Mölten,69,,6,9,15
050 Mölten,70,,8,4,12
050 Mölten,71,,5,7,12
050 Mölten,72,,5,6,11
050 Mölten,73,,3,3,6
050 Mölten,74,,4,7,11
050 Mölten,75,,2,4,6
050 Mölten,76,,8,6,14
050 Mölten,77,,8,4,12
050 Mölten,78,,5,8,13
050 Mölten,79,,3,5,8
050 Mölten,80,,8,2,10
050 Mölten,81,,6,2,8
050 Mölten,82,,1,5,6
050 Mölten,83,,1,3,4
050 Mölten,84,,1,1,2
050 Mölten,85,,1,4,5
050 Mölten,86,,1,3,4
050 Mölten,88,,3,1,4
050 Mölten,89,,1,2,3
050 Mölten,90,,-,2,2
050 Mölten,91,,-,5,5
050 Mölten,92,,-,2,2
050 Mölten,97,,-,1,1
051 Meran,0,,183,194,377
051 Meran,1,,187,191,378
051 Meran,2,,188,174,362
051 Meran,3,,188,172,360
051 Meran,4,,216,197,413
051 Meran,5,,206,209,415
051 Meran,6,,183,175,358
051 Meran,7,,235,172,407
051 Meran,8,,185,165,350
051 Meran,9,,188,162,350
051 Meran,10,,201,188,389
051 Meran,11,,197,168,365
051 Meran,12,,183,193,376
051 Meran,13,,166,158,324
051 Meran,14,,202,171,373
051 Meran,15,,203,170,373
051 Meran,16,,179,166,345
051 Meran,17,,179,199,378
051 Meran,18,,152,160,312
051 Meran,19,,193,156,349
051 Meran,20,,177,202,379
051 Meran,21,,192,168,360
051 Meran,22,,218,185,403
051 Meran,23,,208,165,373
051 Meran,24,,203,192,395
051 Meran,25,,197,170,367
051 Meran,26,,195,239,434
051 Meran,27,,229,222,451
051 Meran,28,,225,232,457
051 Meran,29,,227,232,459
051 Meran,30,,253,232,485
051 Meran,31,,262,220,482
051 Meran,32,,223,213,436
051 Meran,33,,267,236,503
051 Meran,34,,244,270,514
051 Meran,35,,243,287,530
051 Meran,36,,264,290,554
051 Meran,37,,296,313,609
051 Meran,38,,285,296,581
051 Meran,39,,305,304,609
051 Meran,40,,327,293,620
051 Meran,41,,319,327,646
051 Meran,42,,335,329,664
051 Meran,43,,365,353,718
051 Meran,44,,368,341,709
051 Meran,45,,327,307,634
051 Meran,46,,338,338,676
051 Meran,47,,349,317,666
051 Meran,48,,340,301,641
051 Meran,49,,270,301,571
051 Meran,50,,293,313,606
051 Meran,51,,291,277,568
051 Meran,52,,276,253,529
051 Meran,53,,266,251,517
051 Meran,54,,230,259,489
051 Meran,55,,226,233,459
051 Meran,56,,201,231,432
051 Meran,57,,187,234,421
051 Meran,58,,184,233,417
051 Meran,59,,205,225,430
051 Meran,60,,199,220,419
051 Meran,61,,189,231,420
051 Meran,62,,227,246,473
051 Meran,63,,207,263,470
051 Meran,64,,223,281,504
051 Meran,65,,241,290,531
051 Meran,66,,193,210,403
051 Meran,67,,194,228,422
051 Meran,68,,248,237,485
051 Meran,69,,243,296,539
051 Meran,70,,216,275,491
051 Meran,71,,173,224,397
051 Meran,72,,179,241,420
051 Meran,73,,164,225,389
051 Meran,74,,167,220,387
051 Meran,75,,148,196,344
051 Meran,76,,139,198,337
051 Meran,77,,138,173,311
051 Meran,78,,130,159,289
051 Meran,79,,114,172,286
051 Meran,80,,93,151,244
051 Meran,81,,104,173,277
051 Meran,82,,81,130,211
051 Meran,83,,73,150,223
051 Meran,84,,71,112,183
051 Meran,85,,60,138,198
051 Meran,86,,43,130,173
051 Meran,87,,49,114,163
051 Meran,88,,37,104,141
051 Meran,89,,45,102,147
051 Meran,90,,21,97,118
051 Meran,91,,21,70,91
051 Meran,92,,16,43,59
051 Meran,93,,2,26,28
051 Meran,94,,8,25,33
051 Meran,95,,8,13,21
051 Meran,96,,4,18,22
051 Meran,97,,6,20,26
051 Meran,98,,4,9,13
051 Meran,99,,3,9,12
051 Meran,100,,2,2,4
051 Meran,101,,1,1,2
051 Meran,102,,-,2,2
051 Meran,103,,1,3,4
051 Meran,105,,-,1,1
052 Welsberg-Taisten,0,,17,17,34
052 Welsberg-Taisten,1,,9,16,25
052 Welsberg-Taisten,2,,13,14,27
052 Welsberg-Taisten,3,,25,21,46
052 Welsberg-Taisten,4,,21,21,42
052 Welsberg-Taisten,5,,11,27,38
052 Welsberg-Taisten,6,,22,27,49
052 Welsberg-Taisten,7,,13,19,32
052 Welsberg-Taisten,8,,18,16,34
052 Welsberg-Taisten,9,,21,22,43
052 Welsberg-Taisten,10,,32,19,51
052 Welsberg-Taisten,11,,18,14,32
052 Welsberg-Taisten,12,,19,22,41
052 Welsberg-Taisten,13,,23,12,35
052 Welsberg-Taisten,14,,19,20,39
052 Welsberg-Taisten,15,,16,17,33
052 Welsberg-Taisten,16,,19,15,34
052 Welsberg-Taisten,17,,13,16,29
052 Welsberg-Taisten,18,,15,22,37
052 Welsberg-Taisten,19,,10,12,22
052 Welsberg-Taisten,20,,20,18,38
052 Welsberg-Taisten,21,,10,17,27
052 Welsberg-Taisten,22,,5,17,22
052 Welsberg-Taisten,23,,12,21,33
052 Welsberg-Taisten,24,,11,13,24
052 Welsberg-Taisten,25,,14,8,22
052 Welsberg-Taisten,26,,9,18,27
052 Welsberg-Taisten,27,,30,15,45
052 Welsberg-Taisten,28,,22,19,41
052 Welsberg-Taisten,29,,15,17,32
052 Welsberg-Taisten,30,,12,16,28
052 Welsberg-Taisten,31,,19,18,37
052 Welsberg-Taisten,32,,22,19,41
052 Welsberg-Taisten,33,,17,18,35
052 Welsberg-Taisten,34,,14,28,42
052 Welsberg-Taisten,35,,19,11,30
052 Welsberg-Taisten,36,,18,24,42
052 Welsberg-Taisten,37,,28,22,50
052 Welsberg-Taisten,38,,26,11,37
052 Welsberg-Taisten,39,,18,30,48
052 Welsberg-Taisten,40,,32,21,53
052 Welsberg-Taisten,41,,28,26,54
052 Welsberg-Taisten,42,,22,22,44
052 Welsberg-Taisten,43,,30,21,51
052 Welsberg-Taisten,44,,32,22,54
052 Welsberg-Taisten,45,,34,21,55
052 Welsberg-Taisten,46,,20,18,38
052 Welsberg-Taisten,47,,34,20,54
052 Welsberg-Taisten,48,,28,24,52
052 Welsberg-Taisten,49,,20,22,42
052 Welsberg-Taisten,50,,16,15,31
052 Welsberg-Taisten,51,,10,17,27
052 Welsberg-Taisten,52,,21,20,41
052 Welsberg-Taisten,53,,27,17,44
052 Welsberg-Taisten,54,,13,19,32
052 Welsberg-Taisten,55,,19,19,38
052 Welsberg-Taisten,56,,16,11,27
052 Welsberg-Taisten,57,,15,14,29
052 Welsberg-Taisten,58,,19,12,31
052 Welsberg-Taisten,59,,17,12,29
052 Welsberg-Taisten,60,,19,11,30
052 Welsberg-Taisten,61,,17,14,31
052 Welsberg-Taisten,62,,15,11,26
052 Welsberg-Taisten,63,,16,16,32
052 Welsberg-Taisten,64,,10,11,21
052 Welsberg-Taisten,65,,13,14,27
052 Welsberg-Taisten,66,,9,12,21
052 Welsberg-Taisten,67,,12,11,23
052 Welsberg-Taisten,68,,10,13,23
052 Welsberg-Taisten,69,,10,14,24
052 Welsberg-Taisten,70,,15,16,31
052 Welsberg-Taisten,71,,6,11,17
052 Welsberg-Taisten,72,,11,9,20
052 Welsberg-Taisten,73,,11,12,23
052 Welsberg-Taisten,74,,8,8,16
052 Welsberg-Taisten,75,,8,10,18
052 Welsberg-Taisten,76,,3,15,18
052 Welsberg-Taisten,77,,17,15,32
052 Welsberg-Taisten,78,,7,9,16
052 Welsberg-Taisten,79,,9,9,18
052 Welsberg-Taisten,80,,6,13,19
052 Welsberg-Taisten,81,,8,7,15
052 Welsberg-Taisten,82,,6,9,15
052 Welsberg-Taisten,83,,5,15,20
052 Welsberg-Taisten,84,,2,10,12
052 Welsberg-Taisten,85,,5,5,10
052 Welsberg-Taisten,86,,-,5,5
052 Welsberg-Taisten,87,,1,5,6
052 Welsberg-Taisten,88,,3,4,7
052 Welsberg-Taisten,89,,2,2,4
052 Welsberg-Taisten,90,,2,3,5
052 Welsberg-Taisten,91,,1,2,3
052 Welsberg-Taisten,92,,-,2,2
052 Welsberg-Taisten,94,,-,1,1
052 Welsberg-Taisten,95,,1,-,1
052 Welsberg-Taisten,96,,1,2,3
052 Welsberg-Taisten,98,,-,1,1
052 Welsberg-Taisten,99,,-,1,1
053 Montan,0,,10,3,13
053 Montan,1,,13,12,25
053 Montan,2,,8,8,16
053 Montan,3,,13,8,21
053 Montan,4,,7,6,13
053 Montan,5,,8,7,15
053 Montan,6,,9,9,18
053 Montan,7,,7,11,18
053 Montan,8,,10,11,21
053 Montan,9,,6,4,10
053 Montan,10,,14,4,18
053 Montan,11,,9,6,15
053 Montan,12,,7,11,18
053 Montan,13,,9,13,22
053 Montan,14,,8,9,17
053 Montan,15,,14,9,23
053 Montan,16,,16,15,31
053 Montan,17,,13,6,19
053 Montan,18,,5,9,14
053 Montan,19,,6,10,16
053 Montan,20,,15,10,25
053 Montan,21,,11,7,18
053 Montan,22,,10,11,21
053 Montan,23,,12,16,28
053 Montan,24,,11,17,28
053 Montan,25,,15,6,21
053 Montan,26,,12,10,22
053 Montan,27,,6,3,9
053 Montan,28,,12,8,20
053 Montan,29,,9,7,16
053 Montan,30,,12,14,26
053 Montan,31,,7,8,15
053 Montan,32,,13,9,22
053 Montan,33,,12,7,19
053 Montan,34,,8,6,14
053 Montan,35,,10,7,17
053 Montan,36,,9,17,26
053 Montan,37,,10,16,26
053 Montan,38,,15,5,20
053 Montan,39,,8,8,16
053 Montan,40,,13,10,23
053 Montan,41,,15,13,28
053 Montan,42,,15,19,34
053 Montan,43,,15,18,33
053 Montan,44,,11,13,24
053 Montan,45,,14,16,30
053 Montan,46,,26,16,42
053 Montan,47,,15,10,25
053 Montan,48,,12,18,30
053 Montan,49,,16,16,32
053 Montan,50,,19,12,31
053 Montan,51,,14,12,26
053 Montan,52,,14,8,22
053 Montan,53,,12,10,22
053 Montan,54,,13,11,24
053 Montan,55,,8,15,23
053 Montan,56,,9,14,23
053 Montan,57,,13,13,26
053 Montan,58,,11,6,17
053 Montan,59,,12,4,16
053 Montan,60,,8,7,15
053 Montan,61,,4,4,8
053 Montan,62,,7,3,10
053 Montan,63,,5,6,11
053 Montan,64,,7,11,18
053 Montan,65,,5,3,8
053 Montan,66,,5,3,8
053 Montan,67,,2,6,8
053 Montan,68,,5,6,11
053 Montan,69,,6,6,12
053 Montan,70,,6,6,12
053 Montan,71,,8,7,15
053 Montan,72,,4,9,13
053 Montan,73,,6,11,17
053 Montan,74,,2,5,7
053 Montan,75,,7,9,16
053 Montan,76,,1,8,9
053 Montan,77,,2,7,9
053 Montan,78,,14,4,18
053 Montan,79,,5,7,12
053 Montan,80,,7,10,17
053 Montan,81,,7,12,19
053 Montan,82,,4,9,13
053 Montan,83,,4,3,7
053 Montan,84,,3,3,6
053 Montan,85,,5,5,10
053 Montan,86,,-,8,8
053 Montan,87,,1,4,5
053 Montan,88,,-,8,8
053 Montan,89,,3,3,6
053 Montan,90,,-,2,2
053 Montan,91,,1,2,3
053 Montan,92,,-,1,1
053 Montan,93,,-,2,2
053 Montan,96,,-,2,2
054 Moos in Passeier,0,,20,13,33
054 Moos in Passeier,1,,10,8,18
054 Moos in Passeier,2,,10,14,24
054 Moos in Passeier,3,,16,11,27
054 Moos in Passeier,4,,17,7,24
054 Moos in Passeier,5,,17,9,26
054 Moos in Passeier,6,,17,14,31
054 Moos in Passeier,7,,17,20,37
054 Moos in Passeier,8,,15,10,25
054 Moos in Passeier,9,,21,18,39
054 Moos in Passeier,10,,15,12,27
054 Moos in Passeier,11,,13,18,31
054 Moos in Passeier,12,,24,9,33
054 Moos in Passeier,13,,16,14,30
054 Moos in Passeier,14,,12,17,29
054 Moos in Passeier,15,,18,19,37
054 Moos in Passeier,16,,7,12,19
054 Moos in Passeier,17,,17,20,37
054 Moos in Passeier,18,,17,12,29
054 Moos in Passeier,19,,18,16,34
054 Moos in Passeier,20,,16,18,34
054 Moos in Passeier,21,,15,14,29
054 Moos in Passeier,22,,16,17,33
054 Moos in Passeier,23,,15,12,27
054 Moos in Passeier,24,,16,14,30
054 Moos in Passeier,25,,16,13,29
054 Moos in Passeier,26,,19,11,30
054 Moos in Passeier,27,,20,20,40
054 Moos in Passeier,28,,11,13,24
054 Moos in Passeier,29,,14,15,29
054 Moos in Passeier,30,,12,15,27
054 Moos in Passeier,31,,13,14,27
054 Moos in Passeier,32,,17,10,27
054 Moos in Passeier,33,,18,14,32
054 Moos in Passeier,34,,20,15,35
054 Moos in Passeier,35,,14,8,22
054 Moos in Passeier,36,,15,12,27
054 Moos in Passeier,37,,23,14,37
054 Moos in Passeier,38,,8,21,29
054 Moos in Passeier,39,,17,15,32
054 Moos in Passeier,40,,17,18,35
054 Moos in Passeier,41,,20,10,30
054 Moos in Passeier,42,,16,18,34
054 Moos in Passeier,43,,16,17,33
054 Moos in Passeier,44,,22,17,39
054 Moos in Passeier,45,,23,18,41
054 Moos in Passeier,46,,20,8,28
054 Moos in Passeier,47,,21,11,32
054 Moos in Passeier,48,,15,18,33
054 Moos in Passeier,49,,10,19,29
054 Moos in Passeier,50,,9,7,16
054 Moos in Passeier,51,,15,15,30
054 Moos in Passeier,52,,14,12,26
054 Moos in Passeier,53,,12,13,25
054 Moos in Passeier,54,,19,5,24
054 Moos in Passeier,55,,9,8,17
054 Moos in Passeier,56,,8,8,16
054 Moos in Passeier,57,,14,9,23
054 Moos in Passeier,58,,7,8,15
054 Moos in Passeier,59,,8,3,11
054 Moos in Passeier,60,,9,10,19
054 Moos in Passeier,61,,6,10,16
054 Moos in Passeier,62,,13,9,22
054 Moos in Passeier,63,,6,6,12
054 Moos in Passeier,64,,17,10,27
054 Moos in Passeier,65,,9,8,17
054 Moos in Passeier,66,,9,7,16
054 Moos in Passeier,67,,10,7,17
054 Moos in Passeier,68,,14,11,25
054 Moos in Passeier,69,,5,12,17
054 Moos in Passeier,70,,9,13,22
054 Moos in Passeier,71,,8,10,18
054 Moos in Passeier,72,,5,4,9
054 Moos in Passeier,73,,9,6,15
054 Moos in Passeier,74,,5,6,11
054 Moos in Passeier,75,,8,7,15
054 Moos in Passeier,76,,8,5,13
054 Moos in Passeier,77,,11,13,24
054 Moos in Passeier,78,,5,9,14
054 Moos in Passeier,79,,8,3,11
054 Moos in Passeier,80,,6,6,12
054 Moos in Passeier,81,,6,7,13
054 Moos in Passeier,82,,6,10,16
054 Moos in Passeier,83,,3,8,11
054 Moos in Passeier,84,,4,4,8
054 Moos in Passeier,85,,6,2,8
054 Moos in Passeier,86,,4,6,10
054 Moos in Passeier,87,,3,4,7
054 Moos in Passeier,88,,2,1,3
054 Moos in Passeier,89,,-,2,2
054 Moos in Passeier,91,,-,1,1
054 Moos in Passeier,92,,-,2,2
054 Moos in Passeier,94,,-,1,1
054 Moos in Passeier,95,,-,1,1
054 Moos in Passeier,101,,-,1,1
055 Nals,0,,10,11,21
055 Nals,1,,9,17,26
055 Nals,2,,10,10,20
055 Nals,3,,10,5,15
055 Nals,4,,8,10,18
055 Nals,5,,11,3,14
055 Nals,6,,7,14,21
055 Nals,7,,7,8,15
055 Nals,8,,11,6,17
055 Nals,9,,12,13,25
055 Nals,10,,8,9,17
055 Nals,11,,6,13,19
055 Nals,12,,14,9,23
055 Nals,13,,14,8,22
055 Nals,14,,12,9,21
055 Nals,15,,12,11,23
055 Nals,16,,7,6,13
055 Nals,17,,9,8,17
055 Nals,18,,7,14,21
055 Nals,19,,11,9,20
055 Nals,20,,12,10,22
055 Nals,21,,9,8,17
055 Nals,22,,12,8,20
055 Nals,23,,13,11,24
055 Nals,24,,12,12,24
055 Nals,25,,6,5,11
055 Nals,26,,15,12,27
055 Nals,27,,10,12,22
055 Nals,28,,7,10,17
055 Nals,29,,8,10,18
055 Nals,30,,14,13,27
055 Nals,31,,17,16,33
055 Nals,32,,10,13,23
055 Nals,33,,12,14,26
055 Nals,34,,8,18,26
055 Nals,35,,16,12,28
055 Nals,36,,9,14,23
055 Nals,37,,21,14,35
055 Nals,38,,18,7,25
055 Nals,39,,15,18,33
055 Nals,40,,19,18,37
055 Nals,41,,28,11,39
055 Nals,42,,20,20,40
055 Nals,43,,22,18,40
055 Nals,44,,19,15,34
055 Nals,45,,15,15,30
055 Nals,46,,17,15,32
055 Nals,47,,17,21,38
055 Nals,48,,10,23,33
055 Nals,49,,11,13,24
055 Nals,50,,18,14,32
055 Nals,51,,16,10,26
055 Nals,52,,15,17,32
055 Nals,53,,15,17,32
055 Nals,54,,7,6,13
055 Nals,55,,7,7,14
055 Nals,56,,22,13,35
055 Nals,57,,8,6,14
055 Nals,58,,9,8,17
055 Nals,59,,8,7,15
055 Nals,60,,3,9,12
055 Nals,61,,6,10,16
055 Nals,62,,9,9,18
055 Nals,63,,11,12,23
055 Nals,64,,11,5,16
055 Nals,65,,7,14,21
055 Nals,66,,7,12,19
055 Nals,67,,5,12,17
055 Nals,68,,9,7,16
055 Nals,69,,5,9,14
055 Nals,70,,11,6,17
055 Nals,71,,7,12,19
055 Nals,72,,8,11,19
055 Nals,73,,4,9,13
055 Nals,74,,3,13,16
055 Nals,75,,6,4,10
055 Nals,76,,5,6,11
055 Nals,77,,4,6,10
055 Nals,78,,7,10,17
055 Nals,79,,5,5,10
055 Nals,80,,3,5,8
055 Nals,81,,1,5,6
055 Nals,82,,6,7,13
055 Nals,83,,5,6,11
055 Nals,84,,2,6,8
055 Nals,85,,5,3,8
055 Nals,86,,3,2,5
055 Nals,87,,2,-,2
055 Nals,88,,-,3,3
055 Nals,89,,1,3,4
055 Nals,90,,-,8,8
055 Nals,92,,-,2,2
055 Nals,95,,-,1,1
055 Nals,96,,-,1,1
055 Nals,97,,-,1,1
055 Nals,100,,-,1,1
056 Naturns,0,,33,26,59
056 Naturns,1,,40,24,64
056 Naturns,2,,24,27,51
056 Naturns,3,,34,22,56
056 Naturns,4,,33,31,64
056 Naturns,5,,35,30,65
056 Naturns,6,,34,21,55
056 Naturns,7,,36,33,69
056 Naturns,8,,38,23,61
056 Naturns,9,,28,27,55
056 Naturns,10,,33,30,63
056 Naturns,11,,31,25,56
056 Naturns,12,,32,27,59
056 Naturns,13,,29,35,64
056 Naturns,14,,20,18,38
056 Naturns,15,,33,36,69
056 Naturns,16,,44,34,78
056 Naturns,17,,33,38,71
056 Naturns,18,,35,37,72
056 Naturns,19,,29,38,67
056 Naturns,20,,43,40,83
056 Naturns,21,,34,32,66
056 Naturns,22,,40,25,65
056 Naturns,23,,48,36,84
056 Naturns,24,,34,19,53
056 Naturns,25,,31,33,64
056 Naturns,26,,41,30,71
056 Naturns,27,,41,25,66
056 Naturns,28,,32,36,68
056 Naturns,29,,41,44,85
056 Naturns,30,,41,49,90
056 Naturns,31,,38,38,76
056 Naturns,32,,53,36,89
056 Naturns,33,,47,45,92
056 Naturns,34,,41,43,84
056 Naturns,35,,39,35,74
056 Naturns,36,,46,40,86
056 Naturns,37,,43,49,92
056 Naturns,38,,47,50,97
056 Naturns,39,,50,49,99
056 Naturns,40,,41,40,81
056 Naturns,41,,54,42,96
056 Naturns,42,,41,46,87
056 Naturns,43,,46,42,88
056 Naturns,44,,46,46,92
056 Naturns,45,,55,45,100
056 Naturns,46,,36,55,91
056 Naturns,47,,54,38,92
056 Naturns,48,,42,48,90
056 Naturns,49,,39,47,86
056 Naturns,50,,40,48,88
056 Naturns,51,,56,39,95
056 Naturns,52,,43,40,83
056 Naturns,53,,32,36,68
056 Naturns,54,,38,33,71
056 Naturns,55,,42,41,83
056 Naturns,56,,29,32,61
056 Naturns,57,,39,31,70
056 Naturns,58,,35,22,57
056 Naturns,59,,30,36,66
056 Naturns,60,,34,35,69
056 Naturns,61,,28,33,61
056 Naturns,62,,26,19,45
056 Naturns,63,,28,24,52
056 Naturns,64,,9,23,32
056 Naturns,65,,22,30,52
056 Naturns,66,,25,18,43
056 Naturns,67,,19,19,38
056 Naturns,68,,25,33,58
056 Naturns,69,,30,35,65
056 Naturns,70,,36,29,65
056 Naturns,71,,23,19,42
056 Naturns,72,,19,21,40
056 Naturns,73,,19,17,36
056 Naturns,74,,21,20,41
056 Naturns,75,,18,21,39
056 Naturns,76,,16,11,27
056 Naturns,77,,15,18,33
056 Naturns,78,,14,13,27
056 Naturns,79,,8,17,25
056 Naturns,80,,7,19,26
056 Naturns,81,,11,20,31
056 Naturns,82,,10,16,26
056 Naturns,83,,13,11,24
056 Naturns,84,,3,14,17
056 Naturns,85,,10,11,21
056 Naturns,86,,8,13,21
056 Naturns,87,,10,10,20
056 Naturns,88,,2,8,10
056 Naturns,89,,1,6,7
056 Naturns,90,,1,8,9
056 Naturns,91,,1,2,3
056 Naturns,92,,-,4,4
056 Naturns,93,,2,-,2
056 Naturns,94,,1,-,1
056 Naturns,97,,-,6,6
056 Naturns,98,,1,1,2
056 Naturns,99,,-,1,1
056 Naturns,100,,-,1,1
057 Natz-Schabs,0,,28,16,44
057 Natz-Schabs,1,,16,15,31
057 Natz-Schabs,2,,8,23,31
057 Natz-Schabs,3,,17,22,39
057 Natz-Schabs,4,,16,12,28
057 Natz-Schabs,5,,14,17,31
057 Natz-Schabs,6,,14,15,29
057 Natz-Schabs,7,,16,19,35
057 Natz-Schabs,8,,18,18,36
057 Natz-Schabs,9,,24,19,43
057 Natz-Schabs,10,,16,14,30
057 Natz-Schabs,11,,21,17,38
057 Natz-Schabs,12,,15,20,35
057 Natz-Schabs,13,,24,16,40
057 Natz-Schabs,14,,17,17,34
057 Natz-Schabs,15,,22,17,39
057 Natz-Schabs,16,,13,14,27
057 Natz-Schabs,17,,21,16,37
057 Natz-Schabs,18,,19,18,37
057 Natz-Schabs,19,,16,14,30
057 Natz-Schabs,20,,20,22,42
057 Natz-Schabs,21,,16,28,44
057 Natz-Schabs,22,,17,24,41
057 Natz-Schabs,23,,26,15,41
057 Natz-Schabs,24,,19,17,36
057 Natz-Schabs,25,,17,20,37
057 Natz-Schabs,26,,22,25,47
057 Natz-Schabs,27,,22,18,40
057 Natz-Schabs,28,,22,24,46
057 Natz-Schabs,29,,15,25,40
057 Natz-Schabs,30,,25,21,46
057 Natz-Schabs,31,,28,22,50
057 Natz-Schabs,32,,19,18,37
057 Natz-Schabs,33,,19,30,49
057 Natz-Schabs,34,,23,15,38
057 Natz-Schabs,35,,16,24,40
057 Natz-Schabs,36,,22,29,51
057 Natz-Schabs,37,,19,28,47
057 Natz-Schabs,38,,31,24,55
057 Natz-Schabs,39,,24,23,47
057 Natz-Schabs,40,,27,24,51
057 Natz-Schabs,41,,33,25,58
057 Natz-Schabs,42,,31,25,56
057 Natz-Schabs,43,,35,20,55
057 Natz-Schabs,44,,27,22,49
057 Natz-Schabs,45,,31,21,52
057 Natz-Schabs,46,,34,36,70
057 Natz-Schabs,47,,31,27,58
057 Natz-Schabs,48,,26,26,52
057 Natz-Schabs,49,,17,22,39
057 Natz-Schabs,50,,16,19,35
057 Natz-Schabs,51,,30,20,50
057 Natz-Schabs,52,,20,19,39
057 Natz-Schabs,53,,21,20,41
057 Natz-Schabs,54,,19,23,42
057 Natz-Schabs,55,,16,23,39
057 Natz-Schabs,56,,19,17,36
057 Natz-Schabs,57,,11,15,26
057 Natz-Schabs,58,,20,14,34
057 Natz-Schabs,59,,12,10,22
057 Natz-Schabs,60,,15,13,28
057 Natz-Schabs,61,,15,14,29
057 Natz-Schabs,62,,18,16,34
057 Natz-Schabs,63,,14,12,26
057 Natz-Schabs,64,,12,13,25
057 Natz-Schabs,65,,15,11,26
057 Natz-Schabs,66,,8,6,14
057 Natz-Schabs,67,,14,10,24
057 Natz-Schabs,68,,13,6,19
057 Natz-Schabs,69,,12,7,19
057 Natz-Schabs,70,,12,8,20
057 Natz-Schabs,71,,4,6,10
057 Natz-Schabs,72,,1,5,6
057 Natz-Schabs,73,,7,5,12
057 Natz-Schabs,74,,8,6,14
057 Natz-Schabs,75,,6,4,10
057 Natz-Schabs,76,,6,7,13
057 Natz-Schabs,77,,3,3,6
057 Natz-Schabs,78,,6,9,15
057 Natz-Schabs,79,,3,8,11
057 Natz-Schabs,80,,3,5,8
057 Natz-Schabs,81,,4,7,11
057 Natz-Schabs,82,,8,3,11
057 Natz-Schabs,83,,3,5,8
057 Natz-Schabs,84,,1,2,3
057 Natz-Schabs,85,,2,2,4
057 Natz-Schabs,86,,2,1,3
057 Natz-Schabs,87,,-,3,3
057 Natz-Schabs,88,,-,6,6
057 Natz-Schabs,89,,3,2,5
057 Natz-Schabs,90,,2,2,4
057 Natz-Schabs,91,,1,3,4
057 Natz-Schabs,93,,-,2,2
058 Welschnofen,0,,13,4,17
058 Welschnofen,1,,5,7,12
058 Welschnofen,2,,9,4,13
058 Welschnofen,3,,10,8,18
058 Welschnofen,4,,8,8,16
058 Welschnofen,5,,8,7,15
058 Welschnofen,6,,9,12,21
058 Welschnofen,7,,12,7,19
058 Welschnofen,8,,8,9,17
058 Welschnofen,9,,17,6,23
058 Welschnofen,10,,6,10,16
058 Welschnofen,11,,8,7,15
058 Welschnofen,12,,10,13,23
058 Welschnofen,13,,14,10,24
058 Welschnofen,14,,13,13,26
058 Welschnofen,15,,9,10,19
058 Welschnofen,16,,14,13,27
058 Welschnofen,17,,13,10,23
058 Welschnofen,18,,11,10,21
058 Welschnofen,19,,18,13,31
058 Welschnofen,20,,15,11,26
058 Welschnofen,21,,11,14,25
058 Welschnofen,22,,14,11,25
058 Welschnofen,23,,11,16,27
058 Welschnofen,24,,11,8,19
058 Welschnofen,25,,7,12,19
058 Welschnofen,26,,13,12,25
058 Welschnofen,27,,6,6,12
058 Welschnofen,28,,12,13,25
058 Welschnofen,29,,13,13,26
058 Welschnofen,30,,14,15,29
058 Welschnofen,31,,13,11,24
058 Welschnofen,32,,9,9,18
058 Welschnofen,33,,13,14,27
058 Welschnofen,34,,15,14,29
058 Welschnofen,35,,17,10,27
058 Welschnofen,36,,19,13,32
058 Welschnofen,37,,12,16,28
058 Welschnofen,38,,16,19,35
058 Welschnofen,39,,12,13,25
058 Welschnofen,40,,18,19,37
058 Welschnofen,41,,21,14,35
058 Welschnofen,42,,15,14,29
058 Welschnofen,43,,19,19,38
058 Welschnofen,44,,16,15,31
058 Welschnofen,45,,16,13,29
058 Welschnofen,46,,23,13,36
058 Welschnofen,47,,14,8,22
058 Welschnofen,48,,19,14,33
058 Welschnofen,49,,14,14,28
058 Welschnofen,50,,17,18,35
058 Welschnofen,51,,18,10,28
058 Welschnofen,52,,14,12,26
058 Welschnofen,53,,16,10,26
058 Welschnofen,54,,10,17,27
058 Welschnofen,55,,11,11,22
058 Welschnofen,56,,15,13,28
058 Welschnofen,57,,13,10,23
058 Welschnofen,58,,11,11,22
058 Welschnofen,59,,11,9,20
058 Welschnofen,60,,14,7,21
058 Welschnofen,61,,8,9,17
058 Welschnofen,62,,10,13,23
058 Welschnofen,63,,8,10,18
058 Welschnofen,64,,9,6,15
058 Welschnofen,65,,11,10,21
058 Welschnofen,66,,13,4,17
058 Welschnofen,67,,6,9,15
058 Welschnofen,68,,12,8,20
058 Welschnofen,69,,10,12,22
058 Welschnofen,70,,10,6,16
058 Welschnofen,71,,6,7,13
058 Welschnofen,72,,8,6,14
058 Welschnofen,73,,6,6,12
058 Welschnofen,74,,8,3,11
058 Welschnofen,75,,5,12,17
058 Welschnofen,76,,7,6,13
058 Welschnofen,77,,8,10,18
058 Welschnofen,78,,6,13,19
058 Welschnofen,79,,7,6,13
058 Welschnofen,80,,3,7,10
058 Welschnofen,81,,3,8,11
058 Welschnofen,82,,2,13,15
058 Welschnofen,83,,6,2,8
058 Welschnofen,84,,2,3,5
058 Welschnofen,85,,1,5,6
058 Welschnofen,86,,4,4,8
058 Welschnofen,87,,2,5,7
058 Welschnofen,88,,3,5,8
058 Welschnofen,89,,4,4,8
058 Welschnofen,90,,-,7,7
058 Welschnofen,91,,1,2,3
058 Welschnofen,92,,1,2,3
058 Welschnofen,95,,-,2,2
058 Welschnofen,99,,-,1,1
059 Deutschnofen,0,,14,21,35
059 Deutschnofen,1,,21,18,39
059 Deutschnofen,2,,30,19,49
059 Deutschnofen,3,,20,21,41
059 Deutschnofen,4,,17,16,33
059 Deutschnofen,5,,19,25,44
059 Deutschnofen,6,,29,33,62
059 Deutschnofen,7,,18,31,49
059 Deutschnofen,8,,18,35,53
059 Deutschnofen,9,,32,13,45
059 Deutschnofen,10,,23,33,56
059 Deutschnofen,11,,24,26,50
059 Deutschnofen,12,,30,24,54
059 Deutschnofen,13,,33,12,45
059 Deutschnofen,14,,23,31,54
059 Deutschnofen,15,,20,29,49
059 Deutschnofen,16,,27,25,52
059 Deutschnofen,17,,28,15,43
059 Deutschnofen,18,,25,26,51
059 Deutschnofen,19,,35,28,63
059 Deutschnofen,20,,23,21,44
059 Deutschnofen,21,,35,30,65
059 Deutschnofen,22,,27,22,49
059 Deutschnofen,23,,20,35,55
059 Deutschnofen,24,,25,28,53
059 Deutschnofen,25,,31,19,50
059 Deutschnofen,26,,27,26,53
059 Deutschnofen,27,,34,31,65
059 Deutschnofen,28,,26,24,50
059 Deutschnofen,29,,21,32,53
059 Deutschnofen,30,,24,19,43
059 Deutschnofen,31,,29,28,57
059 Deutschnofen,32,,22,23,45
059 Deutschnofen,33,,23,22,45
059 Deutschnofen,34,,36,25,61
059 Deutschnofen,35,,22,22,44
059 Deutschnofen,36,,22,24,46
059 Deutschnofen,37,,29,33,62
059 Deutschnofen,38,,23,31,54
059 Deutschnofen,39,,29,36,65
059 Deutschnofen,40,,29,25,54
059 Deutschnofen,41,,32,31,63
059 Deutschnofen,42,,43,28,71
059 Deutschnofen,43,,25,34,59
059 Deutschnofen,44,,29,28,57
059 Deutschnofen,45,,33,35,68
059 Deutschnofen,46,,35,22,57
059 Deutschnofen,47,,31,31,62
059 Deutschnofen,48,,34,26,60
059 Deutschnofen,49,,25,28,53
059 Deutschnofen,50,,35,22,57
059 Deutschnofen,51,,43,27,70
059 Deutschnofen,52,,31,18,49
059 Deutschnofen,53,,21,28,49
059 Deutschnofen,54,,20,24,44
059 Deutschnofen,55,,30,28,58
059 Deutschnofen,56,,30,21,51
059 Deutschnofen,57,,29,22,51
059 Deutschnofen,58,,22,22,44
059 Deutschnofen,59,,24,21,45
059 Deutschnofen,60,,21,15,36
059 Deutschnofen,61,,18,19,37
059 Deutschnofen,62,,19,15,34
059 Deutschnofen,63,,23,17,40
059 Deutschnofen,64,,13,12,25
059 Deutschnofen,65,,16,21,37
059 Deutschnofen,66,,16,14,30
059 Deutschnofen,67,,16,15,31
059 Deutschnofen,68,,21,22,43
059 Deutschnofen,69,,16,18,34
059 Deutschnofen,70,,17,25,42
059 Deutschnofen,71,,14,16,30
059 Deutschnofen,72,,23,14,37
059 Deutschnofen,73,,14,19,33
059 Deutschnofen,74,,11,7,18
059 Deutschnofen,75,,13,10,23
059 Deutschnofen,76,,8,11,19
059 Deutschnofen,77,,13,10,23
059 Deutschnofen,78,,6,13,19
059 Deutschnofen,79,,13,14,27
059 Deutschnofen,80,,7,9,16
059 Deutschnofen,81,,6,9,15
059 Deutschnofen,82,,6,4,10
059 Deutschnofen,83,,5,19,24
059 Deutschnofen,84,,6,11,17
059 Deutschnofen,85,,8,8,16
059 Deutschnofen,86,,3,16,19
059 Deutschnofen,87,,1,9,10
059 Deutschnofen,88,,2,6,8
059 Deutschnofen,89,,4,6,10
059 Deutschnofen,90,,2,6,8
059 Deutschnofen,91,,1,4,5
059 Deutschnofen,92,,1,1,2
059 Deutschnofen,93,,-,2,2
059 Deutschnofen,94,,-,2,2
059 Deutschnofen,95,,1,1,2
059 Deutschnofen,96,,1,1,2
059 Deutschnofen,97,,-,2,2
059 Deutschnofen,98,,-,2,2
059 Deutschnofen,100,,-,1,1
059 Deutschnofen,101,,1,-,1
060 Auer,0,,21,21,42
060 Auer,1,,22,12,34
060 Auer,2,,22,27,49
060 Auer,3,,9,21,30
060 Auer,4,,21,11,32
060 Auer,5,,14,15,29
060 Auer,6,,26,23,49
060 Auer,7,,22,19,41
060 Auer,8,,21,14,35
060 Auer,9,,30,17,47
060 Auer,10,,18,26,44
060 Auer,11,,21,22,43
060 Auer,12,,18,24,42
060 Auer,13,,23,24,47
060 Auer,14,,20,17,37
060 Auer,15,,21,21,42
060 Auer,16,,17,17,34
060 Auer,17,,25,23,48
060 Auer,18,,12,21,33
060 Auer,19,,18,21,39
060 Auer,20,,27,16,43
060 Auer,21,,16,20,36
060 Auer,22,,20,28,48
060 Auer,23,,21,26,47
060 Auer,24,,24,20,44
060 Auer,25,,18,16,34
060 Auer,26,,22,25,47
060 Auer,27,,20,22,42
060 Auer,28,,19,19,38
060 Auer,29,,26,28,54
060 Auer,30,,22,20,42
060 Auer,31,,20,19,39
060 Auer,32,,25,20,45
060 Auer,33,,14,22,36
060 Auer,34,,19,34,53
060 Auer,35,,24,29,53
060 Auer,36,,23,17,40
060 Auer,37,,32,26,58
060 Auer,38,,27,27,54
060 Auer,39,,19,24,43
060 Auer,40,,45,28,73
060 Auer,41,,30,28,58
060 Auer,42,,22,32,54
060 Auer,43,,32,36,68
060 Auer,44,,26,28,54
060 Auer,45,,39,46,85
060 Auer,46,,35,27,62
060 Auer,47,,31,23,54
060 Auer,48,,32,40,72
060 Auer,49,,26,20,46
060 Auer,50,,33,33,66
060 Auer,51,,28,33,61
060 Auer,52,,36,31,67
060 Auer,53,,35,25,60
060 Auer,54,,19,25,44
060 Auer,55,,29,32,61
060 Auer,56,,11,22,33
060 Auer,57,,22,14,36
060 Auer,58,,17,25,42
060 Auer,59,,16,22,38
060 Auer,60,,15,18,33
060 Auer,61,,17,20,37
060 Auer,62,,15,13,28
060 Auer,63,,29,15,44
060 Auer,64,,17,19,36
060 Auer,65,,15,25,40
060 Auer,66,,13,13,26
060 Auer,67,,21,16,37
060 Auer,68,,13,16,29
060 Auer,69,,14,19,33
060 Auer,70,,19,13,32
060 Auer,71,,10,9,19
060 Auer,72,,12,20,32
060 Auer,73,,16,17,33
060 Auer,74,,8,10,18
060 Auer,75,,11,7,18
060 Auer,76,,9,15,24
060 Auer,77,,14,12,26
060 Auer,78,,3,8,11
060 Auer,79,,3,15,18
060 Auer,80,,7,9,16
060 Auer,81,,6,6,12
060 Auer,82,,8,10,18
060 Auer,83,,9,6,15
060 Auer,84,,5,14,19
060 Auer,85,,-,15,15
060 Auer,86,,8,8,16
060 Auer,87,,5,7,12
060 Auer,88,,6,7,13
060 Auer,89,,1,8,9
060 Auer,90,,-,4,4
060 Auer,91,,2,5,7
060 Auer,92,,2,2,4
060 Auer,93,,-,3,3
060 Auer,94,,-,2,2
060 Auer,95,,-,1,1
060 Auer,98,,1,1,2
061 St.Ulrich,0,,26,30,56
061 St.Ulrich,1,,21,23,44
061 St.Ulrich,2,,27,20,47
061 St.Ulrich,3,,34,23,57
061 St.Ulrich,4,,33,32,65
061 St.Ulrich,5,,36,26,62
061 St.Ulrich,6,,32,21,53
061 St.Ulrich,7,,23,32,55
061 St.Ulrich,8,,23,33,56
061 St.Ulrich,9,,25,37,62
061 St.Ulrich,10,,21,22,43
061 St.Ulrich,11,,31,35,66
061 St.Ulrich,12,,44,32,76
061 St.Ulrich,13,,47,37,84
061 St.Ulrich,14,,33,27,60
061 St.Ulrich,15,,31,24,55
061 St.Ulrich,16,,32,30,62
061 St.Ulrich,17,,28,30,58
061 St.Ulrich,18,,23,30,53
061 St.Ulrich,19,,35,30,65
061 St.Ulrich,20,,33,31,64
061 St.Ulrich,21,,26,25,51
061 St.Ulrich,22,,17,21,38
061 St.Ulrich,23,,17,24,41
061 St.Ulrich,24,,27,19,46
061 St.Ulrich,25,,22,21,43
061 St.Ulrich,26,,20,18,38
061 St.Ulrich,27,,20,21,41
061 St.Ulrich,28,,14,17,31
061 St.Ulrich,29,,22,35,57
061 St.Ulrich,30,,27,32,59
061 St.Ulrich,31,,21,39,60
061 St.Ulrich,32,,31,33,64
061 St.Ulrich,33,,23,28,51
061 St.Ulrich,34,,22,21,43
061 St.Ulrich,35,,37,34,71
061 St.Ulrich,36,,41,26,67
061 St.Ulrich,37,,35,34,69
061 St.Ulrich,38,,37,29,66
061 St.Ulrich,39,,40,33,73
061 St.Ulrich,40,,38,39,77
061 St.Ulrich,41,,33,34,67
061 St.Ulrich,42,,41,45,86
061 St.Ulrich,43,,41,47,88
061 St.Ulrich,44,,39,40,79
061 St.Ulrich,45,,33,38,71
061 St.Ulrich,46,,39,33,72
061 St.Ulrich,47,,37,41,78
061 St.Ulrich,48,,37,33,70
061 St.Ulrich,49,,30,34,64
061 St.Ulrich,50,,26,23,49
061 St.Ulrich,51,,33,28,61
061 St.Ulrich,52,,37,26,63
061 St.Ulrich,53,,25,18,43
061 St.Ulrich,54,,24,30,54
061 St.Ulrich,55,,18,29,47
061 St.Ulrich,56,,26,36,62
061 St.Ulrich,57,,27,33,60
061 St.Ulrich,58,,27,22,49
061 St.Ulrich,59,,13,30,43
061 St.Ulrich,60,,25,24,49
061 St.Ulrich,61,,20,26,46
061 St.Ulrich,62,,15,29,44
061 St.Ulrich,63,,29,28,57
061 St.Ulrich,64,,21,24,45
061 St.Ulrich,65,,32,24,56
061 St.Ulrich,66,,17,17,34
061 St.Ulrich,67,,28,33,61
061 St.Ulrich,68,,35,36,71
061 St.Ulrich,69,,28,34,62
061 St.Ulrich,70,,33,42,75
061 St.Ulrich,71,,27,27,54
061 St.Ulrich,72,,16,18,34
061 St.Ulrich,73,,21,23,44
061 St.Ulrich,74,,20,25,45
061 St.Ulrich,75,,21,16,37
061 St.Ulrich,76,,12,23,35
061 St.Ulrich,77,,16,9,25
061 St.Ulrich,78,,15,12,27
061 St.Ulrich,79,,13,20,33
061 St.Ulrich,80,,15,13,28
061 St.Ulrich,81,,16,8,24
061 St.Ulrich,82,,10,4,14
061 St.Ulrich,83,,11,11,22
061 St.Ulrich,84,,11,10,21
061 St.Ulrich,85,,5,12,17
061 St.Ulrich,86,,8,7,15
061 St.Ulrich,87,,3,12,15
061 St.Ulrich,88,,-,13,13
061 St.Ulrich,89,,3,9,12
061 St.Ulrich,90,,4,10,14
061 St.Ulrich,91,,3,8,11
061 St.Ulrich,92,,1,4,5
061 St.Ulrich,93,,1,4,5
061 St.Ulrich,95,,-,1,1
061 St.Ulrich,96,,1,3,4
061 St.Ulrich,97,,1,1,2
061 St.Ulrich,98,,-,3,3
061 St.Ulrich,99,,-,1,1
061 St.Ulrich,100,,-,1,1
062 Partschins,0,,18,15,33
062 Partschins,1,,20,17,37
062 Partschins,2,,18,16,34
062 Partschins,3,,22,13,35
062 Partschins,4,,17,19,36
062 Partschins,5,,16,17,33
062 Partschins,6,,19,24,43
062 Partschins,7,,15,23,38
062 Partschins,8,,24,17,41
062 Partschins,9,,26,19,45
062 Partschins,10,,13,16,29
062 Partschins,11,,22,16,38
062 Partschins,12,,14,19,33
062 Partschins,13,,20,10,30
062 Partschins,14,,24,23,47
062 Partschins,15,,13,18,31
062 Partschins,16,,25,17,42
062 Partschins,17,,22,20,42
062 Partschins,18,,26,18,44
062 Partschins,19,,25,17,42
062 Partschins,20,,26,30,56
062 Partschins,21,,21,25,46
062 Partschins,22,,11,27,38
062 Partschins,23,,17,28,45
062 Partschins,24,,17,17,34
062 Partschins,25,,25,18,43
062 Partschins,26,,14,15,29
062 Partschins,27,,19,25,44
062 Partschins,28,,14,23,37
062 Partschins,29,,17,23,40
062 Partschins,30,,24,29,53
062 Partschins,31,,28,27,55
062 Partschins,32,,21,25,46
062 Partschins,33,,21,13,34
062 Partschins,34,,25,19,44
062 Partschins,35,,20,18,38
062 Partschins,36,,30,17,47
062 Partschins,37,,33,26,59
062 Partschins,38,,32,28,60
062 Partschins,39,,29,28,57
062 Partschins,40,,24,35,59
062 Partschins,41,,26,33,59
062 Partschins,42,,38,30,68
062 Partschins,43,,25,35,60
062 Partschins,44,,35,27,62
062 Partschins,45,,37,37,74
062 Partschins,46,,28,28,56
062 Partschins,47,,30,38,68
062 Partschins,48,,36,25,61
062 Partschins,49,,34,23,57
062 Partschins,50,,22,23,45
062 Partschins,51,,28,39,67
062 Partschins,52,,29,24,53
062 Partschins,53,,20,19,39
062 Partschins,54,,23,26,49
062 Partschins,55,,23,20,43
062 Partschins,56,,27,22,49
062 Partschins,57,,14,29,43
062 Partschins,58,,20,19,39
062 Partschins,59,,14,15,29
062 Partschins,60,,19,18,37
062 Partschins,61,,20,22,42
062 Partschins,62,,9,13,22
062 Partschins,63,,17,19,36
062 Partschins,64,,16,18,34
062 Partschins,65,,25,26,51
062 Partschins,66,,12,17,29
062 Partschins,67,,19,15,34
062 Partschins,68,,21,24,45
062 Partschins,69,,12,17,29
062 Partschins,70,,24,28,52
062 Partschins,71,,13,13,26
062 Partschins,72,,12,13,25
062 Partschins,73,,16,14,30
062 Partschins,74,,14,16,30
062 Partschins,75,,13,16,29
062 Partschins,76,,9,9,18
062 Partschins,77,,9,16,25
062 Partschins,78,,8,16,24
062 Partschins,79,,13,10,23
062 Partschins,80,,12,17,29
062 Partschins,81,,9,9,18
062 Partschins,82,,11,7,18
062 Partschins,83,,8,7,15
062 Partschins,84,,10,10,20
062 Partschins,85,,6,8,14
062 Partschins,86,,4,9,13
062 Partschins,87,,3,9,12
062 Partschins,88,,5,7,12
062 Partschins,89,,3,4,7
062 Partschins,90,,7,4,11
062 Partschins,91,,-,3,3
062 Partschins,92,,2,4,6
062 Partschins,93,,1,-,1
062 Partschins,94,,-,2,2
062 Partschins,95,,-,1,1
062 Partschins,96,,-,1,1
062 Partschins,97,,-,1,1
062 Partschins,98,,-,1,1
063 Percha,0,,5,11,16
063 Percha,1,,5,13,18
063 Percha,2,,11,7,18
063 Percha,3,,8,9,17
063 Percha,4,,11,7,18
063 Percha,5,,3,3,6
063 Percha,6,,6,11,17
063 Percha,7,,10,16,26
063 Percha,8,,9,7,16
063 Percha,9,,10,7,17
063 Percha,10,,4,6,10
063 Percha,11,,10,9,19
063 Percha,12,,6,8,14
063 Percha,13,,8,8,16
063 Percha,14,,12,15,27
063 Percha,15,,9,5,14
063 Percha,16,,7,8,15
063 Percha,17,,9,11,20
063 Percha,18,,7,8,15
063 Percha,19,,12,7,19
063 Percha,20,,10,10,20
063 Percha,21,,8,8,16
063 Percha,22,,6,11,17
063 Percha,23,,6,5,11
063 Percha,24,,9,19,28
063 Percha,25,,5,10,15
063 Percha,26,,7,12,19
063 Percha,27,,16,5,21
063 Percha,28,,17,12,29
063 Percha,29,,6,14,20
063 Percha,30,,11,8,19
063 Percha,31,,12,8,20
063 Percha,32,,7,13,20
063 Percha,33,,13,13,26
063 Percha,34,,9,7,16
063 Percha,35,,12,16,28
063 Percha,36,,8,12,20
063 Percha,37,,9,13,22
063 Percha,38,,15,12,27
063 Percha,39,,13,10,23
063 Percha,40,,20,18,38
063 Percha,41,,9,11,20
063 Percha,42,,20,14,34
063 Percha,43,,17,15,32
063 Percha,44,,9,9,18
063 Percha,45,,20,6,26
063 Percha,46,,15,19,34
063 Percha,47,,15,7,22
063 Percha,48,,11,15,26
063 Percha,49,,17,10,27
063 Percha,50,,9,13,22
063 Percha,51,,12,6,18
063 Percha,52,,6,10,16
063 Percha,53,,10,8,18
063 Percha,54,,9,5,14
063 Percha,55,,7,14,21
063 Percha,56,,9,9,18
063 Percha,57,,5,6,11
063 Percha,58,,8,6,14
063 Percha,59,,5,9,14
063 Percha,60,,7,7,14
063 Percha,61,,6,7,13
063 Percha,62,,9,5,14
063 Percha,63,,5,5,10
063 Percha,64,,5,6,11
063 Percha,65,,7,8,15
063 Percha,66,,9,5,14
063 Percha,67,,12,4,16
063 Percha,68,,7,8,15
063 Percha,69,,8,7,15
063 Percha,70,,6,7,13
063 Percha,71,,4,5,9
063 Percha,72,,7,5,12
063 Percha,73,,5,9,14
063 Percha,74,,2,5,7
063 Percha,75,,3,1,4
063 Percha,76,,3,4,7
063 Percha,77,,6,5,11
063 Percha,78,,4,5,9
063 Percha,79,,4,3,7
063 Percha,80,,5,1,6
063 Percha,81,,6,2,8
063 Percha,82,,-,3,3
063 Percha,83,,2,2,4
063 Percha,84,,4,2,6
063 Percha,85,,2,5,7
063 Percha,86,,2,4,6
063 Percha,87,,-,1,1
063 Percha,88,,1,2,3
063 Percha,89,,1,-,1
063 Percha,97,,-,1,1
064 Plaus,0,,5,1,6
064 Plaus,1,,6,4,10
064 Plaus,2,,4,4,8
064 Plaus,3,,4,4,8
064 Plaus,4,,5,4,9
064 Plaus,5,,4,1,5
064 Plaus,6,,4,1,5
064 Plaus,7,,5,3,8
064 Plaus,8,,3,4,7
064 Plaus,9,,5,7,12
064 Plaus,10,,8,4,12
064 Plaus,11,,11,5,16
064 Plaus,12,,12,7,19
064 Plaus,13,,6,7,13
064 Plaus,14,,7,5,12
064 Plaus,15,,4,3,7
064 Plaus,16,,2,2,4
064 Plaus,17,,7,1,8
064 Plaus,18,,10,4,14
064 Plaus,19,,7,7,14
064 Plaus,20,,3,9,12
064 Plaus,21,,4,3,7
064 Plaus,22,,5,5,10
064 Plaus,23,,5,3,8
064 Plaus,24,,5,2,7
064 Plaus,25,,1,5,6
064 Plaus,26,,2,5,7
064 Plaus,27,,6,2,8
064 Plaus,28,,1,3,4
064 Plaus,29,,-,4,4
064 Plaus,30,,2,7,9
064 Plaus,31,,7,4,11
064 Plaus,32,,4,5,9
064 Plaus,33,,3,4,7
064 Plaus,34,,1,8,9
064 Plaus,35,,5,3,8
064 Plaus,36,,13,5,18
064 Plaus,37,,5,11,16
064 Plaus,38,,10,5,15
064 Plaus,39,,7,6,13
064 Plaus,40,,6,8,14
064 Plaus,41,,7,4,11
064 Plaus,42,,7,10,17
064 Plaus,43,,5,8,13
064 Plaus,44,,9,10,19
064 Plaus,45,,4,5,9
064 Plaus,46,,14,3,17
064 Plaus,47,,6,9,15
064 Plaus,48,,2,4,6
064 Plaus,49,,10,5,15
064 Plaus,50,,7,3,10
064 Plaus,51,,2,8,10
064 Plaus,52,,7,1,8
064 Plaus,53,,3,3,6
064 Plaus,54,,2,3,5
064 Plaus,55,,3,2,5
064 Plaus,56,,2,5,7
064 Plaus,57,,1,1,2
064 Plaus,58,,3,5,8
064 Plaus,59,,4,2,6
064 Plaus,60,,4,3,7
064 Plaus,61,,2,2,4
064 Plaus,62,,5,3,8
064 Plaus,63,,1,4,5
064 Plaus,64,,2,4,6
064 Plaus,65,,5,1,6
064 Plaus,66,,4,1,5
064 Plaus,67,,3,2,5
064 Plaus,68,,5,1,6
064 Plaus,69,,1,4,5
064 Plaus,70,,3,2,5
064 Plaus,71,,3,1,4
064 Plaus,72,,4,2,6
064 Plaus,73,,1,1,2
064 Plaus,74,,3,3,6
064 Plaus,76,,1,2,3
064 Plaus,77,,4,1,5
064 Plaus,78,,2,3,5
064 Plaus,79,,2,3,5
064 Plaus,80,,-,1,1
064 Plaus,82,,1,1,2
064 Plaus,83,,-,1,1
064 Plaus,84,,1,1,2
064 Plaus,85,,-,1,1
064 Plaus,86,,1,-,1
064 Plaus,87,,-,3,3
064 Plaus,88,,-,1,1
064 Plaus,92,,-,1,1
064 Plaus,96,,-,1,1
065 Waidbruck,0,,2,3,5
065 Waidbruck,2,,2,3,5
065 Waidbruck,4,,2,-,2
065 Waidbruck,5,,3,-,3
065 Waidbruck,7,,1,1,2
065 Waidbruck,8,,-,2,2
065 Waidbruck,9,,1,1,2
065 Waidbruck,10,,1,-,1
065 Waidbruck,11,,1,2,3
065 Waidbruck,12,,2,1,3
065 Waidbruck,14,,4,3,7
065 Waidbruck,15,,4,1,5
065 Waidbruck,16,,1,2,3
065 Waidbruck,17,,3,2,5
065 Waidbruck,18,,1,1,2
065 Waidbruck,19,,-,4,4
065 Waidbruck,20,,1,-,1
065 Waidbruck,21,,-,2,2
065 Waidbruck,22,,3,1,4
065 Waidbruck,23,,-,1,1
065 Waidbruck,24,,2,-,2
065 Waidbruck,25,,-,2,2
065 Waidbruck,26,,2,1,3
065 Waidbruck,27,,2,1,3
065 Waidbruck,28,,2,-,2
065 Waidbruck,29,,1,-,1
065 Waidbruck,30,,3,2,5
065 Waidbruck,31,,1,1,2
065 Waidbruck,33,,5,-,5
065 Waidbruck,34,,-,1,1
065 Waidbruck,36,,1,1,2
065 Waidbruck,37,,3,2,5
065 Waidbruck,38,,-,1,1
065 Waidbruck,39,,-,2,2
065 Waidbruck,40,,2,-,2
065 Waidbruck,41,,1,2,3
065 Waidbruck,42,,4,2,6
065 Waidbruck,43,,2,1,3
065 Waidbruck,44,,2,4,6
065 Waidbruck,45,,3,3,6
065 Waidbruck,46,,3,1,4
065 Waidbruck,47,,3,-,3
065 Waidbruck,48,,-,2,2
065 Waidbruck,49,,1,-,1
065 Waidbruck,50,,1,2,3
065 Waidbruck,51,,3,1,4
065 Waidbruck,52,,2,1,3
065 Waidbruck,53,,-,1,1
065 Waidbruck,54,,3,1,4
065 Waidbruck,55,,2,-,2
065 Waidbruck,56,,3,-,3
065 Waidbruck,59,,1,1,2
065 Waidbruck,60,,-,1,1
065 Waidbruck,65,,-,3,3
065 Waidbruck,66,,1,1,2
065 Waidbruck,67,,2,1,3
065 Waidbruck,69,,1,1,2
065 Waidbruck,70,,-,2,2
065 Waidbruck,71,,-,3,3
065 Waidbruck,72,,1,-,1
065 Waidbruck,73,,-,2,2
065 Waidbruck,74,,1,-,1
065 Waidbruck,75,,2,1,3
065 Waidbruck,76,,-,3,3
065 Waidbruck,77,,1,1,2
065 Waidbruck,78,,1,-,1
065 Waidbruck,79,,-,3,3
065 Waidbruck,80,,1,-,1
065 Waidbruck,81,,1,-,1
065 Waidbruck,82,,-,2,2
065 Waidbruck,83,,1,-,1
065 Waidbruck,84,,2,1,3
065 Waidbruck,85,,-,1,1
065 Waidbruck,86,,1,-,1
065 Waidbruck,88,,-,2,2
065 Waidbruck,91,,-,1,1
065 Waidbruck,92,,-,1,1
066 Burgstall,0,,12,17,29
066 Burgstall,1,,11,14,25
066 Burgstall,2,,18,6,24
066 Burgstall,3,,14,15,29
066 Burgstall,4,,13,6,19
066 Burgstall,5,,7,11,18
066 Burgstall,6,,5,7,12
066 Burgstall,7,,14,7,21
066 Burgstall,8,,7,11,18
066 Burgstall,9,,7,12,19
066 Burgstall,10,,10,8,18
066 Burgstall,11,,11,11,22
066 Burgstall,12,,9,8,17
066 Burgstall,13,,9,8,17
066 Burgstall,14,,10,6,16
066 Burgstall,15,,6,7,13
066 Burgstall,16,,12,6,18
066 Burgstall,17,,6,4,10
066 Burgstall,18,,7,10,17
066 Burgstall,19,,5,7,12
066 Burgstall,20,,7,10,17
066 Burgstall,21,,13,10,23
066 Burgstall,22,,14,5,19
066 Burgstall,23,,7,11,18
066 Burgstall,24,,8,11,19
066 Burgstall,25,,10,7,17
066 Burgstall,26,,8,12,20
066 Burgstall,27,,8,15,23
066 Burgstall,28,,12,16,28
066 Burgstall,29,,10,12,22
066 Burgstall,30,,7,11,18
066 Burgstall,31,,13,12,25
066 Burgstall,32,,16,10,26
066 Burgstall,33,,6,11,17
066 Burgstall,34,,11,18,29
066 Burgstall,35,,8,11,19
066 Burgstall,36,,21,15,36
066 Burgstall,37,,9,14,23
066 Burgstall,38,,12,19,31
066 Burgstall,39,,13,20,33
066 Burgstall,40,,17,14,31
066 Burgstall,41,,20,15,35
066 Burgstall,42,,17,11,28
066 Burgstall,43,,21,17,38
066 Burgstall,44,,12,13,25
066 Burgstall,45,,16,19,35
066 Burgstall,46,,18,17,35
066 Burgstall,47,,14,12,26
066 Burgstall,48,,19,16,35
066 Burgstall,49,,15,12,27
066 Burgstall,50,,15,18,33
066 Burgstall,51,,15,12,27
066 Burgstall,52,,10,8,18
066 Burgstall,53,,14,9,23
066 Burgstall,54,,11,8,19
066 Burgstall,55,,12,11,23
066 Burgstall,56,,8,10,18
066 Burgstall,57,,10,17,27
066 Burgstall,58,,9,11,20
066 Burgstall,59,,12,13,25
066 Burgstall,60,,12,8,20
066 Burgstall,61,,9,10,19
066 Burgstall,62,,9,8,17
066 Burgstall,63,,7,10,17
066 Burgstall,64,,7,10,17
066 Burgstall,65,,9,9,18
066 Burgstall,66,,8,8,16
066 Burgstall,67,,8,10,18
066 Burgstall,68,,11,8,19
066 Burgstall,69,,6,5,11
066 Burgstall,70,,7,4,11
066 Burgstall,71,,4,12,16
066 Burgstall,72,,5,8,13
066 Burgstall,73,,9,12,21
066 Burgstall,74,,5,8,13
066 Burgstall,75,,4,6,10
066 Burgstall,76,,7,3,10
066 Burgstall,77,,5,8,13
066 Burgstall,78,,8,4,12
066 Burgstall,79,,2,7,9
066 Burgstall,80,,6,3,9
066 Burgstall,81,,4,5,9
066 Burgstall,82,,1,4,5
066 Burgstall,83,,3,5,8
066 Burgstall,84,,1,9,10
066 Burgstall,85,,3,8,11
066 Burgstall,86,,3,3,6
066 Burgstall,87,,1,5,6
066 Burgstall,88,,2,1,3
066 Burgstall,89,,1,4,5
066 Burgstall,91,,1,1,2
066 Burgstall,92,,-,1,1
066 Burgstall,93,,-,1,1
066 Burgstall,94,,1,-,1
066 Burgstall,96,,1,1,2
067 Prad am Stilfser Joch,0,,16,15,31
067 Prad am Stilfser Joch,1,,20,12,32
067 Prad am Stilfser Joch,2,,15,14,29
067 Prad am Stilfser Joch,3,,17,18,35
067 Prad am Stilfser Joch,4,,14,10,24
067 Prad am Stilfser Joch,5,,17,18,35
067 Prad am Stilfser Joch,6,,21,16,37
067 Prad am Stilfser Joch,7,,20,22,42
067 Prad am Stilfser Joch,8,,14,15,29
067 Prad am Stilfser Joch,9,,12,17,29
067 Prad am Stilfser Joch,10,,23,16,39
067 Prad am Stilfser Joch,11,,17,17,34
067 Prad am Stilfser Joch,12,,19,21,40
067 Prad am Stilfser Joch,13,,19,23,42
067 Prad am Stilfser Joch,14,,27,18,45
067 Prad am Stilfser Joch,15,,22,21,43
067 Prad am Stilfser Joch,16,,20,14,34
067 Prad am Stilfser Joch,17,,23,27,50
067 Prad am Stilfser Joch,18,,23,29,52
067 Prad am Stilfser Joch,19,,19,20,39
067 Prad am Stilfser Joch,20,,19,11,30
067 Prad am Stilfser Joch,21,,21,22,43
067 Prad am Stilfser Joch,22,,20,19,39
067 Prad am Stilfser Joch,23,,31,18,49
067 Prad am Stilfser Joch,24,,13,20,33
067 Prad am Stilfser Joch,25,,24,28,52
067 Prad am Stilfser Joch,26,,30,22,52
067 Prad am Stilfser Joch,27,,32,24,56
067 Prad am Stilfser Joch,28,,25,26,51
067 Prad am Stilfser Joch,29,,26,18,44
067 Prad am Stilfser Joch,30,,20,23,43
067 Prad am Stilfser Joch,31,,30,22,52
067 Prad am Stilfser Joch,32,,20,19,39
067 Prad am Stilfser Joch,33,,24,20,44
067 Prad am Stilfser Joch,34,,22,29,51
067 Prad am Stilfser Joch,35,,26,20,46
067 Prad am Stilfser Joch,36,,21,20,41
067 Prad am Stilfser Joch,37,,28,15,43
067 Prad am Stilfser Joch,38,,19,39,58
067 Prad am Stilfser Joch,39,,24,25,49
067 Prad am Stilfser Joch,40,,27,26,53
067 Prad am Stilfser Joch,41,,27,24,51
067 Prad am Stilfser Joch,42,,29,29,58
067 Prad am Stilfser Joch,43,,33,36,69
067 Prad am Stilfser Joch,44,,28,23,51
067 Prad am Stilfser Joch,45,,35,26,61
067 Prad am Stilfser Joch,46,,35,26,61
067 Prad am Stilfser Joch,47,,24,26,50
067 Prad am Stilfser Joch,48,,28,10,38
067 Prad am Stilfser Joch,49,,28,33,61
067 Prad am Stilfser Joch,50,,22,27,49
067 Prad am Stilfser Joch,51,,18,27,45
067 Prad am Stilfser Joch,52,,34,15,49
067 Prad am Stilfser Joch,53,,20,28,48
067 Prad am Stilfser Joch,54,,26,25,51
067 Prad am Stilfser Joch,55,,24,24,48
067 Prad am Stilfser Joch,56,,24,19,43
067 Prad am Stilfser Joch,57,,27,16,43
067 Prad am Stilfser Joch,58,,28,18,46
067 Prad am Stilfser Joch,59,,14,20,34
067 Prad am Stilfser Joch,60,,18,24,42
067 Prad am Stilfser Joch,61,,19,17,36
067 Prad am Stilfser Joch,62,,21,21,42
067 Prad am Stilfser Joch,63,,20,11,31
067 Prad am Stilfser Joch,64,,15,12,27
067 Prad am Stilfser Joch,65,,17,14,31
067 Prad am Stilfser Joch,66,,13,11,24
067 Prad am Stilfser Joch,67,,10,15,25
067 Prad am Stilfser Joch,68,,23,17,40
067 Prad am Stilfser Joch,69,,14,16,30
067 Prad am Stilfser Joch,70,,25,8,33
067 Prad am Stilfser Joch,71,,7,16,23
067 Prad am Stilfser Joch,72,,13,16,29
067 Prad am Stilfser Joch,73,,16,15,31
067 Prad am Stilfser Joch,74,,7,10,17
067 Prad am Stilfser Joch,75,,8,10,18
067 Prad am Stilfser Joch,76,,15,12,27
067 Prad am Stilfser Joch,77,,6,21,27
067 Prad am Stilfser Joch,78,,12,10,22
067 Prad am Stilfser Joch,79,,8,18,26
067 Prad am Stilfser Joch,80,,6,10,16
067 Prad am Stilfser Joch,81,,10,10,20
067 Prad am Stilfser Joch,82,,9,13,22
067 Prad am Stilfser Joch,83,,6,7,13
067 Prad am Stilfser Joch,84,,4,9,13
067 Prad am Stilfser Joch,85,,4,5,9
067 Prad am Stilfser Joch,86,,5,4,9
067 Prad am Stilfser Joch,87,,2,4,6
067 Prad am Stilfser Joch,88,,2,9,11
067 Prad am Stilfser Joch,89,,1,7,8
067 Prad am Stilfser Joch,90,,2,4,6
067 Prad am Stilfser Joch,91,,-,3,3
067 Prad am Stilfser Joch,92,,3,1,4
067 Prad am Stilfser Joch,93,,-,1,1
067 Prad am Stilfser Joch,95,,-,1,1
067 Prad am Stilfser Joch,96,,1,-,1
067 Prad am Stilfser Joch,97,,-,1,1
067 Prad am Stilfser Joch,99,,1,-,1
068 Prettau,0,,5,4,9
068 Prettau,1,,3,1,4
068 Prettau,2,,1,1,2
068 Prettau,3,,7,3,10
068 Prettau,4,,6,2,8
068 Prettau,5,,5,6,11
068 Prettau,6,,2,1,3
068 Prettau,7,,4,5,9
068 Prettau,8,,2,4,6
068 Prettau,9,,1,2,3
068 Prettau,10,,3,5,8
068 Prettau,11,,1,3,4
068 Prettau,12,,6,6,12
068 Prettau,13,,6,3,9
068 Prettau,14,,1,6,7
068 Prettau,15,,1,2,3
068 Prettau,16,,4,4,8
068 Prettau,17,,4,7,11
068 Prettau,18,,3,5,8
068 Prettau,19,,2,3,5
068 Prettau,20,,1,4,5
068 Prettau,21,,1,7,8
068 Prettau,22,,-,3,3
068 Prettau,23,,4,3,7
068 Prettau,24,,4,2,6
068 Prettau,25,,1,2,3
068 Prettau,26,,2,1,3
068 Prettau,27,,4,7,11
068 Prettau,28,,4,1,5
068 Prettau,29,,2,3,5
068 Prettau,30,,2,-,2
068 Prettau,31,,4,3,7
068 Prettau,32,,5,2,7
068 Prettau,33,,2,2,4
068 Prettau,34,,3,3,6
068 Prettau,35,,1,3,4
068 Prettau,36,,4,2,6
068 Prettau,37,,5,1,6
068 Prettau,38,,5,6,11
068 Prettau,39,,9,4,13
068 Prettau,40,,4,6,10
068 Prettau,41,,3,6,9
068 Prettau,42,,6,6,12
068 Prettau,43,,3,2,5
068 Prettau,44,,10,3,13
068 Prettau,45,,6,1,7
068 Prettau,46,,3,8,11
068 Prettau,47,,7,6,13
068 Prettau,48,,5,6,11
068 Prettau,49,,2,5,7
068 Prettau,50,,5,5,10
068 Prettau,51,,7,4,11
068 Prettau,52,,5,3,8
068 Prettau,53,,7,-,7
068 Prettau,54,,4,1,5
068 Prettau,55,,5,5,10
068 Prettau,56,,6,5,11
068 Prettau,57,,5,2,7
068 Prettau,58,,3,3,6
068 Prettau,59,,4,3,7
068 Prettau,60,,3,2,5
068 Prettau,61,,2,2,4
068 Prettau,62,,2,3,5
068 Prettau,63,,2,1,3
068 Prettau,64,,4,5,9
068 Prettau,65,,6,3,9
068 Prettau,66,,1,3,4
068 Prettau,67,,6,5,11
068 Prettau,68,,4,3,7
068 Prettau,69,,3,2,5
068 Prettau,70,,3,2,5
068 Prettau,71,,4,4,8
068 Prettau,72,,5,3,8
068 Prettau,73,,5,6,11
068 Prettau,74,,2,6,8
068 Prettau,75,,3,3,6
068 Prettau,76,,3,2,5
068 Prettau,77,,1,3,4
068 Prettau,78,,3,3,6
068 Prettau,79,,3,-,3
068 Prettau,80,,1,1,2
068 Prettau,81,,4,4,8
068 Prettau,82,,4,5,9
068 Prettau,83,,-,1,1
068 Prettau,84,,3,1,4
068 Prettau,85,,1,4,5
068 Prettau,86,,-,1,1
068 Prettau,88,,-,1,1
068 Prettau,89,,1,-,1
068 Prettau,90,,-,1,1
068 Prettau,93,,1,1,2
068 Prettau,98,,-,1,1
069 Proveis,0,,-,1,1
069 Proveis,1,,1,1,2
069 Proveis,2,,3,1,4
069 Proveis,3,,-,1,1
069 Proveis,4,,1,1,2
069 Proveis,5,,2,-,2
069 Proveis,6,,-,4,4
069 Proveis,7,,2,2,4
069 Proveis,8,,3,1,4
069 Proveis,9,,4,-,4
069 Proveis,10,,1,1,2
069 Proveis,11,,-,1,1
069 Proveis,12,,4,1,5
069 Proveis,13,,2,2,4
069 Proveis,14,,1,3,4
069 Proveis,15,,1,1,2
069 Proveis,16,,-,5,5
069 Proveis,17,,2,-,2
069 Proveis,18,,2,1,3
069 Proveis,19,,3,1,4
069 Proveis,20,,3,2,5
069 Proveis,21,,-,1,1
069 Proveis,22,,1,1,2
069 Proveis,23,,2,3,5
069 Proveis,24,,1,2,3
069 Proveis,25,,3,1,4
069 Proveis,26,,6,-,6
069 Proveis,27,,3,3,6
069 Proveis,28,,3,2,5
069 Proveis,29,,2,-,2
069 Proveis,30,,2,3,5
069 Proveis,32,,3,1,4
069 Proveis,33,,1,2,3
069 Proveis,34,,2,1,3
069 Proveis,35,,1,1,2
069 Proveis,36,,2,1,3
069 Proveis,37,,3,2,5
069 Proveis,38,,2,-,2
069 Proveis,39,,1,1,2
069 Proveis,40,,-,1,1
069 Proveis,41,,3,3,6
069 Proveis,42,,3,4,7
069 Proveis,43,,3,1,4
069 Proveis,44,,2,1,3
069 Proveis,45,,2,2,4
069 Proveis,46,,1,1,2
069 Proveis,47,,2,-,2
069 Proveis,48,,4,2,6
069 Proveis,49,,4,1,5
069 Proveis,50,,3,1,4
069 Proveis,51,,-,4,4
069 Proveis,52,,4,-,4
069 Proveis,53,,1,3,4
069 Proveis,54,,2,2,4
069 Proveis,55,,4,2,6
069 Proveis,56,,4,4,8
069 Proveis,57,,3,2,5
069 Proveis,58,,1,1,2
069 Proveis,59,,2,3,5
069 Proveis,60,,2,-,2
069 Proveis,61,,1,1,2
069 Proveis,62,,1,-,1
069 Proveis,63,,2,1,3
069 Proveis,64,,2,2,4
069 Proveis,65,,2,-,2
069 Proveis,66,,1,-,1
069 Proveis,67,,2,-,2
069 Proveis,68,,2,1,3
069 Proveis,69,,1,1,2
069 Proveis,70,,1,1,2
069 Proveis,71,,2,-,2
069 Proveis,72,,1,3,4
069 Proveis,73,,-,2,2
069 Proveis,74,,1,1,2
069 Proveis,75,,1,1,2
069 Proveis,76,,1,1,2
069 Proveis,78,,-,2,2
069 Proveis,79,,-,1,1
069 Proveis,80,,1,1,2
069 Proveis,82,,2,2,4
069 Proveis,83,,2,-,2
069 Proveis,84,,-,1,1
069 Proveis,87,,1,-,1
069 Proveis,89,,-,1,1
069 Proveis,91,,-,1,1
070 Ratschings,0,,21,22,43
070 Ratschings,1,,28,29,57
070 Ratschings,2,,22,22,44
070 Ratschings,3,,21,18,39
070 Ratschings,4,,29,24,53
070 Ratschings,5,,28,25,53
070 Ratschings,6,,24,29,53
070 Ratschings,7,,34,25,59
070 Ratschings,8,,35,23,58
070 Ratschings,9,,16,28,44
070 Ratschings,10,,26,35,61
070 Ratschings,11,,37,27,64
070 Ratschings,12,,29,22,51
070 Ratschings,13,,34,20,54
070 Ratschings,14,,37,34,71
070 Ratschings,15,,29,31,60
070 Ratschings,16,,27,27,54
070 Ratschings,17,,25,27,52
070 Ratschings,18,,28,21,49
070 Ratschings,19,,38,29,67
070 Ratschings,20,,25,23,48
070 Ratschings,21,,31,29,60
070 Ratschings,22,,25,21,46
070 Ratschings,23,,33,28,61
070 Ratschings,24,,28,31,59
070 Ratschings,25,,29,32,61
070 Ratschings,26,,32,34,66
070 Ratschings,27,,24,23,47
070 Ratschings,28,,33,24,57
070 Ratschings,29,,34,31,65
070 Ratschings,30,,30,25,55
070 Ratschings,31,,25,32,57
070 Ratschings,32,,35,31,66
070 Ratschings,33,,32,25,57
070 Ratschings,34,,34,28,62
070 Ratschings,35,,19,21,40
070 Ratschings,36,,42,36,78
070 Ratschings,37,,36,25,61
070 Ratschings,38,,38,37,75
070 Ratschings,39,,41,38,79
070 Ratschings,40,,40,41,81
070 Ratschings,41,,34,41,75
070 Ratschings,42,,39,43,82
070 Ratschings,43,,54,42,96
070 Ratschings,44,,33,38,71
070 Ratschings,45,,44,49,93
070 Ratschings,46,,35,43,78
070 Ratschings,47,,51,40,91
070 Ratschings,48,,46,25,71
070 Ratschings,49,,35,42,77
070 Ratschings,50,,35,26,61
070 Ratschings,51,,43,25,68
070 Ratschings,52,,40,26,66
070 Ratschings,53,,28,27,55
070 Ratschings,54,,32,19,51
070 Ratschings,55,,37,21,58
070 Ratschings,56,,13,33,46
070 Ratschings,57,,27,15,42
070 Ratschings,58,,22,24,46
070 Ratschings,59,,18,19,37
070 Ratschings,60,,19,14,33
070 Ratschings,61,,26,21,47
070 Ratschings,62,,20,24,44
070 Ratschings,63,,29,20,49
070 Ratschings,64,,16,17,33
070 Ratschings,65,,21,7,28
070 Ratschings,66,,20,18,38
070 Ratschings,67,,15,11,26
070 Ratschings,68,,16,13,29
070 Ratschings,69,,18,17,35
070 Ratschings,70,,18,17,35
070 Ratschings,71,,15,16,31
070 Ratschings,72,,11,17,28
070 Ratschings,73,,14,18,32
070 Ratschings,74,,14,9,23
070 Ratschings,75,,9,10,19
070 Ratschings,76,,12,14,26
070 Ratschings,77,,9,9,18
070 Ratschings,78,,10,18,28
070 Ratschings,79,,12,10,22
070 Ratschings,80,,8,11,19
070 Ratschings,81,,6,16,22
070 Ratschings,82,,7,18,25
070 Ratschings,83,,5,8,13
070 Ratschings,84,,5,11,16
070 Ratschings,85,,5,8,13
070 Ratschings,86,,4,6,10
070 Ratschings,87,,3,7,10
070 Ratschings,88,,3,3,6
070 Ratschings,89,,1,4,5
070 Ratschings,90,,1,5,6
070 Ratschings,91,,-,5,5
070 Ratschings,92,,1,-,1
070 Ratschings,93,,-,2,2
070 Ratschings,96,,-,1,1
071 Rasen-Antholz,0,,18,17,35
071 Rasen-Antholz,1,,13,9,22
071 Rasen-Antholz,2,,17,19,36
071 Rasen-Antholz,3,,19,7,26
071 Rasen-Antholz,4,,18,17,35
071 Rasen-Antholz,5,,16,20,36
071 Rasen-Antholz,6,,26,16,42
071 Rasen-Antholz,7,,14,23,37
071 Rasen-Antholz,8,,10,23,33
071 Rasen-Antholz,9,,13,21,34
071 Rasen-Antholz,10,,20,20,40
071 Rasen-Antholz,11,,25,21,46
071 Rasen-Antholz,12,,14,19,33
071 Rasen-Antholz,13,,21,15,36
071 Rasen-Antholz,14,,26,22,48
071 Rasen-Antholz,15,,26,18,44
071 Rasen-Antholz,16,,8,16,24
071 Rasen-Antholz,17,,20,11,31
071 Rasen-Antholz,18,,17,14,31
071 Rasen-Antholz,19,,25,20,45
071 Rasen-Antholz,20,,15,15,30
071 Rasen-Antholz,21,,14,22,36
071 Rasen-Antholz,22,,18,17,35
071 Rasen-Antholz,23,,18,20,38
071 Rasen-Antholz,24,,27,11,38
071 Rasen-Antholz,25,,16,22,38
071 Rasen-Antholz,26,,26,14,40
071 Rasen-Antholz,27,,22,21,43
071 Rasen-Antholz,28,,14,17,31
071 Rasen-Antholz,29,,22,20,42
071 Rasen-Antholz,30,,15,16,31
071 Rasen-Antholz,31,,18,13,31
071 Rasen-Antholz,32,,20,24,44
071 Rasen-Antholz,33,,17,24,41
071 Rasen-Antholz,34,,16,16,32
071 Rasen-Antholz,35,,23,12,35
071 Rasen-Antholz,36,,17,26,43
071 Rasen-Antholz,37,,27,20,47
071 Rasen-Antholz,38,,30,24,54
071 Rasen-Antholz,39,,22,20,42
071 Rasen-Antholz,40,,24,23,47
071 Rasen-Antholz,41,,25,23,48
071 Rasen-Antholz,42,,26,25,51
071 Rasen-Antholz,43,,24,27,51
071 Rasen-Antholz,44,,27,28,55
071 Rasen-Antholz,45,,29,21,50
071 Rasen-Antholz,46,,33,23,56
071 Rasen-Antholz,47,,31,22,53
071 Rasen-Antholz,48,,18,21,39
071 Rasen-Antholz,49,,28,19,47
071 Rasen-Antholz,50,,19,25,44
071 Rasen-Antholz,51,,21,23,44
071 Rasen-Antholz,52,,27,18,45
071 Rasen-Antholz,53,,24,15,39
071 Rasen-Antholz,54,,21,9,30
071 Rasen-Antholz,55,,19,14,33
071 Rasen-Antholz,56,,19,14,33
071 Rasen-Antholz,57,,14,14,28
071 Rasen-Antholz,58,,14,9,23
071 Rasen-Antholz,59,,12,15,27
071 Rasen-Antholz,60,,11,11,22
071 Rasen-Antholz,61,,13,8,21
071 Rasen-Antholz,62,,14,9,23
071 Rasen-Antholz,63,,14,10,24
071 Rasen-Antholz,64,,10,14,24
071 Rasen-Antholz,65,,9,14,23
071 Rasen-Antholz,66,,11,9,20
071 Rasen-Antholz,67,,9,8,17
071 Rasen-Antholz,68,,13,12,25
071 Rasen-Antholz,69,,10,13,23
071 Rasen-Antholz,70,,14,12,26
071 Rasen-Antholz,71,,9,16,25
071 Rasen-Antholz,72,,15,13,28
071 Rasen-Antholz,73,,13,7,20
071 Rasen-Antholz,74,,7,10,17
071 Rasen-Antholz,75,,9,12,21
071 Rasen-Antholz,76,,7,9,16
071 Rasen-Antholz,77,,10,10,20
071 Rasen-Antholz,78,,7,14,21
071 Rasen-Antholz,79,,8,11,19
071 Rasen-Antholz,80,,11,14,25
071 Rasen-Antholz,81,,4,9,13
071 Rasen-Antholz,82,,8,3,11
071 Rasen-Antholz,83,,2,3,5
071 Rasen-Antholz,84,,4,5,9
071 Rasen-Antholz,85,,3,6,9
071 Rasen-Antholz,86,,6,6,12
071 Rasen-Antholz,87,,4,5,9
071 Rasen-Antholz,88,,-,6,6
071 Rasen-Antholz,89,,1,4,5
071 Rasen-Antholz,90,,4,1,5
071 Rasen-Antholz,91,,1,2,3
071 Rasen-Antholz,92,,-,3,3
071 Rasen-Antholz,93,,-,1,1
071 Rasen-Antholz,94,,-,2,2
071 Rasen-Antholz,95,,-,1,1
071 Rasen-Antholz,96,,1,-,1
071 Rasen-Antholz,97,,1,-,1
072 Ritten,0,,45,43,88
072 Ritten,1,,48,41,89
072 Ritten,2,,41,47,88
072 Ritten,3,,38,57,95
072 Ritten,4,,47,52,99
072 Ritten,5,,58,48,106
072 Ritten,6,,47,51,98
072 Ritten,7,,49,53,102
072 Ritten,8,,46,40,86
072 Ritten,9,,36,53,89
072 Ritten,10,,49,45,94
072 Ritten,11,,46,45,91
072 Ritten,12,,53,54,107
072 Ritten,13,,41,43,84
072 Ritten,14,,58,55,113
072 Ritten,15,,41,50,91
072 Ritten,16,,57,41,98
072 Ritten,17,,61,47,108
072 Ritten,18,,57,48,105
072 Ritten,19,,47,69,116
072 Ritten,20,,64,51,115
072 Ritten,21,,62,48,110
072 Ritten,22,,54,40,94
072 Ritten,23,,55,50,105
072 Ritten,24,,50,39,89
072 Ritten,25,,50,47,97
072 Ritten,26,,47,58,105
072 Ritten,27,,48,23,71
072 Ritten,28,,49,54,103
072 Ritten,29,,38,53,91
072 Ritten,30,,51,53,104
072 Ritten,31,,47,50,97
072 Ritten,32,,49,52,101
072 Ritten,33,,46,45,91
072 Ritten,34,,64,35,99
072 Ritten,35,,46,55,101
072 Ritten,36,,57,50,107
072 Ritten,37,,59,64,123
072 Ritten,38,,59,49,108
072 Ritten,39,,54,64,118
072 Ritten,40,,56,66,122
072 Ritten,41,,53,75,128
072 Ritten,42,,51,73,124
072 Ritten,43,,72,64,136
072 Ritten,44,,76,50,126
072 Ritten,45,,64,48,112
072 Ritten,46,,76,43,119
072 Ritten,47,,68,62,130
072 Ritten,48,,64,50,114
072 Ritten,49,,52,60,112
072 Ritten,50,,46,57,103
072 Ritten,51,,63,60,123
072 Ritten,52,,71,53,124
072 Ritten,53,,34,46,80
072 Ritten,54,,40,41,81
072 Ritten,55,,52,46,98
072 Ritten,56,,50,41,91
072 Ritten,57,,35,34,69
072 Ritten,58,,48,34,82
072 Ritten,59,,43,44,87
072 Ritten,60,,45,36,81
072 Ritten,61,,32,42,74
072 Ritten,62,,32,49,81
072 Ritten,63,,49,37,86
072 Ritten,64,,32,30,62
072 Ritten,65,,26,37,63
072 Ritten,66,,20,29,49
072 Ritten,67,,37,40,77
072 Ritten,68,,35,38,73
072 Ritten,69,,42,34,76
072 Ritten,70,,37,37,74
072 Ritten,71,,33,23,56
072 Ritten,72,,36,31,67
072 Ritten,73,,30,32,62
072 Ritten,74,,24,23,47
072 Ritten,75,,19,23,42
072 Ritten,76,,21,27,48
072 Ritten,77,,21,26,47
072 Ritten,78,,11,25,36
072 Ritten,79,,13,20,33
072 Ritten,80,,11,28,39
072 Ritten,81,,8,19,27
072 Ritten,82,,16,17,33
072 Ritten,83,,9,12,21
072 Ritten,84,,12,12,24
072 Ritten,85,,8,14,22
072 Ritten,86,,3,24,27
072 Ritten,87,,10,16,26
072 Ritten,88,,12,18,30
072 Ritten,89,,1,9,10
072 Ritten,90,,4,14,18
072 Ritten,91,,4,10,14
072 Ritten,92,,1,4,5
072 Ritten,93,,-,3,3
072 Ritten,94,,2,1,3
072 Ritten,95,,-,1,1
072 Ritten,96,,2,3,5
072 Ritten,97,,-,1,1
072 Ritten,99,,1,-,1
072 Ritten,100,,1,1,2
073 Riffian,0,,10,13,23
073 Riffian,1,,5,8,13
073 Riffian,2,,6,10,16
073 Riffian,3,,12,5,17
073 Riffian,4,,11,8,19
073 Riffian,5,,5,7,12
073 Riffian,6,,10,8,18
073 Riffian,7,,7,3,10
073 Riffian,8,,8,8,16
073 Riffian,9,,9,7,16
073 Riffian,10,,11,9,20
073 Riffian,11,,10,8,18
073 Riffian,12,,9,9,18
073 Riffian,13,,10,7,17
073 Riffian,14,,9,7,16
073 Riffian,15,,6,8,14
073 Riffian,16,,5,10,15
073 Riffian,17,,6,8,14
073 Riffian,18,,6,7,13
073 Riffian,19,,10,9,19
073 Riffian,20,,13,15,28
073 Riffian,21,,7,7,14
073 Riffian,22,,14,3,17
073 Riffian,23,,8,10,18
073 Riffian,24,,6,9,15
073 Riffian,25,,10,5,15
073 Riffian,26,,9,5,14
073 Riffian,27,,8,8,16
073 Riffian,28,,9,7,16
073 Riffian,29,,10,13,23
073 Riffian,30,,9,8,17
073 Riffian,31,,3,6,9
073 Riffian,32,,9,8,17
073 Riffian,33,,12,7,19
073 Riffian,34,,13,14,27
073 Riffian,35,,9,3,12
073 Riffian,36,,9,15,24
073 Riffian,37,,11,11,22
073 Riffian,38,,9,9,18
073 Riffian,39,,12,24,36
073 Riffian,40,,12,13,25
073 Riffian,41,,7,10,17
073 Riffian,42,,15,15,30
073 Riffian,43,,9,13,22
073 Riffian,44,,12,13,25
073 Riffian,45,,13,5,18
073 Riffian,46,,10,5,15
073 Riffian,47,,11,8,19
073 Riffian,48,,16,12,28
073 Riffian,49,,10,12,22
073 Riffian,50,,8,8,16
073 Riffian,51,,13,6,19
073 Riffian,52,,7,13,20
073 Riffian,53,,8,7,15
073 Riffian,54,,6,10,16
073 Riffian,55,,10,5,15
073 Riffian,56,,3,7,10
073 Riffian,57,,11,6,17
073 Riffian,58,,7,5,12
073 Riffian,59,,7,4,11
073 Riffian,60,,6,10,16
073 Riffian,61,,4,3,7
073 Riffian,62,,7,6,13
073 Riffian,63,,6,3,9
073 Riffian,64,,3,4,7
073 Riffian,65,,2,8,10
073 Riffian,66,,6,3,9
073 Riffian,67,,9,8,17
073 Riffian,68,,6,7,13
073 Riffian,69,,14,8,22
073 Riffian,70,,7,3,10
073 Riffian,71,,4,4,8
073 Riffian,72,,4,9,13
073 Riffian,73,,8,4,12
073 Riffian,74,,4,5,9
073 Riffian,75,,3,4,7
073 Riffian,76,,-,3,3
073 Riffian,77,,-,3,3
073 Riffian,78,,4,5,9
073 Riffian,79,,1,5,6
073 Riffian,80,,3,7,10
073 Riffian,81,,4,4,8
073 Riffian,82,,1,7,8
073 Riffian,83,,2,5,7
073 Riffian,84,,3,4,7
073 Riffian,85,,3,3,6
073 Riffian,86,,3,1,4
073 Riffian,87,,2,2,4
073 Riffian,88,,2,5,7
073 Riffian,89,,1,-,1
073 Riffian,90,,-,3,3
073 Riffian,91,,-,2,2
073 Riffian,94,,-,1,1
073 Riffian,96,,-,1,1
073 Riffian,97,,-,1,1
074 Mühlbach,0,,25,12,37
074 Mühlbach,1,,16,27,43
074 Mühlbach,2,,19,12,31
074 Mühlbach,3,,21,16,37
074 Mühlbach,4,,22,23,45
074 Mühlbach,5,,13,9,22
074 Mühlbach,6,,16,10,26
074 Mühlbach,7,,15,21,36
074 Mühlbach,8,,24,10,34
074 Mühlbach,9,,20,18,38
074 Mühlbach,10,,14,19,33
074 Mühlbach,11,,16,18,34
074 Mühlbach,12,,18,14,32
074 Mühlbach,13,,19,20,39
074 Mühlbach,14,,20,17,37
074 Mühlbach,15,,18,16,34
074 Mühlbach,16,,13,14,27
074 Mühlbach,17,,22,14,36
074 Mühlbach,18,,17,22,39
074 Mühlbach,19,,16,26,42
074 Mühlbach,20,,15,20,35
074 Mühlbach,21,,13,18,31
074 Mühlbach,22,,15,21,36
074 Mühlbach,23,,22,13,35
074 Mühlbach,24,,20,15,35
074 Mühlbach,25,,19,9,28
074 Mühlbach,26,,17,23,40
074 Mühlbach,27,,19,25,44
074 Mühlbach,28,,21,24,45
074 Mühlbach,29,,27,36,63
074 Mühlbach,30,,26,20,46
074 Mühlbach,31,,20,22,42
074 Mühlbach,32,,25,19,44
074 Mühlbach,33,,31,27,58
074 Mühlbach,34,,28,17,45
074 Mühlbach,35,,18,23,41
074 Mühlbach,36,,18,20,38
074 Mühlbach,37,,22,17,39
074 Mühlbach,38,,27,19,46
074 Mühlbach,39,,24,22,46
074 Mühlbach,40,,31,27,58
074 Mühlbach,41,,25,17,42
074 Mühlbach,42,,24,34,58
074 Mühlbach,43,,35,17,52
074 Mühlbach,44,,24,19,43
074 Mühlbach,45,,29,16,45
074 Mühlbach,46,,23,22,45
074 Mühlbach,47,,15,23,38
074 Mühlbach,48,,20,20,40
074 Mühlbach,49,,21,18,39
074 Mühlbach,50,,24,25,49
074 Mühlbach,51,,22,16,38
074 Mühlbach,52,,23,18,41
074 Mühlbach,53,,20,12,32
074 Mühlbach,54,,16,22,38
074 Mühlbach,55,,21,25,46
074 Mühlbach,56,,21,18,39
074 Mühlbach,57,,13,22,35
074 Mühlbach,58,,18,18,36
074 Mühlbach,59,,17,22,39
074 Mühlbach,60,,12,20,32
074 Mühlbach,61,,23,17,40
074 Mühlbach,62,,15,12,27
074 Mühlbach,63,,17,13,30
074 Mühlbach,64,,11,19,30
074 Mühlbach,65,,19,11,30
074 Mühlbach,66,,8,7,15
074 Mühlbach,67,,14,12,26
074 Mühlbach,68,,11,10,21
074 Mühlbach,69,,15,13,28
074 Mühlbach,70,,16,17,33
074 Mühlbach,71,,11,11,22
074 Mühlbach,72,,10,17,27
074 Mühlbach,73,,12,7,19
074 Mühlbach,74,,5,11,16
074 Mühlbach,75,,6,6,12
074 Mühlbach,76,,7,9,16
074 Mühlbach,77,,11,14,25
074 Mühlbach,78,,9,10,19
074 Mühlbach,79,,5,7,12
074 Mühlbach,80,,6,9,15
074 Mühlbach,81,,6,6,12
074 Mühlbach,82,,6,2,8
074 Mühlbach,83,,3,14,17
074 Mühlbach,84,,4,7,11
074 Mühlbach,85,,3,7,10
074 Mühlbach,86,,4,4,8
074 Mühlbach,87,,3,4,7
074 Mühlbach,88,,2,3,5
074 Mühlbach,89,,1,7,8
074 Mühlbach,90,,-,2,2
074 Mühlbach,91,,2,4,6
074 Mühlbach,92,,-,2,2
074 Mühlbach,97,,-,1,1
075 Rodeneck,0,,2,5,7
075 Rodeneck,1,,7,5,12
075 Rodeneck,2,,3,7,10
075 Rodeneck,3,,8,10,18
075 Rodeneck,4,,7,7,14
075 Rodeneck,5,,4,3,7
075 Rodeneck,6,,9,8,17
075 Rodeneck,7,,7,4,11
075 Rodeneck,8,,8,7,15
075 Rodeneck,9,,8,3,11
075 Rodeneck,10,,10,3,13
075 Rodeneck,11,,6,14,20
075 Rodeneck,12,,8,11,19
075 Rodeneck,13,,12,7,19
075 Rodeneck,14,,10,7,17
075 Rodeneck,15,,13,9,22
075 Rodeneck,16,,5,9,14
075 Rodeneck,17,,6,12,18
075 Rodeneck,18,,6,7,13
075 Rodeneck,19,,12,10,22
075 Rodeneck,20,,6,7,13
075 Rodeneck,21,,13,9,22
075 Rodeneck,22,,7,5,12
075 Rodeneck,23,,12,9,21
075 Rodeneck,24,,6,5,11
075 Rodeneck,25,,7,11,18
075 Rodeneck,26,,12,9,21
075 Rodeneck,27,,13,11,24
075 Rodeneck,28,,10,10,20
075 Rodeneck,29,,6,4,10
075 Rodeneck,30,,10,5,15
075 Rodeneck,31,,8,11,19
075 Rodeneck,32,,9,4,13
075 Rodeneck,33,,5,8,13
075 Rodeneck,34,,7,5,12
075 Rodeneck,35,,10,8,18
075 Rodeneck,36,,8,8,16
075 Rodeneck,37,,5,5,10
075 Rodeneck,38,,16,9,25
075 Rodeneck,39,,7,9,16
075 Rodeneck,40,,14,4,18
075 Rodeneck,41,,8,11,19
075 Rodeneck,42,,15,12,27
075 Rodeneck,43,,8,11,19
075 Rodeneck,44,,11,10,21
075 Rodeneck,45,,16,8,24
075 Rodeneck,46,,7,8,15
075 Rodeneck,47,,11,13,24
075 Rodeneck,48,,9,10,19
075 Rodeneck,49,,10,12,22
075 Rodeneck,50,,9,11,20
075 Rodeneck,51,,6,10,16
075 Rodeneck,52,,10,6,16
075 Rodeneck,53,,7,4,11
075 Rodeneck,54,,6,7,13
075 Rodeneck,55,,7,4,11
075 Rodeneck,56,,7,6,13
075 Rodeneck,57,,10,3,13
075 Rodeneck,58,,3,1,4
075 Rodeneck,59,,7,4,11
075 Rodeneck,60,,3,3,6
075 Rodeneck,61,,1,8,9
075 Rodeneck,62,,2,5,7
075 Rodeneck,63,,4,7,11
075 Rodeneck,64,,5,4,9
075 Rodeneck,65,,10,7,17
075 Rodeneck,66,,2,5,7
075 Rodeneck,67,,3,5,8
075 Rodeneck,68,,2,2,4
075 Rodeneck,69,,2,6,8
075 Rodeneck,70,,10,3,13
075 Rodeneck,71,,5,4,9
075 Rodeneck,72,,3,9,12
075 Rodeneck,73,,3,3,6
075 Rodeneck,74,,2,4,6
075 Rodeneck,75,,1,4,5
075 Rodeneck,76,,3,2,5
075 Rodeneck,77,,1,10,11
075 Rodeneck,78,,3,-,3
075 Rodeneck,79,,6,5,11
075 Rodeneck,80,,4,2,6
075 Rodeneck,81,,4,5,9
075 Rodeneck,82,,6,1,7
075 Rodeneck,83,,3,4,7
075 Rodeneck,84,,1,3,4
075 Rodeneck,85,,1,4,5
075 Rodeneck,86,,1,4,5
075 Rodeneck,87,,3,2,5
075 Rodeneck,88,,2,-,2
075 Rodeneck,89,,-,2,2
075 Rodeneck,90,,1,-,1
075 Rodeneck,91,,2,-,2
075 Rodeneck,93,,-,2,2
076 Salurn,0,,26,20,46
076 Salurn,1,,27,14,41
076 Salurn,2,,20,31,51
076 Salurn,3,,28,21,49
076 Salurn,4,,24,25,49
076 Salurn,5,,24,22,46
076 Salurn,6,,16,23,39
076 Salurn,7,,25,18,43
076 Salurn,8,,29,17,46
076 Salurn,9,,17,18,35
076 Salurn,10,,16,17,33
076 Salurn,11,,19,21,40
076 Salurn,12,,20,14,34
076 Salurn,13,,19,25,44
076 Salurn,14,,13,14,27
076 Salurn,15,,27,23,50
076 Salurn,16,,21,15,36
076 Salurn,17,,20,20,40
076 Salurn,18,,19,17,36
076 Salurn,19,,26,21,47
076 Salurn,20,,14,22,36
076 Salurn,21,,15,18,33
076 Salurn,22,,18,23,41
076 Salurn,23,,21,24,45
076 Salurn,24,,24,24,48
076 Salurn,25,,17,19,36
076 Salurn,26,,19,26,45
076 Salurn,27,,15,21,36
076 Salurn,28,,16,25,41
076 Salurn,29,,25,20,45
076 Salurn,30,,20,30,50
076 Salurn,31,,26,27,53
076 Salurn,32,,17,26,43
076 Salurn,33,,22,26,48
076 Salurn,34,,30,27,57
076 Salurn,35,,25,22,47
076 Salurn,36,,29,24,53
076 Salurn,37,,25,21,46
076 Salurn,38,,29,34,63
076 Salurn,39,,31,26,57
076 Salurn,40,,40,28,68
076 Salurn,41,,32,30,62
076 Salurn,42,,25,28,53
076 Salurn,43,,33,27,60
076 Salurn,44,,25,24,49
076 Salurn,45,,26,27,53
076 Salurn,46,,25,32,57
076 Salurn,47,,35,29,64
076 Salurn,48,,39,29,68
076 Salurn,49,,31,29,60
076 Salurn,50,,31,31,62
076 Salurn,51,,20,27,47
076 Salurn,52,,27,29,56
076 Salurn,53,,31,20,51
076 Salurn,54,,21,22,43
076 Salurn,55,,19,13,32
076 Salurn,56,,21,21,42
076 Salurn,57,,20,19,39
076 Salurn,58,,16,18,34
076 Salurn,59,,29,21,50
076 Salurn,60,,27,19,46
076 Salurn,61,,24,16,40
076 Salurn,62,,26,10,36
076 Salurn,63,,12,23,35
076 Salurn,64,,16,21,37
076 Salurn,65,,22,16,38
076 Salurn,66,,12,10,22
076 Salurn,67,,19,18,37
076 Salurn,68,,16,17,33
076 Salurn,69,,21,17,38
076 Salurn,70,,16,15,31
076 Salurn,71,,12,10,22
076 Salurn,72,,12,7,19
076 Salurn,73,,5,10,15
076 Salurn,74,,11,12,23
076 Salurn,75,,12,19,31
076 Salurn,76,,12,17,29
076 Salurn,77,,9,7,16
076 Salurn,78,,9,7,16
076 Salurn,79,,6,17,23
076 Salurn,80,,5,10,15
076 Salurn,81,,11,10,21
076 Salurn,82,,13,11,24
076 Salurn,83,,7,14,21
076 Salurn,84,,2,15,17
076 Salurn,85,,6,9,15
076 Salurn,86,,5,12,17
076 Salurn,87,,3,9,12
076 Salurn,88,,3,4,7
076 Salurn,89,,4,8,12
076 Salurn,90,,1,6,7
076 Salurn,91,,6,7,13
076 Salurn,92,,1,6,7
076 Salurn,93,,-,3,3
076 Salurn,94,,-,2,2
076 Salurn,96,,1,1,2
076 Salurn,97,,-,1,1
076 Salurn,99,,1,-,1
076 Salurn,100,,-,2,2
077 Innichen,0,,26,17,43
077 Innichen,1,,17,10,27
077 Innichen,2,,11,16,27
077 Innichen,3,,21,13,34
077 Innichen,4,,15,18,33
077 Innichen,5,,12,12,24
077 Innichen,6,,15,17,32
077 Innichen,7,,12,12,24
077 Innichen,8,,18,15,33
077 Innichen,9,,16,16,32
077 Innichen,10,,24,17,41
077 Innichen,11,,17,17,34
077 Innichen,12,,11,16,27
077 Innichen,13,,21,13,34
077 Innichen,14,,20,16,36
077 Innichen,15,,17,18,35
077 Innichen,16,,20,11,31
077 Innichen,17,,18,16,34
077 Innichen,18,,22,20,42
077 Innichen,19,,22,15,37
077 Innichen,20,,17,25,42
077 Innichen,21,,20,14,34
077 Innichen,22,,18,23,41
077 Innichen,23,,27,20,47
077 Innichen,24,,20,22,42
077 Innichen,25,,23,18,41
077 Innichen,26,,22,24,46
077 Innichen,27,,20,20,40
077 Innichen,28,,25,23,48
077 Innichen,29,,27,24,51
077 Innichen,30,,15,15,30
077 Innichen,31,,26,17,43
077 Innichen,32,,27,27,54
077 Innichen,33,,13,16,29
077 Innichen,34,,22,23,45
077 Innichen,35,,16,29,45
077 Innichen,36,,18,14,32
077 Innichen,37,,24,18,42
077 Innichen,38,,24,19,43
077 Innichen,39,,22,26,48
077 Innichen,40,,24,17,41
077 Innichen,41,,24,30,54
077 Innichen,42,,20,29,49
077 Innichen,43,,23,22,45
077 Innichen,44,,28,29,57
077 Innichen,45,,28,31,59
077 Innichen,46,,37,30,67
077 Innichen,47,,31,31,62
077 Innichen,48,,29,25,54
077 Innichen,49,,30,23,53
077 Innichen,50,,24,26,50
077 Innichen,51,,29,19,48
077 Innichen,52,,27,21,48
077 Innichen,53,,21,25,46
077 Innichen,54,,17,26,43
077 Innichen,55,,25,14,39
077 Innichen,56,,27,21,48
077 Innichen,57,,23,10,33
077 Innichen,58,,23,18,41
077 Innichen,59,,11,24,35
077 Innichen,60,,12,20,32
077 Innichen,61,,15,20,35
077 Innichen,62,,19,16,35
077 Innichen,63,,16,12,28
077 Innichen,64,,12,14,26
077 Innichen,65,,14,16,30
077 Innichen,66,,10,9,19
077 Innichen,67,,9,13,22
077 Innichen,68,,20,9,29
077 Innichen,69,,17,20,37
077 Innichen,70,,13,20,33
077 Innichen,71,,9,23,32
077 Innichen,72,,12,12,24
077 Innichen,73,,7,12,19
077 Innichen,74,,10,11,21
077 Innichen,75,,8,20,28
077 Innichen,76,,5,19,24
077 Innichen,77,,11,13,24
077 Innichen,78,,9,8,17
077 Innichen,79,,10,17,27
077 Innichen,80,,11,17,28
077 Innichen,81,,15,12,27
077 Innichen,82,,10,13,23
077 Innichen,83,,9,12,21
077 Innichen,84,,2,11,13
077 Innichen,85,,10,10,20
077 Innichen,86,,3,13,16
077 Innichen,87,,5,2,7
077 Innichen,88,,4,9,13
077 Innichen,89,,2,8,10
077 Innichen,90,,2,7,9
077 Innichen,91,,1,6,7
077 Innichen,92,,2,2,4
077 Innichen,93,,-,2,2
077 Innichen,95,,1,-,1
077 Innichen,96,,-,2,2
077 Innichen,99,,-,1,1
079 Jenesien,0,,15,9,24
079 Jenesien,1,,17,18,35
079 Jenesien,2,,17,18,35
079 Jenesien,3,,24,21,45
079 Jenesien,4,,21,17,38
079 Jenesien,5,,22,24,46
079 Jenesien,6,,15,17,32
079 Jenesien,7,,20,19,39
079 Jenesien,8,,17,21,38
079 Jenesien,9,,13,19,32
079 Jenesien,10,,17,22,39
079 Jenesien,11,,18,17,35
079 Jenesien,12,,26,21,47
079 Jenesien,13,,16,29,45
079 Jenesien,14,,21,18,39
079 Jenesien,15,,25,11,36
079 Jenesien,16,,24,17,41
079 Jenesien,17,,21,21,42
079 Jenesien,18,,15,18,33
079 Jenesien,19,,29,22,51
079 Jenesien,20,,19,19,38
079 Jenesien,21,,18,15,33
079 Jenesien,22,,18,14,32
079 Jenesien,23,,24,14,38
079 Jenesien,24,,15,20,35
079 Jenesien,25,,17,17,34
079 Jenesien,26,,17,10,27
079 Jenesien,27,,15,16,31
079 Jenesien,28,,18,19,37
079 Jenesien,29,,16,19,35
079 Jenesien,30,,15,18,33
079 Jenesien,31,,17,17,34
079 Jenesien,32,,20,14,34
079 Jenesien,33,,15,21,36
079 Jenesien,34,,17,15,32
079 Jenesien,35,,17,19,36
079 Jenesien,36,,11,18,29
079 Jenesien,37,,22,24,46
079 Jenesien,38,,22,30,52
079 Jenesien,39,,26,25,51
079 Jenesien,40,,30,26,56
079 Jenesien,41,,31,34,65
079 Jenesien,42,,33,20,53
079 Jenesien,43,,17,25,42
079 Jenesien,44,,17,23,40
079 Jenesien,45,,37,30,67
079 Jenesien,46,,35,28,63
079 Jenesien,47,,33,33,66
079 Jenesien,48,,28,25,53
079 Jenesien,49,,26,22,48
079 Jenesien,50,,31,20,51
079 Jenesien,51,,26,12,38
079 Jenesien,52,,24,16,40
079 Jenesien,53,,23,9,32
079 Jenesien,54,,13,18,31
079 Jenesien,55,,16,12,28
079 Jenesien,56,,11,11,22
079 Jenesien,57,,19,13,32
079 Jenesien,58,,13,10,23
079 Jenesien,59,,12,20,32
079 Jenesien,60,,13,9,22
079 Jenesien,61,,12,21,33
079 Jenesien,62,,11,13,24
079 Jenesien,63,,12,8,20
079 Jenesien,64,,13,12,25
079 Jenesien,65,,10,9,19
079 Jenesien,66,,7,14,21
079 Jenesien,67,,13,11,24
079 Jenesien,68,,16,9,25
079 Jenesien,69,,14,10,24
079 Jenesien,70,,13,22,35
079 Jenesien,71,,15,11,26
079 Jenesien,72,,13,18,31
079 Jenesien,73,,16,9,25
079 Jenesien,74,,10,16,26
079 Jenesien,75,,5,18,23
079 Jenesien,76,,6,8,14
079 Jenesien,77,,8,7,15
079 Jenesien,78,,15,9,24
079 Jenesien,79,,5,9,14
079 Jenesien,80,,6,7,13
079 Jenesien,81,,6,12,18
079 Jenesien,82,,4,13,17
079 Jenesien,83,,7,9,16
079 Jenesien,84,,3,8,11
079 Jenesien,85,,6,8,14
079 Jenesien,86,,-,6,6
079 Jenesien,87,,5,4,9
079 Jenesien,88,,1,3,4
079 Jenesien,89,,1,6,7
079 Jenesien,90,,1,2,3
079 Jenesien,91,,1,1,2
079 Jenesien,92,,-,2,2
079 Jenesien,93,,-,1,1
079 Jenesien,96,,-,1,1
079 Jenesien,98,,-,1,1
079 Jenesien,103,,-,1,1
080 St.Leonhard in Pass.,0,,16,24,40
080 St.Leonhard in Pass.,1,,20,26,46
080 St.Leonhard in Pass.,2,,20,20,40
080 St.Leonhard in Pass.,3,,22,22,44
080 St.Leonhard in Pass.,4,,21,23,44
080 St.Leonhard in Pass.,5,,17,24,41
080 St.Leonhard in Pass.,6,,25,20,45
080 St.Leonhard in Pass.,7,,18,20,38
080 St.Leonhard in Pass.,8,,25,14,39
080 St.Leonhard in Pass.,9,,22,18,40
080 St.Leonhard in Pass.,10,,28,14,42
080 St.Leonhard in Pass.,11,,21,17,38
080 St.Leonhard in Pass.,12,,21,22,43
080 St.Leonhard in Pass.,13,,20,21,41
080 St.Leonhard in Pass.,14,,23,20,43
080 St.Leonhard in Pass.,15,,24,20,44
080 St.Leonhard in Pass.,16,,23,13,36
080 St.Leonhard in Pass.,17,,20,19,39
080 St.Leonhard in Pass.,18,,27,22,49
080 St.Leonhard in Pass.,19,,22,21,43
080 St.Leonhard in Pass.,20,,21,22,43
080 St.Leonhard in Pass.,21,,24,20,44
080 St.Leonhard in Pass.,22,,37,31,68
080 St.Leonhard in Pass.,23,,21,29,50
080 St.Leonhard in Pass.,24,,29,20,49
080 St.Leonhard in Pass.,25,,33,33,66
080 St.Leonhard in Pass.,26,,23,25,48
080 St.Leonhard in Pass.,27,,24,23,47
080 St.Leonhard in Pass.,28,,28,22,50
080 St.Leonhard in Pass.,29,,26,26,52
080 St.Leonhard in Pass.,30,,27,31,58
080 St.Leonhard in Pass.,31,,21,27,48
080 St.Leonhard in Pass.,32,,27,26,53
080 St.Leonhard in Pass.,33,,28,27,55
080 St.Leonhard in Pass.,34,,29,25,54
080 St.Leonhard in Pass.,35,,14,29,43
080 St.Leonhard in Pass.,36,,29,13,42
080 St.Leonhard in Pass.,37,,33,23,56
080 St.Leonhard in Pass.,38,,30,29,59
080 St.Leonhard in Pass.,39,,27,25,52
080 St.Leonhard in Pass.,40,,33,22,55
080 St.Leonhard in Pass.,41,,21,24,45
080 St.Leonhard in Pass.,42,,24,24,48
080 St.Leonhard in Pass.,43,,33,21,54
080 St.Leonhard in Pass.,44,,24,24,48
080 St.Leonhard in Pass.,45,,33,29,62
080 St.Leonhard in Pass.,46,,30,32,62
080 St.Leonhard in Pass.,47,,26,30,56
080 St.Leonhard in Pass.,48,,22,22,44
080 St.Leonhard in Pass.,49,,22,31,53
080 St.Leonhard in Pass.,50,,28,21,49
080 St.Leonhard in Pass.,51,,31,19,50
080 St.Leonhard in Pass.,52,,29,26,55
080 St.Leonhard in Pass.,53,,24,20,44
080 St.Leonhard in Pass.,54,,21,28,49
080 St.Leonhard in Pass.,55,,25,16,41
080 St.Leonhard in Pass.,56,,24,18,42
080 St.Leonhard in Pass.,57,,18,14,32
080 St.Leonhard in Pass.,58,,29,24,53
080 St.Leonhard in Pass.,59,,20,24,44
080 St.Leonhard in Pass.,60,,24,16,40
080 St.Leonhard in Pass.,61,,16,14,30
080 St.Leonhard in Pass.,62,,22,10,32
080 St.Leonhard in Pass.,63,,23,11,34
080 St.Leonhard in Pass.,64,,18,15,33
080 St.Leonhard in Pass.,65,,16,18,34
080 St.Leonhard in Pass.,66,,9,10,19
080 St.Leonhard in Pass.,67,,11,12,23
080 St.Leonhard in Pass.,68,,9,23,32
080 St.Leonhard in Pass.,69,,8,13,21
080 St.Leonhard in Pass.,70,,13,14,27
080 St.Leonhard in Pass.,71,,18,12,30
080 St.Leonhard in Pass.,72,,18,18,36
080 St.Leonhard in Pass.,73,,11,14,25
080 St.Leonhard in Pass.,74,,16,7,23
080 St.Leonhard in Pass.,75,,15,11,26
080 St.Leonhard in Pass.,76,,9,11,20
080 St.Leonhard in Pass.,77,,7,14,21
080 St.Leonhard in Pass.,78,,10,13,23
080 St.Leonhard in Pass.,79,,6,12,18
080 St.Leonhard in Pass.,80,,5,13,18
080 St.Leonhard in Pass.,81,,5,9,14
080 St.Leonhard in Pass.,82,,7,6,13
080 St.Leonhard in Pass.,83,,5,11,16
080 St.Leonhard in Pass.,84,,3,10,13
080 St.Leonhard in Pass.,85,,4,7,11
080 St.Leonhard in Pass.,86,,4,8,12
080 St.Leonhard in Pass.,87,,3,7,10
080 St.Leonhard in Pass.,88,,5,4,9
080 St.Leonhard in Pass.,89,,1,5,6
080 St.Leonhard in Pass.,90,,1,4,5
080 St.Leonhard in Pass.,91,,1,1,2
080 St.Leonhard in Pass.,92,,-,2,2
080 St.Leonhard in Pass.,94,,-,1,1
080 St.Leonhard in Pass.,96,,1,-,1
080 St.Leonhard in Pass.,97,,-,1,1
080 St.Leonhard in Pass.,99,,-,2,2
081 St.Lorenzen,0,,18,21,39
081 St.Lorenzen,1,,27,23,50
081 St.Lorenzen,2,,20,22,42
081 St.Lorenzen,3,,23,19,42
081 St.Lorenzen,4,,24,21,45
081 St.Lorenzen,5,,15,19,34
081 St.Lorenzen,6,,26,18,44
081 St.Lorenzen,7,,26,21,47
081 St.Lorenzen,8,,24,18,42
081 St.Lorenzen,9,,18,19,37
081 St.Lorenzen,10,,29,21,50
081 St.Lorenzen,11,,20,29,49
081 St.Lorenzen,12,,29,26,55
081 St.Lorenzen,13,,33,26,59
081 St.Lorenzen,14,,18,30,48
081 St.Lorenzen,15,,30,30,60
081 St.Lorenzen,16,,24,14,38
081 St.Lorenzen,17,,33,20,53
081 St.Lorenzen,18,,25,31,56
081 St.Lorenzen,19,,26,20,46
081 St.Lorenzen,20,,24,14,38
081 St.Lorenzen,21,,27,22,49
081 St.Lorenzen,22,,16,17,33
081 St.Lorenzen,23,,18,29,47
081 St.Lorenzen,24,,21,25,46
081 St.Lorenzen,25,,25,27,52
081 St.Lorenzen,26,,26,26,52
081 St.Lorenzen,27,,29,26,55
081 St.Lorenzen,28,,28,21,49
081 St.Lorenzen,29,,34,22,56
081 St.Lorenzen,30,,27,19,46
081 St.Lorenzen,31,,19,24,43
081 St.Lorenzen,32,,28,31,59
081 St.Lorenzen,33,,28,22,50
081 St.Lorenzen,34,,27,19,46
081 St.Lorenzen,35,,26,17,43
081 St.Lorenzen,36,,27,31,58
081 St.Lorenzen,37,,27,32,59
081 St.Lorenzen,38,,34,32,66
081 St.Lorenzen,39,,37,35,72
081 St.Lorenzen,40,,33,31,64
081 St.Lorenzen,41,,30,30,60
081 St.Lorenzen,42,,22,32,54
081 St.Lorenzen,43,,44,36,80
081 St.Lorenzen,44,,32,40,72
081 St.Lorenzen,45,,37,30,67
081 St.Lorenzen,46,,34,28,62
081 St.Lorenzen,47,,33,23,56
081 St.Lorenzen,48,,36,32,68
081 St.Lorenzen,49,,28,38,66
081 St.Lorenzen,50,,25,38,63
081 St.Lorenzen,51,,33,20,53
081 St.Lorenzen,52,,31,23,54
081 St.Lorenzen,53,,31,32,63
081 St.Lorenzen,54,,22,26,48
081 St.Lorenzen,55,,26,28,54
081 St.Lorenzen,56,,17,18,35
081 St.Lorenzen,57,,14,19,33
081 St.Lorenzen,58,,24,18,42
081 St.Lorenzen,59,,18,11,29
081 St.Lorenzen,60,,17,16,33
081 St.Lorenzen,61,,17,19,36
081 St.Lorenzen,62,,11,22,33
081 St.Lorenzen,63,,15,14,29
081 St.Lorenzen,64,,19,8,27
081 St.Lorenzen,65,,17,11,28
081 St.Lorenzen,66,,10,18,28
081 St.Lorenzen,67,,17,15,32
081 St.Lorenzen,68,,13,15,28
081 St.Lorenzen,69,,17,20,37
081 St.Lorenzen,70,,17,17,34
081 St.Lorenzen,71,,13,12,25
081 St.Lorenzen,72,,12,19,31
081 St.Lorenzen,73,,12,13,25
081 St.Lorenzen,74,,18,16,34
081 St.Lorenzen,75,,12,13,25
081 St.Lorenzen,76,,9,13,22
081 St.Lorenzen,77,,14,7,21
081 St.Lorenzen,78,,11,8,19
081 St.Lorenzen,79,,8,10,18
081 St.Lorenzen,80,,7,13,20
081 St.Lorenzen,81,,7,6,13
081 St.Lorenzen,82,,9,16,25
081 St.Lorenzen,83,,6,14,20
081 St.Lorenzen,84,,4,6,10
081 St.Lorenzen,85,,6,5,11
081 St.Lorenzen,86,,1,9,10
081 St.Lorenzen,87,,2,6,8
081 St.Lorenzen,88,,4,7,11
081 St.Lorenzen,89,,-,4,4
081 St.Lorenzen,90,,2,3,5
081 St.Lorenzen,91,,-,3,3
081 St.Lorenzen,92,,1,2,3
081 St.Lorenzen,93,,-,1,1
081 St.Lorenzen,97,,-,1,1
082 St.Martin in Thurn,0,,13,7,20
082 St.Martin in Thurn,1,,7,7,14
082 St.Martin in Thurn,2,,7,5,12
082 St.Martin in Thurn,3,,8,3,11
082 St.Martin in Thurn,4,,3,10,13
082 St.Martin in Thurn,5,,9,15,24
082 St.Martin in Thurn,6,,10,9,19
082 St.Martin in Thurn,7,,17,13,30
082 St.Martin in Thurn,8,,4,6,10
082 St.Martin in Thurn,9,,15,8,23
082 St.Martin in Thurn,10,,8,14,22
082 St.Martin in Thurn,11,,7,9,16
082 St.Martin in Thurn,12,,9,19,28
082 St.Martin in Thurn,13,,11,11,22
082 St.Martin in Thurn,14,,15,11,26
082 St.Martin in Thurn,15,,24,14,38
082 St.Martin in Thurn,16,,15,11,26
082 St.Martin in Thurn,17,,15,8,23
082 St.Martin in Thurn,18,,9,9,18
082 St.Martin in Thurn,19,,17,14,31
082 St.Martin in Thurn,20,,11,11,22
082 St.Martin in Thurn,21,,6,16,22
082 St.Martin in Thurn,22,,15,13,28
082 St.Martin in Thurn,23,,7,4,11
082 St.Martin in Thurn,24,,13,11,24
082 St.Martin in Thurn,25,,13,10,23
082 St.Martin in Thurn,26,,11,17,28
082 St.Martin in Thurn,27,,8,8,16
082 St.Martin in Thurn,28,,14,11,25
082 St.Martin in Thurn,29,,14,14,28
082 St.Martin in Thurn,30,,14,8,22
082 St.Martin in Thurn,31,,10,9,19
082 St.Martin in Thurn,32,,9,9,18
082 St.Martin in Thurn,33,,17,9,26
082 St.Martin in Thurn,34,,13,9,22
082 St.Martin in Thurn,35,,13,11,24
082 St.Martin in Thurn,36,,7,9,16
082 St.Martin in Thurn,37,,7,11,18
082 St.Martin in Thurn,38,,11,10,21
082 St.Martin in Thurn,39,,12,9,21
082 St.Martin in Thurn,40,,17,13,30
082 St.Martin in Thurn,41,,12,13,25
082 St.Martin in Thurn,42,,15,16,31
082 St.Martin in Thurn,43,,17,14,31
082 St.Martin in Thurn,44,,10,12,22
082 St.Martin in Thurn,45,,16,25,41
082 St.Martin in Thurn,46,,16,21,37
082 St.Martin in Thurn,47,,11,16,27
082 St.Martin in Thurn,48,,14,14,28
082 St.Martin in Thurn,49,,15,16,31
082 St.Martin in Thurn,50,,14,19,33
082 St.Martin in Thurn,51,,16,5,21
082 St.Martin in Thurn,52,,12,9,21
082 St.Martin in Thurn,53,,12,7,19
082 St.Martin in Thurn,54,,12,9,21
082 St.Martin in Thurn,55,,8,5,13
082 St.Martin in Thurn,56,,13,9,22
082 St.Martin in Thurn,57,,8,8,16
082 St.Martin in Thurn,58,,5,10,15
082 St.Martin in Thurn,59,,3,4,7
082 St.Martin in Thurn,60,,8,8,16
082 St.Martin in Thurn,61,,9,6,15
082 St.Martin in Thurn,62,,3,7,10
082 St.Martin in Thurn,63,,7,6,13
082 St.Martin in Thurn,64,,9,6,15
082 St.Martin in Thurn,65,,8,7,15
082 St.Martin in Thurn,66,,6,4,10
082 St.Martin in Thurn,67,,10,8,18
082 St.Martin in Thurn,68,,4,8,12
082 St.Martin in Thurn,69,,6,6,12
082 St.Martin in Thurn,70,,7,6,13
082 St.Martin in Thurn,71,,4,5,9
082 St.Martin in Thurn,72,,5,7,12
082 St.Martin in Thurn,73,,8,8,16
082 St.Martin in Thurn,74,,5,12,17
082 St.Martin in Thurn,75,,4,6,10
082 St.Martin in Thurn,76,,7,6,13
082 St.Martin in Thurn,77,,6,4,10
082 St.Martin in Thurn,78,,3,9,12
082 St.Martin in Thurn,79,,6,7,13
082 St.Martin in Thurn,80,,7,8,15
082 St.Martin in Thurn,81,,5,6,11
082 St.Martin in Thurn,82,,5,8,13
082 St.Martin in Thurn,83,,2,3,5
082 St.Martin in Thurn,84,,2,5,7
082 St.Martin in Thurn,85,,6,3,9
082 St.Martin in Thurn,86,,5,4,9
082 St.Martin in Thurn,87,,5,7,12
082 St.Martin in Thurn,88,,2,5,7
082 St.Martin in Thurn,89,,5,4,9
082 St.Martin in Thurn,90,,1,1,2
082 St.Martin in Thurn,91,,1,6,7
082 St.Martin in Thurn,92,,1,3,4
082 St.Martin in Thurn,98,,1,-,1
083 St.Martin in Passeier,0,,14,16,30
083 St.Martin in Passeier,1,,26,14,40
083 St.Martin in Passeier,2,,15,20,35
083 St.Martin in Passeier,3,,20,26,46
083 St.Martin in Passeier,4,,16,21,37
083 St.Martin in Passeier,5,,25,18,43
083 St.Martin in Passeier,6,,19,19,38
083 St.Martin in Passeier,7,,21,22,43
083 St.Martin in Passeier,8,,19,17,36
083 St.Martin in Passeier,9,,17,14,31
083 St.Martin in Passeier,10,,18,16,34
083 St.Martin in Passeier,11,,12,23,35
083 St.Martin in Passeier,12,,8,20,28
083 St.Martin in Passeier,13,,22,20,42
083 St.Martin in Passeier,14,,26,25,51
083 St.Martin in Passeier,15,,22,21,43
083 St.Martin in Passeier,16,,21,17,38
083 St.Martin in Passeier,17,,22,24,46
083 St.Martin in Passeier,18,,19,23,42
083 St.Martin in Passeier,19,,23,18,41
083 St.Martin in Passeier,20,,21,24,45
083 St.Martin in Passeier,21,,21,26,47
083 St.Martin in Passeier,22,,19,21,40
083 St.Martin in Passeier,23,,17,17,34
083 St.Martin in Passeier,24,,19,26,45
083 St.Martin in Passeier,25,,24,22,46
083 St.Martin in Passeier,26,,19,23,42
083 St.Martin in Passeier,27,,25,28,53
083 St.Martin in Passeier,28,,23,14,37
083 St.Martin in Passeier,29,,22,20,42
083 St.Martin in Passeier,30,,25,22,47
083 St.Martin in Passeier,31,,20,25,45
083 St.Martin in Passeier,32,,19,11,30
083 St.Martin in Passeier,33,,30,17,47
083 St.Martin in Passeier,34,,25,26,51
083 St.Martin in Passeier,35,,21,18,39
083 St.Martin in Passeier,36,,22,20,42
083 St.Martin in Passeier,37,,25,21,46
083 St.Martin in Passeier,38,,22,27,49
083 St.Martin in Passeier,39,,20,20,40
083 St.Martin in Passeier,40,,28,24,52
083 St.Martin in Passeier,41,,31,24,55
083 St.Martin in Passeier,42,,33,27,60
083 St.Martin in Passeier,43,,28,24,52
083 St.Martin in Passeier,44,,23,25,48
083 St.Martin in Passeier,45,,28,32,60
083 St.Martin in Passeier,46,,34,24,58
083 St.Martin in Passeier,47,,17,18,35
083 St.Martin in Passeier,48,,33,21,54
083 St.Martin in Passeier,49,,23,30,53
083 St.Martin in Passeier,50,,34,24,58
083 St.Martin in Passeier,51,,24,22,46
083 St.Martin in Passeier,52,,25,23,48
083 St.Martin in Passeier,53,,26,19,45
083 St.Martin in Passeier,54,,25,12,37
083 St.Martin in Passeier,55,,21,17,38
083 St.Martin in Passeier,56,,28,14,42
083 St.Martin in Passeier,57,,11,12,23
083 St.Martin in Passeier,58,,21,16,37
083 St.Martin in Passeier,59,,6,18,24
083 St.Martin in Passeier,60,,21,13,34
083 St.Martin in Passeier,61,,10,15,25
083 St.Martin in Passeier,62,,14,12,26
083 St.Martin in Passeier,63,,11,12,23
083 St.Martin in Passeier,64,,15,13,28
083 St.Martin in Passeier,65,,12,9,21
083 St.Martin in Passeier,66,,12,10,22
083 St.Martin in Passeier,67,,17,13,30
083 St.Martin in Passeier,68,,11,11,22
083 St.Martin in Passeier,69,,14,14,28
083 St.Martin in Passeier,70,,8,14,22
083 St.Martin in Passeier,71,,4,11,15
083 St.Martin in Passeier,72,,7,13,20
083 St.Martin in Passeier,73,,12,8,20
083 St.Martin in Passeier,74,,14,20,34
083 St.Martin in Passeier,75,,12,13,25
083 St.Martin in Passeier,76,,7,13,20
083 St.Martin in Passeier,77,,15,9,24
083 St.Martin in Passeier,78,,11,9,20
083 St.Martin in Passeier,79,,3,8,11
083 St.Martin in Passeier,80,,3,10,13
083 St.Martin in Passeier,81,,4,10,14
083 St.Martin in Passeier,82,,8,9,17
083 St.Martin in Passeier,83,,5,6,11
083 St.Martin in Passeier,84,,6,2,8
083 St.Martin in Passeier,85,,1,10,11
083 St.Martin in Passeier,86,,4,3,7
083 St.Martin in Passeier,87,,2,8,10
083 St.Martin in Passeier,88,,1,6,7
083 St.Martin in Passeier,89,,-,3,3
083 St.Martin in Passeier,90,,-,7,7
083 St.Martin in Passeier,91,,1,2,3
083 St.Martin in Passeier,92,,1,1,2
083 St.Martin in Passeier,93,,-,2,2
083 St.Martin in Passeier,94,,-,2,2
083 St.Martin in Passeier,96,,1,-,1
083 St.Martin in Passeier,100,,1,-,1
084 St.Pankraz,0,,8,6,14
084 St.Pankraz,1,,8,5,13
084 St.Pankraz,2,,9,12,21
084 St.Pankraz,3,,8,11,19
084 St.Pankraz,4,,9,12,21
084 St.Pankraz,5,,8,13,21
084 St.Pankraz,6,,13,9,22
084 St.Pankraz,7,,13,9,22
084 St.Pankraz,8,,13,8,21
084 St.Pankraz,9,,8,3,11
084 St.Pankraz,10,,14,14,28
084 St.Pankraz,11,,11,12,23
084 St.Pankraz,12,,8,4,12
084 St.Pankraz,13,,13,7,20
084 St.Pankraz,14,,8,11,19
084 St.Pankraz,15,,10,8,18
084 St.Pankraz,16,,9,5,14
084 St.Pankraz,17,,8,10,18
084 St.Pankraz,18,,5,11,16
084 St.Pankraz,19,,7,10,17
084 St.Pankraz,20,,10,11,21
084 St.Pankraz,21,,12,3,15
084 St.Pankraz,22,,12,16,28
084 St.Pankraz,23,,13,7,20
084 St.Pankraz,24,,9,7,16
084 St.Pankraz,25,,11,5,16
084 St.Pankraz,26,,9,7,16
084 St.Pankraz,27,,11,5,16
084 St.Pankraz,28,,10,7,17
084 St.Pankraz,29,,11,7,18
084 St.Pankraz,30,,7,15,22
084 St.Pankraz,31,,14,9,23
084 St.Pankraz,32,,4,4,8
084 St.Pankraz,33,,12,8,20
084 St.Pankraz,34,,9,9,18
084 St.Pankraz,35,,4,11,15
084 St.Pankraz,36,,8,12,20
084 St.Pankraz,37,,13,11,24
084 St.Pankraz,38,,12,6,18
084 St.Pankraz,39,,10,19,29
084 St.Pankraz,40,,15,11,26
084 St.Pankraz,41,,13,11,24
084 St.Pankraz,42,,17,10,27
084 St.Pankraz,43,,16,13,29
084 St.Pankraz,44,,8,15,23
084 St.Pankraz,45,,14,7,21
084 St.Pankraz,46,,23,14,37
084 St.Pankraz,47,,13,12,25
084 St.Pankraz,48,,9,9,18
084 St.Pankraz,49,,17,9,26
084 St.Pankraz,50,,14,13,27
084 St.Pankraz,51,,13,4,17
084 St.Pankraz,52,,14,12,26
084 St.Pankraz,53,,5,8,13
084 St.Pankraz,54,,10,9,19
084 St.Pankraz,55,,10,15,25
084 St.Pankraz,56,,6,4,10
084 St.Pankraz,57,,11,9,20
084 St.Pankraz,58,,9,10,19
084 St.Pankraz,59,,14,9,23
084 St.Pankraz,60,,6,2,8
084 St.Pankraz,61,,10,5,15
084 St.Pankraz,62,,7,6,13
084 St.Pankraz,63,,8,2,10
084 St.Pankraz,64,,7,6,13
084 St.Pankraz,65,,4,7,11
084 St.Pankraz,66,,3,6,9
084 St.Pankraz,67,,4,7,11
084 St.Pankraz,68,,12,14,26
084 St.Pankraz,69,,9,15,24
084 St.Pankraz,70,,8,10,18
084 St.Pankraz,71,,8,6,14
084 St.Pankraz,72,,7,7,14
084 St.Pankraz,73,,5,10,15
084 St.Pankraz,74,,9,8,17
084 St.Pankraz,75,,5,3,8
084 St.Pankraz,76,,5,3,8
084 St.Pankraz,77,,5,7,12
084 St.Pankraz,78,,7,3,10
084 St.Pankraz,79,,6,10,16
084 St.Pankraz,80,,6,4,10
084 St.Pankraz,81,,3,5,8
084 St.Pankraz,82,,5,9,14
084 St.Pankraz,83,,5,7,12
084 St.Pankraz,84,,7,3,10
084 St.Pankraz,85,,1,6,7
084 St.Pankraz,86,,4,5,9
084 St.Pankraz,87,,1,6,7
084 St.Pankraz,88,,4,3,7
084 St.Pankraz,89,,3,3,6
084 St.Pankraz,90,,2,4,6
084 St.Pankraz,91,,-,3,3
084 St.Pankraz,92,,-,1,1
084 St.Pankraz,97,,-,1,1
084 St.Pankraz,99,,1,-,1
085 St.Christina in Gröden,0,,13,9,22
085 St.Christina in Gröden,1,,10,8,18
085 St.Christina in Gröden,2,,11,7,18
085 St.Christina in Gröden,3,,13,7,20
085 St.Christina in Gröden,4,,9,7,16
085 St.Christina in Gröden,5,,9,9,18
085 St.Christina in Gröden,6,,16,12,28
085 St.Christina in Gröden,7,,14,12,26
085 St.Christina in Gröden,8,,8,7,15
085 St.Christina in Gröden,9,,10,14,24
085 St.Christina in Gröden,10,,9,11,20
085 St.Christina in Gröden,11,,19,12,31
085 St.Christina in Gröden,12,,20,10,30
085 St.Christina in Gröden,13,,10,15,25
085 St.Christina in Gröden,14,,9,12,21
085 St.Christina in Gröden,15,,12,5,17
085 St.Christina in Gröden,16,,15,10,25
085 St.Christina in Gröden,17,,8,14,22
085 St.Christina in Gröden,18,,13,12,25
085 St.Christina in Gröden,19,,15,14,29
085 St.Christina in Gröden,20,,11,17,28
085 St.Christina in Gröden,21,,8,14,22
085 St.Christina in Gröden,22,,6,9,15
085 St.Christina in Gröden,23,,9,7,16
085 St.Christina in Gröden,24,,12,6,18
085 St.Christina in Gröden,25,,13,12,25
085 St.Christina in Gröden,26,,7,10,17
085 St.Christina in Gröden,27,,10,5,15
085 St.Christina in Gröden,28,,22,15,37
085 St.Christina in Gröden,29,,9,5,14
085 St.Christina in Gröden,30,,8,12,20
085 St.Christina in Gröden,31,,13,19,32
085 St.Christina in Gröden,32,,10,11,21
085 St.Christina in Gröden,33,,6,17,23
085 St.Christina in Gröden,34,,9,10,19
085 St.Christina in Gröden,35,,15,11,26
085 St.Christina in Gröden,36,,13,13,26
085 St.Christina in Gröden,37,,10,23,33
085 St.Christina in Gröden,38,,10,12,22
085 St.Christina in Gröden,39,,19,10,29
085 St.Christina in Gröden,40,,12,15,27
085 St.Christina in Gröden,41,,22,20,42
085 St.Christina in Gröden,42,,22,12,34
085 St.Christina in Gröden,43,,24,24,48
085 St.Christina in Gröden,44,,16,16,32
085 St.Christina in Gröden,45,,22,8,30
085 St.Christina in Gröden,46,,12,14,26
085 St.Christina in Gröden,47,,13,25,38
085 St.Christina in Gröden,48,,13,17,30
085 St.Christina in Gröden,49,,18,13,31
085 St.Christina in Gröden,50,,21,16,37
085 St.Christina in Gröden,51,,20,16,36
085 St.Christina in Gröden,52,,12,9,21
085 St.Christina in Gröden,53,,9,11,20
085 St.Christina in Gröden,54,,17,11,28
085 St.Christina in Gröden,55,,11,10,21
085 St.Christina in Gröden,56,,9,9,18
085 St.Christina in Gröden,57,,12,13,25
085 St.Christina in Gröden,58,,9,9,18
085 St.Christina in Gröden,59,,4,7,11
085 St.Christina in Gröden,60,,11,5,16
085 St.Christina in Gröden,61,,7,5,12
085 St.Christina in Gröden,62,,8,9,17
085 St.Christina in Gröden,63,,8,5,13
085 St.Christina in Gröden,64,,6,8,14
085 St.Christina in Gröden,65,,8,9,17
085 St.Christina in Gröden,66,,6,7,13
085 St.Christina in Gröden,67,,5,12,17
085 St.Christina in Gröden,68,,11,15,26
085 St.Christina in Gröden,69,,8,6,14
085 St.Christina in Gröden,70,,12,8,20
085 St.Christina in Gröden,71,,9,11,20
085 St.Christina in Gröden,72,,9,10,19
085 St.Christina in Gröden,73,,8,7,15
085 St.Christina in Gröden,74,,8,4,12
085 St.Christina in Gröden,75,,10,10,20
085 St.Christina in Gröden,76,,12,3,15
085 St.Christina in Gröden,77,,7,12,19
085 St.Christina in Gröden,78,,4,12,16
085 St.Christina in Gröden,79,,7,8,15
085 St.Christina in Gröden,80,,2,6,8
085 St.Christina in Gröden,81,,11,4,15
085 St.Christina in Gröden,82,,2,9,11
085 St.Christina in Gröden,83,,2,3,5
085 St.Christina in Gröden,84,,5,6,11
085 St.Christina in Gröden,85,,7,3,10
085 St.Christina in Gröden,86,,3,6,9
085 St.Christina in Gröden,87,,-,1,1
085 St.Christina in Gröden,88,,1,4,5
085 St.Christina in Gröden,89,,-,6,6
085 St.Christina in Gröden,90,,2,3,5
085 St.Christina in Gröden,91,,1,2,3
085 St.Christina in Gröden,92,,-,1,1
085 St.Christina in Gröden,96,,2,-,2
085 St.Christina in Gröden,97,,-,1,1
085 St.Christina in Gröden,98,,2,-,2
086 Sarntal,0,,46,42,88
086 Sarntal,1,,46,41,87
086 Sarntal,2,,34,38,72
086 Sarntal,3,,41,56,97
086 Sarntal,4,,53,38,91
086 Sarntal,5,,44,51,95
086 Sarntal,6,,41,36,77
086 Sarntal,7,,39,39,78
086 Sarntal,8,,46,35,81
086 Sarntal,9,,31,40,71
086 Sarntal,10,,51,26,77
086 Sarntal,11,,37,42,79
086 Sarntal,12,,35,36,71
086 Sarntal,13,,52,41,93
086 Sarntal,14,,45,48,93
086 Sarntal,15,,46,41,87
086 Sarntal,16,,43,45,88
086 Sarntal,17,,33,40,73
086 Sarntal,18,,33,41,74
086 Sarntal,19,,43,37,80
086 Sarntal,20,,44,44,88
086 Sarntal,21,,45,33,78
086 Sarntal,22,,56,34,90
086 Sarntal,23,,43,46,89
086 Sarntal,24,,37,34,71
086 Sarntal,25,,38,45,83
086 Sarntal,26,,43,43,86
086 Sarntal,27,,41,38,79
086 Sarntal,28,,56,44,100
086 Sarntal,29,,59,45,104
086 Sarntal,30,,45,54,99
086 Sarntal,31,,52,40,92
086 Sarntal,32,,53,47,100
086 Sarntal,33,,56,56,112
086 Sarntal,34,,56,41,97
086 Sarntal,35,,43,36,79
086 Sarntal,36,,56,50,106
086 Sarntal,37,,45,60,105
086 Sarntal,38,,57,62,119
086 Sarntal,39,,70,40,110
086 Sarntal,40,,46,48,94
086 Sarntal,41,,65,59,124
086 Sarntal,42,,62,54,116
086 Sarntal,43,,52,44,96
086 Sarntal,44,,53,47,100
086 Sarntal,45,,50,48,98
086 Sarntal,46,,65,55,120
086 Sarntal,47,,57,64,121
086 Sarntal,48,,42,43,85
086 Sarntal,49,,57,35,92
086 Sarntal,50,,42,47,89
086 Sarntal,51,,66,45,111
086 Sarntal,52,,41,43,84
086 Sarntal,53,,56,44,100
086 Sarntal,54,,34,41,75
086 Sarntal,55,,39,30,69
086 Sarntal,56,,40,40,80
086 Sarntal,57,,36,31,67
086 Sarntal,58,,43,29,72
086 Sarntal,59,,34,42,76
086 Sarntal,60,,42,33,75
086 Sarntal,61,,36,32,68
086 Sarntal,62,,50,26,76
086 Sarntal,63,,33,39,72
086 Sarntal,64,,35,28,63
086 Sarntal,65,,36,37,73
086 Sarntal,66,,29,33,62
086 Sarntal,67,,30,29,59
086 Sarntal,68,,35,37,72
086 Sarntal,69,,37,35,72
086 Sarntal,70,,32,28,60
086 Sarntal,71,,27,42,69
086 Sarntal,72,,36,29,65
086 Sarntal,73,,29,30,59
086 Sarntal,74,,23,32,55
086 Sarntal,75,,15,22,37
086 Sarntal,76,,17,21,38
086 Sarntal,77,,21,18,39
086 Sarntal,78,,17,17,34
086 Sarntal,79,,18,23,41
086 Sarntal,80,,12,22,34
086 Sarntal,81,,13,21,34
086 Sarntal,82,,16,26,42
086 Sarntal,83,,12,22,34
086 Sarntal,84,,13,28,41
086 Sarntal,85,,7,11,18
086 Sarntal,86,,13,16,29
086 Sarntal,87,,-,17,17
086 Sarntal,88,,2,13,15
086 Sarntal,89,,3,15,18
086 Sarntal,90,,1,6,7
086 Sarntal,91,,2,7,9
086 Sarntal,92,,2,7,9
086 Sarntal,93,,1,5,6
086 Sarntal,94,,-,2,2
086 Sarntal,95,,-,1,1
086 Sarntal,97,,-,1,1
086 Sarntal,98,,2,2,4
086 Sarntal,104,,1,-,1
087 Schenna,0,,12,14,26
087 Schenna,1,,10,19,29
087 Schenna,2,,12,15,27
087 Schenna,3,,15,18,33
087 Schenna,4,,14,14,28
087 Schenna,5,,20,25,45
087 Schenna,6,,11,9,20
087 Schenna,7,,16,17,33
087 Schenna,8,,14,15,29
087 Schenna,9,,16,19,35
087 Schenna,10,,17,14,31
087 Schenna,11,,19,20,39
087 Schenna,12,,24,18,42
087 Schenna,13,,16,10,26
087 Schenna,14,,13,18,31
087 Schenna,15,,17,18,35
087 Schenna,16,,21,18,39
087 Schenna,17,,20,15,35
087 Schenna,18,,12,6,18
087 Schenna,19,,16,17,33
087 Schenna,20,,12,21,33
087 Schenna,21,,18,16,34
087 Schenna,22,,22,10,32
087 Schenna,23,,20,21,41
087 Schenna,24,,20,16,36
087 Schenna,25,,18,14,32
087 Schenna,26,,15,18,33
087 Schenna,27,,13,19,32
087 Schenna,28,,15,8,23
087 Schenna,29,,10,16,26
087 Schenna,30,,21,16,37
087 Schenna,31,,17,26,43
087 Schenna,32,,27,20,47
087 Schenna,33,,14,16,30
087 Schenna,34,,23,23,46
087 Schenna,35,,25,9,34
087 Schenna,36,,19,30,49
087 Schenna,37,,26,22,48
087 Schenna,38,,26,22,48
087 Schenna,39,,26,17,43
087 Schenna,40,,26,25,51
087 Schenna,41,,20,20,40
087 Schenna,42,,28,21,49
087 Schenna,43,,24,19,43
087 Schenna,44,,28,19,47
087 Schenna,45,,19,19,38
087 Schenna,46,,30,30,60
087 Schenna,47,,20,26,46
087 Schenna,48,,25,19,44
087 Schenna,49,,21,11,32
087 Schenna,50,,31,24,55
087 Schenna,51,,32,23,55
087 Schenna,52,,14,13,27
087 Schenna,53,,22,19,41
087 Schenna,54,,15,17,32
087 Schenna,55,,18,17,35
087 Schenna,56,,10,18,28
087 Schenna,57,,15,17,32
087 Schenna,58,,15,15,30
087 Schenna,59,,10,16,26
087 Schenna,60,,14,11,25
087 Schenna,61,,18,14,32
087 Schenna,62,,17,20,37
087 Schenna,63,,16,16,32
087 Schenna,64,,17,18,35
087 Schenna,65,,16,22,38
087 Schenna,66,,13,14,27
087 Schenna,67,,15,9,24
087 Schenna,68,,18,14,32
087 Schenna,69,,9,19,28
087 Schenna,70,,13,12,25
087 Schenna,71,,10,10,20
087 Schenna,72,,9,12,21
087 Schenna,73,,14,17,31
087 Schenna,74,,6,11,17
087 Schenna,75,,8,11,19
087 Schenna,76,,11,9,20
087 Schenna,77,,12,14,26
087 Schenna,78,,7,9,16
087 Schenna,79,,7,10,17
087 Schenna,80,,9,9,18
087 Schenna,81,,9,5,14
087 Schenna,82,,4,10,14
087 Schenna,83,,6,8,14
087 Schenna,84,,2,10,12
087 Schenna,85,,5,6,11
087 Schenna,86,,-,8,8
087 Schenna,87,,7,5,12
087 Schenna,88,,2,3,5
087 Schenna,89,,3,4,7
087 Schenna,90,,3,6,9
087 Schenna,91,,1,2,3
087 Schenna,92,,-,2,2
087 Schenna,95,,-,1,1
087 Schenna,98,,-,2,2
088 Mühlwald,0,,5,8,13
088 Mühlwald,1,,5,8,13
088 Mühlwald,2,,3,7,10
088 Mühlwald,3,,9,8,17
088 Mühlwald,4,,7,8,15
088 Mühlwald,5,,5,12,17
088 Mühlwald,6,,8,5,13
088 Mühlwald,7,,10,9,19
088 Mühlwald,8,,15,9,24
088 Mühlwald,9,,10,12,22
088 Mühlwald,10,,10,13,23
088 Mühlwald,11,,8,10,18
088 Mühlwald,12,,15,10,25
088 Mühlwald,13,,13,14,27
088 Mühlwald,14,,12,9,21
088 Mühlwald,15,,15,13,28
088 Mühlwald,16,,12,4,16
088 Mühlwald,17,,8,6,14
088 Mühlwald,18,,15,13,28
088 Mühlwald,19,,5,5,10
088 Mühlwald,20,,12,7,19
088 Mühlwald,21,,10,6,16
088 Mühlwald,22,,16,9,25
088 Mühlwald,23,,7,5,12
088 Mühlwald,24,,9,15,24
088 Mühlwald,25,,6,7,13
088 Mühlwald,26,,10,17,27
088 Mühlwald,27,,10,14,24
088 Mühlwald,28,,10,6,16
088 Mühlwald,29,,5,9,14
088 Mühlwald,30,,11,11,22
088 Mühlwald,31,,20,2,22
088 Mühlwald,32,,7,11,18
088 Mühlwald,33,,12,6,18
088 Mühlwald,34,,8,5,13
088 Mühlwald,35,,13,11,24
088 Mühlwald,36,,12,6,18
088 Mühlwald,37,,9,6,15
088 Mühlwald,38,,15,12,27
088 Mühlwald,39,,7,9,16
088 Mühlwald,40,,19,14,33
088 Mühlwald,41,,7,10,17
088 Mühlwald,42,,14,15,29
088 Mühlwald,43,,16,9,25
088 Mühlwald,44,,17,14,31
088 Mühlwald,45,,12,7,19
088 Mühlwald,46,,18,12,30
088 Mühlwald,47,,18,10,28
088 Mühlwald,48,,9,11,20
088 Mühlwald,49,,8,11,19
088 Mühlwald,50,,6,10,16
088 Mühlwald,51,,14,9,23
088 Mühlwald,52,,13,5,18
088 Mühlwald,53,,9,5,14
088 Mühlwald,54,,13,12,25
088 Mühlwald,55,,7,8,15
088 Mühlwald,56,,7,7,14
088 Mühlwald,57,,9,4,13
088 Mühlwald,58,,10,9,19
088 Mühlwald,59,,9,7,16
088 Mühlwald,60,,10,4,14
088 Mühlwald,61,,4,10,14
088 Mühlwald,62,,9,3,12
088 Mühlwald,63,,12,4,16
088 Mühlwald,64,,9,7,16
088 Mühlwald,65,,7,3,10
088 Mühlwald,66,,4,4,8
088 Mühlwald,67,,8,4,12
088 Mühlwald,68,,8,2,10
088 Mühlwald,69,,6,7,13
088 Mühlwald,70,,4,7,11
088 Mühlwald,71,,4,9,13
088 Mühlwald,72,,5,11,16
088 Mühlwald,73,,8,4,12
088 Mühlwald,74,,10,2,12
088 Mühlwald,75,,4,3,7
088 Mühlwald,76,,4,3,7
088 Mühlwald,77,,4,5,9
088 Mühlwald,78,,2,10,12
088 Mühlwald,79,,1,2,3
088 Mühlwald,80,,4,4,8
088 Mühlwald,81,,3,4,7
088 Mühlwald,82,,5,5,10
088 Mühlwald,83,,3,4,7
088 Mühlwald,84,,4,1,5
088 Mühlwald,85,,1,4,5
088 Mühlwald,86,,1,1,2
088 Mühlwald,87,,1,1,2
088 Mühlwald,88,,-,3,3
088 Mühlwald,89,,-,2,2
088 Mühlwald,90,,-,5,5
088 Mühlwald,92,,-,1,1
088 Mühlwald,94,,1,-,1
088 Mühlwald,96,,-,1,1
088 Mühlwald,98,,-,1,1
089 Wolkenstein in Gröden,0,,15,18,33
089 Wolkenstein in Gröden,1,,16,11,27
089 Wolkenstein in Gröden,2,,11,9,20
089 Wolkenstein in Gröden,3,,17,13,30
089 Wolkenstein in Gröden,4,,16,13,29
089 Wolkenstein in Gröden,5,,12,17,29
089 Wolkenstein in Gröden,6,,15,18,33
089 Wolkenstein in Gröden,7,,12,9,21
089 Wolkenstein in Gröden,8,,17,19,36
089 Wolkenstein in Gröden,9,,24,19,43
089 Wolkenstein in Gröden,10,,20,18,38
089 Wolkenstein in Gröden,11,,19,23,42
089 Wolkenstein in Gröden,12,,13,17,30
089 Wolkenstein in Gröden,13,,14,23,37
089 Wolkenstein in Gröden,14,,22,29,51
089 Wolkenstein in Gröden,15,,15,12,27
089 Wolkenstein in Gröden,16,,17,12,29
089 Wolkenstein in Gröden,17,,15,17,32
089 Wolkenstein in Gröden,18,,13,16,29
089 Wolkenstein in Gröden,19,,23,14,37
089 Wolkenstein in Gröden,20,,18,18,36
089 Wolkenstein in Gröden,21,,13,9,22
089 Wolkenstein in Gröden,22,,15,13,28
089 Wolkenstein in Gröden,23,,16,17,33
089 Wolkenstein in Gröden,24,,10,22,32
089 Wolkenstein in Gröden,25,,14,13,27
089 Wolkenstein in Gröden,26,,15,11,26
089 Wolkenstein in Gröden,27,,13,10,23
089 Wolkenstein in Gröden,28,,15,9,24
089 Wolkenstein in Gröden,29,,12,18,30
089 Wolkenstein in Gröden,30,,14,9,23
089 Wolkenstein in Gröden,31,,21,15,36
089 Wolkenstein in Gröden,32,,9,18,27
089 Wolkenstein in Gröden,33,,10,9,19
089 Wolkenstein in Gröden,34,,11,12,23
089 Wolkenstein in Gröden,35,,15,9,24
089 Wolkenstein in Gröden,36,,19,25,44
089 Wolkenstein in Gröden,37,,11,17,28
089 Wolkenstein in Gröden,38,,23,23,46
089 Wolkenstein in Gröden,39,,18,24,42
089 Wolkenstein in Gröden,40,,22,23,45
089 Wolkenstein in Gröden,41,,25,24,49
089 Wolkenstein in Gröden,42,,28,23,51
089 Wolkenstein in Gröden,43,,24,25,49
089 Wolkenstein in Gröden,44,,29,26,55
089 Wolkenstein in Gröden,45,,26,23,49
089 Wolkenstein in Gröden,46,,21,33,54
089 Wolkenstein in Gröden,47,,28,21,49
089 Wolkenstein in Gröden,48,,23,22,45
089 Wolkenstein in Gröden,49,,21,20,41
089 Wolkenstein in Gröden,50,,25,24,49
089 Wolkenstein in Gröden,51,,26,22,48
089 Wolkenstein in Gröden,52,,13,16,29
089 Wolkenstein in Gröden,53,,17,15,32
089 Wolkenstein in Gröden,54,,20,16,36
089 Wolkenstein in Gröden,55,,10,14,24
089 Wolkenstein in Gröden,56,,11,10,21
089 Wolkenstein in Gröden,57,,13,12,25
089 Wolkenstein in Gröden,58,,8,12,20
089 Wolkenstein in Gröden,59,,11,7,18
089 Wolkenstein in Gröden,60,,13,12,25
089 Wolkenstein in Gröden,61,,6,17,23
089 Wolkenstein in Gröden,62,,16,11,27
089 Wolkenstein in Gröden,63,,12,13,25
089 Wolkenstein in Gröden,64,,9,15,24
089 Wolkenstein in Gröden,65,,18,19,37
089 Wolkenstein in Gröden,66,,5,14,19
089 Wolkenstein in Gröden,67,,12,8,20
089 Wolkenstein in Gröden,68,,21,14,35
089 Wolkenstein in Gröden,69,,10,12,22
089 Wolkenstein in Gröden,70,,13,12,25
089 Wolkenstein in Gröden,71,,14,16,30
089 Wolkenstein in Gröden,72,,18,12,30
089 Wolkenstein in Gröden,73,,16,8,24
089 Wolkenstein in Gröden,74,,9,19,28
089 Wolkenstein in Gröden,75,,9,15,24
089 Wolkenstein in Gröden,76,,14,6,20
089 Wolkenstein in Gröden,77,,15,10,25
089 Wolkenstein in Gröden,78,,6,10,16
089 Wolkenstein in Gröden,79,,4,9,13
089 Wolkenstein in Gröden,80,,8,9,17
089 Wolkenstein in Gröden,81,,6,9,15
089 Wolkenstein in Gröden,82,,6,6,12
089 Wolkenstein in Gröden,83,,4,9,13
089 Wolkenstein in Gröden,84,,7,5,12
089 Wolkenstein in Gröden,85,,7,4,11
089 Wolkenstein in Gröden,86,,3,6,9
089 Wolkenstein in Gröden,87,,2,8,10
089 Wolkenstein in Gröden,88,,3,4,7
089 Wolkenstein in Gröden,89,,4,9,13
089 Wolkenstein in Gröden,90,,1,3,4
089 Wolkenstein in Gröden,91,,3,3,6
089 Wolkenstein in Gröden,92,,-,1,1
089 Wolkenstein in Gröden,94,,1,-,1
089 Wolkenstein in Gröden,96,,-,1,1
089 Wolkenstein in Gröden,99,,-,1,1
089 Wolkenstein in Gröden,100,,-,1,1
091 Schnals,0,,5,5,10
091 Schnals,1,,2,6,8
091 Schnals,2,,9,9,18
091 Schnals,3,,10,5,15
091 Schnals,4,,4,6,10
091 Schnals,5,,4,4,8
091 Schnals,6,,4,5,9
091 Schnals,7,,7,5,12
091 Schnals,8,,2,7,9
091 Schnals,9,,12,2,14
091 Schnals,10,,3,4,7
091 Schnals,11,,5,5,10
091 Schnals,12,,6,9,15
091 Schnals,13,,7,15,22
091 Schnals,14,,13,10,23
091 Schnals,15,,6,11,17
091 Schnals,16,,5,8,13
091 Schnals,17,,4,7,11
091 Schnals,18,,10,5,15
091 Schnals,19,,12,10,22
091 Schnals,20,,14,9,23
091 Schnals,21,,4,7,11
091 Schnals,22,,18,7,25
091 Schnals,23,,8,5,13
091 Schnals,24,,10,8,18
091 Schnals,25,,7,9,16
091 Schnals,26,,5,9,14
091 Schnals,27,,14,13,27
091 Schnals,28,,7,5,12
091 Schnals,29,,7,6,13
091 Schnals,30,,15,8,23
091 Schnals,31,,11,11,22
091 Schnals,32,,5,10,15
091 Schnals,33,,10,10,20
091 Schnals,34,,7,8,15
091 Schnals,35,,9,2,11
091 Schnals,36,,4,6,10
091 Schnals,37,,14,7,21
091 Schnals,38,,8,9,17
091 Schnals,39,,10,9,19
091 Schnals,40,,10,9,19
091 Schnals,41,,11,7,18
091 Schnals,42,,11,7,18
091 Schnals,43,,11,9,20
091 Schnals,44,,15,11,26
091 Schnals,45,,13,15,28
091 Schnals,46,,15,8,23
091 Schnals,47,,7,9,16
091 Schnals,48,,11,15,26
091 Schnals,49,,12,10,22
091 Schnals,50,,10,13,23
091 Schnals,51,,12,8,20
091 Schnals,52,,15,12,27
091 Schnals,53,,11,11,22
091 Schnals,54,,11,5,16
091 Schnals,55,,12,4,16
091 Schnals,56,,9,6,15
091 Schnals,57,,9,10,19
091 Schnals,58,,12,8,20
091 Schnals,59,,14,7,21
091 Schnals,60,,12,9,21
091 Schnals,61,,9,7,16
091 Schnals,62,,10,9,19
091 Schnals,63,,3,2,5
091 Schnals,64,,8,8,16
091 Schnals,65,,5,5,10
091 Schnals,66,,6,4,10
091 Schnals,67,,3,7,10
091 Schnals,68,,6,8,14
091 Schnals,69,,4,4,8
091 Schnals,70,,3,4,7
091 Schnals,71,,7,7,14
091 Schnals,72,,5,7,12
091 Schnals,73,,1,11,12
091 Schnals,74,,6,4,10
091 Schnals,75,,4,3,7
091 Schnals,76,,2,5,7
091 Schnals,77,,2,3,5
091 Schnals,78,,3,3,6
091 Schnals,79,,2,7,9
091 Schnals,80,,2,4,6
091 Schnals,81,,-,3,3
091 Schnals,82,,4,6,10
091 Schnals,83,,1,4,5
091 Schnals,84,,1,4,5
091 Schnals,85,,7,2,9
091 Schnals,86,,3,8,11
091 Schnals,87,,-,3,3
091 Schnals,88,,-,1,1
091 Schnals,89,,2,2,4
091 Schnals,90,,-,2,2
091 Schnals,91,,-,1,1
091 Schnals,93,,2,1,3
091 Schnals,95,,-,1,1
091 Schnals,96,,-,1,1
091 Schnals,98,,-,1,1
091 Schnals,100,,-,1,1
092 Sexten,0,,8,4,12
092 Sexten,1,,9,7,16
092 Sexten,2,,12,7,19
092 Sexten,3,,6,8,14
092 Sexten,4,,8,18,26
092 Sexten,5,,5,7,12
092 Sexten,6,,9,10,19
092 Sexten,7,,13,7,20
092 Sexten,8,,11,11,22
092 Sexten,9,,17,17,34
092 Sexten,10,,16,14,30
092 Sexten,11,,8,16,24
092 Sexten,12,,8,14,22
092 Sexten,13,,12,7,19
092 Sexten,14,,13,10,23
092 Sexten,15,,15,11,26
092 Sexten,16,,15,14,29
092 Sexten,17,,16,11,27
092 Sexten,18,,10,5,15
092 Sexten,19,,14,11,25
092 Sexten,20,,11,13,24
092 Sexten,21,,11,16,27
092 Sexten,22,,9,11,20
092 Sexten,23,,9,5,14
092 Sexten,24,,13,8,21
092 Sexten,25,,6,10,16
092 Sexten,26,,11,12,23
092 Sexten,27,,7,11,18
092 Sexten,28,,13,9,22
092 Sexten,29,,11,13,24
092 Sexten,30,,14,12,26
092 Sexten,31,,15,8,23
092 Sexten,32,,11,19,30
092 Sexten,33,,13,12,25
092 Sexten,34,,8,3,11
092 Sexten,35,,19,17,36
092 Sexten,36,,8,8,16
092 Sexten,37,,8,7,15
092 Sexten,38,,7,10,17
092 Sexten,39,,12,20,32
092 Sexten,40,,15,15,30
092 Sexten,41,,12,19,31
092 Sexten,42,,22,17,39
092 Sexten,43,,14,16,30
092 Sexten,44,,22,19,41
092 Sexten,45,,14,17,31
092 Sexten,46,,18,18,36
092 Sexten,47,,18,19,37
092 Sexten,48,,28,19,47
092 Sexten,49,,13,19,32
092 Sexten,50,,18,12,30
092 Sexten,51,,22,9,31
092 Sexten,52,,15,15,30
092 Sexten,53,,22,14,36
092 Sexten,54,,18,13,31
092 Sexten,55,,14,14,28
092 Sexten,56,,10,11,21
092 Sexten,57,,11,12,23
092 Sexten,58,,5,10,15
092 Sexten,59,,6,13,19
092 Sexten,60,,7,9,16
092 Sexten,61,,11,7,18
092 Sexten,62,,6,4,10
092 Sexten,63,,10,7,17
092 Sexten,64,,10,4,14
092 Sexten,65,,5,9,14
092 Sexten,66,,6,4,10
092 Sexten,67,,6,12,18
092 Sexten,68,,8,5,13
092 Sexten,69,,5,5,10
092 Sexten,70,,8,16,24
092 Sexten,71,,7,12,19
092 Sexten,72,,5,10,15
092 Sexten,73,,13,10,23
092 Sexten,74,,9,6,15
092 Sexten,75,,6,9,15
092 Sexten,76,,8,14,22
092 Sexten,77,,8,7,15
092 Sexten,78,,2,10,12
092 Sexten,79,,3,7,10
092 Sexten,80,,7,13,20
092 Sexten,81,,6,11,17
092 Sexten,82,,6,11,17
092 Sexten,83,,5,11,16
092 Sexten,84,,4,14,18
092 Sexten,85,,4,3,7
092 Sexten,86,,2,8,10
092 Sexten,87,,4,6,10
092 Sexten,88,,1,5,6
092 Sexten,89,,2,6,8
092 Sexten,90,,1,3,4
092 Sexten,91,,-,3,3
092 Sexten,92,,-,3,3
092 Sexten,94,,-,1,1
093 Schlanders,0,,29,25,54
093 Schlanders,1,,27,28,55
093 Schlanders,2,,26,37,63
093 Schlanders,3,,30,25,55
093 Schlanders,4,,30,33,63
093 Schlanders,5,,25,23,48
093 Schlanders,6,,29,35,64
093 Schlanders,7,,27,36,63
093 Schlanders,8,,28,24,52
093 Schlanders,9,,27,33,60
093 Schlanders,10,,31,34,65
093 Schlanders,11,,38,37,75
093 Schlanders,12,,27,41,68
093 Schlanders,13,,44,38,82
093 Schlanders,14,,59,47,106
093 Schlanders,15,,42,35,77
093 Schlanders,16,,38,27,65
093 Schlanders,17,,42,39,81
093 Schlanders,18,,47,44,91
093 Schlanders,19,,34,47,81
093 Schlanders,20,,40,36,76
093 Schlanders,21,,49,43,92
093 Schlanders,22,,38,39,77
093 Schlanders,23,,35,45,80
093 Schlanders,24,,34,35,69
093 Schlanders,25,,41,38,79
093 Schlanders,26,,42,41,83
093 Schlanders,27,,41,41,82
093 Schlanders,28,,33,42,75
093 Schlanders,29,,50,45,95
093 Schlanders,30,,50,41,91
093 Schlanders,31,,41,35,76
093 Schlanders,32,,32,41,73
093 Schlanders,33,,46,35,81
093 Schlanders,34,,37,47,84
093 Schlanders,35,,32,24,56
093 Schlanders,36,,43,39,82
093 Schlanders,37,,47,36,83
093 Schlanders,38,,42,50,92
093 Schlanders,39,,53,36,89
093 Schlanders,40,,46,48,94
093 Schlanders,41,,46,51,97
093 Schlanders,42,,63,43,106
093 Schlanders,43,,53,37,90
093 Schlanders,44,,46,58,104
093 Schlanders,45,,44,56,100
093 Schlanders,46,,58,51,109
093 Schlanders,47,,39,42,81
093 Schlanders,48,,53,60,113
093 Schlanders,49,,49,48,97
093 Schlanders,50,,37,56,93
093 Schlanders,51,,40,44,84
093 Schlanders,52,,35,39,74
093 Schlanders,53,,47,55,102
093 Schlanders,54,,41,35,76
093 Schlanders,55,,28,36,64
093 Schlanders,56,,26,36,62
093 Schlanders,57,,31,34,65
093 Schlanders,58,,33,38,71
093 Schlanders,59,,32,23,55
093 Schlanders,60,,29,31,60
093 Schlanders,61,,22,34,56
093 Schlanders,62,,28,37,65
093 Schlanders,63,,38,25,63
093 Schlanders,64,,22,22,44
093 Schlanders,65,,26,20,46
093 Schlanders,66,,30,15,45
093 Schlanders,67,,27,32,59
093 Schlanders,68,,29,35,64
093 Schlanders,69,,33,35,68
093 Schlanders,70,,32,36,68
093 Schlanders,71,,24,26,50
093 Schlanders,72,,28,33,61
093 Schlanders,73,,12,18,30
093 Schlanders,74,,25,24,49
093 Schlanders,75,,14,26,40
093 Schlanders,76,,14,24,38
093 Schlanders,77,,14,21,35
093 Schlanders,78,,20,29,49
093 Schlanders,79,,16,13,29
093 Schlanders,80,,18,16,34
093 Schlanders,81,,15,24,39
093 Schlanders,82,,11,14,25
093 Schlanders,83,,12,17,29
093 Schlanders,84,,7,17,24
093 Schlanders,85,,6,15,21
093 Schlanders,86,,8,16,24
093 Schlanders,87,,5,12,17
093 Schlanders,88,,6,9,15
093 Schlanders,89,,3,8,11
093 Schlanders,90,,2,8,10
093 Schlanders,91,,1,11,12
093 Schlanders,92,,1,6,7
093 Schlanders,93,,3,4,7
093 Schlanders,94,,1,1,2
093 Schlanders,95,,-,1,1
093 Schlanders,96,,1,1,2
093 Schlanders,98,,-,1,1
093 Schlanders,99,,-,2,2
093 Schlanders,100,,-,1,1
093 Schlanders,101,,-,1,1
093 Schlanders,102,,-,1,1
094 Schluderns,0,,12,11,23
094 Schluderns,1,,9,4,13
094 Schluderns,2,,10,7,17
094 Schluderns,3,,7,2,9
094 Schluderns,4,,11,13,24
094 Schluderns,5,,9,8,17
094 Schluderns,6,,7,6,13
094 Schluderns,7,,6,10,16
094 Schluderns,8,,16,9,25
094 Schluderns,9,,14,9,23
094 Schluderns,10,,12,9,21
094 Schluderns,11,,19,8,27
094 Schluderns,12,,8,14,22
094 Schluderns,13,,6,10,16
094 Schluderns,14,,12,11,23
094 Schluderns,15,,11,14,25
094 Schluderns,16,,9,11,20
094 Schluderns,17,,13,18,31
094 Schluderns,18,,15,6,21
094 Schluderns,19,,8,10,18
094 Schluderns,20,,8,9,17
094 Schluderns,21,,23,5,28
094 Schluderns,22,,15,12,27
094 Schluderns,23,,11,12,23
094 Schluderns,24,,6,12,18
094 Schluderns,25,,11,19,30
094 Schluderns,26,,16,14,30
094 Schluderns,27,,13,11,24
094 Schluderns,28,,12,7,19
094 Schluderns,29,,10,15,25
094 Schluderns,30,,18,12,30
094 Schluderns,31,,8,11,19
094 Schluderns,32,,2,15,17
094 Schluderns,33,,10,14,24
094 Schluderns,34,,11,10,21
094 Schluderns,35,,10,16,26
094 Schluderns,36,,17,10,27
094 Schluderns,37,,18,13,31
094 Schluderns,38,,17,11,28
094 Schluderns,39,,14,11,25
094 Schluderns,40,,10,11,21
094 Schluderns,41,,9,11,20
094 Schluderns,42,,17,11,28
094 Schluderns,43,,17,18,35
094 Schluderns,44,,13,15,28
094 Schluderns,45,,14,16,30
094 Schluderns,46,,25,9,34
094 Schluderns,47,,25,12,37
094 Schluderns,48,,13,18,31
094 Schluderns,49,,11,18,29
094 Schluderns,50,,14,18,32
094 Schluderns,51,,10,4,14
094 Schluderns,52,,13,18,31
094 Schluderns,53,,10,13,23
094 Schluderns,54,,16,7,23
094 Schluderns,55,,10,16,26
094 Schluderns,56,,17,12,29
094 Schluderns,57,,14,8,22
094 Schluderns,58,,13,7,20
094 Schluderns,59,,7,5,12
094 Schluderns,60,,11,4,15
094 Schluderns,61,,8,14,22
094 Schluderns,62,,11,10,21
094 Schluderns,63,,8,9,17
094 Schluderns,64,,7,7,14
094 Schluderns,65,,6,9,15
094 Schluderns,66,,7,4,11
094 Schluderns,67,,5,12,17
094 Schluderns,68,,3,8,11
094 Schluderns,69,,8,7,15
094 Schluderns,70,,10,14,24
094 Schluderns,71,,6,5,11
094 Schluderns,72,,11,8,19
094 Schluderns,73,,8,7,15
094 Schluderns,74,,5,10,15
094 Schluderns,75,,4,6,10
094 Schluderns,76,,5,10,15
094 Schluderns,77,,8,10,18
094 Schluderns,78,,5,9,14
094 Schluderns,79,,7,10,17
094 Schluderns,80,,4,6,10
094 Schluderns,81,,5,7,12
094 Schluderns,82,,3,5,8
094 Schluderns,83,,4,6,10
094 Schluderns,84,,3,2,5
094 Schluderns,85,,2,10,12
094 Schluderns,86,,1,4,5
094 Schluderns,87,,1,1,2
094 Schluderns,88,,1,3,4
094 Schluderns,89,,2,1,3
094 Schluderns,90,,-,4,4
094 Schluderns,91,,-,1,1
094 Schluderns,92,,-,2,2
094 Schluderns,93,,1,1,2
094 Schluderns,94,,-,2,2
094 Schluderns,96,,-,1,1
095 Stilfs,0,,4,4,8
095 Stilfs,1,,2,5,7
095 Stilfs,2,,2,3,5
095 Stilfs,3,,6,5,11
095 Stilfs,4,,2,6,8
095 Stilfs,5,,5,2,7
095 Stilfs,6,,5,5,10
095 Stilfs,7,,5,4,9
095 Stilfs,8,,5,6,11
095 Stilfs,9,,5,3,8
095 Stilfs,10,,5,11,16
095 Stilfs,11,,9,4,13
095 Stilfs,12,,2,6,8
095 Stilfs,13,,8,3,11
095 Stilfs,14,,10,10,20
095 Stilfs,15,,11,1,12
095 Stilfs,16,,6,6,12
095 Stilfs,17,,8,7,15
095 Stilfs,18,,5,14,19
095 Stilfs,19,,4,9,13
095 Stilfs,20,,12,5,17
095 Stilfs,21,,18,8,26
095 Stilfs,22,,6,7,13
095 Stilfs,23,,7,3,10
095 Stilfs,24,,5,6,11
095 Stilfs,25,,9,9,18
095 Stilfs,26,,9,4,13
095 Stilfs,27,,13,7,20
095 Stilfs,28,,8,2,10
095 Stilfs,29,,10,6,16
095 Stilfs,30,,9,6,15
095 Stilfs,31,,4,5,9
095 Stilfs,32,,6,7,13
095 Stilfs,33,,5,10,15
095 Stilfs,34,,9,4,13
095 Stilfs,35,,14,4,18
095 Stilfs,36,,9,8,17
095 Stilfs,37,,3,7,10
095 Stilfs,38,,11,17,28
095 Stilfs,39,,9,11,20
095 Stilfs,40,,12,10,22
095 Stilfs,41,,10,12,22
095 Stilfs,42,,11,11,22
095 Stilfs,43,,9,10,19
095 Stilfs,44,,7,9,16
095 Stilfs,45,,18,8,26
095 Stilfs,46,,12,11,23
095 Stilfs,47,,12,5,17
095 Stilfs,48,,9,6,15
095 Stilfs,49,,7,12,19
095 Stilfs,50,,8,3,11
095 Stilfs,51,,8,7,15
095 Stilfs,52,,9,9,18
095 Stilfs,53,,7,14,21
095 Stilfs,54,,11,6,17
095 Stilfs,55,,5,9,14
095 Stilfs,56,,4,4,8
095 Stilfs,57,,16,9,25
095 Stilfs,58,,9,4,13
095 Stilfs,59,,9,5,14
095 Stilfs,60,,14,9,23
095 Stilfs,61,,1,6,7
095 Stilfs,62,,5,3,8
095 Stilfs,63,,7,9,16
095 Stilfs,64,,7,5,12
095 Stilfs,65,,9,9,18
095 Stilfs,66,,3,4,7
095 Stilfs,67,,12,8,20
095 Stilfs,68,,8,7,15
095 Stilfs,69,,4,12,16
095 Stilfs,70,,7,4,11
095 Stilfs,71,,5,9,14
095 Stilfs,72,,3,7,10
095 Stilfs,73,,3,4,7
095 Stilfs,74,,7,5,12
095 Stilfs,75,,3,9,12
095 Stilfs,76,,1,5,6
095 Stilfs,77,,4,4,8
095 Stilfs,78,,3,6,9
095 Stilfs,79,,3,6,9
095 Stilfs,80,,2,4,6
095 Stilfs,81,,5,5,10
095 Stilfs,82,,2,1,3
095 Stilfs,83,,3,6,9
095 Stilfs,84,,3,3,6
095 Stilfs,85,,1,5,6
095 Stilfs,86,,2,3,5
095 Stilfs,87,,-,5,5
095 Stilfs,88,,-,2,2
095 Stilfs,89,,1,4,5
095 Stilfs,90,,1,4,5
095 Stilfs,91,,-,2,2
095 Stilfs,94,,-,1,1
095 Stilfs,95,,-,1,1
095 Stilfs,97,,1,-,1
096 Terenten,0,,7,8,15
096 Terenten,1,,3,10,13
096 Terenten,2,,14,7,21
096 Terenten,3,,12,5,17
096 Terenten,4,,9,11,20
096 Terenten,5,,14,9,23
096 Terenten,6,,16,10,26
096 Terenten,7,,11,18,29
096 Terenten,8,,9,12,21
096 Terenten,9,,8,7,15
096 Terenten,10,,11,14,25
096 Terenten,11,,10,8,18
096 Terenten,12,,10,18,28
096 Terenten,13,,21,19,40
096 Terenten,14,,10,7,17
096 Terenten,15,,13,11,24
096 Terenten,16,,12,8,20
096 Terenten,17,,12,13,25
096 Terenten,18,,6,13,19
096 Terenten,19,,9,8,17
096 Terenten,20,,8,16,24
096 Terenten,21,,12,16,28
096 Terenten,22,,14,8,22
096 Terenten,23,,10,9,19
096 Terenten,24,,15,7,22
096 Terenten,25,,10,9,19
096 Terenten,26,,9,12,21
096 Terenten,27,,12,10,22
096 Terenten,28,,14,15,29
096 Terenten,29,,12,11,23
096 Terenten,30,,13,14,27
096 Terenten,31,,10,13,23
096 Terenten,32,,9,10,19
096 Terenten,33,,18,18,36
096 Terenten,34,,11,4,15
096 Terenten,35,,15,11,26
096 Terenten,36,,17,9,26
096 Terenten,37,,16,16,32
096 Terenten,38,,7,16,23
096 Terenten,39,,18,9,27
096 Terenten,40,,16,16,32
096 Terenten,41,,20,12,32
096 Terenten,42,,17,14,31
096 Terenten,43,,15,14,29
096 Terenten,44,,17,19,36
096 Terenten,45,,14,17,31
096 Terenten,46,,16,9,25
096 Terenten,47,,18,13,31
096 Terenten,48,,24,13,37
096 Terenten,49,,20,11,31
096 Terenten,50,,10,16,26
096 Terenten,51,,12,9,21
096 Terenten,52,,14,12,26
096 Terenten,53,,13,10,23
096 Terenten,54,,11,8,19
096 Terenten,55,,9,12,21
096 Terenten,56,,12,10,22
096 Terenten,57,,14,10,24
096 Terenten,58,,9,9,18
096 Terenten,59,,7,7,14
096 Terenten,60,,7,6,13
096 Terenten,61,,7,7,14
096 Terenten,62,,8,6,14
096 Terenten,63,,10,8,18
096 Terenten,64,,7,3,10
096 Terenten,65,,9,3,12
096 Terenten,66,,6,4,10
096 Terenten,67,,3,6,9
096 Terenten,68,,8,5,13
096 Terenten,69,,5,5,10
096 Terenten,70,,5,4,9
096 Terenten,71,,8,5,13
096 Terenten,72,,2,6,8
096 Terenten,73,,5,10,15
096 Terenten,74,,4,4,8
096 Terenten,75,,3,9,12
096 Terenten,76,,5,5,10
096 Terenten,77,,1,3,4
096 Terenten,78,,4,3,7
096 Terenten,79,,3,3,6
096 Terenten,80,,4,10,14
096 Terenten,81,,4,5,9
096 Terenten,82,,4,2,6
096 Terenten,83,,4,5,9
096 Terenten,84,,1,2,3
096 Terenten,85,,1,5,6
096 Terenten,86,,3,2,5
096 Terenten,87,,1,3,4
096 Terenten,88,,3,2,5
096 Terenten,90,,-,2,2
096 Terenten,91,,1,3,4
096 Terenten,92,,1,-,1
097 Terlan,0,,35,24,59
097 Terlan,1,,14,14,28
097 Terlan,2,,36,23,59
097 Terlan,3,,23,24,47
097 Terlan,4,,21,19,40
097 Terlan,5,,22,32,54
097 Terlan,6,,19,24,43
097 Terlan,7,,27,20,47
097 Terlan,8,,22,24,46
097 Terlan,9,,20,15,35
097 Terlan,10,,22,27,49
097 Terlan,11,,36,25,61
097 Terlan,12,,32,20,52
097 Terlan,13,,20,22,42
097 Terlan,14,,36,29,65
097 Terlan,15,,13,27,40
097 Terlan,16,,26,27,53
097 Terlan,17,,24,20,44
097 Terlan,18,,29,23,52
097 Terlan,19,,24,31,55
097 Terlan,20,,26,19,45
097 Terlan,21,,15,23,38
097 Terlan,22,,23,30,53
097 Terlan,23,,25,18,43
097 Terlan,24,,29,18,47
097 Terlan,25,,21,24,45
097 Terlan,26,,28,20,48
097 Terlan,27,,17,21,38
097 Terlan,28,,25,16,41
097 Terlan,29,,18,21,39
097 Terlan,30,,19,22,41
097 Terlan,31,,33,31,64
097 Terlan,32,,23,26,49
097 Terlan,33,,17,31,48
097 Terlan,34,,41,25,66
097 Terlan,35,,36,35,71
097 Terlan,36,,33,39,72
097 Terlan,37,,28,49,77
097 Terlan,38,,32,37,69
097 Terlan,39,,41,28,69
097 Terlan,40,,31,26,57
097 Terlan,41,,43,44,87
097 Terlan,42,,37,32,69
097 Terlan,43,,38,34,72
097 Terlan,44,,32,40,72
097 Terlan,45,,47,37,84
097 Terlan,46,,35,28,63
097 Terlan,47,,35,30,65
097 Terlan,48,,36,30,66
097 Terlan,49,,30,35,65
097 Terlan,50,,43,28,71
097 Terlan,51,,27,37,64
097 Terlan,52,,20,25,45
097 Terlan,53,,32,23,55
097 Terlan,54,,25,28,53
097 Terlan,55,,29,31,60
097 Terlan,56,,24,21,45
097 Terlan,57,,26,20,46
097 Terlan,58,,12,23,35
097 Terlan,59,,16,25,41
097 Terlan,60,,24,17,41
097 Terlan,61,,24,25,49
097 Terlan,62,,19,16,35
097 Terlan,63,,18,23,41
097 Terlan,64,,17,19,36
097 Terlan,65,,14,25,39
097 Terlan,66,,22,22,44
097 Terlan,67,,24,22,46
097 Terlan,68,,14,28,42
097 Terlan,69,,31,21,52
097 Terlan,70,,22,25,47
097 Terlan,71,,20,16,36
097 Terlan,72,,14,19,33
097 Terlan,73,,19,15,34
097 Terlan,74,,12,16,28
097 Terlan,75,,4,11,15
097 Terlan,76,,15,22,37
097 Terlan,77,,9,23,32
097 Terlan,78,,10,14,24
097 Terlan,79,,12,11,23
097 Terlan,80,,17,10,27
097 Terlan,81,,10,15,25
097 Terlan,82,,9,11,20
097 Terlan,83,,9,8,17
097 Terlan,84,,7,9,16
097 Terlan,85,,3,14,17
097 Terlan,86,,6,9,15
097 Terlan,87,,4,10,14
097 Terlan,88,,4,20,24
097 Terlan,89,,3,11,14
097 Terlan,90,,1,6,7
097 Terlan,91,,-,5,5
097 Terlan,92,,-,3,3
097 Terlan,93,,1,2,3
097 Terlan,94,,-,3,3
097 Terlan,95,,-,3,3
097 Terlan,96,,1,1,2
097 Terlan,97,,-,2,2
097 Terlan,98,,-,2,2
098 Tramin a.d. Weinstr.,0,,13,11,24
098 Tramin a.d. Weinstr.,1,,18,12,30
098 Tramin a.d. Weinstr.,2,,22,14,36
098 Tramin a.d. Weinstr.,3,,18,11,29
098 Tramin a.d. Weinstr.,4,,14,12,26
098 Tramin a.d. Weinstr.,5,,15,11,26
098 Tramin a.d. Weinstr.,6,,18,11,29
098 Tramin a.d. Weinstr.,7,,13,18,31
098 Tramin a.d. Weinstr.,8,,27,16,43
098 Tramin a.d. Weinstr.,9,,14,17,31
098 Tramin a.d. Weinstr.,10,,21,19,40
098 Tramin a.d. Weinstr.,11,,23,13,36
098 Tramin a.d. Weinstr.,12,,19,18,37
098 Tramin a.d. Weinstr.,13,,14,19,33
098 Tramin a.d. Weinstr.,14,,28,15,43
098 Tramin a.d. Weinstr.,15,,20,27,47
098 Tramin a.d. Weinstr.,16,,18,20,38
098 Tramin a.d. Weinstr.,17,,22,20,42
098 Tramin a.d. Weinstr.,18,,18,19,37
098 Tramin a.d. Weinstr.,19,,21,25,46
098 Tramin a.d. Weinstr.,20,,22,10,32
098 Tramin a.d. Weinstr.,21,,23,20,43
098 Tramin a.d. Weinstr.,22,,14,28,42
098 Tramin a.d. Weinstr.,23,,13,28,41
098 Tramin a.d. Weinstr.,24,,23,24,47
098 Tramin a.d. Weinstr.,25,,12,14,26
098 Tramin a.d. Weinstr.,26,,24,23,47
098 Tramin a.d. Weinstr.,27,,22,16,38
098 Tramin a.d. Weinstr.,28,,18,19,37
098 Tramin a.d. Weinstr.,29,,23,24,47
098 Tramin a.d. Weinstr.,30,,35,13,48
098 Tramin a.d. Weinstr.,31,,21,18,39
098 Tramin a.d. Weinstr.,32,,15,16,31
098 Tramin a.d. Weinstr.,33,,11,24,35
098 Tramin a.d. Weinstr.,34,,21,18,39
098 Tramin a.d. Weinstr.,35,,25,13,38
098 Tramin a.d. Weinstr.,36,,21,24,45
098 Tramin a.d. Weinstr.,37,,25,19,44
098 Tramin a.d. Weinstr.,38,,20,15,35
098 Tramin a.d. Weinstr.,39,,19,28,47
098 Tramin a.d. Weinstr.,40,,25,37,62
098 Tramin a.d. Weinstr.,41,,27,21,48
098 Tramin a.d. Weinstr.,42,,29,29,58
098 Tramin a.d. Weinstr.,43,,27,21,48
098 Tramin a.d. Weinstr.,44,,31,32,63
098 Tramin a.d. Weinstr.,45,,31,26,57
098 Tramin a.d. Weinstr.,46,,35,29,64
098 Tramin a.d. Weinstr.,47,,28,28,56
098 Tramin a.d. Weinstr.,48,,23,22,45
098 Tramin a.d. Weinstr.,49,,23,14,37
098 Tramin a.d. Weinstr.,50,,30,25,55
098 Tramin a.d. Weinstr.,51,,27,34,61
098 Tramin a.d. Weinstr.,52,,16,32,48
098 Tramin a.d. Weinstr.,53,,26,23,49
098 Tramin a.d. Weinstr.,54,,22,24,46
098 Tramin a.d. Weinstr.,55,,25,21,46
098 Tramin a.d. Weinstr.,56,,18,19,37
098 Tramin a.d. Weinstr.,57,,21,19,40
098 Tramin a.d. Weinstr.,58,,16,15,31
098 Tramin a.d. Weinstr.,59,,18,18,36
098 Tramin a.d. Weinstr.,60,,12,14,26
098 Tramin a.d. Weinstr.,61,,15,19,34
098 Tramin a.d. Weinstr.,62,,15,17,32
098 Tramin a.d. Weinstr.,63,,17,19,36
098 Tramin a.d. Weinstr.,64,,14,21,35
098 Tramin a.d. Weinstr.,65,,18,17,35
098 Tramin a.d. Weinstr.,66,,7,9,16
098 Tramin a.d. Weinstr.,67,,22,26,48
098 Tramin a.d. Weinstr.,68,,18,21,39
098 Tramin a.d. Weinstr.,69,,20,16,36
098 Tramin a.d. Weinstr.,70,,13,24,37
098 Tramin a.d. Weinstr.,71,,21,17,38
098 Tramin a.d. Weinstr.,72,,12,12,24
098 Tramin a.d. Weinstr.,73,,6,18,24
098 Tramin a.d. Weinstr.,74,,12,13,25
098 Tramin a.d. Weinstr.,75,,14,12,26
098 Tramin a.d. Weinstr.,76,,15,12,27
098 Tramin a.d. Weinstr.,77,,8,13,21
098 Tramin a.d. Weinstr.,78,,7,13,20
098 Tramin a.d. Weinstr.,79,,10,15,25
098 Tramin a.d. Weinstr.,80,,6,15,21
098 Tramin a.d. Weinstr.,81,,15,11,26
098 Tramin a.d. Weinstr.,82,,8,14,22
098 Tramin a.d. Weinstr.,83,,10,9,19
098 Tramin a.d. Weinstr.,84,,10,11,21
098 Tramin a.d. Weinstr.,85,,8,14,22
098 Tramin a.d. Weinstr.,86,,6,16,22
098 Tramin a.d. Weinstr.,87,,4,12,16
098 Tramin a.d. Weinstr.,88,,3,11,14
098 Tramin a.d. Weinstr.,89,,-,5,5
098 Tramin a.d. Weinstr.,90,,2,7,9
098 Tramin a.d. Weinstr.,91,,1,5,6
098 Tramin a.d. Weinstr.,92,,1,4,5
098 Tramin a.d. Weinstr.,93,,1,1,2
098 Tramin a.d. Weinstr.,95,,1,-,1
098 Tramin a.d. Weinstr.,96,,-,2,2
098 Tramin a.d. Weinstr.,97,,-,1,1
098 Tramin a.d. Weinstr.,99,,1,1,2
099 Tisens,0,,7,8,15
099 Tisens,1,,10,7,17
099 Tisens,2,,7,3,10
099 Tisens,3,,12,7,19
099 Tisens,4,,12,10,22
099 Tisens,5,,10,7,17
099 Tisens,6,,12,17,29
099 Tisens,7,,12,13,25
099 Tisens,8,,10,13,23
099 Tisens,9,,12,9,21
099 Tisens,10,,11,17,28
099 Tisens,11,,10,12,22
099 Tisens,12,,10,8,18
099 Tisens,13,,13,14,27
099 Tisens,14,,4,7,11
099 Tisens,15,,10,7,17
099 Tisens,16,,10,6,16
099 Tisens,17,,11,11,22
099 Tisens,18,,5,9,14
099 Tisens,19,,6,16,22
099 Tisens,20,,16,9,25
099 Tisens,21,,9,13,22
099 Tisens,22,,11,7,18
099 Tisens,23,,8,12,20
099 Tisens,24,,16,7,23
099 Tisens,25,,15,8,23
099 Tisens,26,,11,8,19
099 Tisens,27,,9,12,21
099 Tisens,28,,17,6,23
099 Tisens,29,,16,14,30
099 Tisens,30,,6,21,27
099 Tisens,31,,16,12,28
099 Tisens,32,,11,10,21
099 Tisens,33,,11,17,28
099 Tisens,34,,12,9,21
099 Tisens,35,,9,8,17
099 Tisens,36,,16,11,27
099 Tisens,37,,14,10,24
099 Tisens,38,,7,11,18
099 Tisens,39,,10,13,23
099 Tisens,40,,16,11,27
099 Tisens,41,,16,20,36
099 Tisens,42,,19,17,36
099 Tisens,43,,19,21,40
099 Tisens,44,,23,21,44
099 Tisens,45,,24,10,34
099 Tisens,46,,18,29,47
099 Tisens,47,,16,9,25
099 Tisens,48,,18,14,32
099 Tisens,49,,21,6,27
099 Tisens,50,,14,14,28
099 Tisens,51,,16,6,22
099 Tisens,52,,12,14,26
099 Tisens,53,,9,13,22
099 Tisens,54,,15,19,34
099 Tisens,55,,10,12,22
099 Tisens,56,,18,13,31
099 Tisens,57,,8,8,16
099 Tisens,58,,10,11,21
099 Tisens,59,,7,13,20
099 Tisens,60,,12,10,22
099 Tisens,61,,10,6,16
099 Tisens,62,,5,7,12
099 Tisens,63,,13,7,20
099 Tisens,64,,9,9,18
099 Tisens,65,,7,6,13
099 Tisens,66,,3,6,9
099 Tisens,67,,9,11,20
099 Tisens,68,,10,9,19
099 Tisens,69,,7,11,18
099 Tisens,70,,7,14,21
099 Tisens,71,,4,8,12
099 Tisens,72,,11,9,20
099 Tisens,73,,6,12,18
099 Tisens,74,,5,4,9
099 Tisens,75,,7,8,15
099 Tisens,76,,3,12,15
099 Tisens,77,,7,6,13
099 Tisens,78,,2,10,12
099 Tisens,79,,5,9,14
099 Tisens,80,,5,9,14
099 Tisens,81,,2,15,17
099 Tisens,82,,6,8,14
099 Tisens,83,,4,9,13
099 Tisens,84,,5,6,11
099 Tisens,85,,4,9,13
099 Tisens,86,,3,8,11
099 Tisens,87,,1,3,4
099 Tisens,88,,-,6,6
099 Tisens,89,,3,4,7
099 Tisens,90,,2,3,5
099 Tisens,91,,2,-,2
099 Tisens,92,,2,2,4
099 Tisens,93,,-,1,1
099 Tisens,95,,-,1,1
099 Tisens,96,,-,1,1
099 Tisens,97,,-,1,1
099 Tisens,99,,-,1,1
099 Tisens,100,,-,1,1
100 Tiers,0,,3,6,9
100 Tiers,1,,11,4,15
100 Tiers,2,,3,3,6
100 Tiers,3,,9,8,17
100 Tiers,4,,9,3,12
100 Tiers,5,,2,7,9
100 Tiers,6,,2,9,11
100 Tiers,7,,5,3,8
100 Tiers,8,,4,9,13
100 Tiers,9,,6,5,11
100 Tiers,10,,3,9,12
100 Tiers,11,,2,8,10
100 Tiers,12,,4,9,13
100 Tiers,13,,4,10,14
100 Tiers,14,,9,6,15
100 Tiers,15,,6,4,10
100 Tiers,16,,7,10,17
100 Tiers,17,,5,7,12
100 Tiers,18,,5,2,7
100 Tiers,19,,6,3,9
100 Tiers,20,,6,3,9
100 Tiers,21,,8,7,15
100 Tiers,22,,5,7,12
100 Tiers,23,,7,9,16
100 Tiers,24,,5,4,9
100 Tiers,25,,9,5,14
100 Tiers,26,,5,6,11
100 Tiers,27,,4,9,13
100 Tiers,28,,6,5,11
100 Tiers,29,,6,3,9
100 Tiers,30,,4,5,9
100 Tiers,31,,5,5,10
100 Tiers,32,,2,5,7
100 Tiers,33,,10,8,18
100 Tiers,34,,5,1,6
100 Tiers,35,,1,4,5
100 Tiers,36,,9,10,19
100 Tiers,37,,5,8,13
100 Tiers,38,,9,9,18
100 Tiers,39,,10,7,17
100 Tiers,40,,5,7,12
100 Tiers,41,,7,8,15
100 Tiers,42,,15,11,26
100 Tiers,43,,7,3,10
100 Tiers,44,,10,12,22
100 Tiers,45,,10,6,16
100 Tiers,46,,5,7,12
100 Tiers,47,,8,6,14
100 Tiers,48,,7,10,17
100 Tiers,49,,6,7,13
100 Tiers,50,,6,6,12
100 Tiers,51,,4,9,13
100 Tiers,52,,12,6,18
100 Tiers,53,,7,4,11
100 Tiers,54,,5,9,14
100 Tiers,55,,10,8,18
100 Tiers,56,,5,4,9
100 Tiers,57,,6,4,10
100 Tiers,58,,6,5,11
100 Tiers,59,,3,2,5
100 Tiers,60,,1,4,5
100 Tiers,61,,7,5,12
100 Tiers,62,,3,4,7
100 Tiers,63,,3,5,8
100 Tiers,64,,-,3,3
100 Tiers,65,,5,4,9
100 Tiers,66,,8,3,11
100 Tiers,67,,2,4,6
100 Tiers,68,,9,10,19
100 Tiers,69,,2,5,7
100 Tiers,70,,4,6,10
100 Tiers,71,,2,3,5
100 Tiers,72,,5,6,11
100 Tiers,73,,6,5,11
100 Tiers,74,,4,4,8
100 Tiers,75,,4,5,9
100 Tiers,76,,6,2,8
100 Tiers,77,,2,5,7
100 Tiers,78,,5,4,9
100 Tiers,79,,2,5,7
100 Tiers,80,,3,3,6
100 Tiers,81,,2,-,2
100 Tiers,82,,2,2,4
100 Tiers,83,,2,2,4
100 Tiers,84,,3,3,6
100 Tiers,85,,3,2,5
100 Tiers,86,,5,1,6
100 Tiers,87,,1,4,5
100 Tiers,88,,-,2,2
100 Tiers,89,,1,-,1
100 Tiers,90,,-,5,5
100 Tiers,91,,1,1,2
100 Tiers,93,,1,1,2
100 Tiers,94,,-,1,1
100 Tiers,96,,1,-,1
100 Tiers,99,,-,1,1
101 Tirol,0,,9,15,24
101 Tirol,1,,14,13,27
101 Tirol,2,,10,9,19
101 Tirol,3,,9,13,22
101 Tirol,4,,14,9,23
101 Tirol,5,,10,10,20
101 Tirol,6,,14,6,20
101 Tirol,7,,12,18,30
101 Tirol,8,,12,12,24
101 Tirol,9,,16,9,25
101 Tirol,10,,19,9,28
101 Tirol,11,,21,13,34
101 Tirol,12,,13,16,29
101 Tirol,13,,17,13,30
101 Tirol,14,,19,23,42
101 Tirol,15,,18,17,35
101 Tirol,16,,9,17,26
101 Tirol,17,,14,15,29
101 Tirol,18,,22,12,34
101 Tirol,19,,14,13,27
101 Tirol,20,,6,9,15
101 Tirol,21,,16,11,27
101 Tirol,22,,11,18,29
101 Tirol,23,,12,15,27
101 Tirol,24,,16,13,29
101 Tirol,25,,10,12,22
101 Tirol,26,,9,15,24
101 Tirol,27,,18,13,31
101 Tirol,28,,18,16,34
101 Tirol,29,,17,10,27
101 Tirol,30,,17,20,37
101 Tirol,31,,22,4,26
101 Tirol,32,,12,10,22
101 Tirol,33,,6,12,18
101 Tirol,34,,13,21,34
101 Tirol,35,,15,15,30
101 Tirol,36,,19,15,34
101 Tirol,37,,15,22,37
101 Tirol,38,,25,17,42
101 Tirol,39,,27,19,46
101 Tirol,40,,22,20,42
101 Tirol,41,,22,16,38
101 Tirol,42,,23,19,42
101 Tirol,43,,26,26,52
101 Tirol,44,,25,18,43
101 Tirol,45,,23,20,43
101 Tirol,46,,21,19,40
101 Tirol,47,,25,22,47
101 Tirol,48,,18,15,33
101 Tirol,49,,19,17,36
101 Tirol,50,,19,23,42
101 Tirol,51,,23,13,36
101 Tirol,52,,16,16,32
101 Tirol,53,,11,17,28
101 Tirol,54,,16,20,36
101 Tirol,55,,8,15,23
101 Tirol,56,,15,18,33
101 Tirol,57,,13,17,30
101 Tirol,58,,19,17,36
101 Tirol,59,,14,13,27
101 Tirol,60,,15,18,33
101 Tirol,61,,12,10,22
101 Tirol,62,,16,16,32
101 Tirol,63,,19,14,33
101 Tirol,64,,9,12,21
101 Tirol,65,,13,8,21
101 Tirol,66,,11,14,25
101 Tirol,67,,14,15,29
101 Tirol,68,,11,11,22
101 Tirol,69,,13,18,31
101 Tirol,70,,11,17,28
101 Tirol,71,,10,14,24
101 Tirol,72,,9,12,21
101 Tirol,73,,8,8,16
101 Tirol,74,,8,14,22
101 Tirol,75,,6,10,16
101 Tirol,76,,7,7,14
101 Tirol,77,,13,8,21
101 Tirol,78,,5,10,15
101 Tirol,79,,6,6,12
101 Tirol,80,,6,7,13
101 Tirol,81,,4,6,10
101 Tirol,82,,6,10,16
101 Tirol,83,,5,7,12
101 Tirol,84,,9,7,16
101 Tirol,85,,1,6,7
101 Tirol,86,,6,6,12
101 Tirol,87,,3,9,12
101 Tirol,88,,2,5,7
101 Tirol,89,,2,3,5
101 Tirol,90,,2,3,5
101 Tirol,91,,1,4,5
101 Tirol,92,,1,1,2
101 Tirol,93,,1,1,2
101 Tirol,95,,1,1,2
102 Truden im Naturpark,0,,2,1,3
102 Truden im Naturpark,1,,9,6,15
102 Truden im Naturpark,2,,10,8,18
102 Truden im Naturpark,3,,7,8,15
102 Truden im Naturpark,4,,9,9,18
102 Truden im Naturpark,5,,5,1,6
102 Truden im Naturpark,6,,1,5,6
102 Truden im Naturpark,7,,3,9,12
102 Truden im Naturpark,8,,6,4,10
102 Truden im Naturpark,9,,2,3,5
102 Truden im Naturpark,10,,4,2,6
102 Truden im Naturpark,11,,6,7,13
102 Truden im Naturpark,12,,-,3,3
102 Truden im Naturpark,13,,2,8,10
102 Truden im Naturpark,14,,7,6,13
102 Truden im Naturpark,15,,6,6,12
102 Truden im Naturpark,16,,5,6,11
102 Truden im Naturpark,17,,7,5,12
102 Truden im Naturpark,18,,11,6,17
102 Truden im Naturpark,19,,7,5,12
102 Truden im Naturpark,20,,6,9,15
102 Truden im Naturpark,21,,4,5,9
102 Truden im Naturpark,22,,11,9,20
102 Truden im Naturpark,23,,8,12,20
102 Truden im Naturpark,24,,8,4,12
102 Truden im Naturpark,25,,2,7,9
102 Truden im Naturpark,26,,8,6,14
102 Truden im Naturpark,27,,12,5,17
102 Truden im Naturpark,28,,5,5,10
102 Truden im Naturpark,29,,10,5,15
102 Truden im Naturpark,30,,3,11,14
102 Truden im Naturpark,31,,6,5,11
102 Truden im Naturpark,32,,8,5,13
102 Truden im Naturpark,33,,9,6,15
102 Truden im Naturpark,34,,3,6,9
102 Truden im Naturpark,35,,8,6,14
102 Truden im Naturpark,36,,6,3,9
102 Truden im Naturpark,37,,7,10,17
102 Truden im Naturpark,38,,8,9,17
102 Truden im Naturpark,39,,9,9,18
102 Truden im Naturpark,40,,4,2,6
102 Truden im Naturpark,41,,1,8,9
102 Truden im Naturpark,42,,9,9,18
102 Truden im Naturpark,43,,6,8,14
102 Truden im Naturpark,44,,12,6,18
102 Truden im Naturpark,45,,5,9,14
102 Truden im Naturpark,46,,8,8,16
102 Truden im Naturpark,47,,10,8,18
102 Truden im Naturpark,48,,12,7,19
102 Truden im Naturpark,49,,9,4,13
102 Truden im Naturpark,50,,8,7,15
102 Truden im Naturpark,51,,9,13,22
102 Truden im Naturpark,52,,5,9,14
102 Truden im Naturpark,53,,6,12,18
102 Truden im Naturpark,54,,7,8,15
102 Truden im Naturpark,55,,7,5,12
102 Truden im Naturpark,56,,7,10,17
102 Truden im Naturpark,57,,5,6,11
102 Truden im Naturpark,58,,9,6,15
102 Truden im Naturpark,59,,5,6,11
102 Truden im Naturpark,60,,8,5,13
102 Truden im Naturpark,61,,2,3,5
102 Truden im Naturpark,62,,7,4,11
102 Truden im Naturpark,63,,1,5,6
102 Truden im Naturpark,64,,7,2,9
102 Truden im Naturpark,65,,9,6,15
102 Truden im Naturpark,66,,4,3,7
102 Truden im Naturpark,67,,3,6,9
102 Truden im Naturpark,68,,4,5,9
102 Truden im Naturpark,69,,4,4,8
102 Truden im Naturpark,70,,4,5,9
102 Truden im Naturpark,71,,2,4,6
102 Truden im Naturpark,72,,8,2,10
102 Truden im Naturpark,73,,5,7,12
102 Truden im Naturpark,74,,1,4,5
102 Truden im Naturpark,75,,4,2,6
102 Truden im Naturpark,76,,3,1,4
102 Truden im Naturpark,77,,4,1,5
102 Truden im Naturpark,78,,4,7,11
102 Truden im Naturpark,79,,3,3,6
102 Truden im Naturpark,80,,2,3,5
102 Truden im Naturpark,81,,2,7,9
102 Truden im Naturpark,82,,-,6,6
102 Truden im Naturpark,83,,-,6,6
102 Truden im Naturpark,84,,3,5,8
102 Truden im Naturpark,85,,1,6,7
102 Truden im Naturpark,86,,-,4,4
102 Truden im Naturpark,87,,-,4,4
102 Truden im Naturpark,88,,-,4,4
102 Truden im Naturpark,89,,2,3,5
102 Truden im Naturpark,90,,-,3,3
102 Truden im Naturpark,91,,-,2,2
102 Truden im Naturpark,92,,-,2,2
103 Taufers im Münstertal,0,,5,6,11
103 Taufers im Münstertal,1,,3,-,3
103 Taufers im Münstertal,2,,7,6,13
103 Taufers im Münstertal,3,,5,5,10
103 Taufers im Münstertal,4,,5,4,9
103 Taufers im Münstertal,5,,4,8,12
103 Taufers im Münstertal,6,,2,5,7
103 Taufers im Münstertal,7,,8,4,12
103 Taufers im Münstertal,8,,3,3,6
103 Taufers im Münstertal,9,,5,5,10
103 Taufers im Münstertal,10,,5,6,11
103 Taufers im Münstertal,11,,4,4,8
103 Taufers im Münstertal,12,,3,4,7
103 Taufers im Münstertal,13,,7,8,15
103 Taufers im Münstertal,14,,4,4,8
103 Taufers im Münstertal,15,,6,4,10
103 Taufers im Münstertal,16,,9,9,18
103 Taufers im Münstertal,17,,6,8,14
103 Taufers im Münstertal,18,,6,5,11
103 Taufers im Münstertal,19,,9,8,17
103 Taufers im Münstertal,20,,6,10,16
103 Taufers im Münstertal,21,,7,8,15
103 Taufers im Münstertal,22,,8,3,11
103 Taufers im Münstertal,23,,6,6,12
103 Taufers im Münstertal,24,,4,7,11
103 Taufers im Münstertal,25,,6,4,10
103 Taufers im Münstertal,26,,6,5,11
103 Taufers im Münstertal,27,,5,7,12
103 Taufers im Münstertal,28,,4,6,10
103 Taufers im Münstertal,29,,5,11,16
103 Taufers im Münstertal,30,,7,8,15
103 Taufers im Münstertal,31,,8,5,13
103 Taufers im Münstertal,32,,4,3,7
103 Taufers im Münstertal,33,,7,3,10
103 Taufers im Münstertal,34,,4,3,7
103 Taufers im Münstertal,35,,2,7,9
103 Taufers im Münstertal,36,,11,5,16
103 Taufers im Münstertal,37,,6,6,12
103 Taufers im Münstertal,38,,1,6,7
103 Taufers im Münstertal,39,,5,7,12
103 Taufers im Münstertal,40,,6,15,21
103 Taufers im Münstertal,41,,6,10,16
103 Taufers im Münstertal,42,,9,5,14
103 Taufers im Münstertal,43,,9,12,21
103 Taufers im Münstertal,44,,4,5,9
103 Taufers im Münstertal,45,,5,10,15
103 Taufers im Münstertal,46,,11,7,18
103 Taufers im Münstertal,47,,10,12,22
103 Taufers im Münstertal,48,,9,9,18
103 Taufers im Münstertal,49,,12,8,20
103 Taufers im Münstertal,50,,10,7,17
103 Taufers im Münstertal,51,,12,7,19
103 Taufers im Münstertal,52,,6,10,16
103 Taufers im Münstertal,53,,5,6,11
103 Taufers im Münstertal,54,,8,7,15
103 Taufers im Münstertal,55,,11,10,21
103 Taufers im Münstertal,56,,5,3,8
103 Taufers im Münstertal,57,,4,6,10
103 Taufers im Münstertal,58,,6,4,10
103 Taufers im Münstertal,59,,7,2,9
103 Taufers im Münstertal,60,,5,4,9
103 Taufers im Münstertal,61,,7,2,9
103 Taufers im Münstertal,62,,5,1,6
103 Taufers im Münstertal,63,,5,-,5
103 Taufers im Münstertal,64,,4,6,10
103 Taufers im Münstertal,65,,3,3,6
103 Taufers im Münstertal,66,,3,4,7
103 Taufers im Münstertal,67,,1,-,1
103 Taufers im Münstertal,68,,6,4,10
103 Taufers im Münstertal,69,,4,4,8
103 Taufers im Münstertal,70,,3,6,9
103 Taufers im Münstertal,71,,2,3,5
103 Taufers im Münstertal,72,,4,4,8
103 Taufers im Münstertal,73,,6,8,14
103 Taufers im Münstertal,74,,3,3,6
103 Taufers im Münstertal,75,,2,8,10
103 Taufers im Münstertal,76,,3,2,5
103 Taufers im Münstertal,77,,2,7,9
103 Taufers im Münstertal,78,,3,5,8
103 Taufers im Münstertal,79,,5,1,6
103 Taufers im Münstertal,80,,7,4,11
103 Taufers im Münstertal,81,,2,4,6
103 Taufers im Münstertal,82,,4,5,9
103 Taufers im Münstertal,83,,3,4,7
103 Taufers im Münstertal,84,,2,3,5
103 Taufers im Münstertal,85,,1,4,5
103 Taufers im Münstertal,86,,1,3,4
103 Taufers im Münstertal,87,,-,3,3
103 Taufers im Münstertal,88,,3,2,5
103 Taufers im Münstertal,89,,-,1,1
103 Taufers im Münstertal,90,,1,-,1
103 Taufers im Münstertal,91,,2,-,2
103 Taufers im Münstertal,93,,-,1,1
103 Taufers im Münstertal,94,,1,1,2
103 Taufers im Münstertal,99,,-,1,1
104 Ulten,0,,14,21,35
104 Ulten,1,,16,12,28
104 Ulten,2,,19,12,31
104 Ulten,3,,17,10,27
104 Ulten,4,,6,10,16
104 Ulten,5,,14,12,26
104 Ulten,6,,18,21,39
104 Ulten,7,,17,12,29
104 Ulten,8,,23,18,41
104 Ulten,9,,15,18,33
104 Ulten,10,,20,17,37
104 Ulten,11,,16,18,34
104 Ulten,12,,14,14,28
104 Ulten,13,,16,16,32
104 Ulten,14,,13,20,33
104 Ulten,15,,11,14,25
104 Ulten,16,,12,15,27
104 Ulten,17,,18,14,32
104 Ulten,18,,23,14,37
104 Ulten,19,,17,17,34
104 Ulten,20,,24,29,53
104 Ulten,21,,14,16,30
104 Ulten,22,,16,29,45
104 Ulten,23,,13,20,33
104 Ulten,24,,18,17,35
104 Ulten,25,,19,11,30
104 Ulten,26,,17,17,34
104 Ulten,27,,20,16,36
104 Ulten,28,,22,13,35
104 Ulten,29,,15,21,36
104 Ulten,30,,23,19,42
104 Ulten,31,,19,20,39
104 Ulten,32,,16,18,34
104 Ulten,33,,23,16,39
104 Ulten,34,,17,14,31
104 Ulten,35,,18,19,37
104 Ulten,36,,23,22,45
104 Ulten,37,,14,21,35
104 Ulten,38,,25,13,38
104 Ulten,39,,21,19,40
104 Ulten,40,,26,20,46
104 Ulten,41,,22,25,47
104 Ulten,42,,26,21,47
104 Ulten,43,,30,25,55
104 Ulten,44,,16,20,36
104 Ulten,45,,20,17,37
104 Ulten,46,,26,26,52
104 Ulten,47,,25,20,45
104 Ulten,48,,29,25,54
104 Ulten,49,,31,21,52
104 Ulten,50,,29,16,45
104 Ulten,51,,25,21,46
104 Ulten,52,,23,21,44
104 Ulten,53,,26,16,42
104 Ulten,54,,34,22,56
104 Ulten,55,,18,15,33
104 Ulten,56,,13,12,25
104 Ulten,57,,17,15,32
104 Ulten,58,,22,13,35
104 Ulten,59,,18,13,31
104 Ulten,60,,17,17,34
104 Ulten,61,,18,12,30
104 Ulten,62,,17,9,26
104 Ulten,63,,13,12,25
104 Ulten,64,,16,9,25
104 Ulten,65,,15,14,29
104 Ulten,66,,9,13,22
104 Ulten,67,,14,21,35
104 Ulten,68,,17,16,33
104 Ulten,69,,8,13,21
104 Ulten,70,,11,10,21
104 Ulten,71,,14,8,22
104 Ulten,72,,17,17,34
104 Ulten,73,,6,10,16
104 Ulten,74,,10,9,19
104 Ulten,75,,8,9,17
104 Ulten,76,,9,10,19
104 Ulten,77,,10,13,23
104 Ulten,78,,4,12,16
104 Ulten,79,,8,8,16
104 Ulten,80,,10,8,18
104 Ulten,81,,10,15,25
104 Ulten,82,,3,11,14
104 Ulten,83,,7,11,18
104 Ulten,84,,6,16,22
104 Ulten,85,,4,12,16
104 Ulten,86,,8,8,16
104 Ulten,87,,4,7,11
104 Ulten,88,,5,21,26
104 Ulten,89,,3,6,9
104 Ulten,90,,5,8,13
104 Ulten,91,,2,4,6
104 Ulten,92,,1,4,5
104 Ulten,93,,1,-,1
104 Ulten,96,,1,-,1
104 Ulten,97,,-,1,1
104 Ulten,100,,-,2,2
105 Pfatten,0,,11,9,20
105 Pfatten,1,,6,4,10
105 Pfatten,2,,6,7,13
105 Pfatten,3,,7,6,13
105 Pfatten,4,,8,8,16
105 Pfatten,5,,8,3,11
105 Pfatten,6,,5,11,16
105 Pfatten,7,,2,6,8
105 Pfatten,8,,12,5,17
105 Pfatten,9,,3,5,8
105 Pfatten,10,,5,3,8
105 Pfatten,11,,6,5,11
105 Pfatten,12,,4,7,11
105 Pfatten,13,,8,5,13
105 Pfatten,14,,5,2,7
105 Pfatten,15,,4,9,13
105 Pfatten,16,,5,7,12
105 Pfatten,17,,8,10,18
105 Pfatten,18,,5,5,10
105 Pfatten,19,,6,6,12
105 Pfatten,20,,8,6,14
105 Pfatten,21,,9,8,17
105 Pfatten,22,,6,6,12
105 Pfatten,23,,2,5,7
105 Pfatten,24,,8,4,12
105 Pfatten,25,,5,12,17
105 Pfatten,26,,6,9,15
105 Pfatten,27,,4,6,10
105 Pfatten,28,,8,10,18
105 Pfatten,29,,6,5,11
105 Pfatten,30,,11,4,15
105 Pfatten,31,,2,3,5
105 Pfatten,32,,6,12,18
105 Pfatten,33,,5,10,15
105 Pfatten,34,,7,5,12
105 Pfatten,35,,5,10,15
105 Pfatten,36,,4,9,13
105 Pfatten,37,,13,10,23
105 Pfatten,38,,12,4,16
105 Pfatten,39,,10,8,18
105 Pfatten,40,,11,6,17
105 Pfatten,41,,9,8,17
105 Pfatten,42,,6,4,10
105 Pfatten,43,,7,8,15
105 Pfatten,44,,14,7,21
105 Pfatten,45,,9,9,18
105 Pfatten,46,,10,11,21
105 Pfatten,47,,11,3,14
105 Pfatten,48,,8,9,17
105 Pfatten,49,,11,13,24
105 Pfatten,50,,10,13,23
105 Pfatten,51,,8,9,17
105 Pfatten,52,,5,14,19
105 Pfatten,53,,7,6,13
105 Pfatten,54,,14,7,21
105 Pfatten,55,,9,9,18
105 Pfatten,56,,5,5,10
105 Pfatten,57,,11,3,14
105 Pfatten,58,,6,5,11
105 Pfatten,59,,1,6,7
105 Pfatten,60,,3,5,8
105 Pfatten,61,,5,6,11
105 Pfatten,62,,9,2,11
105 Pfatten,63,,3,1,4
105 Pfatten,64,,7,7,14
105 Pfatten,65,,3,4,7
105 Pfatten,66,,7,2,9
105 Pfatten,67,,4,2,6
105 Pfatten,68,,2,3,5
105 Pfatten,69,,1,2,3
105 Pfatten,70,,3,4,7
105 Pfatten,71,,3,3,6
105 Pfatten,72,,4,1,5
105 Pfatten,73,,2,2,4
105 Pfatten,74,,4,1,5
105 Pfatten,75,,2,3,5
105 Pfatten,76,,5,3,8
105 Pfatten,77,,2,6,8
105 Pfatten,78,,1,2,3
105 Pfatten,79,,-,5,5
105 Pfatten,80,,2,3,5
105 Pfatten,81,,1,2,3
105 Pfatten,82,,-,5,5
105 Pfatten,83,,-,1,1
105 Pfatten,85,,1,2,3
105 Pfatten,86,,1,3,4
105 Pfatten,87,,1,2,3
105 Pfatten,88,,1,-,1
105 Pfatten,90,,-,1,1
105 Pfatten,91,,1,1,2
105 Pfatten,94,,1,1,2
105 Pfatten,95,,-,1,1
106 Olang,0,,20,22,42
106 Olang,1,,18,22,40
106 Olang,2,,13,19,32
106 Olang,3,,24,22,46
106 Olang,4,,12,21,33
106 Olang,5,,7,18,25
106 Olang,6,,22,14,36
106 Olang,7,,14,12,26
106 Olang,8,,21,12,33
106 Olang,9,,16,12,28
106 Olang,10,,17,20,37
106 Olang,11,,19,23,42
106 Olang,12,,17,13,30
106 Olang,13,,17,22,39
106 Olang,14,,24,17,41
106 Olang,15,,27,23,50
106 Olang,16,,19,10,29
106 Olang,17,,22,11,33
106 Olang,18,,21,24,45
106 Olang,19,,16,16,32
106 Olang,20,,27,18,45
106 Olang,21,,25,22,47
106 Olang,22,,22,19,41
106 Olang,23,,17,17,34
106 Olang,24,,27,20,47
106 Olang,25,,15,21,36
106 Olang,26,,13,24,37
106 Olang,27,,24,14,38
106 Olang,28,,16,18,34
106 Olang,29,,20,24,44
106 Olang,30,,14,25,39
106 Olang,31,,21,24,45
106 Olang,32,,23,29,52
106 Olang,33,,22,21,43
106 Olang,34,,32,32,64
106 Olang,35,,22,21,43
106 Olang,36,,25,28,53
106 Olang,37,,17,27,44
106 Olang,38,,30,26,56
106 Olang,39,,28,20,48
106 Olang,40,,31,18,49
106 Olang,41,,21,21,42
106 Olang,42,,22,33,55
106 Olang,43,,29,26,55
106 Olang,44,,33,25,58
106 Olang,45,,32,24,56
106 Olang,46,,19,25,44
106 Olang,47,,20,27,47
106 Olang,48,,24,24,48
106 Olang,49,,24,14,38
106 Olang,50,,16,25,41
106 Olang,51,,21,26,47
106 Olang,52,,25,15,40
106 Olang,53,,23,14,37
106 Olang,54,,28,12,40
106 Olang,55,,14,28,42
106 Olang,56,,17,17,34
106 Olang,57,,15,20,35
106 Olang,58,,16,20,36
106 Olang,59,,15,13,28
106 Olang,60,,8,14,22
106 Olang,61,,32,17,49
106 Olang,62,,20,11,31
106 Olang,63,,19,21,40
106 Olang,64,,13,25,38
106 Olang,65,,14,13,27
106 Olang,66,,17,11,28
106 Olang,67,,16,6,22
106 Olang,68,,11,17,28
106 Olang,69,,14,16,30
106 Olang,70,,12,13,25
106 Olang,71,,16,10,26
106 Olang,72,,11,8,19
106 Olang,73,,8,14,22
106 Olang,74,,6,8,14
106 Olang,75,,6,8,14
106 Olang,76,,7,14,21
106 Olang,77,,11,9,20
106 Olang,78,,9,14,23
106 Olang,79,,8,8,16
106 Olang,80,,2,6,8
106 Olang,81,,10,6,16
106 Olang,82,,7,12,19
106 Olang,83,,4,6,10
106 Olang,84,,4,4,8
106 Olang,85,,2,10,12
106 Olang,86,,3,2,5
106 Olang,87,,2,7,9
106 Olang,88,,4,3,7
106 Olang,89,,2,5,7
106 Olang,90,,3,1,4
106 Olang,91,,-,5,5
106 Olang,92,,1,1,2
106 Olang,94,,1,-,1
106 Olang,95,,-,1,1
106 Olang,96,,-,2,2
106 Olang,97,,-,1,1
107 Pfitsch,0,,16,18,34
107 Pfitsch,1,,24,12,36
107 Pfitsch,2,,17,11,28
107 Pfitsch,3,,14,22,36
107 Pfitsch,4,,15,10,25
107 Pfitsch,5,,24,14,38
107 Pfitsch,6,,14,16,30
107 Pfitsch,7,,22,13,35
107 Pfitsch,8,,19,11,30
107 Pfitsch,9,,22,19,41
107 Pfitsch,10,,10,8,18
107 Pfitsch,11,,22,23,45
107 Pfitsch,12,,19,13,32
107 Pfitsch,13,,12,16,28
107 Pfitsch,14,,15,16,31
107 Pfitsch,15,,10,13,23
107 Pfitsch,16,,17,10,27
107 Pfitsch,17,,14,18,32
107 Pfitsch,18,,14,14,28
107 Pfitsch,19,,15,17,32
107 Pfitsch,20,,20,14,34
107 Pfitsch,21,,19,17,36
107 Pfitsch,22,,11,18,29
107 Pfitsch,23,,15,18,33
107 Pfitsch,24,,13,16,29
107 Pfitsch,25,,13,14,27
107 Pfitsch,26,,17,11,28
107 Pfitsch,27,,24,9,33
107 Pfitsch,28,,22,30,52
107 Pfitsch,29,,28,19,47
107 Pfitsch,30,,23,26,49
107 Pfitsch,31,,17,25,42
107 Pfitsch,32,,28,21,49
107 Pfitsch,33,,26,19,45
107 Pfitsch,34,,17,15,32
107 Pfitsch,35,,18,27,45
107 Pfitsch,36,,19,27,46
107 Pfitsch,37,,19,23,42
107 Pfitsch,38,,24,21,45
107 Pfitsch,39,,23,19,42
107 Pfitsch,40,,27,16,43
107 Pfitsch,41,,19,20,39
107 Pfitsch,42,,28,17,45
107 Pfitsch,43,,18,19,37
107 Pfitsch,44,,23,22,45
107 Pfitsch,45,,24,17,41
107 Pfitsch,46,,21,20,41
107 Pfitsch,47,,15,24,39
107 Pfitsch,48,,18,17,35
107 Pfitsch,49,,25,21,46
107 Pfitsch,50,,22,20,42
107 Pfitsch,51,,17,25,42
107 Pfitsch,52,,15,17,32
107 Pfitsch,53,,22,14,36
107 Pfitsch,54,,25,23,48
107 Pfitsch,55,,20,14,34
107 Pfitsch,56,,14,14,28
107 Pfitsch,57,,20,20,40
107 Pfitsch,58,,22,16,38
107 Pfitsch,59,,15,23,38
107 Pfitsch,60,,21,16,37
107 Pfitsch,61,,19,19,38
107 Pfitsch,62,,13,18,31
107 Pfitsch,63,,8,7,15
107 Pfitsch,64,,9,11,20
107 Pfitsch,65,,14,14,28
107 Pfitsch,66,,11,12,23
107 Pfitsch,67,,11,13,24
107 Pfitsch,68,,19,11,30
107 Pfitsch,69,,19,13,32
107 Pfitsch,70,,13,16,29
107 Pfitsch,71,,11,15,26
107 Pfitsch,72,,14,9,23
107 Pfitsch,73,,4,13,17
107 Pfitsch,74,,8,11,19
107 Pfitsch,75,,6,11,17
107 Pfitsch,76,,6,6,12
107 Pfitsch,77,,10,6,16
107 Pfitsch,78,,12,12,24
107 Pfitsch,79,,5,12,17
107 Pfitsch,80,,7,8,15
107 Pfitsch,81,,2,9,11
107 Pfitsch,82,,10,9,19
107 Pfitsch,83,,2,12,14
107 Pfitsch,84,,7,8,15
107 Pfitsch,85,,2,8,10
107 Pfitsch,86,,6,8,14
107 Pfitsch,87,,-,6,6
107 Pfitsch,88,,2,7,9
107 Pfitsch,89,,3,2,5
107 Pfitsch,90,,-,5,5
107 Pfitsch,91,,-,3,3
107 Pfitsch,92,,1,2,3
107 Pfitsch,93,,-,1,1
107 Pfitsch,94,,1,2,3
107 Pfitsch,96,,-,1,1
108 Ahrntal,0,,33,33,66
108 Ahrntal,1,,31,29,60
108 Ahrntal,2,,43,42,85
108 Ahrntal,3,,26,48,74
108 Ahrntal,4,,41,41,82
108 Ahrntal,5,,42,37,79
108 Ahrntal,6,,31,35,66
108 Ahrntal,7,,32,38,70
108 Ahrntal,8,,34,39,73
108 Ahrntal,9,,31,35,66
108 Ahrntal,10,,34,30,64
108 Ahrntal,11,,49,42,91
108 Ahrntal,12,,33,39,72
108 Ahrntal,13,,37,37,74
108 Ahrntal,14,,41,46,87
108 Ahrntal,15,,39,49,88
108 Ahrntal,16,,35,30,65
108 Ahrntal,17,,28,27,55
108 Ahrntal,18,,38,43,81
108 Ahrntal,19,,41,34,75
108 Ahrntal,20,,28,35,63
108 Ahrntal,21,,43,32,75
108 Ahrntal,22,,39,37,76
108 Ahrntal,23,,28,30,58
108 Ahrntal,24,,40,38,78
108 Ahrntal,25,,35,48,83
108 Ahrntal,26,,37,44,81
108 Ahrntal,27,,41,30,71
108 Ahrntal,28,,45,47,92
108 Ahrntal,29,,39,41,80
108 Ahrntal,30,,51,41,92
108 Ahrntal,31,,40,42,82
108 Ahrntal,32,,36,45,81
108 Ahrntal,33,,35,39,74
108 Ahrntal,34,,50,46,96
108 Ahrntal,35,,48,44,92
108 Ahrntal,36,,43,39,82
108 Ahrntal,37,,46,38,84
108 Ahrntal,38,,47,39,86
108 Ahrntal,39,,54,51,105
108 Ahrntal,40,,68,44,112
108 Ahrntal,41,,54,46,100
108 Ahrntal,42,,53,43,96
108 Ahrntal,43,,52,42,94
108 Ahrntal,44,,40,50,90
108 Ahrntal,45,,59,44,103
108 Ahrntal,46,,57,42,99
108 Ahrntal,47,,50,43,93
108 Ahrntal,48,,51,43,94
108 Ahrntal,49,,37,49,86
108 Ahrntal,50,,34,39,73
108 Ahrntal,51,,37,30,67
108 Ahrntal,52,,41,39,80
108 Ahrntal,53,,48,29,77
108 Ahrntal,54,,26,40,66
108 Ahrntal,55,,37,20,57
108 Ahrntal,56,,34,25,59
108 Ahrntal,57,,35,20,55
108 Ahrntal,58,,25,30,55
108 Ahrntal,59,,26,34,60
108 Ahrntal,60,,31,23,54
108 Ahrntal,61,,32,20,52
108 Ahrntal,62,,33,31,64
108 Ahrntal,63,,28,27,55
108 Ahrntal,64,,23,18,41
108 Ahrntal,65,,17,22,39
108 Ahrntal,66,,20,13,33
108 Ahrntal,67,,18,18,36
108 Ahrntal,68,,21,30,51
108 Ahrntal,69,,27,29,56
108 Ahrntal,70,,28,31,59
108 Ahrntal,71,,30,23,53
108 Ahrntal,72,,21,23,44
108 Ahrntal,73,,32,30,62
108 Ahrntal,74,,22,22,44
108 Ahrntal,75,,20,15,35
108 Ahrntal,76,,15,36,51
108 Ahrntal,77,,15,20,35
108 Ahrntal,78,,16,17,33
108 Ahrntal,79,,17,26,43
108 Ahrntal,80,,22,17,39
108 Ahrntal,81,,15,15,30
108 Ahrntal,82,,11,15,26
108 Ahrntal,83,,11,23,34
108 Ahrntal,84,,7,14,21
108 Ahrntal,85,,10,13,23
108 Ahrntal,86,,6,13,19
108 Ahrntal,87,,6,7,13
108 Ahrntal,88,,5,7,12
108 Ahrntal,89,,5,10,15
108 Ahrntal,90,,3,2,5
108 Ahrntal,91,,2,2,4
108 Ahrntal,92,,5,4,9
108 Ahrntal,93,,-,2,2
108 Ahrntal,95,,-,2,2
108 Ahrntal,96,,-,1,1
108 Ahrntal,97,,-,4,4
109 Gsies,0,,9,16,25
109 Gsies,1,,17,14,31
109 Gsies,2,,17,19,36
109 Gsies,3,,15,9,24
109 Gsies,4,,18,13,31
109 Gsies,5,,19,20,39
109 Gsies,6,,16,16,32
109 Gsies,7,,12,13,25
109 Gsies,8,,19,18,37
109 Gsies,9,,13,13,26
109 Gsies,10,,15,14,29
109 Gsies,11,,10,12,22
109 Gsies,12,,31,10,41
109 Gsies,13,,19,5,24
109 Gsies,14,,13,17,30
109 Gsies,15,,11,17,28
109 Gsies,16,,15,16,31
109 Gsies,17,,9,17,26
109 Gsies,18,,17,19,36
109 Gsies,19,,16,10,26
109 Gsies,20,,15,23,38
109 Gsies,21,,18,13,31
109 Gsies,22,,10,13,23
109 Gsies,23,,8,14,22
109 Gsies,24,,19,17,36
109 Gsies,25,,14,17,31
109 Gsies,26,,15,15,30
109 Gsies,27,,12,11,23
109 Gsies,28,,19,8,27
109 Gsies,29,,18,18,36
109 Gsies,30,,16,22,38
109 Gsies,31,,24,21,45
109 Gsies,32,,11,14,25
109 Gsies,33,,16,12,28
109 Gsies,34,,13,18,31
109 Gsies,35,,13,18,31
109 Gsies,36,,17,22,39
109 Gsies,37,,19,13,32
109 Gsies,38,,14,9,23
109 Gsies,39,,8,21,29
109 Gsies,40,,19,18,37
109 Gsies,41,,27,14,41
109 Gsies,42,,23,10,33
109 Gsies,43,,15,15,30
109 Gsies,44,,16,13,29
109 Gsies,45,,15,19,34
109 Gsies,46,,20,6,26
109 Gsies,47,,16,18,34
109 Gsies,48,,14,14,28
109 Gsies,49,,16,8,24
109 Gsies,50,,9,14,23
109 Gsies,51,,15,17,32
109 Gsies,52,,10,14,24
109 Gsies,53,,16,16,32
109 Gsies,54,,12,13,25
109 Gsies,55,,16,7,23
109 Gsies,56,,14,10,24
109 Gsies,57,,16,6,22
109 Gsies,58,,18,6,24
109 Gsies,59,,16,14,30
109 Gsies,60,,14,12,26
109 Gsies,61,,8,9,17
109 Gsies,62,,15,17,32
109 Gsies,63,,7,10,17
109 Gsies,64,,22,7,29
109 Gsies,65,,15,10,25
109 Gsies,66,,5,12,17
109 Gsies,67,,7,13,20
109 Gsies,68,,9,9,18
109 Gsies,69,,5,13,18
109 Gsies,70,,6,11,17
109 Gsies,71,,7,10,17
109 Gsies,72,,6,9,15
109 Gsies,73,,9,8,17
109 Gsies,74,,8,7,15
109 Gsies,75,,5,11,16
109 Gsies,76,,4,7,11
109 Gsies,77,,3,9,12
109 Gsies,78,,5,6,11
109 Gsies,79,,7,5,12
109 Gsies,80,,5,6,11
109 Gsies,81,,10,6,16
109 Gsies,82,,3,5,8
109 Gsies,83,,7,9,16
109 Gsies,84,,1,8,9
109 Gsies,85,,3,2,5
109 Gsies,86,,5,3,8
109 Gsies,87,,3,4,7
109 Gsies,88,,5,6,11
109 Gsies,89,,4,5,9
109 Gsies,90,,1,4,5
109 Gsies,91,,2,-,2
109 Gsies,92,,2,1,3
109 Gsies,93,,-,1,1
109 Gsies,94,,1,-,1
109 Gsies,96,,1,-,1
109 Gsies,100,,-,1,1
110 Vintl,0,,11,20,31
110 Vintl,1,,16,15,31
110 Vintl,2,,24,19,43
110 Vintl,3,,21,18,39
110 Vintl,4,,25,16,41
110 Vintl,5,,13,13,26
110 Vintl,6,,20,24,44
110 Vintl,7,,11,14,25
110 Vintl,8,,17,18,35
110 Vintl,9,,14,21,35
110 Vintl,10,,15,21,36
110 Vintl,11,,22,16,38
110 Vintl,12,,21,24,45
110 Vintl,13,,21,29,50
110 Vintl,14,,20,15,35
110 Vintl,15,,21,19,40
110 Vintl,16,,38,25,63
110 Vintl,17,,19,18,37
110 Vintl,18,,25,19,44
110 Vintl,19,,27,22,49
110 Vintl,20,,24,31,55
110 Vintl,21,,29,21,50
110 Vintl,22,,26,15,41
110 Vintl,23,,22,20,42
110 Vintl,24,,19,24,43
110 Vintl,25,,20,20,40
110 Vintl,26,,10,19,29
110 Vintl,27,,27,14,41
110 Vintl,28,,19,15,34
110 Vintl,29,,22,27,49
110 Vintl,30,,19,21,40
110 Vintl,31,,27,18,45
110 Vintl,32,,26,19,45
110 Vintl,33,,21,39,60
110 Vintl,34,,18,24,42
110 Vintl,35,,24,22,46
110 Vintl,36,,23,19,42
110 Vintl,37,,25,23,48
110 Vintl,38,,19,21,40
110 Vintl,39,,28,16,44
110 Vintl,40,,30,28,58
110 Vintl,41,,19,18,37
110 Vintl,42,,28,24,52
110 Vintl,43,,26,23,49
110 Vintl,44,,30,32,62
110 Vintl,45,,32,27,59
110 Vintl,46,,33,30,63
110 Vintl,47,,33,24,57
110 Vintl,48,,35,27,62
110 Vintl,49,,32,22,54
110 Vintl,50,,26,32,58
110 Vintl,51,,17,22,39
110 Vintl,52,,21,21,42
110 Vintl,53,,21,15,36
110 Vintl,54,,22,28,50
110 Vintl,55,,27,17,44
110 Vintl,56,,20,14,34
110 Vintl,57,,15,18,33
110 Vintl,58,,22,9,31
110 Vintl,59,,15,18,33
110 Vintl,60,,21,16,37
110 Vintl,61,,22,20,42
110 Vintl,62,,19,21,40
110 Vintl,63,,12,13,25
110 Vintl,64,,21,14,35
110 Vintl,65,,15,12,27
110 Vintl,66,,13,17,30
110 Vintl,67,,11,5,16
110 Vintl,68,,20,11,31
110 Vintl,69,,10,10,20
110 Vintl,70,,7,15,22
110 Vintl,71,,8,19,27
110 Vintl,72,,12,15,27
110 Vintl,73,,9,5,14
110 Vintl,74,,9,8,17
110 Vintl,75,,11,11,22
110 Vintl,76,,9,10,19
110 Vintl,77,,12,7,19
110 Vintl,78,,3,17,20
110 Vintl,79,,7,12,19
110 Vintl,80,,9,10,19
110 Vintl,81,,5,14,19
110 Vintl,82,,6,13,19
110 Vintl,83,,7,7,14
110 Vintl,84,,4,11,15
110 Vintl,85,,8,1,9
110 Vintl,86,,3,4,7
110 Vintl,87,,2,5,7
110 Vintl,88,,2,5,7
110 Vintl,89,,2,6,8
110 Vintl,90,,2,3,5
110 Vintl,91,,-,7,7
110 Vintl,94,,-,2,2
110 Vintl,95,,-,1,1
110 Vintl,96,,1,-,1
110 Vintl,99,,1,-,1
111 Vahrn,0,,30,26,56
111 Vahrn,1,,26,27,53
111 Vahrn,2,,31,21,52
111 Vahrn,3,,22,25,47
111 Vahrn,4,,33,20,53
111 Vahrn,5,,32,32,64
111 Vahrn,6,,31,31,62
111 Vahrn,7,,29,30,59
111 Vahrn,8,,27,14,41
111 Vahrn,9,,28,31,59
111 Vahrn,10,,28,19,47
111 Vahrn,11,,27,20,47
111 Vahrn,12,,28,31,59
111 Vahrn,13,,23,25,48
111 Vahrn,14,,23,23,46
111 Vahrn,15,,35,18,53
111 Vahrn,16,,26,24,50
111 Vahrn,17,,22,22,44
111 Vahrn,18,,20,21,41
111 Vahrn,19,,17,26,43
111 Vahrn,20,,22,23,45
111 Vahrn,21,,14,27,41
111 Vahrn,22,,28,22,50
111 Vahrn,23,,24,18,42
111 Vahrn,24,,21,23,44
111 Vahrn,25,,24,12,36
111 Vahrn,26,,25,27,52
111 Vahrn,27,,24,21,45
111 Vahrn,28,,26,31,57
111 Vahrn,29,,30,39,69
111 Vahrn,30,,28,27,55
111 Vahrn,31,,27,34,61
111 Vahrn,32,,24,36,60
111 Vahrn,33,,30,34,64
111 Vahrn,34,,23,30,53
111 Vahrn,35,,43,29,72
111 Vahrn,36,,35,33,68
111 Vahrn,37,,35,43,78
111 Vahrn,38,,41,42,83
111 Vahrn,39,,36,41,77
111 Vahrn,40,,40,30,70
111 Vahrn,41,,48,42,90
111 Vahrn,42,,45,46,91
111 Vahrn,43,,35,35,70
111 Vahrn,44,,46,34,80
111 Vahrn,45,,40,32,72
111 Vahrn,46,,40,42,82
111 Vahrn,47,,33,38,71
111 Vahrn,48,,39,35,74
111 Vahrn,49,,28,35,63
111 Vahrn,50,,29,24,53
111 Vahrn,51,,34,31,65
111 Vahrn,52,,31,28,59
111 Vahrn,53,,20,21,41
111 Vahrn,54,,31,29,60
111 Vahrn,55,,20,23,43
111 Vahrn,56,,25,33,58
111 Vahrn,57,,21,31,52
111 Vahrn,58,,23,25,48
111 Vahrn,59,,22,15,37
111 Vahrn,60,,21,16,37
111 Vahrn,61,,19,21,40
111 Vahrn,62,,23,33,56
111 Vahrn,63,,18,17,35
111 Vahrn,64,,15,26,41
111 Vahrn,65,,19,24,43
111 Vahrn,66,,12,14,26
111 Vahrn,67,,17,20,37
111 Vahrn,68,,22,24,46
111 Vahrn,69,,15,22,37
111 Vahrn,70,,18,22,40
111 Vahrn,71,,21,15,36
111 Vahrn,72,,19,20,39
111 Vahrn,73,,12,10,22
111 Vahrn,74,,15,19,34
111 Vahrn,75,,9,15,24
111 Vahrn,76,,7,13,20
111 Vahrn,77,,13,13,26
111 Vahrn,78,,7,12,19
111 Vahrn,79,,6,11,17
111 Vahrn,80,,8,12,20
111 Vahrn,81,,11,10,21
111 Vahrn,82,,5,18,23
111 Vahrn,83,,7,11,18
111 Vahrn,84,,1,15,16
111 Vahrn,85,,4,3,7
111 Vahrn,86,,2,10,12
111 Vahrn,87,,4,6,10
111 Vahrn,88,,3,7,10
111 Vahrn,89,,1,6,7
111 Vahrn,90,,2,4,6
111 Vahrn,91,,1,3,4
111 Vahrn,92,,1,-,1
111 Vahrn,93,,-,1,1
111 Vahrn,94,,-,1,1
111 Vahrn,95,,1,-,1
111 Vahrn,97,,-,2,2
111 Vahrn,99,,-,1,1
111 Vahrn,101,,-,1,1
112 Vöran,0,,2,4,6
112 Vöran,1,,10,4,14
112 Vöran,2,,5,5,10
112 Vöran,3,,7,3,10
112 Vöran,4,,5,3,8
112 Vöran,5,,9,3,12
112 Vöran,6,,3,5,8
112 Vöran,7,,3,5,8
112 Vöran,8,,9,5,14
112 Vöran,9,,5,7,12
112 Vöran,10,,8,4,12
112 Vöran,11,,11,6,17
112 Vöran,12,,5,3,8
112 Vöran,13,,5,4,9
112 Vöran,14,,11,7,18
112 Vöran,15,,9,5,14
112 Vöran,16,,5,9,14
112 Vöran,17,,7,7,14
112 Vöran,18,,8,6,14
112 Vöran,19,,7,3,10
112 Vöran,20,,7,3,10
112 Vöran,21,,5,7,12
112 Vöran,22,,10,6,16
112 Vöran,23,,8,9,17
112 Vöran,24,,11,5,16
112 Vöran,25,,6,7,13
112 Vöran,26,,9,7,16
112 Vöran,27,,8,6,14
112 Vöran,28,,5,3,8
112 Vöran,29,,8,8,16
112 Vöran,30,,9,10,19
112 Vöran,31,,5,4,9
112 Vöran,32,,4,7,11
112 Vöran,33,,7,9,16
112 Vöran,34,,10,5,15
112 Vöran,35,,7,6,13
112 Vöran,36,,8,4,12
112 Vöran,37,,15,10,25
112 Vöran,38,,5,6,11
112 Vöran,39,,9,8,17
112 Vöran,40,,7,10,17
112 Vöran,41,,8,6,14
112 Vöran,42,,7,4,11
112 Vöran,43,,14,3,17
112 Vöran,44,,4,6,10
112 Vöran,45,,8,6,14
112 Vöran,46,,4,4,8
112 Vöran,47,,11,4,15
112 Vöran,48,,7,7,14
112 Vöran,49,,13,14,27
112 Vöran,50,,4,5,9
112 Vöran,51,,6,6,12
112 Vöran,52,,3,7,10
112 Vöran,53,,6,6,12
112 Vöran,54,,5,9,14
112 Vöran,55,,2,1,3
112 Vöran,56,,5,2,7
112 Vöran,57,,5,5,10
112 Vöran,58,,5,4,9
112 Vöran,59,,9,2,11
112 Vöran,60,,4,-,4
112 Vöran,61,,7,4,11
112 Vöran,62,,7,5,12
112 Vöran,63,,2,3,5
112 Vöran,64,,5,3,8
112 Vöran,65,,4,2,6
112 Vöran,66,,-,4,4
112 Vöran,67,,4,3,7
112 Vöran,68,,3,5,8
112 Vöran,69,,5,4,9
112 Vöran,70,,4,6,10
112 Vöran,71,,2,5,7
112 Vöran,72,,2,3,5
112 Vöran,73,,8,3,11
112 Vöran,74,,2,2,4
112 Vöran,75,,3,5,8
112 Vöran,76,,2,-,2
112 Vöran,77,,1,6,7
112 Vöran,78,,6,6,12
112 Vöran,79,,2,3,5
112 Vöran,80,,3,-,3
112 Vöran,81,,5,1,6
112 Vöran,82,,1,1,2
112 Vöran,83,,2,1,3
112 Vöran,84,,-,1,1
112 Vöran,85,,-,2,2
112 Vöran,86,,2,2,4
112 Vöran,87,,-,1,1
112 Vöran,88,,1,1,2
112 Vöran,89,,1,-,1
112 Vöran,90,,1,-,1
112 Vöran,91,,-,2,2
113 Niederdorf,0,,10,6,16
113 Niederdorf,1,,9,6,15
113 Niederdorf,2,,13,11,24
113 Niederdorf,3,,9,8,17
113 Niederdorf,4,,9,12,21
113 Niederdorf,5,,7,7,14
113 Niederdorf,6,,16,7,23
113 Niederdorf,7,,10,19,29
113 Niederdorf,8,,5,13,18
113 Niederdorf,9,,6,13,19
113 Niederdorf,10,,9,9,18
113 Niederdorf,11,,13,11,24
113 Niederdorf,12,,4,6,10
113 Niederdorf,13,,7,12,19
113 Niederdorf,14,,9,10,19
113 Niederdorf,15,,5,7,12
113 Niederdorf,16,,6,10,16
113 Niederdorf,17,,13,8,21
113 Niederdorf,18,,9,7,16
113 Niederdorf,19,,7,9,16
113 Niederdorf,20,,7,13,20
113 Niederdorf,21,,13,11,24
113 Niederdorf,22,,9,7,16
113 Niederdorf,23,,8,8,16
113 Niederdorf,24,,2,9,11
113 Niederdorf,25,,4,7,11
113 Niederdorf,26,,8,7,15
113 Niederdorf,27,,8,5,13
113 Niederdorf,28,,7,8,15
113 Niederdorf,29,,3,18,21
113 Niederdorf,30,,11,7,18
113 Niederdorf,31,,11,4,15
113 Niederdorf,32,,11,8,19
113 Niederdorf,33,,5,3,8
113 Niederdorf,34,,7,8,15
113 Niederdorf,35,,10,10,20
113 Niederdorf,36,,11,14,25
113 Niederdorf,37,,11,7,18
113 Niederdorf,38,,14,13,27
113 Niederdorf,39,,16,8,24
113 Niederdorf,40,,6,13,19
113 Niederdorf,41,,8,13,21
113 Niederdorf,42,,22,16,38
113 Niederdorf,43,,15,12,27
113 Niederdorf,44,,13,19,32
113 Niederdorf,45,,20,10,30
113 Niederdorf,46,,9,14,23
113 Niederdorf,47,,18,15,33
113 Niederdorf,48,,11,9,20
113 Niederdorf,49,,23,8,31
113 Niederdorf,50,,14,10,24
113 Niederdorf,51,,7,10,17
113 Niederdorf,52,,12,9,21
113 Niederdorf,53,,6,5,11
113 Niederdorf,54,,9,11,20
113 Niederdorf,55,,7,12,19
113 Niederdorf,56,,11,8,19
113 Niederdorf,57,,11,6,17
113 Niederdorf,58,,7,4,11
113 Niederdorf,59,,8,5,13
113 Niederdorf,60,,2,2,4
113 Niederdorf,61,,5,5,10
113 Niederdorf,62,,10,4,14
113 Niederdorf,63,,5,9,14
113 Niederdorf,64,,5,7,12
113 Niederdorf,65,,7,7,14
113 Niederdorf,66,,2,6,8
113 Niederdorf,67,,4,7,11
113 Niederdorf,68,,5,9,14
113 Niederdorf,69,,5,8,13
113 Niederdorf,70,,3,5,8
113 Niederdorf,71,,5,7,12
113 Niederdorf,72,,2,3,5
113 Niederdorf,73,,8,5,13
113 Niederdorf,74,,6,7,13
113 Niederdorf,75,,4,8,12
113 Niederdorf,76,,7,7,14
113 Niederdorf,77,,1,12,13
113 Niederdorf,78,,5,6,11
113 Niederdorf,79,,7,5,12
113 Niederdorf,80,,5,5,10
113 Niederdorf,81,,5,9,14
113 Niederdorf,82,,4,7,11
113 Niederdorf,83,,4,3,7
113 Niederdorf,84,,3,9,12
113 Niederdorf,85,,1,4,5
113 Niederdorf,86,,1,6,7
113 Niederdorf,87,,3,5,8
113 Niederdorf,88,,1,1,2
113 Niederdorf,89,,1,4,5
113 Niederdorf,90,,3,3,6
113 Niederdorf,94,,1,-,1
113 Niederdorf,95,,-,1,1
113 Niederdorf,96,,-,1,1
113 Niederdorf,101,,-,1,1
114 Villanders,0,,6,6,12
114 Villanders,1,,16,9,25
114 Villanders,2,,10,7,17
114 Villanders,3,,7,10,17
114 Villanders,4,,13,14,27
114 Villanders,5,,13,14,27
114 Villanders,6,,17,8,25
114 Villanders,7,,13,14,27
114 Villanders,8,,6,12,18
114 Villanders,9,,7,10,17
114 Villanders,10,,13,11,24
114 Villanders,11,,10,17,27
114 Villanders,12,,13,11,24
114 Villanders,13,,13,8,21
114 Villanders,14,,10,12,22
114 Villanders,15,,14,8,22
114 Villanders,16,,18,6,24
114 Villanders,17,,11,12,23
114 Villanders,18,,7,19,26
114 Villanders,19,,14,8,22
114 Villanders,20,,16,14,30
114 Villanders,21,,16,15,31
114 Villanders,22,,14,11,25
114 Villanders,23,,11,13,24
114 Villanders,24,,6,10,16
114 Villanders,25,,10,10,20
114 Villanders,26,,9,13,22
114 Villanders,27,,13,15,28
114 Villanders,28,,13,3,16
114 Villanders,29,,14,12,26
114 Villanders,30,,19,13,32
114 Villanders,31,,10,15,25
114 Villanders,32,,17,7,24
114 Villanders,33,,11,9,20
114 Villanders,34,,17,11,28
114 Villanders,35,,15,9,24
114 Villanders,36,,14,10,24
114 Villanders,37,,14,19,33
114 Villanders,38,,11,17,28
114 Villanders,39,,17,20,37
114 Villanders,40,,16,18,34
114 Villanders,41,,15,11,26
114 Villanders,42,,26,17,43
114 Villanders,43,,23,12,35
114 Villanders,44,,21,13,34
114 Villanders,45,,20,18,38
114 Villanders,46,,23,18,41
114 Villanders,47,,19,16,35
114 Villanders,48,,15,12,27
114 Villanders,49,,17,10,27
114 Villanders,50,,16,12,28
114 Villanders,51,,18,6,24
114 Villanders,52,,15,11,26
114 Villanders,53,,16,7,23
114 Villanders,54,,10,7,17
114 Villanders,55,,10,8,18
114 Villanders,56,,11,17,28
114 Villanders,57,,7,6,13
114 Villanders,58,,10,10,20
114 Villanders,59,,11,7,18
114 Villanders,60,,10,7,17
114 Villanders,61,,12,8,20
114 Villanders,62,,11,5,16
114 Villanders,63,,7,11,18
114 Villanders,64,,5,8,13
114 Villanders,65,,8,10,18
114 Villanders,66,,6,2,8
114 Villanders,67,,3,9,12
114 Villanders,68,,7,7,14
114 Villanders,69,,9,8,17
114 Villanders,70,,7,9,16
114 Villanders,71,,9,11,20
114 Villanders,72,,7,5,12
114 Villanders,73,,7,6,13
114 Villanders,74,,3,9,12
114 Villanders,75,,7,7,14
114 Villanders,76,,2,8,10
114 Villanders,77,,1,9,10
114 Villanders,78,,7,9,16
114 Villanders,79,,8,9,17
114 Villanders,80,,5,8,13
114 Villanders,81,,4,5,9
114 Villanders,82,,3,8,11
114 Villanders,83,,2,6,8
114 Villanders,84,,4,3,7
114 Villanders,85,,2,3,5
114 Villanders,86,,1,5,6
114 Villanders,87,,3,1,4
114 Villanders,88,,2,1,3
114 Villanders,89,,1,3,4
114 Villanders,90,,1,7,8
114 Villanders,91,,-,3,3
114 Villanders,92,,-,1,1
114 Villanders,98,,-,1,1
114 Villanders,99,,-,1,1
115 Sterzing,0,,37,22,59
115 Sterzing,1,,33,32,65
115 Sterzing,2,,36,35,71
115 Sterzing,3,,38,37,75
115 Sterzing,4,,38,31,69
115 Sterzing,5,,37,33,70
115 Sterzing,6,,33,27,60
115 Sterzing,7,,26,33,59
115 Sterzing,8,,30,40,70
115 Sterzing,9,,34,29,63
115 Sterzing,10,,33,33,66
115 Sterzing,11,,33,35,68
115 Sterzing,12,,28,27,55
115 Sterzing,13,,27,27,54
115 Sterzing,14,,33,38,71
115 Sterzing,15,,32,40,72
115 Sterzing,16,,36,26,62
115 Sterzing,17,,30,24,54
115 Sterzing,18,,34,26,60
115 Sterzing,19,,31,38,69
115 Sterzing,20,,38,34,72
115 Sterzing,21,,33,39,72
115 Sterzing,22,,40,26,66
115 Sterzing,23,,42,27,69
115 Sterzing,24,,45,38,83
115 Sterzing,25,,52,37,89
115 Sterzing,26,,35,36,71
115 Sterzing,27,,56,45,101
115 Sterzing,28,,60,39,99
115 Sterzing,29,,82,47,129
115 Sterzing,30,,85,40,125
115 Sterzing,31,,54,55,109
115 Sterzing,32,,55,48,103
115 Sterzing,33,,69,36,105
115 Sterzing,34,,39,35,74
115 Sterzing,35,,44,42,86
115 Sterzing,36,,51,42,93
115 Sterzing,37,,50,44,94
115 Sterzing,38,,52,59,111
115 Sterzing,39,,55,54,109
115 Sterzing,40,,47,52,99
115 Sterzing,41,,57,64,121
115 Sterzing,42,,45,39,84
115 Sterzing,43,,55,58,113
115 Sterzing,44,,70,49,119
115 Sterzing,45,,60,53,113
115 Sterzing,46,,59,47,106
115 Sterzing,47,,49,42,91
115 Sterzing,48,,53,54,107
115 Sterzing,49,,42,47,89
115 Sterzing,50,,41,38,79
115 Sterzing,51,,39,47,86
115 Sterzing,52,,58,42,100
115 Sterzing,53,,42,43,85
115 Sterzing,54,,32,47,79
115 Sterzing,55,,40,27,67
115 Sterzing,56,,36,46,82
115 Sterzing,57,,36,35,71
115 Sterzing,58,,31,43,74
115 Sterzing,59,,42,38,80
115 Sterzing,60,,38,43,81
115 Sterzing,61,,38,35,73
115 Sterzing,62,,36,46,82
115 Sterzing,63,,37,47,84
115 Sterzing,64,,27,26,53
115 Sterzing,65,,43,44,87
115 Sterzing,66,,36,37,73
115 Sterzing,67,,32,28,60
115 Sterzing,68,,39,47,86
115 Sterzing,69,,26,38,64
115 Sterzing,70,,29,30,59
115 Sterzing,71,,35,31,66
115 Sterzing,72,,23,30,53
115 Sterzing,73,,29,27,56
115 Sterzing,74,,19,34,53
115 Sterzing,75,,18,41,59
115 Sterzing,76,,19,25,44
115 Sterzing,77,,13,22,35
115 Sterzing,78,,25,25,50
115 Sterzing,79,,14,13,27
115 Sterzing,80,,18,29,47
115 Sterzing,81,,6,19,25
115 Sterzing,82,,11,16,27
115 Sterzing,83,,16,22,38
115 Sterzing,84,,11,16,27
115 Sterzing,85,,8,19,27
115 Sterzing,86,,4,14,18
115 Sterzing,87,,4,12,16
115 Sterzing,88,,6,14,20
115 Sterzing,89,,4,13,17
115 Sterzing,90,,2,8,10
115 Sterzing,91,,2,3,5
115 Sterzing,92,,1,2,3
115 Sterzing,93,,1,1,2
115 Sterzing,95,,-,1,1
115 Sterzing,96,,-,3,3
115 Sterzing,97,,-,1,1
115 Sterzing,99,,-,1,1
116 Feldthurns,0,,13,14,27
116 Feldthurns,1,,21,19,40
116 Feldthurns,2,,15,16,31
116 Feldthurns,3,,17,20,37
116 Feldthurns,4,,26,16,42
116 Feldthurns,5,,28,24,52
116 Feldthurns,6,,25,15,40
116 Feldthurns,7,,20,16,36
116 Feldthurns,8,,11,13,24
116 Feldthurns,9,,23,20,43
116 Feldthurns,10,,17,20,37
116 Feldthurns,11,,25,14,39
116 Feldthurns,12,,18,22,40
116 Feldthurns,13,,22,20,42
116 Feldthurns,14,,22,17,39
116 Feldthurns,15,,15,20,35
116 Feldthurns,16,,17,20,37
116 Feldthurns,17,,15,18,33
116 Feldthurns,18,,28,19,47
116 Feldthurns,19,,21,19,40
116 Feldthurns,20,,13,14,27
116 Feldthurns,21,,13,14,27
116 Feldthurns,22,,21,13,34
116 Feldthurns,23,,14,19,33
116 Feldthurns,24,,22,8,30
116 Feldthurns,25,,16,20,36
116 Feldthurns,26,,15,19,34
116 Feldthurns,27,,18,22,40
116 Feldthurns,28,,21,23,44
116 Feldthurns,29,,17,16,33
116 Feldthurns,30,,22,17,39
116 Feldthurns,31,,15,23,38
116 Feldthurns,32,,11,18,29
116 Feldthurns,33,,32,21,53
116 Feldthurns,34,,24,14,38
116 Feldthurns,35,,25,26,51
116 Feldthurns,36,,24,18,42
116 Feldthurns,37,,30,26,56
116 Feldthurns,38,,20,17,37
116 Feldthurns,39,,30,25,55
116 Feldthurns,40,,20,25,45
116 Feldthurns,41,,19,19,38
116 Feldthurns,42,,26,24,50
116 Feldthurns,43,,21,26,47
116 Feldthurns,44,,24,22,46
116 Feldthurns,45,,21,22,43
116 Feldthurns,46,,24,26,50
116 Feldthurns,47,,23,19,42
116 Feldthurns,48,,28,19,47
116 Feldthurns,49,,13,18,31
116 Feldthurns,50,,18,17,35
116 Feldthurns,51,,15,13,28
116 Feldthurns,52,,16,16,32
116 Feldthurns,53,,13,19,32
116 Feldthurns,54,,15,13,28
116 Feldthurns,55,,11,19,30
116 Feldthurns,56,,13,12,25
116 Feldthurns,57,,14,14,28
116 Feldthurns,58,,17,12,29
116 Feldthurns,59,,21,14,35
116 Feldthurns,60,,12,12,24
116 Feldthurns,61,,14,14,28
116 Feldthurns,62,,7,15,22
116 Feldthurns,63,,12,11,23
116 Feldthurns,64,,14,10,24
116 Feldthurns,65,,11,10,21
116 Feldthurns,66,,12,12,24
116 Feldthurns,67,,17,10,27
116 Feldthurns,68,,10,11,21
116 Feldthurns,69,,8,7,15
116 Feldthurns,70,,6,4,10
116 Feldthurns,71,,9,6,15
116 Feldthurns,72,,8,11,19
116 Feldthurns,73,,11,8,19
116 Feldthurns,74,,4,9,13
116 Feldthurns,75,,6,8,14
116 Feldthurns,76,,9,11,20
116 Feldthurns,77,,2,4,6
116 Feldthurns,78,,6,4,10
116 Feldthurns,79,,6,8,14
116 Feldthurns,80,,4,6,10
116 Feldthurns,81,,4,14,18
116 Feldthurns,82,,2,9,11
116 Feldthurns,83,,6,4,10
116 Feldthurns,84,,2,3,5
116 Feldthurns,85,,1,7,8
116 Feldthurns,86,,4,7,11
116 Feldthurns,87,,1,8,9
116 Feldthurns,88,,4,5,9
116 Feldthurns,89,,1,4,5
116 Feldthurns,90,,1,3,4
116 Feldthurns,91,,-,5,5
116 Feldthurns,92,,2,1,3
116 Feldthurns,95,,-,2,2
116 Feldthurns,96,,-,2,2
116 Feldthurns,97,,-,1,1
117 Wengen,0,,11,4,15
117 Wengen,1,,13,17,30
117 Wengen,2,,7,5,12
117 Wengen,3,,6,9,15
117 Wengen,4,,10,9,19
117 Wengen,5,,7,9,16
117 Wengen,6,,9,5,14
117 Wengen,7,,5,9,14
117 Wengen,8,,5,6,11
117 Wengen,9,,10,4,14
117 Wengen,10,,5,10,15
117 Wengen,11,,9,6,15
117 Wengen,12,,9,5,14
117 Wengen,13,,7,8,15
117 Wengen,14,,12,8,20
117 Wengen,15,,9,8,17
117 Wengen,16,,11,8,19
117 Wengen,17,,12,7,19
117 Wengen,18,,10,7,17
117 Wengen,19,,10,7,17
117 Wengen,20,,17,8,25
117 Wengen,21,,12,8,20
117 Wengen,22,,5,6,11
117 Wengen,23,,6,12,18
117 Wengen,24,,11,5,16
117 Wengen,25,,9,8,17
117 Wengen,26,,8,4,12
117 Wengen,27,,14,10,24
117 Wengen,28,,13,3,16
117 Wengen,29,,11,7,18
117 Wengen,30,,5,7,12
117 Wengen,31,,9,14,23
117 Wengen,32,,12,5,17
117 Wengen,33,,5,7,12
117 Wengen,34,,11,7,18
117 Wengen,35,,6,5,11
117 Wengen,36,,18,11,29
117 Wengen,37,,11,6,17
117 Wengen,38,,17,9,26
117 Wengen,39,,12,12,24
117 Wengen,40,,12,14,26
117 Wengen,41,,11,13,24
117 Wengen,42,,7,9,16
117 Wengen,43,,16,10,26
117 Wengen,44,,9,13,22
117 Wengen,45,,13,6,19
117 Wengen,46,,8,10,18
117 Wengen,47,,11,6,17
117 Wengen,48,,14,12,26
117 Wengen,49,,14,7,21
117 Wengen,50,,7,10,17
117 Wengen,51,,10,12,22
117 Wengen,52,,7,6,13
117 Wengen,53,,6,7,13
117 Wengen,54,,6,11,17
117 Wengen,55,,4,6,10
117 Wengen,56,,7,6,13
117 Wengen,57,,9,4,13
117 Wengen,58,,6,2,8
117 Wengen,59,,5,6,11
117 Wengen,60,,9,6,15
117 Wengen,61,,2,6,8
117 Wengen,62,,4,8,12
117 Wengen,63,,2,11,13
117 Wengen,64,,6,3,9
117 Wengen,65,,5,3,8
117 Wengen,66,,6,3,9
117 Wengen,67,,7,8,15
117 Wengen,68,,3,6,9
117 Wengen,69,,7,6,13
117 Wengen,70,,4,4,8
117 Wengen,71,,6,8,14
117 Wengen,72,,6,3,9
117 Wengen,73,,5,4,9
117 Wengen,74,,7,7,14
117 Wengen,75,,-,1,1
117 Wengen,76,,2,6,8
117 Wengen,77,,2,7,9
117 Wengen,78,,3,2,5
117 Wengen,79,,1,7,8
117 Wengen,80,,5,2,7
117 Wengen,81,,4,2,6
117 Wengen,82,,2,7,9
117 Wengen,83,,1,2,3
117 Wengen,84,,1,3,4
117 Wengen,85,,1,2,3
117 Wengen,86,,-,3,3
117 Wengen,87,,-,4,4
117 Wengen,88,,2,3,5
117 Wengen,89,,2,2,4
117 Wengen,90,,1,6,7
117 Wengen,91,,1,1,2
117 Wengen,94,,1,-,1
118 U.L.Frau i.W.-St.Felix,0,,-,2,2
118 U.L.Frau i.W.-St.Felix,1,,3,4,7
118 U.L.Frau i.W.-St.Felix,2,,5,3,8
118 U.L.Frau i.W.-St.Felix,3,,1,8,9
118 U.L.Frau i.W.-St.Felix,4,,3,-,3
118 U.L.Frau i.W.-St.Felix,5,,3,2,5
118 U.L.Frau i.W.-St.Felix,6,,5,7,12
118 U.L.Frau i.W.-St.Felix,7,,5,3,8
118 U.L.Frau i.W.-St.Felix,8,,8,6,14
118 U.L.Frau i.W.-St.Felix,9,,7,3,10
118 U.L.Frau i.W.-St.Felix,10,,9,5,14
118 U.L.Frau i.W.-St.Felix,11,,3,2,5
118 U.L.Frau i.W.-St.Felix,12,,5,5,10
118 U.L.Frau i.W.-St.Felix,13,,6,9,15
118 U.L.Frau i.W.-St.Felix,14,,5,4,9
118 U.L.Frau i.W.-St.Felix,15,,8,5,13
118 U.L.Frau i.W.-St.Felix,16,,3,10,13
118 U.L.Frau i.W.-St.Felix,17,,7,7,14
118 U.L.Frau i.W.-St.Felix,18,,9,5,14
118 U.L.Frau i.W.-St.Felix,19,,7,4,11
118 U.L.Frau i.W.-St.Felix,20,,11,7,18
118 U.L.Frau i.W.-St.Felix,21,,6,3,9
118 U.L.Frau i.W.-St.Felix,22,,8,5,13
118 U.L.Frau i.W.-St.Felix,23,,8,5,13
118 U.L.Frau i.W.-St.Felix,24,,3,7,10
118 U.L.Frau i.W.-St.Felix,25,,7,3,10
118 U.L.Frau i.W.-St.Felix,26,,6,3,9
118 U.L.Frau i.W.-St.Felix,27,,6,2,8
118 U.L.Frau i.W.-St.Felix,28,,1,9,10
118 U.L.Frau i.W.-St.Felix,29,,4,6,10
118 U.L.Frau i.W.-St.Felix,30,,7,1,8
118 U.L.Frau i.W.-St.Felix,31,,3,5,8
118 U.L.Frau i.W.-St.Felix,32,,1,2,3
118 U.L.Frau i.W.-St.Felix,33,,-,3,3
118 U.L.Frau i.W.-St.Felix,34,,5,3,8
118 U.L.Frau i.W.-St.Felix,35,,4,8,12
118 U.L.Frau i.W.-St.Felix,36,,8,1,9
118 U.L.Frau i.W.-St.Felix,37,,5,6,11
118 U.L.Frau i.W.-St.Felix,38,,2,3,5
118 U.L.Frau i.W.-St.Felix,39,,7,5,12
118 U.L.Frau i.W.-St.Felix,40,,4,4,8
118 U.L.Frau i.W.-St.Felix,41,,5,9,14
118 U.L.Frau i.W.-St.Felix,42,,7,4,11
118 U.L.Frau i.W.-St.Felix,43,,3,9,12
118 U.L.Frau i.W.-St.Felix,44,,3,4,7
118 U.L.Frau i.W.-St.Felix,45,,9,7,16
118 U.L.Frau i.W.-St.Felix,46,,9,6,15
118 U.L.Frau i.W.-St.Felix,47,,4,8,12
118 U.L.Frau i.W.-St.Felix,48,,17,8,25
118 U.L.Frau i.W.-St.Felix,49,,8,9,17
118 U.L.Frau i.W.-St.Felix,50,,4,4,8
118 U.L.Frau i.W.-St.Felix,51,,8,9,17
118 U.L.Frau i.W.-St.Felix,52,,5,4,9
118 U.L.Frau i.W.-St.Felix,53,,4,2,6
118 U.L.Frau i.W.-St.Felix,54,,3,6,9
118 U.L.Frau i.W.-St.Felix,55,,6,6,12
118 U.L.Frau i.W.-St.Felix,56,,3,4,7
118 U.L.Frau i.W.-St.Felix,57,,6,3,9
118 U.L.Frau i.W.-St.Felix,58,,2,2,4
118 U.L.Frau i.W.-St.Felix,59,,6,3,9
118 U.L.Frau i.W.-St.Felix,60,,6,3,9
118 U.L.Frau i.W.-St.Felix,61,,3,4,7
118 U.L.Frau i.W.-St.Felix,62,,4,-,4
118 U.L.Frau i.W.-St.Felix,63,,4,-,4
118 U.L.Frau i.W.-St.Felix,64,,1,7,8
118 U.L.Frau i.W.-St.Felix,65,,1,4,5
118 U.L.Frau i.W.-St.Felix,66,,3,1,4
118 U.L.Frau i.W.-St.Felix,67,,5,1,6
118 U.L.Frau i.W.-St.Felix,68,,6,4,10
118 U.L.Frau i.W.-St.Felix,69,,2,3,5
118 U.L.Frau i.W.-St.Felix,70,,4,8,12
118 U.L.Frau i.W.-St.Felix,71,,2,-,2
118 U.L.Frau i.W.-St.Felix,72,,1,3,4
118 U.L.Frau i.W.-St.Felix,73,,2,4,6
118 U.L.Frau i.W.-St.Felix,74,,3,-,3
118 U.L.Frau i.W.-St.Felix,75,,4,2,6
118 U.L.Frau i.W.-St.Felix,76,,3,4,7
118 U.L.Frau i.W.-St.Felix,77,,3,2,5
118 U.L.Frau i.W.-St.Felix,78,,4,3,7
118 U.L.Frau i.W.-St.Felix,79,,4,1,5
118 U.L.Frau i.W.-St.Felix,80,,2,-,2
118 U.L.Frau i.W.-St.Felix,81,,3,5,8
118 U.L.Frau i.W.-St.Felix,82,,1,3,4
118 U.L.Frau i.W.-St.Felix,83,,1,4,5
118 U.L.Frau i.W.-St.Felix,84,,2,4,6
118 U.L.Frau i.W.-St.Felix,85,,2,3,5
118 U.L.Frau i.W.-St.Felix,86,,3,5,8
118 U.L.Frau i.W.-St.Felix,87,,1,1,2
118 U.L.Frau i.W.-St.Felix,88,,2,4,6
118 U.L.Frau i.W.-St.Felix,90,,-,1,1
118 U.L.Frau i.W.-St.Felix,94,,-,1,1
118 U.L.Frau i.W.-St.Felix,98,,1,-,1

