Gemeinde,Altersklassen,Geschlecht,Männer,Frauen,Insgesamt
001 Aldein,0,,2,9,11
001 Aldein,1,,10,2,12
001 Aldein,2,,10,10,20
001 Aldein,3,,8,9,17
001 Aldein,4,,8,11,19
001 Aldein,5,,8,13,21
001 Aldein,6,,8,14,22
001 Aldein,7,,9,8,17
001 Aldein,8,,18,8,26
001 Aldein,9,,15,10,25
001 Aldein,10,,13,8,21
001 Aldein,11,,16,8,24
001 Aldein,12,,13,4,17
001 Aldein,13,,17,15,32
001 Aldein,14,,12,16,28
001 Aldein,15,,16,9,25
001 Aldein,16,,8,9,17
001 Aldein,17,,8,12,20
001 Aldein,18,,15,7,22
001 Aldein,19,,13,13,26
001 Aldein,20,,9,13,22
001 Aldein,21,,7,8,15
001 Aldein,22,,7,7,14
001 Aldein,23,,10,16,26
001 Aldein,24,,10,9,19
001 Aldein,25,,11,5,16
001 Aldein,26,,10,7,17
001 Aldein,27,,13,11,24
001 Aldein,28,,10,6,16
001 Aldein,29,,9,10,19
001 Aldein,30,,11,5,16
001 Aldein,31,,9,11,20
001 Aldein,32,,8,13,21
001 Aldein,33,,11,15,26
001 Aldein,34,,11,8,19
001 Aldein,35,,8,19,27
001 Aldein,36,,8,13,21
001 Aldein,37,,18,12,30
001 Aldein,38,,14,11,25
001 Aldein,39,,13,10,23
001 Aldein,40,,16,9,25
001 Aldein,41,,15,15,30
001 Aldein,42,,13,15,28
001 Aldein,43,,18,7,25
001 Aldein,44,,12,16,28
001 Aldein,45,,6,14,20
001 Aldein,46,,7,20,27
001 Aldein,47,,16,11,27
001 Aldein,48,,15,11,26
001 Aldein,49,,13,6,19
001 Aldein,50,,8,17,25
001 Aldein,51,,17,15,32
001 Aldein,52,,14,9,23
001 Aldein,53,,11,11,22
001 Aldein,54,,7,5,12
001 Aldein,55,,10,10,20
001 Aldein,56,,9,8,17
001 Aldein,57,,9,9,18
001 Aldein,58,,9,7,16
001 Aldein,59,,9,9,18
001 Aldein,60,,7,4,11
001 Aldein,61,,15,10,25
001 Aldein,62,,5,13,18
001 Aldein,63,,9,6,15
001 Aldein,64,,9,10,19
001 Aldein,65,,5,10,15
001 Aldein,66,,6,10,16
001 Aldein,67,,9,5,14
001 Aldein,68,,5,7,12
001 Aldein,69,,10,9,19
001 Aldein,70,,6,11,17
001 Aldein,71,,5,12,17
001 Aldein,72,,4,8,12
001 Aldein,73,,5,9,14
001 Aldein,74,,7,7,14
001 Aldein,75,,5,9,14
001 Aldein,76,,5,6,11
001 Aldein,77,,4,4,8
001 Aldein,78,,12,4,16
001 Aldein,79,,6,4,10
001 Aldein,80,,2,7,9
001 Aldein,81,,6,2,8
001 Aldein,82,,1,3,4
001 Aldein,83,,6,7,13
001 Aldein,84,,2,1,3
001 Aldein,85,,5,4,9
001 Aldein,86,,-,2,2
001 Aldein,87,,1,4,5
001 Aldein,88,,-,6,6
001 Aldein,89,,1,4,5
001 Aldein,90,,-,6,6
001 Aldein,91,,1,6,7
001 Aldein,92,,1,1,2
001 Aldein,93,,-,2,2
001 Aldein,Insgesamt,,833,841,1.674
002 Andrian,0,,8,6,14
002 Andrian,1,,7,5,12
002 Andrian,2,,7,6,13
002 Andrian,3,,7,10,17
002 Andrian,4,,5,6,11
002 Andrian,5,,4,6,10
002 Andrian,6,,8,3,11
002 Andrian,7,,6,7,13
002 Andrian,8,,9,4,13
002 Andrian,9,,6,11,17
002 Andrian,10,,3,4,7
002 Andrian,11,,3,4,7
002 Andrian,12,,6,5,11
002 Andrian,13,,4,5,9
002 Andrian,14,,8,2,10
002 Andrian,15,,9,7,16
002 Andrian,16,,3,10,13
002 Andrian,17,,8,4,12
002 Andrian,18,,7,6,13
002 Andrian,19,,4,4,8
002 Andrian,20,,7,7,14
002 Andrian,21,,6,9,15
002 Andrian,22,,5,5,10
002 Andrian,23,,5,5,10
002 Andrian,24,,12,5,17
002 Andrian,25,,6,5,11
002 Andrian,26,,8,6,14
002 Andrian,27,,3,7,10
002 Andrian,28,,8,6,14
002 Andrian,29,,7,4,11
002 Andrian,30,,10,5,15
002 Andrian,31,,7,7,14
002 Andrian,32,,6,5,11
002 Andrian,33,,8,9,17
002 Andrian,34,,7,7,14
002 Andrian,35,,7,11,18
002 Andrian,36,,9,10,19
002 Andrian,37,,12,5,17
002 Andrian,38,,5,9,14
002 Andrian,39,,12,12,24
002 Andrian,40,,6,11,17
002 Andrian,41,,11,11,22
002 Andrian,42,,11,5,16
002 Andrian,43,,5,7,12
002 Andrian,44,,10,9,19
002 Andrian,45,,9,9,18
002 Andrian,46,,10,9,19
002 Andrian,47,,12,10,22
002 Andrian,48,,9,7,16
002 Andrian,49,,7,14,21
002 Andrian,50,,12,7,19
002 Andrian,51,,8,3,11
002 Andrian,52,,7,6,13
002 Andrian,53,,8,4,12
002 Andrian,54,,8,8,16
002 Andrian,55,,8,7,15
002 Andrian,56,,4,10,14
002 Andrian,57,,3,4,7
002 Andrian,58,,6,3,9
002 Andrian,59,,6,7,13
002 Andrian,60,,1,3,4
002 Andrian,61,,3,2,5
002 Andrian,62,,6,6,12
002 Andrian,63,,3,2,5
002 Andrian,64,,3,4,7
002 Andrian,65,,5,4,9
002 Andrian,66,,6,8,14
002 Andrian,67,,2,2,4
002 Andrian,68,,1,4,5
002 Andrian,69,,6,7,13
002 Andrian,70,,2,4,6
002 Andrian,71,,5,4,9
002 Andrian,72,,2,7,9
002 Andrian,73,,1,7,8
002 Andrian,74,,4,3,7
002 Andrian,75,,4,4,8
002 Andrian,76,,2,3,5
002 Andrian,77,,4,2,6
002 Andrian,78,,5,1,6
002 Andrian,79,,3,4,7
002 Andrian,80,,7,3,10
002 Andrian,81,,1,4,5
002 Andrian,82,,3,1,4
002 Andrian,83,,2,1,3
002 Andrian,84,,1,3,4
002 Andrian,85,,-,2,2
002 Andrian,86,,3,4,7
002 Andrian,87,,2,2,4
002 Andrian,88,,1,3,4
002 Andrian,90,,-,1,1
002 Andrian,91,,1,2,3
002 Andrian,92,,1,-,1
002 Andrian,93,,1,1,2
002 Andrian,97,,-,1,1
002 Andrian,98,,-,1,1
002 Andrian,Insgesamt,,523,515,1.038
003 Altrei,0,,1,3,4
003 Altrei,1,,-,1,1
003 Altrei,3,,2,2,4
003 Altrei,4,,1,4,5
003 Altrei,5,,6,4,10
003 Altrei,6,,2,-,2
003 Altrei,7,,4,1,5
003 Altrei,8,,1,1,2
003 Altrei,9,,-,1,1
003 Altrei,10,,2,1,3
003 Altrei,11,,4,1,5
003 Altrei,12,,1,1,2
003 Altrei,13,,3,-,3
003 Altrei,14,,3,1,4
003 Altrei,15,,-,1,1
003 Altrei,16,,-,2,2
003 Altrei,17,,1,2,3
003 Altrei,18,,3,2,5
003 Altrei,19,,3,-,3
003 Altrei,20,,6,3,9
003 Altrei,21,,1,1,2
003 Altrei,22,,3,1,4
003 Altrei,23,,1,2,3
003 Altrei,24,,3,5,8
003 Altrei,25,,2,1,3
003 Altrei,26,,3,2,5
003 Altrei,27,,3,1,4
003 Altrei,28,,3,1,4
003 Altrei,29,,4,1,5
003 Altrei,30,,2,2,4
003 Altrei,31,,2,2,4
003 Altrei,32,,1,2,3
003 Altrei,33,,1,2,3
003 Altrei,34,,2,4,6
003 Altrei,35,,-,2,2
003 Altrei,36,,2,3,5
003 Altrei,37,,2,2,4
003 Altrei,38,,1,-,1
003 Altrei,39,,2,3,5
003 Altrei,40,,4,-,4
003 Altrei,41,,4,3,7
003 Altrei,42,,2,2,4
003 Altrei,43,,3,5,8
003 Altrei,44,,1,4,5
003 Altrei,45,,3,1,4
003 Altrei,46,,2,4,6
003 Altrei,47,,3,4,7
003 Altrei,48,,3,6,9
003 Altrei,49,,2,2,4
003 Altrei,50,,10,2,12
003 Altrei,51,,2,3,5
003 Altrei,52,,4,2,6
003 Altrei,53,,5,4,9
003 Altrei,54,,2,3,5
003 Altrei,55,,1,2,3
003 Altrei,56,,5,1,6
003 Altrei,57,,2,3,5
003 Altrei,58,,2,1,3
003 Altrei,59,,2,2,4
003 Altrei,60,,6,3,9
003 Altrei,61,,4,3,7
003 Altrei,62,,-,3,3
003 Altrei,63,,1,-,1
003 Altrei,64,,2,2,4
003 Altrei,65,,3,2,5
003 Altrei,66,,2,3,5
003 Altrei,67,,3,1,4
003 Altrei,68,,2,3,5
003 Altrei,69,,1,3,4
003 Altrei,70,,3,1,4
003 Altrei,71,,1,3,4
003 Altrei,72,,3,4,7
003 Altrei,73,,2,3,5
003 Altrei,74,,1,1,2
003 Altrei,75,,3,1,4
003 Altrei,76,,3,1,4
003 Altrei,77,,2,1,3
003 Altrei,78,,-,2,2
003 Altrei,79,,2,2,4
003 Altrei,80,,-,2,2
003 Altrei,81,,-,2,2
003 Altrei,82,,1,1,2
003 Altrei,83,,2,2,4
003 Altrei,84,,-,2,2
003 Altrei,85,,2,3,5
003 Altrei,86,,-,3,3
003 Altrei,88,,-,2,2
003 Altrei,89,,-,1,1
003 Altrei,90,,-,1,1
003 Altrei,91,,-,1,1
003 Altrei,Insgesamt,,192,184,376
004 Eppan a.d. Weinstr.,0,,89,76,165
004 Eppan a.d. Weinstr.,1,,78,73,151
004 Eppan a.d. Weinstr.,2,,82,70,152
004 Eppan a.d. Weinstr.,3,,69,67,136
004 Eppan a.d. Weinstr.,4,,82,97,179
004 Eppan a.d. Weinstr.,5,,76,68,144
004 Eppan a.d. Weinstr.,6,,105,77,182
004 Eppan a.d. Weinstr.,7,,84,109,193
004 Eppan a.d. Weinstr.,8,,92,72,164
004 Eppan a.d. Weinstr.,9,,87,71,158
004 Eppan a.d. Weinstr.,10,,79,76,155
004 Eppan a.d. Weinstr.,11,,86,72,158
004 Eppan a.d. Weinstr.,12,,72,81,153
004 Eppan a.d. Weinstr.,13,,90,60,150
004 Eppan a.d. Weinstr.,14,,82,86,168
004 Eppan a.d. Weinstr.,15,,75,70,145
004 Eppan a.d. Weinstr.,16,,78,74,152
004 Eppan a.d. Weinstr.,17,,74,66,140
004 Eppan a.d. Weinstr.,18,,81,77,158
004 Eppan a.d. Weinstr.,19,,86,90,176
004 Eppan a.d. Weinstr.,20,,72,72,144
004 Eppan a.d. Weinstr.,21,,81,70,151
004 Eppan a.d. Weinstr.,22,,86,72,158
004 Eppan a.d. Weinstr.,23,,82,65,147
004 Eppan a.d. Weinstr.,24,,87,81,168
004 Eppan a.d. Weinstr.,25,,78,74,152
004 Eppan a.d. Weinstr.,26,,101,91,192
004 Eppan a.d. Weinstr.,27,,87,64,151
004 Eppan a.d. Weinstr.,28,,87,88,175
004 Eppan a.d. Weinstr.,29,,84,91,175
004 Eppan a.d. Weinstr.,30,,77,95,172
004 Eppan a.d. Weinstr.,31,,84,97,181
004 Eppan a.d. Weinstr.,32,,91,97,188
004 Eppan a.d. Weinstr.,33,,93,100,193
004 Eppan a.d. Weinstr.,34,,113,96,209
004 Eppan a.d. Weinstr.,35,,95,91,186
004 Eppan a.d. Weinstr.,36,,97,87,184
004 Eppan a.d. Weinstr.,37,,108,111,219
004 Eppan a.d. Weinstr.,38,,104,105,209
004 Eppan a.d. Weinstr.,39,,117,118,235
004 Eppan a.d. Weinstr.,40,,115,143,258
004 Eppan a.d. Weinstr.,41,,124,110,234
004 Eppan a.d. Weinstr.,42,,139,121,260
004 Eppan a.d. Weinstr.,43,,151,131,282
004 Eppan a.d. Weinstr.,44,,126,125,251
004 Eppan a.d. Weinstr.,45,,125,136,261
004 Eppan a.d. Weinstr.,46,,133,149,282
004 Eppan a.d. Weinstr.,47,,116,119,235
004 Eppan a.d. Weinstr.,48,,139,114,253
004 Eppan a.d. Weinstr.,49,,112,117,229
004 Eppan a.d. Weinstr.,50,,133,117,250
004 Eppan a.d. Weinstr.,51,,130,108,238
004 Eppan a.d. Weinstr.,52,,109,125,234
004 Eppan a.d. Weinstr.,53,,117,102,219
004 Eppan a.d. Weinstr.,54,,100,104,204
004 Eppan a.d. Weinstr.,55,,95,95,190
004 Eppan a.d. Weinstr.,56,,94,84,178
004 Eppan a.d. Weinstr.,57,,87,88,175
004 Eppan a.d. Weinstr.,58,,76,92,168
004 Eppan a.d. Weinstr.,59,,90,87,177
004 Eppan a.d. Weinstr.,60,,71,84,155
004 Eppan a.d. Weinstr.,61,,87,70,157
004 Eppan a.d. Weinstr.,62,,60,78,138
004 Eppan a.d. Weinstr.,63,,65,56,121
004 Eppan a.d. Weinstr.,64,,76,73,149
004 Eppan a.d. Weinstr.,65,,61,80,141
004 Eppan a.d. Weinstr.,66,,78,70,148
004 Eppan a.d. Weinstr.,67,,53,53,106
004 Eppan a.d. Weinstr.,68,,68,79,147
004 Eppan a.d. Weinstr.,69,,89,83,172
004 Eppan a.d. Weinstr.,70,,86,75,161
004 Eppan a.d. Weinstr.,71,,60,106,166
004 Eppan a.d. Weinstr.,72,,65,52,117
004 Eppan a.d. Weinstr.,73,,59,77,136
004 Eppan a.d. Weinstr.,74,,48,48,96
004 Eppan a.d. Weinstr.,75,,42,53,95
004 Eppan a.d. Weinstr.,76,,45,41,86
004 Eppan a.d. Weinstr.,77,,30,43,73
004 Eppan a.d. Weinstr.,78,,27,45,72
004 Eppan a.d. Weinstr.,79,,43,49,92
004 Eppan a.d. Weinstr.,80,,36,45,81
004 Eppan a.d. Weinstr.,81,,22,53,75
004 Eppan a.d. Weinstr.,82,,32,53,85
004 Eppan a.d. Weinstr.,83,,27,43,70
004 Eppan a.d. Weinstr.,84,,28,34,62
004 Eppan a.d. Weinstr.,85,,17,41,58
004 Eppan a.d. Weinstr.,86,,18,41,59
004 Eppan a.d. Weinstr.,87,,17,33,50
004 Eppan a.d. Weinstr.,88,,8,35,43
004 Eppan a.d. Weinstr.,89,,4,26,30
004 Eppan a.d. Weinstr.,90,,6,28,34
004 Eppan a.d. Weinstr.,91,,9,18,27
004 Eppan a.d. Weinstr.,92,,5,12,17
004 Eppan a.d. Weinstr.,93,,3,7,10
004 Eppan a.d. Weinstr.,94,,2,6,8
004 Eppan a.d. Weinstr.,95,,1,1,2
004 Eppan a.d. Weinstr.,97,,1,-,1
004 Eppan a.d. Weinstr.,98,,-,2,2
004 Eppan a.d. Weinstr.,99,,2,1,3
004 Eppan a.d. Weinstr.,100,,-,3,3
004 Eppan a.d. Weinstr.,101,,-,2,2
004 Eppan a.d. Weinstr.,102,,-,1,1
004 Eppan a.d. Weinstr.,103,,1,1,2
004 Eppan a.d. Weinstr.,Insgesamt,,7.234,7.365,14.599
005 Hafling,0,,3,3,6
005 Hafling,1,,1,2,3
005 Hafling,2,,2,4,6
005 Hafling,3,,3,8,11
005 Hafling,4,,5,5,10
005 Hafling,5,,4,2,6
005 Hafling,6,,6,6,12
005 Hafling,7,,3,2,5
005 Hafling,8,,1,6,7
005 Hafling,9,,-,4,4
005 Hafling,10,,6,1,7
005 Hafling,11,,4,3,7
005 Hafling,12,,4,7,11
005 Hafling,13,,4,3,7
005 Hafling,14,,2,7,9
005 Hafling,15,,2,9,11
005 Hafling,16,,12,4,16
005 Hafling,17,,6,4,10
005 Hafling,18,,4,5,9
005 Hafling,19,,3,7,10
005 Hafling,20,,1,4,5
005 Hafling,21,,7,3,10
005 Hafling,22,,4,6,10
005 Hafling,23,,4,2,6
005 Hafling,24,,2,6,8
005 Hafling,25,,4,4,8
005 Hafling,26,,4,2,6
005 Hafling,27,,5,4,9
005 Hafling,28,,3,9,12
005 Hafling,29,,3,-,3
005 Hafling,30,,4,2,6
005 Hafling,31,,5,8,13
005 Hafling,32,,4,10,14
005 Hafling,33,,6,5,11
005 Hafling,34,,5,6,11
005 Hafling,35,,6,7,13
005 Hafling,36,,6,6,12
005 Hafling,37,,6,4,10
005 Hafling,38,,7,7,14
005 Hafling,39,,10,1,11
005 Hafling,40,,10,1,11
005 Hafling,41,,11,6,17
005 Hafling,42,,10,11,21
005 Hafling,43,,7,12,19
005 Hafling,44,,2,9,11
005 Hafling,45,,3,1,4
005 Hafling,46,,11,6,17
005 Hafling,47,,7,12,19
005 Hafling,48,,3,2,5
005 Hafling,49,,7,3,10
005 Hafling,50,,6,2,8
005 Hafling,51,,8,5,13
005 Hafling,52,,10,7,17
005 Hafling,53,,6,5,11
005 Hafling,54,,3,4,7
005 Hafling,55,,3,4,7
005 Hafling,56,,3,9,12
005 Hafling,57,,6,2,8
005 Hafling,58,,3,1,4
005 Hafling,59,,2,3,5
005 Hafling,60,,7,2,9
005 Hafling,61,,2,3,5
005 Hafling,62,,5,4,9
005 Hafling,63,,4,4,8
005 Hafling,64,,6,2,8
005 Hafling,65,,2,4,6
005 Hafling,66,,1,3,4
005 Hafling,67,,3,2,5
005 Hafling,68,,3,2,5
005 Hafling,69,,4,4,8
005 Hafling,70,,5,3,8
005 Hafling,71,,3,4,7
005 Hafling,72,,2,1,3
005 Hafling,73,,4,4,8
005 Hafling,74,,2,2,4
005 Hafling,75,,2,1,3
005 Hafling,76,,1,1,2
005 Hafling,77,,2,2,4
005 Hafling,78,,-,2,2
005 Hafling,79,,4,3,7
005 Hafling,80,,3,2,5
005 Hafling,81,,2,5,7
005 Hafling,82,,1,4,5
005 Hafling,83,,2,1,3
005 Hafling,84,,-,1,1
005 Hafling,85,,3,2,5
005 Hafling,86,,-,2,2
005 Hafling,87,,1,-,1
005 Hafling,88,,1,-,1
005 Hafling,90,,-,1,1
005 Hafling,91,,-,1,1
005 Hafling,92,,3,1,4
005 Hafling,93,,-,1,1
005 Hafling,95,,-,1,1
005 Hafling,Insgesamt,,370,368,738
006 Abtei,0,,24,15,39
006 Abtei,1,,20,12,32
006 Abtei,2,,26,17,43
006 Abtei,3,,21,19,40
006 Abtei,4,,24,19,43
006 Abtei,5,,29,21,50
006 Abtei,6,,29,22,51
006 Abtei,7,,22,27,49
006 Abtei,8,,29,12,41
006 Abtei,9,,21,19,40
006 Abtei,10,,12,31,43
006 Abtei,11,,24,23,47
006 Abtei,12,,23,31,54
006 Abtei,13,,22,26,48
006 Abtei,14,,13,14,27
006 Abtei,15,,27,22,49
006 Abtei,16,,25,14,39
006 Abtei,17,,24,28,52
006 Abtei,18,,19,14,33
006 Abtei,19,,16,19,35
006 Abtei,20,,24,15,39
006 Abtei,21,,22,13,35
006 Abtei,22,,24,15,39
006 Abtei,23,,13,16,29
006 Abtei,24,,15,10,25
006 Abtei,25,,19,13,32
006 Abtei,26,,18,20,38
006 Abtei,27,,13,13,26
006 Abtei,28,,12,17,29
006 Abtei,29,,14,14,28
006 Abtei,30,,24,17,41
006 Abtei,31,,19,19,38
006 Abtei,32,,26,17,43
006 Abtei,33,,17,25,42
006 Abtei,34,,22,35,57
006 Abtei,35,,24,37,61
006 Abtei,36,,25,24,49
006 Abtei,37,,15,32,47
006 Abtei,38,,20,29,49
006 Abtei,39,,28,21,49
006 Abtei,40,,44,33,77
006 Abtei,41,,17,31,48
006 Abtei,42,,30,36,66
006 Abtei,43,,30,33,63
006 Abtei,44,,30,33,63
006 Abtei,45,,36,35,71
006 Abtei,46,,23,29,52
006 Abtei,47,,35,25,60
006 Abtei,48,,26,34,60
006 Abtei,49,,29,27,56
006 Abtei,50,,26,29,55
006 Abtei,51,,25,26,51
006 Abtei,52,,26,24,50
006 Abtei,53,,27,24,51
006 Abtei,54,,19,21,40
006 Abtei,55,,20,15,35
006 Abtei,56,,20,17,37
006 Abtei,57,,17,15,32
006 Abtei,58,,11,15,26
006 Abtei,59,,14,19,33
006 Abtei,60,,11,14,25
006 Abtei,61,,11,12,23
006 Abtei,62,,13,20,33
006 Abtei,63,,10,18,28
006 Abtei,64,,23,17,40
006 Abtei,65,,15,15,30
006 Abtei,66,,23,18,41
006 Abtei,67,,16,20,36
006 Abtei,68,,11,16,27
006 Abtei,69,,12,12,24
006 Abtei,70,,20,12,32
006 Abtei,71,,14,22,36
006 Abtei,72,,15,16,31
006 Abtei,73,,13,13,26
006 Abtei,74,,15,17,32
006 Abtei,75,,6,16,22
006 Abtei,76,,14,9,23
006 Abtei,77,,9,16,25
006 Abtei,78,,11,13,24
006 Abtei,79,,5,15,20
006 Abtei,80,,4,5,9
006 Abtei,81,,8,11,19
006 Abtei,82,,10,10,20
006 Abtei,83,,5,6,11
006 Abtei,84,,3,10,13
006 Abtei,85,,5,7,12
006 Abtei,86,,3,3,6
006 Abtei,87,,4,4,8
006 Abtei,88,,4,7,11
006 Abtei,89,,3,5,8
006 Abtei,90,,4,2,6
006 Abtei,91,,1,1,2
006 Abtei,92,,1,5,6
006 Abtei,93,,-,1,1
006 Abtei,94,,-,2,2
006 Abtei,96,,1,2,3
006 Abtei,98,,-,1,1
006 Abtei,100,,-,1,1
006 Abtei,Insgesamt,,1.672,1.722,3.394
007 Barbian,0,,12,13,25
007 Barbian,1,,11,7,18
007 Barbian,2,,7,7,14
007 Barbian,3,,7,14,21
007 Barbian,4,,11,5,16
007 Barbian,5,,6,11,17
007 Barbian,6,,6,2,8
007 Barbian,7,,17,5,22
007 Barbian,8,,6,5,11
007 Barbian,9,,8,15,23
007 Barbian,10,,6,8,14
007 Barbian,11,,11,16,27
007 Barbian,12,,14,6,20
007 Barbian,13,,11,11,22
007 Barbian,14,,13,7,20
007 Barbian,15,,9,10,19
007 Barbian,16,,11,10,21
007 Barbian,17,,11,9,20
007 Barbian,18,,8,4,12
007 Barbian,19,,9,13,22
007 Barbian,20,,12,6,18
007 Barbian,21,,13,13,26
007 Barbian,22,,16,12,28
007 Barbian,23,,7,12,19
007 Barbian,24,,14,6,20
007 Barbian,25,,9,9,18
007 Barbian,26,,14,9,23
007 Barbian,27,,6,8,14
007 Barbian,28,,11,6,17
007 Barbian,29,,12,14,26
007 Barbian,30,,9,12,21
007 Barbian,31,,10,13,23
007 Barbian,32,,12,6,18
007 Barbian,33,,17,9,26
007 Barbian,34,,13,9,22
007 Barbian,35,,13,19,32
007 Barbian,36,,7,13,20
007 Barbian,37,,9,9,18
007 Barbian,38,,13,10,23
007 Barbian,39,,12,19,31
007 Barbian,40,,15,14,29
007 Barbian,41,,16,8,24
007 Barbian,42,,13,13,26
007 Barbian,43,,15,6,21
007 Barbian,44,,14,10,24
007 Barbian,45,,9,8,17
007 Barbian,46,,12,11,23
007 Barbian,47,,7,12,19
007 Barbian,48,,15,15,30
007 Barbian,49,,15,15,30
007 Barbian,50,,15,14,29
007 Barbian,51,,16,11,27
007 Barbian,52,,13,15,28
007 Barbian,53,,10,9,19
007 Barbian,54,,8,9,17
007 Barbian,55,,16,7,23
007 Barbian,56,,5,10,15
007 Barbian,57,,7,7,14
007 Barbian,58,,7,15,22
007 Barbian,59,,7,12,19
007 Barbian,60,,8,6,14
007 Barbian,61,,9,9,18
007 Barbian,62,,11,11,22
007 Barbian,63,,5,6,11
007 Barbian,64,,3,5,8
007 Barbian,65,,6,9,15
007 Barbian,66,,17,6,23
007 Barbian,67,,4,6,10
007 Barbian,68,,10,9,19
007 Barbian,69,,9,7,16
007 Barbian,70,,11,10,21
007 Barbian,71,,8,12,20
007 Barbian,72,,9,4,13
007 Barbian,73,,5,4,9
007 Barbian,74,,5,9,14
007 Barbian,75,,8,9,17
007 Barbian,76,,3,5,8
007 Barbian,77,,2,5,7
007 Barbian,78,,5,5,10
007 Barbian,79,,7,4,11
007 Barbian,80,,6,6,12
007 Barbian,81,,2,6,8
007 Barbian,82,,3,4,7
007 Barbian,83,,5,7,12
007 Barbian,84,,4,4,8
007 Barbian,85,,3,-,3
007 Barbian,86,,2,1,3
007 Barbian,87,,4,1,5
007 Barbian,88,,1,3,4
007 Barbian,89,,-,3,3
007 Barbian,90,,1,2,3
007 Barbian,91,,1,1,2
007 Barbian,94,,1,-,1
007 Barbian,Insgesamt,,836,792,1.628
008 Bozen,0,,508,453,961
008 Bozen,1,,493,476,969
008 Bozen,2,,511,487,998
008 Bozen,3,,518,468,986
008 Bozen,4,,532,511,1.043
008 Bozen,5,,568,484,1.052
008 Bozen,6,,486,504,990
008 Bozen,7,,556,492,1.048
008 Bozen,8,,547,506,1.053
008 Bozen,9,,537,521,1.058
008 Bozen,10,,545,475,1.020
008 Bozen,11,,532,473,1.005
008 Bozen,12,,472,506,978
008 Bozen,13,,524,498,1.022
008 Bozen,14,,521,482,1.003
008 Bozen,15,,500,455,955
008 Bozen,16,,475,511,986
008 Bozen,17,,472,438,910
008 Bozen,18,,515,491,1.006
008 Bozen,19,,467,478,945
008 Bozen,20,,508,459,967
008 Bozen,21,,540,476,1.016
008 Bozen,22,,538,490,1.028
008 Bozen,23,,536,512,1.048
008 Bozen,24,,552,525,1.077
008 Bozen,25,,456,504,960
008 Bozen,26,,527,509,1.036
008 Bozen,27,,565,531,1.096
008 Bozen,28,,559,564,1.123
008 Bozen,29,,603,560,1.163
008 Bozen,30,,598,571,1.169
008 Bozen,31,,603,575,1.178
008 Bozen,32,,667,618,1.285
008 Bozen,33,,626,615,1.241
008 Bozen,34,,617,631,1.248
008 Bozen,35,,662,661,1.323
008 Bozen,36,,672,704,1.376
008 Bozen,37,,713,746,1.459
008 Bozen,38,,784,773,1.557
008 Bozen,39,,743,836,1.579
008 Bozen,40,,817,864,1.681
008 Bozen,41,,878,911,1.789
008 Bozen,42,,840,830,1.670
008 Bozen,43,,918,889,1.807
008 Bozen,44,,842,815,1.657
008 Bozen,45,,810,880,1.690
008 Bozen,46,,896,911,1.807
008 Bozen,47,,929,908,1.837
008 Bozen,48,,902,923,1.825
008 Bozen,49,,780,868,1.648
008 Bozen,50,,768,806,1.574
008 Bozen,51,,755,752,1.507
008 Bozen,52,,715,755,1.470
008 Bozen,53,,700,723,1.423
008 Bozen,54,,698,730,1.428
008 Bozen,55,,618,734,1.352
008 Bozen,56,,625,677,1.302
008 Bozen,57,,593,670,1.263
008 Bozen,58,,592,620,1.212
008 Bozen,59,,526,621,1.147
008 Bozen,60,,517,650,1.167
008 Bozen,61,,518,626,1.144
008 Bozen,62,,542,674,1.216
008 Bozen,63,,554,642,1.196
008 Bozen,64,,593,718,1.311
008 Bozen,65,,574,785,1.359
008 Bozen,66,,650,849,1.499
008 Bozen,67,,482,570,1.052
008 Bozen,68,,528,693,1.221
008 Bozen,69,,562,699,1.261
008 Bozen,70,,591,683,1.274
008 Bozen,71,,627,720,1.347
008 Bozen,72,,589,696,1.285
008 Bozen,73,,527,692,1.219
008 Bozen,74,,537,627,1.164
008 Bozen,75,,456,538,994
008 Bozen,76,,404,525,929
008 Bozen,77,,384,526,910
008 Bozen,78,,396,512,908
008 Bozen,79,,340,503,843
008 Bozen,80,,333,497,830
008 Bozen,81,,317,460,777
008 Bozen,82,,301,452,753
008 Bozen,83,,201,392,593
008 Bozen,84,,229,377,606
008 Bozen,85,,195,360,555
008 Bozen,86,,214,327,541
008 Bozen,87,,150,323,473
008 Bozen,88,,134,271,405
008 Bozen,89,,94,276,370
008 Bozen,90,,83,263,346
008 Bozen,91,,66,199,265
008 Bozen,92,,55,168,223
008 Bozen,93,,20,103,123
008 Bozen,94,,11,47,58
008 Bozen,95,,11,36,47
008 Bozen,96,,9,43,52
008 Bozen,97,,4,41,45
008 Bozen,98,,8,29,37
008 Bozen,99,,6,15,21
008 Bozen,100,,6,12,18
008 Bozen,101,,3,12,15
008 Bozen,102,,1,4,5
008 Bozen,104,,-,1,1
008 Bozen,105,,-,2,2
008 Bozen,106,,-,1,1
008 Bozen,Insgesamt,,50.372,55.095,105.467
009 Prags,0,,1,1,2
009 Prags,1,,5,2,7
009 Prags,2,,1,3,4
009 Prags,3,,2,2,4
009 Prags,4,,4,6,10
009 Prags,5,,4,6,10
009 Prags,6,,4,3,7
009 Prags,7,,4,1,5
009 Prags,8,,3,3,6
009 Prags,9,,2,5,7
009 Prags,10,,2,6,8
009 Prags,11,,8,5,13
009 Prags,12,,2,3,5
009 Prags,13,,5,9,14
009 Prags,14,,1,4,5
009 Prags,15,,3,5,8
009 Prags,16,,3,6,9
009 Prags,17,,3,1,4
009 Prags,18,,4,5,9
009 Prags,19,,7,2,9
009 Prags,20,,6,2,8
009 Prags,21,,8,1,9
009 Prags,22,,4,1,5
009 Prags,23,,8,1,9
009 Prags,24,,2,5,7
009 Prags,25,,3,3,6
009 Prags,26,,5,4,9
009 Prags,27,,8,2,10
009 Prags,28,,5,3,8
009 Prags,29,,3,3,6
009 Prags,30,,3,5,8
009 Prags,31,,2,5,7
009 Prags,32,,5,1,6
009 Prags,33,,2,2,4
009 Prags,34,,5,7,12
009 Prags,35,,3,3,6
009 Prags,36,,5,3,8
009 Prags,37,,2,5,7
009 Prags,38,,2,5,7
009 Prags,39,,8,3,11
009 Prags,40,,4,3,7
009 Prags,41,,6,4,10
009 Prags,42,,5,6,11
009 Prags,43,,9,5,14
009 Prags,44,,8,8,16
009 Prags,45,,7,6,13
009 Prags,46,,8,5,13
009 Prags,47,,7,7,14
009 Prags,48,,5,3,8
009 Prags,49,,6,5,11
009 Prags,50,,3,5,8
009 Prags,51,,5,12,17
009 Prags,52,,5,4,9
009 Prags,53,,11,5,16
009 Prags,54,,6,2,8
009 Prags,55,,6,4,10
009 Prags,56,,1,6,7
009 Prags,57,,4,5,9
009 Prags,58,,6,4,10
009 Prags,59,,4,1,5
009 Prags,60,,2,5,7
009 Prags,61,,3,1,4
009 Prags,62,,4,1,5
009 Prags,63,,1,1,2
009 Prags,64,,4,1,5
009 Prags,65,,1,-,1
009 Prags,66,,2,4,6
009 Prags,67,,2,2,4
009 Prags,68,,4,4,8
009 Prags,69,,1,3,4
009 Prags,70,,4,4,8
009 Prags,71,,5,2,7
009 Prags,72,,1,3,4
009 Prags,73,,3,5,8
009 Prags,74,,3,2,5
009 Prags,75,,-,2,2
009 Prags,76,,1,3,4
009 Prags,77,,1,3,4
009 Prags,78,,2,2,4
009 Prags,79,,3,2,5
009 Prags,80,,3,4,7
009 Prags,81,,-,3,3
009 Prags,82,,-,1,1
009 Prags,83,,1,1,2
009 Prags,84,,-,2,2
009 Prags,85,,1,6,7
009 Prags,86,,1,4,5
009 Prags,87,,1,3,4
009 Prags,88,,3,1,4
009 Prags,89,,-,2,2
009 Prags,90,,2,1,3
009 Prags,91,,1,2,3
009 Prags,92,,1,-,1
009 Prags,93,,-,1,1
009 Prags,Insgesamt,,334,323,657
010 Brenner,0,,6,8,14
010 Brenner,1,,6,18,24
010 Brenner,2,,14,17,31
010 Brenner,3,,14,8,22
010 Brenner,4,,10,18,28
010 Brenner,5,,12,12,24
010 Brenner,6,,6,15,21
010 Brenner,7,,13,10,23
010 Brenner,8,,11,18,29
010 Brenner,9,,11,9,20
010 Brenner,10,,13,12,25
010 Brenner,11,,6,7,13
010 Brenner,12,,16,12,28
010 Brenner,13,,11,14,25
010 Brenner,14,,15,5,20
010 Brenner,15,,16,7,23
010 Brenner,16,,7,11,18
010 Brenner,17,,7,9,16
010 Brenner,18,,20,11,31
010 Brenner,19,,15,6,21
010 Brenner,20,,16,10,26
010 Brenner,21,,11,20,31
010 Brenner,22,,15,10,25
010 Brenner,23,,13,9,22
010 Brenner,24,,12,10,22
010 Brenner,25,,10,12,22
010 Brenner,26,,11,10,21
010 Brenner,27,,20,6,26
010 Brenner,28,,18,20,38
010 Brenner,29,,17,17,34
010 Brenner,30,,17,12,29
010 Brenner,31,,15,20,35
010 Brenner,32,,14,17,31
010 Brenner,33,,15,14,29
010 Brenner,34,,17,15,32
010 Brenner,35,,24,10,34
010 Brenner,36,,13,8,21
010 Brenner,37,,20,20,40
010 Brenner,38,,16,7,23
010 Brenner,39,,13,6,19
010 Brenner,40,,19,24,43
010 Brenner,41,,22,15,37
010 Brenner,42,,18,16,34
010 Brenner,43,,11,16,27
010 Brenner,44,,14,17,31
010 Brenner,45,,18,15,33
010 Brenner,46,,20,18,38
010 Brenner,47,,22,16,38
010 Brenner,48,,22,16,38
010 Brenner,49,,11,19,30
010 Brenner,50,,17,12,29
010 Brenner,51,,20,12,32
010 Brenner,52,,20,14,34
010 Brenner,53,,13,13,26
010 Brenner,54,,16,10,26
010 Brenner,55,,14,17,31
010 Brenner,56,,17,13,30
010 Brenner,57,,12,9,21
010 Brenner,58,,10,15,25
010 Brenner,59,,7,14,21
010 Brenner,60,,19,7,26
010 Brenner,61,,12,11,23
010 Brenner,62,,12,12,24
010 Brenner,63,,15,13,28
010 Brenner,64,,6,9,15
010 Brenner,65,,20,11,31
010 Brenner,66,,9,18,27
010 Brenner,67,,4,8,12
010 Brenner,68,,15,12,27
010 Brenner,69,,15,12,27
010 Brenner,70,,7,10,17
010 Brenner,71,,11,11,22
010 Brenner,72,,9,12,21
010 Brenner,73,,7,10,17
010 Brenner,74,,8,14,22
010 Brenner,75,,8,13,21
010 Brenner,76,,11,6,17
010 Brenner,77,,3,5,8
010 Brenner,78,,8,5,13
010 Brenner,79,,4,4,8
010 Brenner,80,,-,4,4
010 Brenner,81,,5,8,13
010 Brenner,82,,7,10,17
010 Brenner,83,,5,5,10
010 Brenner,84,,5,5,10
010 Brenner,85,,5,2,7
010 Brenner,86,,4,4,8
010 Brenner,87,,2,5,7
010 Brenner,88,,1,4,5
010 Brenner,89,,2,4,6
010 Brenner,90,,-,3,3
010 Brenner,92,,1,2,3
010 Brenner,93,,1,-,1
010 Brenner,Insgesamt,,1.100,1.040,2.140
011 Brixen,0,,107,114,221
011 Brixen,1,,89,90,179
011 Brixen,2,,127,118,245
011 Brixen,3,,130,114,244
011 Brixen,4,,113,105,218
011 Brixen,5,,127,102,229
011 Brixen,6,,128,106,234
011 Brixen,7,,129,119,248
011 Brixen,8,,117,118,235
011 Brixen,9,,109,111,220
011 Brixen,10,,114,115,229
011 Brixen,11,,125,125,250
011 Brixen,12,,122,105,227
011 Brixen,13,,144,127,271
011 Brixen,14,,113,135,248
011 Brixen,15,,119,108,227
011 Brixen,16,,122,119,241
011 Brixen,17,,115,123,238
011 Brixen,18,,130,127,257
011 Brixen,19,,120,110,230
011 Brixen,20,,120,121,241
011 Brixen,21,,128,107,235
011 Brixen,22,,108,110,218
011 Brixen,23,,122,99,221
011 Brixen,24,,126,105,231
011 Brixen,25,,115,125,240
011 Brixen,26,,110,132,242
011 Brixen,27,,130,107,237
011 Brixen,28,,125,116,241
011 Brixen,29,,131,141,272
011 Brixen,30,,127,123,250
011 Brixen,31,,136,138,274
011 Brixen,32,,116,131,247
011 Brixen,33,,150,133,283
011 Brixen,34,,110,142,252
011 Brixen,35,,148,150,298
011 Brixen,36,,147,159,306
011 Brixen,37,,136,132,268
011 Brixen,38,,137,159,296
011 Brixen,39,,162,161,323
011 Brixen,40,,165,175,340
011 Brixen,41,,164,175,339
011 Brixen,42,,172,166,338
011 Brixen,43,,191,196,387
011 Brixen,44,,174,197,371
011 Brixen,45,,180,168,348
011 Brixen,46,,174,195,369
011 Brixen,47,,182,167,349
011 Brixen,48,,184,191,375
011 Brixen,49,,145,165,310
011 Brixen,50,,164,170,334
011 Brixen,51,,138,167,305
011 Brixen,52,,141,148,289
011 Brixen,53,,152,144,296
011 Brixen,54,,146,125,271
011 Brixen,55,,133,145,278
011 Brixen,56,,111,143,254
011 Brixen,57,,123,100,223
011 Brixen,58,,90,119,209
011 Brixen,59,,88,112,200
011 Brixen,60,,104,108,212
011 Brixen,61,,95,109,204
011 Brixen,62,,118,105,223
011 Brixen,63,,82,128,210
011 Brixen,64,,105,116,221
011 Brixen,65,,89,114,203
011 Brixen,66,,100,103,203
011 Brixen,67,,64,100,164
011 Brixen,68,,112,116,228
011 Brixen,69,,119,112,231
011 Brixen,70,,87,103,190
011 Brixen,71,,102,118,220
011 Brixen,72,,83,112,195
011 Brixen,73,,84,98,182
011 Brixen,74,,77,88,165
011 Brixen,75,,80,89,169
011 Brixen,76,,60,88,148
011 Brixen,77,,67,82,149
011 Brixen,78,,61,82,143
011 Brixen,79,,64,63,127
011 Brixen,80,,58,76,134
011 Brixen,81,,55,69,124
011 Brixen,82,,39,78,117
011 Brixen,83,,35,70,105
011 Brixen,84,,38,58,96
011 Brixen,85,,22,77,99
011 Brixen,86,,28,52,80
011 Brixen,87,,26,58,84
011 Brixen,88,,19,49,68
011 Brixen,89,,19,39,58
011 Brixen,90,,10,40,50
011 Brixen,91,,8,32,40
011 Brixen,92,,5,29,34
011 Brixen,93,,4,14,18
011 Brixen,94,,3,6,9
011 Brixen,95,,7,11,18
011 Brixen,96,,1,4,5
011 Brixen,97,,-,3,3
011 Brixen,98,,2,5,7
011 Brixen,99,,1,-,1
011 Brixen,100,,1,3,4
011 Brixen,101,,-,2,2
011 Brixen,102,,-,1,1
011 Brixen,105,,-,1,1
011 Brixen,Insgesamt,,10.135,10.861,20.996
012 Branzoll,0,,13,18,31
012 Branzoll,1,,17,11,28
012 Branzoll,2,,12,23,35
012 Branzoll,3,,16,18,34
012 Branzoll,4,,12,15,27
012 Branzoll,5,,14,16,30
012 Branzoll,6,,14,9,23
012 Branzoll,7,,7,9,16
012 Branzoll,8,,16,15,31
012 Branzoll,9,,15,22,37
012 Branzoll,10,,14,12,26
012 Branzoll,11,,8,12,20
012 Branzoll,12,,22,8,30
012 Branzoll,13,,10,13,23
012 Branzoll,14,,14,4,18
012 Branzoll,15,,15,21,36
012 Branzoll,16,,17,7,24
012 Branzoll,17,,14,15,29
012 Branzoll,18,,17,9,26
012 Branzoll,19,,21,15,36
012 Branzoll,20,,15,13,28
012 Branzoll,21,,12,17,29
012 Branzoll,22,,16,19,35
012 Branzoll,23,,11,11,22
012 Branzoll,24,,15,13,28
012 Branzoll,25,,15,13,28
012 Branzoll,26,,14,18,32
012 Branzoll,27,,17,16,33
012 Branzoll,28,,16,15,31
012 Branzoll,29,,13,13,26
012 Branzoll,30,,16,14,30
012 Branzoll,31,,16,14,30
012 Branzoll,32,,15,17,32
012 Branzoll,33,,14,12,26
012 Branzoll,34,,12,25,37
012 Branzoll,35,,14,23,37
012 Branzoll,36,,19,19,38
012 Branzoll,37,,21,17,38
012 Branzoll,38,,24,27,51
012 Branzoll,39,,25,16,41
012 Branzoll,40,,23,16,39
012 Branzoll,41,,25,27,52
012 Branzoll,42,,21,19,40
012 Branzoll,43,,25,28,53
012 Branzoll,44,,20,22,42
012 Branzoll,45,,22,20,42
012 Branzoll,46,,17,20,37
012 Branzoll,47,,23,20,43
012 Branzoll,48,,30,26,56
012 Branzoll,49,,19,20,39
012 Branzoll,50,,16,17,33
012 Branzoll,51,,25,30,55
012 Branzoll,52,,28,20,48
012 Branzoll,53,,20,22,42
012 Branzoll,54,,19,18,37
012 Branzoll,55,,18,14,32
012 Branzoll,56,,15,18,33
012 Branzoll,57,,17,19,36
012 Branzoll,58,,20,17,37
012 Branzoll,59,,12,20,32
012 Branzoll,60,,14,21,35
012 Branzoll,61,,15,14,29
012 Branzoll,62,,17,14,31
012 Branzoll,63,,16,15,31
012 Branzoll,64,,14,15,29
012 Branzoll,65,,16,17,33
012 Branzoll,66,,14,19,33
012 Branzoll,67,,12,9,21
012 Branzoll,68,,12,10,22
012 Branzoll,69,,14,10,24
012 Branzoll,70,,19,12,31
012 Branzoll,71,,19,12,31
012 Branzoll,72,,9,14,23
012 Branzoll,73,,14,13,27
012 Branzoll,74,,9,9,18
012 Branzoll,75,,3,7,10
012 Branzoll,76,,6,8,14
012 Branzoll,77,,8,8,16
012 Branzoll,78,,5,9,14
012 Branzoll,79,,17,10,27
012 Branzoll,80,,8,9,17
012 Branzoll,81,,1,9,10
012 Branzoll,82,,5,11,16
012 Branzoll,83,,2,10,12
012 Branzoll,84,,3,8,11
012 Branzoll,85,,2,5,7
012 Branzoll,86,,4,9,13
012 Branzoll,87,,1,4,5
012 Branzoll,88,,1,4,5
012 Branzoll,89,,2,6,8
012 Branzoll,90,,-,1,1
012 Branzoll,91,,-,4,4
012 Branzoll,92,,1,3,4
012 Branzoll,93,,1,1,2
012 Branzoll,94,,2,-,2
012 Branzoll,98,,-,1,1
012 Branzoll,Insgesamt,,1.309,1.348,2.657
013 Bruneck,0,,88,67,155
013 Bruneck,1,,79,61,140
013 Bruneck,2,,82,75,157
013 Bruneck,3,,96,64,160
013 Bruneck,4,,82,68,150
013 Bruneck,5,,89,67,156
013 Bruneck,6,,106,74,180
013 Bruneck,7,,83,89,172
013 Bruneck,8,,89,101,190
013 Bruneck,9,,99,78,177
013 Bruneck,10,,82,90,172
013 Bruneck,11,,96,80,176
013 Bruneck,12,,89,86,175
013 Bruneck,13,,93,100,193
013 Bruneck,14,,101,92,193
013 Bruneck,15,,111,73,184
013 Bruneck,16,,82,100,182
013 Bruneck,17,,67,80,147
013 Bruneck,18,,88,77,165
013 Bruneck,19,,89,71,160
013 Bruneck,20,,95,83,178
013 Bruneck,21,,90,76,166
013 Bruneck,22,,97,83,180
013 Bruneck,23,,85,93,178
013 Bruneck,24,,81,85,166
013 Bruneck,25,,66,76,142
013 Bruneck,26,,120,84,204
013 Bruneck,27,,90,84,174
013 Bruneck,28,,87,94,181
013 Bruneck,29,,103,89,192
013 Bruneck,30,,110,103,213
013 Bruneck,31,,107,114,221
013 Bruneck,32,,101,111,212
013 Bruneck,33,,95,101,196
013 Bruneck,34,,121,122,243
013 Bruneck,35,,115,109,224
013 Bruneck,36,,106,133,239
013 Bruneck,37,,122,125,247
013 Bruneck,38,,134,115,249
013 Bruneck,39,,131,120,251
013 Bruneck,40,,116,128,244
013 Bruneck,41,,140,111,251
013 Bruneck,42,,123,142,265
013 Bruneck,43,,136,118,254
013 Bruneck,44,,120,151,271
013 Bruneck,45,,137,128,265
013 Bruneck,46,,127,126,253
013 Bruneck,47,,153,147,300
013 Bruneck,48,,137,136,273
013 Bruneck,49,,137,115,252
013 Bruneck,50,,131,122,253
013 Bruneck,51,,122,97,219
013 Bruneck,52,,109,119,228
013 Bruneck,53,,109,104,213
013 Bruneck,54,,102,116,218
013 Bruneck,55,,85,98,183
013 Bruneck,56,,90,94,184
013 Bruneck,57,,77,80,157
013 Bruneck,58,,88,80,168
013 Bruneck,59,,77,101,178
013 Bruneck,60,,89,96,185
013 Bruneck,61,,66,103,169
013 Bruneck,62,,80,96,176
013 Bruneck,63,,82,90,172
013 Bruneck,64,,78,110,188
013 Bruneck,65,,94,71,165
013 Bruneck,66,,97,83,180
013 Bruneck,67,,61,67,128
013 Bruneck,68,,81,93,174
013 Bruneck,69,,93,81,174
013 Bruneck,70,,80,85,165
013 Bruneck,71,,72,93,165
013 Bruneck,72,,72,83,155
013 Bruneck,73,,73,90,163
013 Bruneck,74,,54,51,105
013 Bruneck,75,,50,54,104
013 Bruneck,76,,47,58,105
013 Bruneck,77,,42,46,88
013 Bruneck,78,,31,52,83
013 Bruneck,79,,40,57,97
013 Bruneck,80,,41,46,87
013 Bruneck,81,,31,41,72
013 Bruneck,82,,27,50,77
013 Bruneck,83,,21,49,70
013 Bruneck,84,,27,50,77
013 Bruneck,85,,21,31,52
013 Bruneck,86,,15,24,39
013 Bruneck,87,,13,29,42
013 Bruneck,88,,6,40,46
013 Bruneck,89,,9,23,32
013 Bruneck,90,,13,17,30
013 Bruneck,91,,1,15,16
013 Bruneck,92,,3,17,20
013 Bruneck,93,,5,8,13
013 Bruneck,94,,-,7,7
013 Bruneck,95,,2,7,9
013 Bruneck,96,,-,8,8
013 Bruneck,97,,1,2,3
013 Bruneck,98,,-,3,3
013 Bruneck,99,,-,4,4
013 Bruneck,100,,-,2,2
013 Bruneck,101,,-,1,1
013 Bruneck,103,,-,1,1
013 Bruneck,Insgesamt,,7.781,7.940,15.721
014 Kuens,0,,1,2,3
014 Kuens,1,,2,6,8
014 Kuens,2,,1,1,2
014 Kuens,3,,3,4,7
014 Kuens,4,,4,3,7
014 Kuens,5,,2,4,6
014 Kuens,6,,1,1,2
014 Kuens,7,,6,2,8
014 Kuens,8,,1,3,4
014 Kuens,9,,5,4,9
014 Kuens,10,,2,1,3
014 Kuens,11,,5,2,7
014 Kuens,12,,2,6,8
014 Kuens,13,,2,3,5
014 Kuens,14,,2,6,8
014 Kuens,15,,1,1,2
014 Kuens,16,,5,2,7
014 Kuens,17,,2,3,5
014 Kuens,18,,1,4,5
014 Kuens,19,,3,2,5
014 Kuens,20,,4,2,6
014 Kuens,21,,2,2,4
014 Kuens,22,,4,2,6
014 Kuens,23,,2,2,4
014 Kuens,24,,1,3,4
014 Kuens,25,,2,1,3
014 Kuens,26,,1,-,1
014 Kuens,27,,1,1,2
014 Kuens,28,,-,2,2
014 Kuens,29,,-,1,1
014 Kuens,30,,2,1,3
014 Kuens,31,,1,4,5
014 Kuens,32,,4,6,10
014 Kuens,33,,1,1,2
014 Kuens,34,,3,3,6
014 Kuens,35,,2,2,4
014 Kuens,36,,3,1,4
014 Kuens,37,,3,6,9
014 Kuens,38,,4,4,8
014 Kuens,39,,1,4,5
014 Kuens,40,,6,1,7
014 Kuens,41,,2,4,6
014 Kuens,42,,6,5,11
014 Kuens,43,,4,1,5
014 Kuens,44,,4,4,8
014 Kuens,45,,6,11,17
014 Kuens,46,,1,5,6
014 Kuens,47,,7,1,8
014 Kuens,48,,5,6,11
014 Kuens,49,,10,2,12
014 Kuens,50,,5,1,6
014 Kuens,51,,-,5,5
014 Kuens,53,,1,-,1
014 Kuens,54,,-,4,4
014 Kuens,55,,3,-,3
014 Kuens,56,,2,-,2
014 Kuens,57,,1,2,3
014 Kuens,58,,-,1,1
014 Kuens,59,,2,2,4
014 Kuens,60,,1,3,4
014 Kuens,62,,-,3,3
014 Kuens,63,,-,2,2
014 Kuens,64,,3,1,4
014 Kuens,65,,1,2,3
014 Kuens,66,,1,2,3
014 Kuens,67,,3,1,4
014 Kuens,68,,1,-,1
014 Kuens,69,,-,2,2
014 Kuens,70,,1,3,4
014 Kuens,71,,-,2,2
014 Kuens,72,,-,1,1
014 Kuens,73,,5,2,7
014 Kuens,74,,3,2,5
014 Kuens,75,,1,3,4
014 Kuens,76,,2,2,4
014 Kuens,77,,1,2,3
014 Kuens,78,,-,1,1
014 Kuens,79,,-,1,1
014 Kuens,80,,4,2,6
014 Kuens,81,,2,2,4
014 Kuens,82,,2,1,3
014 Kuens,83,,1,-,1
014 Kuens,84,,1,-,1
014 Kuens,85,,1,-,1
014 Kuens,86,,1,1,2
014 Kuens,90,,-,2,2
014 Kuens,Insgesamt,,192,206,398
015 Kaltern a.d. Weinstr.,0,,48,31,79
015 Kaltern a.d. Weinstr.,1,,41,53,94
015 Kaltern a.d. Weinstr.,2,,57,33,90
015 Kaltern a.d. Weinstr.,3,,52,32,84
015 Kaltern a.d. Weinstr.,4,,41,44,85
015 Kaltern a.d. Weinstr.,5,,43,41,84
015 Kaltern a.d. Weinstr.,6,,44,40,84
015 Kaltern a.d. Weinstr.,7,,46,43,89
015 Kaltern a.d. Weinstr.,8,,45,47,92
015 Kaltern a.d. Weinstr.,9,,44,37,81
015 Kaltern a.d. Weinstr.,10,,43,36,79
015 Kaltern a.d. Weinstr.,11,,30,51,81
015 Kaltern a.d. Weinstr.,12,,37,38,75
015 Kaltern a.d. Weinstr.,13,,44,37,81
015 Kaltern a.d. Weinstr.,14,,41,50,91
015 Kaltern a.d. Weinstr.,15,,45,43,88
015 Kaltern a.d. Weinstr.,16,,43,44,87
015 Kaltern a.d. Weinstr.,17,,42,37,79
015 Kaltern a.d. Weinstr.,18,,32,40,72
015 Kaltern a.d. Weinstr.,19,,30,41,71
015 Kaltern a.d. Weinstr.,20,,38,43,81
015 Kaltern a.d. Weinstr.,21,,40,46,86
015 Kaltern a.d. Weinstr.,22,,39,36,75
015 Kaltern a.d. Weinstr.,23,,57,31,88
015 Kaltern a.d. Weinstr.,24,,40,42,82
015 Kaltern a.d. Weinstr.,25,,39,37,76
015 Kaltern a.d. Weinstr.,26,,55,43,98
015 Kaltern a.d. Weinstr.,27,,53,43,96
015 Kaltern a.d. Weinstr.,28,,44,47,91
015 Kaltern a.d. Weinstr.,29,,40,48,88
015 Kaltern a.d. Weinstr.,30,,55,58,113
015 Kaltern a.d. Weinstr.,31,,46,47,93
015 Kaltern a.d. Weinstr.,32,,48,52,100
015 Kaltern a.d. Weinstr.,33,,51,45,96
015 Kaltern a.d. Weinstr.,34,,57,46,103
015 Kaltern a.d. Weinstr.,35,,41,58,99
015 Kaltern a.d. Weinstr.,36,,48,54,102
015 Kaltern a.d. Weinstr.,37,,52,67,119
015 Kaltern a.d. Weinstr.,38,,53,57,110
015 Kaltern a.d. Weinstr.,39,,53,57,110
015 Kaltern a.d. Weinstr.,40,,66,69,135
015 Kaltern a.d. Weinstr.,41,,62,61,123
015 Kaltern a.d. Weinstr.,42,,57,64,121
015 Kaltern a.d. Weinstr.,43,,62,63,125
015 Kaltern a.d. Weinstr.,44,,81,69,150
015 Kaltern a.d. Weinstr.,45,,65,65,130
015 Kaltern a.d. Weinstr.,46,,64,73,137
015 Kaltern a.d. Weinstr.,47,,57,59,116
015 Kaltern a.d. Weinstr.,48,,84,53,137
015 Kaltern a.d. Weinstr.,49,,51,59,110
015 Kaltern a.d. Weinstr.,50,,58,64,122
015 Kaltern a.d. Weinstr.,51,,66,69,135
015 Kaltern a.d. Weinstr.,52,,51,67,118
015 Kaltern a.d. Weinstr.,53,,51,57,108
015 Kaltern a.d. Weinstr.,54,,57,69,126
015 Kaltern a.d. Weinstr.,55,,51,59,110
015 Kaltern a.d. Weinstr.,56,,62,40,102
015 Kaltern a.d. Weinstr.,57,,48,42,90
015 Kaltern a.d. Weinstr.,58,,38,50,88
015 Kaltern a.d. Weinstr.,59,,36,36,72
015 Kaltern a.d. Weinstr.,60,,40,59,99
015 Kaltern a.d. Weinstr.,61,,34,38,72
015 Kaltern a.d. Weinstr.,62,,44,34,78
015 Kaltern a.d. Weinstr.,63,,30,35,65
015 Kaltern a.d. Weinstr.,64,,35,34,69
015 Kaltern a.d. Weinstr.,65,,37,56,93
015 Kaltern a.d. Weinstr.,66,,48,48,96
015 Kaltern a.d. Weinstr.,67,,35,38,73
015 Kaltern a.d. Weinstr.,68,,32,43,75
015 Kaltern a.d. Weinstr.,69,,31,37,68
015 Kaltern a.d. Weinstr.,70,,40,40,80
015 Kaltern a.d. Weinstr.,71,,43,41,84
015 Kaltern a.d. Weinstr.,72,,28,43,71
015 Kaltern a.d. Weinstr.,73,,20,35,55
015 Kaltern a.d. Weinstr.,74,,35,38,73
015 Kaltern a.d. Weinstr.,75,,25,29,54
015 Kaltern a.d. Weinstr.,76,,23,22,45
015 Kaltern a.d. Weinstr.,77,,24,26,50
015 Kaltern a.d. Weinstr.,78,,20,25,45
015 Kaltern a.d. Weinstr.,79,,21,37,58
015 Kaltern a.d. Weinstr.,80,,21,32,53
015 Kaltern a.d. Weinstr.,81,,14,29,43
015 Kaltern a.d. Weinstr.,82,,19,28,47
015 Kaltern a.d. Weinstr.,83,,19,28,47
015 Kaltern a.d. Weinstr.,84,,12,23,35
015 Kaltern a.d. Weinstr.,85,,12,27,39
015 Kaltern a.d. Weinstr.,86,,8,20,28
015 Kaltern a.d. Weinstr.,87,,10,26,36
015 Kaltern a.d. Weinstr.,88,,6,16,22
015 Kaltern a.d. Weinstr.,89,,2,12,14
015 Kaltern a.d. Weinstr.,90,,5,18,23
015 Kaltern a.d. Weinstr.,91,,5,12,17
015 Kaltern a.d. Weinstr.,92,,1,13,14
015 Kaltern a.d. Weinstr.,93,,2,2,4
015 Kaltern a.d. Weinstr.,94,,1,4,5
015 Kaltern a.d. Weinstr.,95,,-,3,3
015 Kaltern a.d. Weinstr.,96,,-,1,1
015 Kaltern a.d. Weinstr.,97,,1,2,3
015 Kaltern a.d. Weinstr.,98,,-,3,3
015 Kaltern a.d. Weinstr.,99,,-,1,1
015 Kaltern a.d. Weinstr.,100,,-,2,2
015 Kaltern a.d. Weinstr.,101,,-,1,1
015 Kaltern a.d. Weinstr.,Insgesamt,,3.747,4.024,7.771
016 Freienfeld,0,,11,11,22
016 Freienfeld,1,,16,20,36
016 Freienfeld,2,,15,15,30
016 Freienfeld,3,,19,16,35
016 Freienfeld,4,,13,13,26
016 Freienfeld,5,,23,12,35
016 Freienfeld,6,,15,16,31
016 Freienfeld,7,,19,17,36
016 Freienfeld,8,,16,10,26
016 Freienfeld,9,,21,15,36
016 Freienfeld,10,,19,19,38
016 Freienfeld,11,,17,18,35
016 Freienfeld,12,,14,14,28
016 Freienfeld,13,,18,21,39
016 Freienfeld,14,,14,21,35
016 Freienfeld,15,,18,18,36
016 Freienfeld,16,,22,13,35
016 Freienfeld,17,,17,16,33
016 Freienfeld,18,,15,11,26
016 Freienfeld,19,,14,13,27
016 Freienfeld,20,,18,21,39
016 Freienfeld,21,,10,10,20
016 Freienfeld,22,,20,17,37
016 Freienfeld,23,,25,21,46
016 Freienfeld,24,,21,16,37
016 Freienfeld,25,,17,15,32
016 Freienfeld,26,,15,15,30
016 Freienfeld,27,,18,14,32
016 Freienfeld,28,,23,13,36
016 Freienfeld,29,,23,21,44
016 Freienfeld,30,,20,18,38
016 Freienfeld,31,,21,15,36
016 Freienfeld,32,,18,14,32
016 Freienfeld,33,,16,23,39
016 Freienfeld,34,,13,14,27
016 Freienfeld,35,,21,24,45
016 Freienfeld,36,,15,16,31
016 Freienfeld,37,,18,14,32
016 Freienfeld,38,,23,22,45
016 Freienfeld,39,,21,18,39
016 Freienfeld,40,,17,24,41
016 Freienfeld,41,,25,25,50
016 Freienfeld,42,,23,16,39
016 Freienfeld,43,,24,25,49
016 Freienfeld,44,,22,18,40
016 Freienfeld,45,,19,28,47
016 Freienfeld,46,,25,21,46
016 Freienfeld,47,,26,21,47
016 Freienfeld,48,,26,19,45
016 Freienfeld,49,,23,17,40
016 Freienfeld,50,,26,29,55
016 Freienfeld,51,,26,16,42
016 Freienfeld,52,,24,22,46
016 Freienfeld,53,,25,14,39
016 Freienfeld,54,,17,21,38
016 Freienfeld,55,,15,20,35
016 Freienfeld,56,,19,17,36
016 Freienfeld,57,,20,10,30
016 Freienfeld,58,,17,18,35
016 Freienfeld,59,,18,12,30
016 Freienfeld,60,,15,18,33
016 Freienfeld,61,,12,10,22
016 Freienfeld,62,,18,9,27
016 Freienfeld,63,,16,12,28
016 Freienfeld,64,,18,13,31
016 Freienfeld,65,,4,9,13
016 Freienfeld,66,,11,16,27
016 Freienfeld,67,,9,2,11
016 Freienfeld,68,,8,5,13
016 Freienfeld,69,,11,8,19
016 Freienfeld,70,,11,9,20
016 Freienfeld,71,,10,10,20
016 Freienfeld,72,,10,4,14
016 Freienfeld,73,,7,9,16
016 Freienfeld,74,,11,12,23
016 Freienfeld,75,,4,11,15
016 Freienfeld,76,,8,11,19
016 Freienfeld,77,,6,11,17
016 Freienfeld,78,,4,4,8
016 Freienfeld,79,,6,8,14
016 Freienfeld,80,,6,9,15
016 Freienfeld,81,,5,7,12
016 Freienfeld,82,,6,5,11
016 Freienfeld,83,,2,4,6
016 Freienfeld,84,,4,3,7
016 Freienfeld,85,,3,6,9
016 Freienfeld,86,,6,6,12
016 Freienfeld,87,,2,2,4
016 Freienfeld,88,,1,2,3
016 Freienfeld,89,,-,6,6
016 Freienfeld,90,,-,3,3
016 Freienfeld,92,,1,1,2
016 Freienfeld,93,,1,-,1
016 Freienfeld,98,,-,1,1
016 Freienfeld,Insgesamt,,1.385,1.289,2.674
017 Sand in Taufers,0,,23,32,55
017 Sand in Taufers,1,,26,26,52
017 Sand in Taufers,2,,25,25,50
017 Sand in Taufers,3,,35,42,77
017 Sand in Taufers,4,,29,31,60
017 Sand in Taufers,5,,50,42,92
017 Sand in Taufers,6,,37,22,59
017 Sand in Taufers,7,,36,30,66
017 Sand in Taufers,8,,36,20,56
017 Sand in Taufers,9,,33,29,62
017 Sand in Taufers,10,,28,27,55
017 Sand in Taufers,11,,31,38,69
017 Sand in Taufers,12,,45,21,66
017 Sand in Taufers,13,,36,39,75
017 Sand in Taufers,14,,28,36,64
017 Sand in Taufers,15,,36,35,71
017 Sand in Taufers,16,,29,30,59
017 Sand in Taufers,17,,31,27,58
017 Sand in Taufers,18,,44,35,79
017 Sand in Taufers,19,,25,36,61
017 Sand in Taufers,20,,35,38,73
017 Sand in Taufers,21,,27,32,59
017 Sand in Taufers,22,,24,35,59
017 Sand in Taufers,23,,28,35,63
017 Sand in Taufers,24,,30,34,64
017 Sand in Taufers,25,,22,25,47
017 Sand in Taufers,26,,22,20,42
017 Sand in Taufers,27,,26,29,55
017 Sand in Taufers,28,,35,25,60
017 Sand in Taufers,29,,35,29,64
017 Sand in Taufers,30,,28,36,64
017 Sand in Taufers,31,,32,34,66
017 Sand in Taufers,32,,35,38,73
017 Sand in Taufers,33,,33,42,75
017 Sand in Taufers,34,,43,35,78
017 Sand in Taufers,35,,38,40,78
017 Sand in Taufers,36,,37,32,69
017 Sand in Taufers,37,,44,37,81
017 Sand in Taufers,38,,57,49,106
017 Sand in Taufers,39,,53,43,96
017 Sand in Taufers,40,,48,51,99
017 Sand in Taufers,41,,45,48,93
017 Sand in Taufers,42,,42,63,105
017 Sand in Taufers,43,,59,47,106
017 Sand in Taufers,44,,54,40,94
017 Sand in Taufers,45,,34,41,75
017 Sand in Taufers,46,,51,36,87
017 Sand in Taufers,47,,55,37,92
017 Sand in Taufers,48,,51,43,94
017 Sand in Taufers,49,,47,43,90
017 Sand in Taufers,50,,37,46,83
017 Sand in Taufers,51,,48,40,88
017 Sand in Taufers,52,,40,33,73
017 Sand in Taufers,53,,34,35,69
017 Sand in Taufers,54,,29,23,52
017 Sand in Taufers,55,,24,39,63
017 Sand in Taufers,56,,23,33,56
017 Sand in Taufers,57,,24,27,51
017 Sand in Taufers,58,,23,29,52
017 Sand in Taufers,59,,29,24,53
017 Sand in Taufers,60,,16,29,45
017 Sand in Taufers,61,,26,22,48
017 Sand in Taufers,62,,33,32,65
017 Sand in Taufers,63,,29,22,51
017 Sand in Taufers,64,,21,24,45
017 Sand in Taufers,65,,24,28,52
017 Sand in Taufers,66,,27,23,50
017 Sand in Taufers,67,,26,8,34
017 Sand in Taufers,68,,16,29,45
017 Sand in Taufers,69,,25,28,53
017 Sand in Taufers,70,,27,32,59
017 Sand in Taufers,71,,25,31,56
017 Sand in Taufers,72,,22,18,40
017 Sand in Taufers,73,,23,29,52
017 Sand in Taufers,74,,16,23,39
017 Sand in Taufers,75,,24,12,36
017 Sand in Taufers,76,,14,25,39
017 Sand in Taufers,77,,23,16,39
017 Sand in Taufers,78,,14,10,24
017 Sand in Taufers,79,,12,16,28
017 Sand in Taufers,80,,7,16,23
017 Sand in Taufers,81,,9,11,20
017 Sand in Taufers,82,,11,18,29
017 Sand in Taufers,83,,9,10,19
017 Sand in Taufers,84,,5,11,16
017 Sand in Taufers,85,,4,7,11
017 Sand in Taufers,86,,5,13,18
017 Sand in Taufers,87,,2,7,9
017 Sand in Taufers,88,,4,9,13
017 Sand in Taufers,89,,3,4,7
017 Sand in Taufers,90,,2,9,11
017 Sand in Taufers,91,,1,9,10
017 Sand in Taufers,92,,1,2,3
017 Sand in Taufers,93,,-,2,2
017 Sand in Taufers,94,,2,2,4
017 Sand in Taufers,95,,-,1,1
017 Sand in Taufers,97,,1,3,4
017 Sand in Taufers,98,,1,1,2
017 Sand in Taufers,99,,-,1,1
017 Sand in Taufers,101,,-,1,1
017 Sand in Taufers,Insgesamt,,2.654,2.683,5.337
018 Kastelbell-Tschars,0,,17,7,24
018 Kastelbell-Tschars,1,,14,12,26
018 Kastelbell-Tschars,2,,12,20,32
018 Kastelbell-Tschars,3,,9,9,18
018 Kastelbell-Tschars,4,,11,4,15
018 Kastelbell-Tschars,5,,12,9,21
018 Kastelbell-Tschars,6,,19,6,25
018 Kastelbell-Tschars,7,,10,8,18
018 Kastelbell-Tschars,8,,12,11,23
018 Kastelbell-Tschars,9,,11,9,20
018 Kastelbell-Tschars,10,,7,10,17
018 Kastelbell-Tschars,11,,14,15,29
018 Kastelbell-Tschars,12,,12,9,21
018 Kastelbell-Tschars,13,,25,12,37
018 Kastelbell-Tschars,14,,16,7,23
018 Kastelbell-Tschars,15,,10,11,21
018 Kastelbell-Tschars,16,,17,17,34
018 Kastelbell-Tschars,17,,15,10,25
018 Kastelbell-Tschars,18,,14,15,29
018 Kastelbell-Tschars,19,,14,15,29
018 Kastelbell-Tschars,20,,14,14,28
018 Kastelbell-Tschars,21,,15,14,29
018 Kastelbell-Tschars,22,,17,11,28
018 Kastelbell-Tschars,23,,17,9,26
018 Kastelbell-Tschars,24,,21,6,27
018 Kastelbell-Tschars,25,,20,17,37
018 Kastelbell-Tschars,26,,14,20,34
018 Kastelbell-Tschars,27,,24,16,40
018 Kastelbell-Tschars,28,,6,15,21
018 Kastelbell-Tschars,29,,17,18,35
018 Kastelbell-Tschars,30,,26,13,39
018 Kastelbell-Tschars,31,,15,14,29
018 Kastelbell-Tschars,32,,9,14,23
018 Kastelbell-Tschars,33,,13,15,28
018 Kastelbell-Tschars,34,,15,16,31
018 Kastelbell-Tschars,35,,11,15,26
018 Kastelbell-Tschars,36,,22,18,40
018 Kastelbell-Tschars,37,,15,11,26
018 Kastelbell-Tschars,38,,21,12,33
018 Kastelbell-Tschars,39,,14,25,39
018 Kastelbell-Tschars,40,,13,20,33
018 Kastelbell-Tschars,41,,17,16,33
018 Kastelbell-Tschars,42,,17,15,32
018 Kastelbell-Tschars,43,,24,26,50
018 Kastelbell-Tschars,44,,16,18,34
018 Kastelbell-Tschars,45,,15,21,36
018 Kastelbell-Tschars,46,,19,13,32
018 Kastelbell-Tschars,47,,19,12,31
018 Kastelbell-Tschars,48,,23,14,37
018 Kastelbell-Tschars,49,,24,21,45
018 Kastelbell-Tschars,50,,7,21,28
018 Kastelbell-Tschars,51,,20,17,37
018 Kastelbell-Tschars,52,,24,19,43
018 Kastelbell-Tschars,53,,22,20,42
018 Kastelbell-Tschars,54,,19,14,33
018 Kastelbell-Tschars,55,,16,9,25
018 Kastelbell-Tschars,56,,13,14,27
018 Kastelbell-Tschars,57,,21,18,39
018 Kastelbell-Tschars,58,,9,14,23
018 Kastelbell-Tschars,59,,9,16,25
018 Kastelbell-Tschars,60,,13,15,28
018 Kastelbell-Tschars,61,,15,13,28
018 Kastelbell-Tschars,62,,10,13,23
018 Kastelbell-Tschars,63,,17,10,27
018 Kastelbell-Tschars,64,,11,13,24
018 Kastelbell-Tschars,65,,9,8,17
018 Kastelbell-Tschars,66,,11,13,24
018 Kastelbell-Tschars,67,,11,4,15
018 Kastelbell-Tschars,68,,12,6,18
018 Kastelbell-Tschars,69,,7,7,14
018 Kastelbell-Tschars,70,,11,11,22
018 Kastelbell-Tschars,71,,9,8,17
018 Kastelbell-Tschars,72,,8,9,17
018 Kastelbell-Tschars,73,,11,11,22
018 Kastelbell-Tschars,74,,7,15,22
018 Kastelbell-Tschars,75,,11,11,22
018 Kastelbell-Tschars,76,,9,15,24
018 Kastelbell-Tschars,77,,8,8,16
018 Kastelbell-Tschars,78,,5,12,17
018 Kastelbell-Tschars,79,,14,12,26
018 Kastelbell-Tschars,80,,7,12,19
018 Kastelbell-Tschars,81,,8,10,18
018 Kastelbell-Tschars,82,,15,13,28
018 Kastelbell-Tschars,83,,8,10,18
018 Kastelbell-Tschars,84,,5,10,15
018 Kastelbell-Tschars,85,,4,5,9
018 Kastelbell-Tschars,86,,6,12,18
018 Kastelbell-Tschars,87,,8,6,14
018 Kastelbell-Tschars,88,,2,5,7
018 Kastelbell-Tschars,89,,1,5,6
018 Kastelbell-Tschars,90,,-,3,3
018 Kastelbell-Tschars,91,,1,2,3
018 Kastelbell-Tschars,92,,3,3,6
018 Kastelbell-Tschars,94,,-,1,1
018 Kastelbell-Tschars,95,,-,1,1
018 Kastelbell-Tschars,Insgesamt,,1.221,1.159,2.380
019 Kastelruth,0,,36,38,74
019 Kastelruth,1,,39,33,72
019 Kastelruth,2,,42,38,80
019 Kastelruth,3,,28,37,65
019 Kastelruth,4,,58,36,94
019 Kastelruth,5,,42,38,80
019 Kastelruth,6,,45,34,79
019 Kastelruth,7,,46,33,79
019 Kastelruth,8,,45,38,83
019 Kastelruth,9,,46,39,85
019 Kastelruth,10,,39,33,72
019 Kastelruth,11,,42,35,77
019 Kastelruth,12,,37,26,63
019 Kastelruth,13,,31,43,74
019 Kastelruth,14,,48,41,89
019 Kastelruth,15,,46,45,91
019 Kastelruth,16,,44,39,83
019 Kastelruth,17,,51,41,92
019 Kastelruth,18,,38,29,67
019 Kastelruth,19,,37,36,73
019 Kastelruth,20,,38,52,90
019 Kastelruth,21,,36,39,75
019 Kastelruth,22,,42,45,87
019 Kastelruth,23,,48,45,93
019 Kastelruth,24,,27,28,55
019 Kastelruth,25,,36,45,81
019 Kastelruth,26,,36,23,59
019 Kastelruth,27,,29,40,69
019 Kastelruth,28,,26,37,63
019 Kastelruth,29,,41,33,74
019 Kastelruth,30,,47,40,87
019 Kastelruth,31,,36,37,73
019 Kastelruth,32,,49,38,87
019 Kastelruth,33,,38,35,73
019 Kastelruth,34,,31,42,73
019 Kastelruth,35,,34,40,74
019 Kastelruth,36,,45,64,109
019 Kastelruth,37,,52,46,98
019 Kastelruth,38,,60,46,106
019 Kastelruth,39,,42,67,109
019 Kastelruth,40,,68,43,111
019 Kastelruth,41,,54,44,98
019 Kastelruth,42,,57,53,110
019 Kastelruth,43,,58,43,101
019 Kastelruth,44,,60,58,118
019 Kastelruth,45,,68,55,123
019 Kastelruth,46,,71,46,117
019 Kastelruth,47,,50,73,123
019 Kastelruth,48,,54,38,92
019 Kastelruth,49,,52,35,87
019 Kastelruth,50,,34,52,86
019 Kastelruth,51,,54,41,95
019 Kastelruth,52,,48,38,86
019 Kastelruth,53,,45,44,89
019 Kastelruth,54,,48,42,90
019 Kastelruth,55,,38,41,79
019 Kastelruth,56,,38,32,70
019 Kastelruth,57,,40,39,79
019 Kastelruth,58,,36,32,68
019 Kastelruth,59,,29,29,58
019 Kastelruth,60,,35,25,60
019 Kastelruth,61,,29,23,52
019 Kastelruth,62,,44,26,70
019 Kastelruth,63,,18,34,52
019 Kastelruth,64,,28,42,70
019 Kastelruth,65,,32,32,64
019 Kastelruth,66,,23,37,60
019 Kastelruth,67,,22,21,43
019 Kastelruth,68,,22,44,66
019 Kastelruth,69,,36,39,75
019 Kastelruth,70,,33,26,59
019 Kastelruth,71,,28,44,72
019 Kastelruth,72,,24,34,58
019 Kastelruth,73,,26,28,54
019 Kastelruth,74,,22,25,47
019 Kastelruth,75,,25,23,48
019 Kastelruth,76,,27,16,43
019 Kastelruth,77,,23,25,48
019 Kastelruth,78,,18,21,39
019 Kastelruth,79,,29,28,57
019 Kastelruth,80,,14,34,48
019 Kastelruth,81,,32,20,52
019 Kastelruth,82,,7,23,30
019 Kastelruth,83,,15,21,36
019 Kastelruth,84,,8,12,20
019 Kastelruth,85,,13,24,37
019 Kastelruth,86,,9,14,23
019 Kastelruth,87,,9,13,22
019 Kastelruth,88,,7,13,20
019 Kastelruth,89,,4,12,16
019 Kastelruth,90,,5,8,13
019 Kastelruth,91,,4,9,13
019 Kastelruth,92,,1,6,7
019 Kastelruth,93,,1,1,2
019 Kastelruth,94,,1,-,1
019 Kastelruth,95,,-,1,1
019 Kastelruth,96,,-,1,1
019 Kastelruth,97,,-,2,2
019 Kastelruth,98,,-,1,1
019 Kastelruth,101,,-,1,1
019 Kastelruth,Insgesamt,,3.309,3.261,6.570
020 Tscherms,0,,7,9,16
020 Tscherms,1,,19,3,22
020 Tscherms,2,,9,6,15
020 Tscherms,3,,5,6,11
020 Tscherms,4,,7,12,19
020 Tscherms,5,,7,10,17
020 Tscherms,6,,6,6,12
020 Tscherms,7,,3,10,13
020 Tscherms,8,,7,7,14
020 Tscherms,9,,8,8,16
020 Tscherms,10,,8,8,16
020 Tscherms,11,,5,9,14
020 Tscherms,12,,9,8,17
020 Tscherms,13,,8,8,16
020 Tscherms,14,,4,8,12
020 Tscherms,15,,10,8,18
020 Tscherms,16,,8,3,11
020 Tscherms,17,,12,10,22
020 Tscherms,18,,9,18,27
020 Tscherms,19,,7,10,17
020 Tscherms,20,,11,9,20
020 Tscherms,21,,6,8,14
020 Tscherms,22,,8,6,14
020 Tscherms,23,,5,6,11
020 Tscherms,24,,5,17,22
020 Tscherms,25,,6,8,14
020 Tscherms,26,,11,4,15
020 Tscherms,27,,12,13,25
020 Tscherms,28,,15,9,24
020 Tscherms,29,,13,13,26
020 Tscherms,30,,7,8,15
020 Tscherms,31,,11,12,23
020 Tscherms,32,,9,14,23
020 Tscherms,33,,6,6,12
020 Tscherms,34,,7,10,17
020 Tscherms,35,,11,6,17
020 Tscherms,36,,7,10,17
020 Tscherms,37,,13,8,21
020 Tscherms,38,,11,8,19
020 Tscherms,39,,10,14,24
020 Tscherms,40,,10,11,21
020 Tscherms,41,,10,12,22
020 Tscherms,42,,12,7,19
020 Tscherms,43,,10,15,25
020 Tscherms,44,,12,7,19
020 Tscherms,45,,12,11,23
020 Tscherms,46,,17,7,24
020 Tscherms,47,,16,17,33
020 Tscherms,48,,16,17,33
020 Tscherms,49,,15,15,30
020 Tscherms,50,,17,16,33
020 Tscherms,51,,13,10,23
020 Tscherms,52,,9,16,25
020 Tscherms,53,,6,18,24
020 Tscherms,54,,9,7,16
020 Tscherms,55,,8,11,19
020 Tscherms,56,,9,6,15
020 Tscherms,57,,9,7,16
020 Tscherms,58,,7,9,16
020 Tscherms,59,,10,10,20
020 Tscherms,60,,12,6,18
020 Tscherms,61,,5,9,14
020 Tscherms,62,,10,6,16
020 Tscherms,63,,3,3,6
020 Tscherms,64,,6,5,11
020 Tscherms,65,,7,8,15
020 Tscherms,66,,5,8,13
020 Tscherms,67,,4,6,10
020 Tscherms,68,,5,8,13
020 Tscherms,69,,5,3,8
020 Tscherms,70,,8,4,12
020 Tscherms,71,,10,9,19
020 Tscherms,72,,5,4,9
020 Tscherms,73,,6,6,12
020 Tscherms,74,,6,3,9
020 Tscherms,75,,6,8,14
020 Tscherms,76,,6,7,13
020 Tscherms,77,,3,3,6
020 Tscherms,78,,2,9,11
020 Tscherms,79,,4,3,7
020 Tscherms,80,,5,4,9
020 Tscherms,81,,2,3,5
020 Tscherms,82,,3,5,8
020 Tscherms,83,,1,2,3
020 Tscherms,84,,4,3,7
020 Tscherms,85,,3,3,6
020 Tscherms,86,,1,1,2
020 Tscherms,87,,3,5,8
020 Tscherms,88,,3,4,7
020 Tscherms,89,,-,2,2
020 Tscherms,90,,-,5,5
020 Tscherms,91,,-,1,1
020 Tscherms,92,,1,-,1
020 Tscherms,93,,-,1,1
020 Tscherms,94,,-,1,1
020 Tscherms,98,,-,1,1
020 Tscherms,Insgesamt,,713,744,1.457
021 Kiens,0,,16,22,38
021 Kiens,1,,12,10,22
021 Kiens,2,,16,13,29
021 Kiens,3,,10,20,30
021 Kiens,4,,13,9,22
021 Kiens,5,,14,11,25
021 Kiens,6,,15,7,22
021 Kiens,7,,16,18,34
021 Kiens,8,,15,11,26
021 Kiens,9,,13,19,32
021 Kiens,10,,9,15,24
021 Kiens,11,,19,21,40
021 Kiens,12,,9,22,31
021 Kiens,13,,15,18,33
021 Kiens,14,,21,9,30
021 Kiens,15,,16,14,30
021 Kiens,16,,15,18,33
021 Kiens,17,,13,21,34
021 Kiens,18,,19,17,36
021 Kiens,19,,17,19,36
021 Kiens,20,,26,18,44
021 Kiens,21,,13,26,39
021 Kiens,22,,13,22,35
021 Kiens,23,,13,21,34
021 Kiens,24,,15,17,32
021 Kiens,25,,12,14,26
021 Kiens,26,,18,12,30
021 Kiens,27,,20,12,32
021 Kiens,28,,17,11,28
021 Kiens,29,,16,19,35
021 Kiens,30,,22,17,39
021 Kiens,31,,13,16,29
021 Kiens,32,,21,16,37
021 Kiens,33,,12,16,28
021 Kiens,34,,30,17,47
021 Kiens,35,,18,14,32
021 Kiens,36,,21,23,44
021 Kiens,37,,18,21,39
021 Kiens,38,,23,19,42
021 Kiens,39,,31,23,54
021 Kiens,40,,22,17,39
021 Kiens,41,,25,23,48
021 Kiens,42,,24,28,52
021 Kiens,43,,32,24,56
021 Kiens,44,,37,20,57
021 Kiens,45,,21,24,45
021 Kiens,46,,30,25,55
021 Kiens,47,,21,23,44
021 Kiens,48,,32,23,55
021 Kiens,49,,18,23,41
021 Kiens,50,,30,20,50
021 Kiens,51,,20,24,44
021 Kiens,52,,22,17,39
021 Kiens,53,,24,17,41
021 Kiens,54,,15,13,28
021 Kiens,55,,12,16,28
021 Kiens,56,,19,16,35
021 Kiens,57,,14,8,22
021 Kiens,58,,11,15,26
021 Kiens,59,,15,23,38
021 Kiens,60,,11,9,20
021 Kiens,61,,13,10,23
021 Kiens,62,,15,10,25
021 Kiens,63,,10,13,23
021 Kiens,64,,14,18,32
021 Kiens,65,,12,15,27
021 Kiens,66,,21,14,35
021 Kiens,67,,8,11,19
021 Kiens,68,,8,12,20
021 Kiens,69,,18,9,27
021 Kiens,70,,15,9,24
021 Kiens,71,,15,11,26
021 Kiens,72,,10,16,26
021 Kiens,73,,11,9,20
021 Kiens,74,,9,12,21
021 Kiens,75,,10,11,21
021 Kiens,76,,8,9,17
021 Kiens,77,,3,15,18
021 Kiens,78,,7,9,16
021 Kiens,79,,9,8,17
021 Kiens,80,,11,8,19
021 Kiens,81,,11,7,18
021 Kiens,82,,6,10,16
021 Kiens,83,,2,7,9
021 Kiens,84,,1,3,4
021 Kiens,85,,2,4,6
021 Kiens,86,,-,4,4
021 Kiens,87,,2,3,5
021 Kiens,88,,1,5,6
021 Kiens,89,,2,2,4
021 Kiens,90,,2,1,3
021 Kiens,91,,-,2,2
021 Kiens,92,,1,1,2
021 Kiens,98,,-,1,1
021 Kiens,99,,-,1,1
021 Kiens,Insgesamt,,1.377,1.356,2.733
022 Klausen,0,,43,29,72
022 Klausen,1,,33,30,63
022 Klausen,2,,20,35,55
022 Klausen,3,,28,19,47
022 Klausen,4,,23,25,48
022 Klausen,5,,28,28,56
022 Klausen,6,,42,41,83
022 Klausen,7,,36,33,69
022 Klausen,8,,40,36,76
022 Klausen,9,,28,28,56
022 Klausen,10,,41,29,70
022 Klausen,11,,32,29,61
022 Klausen,12,,29,33,62
022 Klausen,13,,27,31,58
022 Klausen,14,,25,29,54
022 Klausen,15,,39,34,73
022 Klausen,16,,30,26,56
022 Klausen,17,,32,27,59
022 Klausen,18,,16,35,51
022 Klausen,19,,35,26,61
022 Klausen,20,,40,25,65
022 Klausen,21,,36,37,73
022 Klausen,22,,42,28,70
022 Klausen,23,,27,30,57
022 Klausen,24,,32,37,69
022 Klausen,25,,30,31,61
022 Klausen,26,,36,27,63
022 Klausen,27,,40,39,79
022 Klausen,28,,31,27,58
022 Klausen,29,,27,34,61
022 Klausen,30,,40,42,82
022 Klausen,31,,40,29,69
022 Klausen,32,,33,43,76
022 Klausen,33,,28,27,55
022 Klausen,34,,40,37,77
022 Klausen,35,,30,27,57
022 Klausen,36,,36,29,65
022 Klausen,37,,37,45,82
022 Klausen,38,,39,33,72
022 Klausen,39,,43,31,74
022 Klausen,40,,37,42,79
022 Klausen,41,,36,45,81
022 Klausen,42,,39,42,81
022 Klausen,43,,48,46,94
022 Klausen,44,,47,46,93
022 Klausen,45,,51,43,94
022 Klausen,46,,64,43,107
022 Klausen,47,,41,48,89
022 Klausen,48,,46,47,93
022 Klausen,49,,39,39,78
022 Klausen,50,,35,40,75
022 Klausen,51,,51,45,96
022 Klausen,52,,38,26,64
022 Klausen,53,,34,40,74
022 Klausen,54,,30,29,59
022 Klausen,55,,33,24,57
022 Klausen,56,,29,24,53
022 Klausen,57,,26,31,57
022 Klausen,58,,31,40,71
022 Klausen,59,,20,30,50
022 Klausen,60,,28,17,45
022 Klausen,61,,33,25,58
022 Klausen,62,,28,22,50
022 Klausen,63,,31,25,56
022 Klausen,64,,28,28,56
022 Klausen,65,,24,20,44
022 Klausen,66,,30,23,53
022 Klausen,67,,12,17,29
022 Klausen,68,,23,17,40
022 Klausen,69,,17,29,46
022 Klausen,70,,21,24,45
022 Klausen,71,,26,18,44
022 Klausen,72,,17,22,39
022 Klausen,73,,21,19,40
022 Klausen,74,,14,20,34
022 Klausen,75,,16,17,33
022 Klausen,76,,15,21,36
022 Klausen,77,,10,17,27
022 Klausen,78,,15,13,28
022 Klausen,79,,19,15,34
022 Klausen,80,,9,18,27
022 Klausen,81,,11,12,23
022 Klausen,82,,9,14,23
022 Klausen,83,,13,15,28
022 Klausen,84,,3,15,18
022 Klausen,85,,3,14,17
022 Klausen,86,,5,6,11
022 Klausen,87,,4,5,9
022 Klausen,88,,4,10,14
022 Klausen,89,,2,6,8
022 Klausen,90,,2,4,6
022 Klausen,91,,-,4,4
022 Klausen,92,,-,4,4
022 Klausen,93,,1,4,5
022 Klausen,94,,1,2,3
022 Klausen,95,,1,4,5
022 Klausen,99,,-,1,1
022 Klausen,Insgesamt,,2.605,2.578,5.183
023 Karneid,0,,17,21,38
023 Karneid,1,,26,17,43
023 Karneid,2,,12,17,29
023 Karneid,3,,15,16,31
023 Karneid,4,,29,17,46
023 Karneid,5,,24,22,46
023 Karneid,6,,21,15,36
023 Karneid,7,,24,20,44
023 Karneid,8,,20,24,44
023 Karneid,9,,29,17,46
023 Karneid,10,,17,12,29
023 Karneid,11,,20,20,40
023 Karneid,12,,15,20,35
023 Karneid,13,,25,24,49
023 Karneid,14,,18,19,37
023 Karneid,15,,27,19,46
023 Karneid,16,,19,24,43
023 Karneid,17,,27,20,47
023 Karneid,18,,22,21,43
023 Karneid,19,,23,19,42
023 Karneid,20,,23,18,41
023 Karneid,21,,16,20,36
023 Karneid,22,,22,16,38
023 Karneid,23,,15,18,33
023 Karneid,24,,15,17,32
023 Karneid,25,,15,23,38
023 Karneid,26,,20,20,40
023 Karneid,27,,22,15,37
023 Karneid,28,,25,20,45
023 Karneid,29,,17,17,34
023 Karneid,30,,20,17,37
023 Karneid,31,,32,28,60
023 Karneid,32,,23,18,41
023 Karneid,33,,27,26,53
023 Karneid,34,,22,14,36
023 Karneid,35,,19,23,42
023 Karneid,36,,28,27,55
023 Karneid,37,,23,16,39
023 Karneid,38,,26,26,52
023 Karneid,39,,30,29,59
023 Karneid,40,,31,26,57
023 Karneid,41,,32,36,68
023 Karneid,42,,34,24,58
023 Karneid,43,,25,29,54
023 Karneid,44,,37,33,70
023 Karneid,45,,32,31,63
023 Karneid,46,,34,33,67
023 Karneid,47,,30,25,55
023 Karneid,48,,36,25,61
023 Karneid,49,,37,22,59
023 Karneid,50,,28,40,68
023 Karneid,51,,28,23,51
023 Karneid,52,,30,26,56
023 Karneid,53,,27,16,43
023 Karneid,54,,24,18,42
023 Karneid,55,,16,12,28
023 Karneid,56,,20,18,38
023 Karneid,57,,15,11,26
023 Karneid,58,,14,13,27
023 Karneid,59,,16,13,29
023 Karneid,60,,11,21,32
023 Karneid,61,,16,11,27
023 Karneid,62,,21,14,35
023 Karneid,63,,10,14,24
023 Karneid,64,,14,25,39
023 Karneid,65,,9,15,24
023 Karneid,66,,12,21,33
023 Karneid,67,,12,14,26
023 Karneid,68,,11,14,25
023 Karneid,69,,19,15,34
023 Karneid,70,,16,25,41
023 Karneid,71,,18,14,32
023 Karneid,72,,11,14,25
023 Karneid,73,,16,14,30
023 Karneid,74,,18,12,30
023 Karneid,75,,8,8,16
023 Karneid,76,,12,11,23
023 Karneid,77,,9,8,17
023 Karneid,78,,9,14,23
023 Karneid,79,,6,13,19
023 Karneid,80,,12,5,17
023 Karneid,81,,11,11,22
023 Karneid,82,,6,7,13
023 Karneid,83,,7,7,14
023 Karneid,84,,7,6,13
023 Karneid,85,,2,7,9
023 Karneid,86,,4,6,10
023 Karneid,87,,1,5,6
023 Karneid,88,,3,2,5
023 Karneid,89,,1,1,2
023 Karneid,90,,-,4,4
023 Karneid,91,,-,3,3
023 Karneid,92,,1,3,4
023 Karneid,93,,2,1,3
023 Karneid,94,,-,1,1
023 Karneid,100,,-,1,1
023 Karneid,Insgesamt,,1.731,1.633,3.364
024 Kurtatsch a.d.Weinstr.,0,,14,10,24
024 Kurtatsch a.d.Weinstr.,1,,8,10,18
024 Kurtatsch a.d.Weinstr.,2,,6,10,16
024 Kurtatsch a.d.Weinstr.,3,,8,10,18
024 Kurtatsch a.d.Weinstr.,4,,15,7,22
024 Kurtatsch a.d.Weinstr.,5,,6,4,10
024 Kurtatsch a.d.Weinstr.,6,,8,15,23
024 Kurtatsch a.d.Weinstr.,7,,13,15,28
024 Kurtatsch a.d.Weinstr.,8,,12,10,22
024 Kurtatsch a.d.Weinstr.,9,,11,12,23
024 Kurtatsch a.d.Weinstr.,10,,12,17,29
024 Kurtatsch a.d.Weinstr.,11,,16,10,26
024 Kurtatsch a.d.Weinstr.,12,,18,14,32
024 Kurtatsch a.d.Weinstr.,13,,18,12,30
024 Kurtatsch a.d.Weinstr.,14,,17,14,31
024 Kurtatsch a.d.Weinstr.,15,,13,14,27
024 Kurtatsch a.d.Weinstr.,16,,23,19,42
024 Kurtatsch a.d.Weinstr.,17,,18,11,29
024 Kurtatsch a.d.Weinstr.,18,,13,7,20
024 Kurtatsch a.d.Weinstr.,19,,23,17,40
024 Kurtatsch a.d.Weinstr.,20,,20,11,31
024 Kurtatsch a.d.Weinstr.,21,,17,16,33
024 Kurtatsch a.d.Weinstr.,22,,11,8,19
024 Kurtatsch a.d.Weinstr.,23,,10,16,26
024 Kurtatsch a.d.Weinstr.,24,,7,13,20
024 Kurtatsch a.d.Weinstr.,25,,12,13,25
024 Kurtatsch a.d.Weinstr.,26,,8,12,20
024 Kurtatsch a.d.Weinstr.,27,,15,10,25
024 Kurtatsch a.d.Weinstr.,28,,13,7,20
024 Kurtatsch a.d.Weinstr.,29,,15,4,19
024 Kurtatsch a.d.Weinstr.,30,,12,16,28
024 Kurtatsch a.d.Weinstr.,31,,13,14,27
024 Kurtatsch a.d.Weinstr.,32,,10,12,22
024 Kurtatsch a.d.Weinstr.,33,,10,14,24
024 Kurtatsch a.d.Weinstr.,34,,8,13,21
024 Kurtatsch a.d.Weinstr.,35,,7,17,24
024 Kurtatsch a.d.Weinstr.,36,,11,13,24
024 Kurtatsch a.d.Weinstr.,37,,11,11,22
024 Kurtatsch a.d.Weinstr.,38,,12,19,31
024 Kurtatsch a.d.Weinstr.,39,,16,18,34
024 Kurtatsch a.d.Weinstr.,40,,12,14,26
024 Kurtatsch a.d.Weinstr.,41,,17,20,37
024 Kurtatsch a.d.Weinstr.,42,,16,23,39
024 Kurtatsch a.d.Weinstr.,43,,25,25,50
024 Kurtatsch a.d.Weinstr.,44,,29,13,42
024 Kurtatsch a.d.Weinstr.,45,,17,21,38
024 Kurtatsch a.d.Weinstr.,46,,27,17,44
024 Kurtatsch a.d.Weinstr.,47,,25,27,52
024 Kurtatsch a.d.Weinstr.,48,,17,24,41
024 Kurtatsch a.d.Weinstr.,49,,23,20,43
024 Kurtatsch a.d.Weinstr.,50,,24,13,37
024 Kurtatsch a.d.Weinstr.,51,,18,15,33
024 Kurtatsch a.d.Weinstr.,52,,17,21,38
024 Kurtatsch a.d.Weinstr.,53,,19,9,28
024 Kurtatsch a.d.Weinstr.,54,,13,15,28
024 Kurtatsch a.d.Weinstr.,55,,12,11,23
024 Kurtatsch a.d.Weinstr.,56,,12,8,20
024 Kurtatsch a.d.Weinstr.,57,,13,20,33
024 Kurtatsch a.d.Weinstr.,58,,14,7,21
024 Kurtatsch a.d.Weinstr.,59,,16,19,35
024 Kurtatsch a.d.Weinstr.,60,,10,8,18
024 Kurtatsch a.d.Weinstr.,61,,9,13,22
024 Kurtatsch a.d.Weinstr.,62,,13,4,17
024 Kurtatsch a.d.Weinstr.,63,,11,9,20
024 Kurtatsch a.d.Weinstr.,64,,10,10,20
024 Kurtatsch a.d.Weinstr.,65,,10,8,18
024 Kurtatsch a.d.Weinstr.,66,,12,9,21
024 Kurtatsch a.d.Weinstr.,67,,7,8,15
024 Kurtatsch a.d.Weinstr.,68,,5,7,12
024 Kurtatsch a.d.Weinstr.,69,,9,6,15
024 Kurtatsch a.d.Weinstr.,70,,9,11,20
024 Kurtatsch a.d.Weinstr.,71,,8,11,19
024 Kurtatsch a.d.Weinstr.,72,,10,11,21
024 Kurtatsch a.d.Weinstr.,73,,3,16,19
024 Kurtatsch a.d.Weinstr.,74,,10,12,22
024 Kurtatsch a.d.Weinstr.,75,,4,9,13
024 Kurtatsch a.d.Weinstr.,76,,8,8,16
024 Kurtatsch a.d.Weinstr.,77,,3,7,10
024 Kurtatsch a.d.Weinstr.,78,,3,8,11
024 Kurtatsch a.d.Weinstr.,79,,7,6,13
024 Kurtatsch a.d.Weinstr.,80,,10,15,25
024 Kurtatsch a.d.Weinstr.,81,,6,9,15
024 Kurtatsch a.d.Weinstr.,82,,5,14,19
024 Kurtatsch a.d.Weinstr.,83,,6,6,12
024 Kurtatsch a.d.Weinstr.,84,,6,7,13
024 Kurtatsch a.d.Weinstr.,85,,6,3,9
024 Kurtatsch a.d.Weinstr.,86,,2,2,4
024 Kurtatsch a.d.Weinstr.,87,,3,6,9
024 Kurtatsch a.d.Weinstr.,88,,2,6,8
024 Kurtatsch a.d.Weinstr.,89,,4,9,13
024 Kurtatsch a.d.Weinstr.,90,,-,2,2
024 Kurtatsch a.d.Weinstr.,91,,-,4,4
024 Kurtatsch a.d.Weinstr.,92,,3,3,6
024 Kurtatsch a.d.Weinstr.,95,,-,1,1
024 Kurtatsch a.d.Weinstr.,97,,1,-,1
024 Kurtatsch a.d.Weinstr.,100,,1,-,1
024 Kurtatsch a.d.Weinstr.,101,,-,1,1
024 Kurtatsch a.d.Weinstr.,Insgesamt,,1.092,1.106,2.198
025 Kurtinig a.d. Weinstr.,0,,3,5,8
025 Kurtinig a.d. Weinstr.,1,,4,4,8
025 Kurtinig a.d. Weinstr.,2,,5,5,10
025 Kurtinig a.d. Weinstr.,3,,6,2,8
025 Kurtinig a.d. Weinstr.,4,,4,-,4
025 Kurtinig a.d. Weinstr.,5,,5,2,7
025 Kurtinig a.d. Weinstr.,6,,3,1,4
025 Kurtinig a.d. Weinstr.,7,,-,3,3
025 Kurtinig a.d. Weinstr.,8,,1,2,3
025 Kurtinig a.d. Weinstr.,9,,5,2,7
025 Kurtinig a.d. Weinstr.,10,,3,4,7
025 Kurtinig a.d. Weinstr.,11,,1,8,9
025 Kurtinig a.d. Weinstr.,12,,3,5,8
025 Kurtinig a.d. Weinstr.,13,,3,2,5
025 Kurtinig a.d. Weinstr.,14,,3,5,8
025 Kurtinig a.d. Weinstr.,15,,3,5,8
025 Kurtinig a.d. Weinstr.,16,,1,2,3
025 Kurtinig a.d. Weinstr.,17,,6,3,9
025 Kurtinig a.d. Weinstr.,18,,3,2,5
025 Kurtinig a.d. Weinstr.,19,,4,4,8
025 Kurtinig a.d. Weinstr.,20,,2,4,6
025 Kurtinig a.d. Weinstr.,21,,7,1,8
025 Kurtinig a.d. Weinstr.,22,,2,2,4
025 Kurtinig a.d. Weinstr.,23,,6,3,9
025 Kurtinig a.d. Weinstr.,24,,5,4,9
025 Kurtinig a.d. Weinstr.,25,,8,7,15
025 Kurtinig a.d. Weinstr.,26,,6,4,10
025 Kurtinig a.d. Weinstr.,27,,3,2,5
025 Kurtinig a.d. Weinstr.,28,,3,4,7
025 Kurtinig a.d. Weinstr.,29,,6,1,7
025 Kurtinig a.d. Weinstr.,30,,6,6,12
025 Kurtinig a.d. Weinstr.,31,,7,4,11
025 Kurtinig a.d. Weinstr.,32,,7,6,13
025 Kurtinig a.d. Weinstr.,33,,5,7,12
025 Kurtinig a.d. Weinstr.,34,,5,3,8
025 Kurtinig a.d. Weinstr.,35,,2,3,5
025 Kurtinig a.d. Weinstr.,36,,1,-,1
025 Kurtinig a.d. Weinstr.,37,,2,7,9
025 Kurtinig a.d. Weinstr.,38,,4,4,8
025 Kurtinig a.d. Weinstr.,39,,7,5,12
025 Kurtinig a.d. Weinstr.,40,,2,7,9
025 Kurtinig a.d. Weinstr.,41,,3,3,6
025 Kurtinig a.d. Weinstr.,42,,6,4,10
025 Kurtinig a.d. Weinstr.,43,,6,5,11
025 Kurtinig a.d. Weinstr.,44,,4,3,7
025 Kurtinig a.d. Weinstr.,45,,6,4,10
025 Kurtinig a.d. Weinstr.,46,,2,5,7
025 Kurtinig a.d. Weinstr.,47,,4,4,8
025 Kurtinig a.d. Weinstr.,48,,6,5,11
025 Kurtinig a.d. Weinstr.,49,,9,5,14
025 Kurtinig a.d. Weinstr.,50,,4,4,8
025 Kurtinig a.d. Weinstr.,51,,7,10,17
025 Kurtinig a.d. Weinstr.,52,,6,4,10
025 Kurtinig a.d. Weinstr.,53,,11,6,17
025 Kurtinig a.d. Weinstr.,54,,3,8,11
025 Kurtinig a.d. Weinstr.,55,,7,9,16
025 Kurtinig a.d. Weinstr.,56,,5,1,6
025 Kurtinig a.d. Weinstr.,57,,2,1,3
025 Kurtinig a.d. Weinstr.,58,,7,3,10
025 Kurtinig a.d. Weinstr.,59,,4,7,11
025 Kurtinig a.d. Weinstr.,60,,2,4,6
025 Kurtinig a.d. Weinstr.,61,,2,5,7
025 Kurtinig a.d. Weinstr.,62,,1,3,4
025 Kurtinig a.d. Weinstr.,63,,3,3,6
025 Kurtinig a.d. Weinstr.,64,,4,3,7
025 Kurtinig a.d. Weinstr.,65,,5,2,7
025 Kurtinig a.d. Weinstr.,66,,-,5,5
025 Kurtinig a.d. Weinstr.,67,,3,3,6
025 Kurtinig a.d. Weinstr.,68,,3,2,5
025 Kurtinig a.d. Weinstr.,69,,4,2,6
025 Kurtinig a.d. Weinstr.,70,,2,2,4
025 Kurtinig a.d. Weinstr.,71,,4,2,6
025 Kurtinig a.d. Weinstr.,72,,2,2,4
025 Kurtinig a.d. Weinstr.,73,,5,3,8
025 Kurtinig a.d. Weinstr.,74,,2,2,4
025 Kurtinig a.d. Weinstr.,75,,2,3,5
025 Kurtinig a.d. Weinstr.,76,,4,3,7
025 Kurtinig a.d. Weinstr.,77,,-,5,5
025 Kurtinig a.d. Weinstr.,78,,2,4,6
025 Kurtinig a.d. Weinstr.,79,,-,2,2
025 Kurtinig a.d. Weinstr.,80,,3,3,6
025 Kurtinig a.d. Weinstr.,81,,1,2,3
025 Kurtinig a.d. Weinstr.,82,,2,3,5
025 Kurtinig a.d. Weinstr.,83,,1,2,3
025 Kurtinig a.d. Weinstr.,84,,1,3,4
025 Kurtinig a.d. Weinstr.,85,,2,1,3
025 Kurtinig a.d. Weinstr.,86,,1,-,1
025 Kurtinig a.d. Weinstr.,87,,-,4,4
025 Kurtinig a.d. Weinstr.,88,,-,2,2
025 Kurtinig a.d. Weinstr.,89,,-,1,1
025 Kurtinig a.d. Weinstr.,91,,1,1,2
025 Kurtinig a.d. Weinstr.,94,,-,1,1
025 Kurtinig a.d. Weinstr.,97,,-,1,1
025 Kurtinig a.d. Weinstr.,98,,-,1,1
025 Kurtinig a.d. Weinstr.,Insgesamt,,326,326,652
026 Corvara,0,,7,7,14
026 Corvara,1,,7,5,12
026 Corvara,2,,12,8,20
026 Corvara,3,,9,8,17
026 Corvara,4,,7,7,14
026 Corvara,5,,5,9,14
026 Corvara,6,,8,3,11
026 Corvara,7,,7,7,14
026 Corvara,8,,6,3,9
026 Corvara,9,,12,5,17
026 Corvara,10,,5,3,8
026 Corvara,11,,5,7,12
026 Corvara,12,,8,5,13
026 Corvara,13,,8,7,15
026 Corvara,14,,10,9,19
026 Corvara,15,,3,5,8
026 Corvara,16,,10,4,14
026 Corvara,17,,8,7,15
026 Corvara,18,,8,5,13
026 Corvara,19,,5,3,8
026 Corvara,20,,6,10,16
026 Corvara,21,,5,5,10
026 Corvara,22,,11,9,20
026 Corvara,23,,6,5,11
026 Corvara,24,,5,3,8
026 Corvara,25,,9,7,16
026 Corvara,26,,4,1,5
026 Corvara,27,,6,8,14
026 Corvara,28,,6,5,11
026 Corvara,29,,7,9,16
026 Corvara,30,,11,13,24
026 Corvara,31,,14,3,17
026 Corvara,32,,10,9,19
026 Corvara,33,,10,8,18
026 Corvara,34,,11,4,15
026 Corvara,35,,16,8,24
026 Corvara,36,,12,6,18
026 Corvara,37,,9,25,34
026 Corvara,38,,6,14,20
026 Corvara,39,,10,13,23
026 Corvara,40,,9,8,17
026 Corvara,41,,13,6,19
026 Corvara,42,,10,14,24
026 Corvara,43,,16,13,29
026 Corvara,44,,8,16,24
026 Corvara,45,,15,21,36
026 Corvara,46,,11,16,27
026 Corvara,47,,16,17,33
026 Corvara,48,,8,8,16
026 Corvara,49,,15,9,24
026 Corvara,50,,12,11,23
026 Corvara,51,,8,8,16
026 Corvara,52,,15,14,29
026 Corvara,53,,7,7,14
026 Corvara,54,,11,8,19
026 Corvara,55,,8,4,12
026 Corvara,56,,5,7,12
026 Corvara,57,,11,7,18
026 Corvara,58,,9,9,18
026 Corvara,59,,6,12,18
026 Corvara,60,,4,8,12
026 Corvara,61,,5,9,14
026 Corvara,62,,7,8,15
026 Corvara,63,,3,9,12
026 Corvara,64,,4,5,9
026 Corvara,65,,4,10,14
026 Corvara,66,,12,10,22
026 Corvara,67,,5,4,9
026 Corvara,68,,6,8,14
026 Corvara,69,,5,10,15
026 Corvara,70,,6,8,14
026 Corvara,71,,10,10,20
026 Corvara,72,,8,6,14
026 Corvara,73,,6,5,11
026 Corvara,74,,3,7,10
026 Corvara,75,,6,9,15
026 Corvara,76,,4,6,10
026 Corvara,77,,6,4,10
026 Corvara,78,,3,10,13
026 Corvara,79,,3,3,6
026 Corvara,80,,4,5,9
026 Corvara,81,,3,9,12
026 Corvara,82,,2,3,5
026 Corvara,83,,3,4,7
026 Corvara,84,,1,1,2
026 Corvara,85,,4,2,6
026 Corvara,86,,2,1,3
026 Corvara,87,,1,2,3
026 Corvara,88,,1,-,1
026 Corvara,89,,3,1,4
026 Corvara,90,,1,2,3
026 Corvara,91,,1,-,1
026 Corvara,92,,1,-,1
026 Corvara,93,,1,1,2
026 Corvara,94,,-,1,1
026 Corvara,98,,-,1,1
026 Corvara,Insgesamt,,675,679,1.354
027 Graun im Vinschgau,0,,11,19,30
027 Graun im Vinschgau,1,,18,13,31
027 Graun im Vinschgau,2,,10,11,21
027 Graun im Vinschgau,3,,19,19,38
027 Graun im Vinschgau,4,,14,7,21
027 Graun im Vinschgau,5,,20,14,34
027 Graun im Vinschgau,6,,15,20,35
027 Graun im Vinschgau,7,,13,14,27
027 Graun im Vinschgau,8,,12,15,27
027 Graun im Vinschgau,9,,10,11,21
027 Graun im Vinschgau,10,,11,11,22
027 Graun im Vinschgau,11,,16,12,28
027 Graun im Vinschgau,12,,14,17,31
027 Graun im Vinschgau,13,,15,9,24
027 Graun im Vinschgau,14,,10,15,25
027 Graun im Vinschgau,15,,19,17,36
027 Graun im Vinschgau,16,,22,15,37
027 Graun im Vinschgau,17,,18,16,34
027 Graun im Vinschgau,18,,19,12,31
027 Graun im Vinschgau,19,,20,15,35
027 Graun im Vinschgau,20,,18,14,32
027 Graun im Vinschgau,21,,8,12,20
027 Graun im Vinschgau,22,,18,18,36
027 Graun im Vinschgau,23,,28,19,47
027 Graun im Vinschgau,24,,21,12,33
027 Graun im Vinschgau,25,,18,8,26
027 Graun im Vinschgau,26,,7,5,12
027 Graun im Vinschgau,27,,19,7,26
027 Graun im Vinschgau,28,,17,12,29
027 Graun im Vinschgau,29,,9,14,23
027 Graun im Vinschgau,30,,16,12,28
027 Graun im Vinschgau,31,,21,20,41
027 Graun im Vinschgau,32,,18,16,34
027 Graun im Vinschgau,33,,15,18,33
027 Graun im Vinschgau,34,,14,17,31
027 Graun im Vinschgau,35,,14,20,34
027 Graun im Vinschgau,36,,11,19,30
027 Graun im Vinschgau,37,,21,17,38
027 Graun im Vinschgau,38,,20,14,34
027 Graun im Vinschgau,39,,18,19,37
027 Graun im Vinschgau,40,,22,17,39
027 Graun im Vinschgau,41,,20,12,32
027 Graun im Vinschgau,42,,21,16,37
027 Graun im Vinschgau,43,,25,18,43
027 Graun im Vinschgau,44,,15,21,36
027 Graun im Vinschgau,45,,23,21,44
027 Graun im Vinschgau,46,,17,23,40
027 Graun im Vinschgau,47,,16,19,35
027 Graun im Vinschgau,48,,20,21,41
027 Graun im Vinschgau,49,,23,17,40
027 Graun im Vinschgau,50,,22,24,46
027 Graun im Vinschgau,51,,20,12,32
027 Graun im Vinschgau,52,,22,19,41
027 Graun im Vinschgau,53,,21,12,33
027 Graun im Vinschgau,54,,19,17,36
027 Graun im Vinschgau,55,,11,13,24
027 Graun im Vinschgau,56,,14,10,24
027 Graun im Vinschgau,57,,13,9,22
027 Graun im Vinschgau,58,,15,14,29
027 Graun im Vinschgau,59,,13,6,19
027 Graun im Vinschgau,60,,16,11,27
027 Graun im Vinschgau,61,,11,16,27
027 Graun im Vinschgau,62,,11,12,23
027 Graun im Vinschgau,63,,7,20,27
027 Graun im Vinschgau,64,,14,12,26
027 Graun im Vinschgau,65,,5,9,14
027 Graun im Vinschgau,66,,10,7,17
027 Graun im Vinschgau,67,,7,8,15
027 Graun im Vinschgau,68,,9,9,18
027 Graun im Vinschgau,69,,9,11,20
027 Graun im Vinschgau,70,,9,12,21
027 Graun im Vinschgau,71,,15,10,25
027 Graun im Vinschgau,72,,12,10,22
027 Graun im Vinschgau,73,,10,11,21
027 Graun im Vinschgau,74,,8,11,19
027 Graun im Vinschgau,75,,11,3,14
027 Graun im Vinschgau,76,,11,14,25
027 Graun im Vinschgau,77,,7,7,14
027 Graun im Vinschgau,78,,10,9,19
027 Graun im Vinschgau,79,,6,7,13
027 Graun im Vinschgau,80,,8,5,13
027 Graun im Vinschgau,81,,9,9,18
027 Graun im Vinschgau,82,,3,5,8
027 Graun im Vinschgau,83,,5,12,17
027 Graun im Vinschgau,84,,5,8,13
027 Graun im Vinschgau,85,,4,7,11
027 Graun im Vinschgau,86,,4,11,15
027 Graun im Vinschgau,87,,1,3,4
027 Graun im Vinschgau,88,,2,5,7
027 Graun im Vinschgau,89,,4,6,10
027 Graun im Vinschgau,90,,2,4,6
027 Graun im Vinschgau,91,,-,3,3
027 Graun im Vinschgau,92,,1,1,2
027 Graun im Vinschgau,93,,-,2,2
027 Graun im Vinschgau,98,,-,1,1
027 Graun im Vinschgau,Insgesamt,,1.255,1.187,2.442
028 Toblach,0,,17,24,41
028 Toblach,1,,18,28,46
028 Toblach,2,,21,21,42
028 Toblach,3,,16,19,35
028 Toblach,4,,24,21,45
028 Toblach,5,,24,15,39
028 Toblach,6,,21,10,31
028 Toblach,7,,14,19,33
028 Toblach,8,,18,24,42
028 Toblach,9,,20,28,48
028 Toblach,10,,13,18,31
028 Toblach,11,,24,19,43
028 Toblach,12,,23,19,42
028 Toblach,13,,16,22,38
028 Toblach,14,,18,14,32
028 Toblach,15,,23,16,39
028 Toblach,16,,26,19,45
028 Toblach,17,,17,10,27
028 Toblach,18,,20,18,38
028 Toblach,19,,19,20,39
028 Toblach,20,,14,16,30
028 Toblach,21,,17,28,45
028 Toblach,22,,13,23,36
028 Toblach,23,,9,16,25
028 Toblach,24,,14,20,34
028 Toblach,25,,33,17,50
028 Toblach,26,,14,22,36
028 Toblach,27,,24,28,52
028 Toblach,28,,20,24,44
028 Toblach,29,,22,22,44
028 Toblach,30,,27,27,54
028 Toblach,31,,24,23,47
028 Toblach,32,,22,25,47
028 Toblach,33,,29,26,55
028 Toblach,34,,16,17,33
028 Toblach,35,,14,24,38
028 Toblach,36,,26,31,57
028 Toblach,37,,19,22,41
028 Toblach,38,,27,19,46
028 Toblach,39,,32,28,60
028 Toblach,40,,25,32,57
028 Toblach,41,,27,24,51
028 Toblach,42,,22,25,47
028 Toblach,43,,42,25,67
028 Toblach,44,,32,25,57
028 Toblach,45,,26,21,47
028 Toblach,46,,32,30,62
028 Toblach,47,,33,28,61
028 Toblach,48,,38,31,69
028 Toblach,49,,27,26,53
028 Toblach,50,,37,28,65
028 Toblach,51,,22,34,56
028 Toblach,52,,22,17,39
028 Toblach,53,,33,26,59
028 Toblach,54,,22,17,39
028 Toblach,55,,28,23,51
028 Toblach,56,,16,24,40
028 Toblach,57,,16,26,42
028 Toblach,58,,20,18,38
028 Toblach,59,,20,24,44
028 Toblach,60,,20,16,36
028 Toblach,61,,24,12,36
028 Toblach,62,,14,15,29
028 Toblach,63,,21,14,35
028 Toblach,64,,15,24,39
028 Toblach,65,,17,15,32
028 Toblach,66,,14,14,28
028 Toblach,67,,9,17,26
028 Toblach,68,,16,10,26
028 Toblach,69,,12,18,30
028 Toblach,70,,13,18,31
028 Toblach,71,,16,12,28
028 Toblach,72,,11,13,24
028 Toblach,73,,12,12,24
028 Toblach,74,,14,6,20
028 Toblach,75,,3,10,13
028 Toblach,76,,5,13,18
028 Toblach,77,,6,15,21
028 Toblach,78,,13,15,28
028 Toblach,79,,9,9,18
028 Toblach,80,,10,14,24
028 Toblach,81,,10,10,20
028 Toblach,82,,6,8,14
028 Toblach,83,,7,10,17
028 Toblach,84,,8,8,16
028 Toblach,85,,5,8,13
028 Toblach,86,,4,7,11
028 Toblach,87,,4,5,9
028 Toblach,88,,5,6,11
028 Toblach,89,,4,2,6
028 Toblach,90,,2,3,5
028 Toblach,91,,-,4,4
028 Toblach,92,,2,1,3
028 Toblach,93,,1,3,4
028 Toblach,97,,-,1,1
028 Toblach,99,,-,1,1
028 Toblach,105,,1,-,1
028 Toblach,Insgesamt,,1.681,1.715,3.396
029 Neumarkt,0,,34,32,66
029 Neumarkt,1,,26,23,49
029 Neumarkt,2,,30,29,59
029 Neumarkt,3,,31,24,55
029 Neumarkt,4,,27,23,50
029 Neumarkt,5,,36,25,61
029 Neumarkt,6,,26,30,56
029 Neumarkt,7,,39,36,75
029 Neumarkt,8,,25,16,41
029 Neumarkt,9,,36,30,66
029 Neumarkt,10,,27,23,50
029 Neumarkt,11,,32,34,66
029 Neumarkt,12,,32,25,57
029 Neumarkt,13,,25,27,52
029 Neumarkt,14,,21,42,63
029 Neumarkt,15,,22,21,43
029 Neumarkt,16,,20,25,45
029 Neumarkt,17,,28,25,53
029 Neumarkt,18,,25,22,47
029 Neumarkt,19,,24,36,60
029 Neumarkt,20,,28,27,55
029 Neumarkt,21,,24,26,50
029 Neumarkt,22,,25,30,55
029 Neumarkt,23,,24,30,54
029 Neumarkt,24,,23,30,53
029 Neumarkt,25,,24,27,51
029 Neumarkt,26,,27,28,55
029 Neumarkt,27,,22,17,39
029 Neumarkt,28,,26,24,50
029 Neumarkt,29,,21,31,52
029 Neumarkt,30,,28,35,63
029 Neumarkt,31,,32,27,59
029 Neumarkt,32,,28,48,76
029 Neumarkt,33,,33,32,65
029 Neumarkt,34,,42,41,83
029 Neumarkt,35,,30,32,62
029 Neumarkt,36,,32,34,66
029 Neumarkt,37,,42,42,84
029 Neumarkt,38,,36,47,83
029 Neumarkt,39,,36,36,72
029 Neumarkt,40,,37,34,71
029 Neumarkt,41,,36,48,84
029 Neumarkt,42,,42,40,82
029 Neumarkt,43,,42,38,80
029 Neumarkt,44,,29,48,77
029 Neumarkt,45,,49,46,95
029 Neumarkt,46,,51,51,102
029 Neumarkt,47,,57,41,98
029 Neumarkt,48,,50,50,100
029 Neumarkt,49,,50,49,99
029 Neumarkt,50,,45,37,82
029 Neumarkt,51,,36,43,79
029 Neumarkt,52,,49,42,91
029 Neumarkt,53,,45,30,75
029 Neumarkt,54,,29,36,65
029 Neumarkt,55,,40,29,69
029 Neumarkt,56,,29,32,61
029 Neumarkt,57,,44,42,86
029 Neumarkt,58,,35,27,62
029 Neumarkt,59,,19,18,37
029 Neumarkt,60,,28,21,49
029 Neumarkt,61,,27,24,51
029 Neumarkt,62,,21,24,45
029 Neumarkt,63,,15,27,42
029 Neumarkt,64,,19,24,43
029 Neumarkt,65,,26,30,56
029 Neumarkt,66,,31,34,65
029 Neumarkt,67,,21,22,43
029 Neumarkt,68,,21,18,39
029 Neumarkt,69,,19,24,43
029 Neumarkt,70,,24,23,47
029 Neumarkt,71,,36,25,61
029 Neumarkt,72,,24,29,53
029 Neumarkt,73,,18,28,46
029 Neumarkt,74,,20,15,35
029 Neumarkt,75,,19,12,31
029 Neumarkt,76,,15,18,33
029 Neumarkt,77,,13,22,35
029 Neumarkt,78,,14,19,33
029 Neumarkt,79,,16,16,32
029 Neumarkt,80,,13,20,33
029 Neumarkt,81,,20,28,48
029 Neumarkt,82,,9,21,30
029 Neumarkt,83,,12,15,27
029 Neumarkt,84,,1,13,14
029 Neumarkt,85,,9,9,18
029 Neumarkt,86,,9,16,25
029 Neumarkt,87,,6,11,17
029 Neumarkt,88,,2,13,15
029 Neumarkt,89,,9,8,17
029 Neumarkt,90,,2,5,7
029 Neumarkt,91,,3,11,14
029 Neumarkt,92,,1,6,7
029 Neumarkt,93,,2,2,4
029 Neumarkt,95,,-,1,1
029 Neumarkt,98,,1,-,1
029 Neumarkt,Insgesamt,,2.489,2.607,5.096
030 Pfalzen,0,,23,13,36
030 Pfalzen,1,,19,21,40
030 Pfalzen,2,,21,14,35
030 Pfalzen,3,,16,18,34
030 Pfalzen,4,,17,22,39
030 Pfalzen,5,,13,9,22
030 Pfalzen,6,,20,21,41
030 Pfalzen,7,,21,17,38
030 Pfalzen,8,,13,21,34
030 Pfalzen,9,,21,13,34
030 Pfalzen,10,,12,17,29
030 Pfalzen,11,,19,14,33
030 Pfalzen,12,,15,18,33
030 Pfalzen,13,,19,19,38
030 Pfalzen,14,,17,16,33
030 Pfalzen,15,,13,16,29
030 Pfalzen,16,,15,15,30
030 Pfalzen,17,,22,17,39
030 Pfalzen,18,,14,18,32
030 Pfalzen,19,,12,19,31
030 Pfalzen,20,,14,22,36
030 Pfalzen,21,,13,18,31
030 Pfalzen,22,,19,13,32
030 Pfalzen,23,,19,21,40
030 Pfalzen,24,,15,13,28
030 Pfalzen,25,,14,21,35
030 Pfalzen,26,,21,20,41
030 Pfalzen,27,,26,19,45
030 Pfalzen,28,,18,11,29
030 Pfalzen,29,,11,11,22
030 Pfalzen,30,,19,19,38
030 Pfalzen,31,,20,17,37
030 Pfalzen,32,,22,22,44
030 Pfalzen,33,,23,18,41
030 Pfalzen,34,,17,23,40
030 Pfalzen,35,,22,26,48
030 Pfalzen,36,,20,15,35
030 Pfalzen,37,,17,16,33
030 Pfalzen,38,,25,17,42
030 Pfalzen,39,,18,23,41
030 Pfalzen,40,,24,25,49
030 Pfalzen,41,,32,26,58
030 Pfalzen,42,,22,24,46
030 Pfalzen,43,,28,15,43
030 Pfalzen,44,,25,34,59
030 Pfalzen,45,,21,22,43
030 Pfalzen,46,,25,22,47
030 Pfalzen,47,,24,30,54
030 Pfalzen,48,,21,24,45
030 Pfalzen,49,,30,21,51
030 Pfalzen,50,,22,30,52
030 Pfalzen,51,,25,20,45
030 Pfalzen,52,,23,15,38
030 Pfalzen,53,,16,15,31
030 Pfalzen,54,,15,21,36
030 Pfalzen,55,,25,19,44
030 Pfalzen,56,,16,15,31
030 Pfalzen,57,,17,14,31
030 Pfalzen,58,,16,11,27
030 Pfalzen,59,,13,11,24
030 Pfalzen,60,,10,11,21
030 Pfalzen,61,,16,16,32
030 Pfalzen,62,,11,12,23
030 Pfalzen,63,,16,7,23
030 Pfalzen,64,,9,11,20
030 Pfalzen,65,,12,3,15
030 Pfalzen,66,,8,10,18
030 Pfalzen,67,,7,9,16
030 Pfalzen,68,,11,6,17
030 Pfalzen,69,,8,10,18
030 Pfalzen,70,,7,12,19
030 Pfalzen,71,,10,8,18
030 Pfalzen,72,,13,9,22
030 Pfalzen,73,,8,5,13
030 Pfalzen,74,,11,10,21
030 Pfalzen,75,,5,5,10
030 Pfalzen,76,,2,7,9
030 Pfalzen,77,,6,7,13
030 Pfalzen,78,,8,9,17
030 Pfalzen,79,,5,8,13
030 Pfalzen,80,,6,4,10
030 Pfalzen,81,,9,7,16
030 Pfalzen,82,,7,7,14
030 Pfalzen,83,,8,3,11
030 Pfalzen,84,,2,3,5
030 Pfalzen,85,,4,5,9
030 Pfalzen,86,,3,2,5
030 Pfalzen,87,,3,2,5
030 Pfalzen,88,,2,4,6
030 Pfalzen,89,,3,2,5
030 Pfalzen,90,,2,-,2
030 Pfalzen,91,,-,3,3
030 Pfalzen,92,,-,1,1
030 Pfalzen,99,,1,-,1
030 Pfalzen,Insgesamt,,1.388,1.335,2.723
031 Völs am Schlern,0,,19,25,44
031 Völs am Schlern,1,,12,21,33
031 Völs am Schlern,2,,30,19,49
031 Völs am Schlern,3,,24,17,41
031 Völs am Schlern,4,,23,32,55
031 Völs am Schlern,5,,17,23,40
031 Völs am Schlern,6,,22,25,47
031 Völs am Schlern,7,,36,16,52
031 Völs am Schlern,8,,20,11,31
031 Völs am Schlern,9,,15,22,37
031 Völs am Schlern,10,,16,30,46
031 Völs am Schlern,11,,19,26,45
031 Völs am Schlern,12,,23,26,49
031 Völs am Schlern,13,,18,19,37
031 Völs am Schlern,14,,23,31,54
031 Völs am Schlern,15,,19,26,45
031 Völs am Schlern,16,,15,20,35
031 Völs am Schlern,17,,23,23,46
031 Völs am Schlern,18,,20,12,32
031 Völs am Schlern,19,,16,14,30
031 Völs am Schlern,20,,21,19,40
031 Völs am Schlern,21,,11,21,32
031 Völs am Schlern,22,,22,18,40
031 Völs am Schlern,23,,22,13,35
031 Völs am Schlern,24,,17,20,37
031 Völs am Schlern,25,,17,23,40
031 Völs am Schlern,26,,23,19,42
031 Völs am Schlern,27,,15,17,32
031 Völs am Schlern,28,,21,6,27
031 Völs am Schlern,29,,13,27,40
031 Völs am Schlern,30,,21,25,46
031 Völs am Schlern,31,,33,22,55
031 Völs am Schlern,32,,36,13,49
031 Völs am Schlern,33,,29,29,58
031 Völs am Schlern,34,,30,27,57
031 Völs am Schlern,35,,25,23,48
031 Völs am Schlern,36,,31,22,53
031 Völs am Schlern,37,,25,17,42
031 Völs am Schlern,38,,28,26,54
031 Völs am Schlern,39,,27,34,61
031 Völs am Schlern,40,,41,29,70
031 Völs am Schlern,41,,38,42,80
031 Völs am Schlern,42,,30,40,70
031 Völs am Schlern,43,,40,31,71
031 Völs am Schlern,44,,38,38,76
031 Völs am Schlern,45,,27,28,55
031 Völs am Schlern,46,,36,34,70
031 Völs am Schlern,47,,25,31,56
031 Völs am Schlern,48,,31,23,54
031 Völs am Schlern,49,,25,23,48
031 Völs am Schlern,50,,26,21,47
031 Völs am Schlern,51,,27,23,50
031 Völs am Schlern,52,,21,17,38
031 Völs am Schlern,53,,23,12,35
031 Völs am Schlern,54,,19,16,35
031 Völs am Schlern,55,,19,18,37
031 Völs am Schlern,56,,17,19,36
031 Völs am Schlern,57,,18,15,33
031 Völs am Schlern,58,,17,25,42
031 Völs am Schlern,59,,16,26,42
031 Völs am Schlern,60,,18,19,37
031 Völs am Schlern,61,,18,20,38
031 Völs am Schlern,62,,19,17,36
031 Völs am Schlern,63,,15,9,24
031 Völs am Schlern,64,,16,13,29
031 Völs am Schlern,65,,14,20,34
031 Völs am Schlern,66,,15,12,27
031 Völs am Schlern,67,,7,13,20
031 Völs am Schlern,68,,14,9,23
031 Völs am Schlern,69,,15,20,35
031 Völs am Schlern,70,,15,17,32
031 Völs am Schlern,71,,16,18,34
031 Völs am Schlern,72,,11,22,33
031 Völs am Schlern,73,,12,11,23
031 Völs am Schlern,74,,11,14,25
031 Völs am Schlern,75,,9,9,18
031 Völs am Schlern,76,,8,17,25
031 Völs am Schlern,77,,14,11,25
031 Völs am Schlern,78,,11,6,17
031 Völs am Schlern,79,,5,14,19
031 Völs am Schlern,80,,14,9,23
031 Völs am Schlern,81,,8,13,21
031 Völs am Schlern,82,,3,10,13
031 Völs am Schlern,83,,2,10,12
031 Völs am Schlern,84,,3,11,14
031 Völs am Schlern,85,,2,8,10
031 Völs am Schlern,86,,4,5,9
031 Völs am Schlern,87,,5,7,12
031 Völs am Schlern,88,,5,8,13
031 Völs am Schlern,89,,2,3,5
031 Völs am Schlern,90,,1,2,3
031 Völs am Schlern,91,,-,6,6
031 Völs am Schlern,92,,1,2,3
031 Völs am Schlern,93,,-,2,2
031 Völs am Schlern,94,,-,3,3
031 Völs am Schlern,95,,1,2,3
031 Völs am Schlern,97,,-,1,1
031 Völs am Schlern,Insgesamt,,1.725,1.763,3.488
032 Franzensfeste,0,,6,7,13
032 Franzensfeste,1,,8,8,16
032 Franzensfeste,2,,9,7,16
032 Franzensfeste,3,,3,4,7
032 Franzensfeste,4,,4,8,12
032 Franzensfeste,5,,8,5,13
032 Franzensfeste,6,,3,4,7
032 Franzensfeste,7,,3,5,8
032 Franzensfeste,8,,9,4,13
032 Franzensfeste,9,,7,3,10
032 Franzensfeste,10,,10,1,11
032 Franzensfeste,11,,3,6,9
032 Franzensfeste,12,,3,5,8
032 Franzensfeste,13,,4,4,8
032 Franzensfeste,14,,7,6,13
032 Franzensfeste,15,,4,5,9
032 Franzensfeste,16,,7,4,11
032 Franzensfeste,17,,4,2,6
032 Franzensfeste,18,,5,6,11
032 Franzensfeste,19,,8,5,13
032 Franzensfeste,20,,7,5,12
032 Franzensfeste,21,,5,7,12
032 Franzensfeste,22,,1,9,10
032 Franzensfeste,23,,8,3,11
032 Franzensfeste,24,,4,4,8
032 Franzensfeste,25,,9,7,16
032 Franzensfeste,26,,7,5,12
032 Franzensfeste,27,,6,6,12
032 Franzensfeste,28,,5,10,15
032 Franzensfeste,29,,5,9,14
032 Franzensfeste,30,,3,9,12
032 Franzensfeste,31,,8,5,13
032 Franzensfeste,32,,7,13,20
032 Franzensfeste,33,,13,3,16
032 Franzensfeste,34,,8,9,17
032 Franzensfeste,35,,4,5,9
032 Franzensfeste,36,,4,5,9
032 Franzensfeste,37,,10,11,21
032 Franzensfeste,38,,11,7,18
032 Franzensfeste,39,,3,6,9
032 Franzensfeste,40,,6,9,15
032 Franzensfeste,41,,6,4,10
032 Franzensfeste,42,,7,6,13
032 Franzensfeste,43,,10,8,18
032 Franzensfeste,44,,9,12,21
032 Franzensfeste,45,,9,4,13
032 Franzensfeste,46,,10,5,15
032 Franzensfeste,47,,12,10,22
032 Franzensfeste,48,,15,8,23
032 Franzensfeste,49,,8,11,19
032 Franzensfeste,50,,11,3,14
032 Franzensfeste,51,,5,5,10
032 Franzensfeste,52,,2,9,11
032 Franzensfeste,53,,6,9,15
032 Franzensfeste,54,,10,3,13
032 Franzensfeste,55,,5,5,10
032 Franzensfeste,56,,5,7,12
032 Franzensfeste,57,,9,6,15
032 Franzensfeste,58,,7,7,14
032 Franzensfeste,59,,5,8,13
032 Franzensfeste,60,,5,4,9
032 Franzensfeste,61,,8,1,9
032 Franzensfeste,62,,11,3,14
032 Franzensfeste,63,,2,4,6
032 Franzensfeste,64,,4,4,8
032 Franzensfeste,65,,2,3,5
032 Franzensfeste,66,,8,4,12
032 Franzensfeste,67,,4,6,10
032 Franzensfeste,68,,4,7,11
032 Franzensfeste,69,,4,2,6
032 Franzensfeste,70,,4,1,5
032 Franzensfeste,71,,4,3,7
032 Franzensfeste,72,,2,4,6
032 Franzensfeste,73,,4,2,6
032 Franzensfeste,74,,1,3,4
032 Franzensfeste,75,,6,6,12
032 Franzensfeste,76,,1,1,2
032 Franzensfeste,77,,1,2,3
032 Franzensfeste,78,,3,3,6
032 Franzensfeste,79,,-,3,3
032 Franzensfeste,80,,3,4,7
032 Franzensfeste,81,,1,5,6
032 Franzensfeste,82,,6,3,9
032 Franzensfeste,83,,-,5,5
032 Franzensfeste,84,,1,4,5
032 Franzensfeste,85,,3,3,6
032 Franzensfeste,86,,-,6,6
032 Franzensfeste,87,,1,1,2
032 Franzensfeste,88,,3,3,6
032 Franzensfeste,89,,2,6,8
032 Franzensfeste,90,,2,2,4
032 Franzensfeste,91,,-,2,2
032 Franzensfeste,92,,-,1,1
032 Franzensfeste,Insgesamt,,500,487,987
033 Villnöss,0,,17,15,32
033 Villnöss,1,,9,22,31
033 Villnöss,2,,16,18,34
033 Villnöss,3,,17,13,30
033 Villnöss,4,,18,9,27
033 Villnöss,5,,16,14,30
033 Villnöss,6,,14,25,39
033 Villnöss,7,,19,22,41
033 Villnöss,8,,11,17,28
033 Villnöss,9,,17,14,31
033 Villnöss,10,,21,15,36
033 Villnöss,11,,15,23,38
033 Villnöss,12,,18,14,32
033 Villnöss,13,,16,30,46
033 Villnöss,14,,25,19,44
033 Villnöss,15,,18,23,41
033 Villnöss,16,,21,17,38
033 Villnöss,17,,18,13,31
033 Villnöss,18,,14,11,25
033 Villnöss,19,,17,11,28
033 Villnöss,20,,14,14,28
033 Villnöss,21,,21,17,38
033 Villnöss,22,,14,12,26
033 Villnöss,23,,13,11,24
033 Villnöss,24,,16,19,35
033 Villnöss,25,,18,18,36
033 Villnöss,26,,12,15,27
033 Villnöss,27,,14,18,32
033 Villnöss,28,,17,16,33
033 Villnöss,29,,16,15,31
033 Villnöss,30,,11,13,24
033 Villnöss,31,,12,19,31
033 Villnöss,32,,24,11,35
033 Villnöss,33,,8,14,22
033 Villnöss,34,,15,14,29
033 Villnöss,35,,13,12,25
033 Villnöss,36,,18,13,31
033 Villnöss,37,,21,16,37
033 Villnöss,38,,20,14,34
033 Villnöss,39,,12,19,31
033 Villnöss,40,,16,26,42
033 Villnöss,41,,21,24,45
033 Villnöss,42,,17,27,44
033 Villnöss,43,,29,23,52
033 Villnöss,44,,27,19,46
033 Villnöss,45,,17,20,37
033 Villnöss,46,,28,18,46
033 Villnöss,47,,28,22,50
033 Villnöss,48,,29,26,55
033 Villnöss,49,,30,20,50
033 Villnöss,50,,28,21,49
033 Villnöss,51,,21,14,35
033 Villnöss,52,,20,12,32
033 Villnöss,53,,11,10,21
033 Villnöss,54,,12,14,26
033 Villnöss,55,,14,13,27
033 Villnöss,56,,15,17,32
033 Villnöss,57,,12,3,15
033 Villnöss,58,,16,13,29
033 Villnöss,59,,14,15,29
033 Villnöss,60,,11,14,25
033 Villnöss,61,,11,9,20
033 Villnöss,62,,6,8,14
033 Villnöss,63,,7,14,21
033 Villnöss,64,,8,10,18
033 Villnöss,65,,13,11,24
033 Villnöss,66,,9,5,14
033 Villnöss,67,,8,4,12
033 Villnöss,68,,6,12,18
033 Villnöss,69,,11,9,20
033 Villnöss,70,,12,19,31
033 Villnöss,71,,11,9,20
033 Villnöss,72,,6,18,24
033 Villnöss,73,,12,13,25
033 Villnöss,74,,10,8,18
033 Villnöss,75,,7,15,22
033 Villnöss,76,,4,16,20
033 Villnöss,77,,2,8,10
033 Villnöss,78,,7,8,15
033 Villnöss,79,,9,10,19
033 Villnöss,80,,11,13,24
033 Villnöss,81,,7,10,17
033 Villnöss,82,,7,11,18
033 Villnöss,83,,8,9,17
033 Villnöss,84,,11,7,18
033 Villnöss,85,,5,8,13
033 Villnöss,86,,2,6,8
033 Villnöss,87,,3,6,9
033 Villnöss,88,,1,6,7
033 Villnöss,89,,3,8,11
033 Villnöss,90,,2,4,6
033 Villnöss,91,,1,3,4
033 Villnöss,92,,-,3,3
033 Villnöss,93,,-,1,1
033 Villnöss,95,,-,1,1
033 Villnöss,99,,-,1,1
033 Villnöss,Insgesamt,,1.282,1.319,2.601
034 Gais,0,,15,14,29
034 Gais,1,,19,21,40
034 Gais,2,,28,15,43
034 Gais,3,,26,14,40
034 Gais,4,,14,18,32
034 Gais,5,,15,19,34
034 Gais,6,,23,15,38
034 Gais,7,,26,17,43
034 Gais,8,,14,27,41
034 Gais,9,,18,16,34
034 Gais,10,,21,22,43
034 Gais,11,,20,17,37
034 Gais,12,,21,16,37
034 Gais,13,,21,23,44
034 Gais,14,,25,19,44
034 Gais,15,,29,13,42
034 Gais,16,,7,16,23
034 Gais,17,,29,19,48
034 Gais,18,,26,26,52
034 Gais,19,,14,21,35
034 Gais,20,,20,28,48
034 Gais,21,,25,28,53
034 Gais,22,,14,20,34
034 Gais,23,,18,11,29
034 Gais,24,,14,17,31
034 Gais,25,,19,17,36
034 Gais,26,,15,22,37
034 Gais,27,,16,15,31
034 Gais,28,,25,16,41
034 Gais,29,,18,26,44
034 Gais,30,,23,19,42
034 Gais,31,,22,22,44
034 Gais,32,,24,25,49
034 Gais,33,,24,16,40
034 Gais,34,,18,20,38
034 Gais,35,,17,24,41
034 Gais,36,,25,22,47
034 Gais,37,,25,22,47
034 Gais,38,,32,30,62
034 Gais,39,,26,25,51
034 Gais,40,,33,42,75
034 Gais,41,,37,27,64
034 Gais,42,,28,24,52
034 Gais,43,,40,31,71
034 Gais,44,,24,20,44
034 Gais,45,,28,32,60
034 Gais,46,,34,22,56
034 Gais,47,,23,25,48
034 Gais,48,,29,32,61
034 Gais,49,,18,18,36
034 Gais,50,,29,20,49
034 Gais,51,,21,32,53
034 Gais,52,,16,10,26
034 Gais,53,,17,22,39
034 Gais,54,,23,18,41
034 Gais,55,,12,16,28
034 Gais,56,,22,20,42
034 Gais,57,,19,10,29
034 Gais,58,,17,13,30
034 Gais,59,,13,12,25
034 Gais,60,,14,17,31
034 Gais,61,,14,20,34
034 Gais,62,,21,22,43
034 Gais,63,,15,11,26
034 Gais,64,,22,13,35
034 Gais,65,,19,11,30
034 Gais,66,,16,15,31
034 Gais,67,,13,8,21
034 Gais,68,,13,13,26
034 Gais,69,,11,16,27
034 Gais,70,,11,13,24
034 Gais,71,,18,12,30
034 Gais,72,,16,12,28
034 Gais,73,,11,14,25
034 Gais,74,,13,13,26
034 Gais,75,,15,16,31
034 Gais,76,,7,13,20
034 Gais,77,,11,11,22
034 Gais,78,,4,5,9
034 Gais,79,,5,9,14
034 Gais,80,,3,6,9
034 Gais,81,,8,5,13
034 Gais,82,,4,10,14
034 Gais,83,,1,2,3
034 Gais,84,,6,7,13
034 Gais,85,,6,7,13
034 Gais,86,,5,4,9
034 Gais,87,,2,2,4
034 Gais,88,,1,2,3
034 Gais,89,,1,4,5
034 Gais,90,,1,2,3
034 Gais,91,,-,2,2
034 Gais,92,,1,-,1
034 Gais,94,,1,1,2
034 Gais,Insgesamt,,1.623,1.557,3.180
035 Gargazon,0,,8,14,22
035 Gargazon,1,,8,8,16
035 Gargazon,2,,8,12,20
035 Gargazon,3,,8,9,17
035 Gargazon,4,,14,8,22
035 Gargazon,5,,8,6,14
035 Gargazon,6,,10,13,23
035 Gargazon,7,,9,7,16
035 Gargazon,8,,8,7,15
035 Gargazon,9,,7,14,21
035 Gargazon,10,,6,12,18
035 Gargazon,11,,5,7,12
035 Gargazon,12,,11,5,16
035 Gargazon,13,,14,9,23
035 Gargazon,14,,15,10,25
035 Gargazon,15,,5,14,19
035 Gargazon,16,,11,8,19
035 Gargazon,17,,11,5,16
035 Gargazon,18,,4,7,11
035 Gargazon,19,,9,6,15
035 Gargazon,20,,14,9,23
035 Gargazon,21,,17,11,28
035 Gargazon,22,,7,14,21
035 Gargazon,23,,10,4,14
035 Gargazon,24,,10,5,15
035 Gargazon,25,,8,9,17
035 Gargazon,26,,7,13,20
035 Gargazon,27,,13,9,22
035 Gargazon,28,,11,8,19
035 Gargazon,29,,7,11,18
035 Gargazon,30,,9,8,17
035 Gargazon,31,,14,11,25
035 Gargazon,32,,12,16,28
035 Gargazon,33,,5,4,9
035 Gargazon,34,,5,17,22
035 Gargazon,35,,11,12,23
035 Gargazon,36,,5,11,16
035 Gargazon,37,,10,10,20
035 Gargazon,38,,14,20,34
035 Gargazon,39,,14,10,24
035 Gargazon,40,,13,20,33
035 Gargazon,41,,17,16,33
035 Gargazon,42,,16,13,29
035 Gargazon,43,,24,15,39
035 Gargazon,44,,18,19,37
035 Gargazon,45,,13,14,27
035 Gargazon,46,,11,18,29
035 Gargazon,47,,15,9,24
035 Gargazon,48,,17,16,33
035 Gargazon,49,,19,21,40
035 Gargazon,50,,16,13,29
035 Gargazon,51,,11,15,26
035 Gargazon,52,,9,12,21
035 Gargazon,53,,18,14,32
035 Gargazon,54,,7,11,18
035 Gargazon,55,,15,14,29
035 Gargazon,56,,14,6,20
035 Gargazon,57,,9,4,13
035 Gargazon,58,,10,11,21
035 Gargazon,59,,16,11,27
035 Gargazon,60,,4,9,13
035 Gargazon,61,,9,8,17
035 Gargazon,62,,8,8,16
035 Gargazon,63,,6,9,15
035 Gargazon,64,,7,9,16
035 Gargazon,65,,5,7,12
035 Gargazon,66,,11,14,25
035 Gargazon,67,,9,6,15
035 Gargazon,68,,2,4,6
035 Gargazon,69,,6,9,15
035 Gargazon,70,,5,8,13
035 Gargazon,71,,9,8,17
035 Gargazon,72,,5,16,21
035 Gargazon,73,,8,6,14
035 Gargazon,74,,8,8,16
035 Gargazon,75,,8,12,20
035 Gargazon,76,,3,3,6
035 Gargazon,77,,12,2,14
035 Gargazon,78,,5,7,12
035 Gargazon,79,,1,10,11
035 Gargazon,80,,5,2,7
035 Gargazon,81,,3,7,10
035 Gargazon,82,,3,4,7
035 Gargazon,83,,1,4,5
035 Gargazon,84,,2,2,4
035 Gargazon,85,,2,5,7
035 Gargazon,86,,3,1,4
035 Gargazon,87,,1,3,4
035 Gargazon,88,,-,3,3
035 Gargazon,89,,3,3,6
035 Gargazon,90,,1,3,4
035 Gargazon,91,,-,2,2
035 Gargazon,96,,-,1,1
035 Gargazon,97,,-,1,1
035 Gargazon,98,,1,-,1
035 Gargazon,99,,-,2,2
035 Gargazon,Insgesamt,,826,871,1.697
036 Glurns,0,,9,2,11
036 Glurns,1,,4,5,9
036 Glurns,2,,3,4,7
036 Glurns,3,,3,5,8
036 Glurns,4,,9,2,11
036 Glurns,5,,5,2,7
036 Glurns,6,,4,8,12
036 Glurns,7,,6,6,12
036 Glurns,8,,4,5,9
036 Glurns,9,,6,6,12
036 Glurns,10,,5,4,9
036 Glurns,11,,5,1,6
036 Glurns,12,,4,3,7
036 Glurns,13,,3,2,5
036 Glurns,14,,10,3,13
036 Glurns,15,,4,7,11
036 Glurns,16,,7,4,11
036 Glurns,17,,6,4,10
036 Glurns,18,,2,3,5
036 Glurns,19,,7,8,15
036 Glurns,20,,5,8,13
036 Glurns,21,,8,2,10
036 Glurns,22,,8,6,14
036 Glurns,23,,4,4,8
036 Glurns,24,,5,7,12
036 Glurns,25,,4,7,11
036 Glurns,26,,4,6,10
036 Glurns,27,,3,2,5
036 Glurns,28,,7,5,12
036 Glurns,29,,10,6,16
036 Glurns,30,,11,6,17
036 Glurns,31,,7,2,9
036 Glurns,32,,11,5,16
036 Glurns,33,,2,8,10
036 Glurns,34,,6,7,13
036 Glurns,35,,3,3,6
036 Glurns,36,,13,4,17
036 Glurns,37,,7,10,17
036 Glurns,38,,8,11,19
036 Glurns,39,,4,3,7
036 Glurns,40,,5,7,12
036 Glurns,41,,6,5,11
036 Glurns,42,,5,1,6
036 Glurns,43,,2,6,8
036 Glurns,44,,7,4,11
036 Glurns,45,,4,9,13
036 Glurns,46,,6,7,13
036 Glurns,47,,2,6,8
036 Glurns,48,,10,5,15
036 Glurns,49,,5,9,14
036 Glurns,50,,5,5,10
036 Glurns,51,,6,6,12
036 Glurns,52,,6,9,15
036 Glurns,53,,12,6,18
036 Glurns,54,,3,9,12
036 Glurns,55,,6,12,18
036 Glurns,56,,6,6,12
036 Glurns,57,,7,7,14
036 Glurns,58,,12,4,16
036 Glurns,59,,8,10,18
036 Glurns,60,,4,8,12
036 Glurns,61,,8,10,18
036 Glurns,62,,6,5,11
036 Glurns,63,,6,3,9
036 Glurns,64,,7,5,12
036 Glurns,65,,10,7,17
036 Glurns,66,,8,2,10
036 Glurns,67,,6,1,7
036 Glurns,68,,5,4,9
036 Glurns,69,,1,4,5
036 Glurns,70,,4,6,10
036 Glurns,71,,3,2,5
036 Glurns,72,,6,1,7
036 Glurns,73,,2,3,5
036 Glurns,74,,4,4,8
036 Glurns,75,,4,4,8
036 Glurns,76,,-,2,2
036 Glurns,77,,2,4,6
036 Glurns,78,,1,5,6
036 Glurns,79,,1,1,2
036 Glurns,80,,5,2,7
036 Glurns,81,,4,1,5
036 Glurns,82,,-,2,2
036 Glurns,83,,2,6,8
036 Glurns,84,,-,1,1
036 Glurns,85,,-,2,2
036 Glurns,87,,1,4,5
036 Glurns,88,,-,2,2
036 Glurns,89,,-,1,1
036 Glurns,91,,2,-,2
036 Glurns,95,,-,1,1
036 Glurns,97,,-,1,1
036 Glurns,Insgesamt,,461,433,894
037 Latsch,0,,32,29,61
037 Latsch,1,,25,20,45
037 Latsch,2,,20,20,40
037 Latsch,3,,20,33,53
037 Latsch,4,,18,24,42
037 Latsch,5,,31,29,60
037 Latsch,6,,28,23,51
037 Latsch,7,,20,29,49
037 Latsch,8,,31,24,55
037 Latsch,9,,26,22,48
037 Latsch,10,,27,27,54
037 Latsch,11,,36,19,55
037 Latsch,12,,36,32,68
037 Latsch,13,,32,19,51
037 Latsch,14,,26,22,48
037 Latsch,15,,36,39,75
037 Latsch,16,,37,33,70
037 Latsch,17,,48,33,81
037 Latsch,18,,41,23,64
037 Latsch,19,,33,36,69
037 Latsch,20,,34,37,71
037 Latsch,21,,31,38,69
037 Latsch,22,,39,50,89
037 Latsch,23,,33,35,68
037 Latsch,24,,40,36,76
037 Latsch,25,,31,38,69
037 Latsch,26,,42,32,74
037 Latsch,27,,35,35,70
037 Latsch,28,,40,31,71
037 Latsch,29,,24,30,54
037 Latsch,30,,33,37,70
037 Latsch,31,,28,42,70
037 Latsch,32,,32,36,68
037 Latsch,33,,38,36,74
037 Latsch,34,,35,24,59
037 Latsch,35,,35,33,68
037 Latsch,36,,28,26,54
037 Latsch,37,,34,36,70
037 Latsch,38,,29,27,56
037 Latsch,39,,32,35,67
037 Latsch,40,,34,41,75
037 Latsch,41,,44,39,83
037 Latsch,42,,34,36,70
037 Latsch,43,,41,39,80
037 Latsch,44,,48,52,100
037 Latsch,45,,49,49,98
037 Latsch,46,,29,48,77
037 Latsch,47,,56,46,102
037 Latsch,48,,58,46,104
037 Latsch,49,,53,48,101
037 Latsch,50,,41,49,90
037 Latsch,51,,44,43,87
037 Latsch,52,,38,49,87
037 Latsch,53,,43,47,90
037 Latsch,54,,39,29,68
037 Latsch,55,,29,35,64
037 Latsch,56,,30,35,65
037 Latsch,57,,36,26,62
037 Latsch,58,,28,18,46
037 Latsch,59,,23,23,46
037 Latsch,60,,37,21,58
037 Latsch,61,,20,32,52
037 Latsch,62,,33,15,48
037 Latsch,63,,16,20,36
037 Latsch,64,,13,20,33
037 Latsch,65,,17,16,33
037 Latsch,66,,17,20,37
037 Latsch,67,,15,20,35
037 Latsch,68,,22,12,34
037 Latsch,69,,22,22,44
037 Latsch,70,,23,25,48
037 Latsch,71,,16,23,39
037 Latsch,72,,19,23,42
037 Latsch,73,,18,18,36
037 Latsch,74,,14,25,39
037 Latsch,75,,11,23,34
037 Latsch,76,,16,13,29
037 Latsch,77,,23,13,36
037 Latsch,78,,15,25,40
037 Latsch,79,,13,23,36
037 Latsch,80,,19,18,37
037 Latsch,81,,14,18,32
037 Latsch,82,,15,16,31
037 Latsch,83,,14,12,26
037 Latsch,84,,15,16,31
037 Latsch,85,,7,17,24
037 Latsch,86,,9,12,21
037 Latsch,87,,10,12,22
037 Latsch,88,,3,7,10
037 Latsch,89,,4,5,9
037 Latsch,90,,4,6,10
037 Latsch,91,,4,6,10
037 Latsch,92,,3,1,4
037 Latsch,93,,1,-,1
037 Latsch,98,,-,1,1
037 Latsch,99,,-,1,1
037 Latsch,100,,-,1,1
037 Latsch,101,,-,1,1
037 Latsch,103,,-,1,1
037 Latsch,Insgesamt,,2.575,2.588,5.163
038 Algund,0,,24,33,57
038 Algund,1,,24,19,43
038 Algund,2,,28,23,51
038 Algund,3,,20,34,54
038 Algund,4,,21,24,45
038 Algund,5,,20,22,42
038 Algund,6,,24,21,45
038 Algund,7,,22,26,48
038 Algund,8,,24,23,47
038 Algund,9,,30,26,56
038 Algund,10,,25,27,52
038 Algund,11,,35,25,60
038 Algund,12,,22,36,58
038 Algund,13,,42,27,69
038 Algund,14,,24,23,47
038 Algund,15,,28,21,49
038 Algund,16,,22,23,45
038 Algund,17,,29,22,51
038 Algund,18,,29,25,54
038 Algund,19,,28,18,46
038 Algund,20,,32,22,54
038 Algund,21,,30,21,51
038 Algund,22,,34,23,57
038 Algund,23,,23,32,55
038 Algund,24,,26,31,57
038 Algund,25,,31,28,59
038 Algund,26,,31,30,61
038 Algund,27,,29,28,57
038 Algund,28,,27,32,59
038 Algund,29,,26,39,65
038 Algund,30,,26,29,55
038 Algund,31,,37,35,72
038 Algund,32,,33,39,72
038 Algund,33,,26,40,66
038 Algund,34,,33,34,67
038 Algund,35,,32,40,72
038 Algund,36,,31,34,65
038 Algund,37,,40,43,83
038 Algund,38,,33,43,76
038 Algund,39,,37,36,73
038 Algund,40,,47,40,87
038 Algund,41,,43,42,85
038 Algund,42,,49,45,94
038 Algund,43,,47,50,97
038 Algund,44,,44,33,77
038 Algund,45,,38,47,85
038 Algund,46,,42,43,85
038 Algund,47,,40,46,86
038 Algund,48,,55,24,79
038 Algund,49,,42,42,84
038 Algund,50,,39,43,82
038 Algund,51,,31,53,84
038 Algund,52,,37,45,82
038 Algund,53,,37,38,75
038 Algund,54,,43,31,74
038 Algund,55,,27,38,65
038 Algund,56,,34,29,63
038 Algund,57,,24,30,54
038 Algund,58,,37,25,62
038 Algund,59,,18,29,47
038 Algund,60,,27,27,54
038 Algund,61,,28,28,56
038 Algund,62,,24,28,52
038 Algund,63,,20,26,46
038 Algund,64,,26,21,47
038 Algund,65,,18,20,38
038 Algund,66,,29,30,59
038 Algund,67,,25,24,49
038 Algund,68,,22,28,50
038 Algund,69,,21,22,43
038 Algund,70,,15,32,47
038 Algund,71,,17,22,39
038 Algund,72,,17,22,39
038 Algund,73,,20,28,48
038 Algund,74,,17,21,38
038 Algund,75,,16,14,30
038 Algund,76,,14,25,39
038 Algund,77,,12,16,28
038 Algund,78,,22,23,45
038 Algund,79,,16,19,35
038 Algund,80,,12,18,30
038 Algund,81,,10,20,30
038 Algund,82,,10,21,31
038 Algund,83,,6,20,26
038 Algund,84,,7,14,21
038 Algund,85,,6,12,18
038 Algund,86,,9,11,20
038 Algund,87,,8,10,18
038 Algund,88,,3,9,12
038 Algund,89,,-,3,3
038 Algund,90,,2,13,15
038 Algund,91,,2,5,7
038 Algund,92,,3,3,6
038 Algund,93,,1,5,6
038 Algund,94,,-,2,2
038 Algund,95,,-,1,1
038 Algund,96,,1,1,2
038 Algund,98,,-,1,1
038 Algund,100,,1,2,3
038 Algund,101,,-,1,1
038 Algund,102,,-,1,1
038 Algund,Insgesamt,,2.399,2.579,4.978
039 Lajen,0,,23,16,39
039 Lajen,1,,20,16,36
039 Lajen,2,,16,21,37
039 Lajen,3,,19,7,26
039 Lajen,4,,18,17,35
039 Lajen,5,,17,22,39
039 Lajen,6,,12,21,33
039 Lajen,7,,18,14,32
039 Lajen,8,,17,23,40
039 Lajen,9,,21,22,43
039 Lajen,10,,22,9,31
039 Lajen,11,,21,21,42
039 Lajen,12,,27,16,43
039 Lajen,13,,17,16,33
039 Lajen,14,,18,16,34
039 Lajen,15,,15,23,38
039 Lajen,16,,15,11,26
039 Lajen,17,,10,11,21
039 Lajen,18,,13,13,26
039 Lajen,19,,12,13,25
039 Lajen,20,,14,9,23
039 Lajen,21,,19,19,38
039 Lajen,22,,9,10,19
039 Lajen,23,,16,15,31
039 Lajen,24,,11,12,23
039 Lajen,25,,13,8,21
039 Lajen,26,,17,16,33
039 Lajen,27,,18,10,28
039 Lajen,28,,11,14,25
039 Lajen,29,,9,24,33
039 Lajen,30,,19,19,38
039 Lajen,31,,9,24,33
039 Lajen,32,,21,18,39
039 Lajen,33,,22,17,39
039 Lajen,34,,23,27,50
039 Lajen,35,,22,15,37
039 Lajen,36,,28,19,47
039 Lajen,37,,22,26,48
039 Lajen,38,,33,18,51
039 Lajen,39,,22,21,43
039 Lajen,40,,21,29,50
039 Lajen,41,,17,22,39
039 Lajen,42,,18,28,46
039 Lajen,43,,34,25,59
039 Lajen,44,,23,22,45
039 Lajen,45,,24,25,49
039 Lajen,46,,22,15,37
039 Lajen,47,,28,20,48
039 Lajen,48,,23,20,43
039 Lajen,49,,17,12,29
039 Lajen,50,,31,19,50
039 Lajen,51,,10,17,27
039 Lajen,52,,12,9,21
039 Lajen,53,,19,25,44
039 Lajen,54,,23,12,35
039 Lajen,55,,15,11,26
039 Lajen,56,,11,13,24
039 Lajen,57,,12,13,25
039 Lajen,58,,6,14,20
039 Lajen,59,,10,7,17
039 Lajen,60,,8,11,19
039 Lajen,61,,9,11,20
039 Lajen,62,,14,11,25
039 Lajen,63,,4,14,18
039 Lajen,64,,9,15,24
039 Lajen,65,,15,7,22
039 Lajen,66,,13,15,28
039 Lajen,67,,10,12,22
039 Lajen,68,,13,8,21
039 Lajen,69,,13,13,26
039 Lajen,70,,13,13,26
039 Lajen,71,,15,15,30
039 Lajen,72,,16,8,24
039 Lajen,73,,11,8,19
039 Lajen,74,,6,16,22
039 Lajen,75,,6,11,17
039 Lajen,76,,6,7,13
039 Lajen,77,,5,6,11
039 Lajen,78,,6,6,12
039 Lajen,79,,5,11,16
039 Lajen,80,,10,2,12
039 Lajen,81,,2,7,9
039 Lajen,82,,6,5,11
039 Lajen,83,,4,6,10
039 Lajen,84,,5,7,12
039 Lajen,85,,6,8,14
039 Lajen,86,,4,6,10
039 Lajen,87,,1,3,4
039 Lajen,88,,1,6,7
039 Lajen,89,,1,4,5
039 Lajen,90,,1,4,5
039 Lajen,91,,-,2,2
039 Lajen,92,,-,1,1
039 Lajen,93,,-,1,1
039 Lajen,94,,-,1,1
039 Lajen,99,,1,-,1
039 Lajen,102,,-,1,1
039 Lajen,Insgesamt,,1.324,1.309,2.633
040 Leifers,0,,108,87,195
040 Leifers,1,,108,87,195
040 Leifers,2,,102,99,201
040 Leifers,3,,94,86,180
040 Leifers,4,,106,95,201
040 Leifers,5,,94,89,183
040 Leifers,6,,89,85,174
040 Leifers,7,,95,73,168
040 Leifers,8,,90,76,166
040 Leifers,9,,105,90,195
040 Leifers,10,,89,93,182
040 Leifers,11,,90,83,173
040 Leifers,12,,96,97,193
040 Leifers,13,,93,90,183
040 Leifers,14,,81,113,194
040 Leifers,15,,112,75,187
040 Leifers,16,,103,89,192
040 Leifers,17,,99,96,195
040 Leifers,18,,95,98,193
040 Leifers,19,,90,79,169
040 Leifers,20,,93,84,177
040 Leifers,21,,99,84,183
040 Leifers,22,,96,92,188
040 Leifers,23,,75,97,172
040 Leifers,24,,86,97,183
040 Leifers,25,,93,85,178
040 Leifers,26,,96,100,196
040 Leifers,27,,103,91,194
040 Leifers,28,,117,91,208
040 Leifers,29,,137,122,259
040 Leifers,30,,128,104,232
040 Leifers,31,,97,101,198
040 Leifers,32,,95,104,199
040 Leifers,33,,111,117,228
040 Leifers,34,,131,96,227
040 Leifers,35,,123,133,256
040 Leifers,36,,126,120,246
040 Leifers,37,,153,143,296
040 Leifers,38,,153,155,308
040 Leifers,39,,155,152,307
040 Leifers,40,,155,149,304
040 Leifers,41,,139,139,278
040 Leifers,42,,172,147,319
040 Leifers,43,,172,136,308
040 Leifers,44,,150,176,326
040 Leifers,45,,145,128,273
040 Leifers,46,,146,143,289
040 Leifers,47,,149,131,280
040 Leifers,48,,161,162,323
040 Leifers,49,,148,135,283
040 Leifers,50,,142,130,272
040 Leifers,51,,143,144,287
040 Leifers,52,,145,123,268
040 Leifers,53,,119,113,232
040 Leifers,54,,94,112,206
040 Leifers,55,,98,114,212
040 Leifers,56,,136,128,264
040 Leifers,57,,105,126,231
040 Leifers,58,,84,111,195
040 Leifers,59,,101,121,222
040 Leifers,60,,100,99,199
040 Leifers,61,,93,92,185
040 Leifers,62,,99,92,191
040 Leifers,63,,90,94,184
040 Leifers,64,,103,105,208
040 Leifers,65,,91,98,189
040 Leifers,66,,106,146,252
040 Leifers,67,,76,79,155
040 Leifers,68,,84,88,172
040 Leifers,69,,88,92,180
040 Leifers,70,,85,92,177
040 Leifers,71,,80,78,158
040 Leifers,72,,89,82,171
040 Leifers,73,,84,90,174
040 Leifers,74,,73,73,146
040 Leifers,75,,49,72,121
040 Leifers,76,,46,62,108
040 Leifers,77,,47,62,109
040 Leifers,78,,50,55,105
040 Leifers,79,,35,58,93
040 Leifers,80,,53,66,119
040 Leifers,81,,36,55,91
040 Leifers,82,,31,49,80
040 Leifers,83,,26,40,66
040 Leifers,84,,27,29,56
040 Leifers,85,,18,39,57
040 Leifers,86,,12,34,46
040 Leifers,87,,15,37,52
040 Leifers,88,,11,30,41
040 Leifers,89,,7,28,35
040 Leifers,90,,10,21,31
040 Leifers,91,,7,14,21
040 Leifers,92,,4,8,12
040 Leifers,93,,2,15,17
040 Leifers,94,,1,3,4
040 Leifers,95,,1,4,5
040 Leifers,96,,-,4,4
040 Leifers,97,,-,5,5
040 Leifers,98,,-,1,1
040 Leifers,99,,1,4,5
040 Leifers,100,,-,3,3
040 Leifers,103,,-,1,1
040 Leifers,Insgesamt,,8.740,8.815,17.555
041 Lana,0,,59,58,117
041 Lana,1,,69,71,140
041 Lana,2,,58,62,120
041 Lana,3,,67,47,114
041 Lana,4,,65,60,125
041 Lana,5,,70,56,126
041 Lana,6,,67,57,124
041 Lana,7,,70,65,135
041 Lana,8,,76,56,132
041 Lana,9,,61,62,123
041 Lana,10,,56,55,111
041 Lana,11,,73,55,128
041 Lana,12,,73,69,142
041 Lana,13,,72,62,134
041 Lana,14,,63,60,123
041 Lana,15,,63,68,131
041 Lana,16,,75,81,156
041 Lana,17,,67,66,133
041 Lana,18,,68,74,142
041 Lana,19,,62,67,129
041 Lana,20,,62,58,120
041 Lana,21,,61,58,119
041 Lana,22,,54,70,124
041 Lana,23,,48,76,124
041 Lana,24,,63,63,126
041 Lana,25,,77,60,137
041 Lana,26,,63,62,125
041 Lana,27,,54,75,129
041 Lana,28,,62,69,131
041 Lana,29,,95,79,174
041 Lana,30,,85,73,158
041 Lana,31,,62,79,141
041 Lana,32,,63,70,133
041 Lana,33,,78,92,170
041 Lana,34,,83,86,169
041 Lana,35,,65,70,135
041 Lana,36,,78,92,170
041 Lana,37,,67,90,157
041 Lana,38,,101,85,186
041 Lana,39,,81,93,174
041 Lana,40,,110,99,209
041 Lana,41,,99,111,210
041 Lana,42,,98,106,204
041 Lana,43,,122,80,202
041 Lana,44,,85,105,190
041 Lana,45,,92,96,188
041 Lana,46,,96,112,208
041 Lana,47,,96,92,188
041 Lana,48,,105,103,208
041 Lana,49,,105,81,186
041 Lana,50,,90,80,170
041 Lana,51,,87,87,174
041 Lana,52,,78,80,158
041 Lana,53,,82,79,161
041 Lana,54,,77,84,161
041 Lana,55,,71,76,147
041 Lana,56,,57,62,119
041 Lana,57,,58,75,133
041 Lana,58,,60,64,124
041 Lana,59,,54,58,112
041 Lana,60,,51,59,110
041 Lana,61,,48,66,114
041 Lana,62,,48,54,102
041 Lana,63,,52,56,108
041 Lana,64,,52,66,118
041 Lana,65,,55,48,103
041 Lana,66,,62,62,124
041 Lana,67,,38,50,88
041 Lana,68,,46,62,108
041 Lana,69,,54,54,108
041 Lana,70,,50,68,118
041 Lana,71,,48,43,91
041 Lana,72,,41,46,87
041 Lana,73,,49,52,101
041 Lana,74,,40,54,94
041 Lana,75,,32,34,66
041 Lana,76,,35,48,83
041 Lana,77,,31,30,61
041 Lana,78,,30,42,72
041 Lana,79,,25,42,67
041 Lana,80,,20,29,49
041 Lana,81,,20,36,56
041 Lana,82,,17,32,49
041 Lana,83,,15,31,46
041 Lana,84,,19,23,42
041 Lana,85,,18,25,43
041 Lana,86,,12,25,37
041 Lana,87,,10,31,41
041 Lana,88,,4,12,16
041 Lana,89,,9,20,29
041 Lana,90,,9,17,26
041 Lana,91,,5,16,21
041 Lana,92,,5,12,17
041 Lana,93,,1,7,8
041 Lana,94,,1,3,4
041 Lana,95,,3,4,7
041 Lana,96,,1,1,2
041 Lana,97,,-,2,2
041 Lana,98,,1,2,3
041 Lana,99,,-,3,3
041 Lana,101,,-,1,1
041 Lana,Insgesamt,,5.515,5.849,11.364
042 Laas,0,,23,29,52
042 Laas,1,,19,24,43
042 Laas,2,,36,28,64
042 Laas,3,,20,30,50
042 Laas,4,,22,25,47
042 Laas,5,,29,15,44
042 Laas,6,,19,30,49
042 Laas,7,,35,15,50
042 Laas,8,,23,21,44
042 Laas,9,,25,19,44
042 Laas,10,,30,16,46
042 Laas,11,,17,21,38
042 Laas,12,,25,24,49
042 Laas,13,,18,14,32
042 Laas,14,,26,32,58
042 Laas,15,,26,24,50
042 Laas,16,,30,35,65
042 Laas,17,,31,25,56
042 Laas,18,,24,27,51
042 Laas,19,,22,18,40
042 Laas,20,,17,25,42
042 Laas,21,,22,24,46
042 Laas,22,,20,26,46
042 Laas,23,,23,22,45
042 Laas,24,,21,18,39
042 Laas,25,,31,18,49
042 Laas,26,,30,15,45
042 Laas,27,,32,25,57
042 Laas,28,,29,35,64
042 Laas,29,,19,46,65
042 Laas,30,,29,28,57
042 Laas,31,,25,31,56
042 Laas,32,,20,22,42
042 Laas,33,,30,28,58
042 Laas,34,,20,33,53
042 Laas,35,,24,21,45
042 Laas,36,,28,27,55
042 Laas,37,,27,19,46
042 Laas,38,,41,31,72
042 Laas,39,,36,29,65
042 Laas,40,,28,22,50
042 Laas,41,,25,25,50
042 Laas,42,,39,25,64
042 Laas,43,,32,38,70
042 Laas,44,,36,32,68
042 Laas,45,,31,24,55
042 Laas,46,,34,25,59
042 Laas,47,,34,32,66
042 Laas,48,,29,29,58
042 Laas,49,,26,29,55
042 Laas,50,,36,28,64
042 Laas,51,,25,28,53
042 Laas,52,,39,25,64
042 Laas,53,,31,26,57
042 Laas,54,,26,26,52
042 Laas,55,,18,27,45
042 Laas,56,,22,17,39
042 Laas,57,,16,16,32
042 Laas,58,,16,25,41
042 Laas,59,,21,13,34
042 Laas,60,,29,25,54
042 Laas,61,,12,16,28
042 Laas,62,,20,24,44
042 Laas,63,,18,19,37
042 Laas,64,,17,21,38
042 Laas,65,,25,11,36
042 Laas,66,,13,15,28
042 Laas,67,,14,11,25
042 Laas,68,,11,15,26
042 Laas,69,,12,15,27
042 Laas,70,,16,19,35
042 Laas,71,,13,20,33
042 Laas,72,,17,21,38
042 Laas,73,,12,24,36
042 Laas,74,,17,11,28
042 Laas,75,,10,14,24
042 Laas,76,,17,10,27
042 Laas,77,,17,21,38
042 Laas,78,,9,18,27
042 Laas,79,,14,11,25
042 Laas,80,,11,13,24
042 Laas,81,,11,20,31
042 Laas,82,,9,12,21
042 Laas,83,,9,7,16
042 Laas,84,,10,11,21
042 Laas,85,,7,12,19
042 Laas,86,,11,7,18
042 Laas,87,,3,8,11
042 Laas,88,,2,15,17
042 Laas,89,,5,6,11
042 Laas,90,,3,9,12
042 Laas,91,,1,2,3
042 Laas,92,,2,5,7
042 Laas,93,,2,-,2
042 Laas,94,,1,-,1
042 Laas,96,,1,2,3
042 Laas,99,,-,1,1
042 Laas,100,,-,1,1
042 Laas,101,,-,1,1
042 Laas,Insgesamt,,1.989,1.980,3.969
043 Laurein,0,,1,1,2
043 Laurein,1,,3,-,3
043 Laurein,2,,2,1,3
043 Laurein,3,,2,3,5
043 Laurein,4,,2,1,3
043 Laurein,5,,1,-,1
043 Laurein,6,,7,-,7
043 Laurein,7,,3,4,7
043 Laurein,8,,3,1,4
043 Laurein,9,,2,3,5
043 Laurein,10,,2,3,5
043 Laurein,11,,7,1,8
043 Laurein,12,,3,7,10
043 Laurein,13,,2,1,3
043 Laurein,14,,4,3,7
043 Laurein,15,,3,5,8
043 Laurein,16,,1,2,3
043 Laurein,17,,2,2,4
043 Laurein,18,,2,4,6
043 Laurein,19,,1,5,6
043 Laurein,20,,1,1,2
043 Laurein,21,,1,1,2
043 Laurein,22,,4,-,4
043 Laurein,23,,3,2,5
043 Laurein,24,,1,-,1
043 Laurein,25,,2,3,5
043 Laurein,26,,4,2,6
043 Laurein,27,,2,2,4
043 Laurein,28,,1,1,2
043 Laurein,30,,1,1,2
043 Laurein,31,,3,-,3
043 Laurein,32,,2,-,2
043 Laurein,33,,1,-,1
043 Laurein,34,,3,5,8
043 Laurein,35,,1,2,3
043 Laurein,36,,5,1,6
043 Laurein,37,,-,3,3
043 Laurein,38,,-,1,1
043 Laurein,39,,5,2,7
043 Laurein,40,,1,2,3
043 Laurein,41,,5,5,10
043 Laurein,42,,4,3,7
043 Laurein,43,,6,3,9
043 Laurein,44,,-,2,2
043 Laurein,45,,4,6,10
043 Laurein,46,,5,3,8
043 Laurein,47,,5,1,6
043 Laurein,48,,4,3,7
043 Laurein,49,,-,2,2
043 Laurein,50,,1,2,3
043 Laurein,51,,5,3,8
043 Laurein,52,,1,-,1
043 Laurein,53,,4,4,8
043 Laurein,54,,2,2,4
043 Laurein,55,,7,-,7
043 Laurein,57,,2,-,2
043 Laurein,58,,3,1,4
043 Laurein,59,,2,1,3
043 Laurein,60,,2,-,2
043 Laurein,62,,1,1,2
043 Laurein,63,,2,2,4
043 Laurein,64,,2,-,2
043 Laurein,65,,2,3,5
043 Laurein,66,,-,1,1
043 Laurein,67,,-,1,1
043 Laurein,68,,-,1,1
043 Laurein,69,,1,-,1
043 Laurein,70,,1,-,1
043 Laurein,72,,2,2,4
043 Laurein,73,,1,2,3
043 Laurein,74,,1,1,2
043 Laurein,75,,2,1,3
043 Laurein,76,,1,2,3
043 Laurein,77,,-,3,3
043 Laurein,78,,1,5,6
043 Laurein,79,,1,-,1
043 Laurein,80,,2,2,4
043 Laurein,81,,-,3,3
043 Laurein,82,,-,4,4
043 Laurein,83,,2,-,2
043 Laurein,84,,5,-,5
043 Laurein,85,,3,1,4
043 Laurein,86,,1,-,1
043 Laurein,87,,-,1,1
043 Laurein,88,,-,1,1
043 Laurein,90,,-,1,1
043 Laurein,91,,-,1,1
043 Laurein,92,,1,-,1
043 Laurein,99,,-,1,1
043 Laurein,Insgesamt,,188,157,345
044 Lüsen,0,,8,7,15
044 Lüsen,1,,11,7,18
044 Lüsen,2,,12,9,21
044 Lüsen,3,,11,9,20
044 Lüsen,4,,8,8,16
044 Lüsen,5,,11,12,23
044 Lüsen,6,,10,14,24
044 Lüsen,7,,9,9,18
044 Lüsen,8,,10,11,21
044 Lüsen,9,,12,9,21
044 Lüsen,10,,9,9,18
044 Lüsen,11,,10,11,21
044 Lüsen,12,,14,11,25
044 Lüsen,13,,6,9,15
044 Lüsen,14,,11,11,22
044 Lüsen,15,,15,6,21
044 Lüsen,16,,7,12,19
044 Lüsen,17,,9,12,21
044 Lüsen,18,,13,13,26
044 Lüsen,19,,8,8,16
044 Lüsen,20,,11,8,19
044 Lüsen,21,,9,8,17
044 Lüsen,22,,6,11,17
044 Lüsen,23,,15,8,23
044 Lüsen,24,,9,8,17
044 Lüsen,25,,7,5,12
044 Lüsen,26,,12,9,21
044 Lüsen,27,,3,2,5
044 Lüsen,28,,9,15,24
044 Lüsen,29,,4,8,12
044 Lüsen,30,,10,9,19
044 Lüsen,31,,10,12,22
044 Lüsen,32,,13,9,22
044 Lüsen,33,,10,10,20
044 Lüsen,34,,16,18,34
044 Lüsen,35,,8,14,22
044 Lüsen,36,,11,10,21
044 Lüsen,37,,13,12,25
044 Lüsen,38,,14,14,28
044 Lüsen,39,,8,7,15
044 Lüsen,40,,8,9,17
044 Lüsen,41,,16,9,25
044 Lüsen,42,,18,13,31
044 Lüsen,43,,9,11,20
044 Lüsen,44,,13,16,29
044 Lüsen,45,,10,20,30
044 Lüsen,46,,17,12,29
044 Lüsen,47,,18,13,31
044 Lüsen,48,,12,8,20
044 Lüsen,49,,13,13,26
044 Lüsen,50,,7,11,18
044 Lüsen,51,,12,9,21
044 Lüsen,52,,9,12,21
044 Lüsen,53,,9,6,15
044 Lüsen,54,,11,12,23
044 Lüsen,55,,10,9,19
044 Lüsen,56,,7,10,17
044 Lüsen,57,,6,7,13
044 Lüsen,58,,10,7,17
044 Lüsen,59,,6,11,17
044 Lüsen,60,,9,4,13
044 Lüsen,61,,5,7,12
044 Lüsen,62,,7,9,16
044 Lüsen,63,,7,10,17
044 Lüsen,64,,8,1,9
044 Lüsen,65,,5,5,10
044 Lüsen,66,,9,6,15
044 Lüsen,67,,3,9,12
044 Lüsen,68,,5,3,8
044 Lüsen,69,,8,8,16
044 Lüsen,70,,2,6,8
044 Lüsen,71,,5,3,8
044 Lüsen,72,,3,10,13
044 Lüsen,73,,8,7,15
044 Lüsen,74,,6,5,11
044 Lüsen,75,,7,4,11
044 Lüsen,76,,4,8,12
044 Lüsen,77,,3,4,7
044 Lüsen,78,,3,3,6
044 Lüsen,79,,7,3,10
044 Lüsen,80,,2,8,10
044 Lüsen,81,,4,4,8
044 Lüsen,82,,-,5,5
044 Lüsen,83,,1,3,4
044 Lüsen,84,,2,5,7
044 Lüsen,85,,2,2,4
044 Lüsen,86,,2,4,6
044 Lüsen,87,,1,3,4
044 Lüsen,88,,1,2,3
044 Lüsen,89,,1,3,4
044 Lüsen,90,,1,1,2
044 Lüsen,91,,1,4,5
044 Lüsen,99,,-,1,1
044 Lüsen,Insgesamt,,755,772,1.527
045 Margreid a.d. Weinstr.,0,,4,6,10
045 Margreid a.d. Weinstr.,1,,3,7,10
045 Margreid a.d. Weinstr.,2,,4,9,13
045 Margreid a.d. Weinstr.,3,,7,5,12
045 Margreid a.d. Weinstr.,4,,10,9,19
045 Margreid a.d. Weinstr.,5,,6,5,11
045 Margreid a.d. Weinstr.,6,,8,4,12
045 Margreid a.d. Weinstr.,7,,7,11,18
045 Margreid a.d. Weinstr.,8,,9,9,18
045 Margreid a.d. Weinstr.,9,,6,4,10
045 Margreid a.d. Weinstr.,10,,9,8,17
045 Margreid a.d. Weinstr.,11,,12,10,22
045 Margreid a.d. Weinstr.,12,,8,6,14
045 Margreid a.d. Weinstr.,13,,7,10,17
045 Margreid a.d. Weinstr.,14,,2,11,13
045 Margreid a.d. Weinstr.,15,,10,15,25
045 Margreid a.d. Weinstr.,16,,5,2,7
045 Margreid a.d. Weinstr.,17,,2,6,8
045 Margreid a.d. Weinstr.,18,,7,6,13
045 Margreid a.d. Weinstr.,19,,5,13,18
045 Margreid a.d. Weinstr.,20,,1,2,3
045 Margreid a.d. Weinstr.,21,,5,6,11
045 Margreid a.d. Weinstr.,22,,6,10,16
045 Margreid a.d. Weinstr.,23,,7,7,14
045 Margreid a.d. Weinstr.,24,,8,9,17
045 Margreid a.d. Weinstr.,25,,7,7,14
045 Margreid a.d. Weinstr.,26,,7,11,18
045 Margreid a.d. Weinstr.,27,,12,2,14
045 Margreid a.d. Weinstr.,28,,7,9,16
045 Margreid a.d. Weinstr.,29,,8,10,18
045 Margreid a.d. Weinstr.,30,,12,12,24
045 Margreid a.d. Weinstr.,31,,18,9,27
045 Margreid a.d. Weinstr.,32,,4,7,11
045 Margreid a.d. Weinstr.,33,,12,3,15
045 Margreid a.d. Weinstr.,34,,8,10,18
045 Margreid a.d. Weinstr.,35,,8,11,19
045 Margreid a.d. Weinstr.,36,,11,16,27
045 Margreid a.d. Weinstr.,37,,8,9,17
045 Margreid a.d. Weinstr.,38,,10,6,16
045 Margreid a.d. Weinstr.,39,,10,10,20
045 Margreid a.d. Weinstr.,40,,6,5,11
045 Margreid a.d. Weinstr.,41,,10,12,22
045 Margreid a.d. Weinstr.,42,,11,10,21
045 Margreid a.d. Weinstr.,43,,8,10,18
045 Margreid a.d. Weinstr.,44,,22,16,38
045 Margreid a.d. Weinstr.,45,,12,18,30
045 Margreid a.d. Weinstr.,46,,19,9,28
045 Margreid a.d. Weinstr.,47,,12,3,15
045 Margreid a.d. Weinstr.,48,,5,4,9
045 Margreid a.d. Weinstr.,49,,9,11,20
045 Margreid a.d. Weinstr.,50,,7,15,22
045 Margreid a.d. Weinstr.,51,,15,13,28
045 Margreid a.d. Weinstr.,52,,14,11,25
045 Margreid a.d. Weinstr.,53,,8,11,19
045 Margreid a.d. Weinstr.,54,,7,6,13
045 Margreid a.d. Weinstr.,55,,9,6,15
045 Margreid a.d. Weinstr.,56,,15,8,23
045 Margreid a.d. Weinstr.,57,,8,8,16
045 Margreid a.d. Weinstr.,58,,5,4,9
045 Margreid a.d. Weinstr.,59,,7,8,15
045 Margreid a.d. Weinstr.,60,,6,7,13
045 Margreid a.d. Weinstr.,61,,4,8,12
045 Margreid a.d. Weinstr.,62,,7,6,13
045 Margreid a.d. Weinstr.,63,,7,3,10
045 Margreid a.d. Weinstr.,64,,5,9,14
045 Margreid a.d. Weinstr.,65,,6,6,12
045 Margreid a.d. Weinstr.,66,,2,3,5
045 Margreid a.d. Weinstr.,67,,6,7,13
045 Margreid a.d. Weinstr.,68,,3,5,8
045 Margreid a.d. Weinstr.,69,,6,3,9
045 Margreid a.d. Weinstr.,70,,9,5,14
045 Margreid a.d. Weinstr.,71,,7,5,12
045 Margreid a.d. Weinstr.,72,,5,4,9
045 Margreid a.d. Weinstr.,73,,3,6,9
045 Margreid a.d. Weinstr.,74,,3,9,12
045 Margreid a.d. Weinstr.,75,,4,3,7
045 Margreid a.d. Weinstr.,76,,6,4,10
045 Margreid a.d. Weinstr.,77,,2,6,8
045 Margreid a.d. Weinstr.,78,,5,4,9
045 Margreid a.d. Weinstr.,79,,2,3,5
045 Margreid a.d. Weinstr.,80,,4,4,8
045 Margreid a.d. Weinstr.,81,,3,5,8
045 Margreid a.d. Weinstr.,82,,6,1,7
045 Margreid a.d. Weinstr.,83,,1,4,5
045 Margreid a.d. Weinstr.,84,,1,1,2
045 Margreid a.d. Weinstr.,85,,-,3,3
045 Margreid a.d. Weinstr.,86,,1,6,7
045 Margreid a.d. Weinstr.,87,,2,2,4
045 Margreid a.d. Weinstr.,88,,1,4,5
045 Margreid a.d. Weinstr.,89,,1,3,4
045 Margreid a.d. Weinstr.,90,,-,1,1
045 Margreid a.d. Weinstr.,91,,-,1,1
045 Margreid a.d. Weinstr.,92,,-,1,1
045 Margreid a.d. Weinstr.,93,,-,3,3
045 Margreid a.d. Weinstr.,94,,1,-,1
045 Margreid a.d. Weinstr.,96,,-,1,1
045 Margreid a.d. Weinstr.,Insgesamt,,628,656,1.284
046 Mals,0,,29,19,48
046 Mals,1,,31,22,53
046 Mals,2,,34,26,60
046 Mals,3,,30,16,46
046 Mals,4,,28,24,52
046 Mals,5,,23,31,54
046 Mals,6,,35,37,72
046 Mals,7,,27,32,59
046 Mals,8,,29,24,53
046 Mals,9,,31,22,53
046 Mals,10,,22,28,50
046 Mals,11,,31,30,61
046 Mals,12,,30,37,67
046 Mals,13,,41,30,71
046 Mals,14,,35,35,70
046 Mals,15,,30,32,62
046 Mals,16,,35,26,61
046 Mals,17,,35,41,76
046 Mals,18,,38,31,69
046 Mals,19,,37,33,70
046 Mals,20,,31,30,61
046 Mals,21,,38,34,72
046 Mals,22,,34,30,64
046 Mals,23,,40,35,75
046 Mals,24,,33,26,59
046 Mals,25,,31,33,64
046 Mals,26,,27,41,68
046 Mals,27,,34,37,71
046 Mals,28,,37,29,66
046 Mals,29,,33,32,65
046 Mals,30,,36,34,70
046 Mals,31,,37,38,75
046 Mals,32,,43,31,74
046 Mals,33,,30,32,62
046 Mals,34,,43,30,73
046 Mals,35,,34,29,63
046 Mals,36,,31,31,62
046 Mals,37,,39,32,71
046 Mals,38,,50,28,78
046 Mals,39,,34,39,73
046 Mals,40,,29,49,78
046 Mals,41,,36,47,83
046 Mals,42,,47,47,94
046 Mals,43,,46,44,90
046 Mals,44,,55,38,93
046 Mals,45,,51,32,83
046 Mals,46,,55,55,110
046 Mals,47,,51,40,91
046 Mals,48,,49,41,90
046 Mals,49,,49,54,103
046 Mals,50,,38,27,65
046 Mals,51,,51,35,86
046 Mals,52,,33,41,74
046 Mals,53,,35,34,69
046 Mals,54,,30,24,54
046 Mals,55,,37,34,71
046 Mals,56,,33,26,59
046 Mals,57,,29,24,53
046 Mals,58,,20,20,40
046 Mals,59,,33,31,64
046 Mals,60,,28,24,52
046 Mals,61,,30,20,50
046 Mals,62,,33,22,55
046 Mals,63,,19,24,43
046 Mals,64,,26,14,40
046 Mals,65,,21,19,40
046 Mals,66,,18,27,45
046 Mals,67,,10,18,28
046 Mals,68,,28,14,42
046 Mals,69,,22,19,41
046 Mals,70,,18,23,41
046 Mals,71,,16,16,32
046 Mals,72,,19,27,46
046 Mals,73,,22,27,49
046 Mals,74,,18,21,39
046 Mals,75,,12,26,38
046 Mals,76,,17,16,33
046 Mals,77,,13,18,31
046 Mals,78,,11,12,23
046 Mals,79,,11,20,31
046 Mals,80,,14,11,25
046 Mals,81,,7,15,22
046 Mals,82,,19,15,34
046 Mals,83,,13,8,21
046 Mals,84,,9,9,18
046 Mals,85,,7,12,19
046 Mals,86,,4,14,18
046 Mals,87,,4,11,15
046 Mals,88,,3,9,12
046 Mals,89,,-,6,6
046 Mals,90,,7,8,15
046 Mals,91,,3,5,8
046 Mals,92,,-,5,5
046 Mals,93,,1,7,8
046 Mals,94,,1,-,1
046 Mals,95,,1,1,2
046 Mals,97,,-,1,1
046 Mals,98,,1,-,1
046 Mals,102,,-,1,1
046 Mals,Insgesamt,,2.639,2.515,5.154
047 Enneberg,0,,16,16,32
047 Enneberg,1,,24,17,41
047 Enneberg,2,,18,11,29
047 Enneberg,3,,14,12,26
047 Enneberg,4,,15,20,35
047 Enneberg,5,,16,17,33
047 Enneberg,6,,22,19,41
047 Enneberg,7,,21,17,38
047 Enneberg,8,,14,18,32
047 Enneberg,9,,21,27,48
047 Enneberg,10,,18,14,32
047 Enneberg,11,,28,16,44
047 Enneberg,12,,19,21,40
047 Enneberg,13,,26,18,44
047 Enneberg,14,,18,9,27
047 Enneberg,15,,23,15,38
047 Enneberg,16,,17,13,30
047 Enneberg,17,,22,9,31
047 Enneberg,18,,21,15,36
047 Enneberg,19,,20,18,38
047 Enneberg,20,,15,15,30
047 Enneberg,21,,17,22,39
047 Enneberg,22,,16,18,34
047 Enneberg,23,,23,16,39
047 Enneberg,24,,20,14,34
047 Enneberg,25,,19,15,34
047 Enneberg,26,,19,11,30
047 Enneberg,27,,24,21,45
047 Enneberg,28,,22,17,39
047 Enneberg,29,,18,17,35
047 Enneberg,30,,23,18,41
047 Enneberg,31,,21,27,48
047 Enneberg,32,,21,20,41
047 Enneberg,33,,13,18,31
047 Enneberg,34,,21,25,46
047 Enneberg,35,,23,21,44
047 Enneberg,36,,13,17,30
047 Enneberg,37,,15,26,41
047 Enneberg,38,,25,34,59
047 Enneberg,39,,26,22,48
047 Enneberg,40,,25,27,52
047 Enneberg,41,,28,36,64
047 Enneberg,42,,28,19,47
047 Enneberg,43,,31,18,49
047 Enneberg,44,,23,24,47
047 Enneberg,45,,25,20,45
047 Enneberg,46,,18,20,38
047 Enneberg,47,,28,21,49
047 Enneberg,48,,22,21,43
047 Enneberg,49,,21,19,40
047 Enneberg,50,,17,15,32
047 Enneberg,51,,18,17,35
047 Enneberg,52,,15,16,31
047 Enneberg,53,,23,15,38
047 Enneberg,54,,20,11,31
047 Enneberg,55,,15,15,30
047 Enneberg,56,,14,18,32
047 Enneberg,57,,14,14,28
047 Enneberg,58,,14,13,27
047 Enneberg,59,,17,21,38
047 Enneberg,60,,14,17,31
047 Enneberg,61,,17,10,27
047 Enneberg,62,,10,15,25
047 Enneberg,63,,17,8,25
047 Enneberg,64,,15,14,29
047 Enneberg,65,,9,11,20
047 Enneberg,66,,11,18,29
047 Enneberg,67,,4,12,16
047 Enneberg,68,,18,17,35
047 Enneberg,69,,17,10,27
047 Enneberg,70,,10,19,29
047 Enneberg,71,,13,12,25
047 Enneberg,72,,9,7,16
047 Enneberg,73,,14,9,23
047 Enneberg,74,,12,17,29
047 Enneberg,75,,14,12,26
047 Enneberg,76,,9,11,20
047 Enneberg,77,,11,15,26
047 Enneberg,78,,7,10,17
047 Enneberg,79,,10,8,18
047 Enneberg,80,,6,16,22
047 Enneberg,81,,8,10,18
047 Enneberg,82,,11,12,23
047 Enneberg,83,,4,7,11
047 Enneberg,84,,6,8,14
047 Enneberg,85,,4,4,8
047 Enneberg,86,,4,5,9
047 Enneberg,87,,8,5,13
047 Enneberg,88,,1,3,4
047 Enneberg,89,,1,7,8
047 Enneberg,90,,5,5,10
047 Enneberg,91,,1,3,4
047 Enneberg,92,,2,1,3
047 Enneberg,93,,-,2,2
047 Enneberg,94,,-,2,2
047 Enneberg,95,,-,1,1
047 Enneberg,96,,-,2,2
047 Enneberg,97,,-,2,2
047 Enneberg,98,,-,1,1
047 Enneberg,Insgesamt,,1.505,1.444,2.949
048 Marling,0,,14,11,25
048 Marling,1,,18,7,25
048 Marling,2,,16,7,23
048 Marling,3,,19,8,27
048 Marling,4,,10,12,22
048 Marling,5,,18,12,30
048 Marling,6,,10,17,27
048 Marling,7,,26,12,38
048 Marling,8,,14,14,28
048 Marling,9,,11,11,22
048 Marling,10,,15,17,32
048 Marling,11,,9,16,25
048 Marling,12,,16,16,32
048 Marling,13,,13,10,23
048 Marling,14,,11,11,22
048 Marling,15,,14,9,23
048 Marling,16,,12,14,26
048 Marling,17,,20,13,33
048 Marling,18,,12,8,20
048 Marling,19,,19,11,30
048 Marling,20,,19,17,36
048 Marling,21,,13,15,28
048 Marling,22,,13,16,29
048 Marling,23,,15,21,36
048 Marling,24,,17,15,32
048 Marling,25,,9,18,27
048 Marling,26,,10,11,21
048 Marling,27,,11,21,32
048 Marling,28,,12,8,20
048 Marling,29,,18,24,42
048 Marling,30,,16,11,27
048 Marling,31,,20,12,32
048 Marling,32,,22,15,37
048 Marling,33,,17,21,38
048 Marling,34,,19,17,36
048 Marling,35,,18,18,36
048 Marling,36,,17,26,43
048 Marling,37,,21,16,37
048 Marling,38,,18,12,30
048 Marling,39,,19,21,40
048 Marling,40,,18,18,36
048 Marling,41,,25,18,43
048 Marling,42,,20,21,41
048 Marling,43,,19,21,40
048 Marling,44,,27,21,48
048 Marling,45,,19,20,39
048 Marling,46,,25,27,52
048 Marling,47,,27,18,45
048 Marling,48,,27,22,49
048 Marling,49,,28,29,57
048 Marling,50,,20,18,38
048 Marling,51,,25,14,39
048 Marling,52,,17,22,39
048 Marling,53,,18,17,35
048 Marling,54,,16,11,27
048 Marling,55,,14,9,23
048 Marling,56,,9,11,20
048 Marling,57,,13,10,23
048 Marling,58,,16,13,29
048 Marling,59,,11,16,27
048 Marling,60,,13,14,27
048 Marling,61,,6,15,21
048 Marling,62,,14,14,28
048 Marling,63,,19,18,37
048 Marling,64,,5,15,20
048 Marling,65,,15,14,29
048 Marling,66,,12,15,27
048 Marling,67,,19,13,32
048 Marling,68,,15,16,31
048 Marling,69,,9,17,26
048 Marling,70,,9,11,20
048 Marling,71,,20,17,37
048 Marling,72,,11,12,23
048 Marling,73,,14,15,29
048 Marling,74,,8,12,20
048 Marling,75,,10,15,25
048 Marling,76,,14,8,22
048 Marling,77,,3,16,19
048 Marling,78,,9,8,17
048 Marling,79,,7,12,19
048 Marling,80,,7,9,16
048 Marling,81,,8,8,16
048 Marling,82,,3,8,11
048 Marling,83,,5,5,10
048 Marling,84,,5,-,5
048 Marling,85,,7,7,14
048 Marling,86,,1,8,9
048 Marling,87,,1,9,10
048 Marling,88,,-,5,5
048 Marling,89,,1,4,5
048 Marling,90,,1,2,3
048 Marling,91,,2,3,5
048 Marling,92,,-,1,1
048 Marling,93,,1,-,1
048 Marling,94,,1,1,2
048 Marling,96,,-,1,1
048 Marling,97,,1,-,1
048 Marling,98,,1,-,1
048 Marling,Insgesamt,,1.292,1.275,2.567
049 Martell,0,,5,6,11
049 Martell,1,,9,4,13
049 Martell,2,,9,4,13
049 Martell,3,,3,3,6
049 Martell,4,,6,1,7
049 Martell,5,,7,-,7
049 Martell,6,,4,5,9
049 Martell,7,,8,2,10
049 Martell,8,,6,1,7
049 Martell,9,,5,5,10
049 Martell,10,,4,5,9
049 Martell,11,,4,7,11
049 Martell,12,,8,2,10
049 Martell,13,,2,6,8
049 Martell,14,,6,6,12
049 Martell,15,,5,9,14
049 Martell,16,,4,6,10
049 Martell,17,,6,8,14
049 Martell,18,,6,8,14
049 Martell,19,,6,5,11
049 Martell,20,,4,4,8
049 Martell,21,,8,5,13
049 Martell,22,,6,4,10
049 Martell,23,,8,4,12
049 Martell,24,,4,1,5
049 Martell,25,,8,6,14
049 Martell,26,,-,2,2
049 Martell,27,,4,5,9
049 Martell,28,,5,2,7
049 Martell,29,,8,5,13
049 Martell,30,,5,9,14
049 Martell,31,,4,6,10
049 Martell,32,,9,2,11
049 Martell,33,,7,3,10
049 Martell,34,,3,4,7
049 Martell,35,,7,3,10
049 Martell,36,,5,4,9
049 Martell,37,,2,7,9
049 Martell,38,,7,10,17
049 Martell,39,,9,5,14
049 Martell,40,,5,8,13
049 Martell,41,,9,6,15
049 Martell,42,,8,4,12
049 Martell,43,,6,13,19
049 Martell,44,,9,6,15
049 Martell,45,,5,7,12
049 Martell,46,,15,7,22
049 Martell,47,,17,11,28
049 Martell,48,,7,9,16
049 Martell,49,,14,1,15
049 Martell,50,,11,7,18
049 Martell,51,,8,5,13
049 Martell,52,,9,3,12
049 Martell,53,,8,6,14
049 Martell,54,,7,6,13
049 Martell,55,,7,3,10
049 Martell,56,,5,4,9
049 Martell,57,,7,4,11
049 Martell,58,,5,6,11
049 Martell,59,,4,4,8
049 Martell,60,,3,3,6
049 Martell,61,,5,7,12
049 Martell,62,,2,5,7
049 Martell,63,,3,1,4
049 Martell,64,,4,4,8
049 Martell,65,,4,3,7
049 Martell,66,,3,-,3
049 Martell,67,,4,1,5
049 Martell,68,,1,3,4
049 Martell,69,,3,4,7
049 Martell,70,,6,5,11
049 Martell,71,,3,4,7
049 Martell,72,,6,2,8
049 Martell,73,,2,4,6
049 Martell,74,,2,5,7
049 Martell,75,,2,4,6
049 Martell,76,,2,4,6
049 Martell,77,,4,7,11
049 Martell,78,,6,1,7
049 Martell,79,,4,6,10
049 Martell,80,,2,2,4
049 Martell,81,,4,-,4
049 Martell,82,,4,4,8
049 Martell,83,,2,2,4
049 Martell,84,,1,1,2
049 Martell,85,,2,3,5
049 Martell,86,,-,5,5
049 Martell,87,,2,1,3
049 Martell,88,,2,3,5
049 Martell,89,,-,2,2
049 Martell,90,,1,1,2
049 Martell,97,,-,1,1
049 Martell,Insgesamt,,481,402,883
050 Mölten,0,,9,6,15
050 Mölten,1,,15,14,29
050 Mölten,2,,6,11,17
050 Mölten,3,,14,14,28
050 Mölten,4,,11,14,25
050 Mölten,5,,13,9,22
050 Mölten,6,,8,8,16
050 Mölten,7,,10,12,22
050 Mölten,8,,11,10,21
050 Mölten,9,,11,9,20
050 Mölten,10,,16,11,27
050 Mölten,11,,16,16,32
050 Mölten,12,,13,15,28
050 Mölten,13,,12,16,28
050 Mölten,14,,8,16,24
050 Mölten,15,,10,7,17
050 Mölten,16,,15,13,28
050 Mölten,17,,12,9,21
050 Mölten,18,,13,5,18
050 Mölten,19,,12,11,23
050 Mölten,20,,6,13,19
050 Mölten,21,,10,6,16
050 Mölten,22,,12,5,17
050 Mölten,23,,12,4,16
050 Mölten,24,,8,10,18
050 Mölten,25,,9,9,18
050 Mölten,26,,10,5,15
050 Mölten,27,,7,8,15
050 Mölten,28,,7,4,11
050 Mölten,29,,9,12,21
050 Mölten,30,,10,13,23
050 Mölten,31,,13,11,24
050 Mölten,32,,17,7,24
050 Mölten,33,,12,13,25
050 Mölten,34,,12,8,20
050 Mölten,35,,9,11,20
050 Mölten,36,,10,20,30
050 Mölten,37,,25,11,36
050 Mölten,38,,12,9,21
050 Mölten,39,,15,17,32
050 Mölten,40,,9,11,20
050 Mölten,41,,15,15,30
050 Mölten,42,,17,12,29
050 Mölten,43,,15,13,28
050 Mölten,44,,16,17,33
050 Mölten,45,,18,15,33
050 Mölten,46,,17,13,30
050 Mölten,47,,11,14,25
050 Mölten,48,,20,16,36
050 Mölten,49,,18,7,25
050 Mölten,50,,16,10,26
050 Mölten,51,,15,10,25
050 Mölten,52,,10,9,19
050 Mölten,53,,14,6,20
050 Mölten,54,,4,9,13
050 Mölten,55,,7,3,10
050 Mölten,56,,6,9,15
050 Mölten,57,,12,8,20
050 Mölten,58,,6,8,14
050 Mölten,59,,7,7,14
050 Mölten,60,,7,6,13
050 Mölten,61,,5,5,10
050 Mölten,62,,9,9,18
050 Mölten,63,,8,6,14
050 Mölten,64,,7,4,11
050 Mölten,65,,3,7,10
050 Mölten,66,,8,4,12
050 Mölten,67,,7,5,12
050 Mölten,68,,2,7,9
050 Mölten,69,,11,8,19
050 Mölten,70,,7,9,16
050 Mölten,71,,8,4,12
050 Mölten,72,,5,7,12
050 Mölten,73,,5,6,11
050 Mölten,74,,3,3,6
050 Mölten,75,,4,6,10
050 Mölten,76,,2,4,6
050 Mölten,77,,8,6,14
050 Mölten,78,,8,4,12
050 Mölten,79,,5,8,13
050 Mölten,80,,3,5,8
050 Mölten,81,,8,2,10
050 Mölten,82,,5,2,7
050 Mölten,83,,1,6,7
050 Mölten,84,,1,3,4
050 Mölten,85,,1,1,2
050 Mölten,86,,1,4,5
050 Mölten,87,,1,3,4
050 Mölten,89,,3,2,5
050 Mölten,90,,1,2,3
050 Mölten,91,,-,2,2
050 Mölten,92,,-,4,4
050 Mölten,93,,-,2,2
050 Mölten,98,,-,1,1
050 Mölten,Insgesamt,,860,791,1.651
051 Meran,0,,171,153,324
051 Meran,1,,185,198,383
051 Meran,2,,192,195,387
051 Meran,3,,197,177,374
051 Meran,4,,198,172,370
051 Meran,5,,223,201,424
051 Meran,6,,207,205,412
051 Meran,7,,187,178,365
051 Meran,8,,237,174,411
051 Meran,9,,188,166,354
051 Meran,10,,194,170,364
051 Meran,11,,207,190,397
051 Meran,12,,203,172,375
051 Meran,13,,185,191,376
051 Meran,14,,169,168,337
051 Meran,15,,201,171,372
051 Meran,16,,208,174,382
051 Meran,17,,186,170,356
051 Meran,18,,183,203,386
051 Meran,19,,158,166,324
051 Meran,20,,197,161,358
051 Meran,21,,183,207,390
051 Meran,22,,187,174,361
051 Meran,23,,218,196,414
051 Meran,24,,217,175,392
051 Meran,25,,211,198,409
051 Meran,26,,213,182,395
051 Meran,27,,204,245,449
051 Meran,28,,233,221,454
051 Meran,29,,221,237,458
051 Meran,30,,239,244,483
051 Meran,31,,250,242,492
051 Meran,32,,267,215,482
051 Meran,33,,229,228,457
051 Meran,34,,265,245,510
051 Meran,35,,248,274,522
051 Meran,36,,250,285,535
051 Meran,37,,269,286,555
051 Meran,38,,284,315,599
051 Meran,39,,280,305,585
051 Meran,40,,307,314,621
051 Meran,41,,335,299,634
051 Meran,42,,319,338,657
051 Meran,43,,342,330,672
051 Meran,44,,367,352,719
051 Meran,45,,372,340,712
051 Meran,46,,327,310,637
051 Meran,47,,332,344,676
051 Meran,48,,353,317,670
051 Meran,49,,350,303,653
051 Meran,50,,275,301,576
051 Meran,51,,289,314,603
051 Meran,52,,288,284,572
051 Meran,53,,268,253,521
051 Meran,54,,267,253,520
051 Meran,55,,224,262,486
051 Meran,56,,225,231,456
051 Meran,57,,201,232,433
051 Meran,58,,189,234,423
051 Meran,59,,181,234,415
051 Meran,60,,205,226,431
051 Meran,61,,197,225,422
051 Meran,62,,188,234,422
051 Meran,63,,231,251,482
051 Meran,64,,206,265,471
051 Meran,65,,223,281,504
051 Meran,66,,237,287,524
051 Meran,67,,187,212,399
051 Meran,68,,192,227,419
051 Meran,69,,248,236,484
051 Meran,70,,238,297,535
051 Meran,71,,212,276,488
051 Meran,72,,166,223,389
051 Meran,73,,177,239,416
051 Meran,74,,156,223,379
051 Meran,75,,164,215,379
051 Meran,76,,141,191,332
051 Meran,77,,137,193,330
051 Meran,78,,131,165,296
051 Meran,79,,127,156,283
051 Meran,80,,111,166,277
051 Meran,81,,85,151,236
051 Meran,82,,95,168,263
051 Meran,83,,74,129,203
051 Meran,84,,68,143,211
051 Meran,85,,62,100,162
051 Meran,86,,56,128,184
051 Meran,87,,41,115,156
051 Meran,88,,48,100,148
051 Meran,89,,30,97,127
051 Meran,90,,40,87,127
051 Meran,91,,15,88,103
051 Meran,92,,15,59,74
051 Meran,93,,13,35,48
051 Meran,94,,1,20,21
051 Meran,95,,6,20,26
051 Meran,96,,5,10,15
051 Meran,97,,3,17,20
051 Meran,98,,5,11,16
051 Meran,99,,3,7,10
051 Meran,100,,3,5,8
051 Meran,101,,2,1,3
051 Meran,102,,-,1,1
051 Meran,103,,-,1,1
051 Meran,104,,-,2,2
051 Meran,106,,-,1,1
051 Meran,Insgesamt,,18.899,20.358,39.257
052 Welsberg-Taisten,0,,12,13,25
052 Welsberg-Taisten,1,,16,16,32
052 Welsberg-Taisten,2,,9,18,27
052 Welsberg-Taisten,3,,12,14,26
052 Welsberg-Taisten,4,,25,21,46
052 Welsberg-Taisten,5,,20,22,42
052 Welsberg-Taisten,6,,11,27,38
052 Welsberg-Taisten,7,,22,27,49
052 Welsberg-Taisten,8,,13,20,33
052 Welsberg-Taisten,9,,18,16,34
052 Welsberg-Taisten,10,,21,23,44
052 Welsberg-Taisten,11,,32,19,51
052 Welsberg-Taisten,12,,18,14,32
052 Welsberg-Taisten,13,,19,22,41
052 Welsberg-Taisten,14,,23,12,35
052 Welsberg-Taisten,15,,20,20,40
052 Welsberg-Taisten,16,,16,15,31
052 Welsberg-Taisten,17,,19,15,34
052 Welsberg-Taisten,18,,12,16,28
052 Welsberg-Taisten,19,,16,21,37
052 Welsberg-Taisten,20,,10,11,21
052 Welsberg-Taisten,21,,20,18,38
052 Welsberg-Taisten,22,,10,17,27
052 Welsberg-Taisten,23,,7,19,26
052 Welsberg-Taisten,24,,12,21,33
052 Welsberg-Taisten,25,,11,12,23
052 Welsberg-Taisten,26,,15,8,23
052 Welsberg-Taisten,27,,7,18,25
052 Welsberg-Taisten,28,,30,16,46
052 Welsberg-Taisten,29,,23,18,41
052 Welsberg-Taisten,30,,15,18,33
052 Welsberg-Taisten,31,,12,16,28
052 Welsberg-Taisten,32,,19,15,34
052 Welsberg-Taisten,33,,21,19,40
052 Welsberg-Taisten,34,,17,18,35
052 Welsberg-Taisten,35,,13,27,40
052 Welsberg-Taisten,36,,19,10,29
052 Welsberg-Taisten,37,,16,25,41
052 Welsberg-Taisten,38,,29,23,52
052 Welsberg-Taisten,39,,26,11,37
052 Welsberg-Taisten,40,,16,30,46
052 Welsberg-Taisten,41,,32,21,53
052 Welsberg-Taisten,42,,28,26,54
052 Welsberg-Taisten,43,,21,22,43
052 Welsberg-Taisten,44,,28,21,49
052 Welsberg-Taisten,45,,32,22,54
052 Welsberg-Taisten,46,,34,22,56
052 Welsberg-Taisten,47,,22,17,39
052 Welsberg-Taisten,48,,34,20,54
052 Welsberg-Taisten,49,,28,24,52
052 Welsberg-Taisten,50,,22,22,44
052 Welsberg-Taisten,51,,16,14,30
052 Welsberg-Taisten,52,,10,17,27
052 Welsberg-Taisten,53,,20,21,41
052 Welsberg-Taisten,54,,26,17,43
052 Welsberg-Taisten,55,,13,19,32
052 Welsberg-Taisten,56,,19,20,39
052 Welsberg-Taisten,57,,16,10,26
052 Welsberg-Taisten,58,,15,14,29
052 Welsberg-Taisten,59,,19,12,31
052 Welsberg-Taisten,60,,17,12,29
052 Welsberg-Taisten,61,,17,11,28
052 Welsberg-Taisten,62,,17,14,31
052 Welsberg-Taisten,63,,15,11,26
052 Welsberg-Taisten,64,,16,16,32
052 Welsberg-Taisten,65,,9,11,20
052 Welsberg-Taisten,66,,13,14,27
052 Welsberg-Taisten,67,,9,13,22
052 Welsberg-Taisten,68,,12,11,23
052 Welsberg-Taisten,69,,10,14,24
052 Welsberg-Taisten,70,,10,13,23
052 Welsberg-Taisten,71,,14,16,30
052 Welsberg-Taisten,72,,6,11,17
052 Welsberg-Taisten,73,,10,9,19
052 Welsberg-Taisten,74,,9,12,21
052 Welsberg-Taisten,75,,8,8,16
052 Welsberg-Taisten,76,,7,9,16
052 Welsberg-Taisten,77,,3,14,17
052 Welsberg-Taisten,78,,15,14,29
052 Welsberg-Taisten,79,,7,9,16
052 Welsberg-Taisten,80,,8,8,16
052 Welsberg-Taisten,81,,5,13,18
052 Welsberg-Taisten,82,,8,7,15
052 Welsberg-Taisten,83,,6,9,15
052 Welsberg-Taisten,84,,5,14,19
052 Welsberg-Taisten,85,,1,9,10
052 Welsberg-Taisten,86,,5,5,10
052 Welsberg-Taisten,87,,-,4,4
052 Welsberg-Taisten,88,,1,5,6
052 Welsberg-Taisten,89,,3,3,6
052 Welsberg-Taisten,90,,2,2,4
052 Welsberg-Taisten,91,,1,3,4
052 Welsberg-Taisten,92,,1,1,2
052 Welsberg-Taisten,93,,-,2,2
052 Welsberg-Taisten,95,,-,1,1
052 Welsberg-Taisten,96,,1,-,1
052 Welsberg-Taisten,97,,-,1,1
052 Welsberg-Taisten,100,,-,1,1
052 Welsberg-Taisten,Insgesamt,,1.408,1.432,2.840
053 Montan,0,,10,12,22
053 Montan,1,,10,3,13
053 Montan,2,,13,11,24
053 Montan,3,,7,8,15
053 Montan,4,,13,7,20
053 Montan,5,,8,5,13
053 Montan,6,,8,7,15
053 Montan,7,,9,9,18
053 Montan,8,,6,11,17
053 Montan,9,,10,12,22
053 Montan,10,,6,4,10
053 Montan,11,,14,4,18
053 Montan,12,,9,6,15
053 Montan,13,,7,11,18
053 Montan,14,,9,13,22
053 Montan,15,,8,9,17
053 Montan,16,,14,10,24
053 Montan,17,,15,16,31
053 Montan,18,,13,6,19
053 Montan,19,,5,9,14
053 Montan,20,,6,9,15
053 Montan,21,,14,10,24
053 Montan,22,,11,7,18
053 Montan,23,,10,11,21
053 Montan,24,,11,15,26
053 Montan,25,,10,19,29
053 Montan,26,,16,6,22
053 Montan,27,,10,9,19
053 Montan,28,,6,3,9
053 Montan,29,,14,10,24
053 Montan,30,,9,7,16
053 Montan,31,,11,14,25
053 Montan,32,,8,7,15
053 Montan,33,,11,8,19
053 Montan,34,,13,8,21
053 Montan,35,,8,7,15
053 Montan,36,,9,7,16
053 Montan,37,,10,17,27
053 Montan,38,,11,16,27
053 Montan,39,,14,5,19
053 Montan,40,,9,8,17
053 Montan,41,,12,10,22
053 Montan,42,,15,14,29
053 Montan,43,,15,18,33
053 Montan,44,,14,19,33
053 Montan,45,,12,13,25
053 Montan,46,,13,16,29
053 Montan,47,,26,15,41
053 Montan,48,,14,11,25
053 Montan,49,,14,19,33
053 Montan,50,,16,16,32
053 Montan,51,,19,13,32
053 Montan,52,,14,11,25
053 Montan,53,,14,10,24
053 Montan,54,,12,10,22
053 Montan,55,,13,11,24
053 Montan,56,,8,15,23
053 Montan,57,,8,14,22
053 Montan,58,,11,13,24
053 Montan,59,,11,7,18
053 Montan,60,,12,4,16
053 Montan,61,,7,7,14
053 Montan,62,,4,4,8
053 Montan,63,,8,3,11
053 Montan,64,,5,6,11
053 Montan,65,,6,10,16
053 Montan,66,,5,2,7
053 Montan,67,,5,3,8
053 Montan,68,,2,6,8
053 Montan,69,,5,7,12
053 Montan,70,,5,6,11
053 Montan,71,,6,6,12
053 Montan,72,,8,7,15
053 Montan,73,,4,10,14
053 Montan,74,,6,10,16
053 Montan,75,,2,5,7
053 Montan,76,,7,9,16
053 Montan,77,,1,8,9
053 Montan,78,,2,7,9
053 Montan,79,,13,4,17
053 Montan,80,,5,7,12
053 Montan,81,,6,10,16
053 Montan,82,,7,13,20
053 Montan,83,,3,7,10
053 Montan,84,,4,3,7
053 Montan,85,,1,3,4
053 Montan,86,,5,5,10
053 Montan,87,,-,7,7
053 Montan,88,,1,4,5
053 Montan,89,,-,7,7
053 Montan,90,,3,2,5
053 Montan,91,,-,2,2
053 Montan,92,,1,1,2
053 Montan,93,,-,1,1
053 Montan,94,,-,2,2
053 Montan,97,,-,1,1
053 Montan,Insgesamt,,825,830,1.655
054 Moos in Passeier,0,,10,16,26
054 Moos in Passeier,1,,20,12,32
054 Moos in Passeier,2,,9,8,17
054 Moos in Passeier,3,,9,14,23
054 Moos in Passeier,4,,15,11,26
054 Moos in Passeier,5,,16,7,23
054 Moos in Passeier,6,,16,9,25
054 Moos in Passeier,7,,17,14,31
054 Moos in Passeier,8,,17,20,37
054 Moos in Passeier,9,,15,10,25
054 Moos in Passeier,10,,21,18,39
054 Moos in Passeier,11,,15,12,27
054 Moos in Passeier,12,,12,19,31
054 Moos in Passeier,13,,24,9,33
054 Moos in Passeier,14,,16,14,30
054 Moos in Passeier,15,,12,17,29
054 Moos in Passeier,16,,18,19,37
054 Moos in Passeier,17,,8,11,19
054 Moos in Passeier,18,,17,19,36
054 Moos in Passeier,19,,17,12,29
054 Moos in Passeier,20,,18,16,34
054 Moos in Passeier,21,,16,17,33
054 Moos in Passeier,22,,15,15,30
054 Moos in Passeier,23,,15,16,31
054 Moos in Passeier,24,,16,12,28
054 Moos in Passeier,25,,16,11,27
054 Moos in Passeier,26,,16,12,28
054 Moos in Passeier,27,,19,12,31
054 Moos in Passeier,28,,19,19,38
054 Moos in Passeier,29,,13,12,25
054 Moos in Passeier,30,,13,14,27
054 Moos in Passeier,31,,11,13,24
054 Moos in Passeier,32,,12,13,25
054 Moos in Passeier,33,,16,9,25
054 Moos in Passeier,34,,17,14,31
054 Moos in Passeier,35,,19,15,34
054 Moos in Passeier,36,,14,8,22
054 Moos in Passeier,37,,15,11,26
054 Moos in Passeier,38,,23,14,37
054 Moos in Passeier,39,,7,21,28
054 Moos in Passeier,40,,18,15,33
054 Moos in Passeier,41,,17,16,33
054 Moos in Passeier,42,,19,9,28
054 Moos in Passeier,43,,16,18,34
054 Moos in Passeier,44,,16,16,32
054 Moos in Passeier,45,,23,16,39
054 Moos in Passeier,46,,23,18,41
054 Moos in Passeier,47,,19,8,27
054 Moos in Passeier,48,,21,11,32
054 Moos in Passeier,49,,15,18,33
054 Moos in Passeier,50,,10,19,29
054 Moos in Passeier,51,,9,7,16
054 Moos in Passeier,52,,15,15,30
054 Moos in Passeier,53,,14,12,26
054 Moos in Passeier,54,,12,13,25
054 Moos in Passeier,55,,19,6,25
054 Moos in Passeier,56,,9,8,17
054 Moos in Passeier,57,,8,8,16
054 Moos in Passeier,58,,14,9,23
054 Moos in Passeier,59,,7,8,15
054 Moos in Passeier,60,,8,3,11
054 Moos in Passeier,61,,10,10,20
054 Moos in Passeier,62,,6,10,16
054 Moos in Passeier,63,,13,9,22
054 Moos in Passeier,64,,6,6,12
054 Moos in Passeier,65,,16,10,26
054 Moos in Passeier,66,,9,8,17
054 Moos in Passeier,67,,9,7,16
054 Moos in Passeier,68,,10,7,17
054 Moos in Passeier,69,,14,11,25
054 Moos in Passeier,70,,5,12,17
054 Moos in Passeier,71,,9,13,22
054 Moos in Passeier,72,,8,7,15
054 Moos in Passeier,73,,5,4,9
054 Moos in Passeier,74,,9,6,15
054 Moos in Passeier,75,,5,6,11
054 Moos in Passeier,76,,8,7,15
054 Moos in Passeier,77,,8,5,13
054 Moos in Passeier,78,,11,13,24
054 Moos in Passeier,79,,5,9,14
054 Moos in Passeier,80,,8,3,11
054 Moos in Passeier,81,,6,5,11
054 Moos in Passeier,82,,6,7,13
054 Moos in Passeier,83,,6,10,16
054 Moos in Passeier,84,,3,7,10
054 Moos in Passeier,85,,3,4,7
054 Moos in Passeier,86,,4,2,6
054 Moos in Passeier,87,,4,4,8
054 Moos in Passeier,88,,2,4,6
054 Moos in Passeier,89,,2,1,3
054 Moos in Passeier,90,,-,2,2
054 Moos in Passeier,92,,-,1,1
054 Moos in Passeier,93,,-,2,2
054 Moos in Passeier,95,,-,1,1
054 Moos in Passeier,96,,-,1,1
054 Moos in Passeier,Insgesamt,,1.136,1.012,2.148
055 Nals,0,,11,9,20
055 Nals,1,,12,11,23
055 Nals,2,,8,14,22
055 Nals,3,,10,11,21
055 Nals,4,,10,6,16
055 Nals,5,,8,10,18
055 Nals,6,,11,3,14
055 Nals,7,,7,13,20
055 Nals,8,,7,8,15
055 Nals,9,,13,5,18
055 Nals,10,,11,12,23
055 Nals,11,,7,9,16
055 Nals,12,,6,13,19
055 Nals,13,,14,9,23
055 Nals,14,,13,8,21
055 Nals,15,,11,9,20
055 Nals,16,,12,11,23
055 Nals,17,,7,6,13
055 Nals,18,,9,8,17
055 Nals,19,,7,14,21
055 Nals,20,,11,9,20
055 Nals,21,,11,10,21
055 Nals,22,,9,8,17
055 Nals,23,,12,9,21
055 Nals,24,,12,13,25
055 Nals,25,,11,12,23
055 Nals,26,,6,8,14
055 Nals,27,,13,9,22
055 Nals,28,,10,9,19
055 Nals,29,,7,12,19
055 Nals,30,,8,12,20
055 Nals,31,,10,11,21
055 Nals,32,,15,14,29
055 Nals,33,,12,14,26
055 Nals,34,,10,15,25
055 Nals,35,,9,20,29
055 Nals,36,,16,15,31
055 Nals,37,,9,13,22
055 Nals,38,,21,15,36
055 Nals,39,,14,8,22
055 Nals,40,,13,19,32
055 Nals,41,,18,18,36
055 Nals,42,,27,11,38
055 Nals,43,,22,20,42
055 Nals,44,,23,16,39
055 Nals,45,,19,16,35
055 Nals,46,,14,16,30
055 Nals,47,,16,16,32
055 Nals,48,,15,20,35
055 Nals,49,,11,23,34
055 Nals,50,,10,13,23
055 Nals,51,,19,14,33
055 Nals,52,,16,11,27
055 Nals,53,,14,17,31
055 Nals,54,,15,16,31
055 Nals,55,,8,5,13
055 Nals,56,,7,7,14
055 Nals,57,,22,13,35
055 Nals,58,,7,6,13
055 Nals,59,,8,8,16
055 Nals,60,,7,7,14
055 Nals,61,,3,10,13
055 Nals,62,,7,10,17
055 Nals,63,,9,9,18
055 Nals,64,,11,12,23
055 Nals,65,,11,5,16
055 Nals,66,,8,14,22
055 Nals,67,,7,11,18
055 Nals,68,,6,11,17
055 Nals,69,,9,7,16
055 Nals,70,,5,9,14
055 Nals,71,,11,5,16
055 Nals,72,,7,12,19
055 Nals,73,,7,11,18
055 Nals,74,,4,8,12
055 Nals,75,,3,13,16
055 Nals,76,,6,4,10
055 Nals,77,,5,6,11
055 Nals,78,,3,6,9
055 Nals,79,,7,10,17
055 Nals,80,,5,5,10
055 Nals,81,,3,5,8
055 Nals,82,,1,5,6
055 Nals,83,,5,7,12
055 Nals,84,,5,6,11
055 Nals,85,,1,6,7
055 Nals,86,,5,2,7
055 Nals,87,,2,-,2
055 Nals,88,,1,-,1
055 Nals,89,,-,3,3
055 Nals,90,,1,3,4
055 Nals,91,,-,4,4
055 Nals,93,,-,1,1
055 Nals,96,,-,1,1
055 Nals,Insgesamt,,889,938,1.827
056 Naturns,0,,31,30,61
056 Naturns,1,,36,28,64
056 Naturns,2,,40,23,63
056 Naturns,3,,23,27,50
056 Naturns,4,,34,21,55
056 Naturns,5,,33,33,66
056 Naturns,6,,36,31,67
056 Naturns,7,,35,23,58
056 Naturns,8,,35,33,68
056 Naturns,9,,38,22,60
056 Naturns,10,,28,26,54
056 Naturns,11,,32,30,62
056 Naturns,12,,31,25,56
056 Naturns,13,,31,27,58
056 Naturns,14,,29,36,65
056 Naturns,15,,20,18,38
056 Naturns,16,,33,36,69
056 Naturns,17,,46,34,80
056 Naturns,18,,32,38,70
056 Naturns,19,,35,39,74
056 Naturns,20,,31,37,68
056 Naturns,21,,43,42,85
056 Naturns,22,,35,35,70
056 Naturns,23,,42,29,71
056 Naturns,24,,49,34,83
056 Naturns,25,,35,20,55
056 Naturns,26,,32,31,63
056 Naturns,27,,39,30,69
056 Naturns,28,,40,22,62
056 Naturns,29,,34,38,72
056 Naturns,30,,42,43,85
056 Naturns,31,,40,48,88
056 Naturns,32,,37,39,76
056 Naturns,33,,51,36,87
056 Naturns,34,,44,45,89
056 Naturns,35,,41,42,83
056 Naturns,36,,40,34,74
056 Naturns,37,,49,38,87
056 Naturns,38,,41,49,90
056 Naturns,39,,47,50,97
056 Naturns,40,,50,47,97
056 Naturns,41,,42,40,82
056 Naturns,42,,54,41,95
056 Naturns,43,,43,46,89
056 Naturns,44,,45,43,88
056 Naturns,45,,49,48,97
056 Naturns,46,,57,43,100
056 Naturns,47,,36,54,90
056 Naturns,48,,53,38,91
056 Naturns,49,,42,49,91
056 Naturns,50,,39,46,85
056 Naturns,51,,39,48,87
056 Naturns,52,,55,39,94
056 Naturns,53,,43,40,83
056 Naturns,54,,32,36,68
056 Naturns,55,,36,33,69
056 Naturns,56,,44,43,87
056 Naturns,57,,29,31,60
056 Naturns,58,,39,31,70
056 Naturns,59,,35,22,57
056 Naturns,60,,28,38,66
056 Naturns,61,,34,32,66
056 Naturns,62,,29,33,62
056 Naturns,63,,25,19,44
056 Naturns,64,,27,23,50
056 Naturns,65,,9,23,32
056 Naturns,66,,23,30,53
056 Naturns,67,,25,18,43
056 Naturns,68,,18,19,37
056 Naturns,69,,25,33,58
056 Naturns,70,,30,33,63
056 Naturns,71,,36,29,65
056 Naturns,72,,23,20,43
056 Naturns,73,,19,21,40
056 Naturns,74,,19,17,36
056 Naturns,75,,20,19,39
056 Naturns,76,,18,21,39
056 Naturns,77,,16,11,27
056 Naturns,78,,14,18,32
056 Naturns,79,,14,13,27
056 Naturns,80,,8,16,24
056 Naturns,81,,7,18,25
056 Naturns,82,,10,19,29
056 Naturns,83,,10,16,26
056 Naturns,84,,9,10,19
056 Naturns,85,,3,13,16
056 Naturns,86,,9,11,20
056 Naturns,87,,7,11,18
056 Naturns,88,,9,9,18
056 Naturns,89,,1,7,8
056 Naturns,90,,1,6,7
056 Naturns,91,,1,6,7
056 Naturns,92,,1,2,3
056 Naturns,93,,-,4,4
056 Naturns,98,,-,3,3
056 Naturns,99,,1,1,2
056 Naturns,101,,-,1,1
056 Naturns,Insgesamt,,2.861,2.763,5.624
057 Natz-Schabs,0,,16,29,45
057 Natz-Schabs,1,,27,15,42
057 Natz-Schabs,2,,16,14,30
057 Natz-Schabs,3,,9,22,31
057 Natz-Schabs,4,,18,22,40
057 Natz-Schabs,5,,14,12,26
057 Natz-Schabs,6,,14,18,32
057 Natz-Schabs,7,,13,15,28
057 Natz-Schabs,8,,15,18,33
057 Natz-Schabs,9,,18,18,36
057 Natz-Schabs,10,,24,18,42
057 Natz-Schabs,11,,16,13,29
057 Natz-Schabs,12,,21,17,38
057 Natz-Schabs,13,,16,20,36
057 Natz-Schabs,14,,24,16,40
057 Natz-Schabs,15,,19,17,36
057 Natz-Schabs,16,,22,17,39
057 Natz-Schabs,17,,13,13,26
057 Natz-Schabs,18,,20,16,36
057 Natz-Schabs,19,,19,19,38
057 Natz-Schabs,20,,16,14,30
057 Natz-Schabs,21,,21,23,44
057 Natz-Schabs,22,,15,26,41
057 Natz-Schabs,23,,17,26,43
057 Natz-Schabs,24,,25,16,41
057 Natz-Schabs,25,,21,19,40
057 Natz-Schabs,26,,17,18,35
057 Natz-Schabs,27,,21,26,47
057 Natz-Schabs,28,,21,15,36
057 Natz-Schabs,29,,21,26,47
057 Natz-Schabs,30,,15,29,44
057 Natz-Schabs,31,,23,21,44
057 Natz-Schabs,32,,26,21,47
057 Natz-Schabs,33,,19,20,39
057 Natz-Schabs,34,,18,25,43
057 Natz-Schabs,35,,21,16,37
057 Natz-Schabs,36,,14,22,36
057 Natz-Schabs,37,,20,30,50
057 Natz-Schabs,38,,23,29,52
057 Natz-Schabs,39,,28,23,51
057 Natz-Schabs,40,,23,24,47
057 Natz-Schabs,41,,25,24,49
057 Natz-Schabs,42,,32,24,56
057 Natz-Schabs,43,,29,27,56
057 Natz-Schabs,44,,31,21,52
057 Natz-Schabs,45,,28,23,51
057 Natz-Schabs,46,,31,21,52
057 Natz-Schabs,47,,34,37,71
057 Natz-Schabs,48,,30,28,58
057 Natz-Schabs,49,,27,28,55
057 Natz-Schabs,50,,17,22,39
057 Natz-Schabs,51,,16,19,35
057 Natz-Schabs,52,,32,21,53
057 Natz-Schabs,53,,20,19,39
057 Natz-Schabs,54,,22,20,42
057 Natz-Schabs,55,,18,23,41
057 Natz-Schabs,56,,17,24,41
057 Natz-Schabs,57,,20,17,37
057 Natz-Schabs,58,,11,15,26
057 Natz-Schabs,59,,20,14,34
057 Natz-Schabs,60,,12,10,22
057 Natz-Schabs,61,,15,12,27
057 Natz-Schabs,62,,15,14,29
057 Natz-Schabs,63,,18,16,34
057 Natz-Schabs,64,,14,12,26
057 Natz-Schabs,65,,11,13,24
057 Natz-Schabs,66,,16,12,28
057 Natz-Schabs,67,,8,6,14
057 Natz-Schabs,68,,14,10,24
057 Natz-Schabs,69,,14,6,20
057 Natz-Schabs,70,,12,8,20
057 Natz-Schabs,71,,12,8,20
057 Natz-Schabs,72,,3,7,10
057 Natz-Schabs,73,,1,5,6
057 Natz-Schabs,74,,7,5,12
057 Natz-Schabs,75,,8,6,14
057 Natz-Schabs,76,,6,4,10
057 Natz-Schabs,77,,5,6,11
057 Natz-Schabs,78,,3,3,6
057 Natz-Schabs,79,,6,9,15
057 Natz-Schabs,80,,3,6,9
057 Natz-Schabs,81,,3,5,8
057 Natz-Schabs,82,,4,8,12
057 Natz-Schabs,83,,7,3,10
057 Natz-Schabs,84,,2,5,7
057 Natz-Schabs,85,,1,2,3
057 Natz-Schabs,86,,2,1,3
057 Natz-Schabs,87,,2,1,3
057 Natz-Schabs,88,,-,2,2
057 Natz-Schabs,89,,-,4,4
057 Natz-Schabs,90,,2,2,4
057 Natz-Schabs,91,,2,1,3
057 Natz-Schabs,92,,1,2,3
057 Natz-Schabs,94,,-,2,2
057 Natz-Schabs,Insgesamt,,1.468,1.461,2.929
058 Welschnofen,0,,10,10,20
058 Welschnofen,1,,13,4,17
058 Welschnofen,2,,5,7,12
058 Welschnofen,3,,9,3,12
058 Welschnofen,4,,9,8,17
058 Welschnofen,5,,8,7,15
058 Welschnofen,6,,8,7,15
058 Welschnofen,7,,9,12,21
058 Welschnofen,8,,12,7,19
058 Welschnofen,9,,9,9,18
058 Welschnofen,10,,17,6,23
058 Welschnofen,11,,7,10,17
058 Welschnofen,12,,8,7,15
058 Welschnofen,13,,9,13,22
058 Welschnofen,14,,14,10,24
058 Welschnofen,15,,13,13,26
058 Welschnofen,16,,9,10,19
058 Welschnofen,17,,14,14,28
058 Welschnofen,18,,12,10,22
058 Welschnofen,19,,11,10,21
058 Welschnofen,20,,19,15,34
058 Welschnofen,21,,15,11,26
058 Welschnofen,22,,11,13,24
058 Welschnofen,23,,14,10,24
058 Welschnofen,24,,12,15,27
058 Welschnofen,25,,9,9,18
058 Welschnofen,26,,7,12,19
058 Welschnofen,27,,11,14,25
058 Welschnofen,28,,8,5,13
058 Welschnofen,29,,13,13,26
058 Welschnofen,30,,12,15,27
058 Welschnofen,31,,15,15,30
058 Welschnofen,32,,13,11,24
058 Welschnofen,33,,9,11,20
058 Welschnofen,34,,13,14,27
058 Welschnofen,35,,14,14,28
058 Welschnofen,36,,17,11,28
058 Welschnofen,37,,20,13,33
058 Welschnofen,38,,12,16,28
058 Welschnofen,39,,15,17,32
058 Welschnofen,40,,12,12,24
058 Welschnofen,41,,18,20,38
058 Welschnofen,42,,20,15,35
058 Welschnofen,43,,15,14,29
058 Welschnofen,44,,21,19,40
058 Welschnofen,45,,16,16,32
058 Welschnofen,46,,14,13,27
058 Welschnofen,47,,22,14,36
058 Welschnofen,48,,16,8,24
058 Welschnofen,49,,18,15,33
058 Welschnofen,50,,14,13,27
058 Welschnofen,51,,17,17,34
058 Welschnofen,52,,18,10,28
058 Welschnofen,53,,14,12,26
058 Welschnofen,54,,16,10,26
058 Welschnofen,55,,10,16,26
058 Welschnofen,56,,12,11,23
058 Welschnofen,57,,15,14,29
058 Welschnofen,58,,13,10,23
058 Welschnofen,59,,11,12,23
058 Welschnofen,60,,11,10,21
058 Welschnofen,61,,14,7,21
058 Welschnofen,62,,8,9,17
058 Welschnofen,63,,10,12,22
058 Welschnofen,64,,8,11,19
058 Welschnofen,65,,8,6,14
058 Welschnofen,66,,12,10,22
058 Welschnofen,67,,12,4,16
058 Welschnofen,68,,6,9,15
058 Welschnofen,69,,12,9,21
058 Welschnofen,70,,10,12,22
058 Welschnofen,71,,10,6,16
058 Welschnofen,72,,6,7,13
058 Welschnofen,73,,9,6,15
058 Welschnofen,74,,6,6,12
058 Welschnofen,75,,8,3,11
058 Welschnofen,76,,5,12,17
058 Welschnofen,77,,7,6,13
058 Welschnofen,78,,8,9,17
058 Welschnofen,79,,6,13,19
058 Welschnofen,80,,6,6,12
058 Welschnofen,81,,3,7,10
058 Welschnofen,82,,3,7,10
058 Welschnofen,83,,2,11,13
058 Welschnofen,84,,6,3,9
058 Welschnofen,85,,1,3,4
058 Welschnofen,86,,1,4,5
058 Welschnofen,87,,3,4,7
058 Welschnofen,88,,2,5,7
058 Welschnofen,89,,3,5,8
058 Welschnofen,90,,3,3,6
058 Welschnofen,91,,-,6,6
058 Welschnofen,92,,1,2,3
058 Welschnofen,93,,1,2,3
058 Welschnofen,Insgesamt,,988,937,1.925
059 Deutschnofen,0,,20,18,38
059 Deutschnofen,1,,14,20,34
059 Deutschnofen,2,,22,17,39
059 Deutschnofen,3,,29,19,48
059 Deutschnofen,4,,20,20,40
059 Deutschnofen,5,,18,16,34
059 Deutschnofen,6,,20,25,45
059 Deutschnofen,7,,28,33,61
059 Deutschnofen,8,,18,31,49
059 Deutschnofen,9,,17,34,51
059 Deutschnofen,10,,32,13,45
059 Deutschnofen,11,,23,32,55
059 Deutschnofen,12,,24,26,50
059 Deutschnofen,13,,28,24,52
059 Deutschnofen,14,,33,12,45
059 Deutschnofen,15,,23,29,52
059 Deutschnofen,16,,20,26,46
059 Deutschnofen,17,,27,25,52
059 Deutschnofen,18,,27,15,42
059 Deutschnofen,19,,25,24,49
059 Deutschnofen,20,,34,29,63
059 Deutschnofen,21,,24,20,44
059 Deutschnofen,22,,34,28,62
059 Deutschnofen,23,,27,22,49
059 Deutschnofen,24,,19,33,52
059 Deutschnofen,25,,23,27,50
059 Deutschnofen,26,,30,20,50
059 Deutschnofen,27,,27,26,53
059 Deutschnofen,28,,33,29,62
059 Deutschnofen,29,,26,26,52
059 Deutschnofen,30,,22,31,53
059 Deutschnofen,31,,24,18,42
059 Deutschnofen,32,,28,29,57
059 Deutschnofen,33,,24,21,45
059 Deutschnofen,34,,23,19,42
059 Deutschnofen,35,,30,24,54
059 Deutschnofen,36,,23,21,44
059 Deutschnofen,37,,20,25,45
059 Deutschnofen,38,,28,32,60
059 Deutschnofen,39,,23,30,53
059 Deutschnofen,40,,31,34,65
059 Deutschnofen,41,,28,26,54
059 Deutschnofen,42,,33,31,64
059 Deutschnofen,43,,41,28,69
059 Deutschnofen,44,,25,35,60
059 Deutschnofen,45,,29,28,57
059 Deutschnofen,46,,34,36,70
059 Deutschnofen,47,,34,21,55
059 Deutschnofen,48,,32,31,63
059 Deutschnofen,49,,34,26,60
059 Deutschnofen,50,,25,29,54
059 Deutschnofen,51,,34,22,56
059 Deutschnofen,52,,43,27,70
059 Deutschnofen,53,,30,19,49
059 Deutschnofen,54,,21,28,49
059 Deutschnofen,55,,20,25,45
059 Deutschnofen,56,,30,29,59
059 Deutschnofen,57,,31,21,52
059 Deutschnofen,58,,29,22,51
059 Deutschnofen,59,,22,21,43
059 Deutschnofen,60,,24,21,45
059 Deutschnofen,61,,21,16,37
059 Deutschnofen,62,,17,18,35
059 Deutschnofen,63,,20,16,36
059 Deutschnofen,64,,22,17,39
059 Deutschnofen,65,,12,12,24
059 Deutschnofen,66,,16,21,37
059 Deutschnofen,67,,16,14,30
059 Deutschnofen,68,,16,15,31
059 Deutschnofen,69,,20,22,42
059 Deutschnofen,70,,16,18,34
059 Deutschnofen,71,,17,25,42
059 Deutschnofen,72,,14,16,30
059 Deutschnofen,73,,23,14,37
059 Deutschnofen,74,,14,19,33
059 Deutschnofen,75,,11,7,18
059 Deutschnofen,76,,13,10,23
059 Deutschnofen,77,,7,11,18
059 Deutschnofen,78,,11,9,20
059 Deutschnofen,79,,5,13,18
059 Deutschnofen,80,,13,14,27
059 Deutschnofen,81,,7,8,15
059 Deutschnofen,82,,5,9,14
059 Deutschnofen,83,,5,4,9
059 Deutschnofen,84,,5,19,24
059 Deutschnofen,85,,6,11,17
059 Deutschnofen,86,,7,8,15
059 Deutschnofen,87,,3,16,19
059 Deutschnofen,88,,1,9,10
059 Deutschnofen,89,,1,6,7
059 Deutschnofen,90,,3,6,9
059 Deutschnofen,91,,2,5,7
059 Deutschnofen,92,,1,4,5
059 Deutschnofen,93,,1,1,2
059 Deutschnofen,94,,-,1,1
059 Deutschnofen,95,,-,2,2
059 Deutschnofen,96,,1,1,2
059 Deutschnofen,97,,-,1,1
059 Deutschnofen,98,,-,2,2
059 Deutschnofen,101,,-,1,1
059 Deutschnofen,102,,1,-,1
059 Deutschnofen,Insgesamt,,1.973,1.950,3.923
060 Auer,0,,25,12,37
060 Auer,1,,21,18,39
060 Auer,2,,20,14,34
060 Auer,3,,21,26,47
060 Auer,4,,10,20,30
060 Auer,5,,20,10,30
060 Auer,6,,14,13,27
060 Auer,7,,24,21,45
060 Auer,8,,19,19,38
060 Auer,9,,21,12,33
060 Auer,10,,31,18,49
060 Auer,11,,18,27,45
060 Auer,12,,21,21,42
060 Auer,13,,19,24,43
060 Auer,14,,23,26,49
060 Auer,15,,20,17,37
060 Auer,16,,20,21,41
060 Auer,17,,17,16,33
060 Auer,18,,25,23,48
060 Auer,19,,12,22,34
060 Auer,20,,17,20,37
060 Auer,21,,28,16,44
060 Auer,22,,16,22,38
060 Auer,23,,21,22,43
060 Auer,24,,22,28,50
060 Auer,25,,25,19,44
060 Auer,26,,16,16,32
060 Auer,27,,19,31,50
060 Auer,28,,19,21,40
060 Auer,29,,18,16,34
060 Auer,30,,19,25,44
060 Auer,31,,26,21,47
060 Auer,32,,21,19,40
060 Auer,33,,28,19,47
060 Auer,34,,14,19,33
060 Auer,35,,19,30,49
060 Auer,36,,21,31,52
060 Auer,37,,22,16,38
060 Auer,38,,30,26,56
060 Auer,39,,24,28,52
060 Auer,40,,20,24,44
060 Auer,41,,42,28,70
060 Auer,42,,31,27,58
060 Auer,43,,22,31,53
060 Auer,44,,32,36,68
060 Auer,45,,26,28,54
060 Auer,46,,39,41,80
060 Auer,47,,31,28,59
060 Auer,48,,30,23,53
060 Auer,49,,31,41,72
060 Auer,50,,26,21,47
060 Auer,51,,33,35,68
060 Auer,52,,31,31,62
060 Auer,53,,36,31,67
060 Auer,54,,35,23,58
060 Auer,55,,20,27,47
060 Auer,56,,28,31,59
060 Auer,57,,14,22,36
060 Auer,58,,23,15,38
060 Auer,59,,19,24,43
060 Auer,60,,15,22,37
060 Auer,61,,14,21,35
060 Auer,62,,16,21,37
060 Auer,63,,15,13,28
060 Auer,64,,28,13,41
060 Auer,65,,18,19,37
060 Auer,66,,16,25,41
060 Auer,67,,14,13,27
060 Auer,68,,21,16,37
060 Auer,69,,13,17,30
060 Auer,70,,14,19,33
060 Auer,71,,19,15,34
060 Auer,72,,11,9,20
060 Auer,73,,10,20,30
060 Auer,74,,16,17,33
060 Auer,75,,8,10,18
060 Auer,76,,9,7,16
060 Auer,77,,8,15,23
060 Auer,78,,12,12,24
060 Auer,79,,3,8,11
060 Auer,80,,3,15,18
060 Auer,81,,7,10,17
060 Auer,82,,5,7,12
060 Auer,83,,8,11,19
060 Auer,84,,8,6,14
060 Auer,85,,4,11,15
060 Auer,86,,-,15,15
060 Auer,87,,7,7,14
060 Auer,88,,5,5,10
060 Auer,89,,5,7,12
060 Auer,90,,1,4,5
060 Auer,91,,-,3,3
060 Auer,92,,2,4,6
060 Auer,93,,2,2,4
060 Auer,94,,-,3,3
060 Auer,95,,-,1,1
060 Auer,96,,-,2,2
060 Auer,97,,-,1,1
060 Auer,99,,1,-,1
060 Auer,Insgesamt,,1.733,1.818,3.551
061 St.Ulrich,0,,22,15,37
061 St.Ulrich,1,,28,30,58
061 St.Ulrich,2,,22,22,44
061 St.Ulrich,3,,25,19,44
061 St.Ulrich,4,,34,24,58
061 St.Ulrich,5,,30,33,63
061 St.Ulrich,6,,35,26,61
061 St.Ulrich,7,,32,23,55
061 St.Ulrich,8,,23,32,55
061 St.Ulrich,9,,23,32,55
061 St.Ulrich,10,,25,38,63
061 St.Ulrich,11,,22,22,44
061 St.Ulrich,12,,31,35,66
061 St.Ulrich,13,,44,33,77
061 St.Ulrich,14,,47,39,86
061 St.Ulrich,15,,35,27,62
061 St.Ulrich,16,,31,23,54
061 St.Ulrich,17,,32,31,63
061 St.Ulrich,18,,29,30,59
061 St.Ulrich,19,,23,30,53
061 St.Ulrich,20,,34,28,62
061 St.Ulrich,21,,33,30,63
061 St.Ulrich,22,,26,24,50
061 St.Ulrich,23,,18,21,39
061 St.Ulrich,24,,17,27,44
061 St.Ulrich,25,,30,19,49
061 St.Ulrich,26,,22,23,45
061 St.Ulrich,27,,19,22,41
061 St.Ulrich,28,,20,21,41
061 St.Ulrich,29,,15,17,32
061 St.Ulrich,30,,19,33,52
061 St.Ulrich,31,,27,32,59
061 St.Ulrich,32,,20,36,56
061 St.Ulrich,33,,30,37,67
061 St.Ulrich,34,,21,29,50
061 St.Ulrich,35,,26,22,48
061 St.Ulrich,36,,35,32,67
061 St.Ulrich,37,,40,25,65
061 St.Ulrich,38,,36,34,70
061 St.Ulrich,39,,35,28,63
061 St.Ulrich,40,,41,33,74
061 St.Ulrich,41,,39,38,77
061 St.Ulrich,42,,35,36,71
061 St.Ulrich,43,,43,44,87
061 St.Ulrich,44,,41,48,89
061 St.Ulrich,45,,41,40,81
061 St.Ulrich,46,,31,38,69
061 St.Ulrich,47,,37,31,68
061 St.Ulrich,48,,36,40,76
061 St.Ulrich,49,,36,36,72
061 St.Ulrich,50,,32,35,67
061 St.Ulrich,51,,27,25,52
061 St.Ulrich,52,,32,28,60
061 St.Ulrich,53,,37,26,63
061 St.Ulrich,54,,24,19,43
061 St.Ulrich,55,,24,31,55
061 St.Ulrich,56,,16,31,47
061 St.Ulrich,57,,26,36,62
061 St.Ulrich,58,,27,32,59
061 St.Ulrich,59,,27,21,48
061 St.Ulrich,60,,13,30,43
061 St.Ulrich,61,,25,24,49
061 St.Ulrich,62,,20,26,46
061 St.Ulrich,63,,15,29,44
061 St.Ulrich,64,,28,28,56
061 St.Ulrich,65,,21,25,46
061 St.Ulrich,66,,31,23,54
061 St.Ulrich,67,,17,16,33
061 St.Ulrich,68,,25,32,57
061 St.Ulrich,69,,37,36,73
061 St.Ulrich,70,,28,34,62
061 St.Ulrich,71,,34,43,77
061 St.Ulrich,72,,27,27,54
061 St.Ulrich,73,,16,18,34
061 St.Ulrich,74,,21,23,44
061 St.Ulrich,75,,20,25,45
061 St.Ulrich,76,,21,16,37
061 St.Ulrich,77,,11,22,33
061 St.Ulrich,78,,15,9,24
061 St.Ulrich,79,,12,11,23
061 St.Ulrich,80,,13,20,33
061 St.Ulrich,81,,13,13,26
061 St.Ulrich,82,,16,8,24
061 St.Ulrich,83,,9,4,13
061 St.Ulrich,84,,10,11,21
061 St.Ulrich,85,,9,10,19
061 St.Ulrich,86,,4,11,15
061 St.Ulrich,87,,6,8,14
061 St.Ulrich,88,,3,10,13
061 St.Ulrich,89,,-,13,13
061 St.Ulrich,90,,3,5,8
061 St.Ulrich,91,,4,10,14
061 St.Ulrich,92,,2,8,10
061 St.Ulrich,93,,1,4,5
061 St.Ulrich,94,,1,4,5
061 St.Ulrich,96,,-,1,1
061 St.Ulrich,97,,1,1,2
061 St.Ulrich,98,,1,1,2
061 St.Ulrich,99,,-,2,2
061 St.Ulrich,100,,-,1,1
061 St.Ulrich,101,,-,1,1
061 St.Ulrich,102,,-,1,1
061 St.Ulrich,Insgesamt,,2.301,2.416,4.717
062 Partschins,0,,22,16,38
062 Partschins,1,,18,15,33
062 Partschins,2,,20,17,37
062 Partschins,3,,18,17,35
062 Partschins,4,,25,12,37
062 Partschins,5,,17,19,36
062 Partschins,6,,17,17,34
062 Partschins,7,,19,24,43
062 Partschins,8,,16,23,39
062 Partschins,9,,26,17,43
062 Partschins,10,,26,18,44
062 Partschins,11,,14,15,29
062 Partschins,12,,22,15,37
062 Partschins,13,,15,20,35
062 Partschins,14,,20,10,30
062 Partschins,15,,24,23,47
062 Partschins,16,,13,18,31
062 Partschins,17,,25,17,42
062 Partschins,18,,23,20,43
062 Partschins,19,,26,18,44
062 Partschins,20,,25,17,42
062 Partschins,21,,26,29,55
062 Partschins,22,,22,26,48
062 Partschins,23,,11,27,38
062 Partschins,24,,18,28,46
062 Partschins,25,,17,17,34
062 Partschins,26,,25,19,44
062 Partschins,27,,13,11,24
062 Partschins,28,,21,23,44
062 Partschins,29,,16,21,37
062 Partschins,30,,16,23,39
062 Partschins,31,,23,29,52
062 Partschins,32,,28,30,58
062 Partschins,33,,20,25,45
062 Partschins,34,,21,14,35
062 Partschins,35,,26,21,47
062 Partschins,36,,21,18,39
062 Partschins,37,,29,18,47
062 Partschins,38,,29,25,54
062 Partschins,39,,33,28,61
062 Partschins,40,,27,26,53
062 Partschins,41,,24,36,60
062 Partschins,42,,25,33,58
062 Partschins,43,,37,27,64
062 Partschins,44,,25,34,59
062 Partschins,45,,36,28,64
062 Partschins,46,,37,38,75
062 Partschins,47,,28,29,57
062 Partschins,48,,30,39,69
062 Partschins,49,,34,25,59
062 Partschins,50,,33,23,56
062 Partschins,51,,22,23,45
062 Partschins,52,,28,39,67
062 Partschins,53,,29,26,55
062 Partschins,54,,20,22,42
062 Partschins,55,,23,26,49
062 Partschins,56,,24,20,44
062 Partschins,57,,28,22,50
062 Partschins,58,,14,31,45
062 Partschins,59,,20,21,41
062 Partschins,60,,14,15,29
062 Partschins,61,,19,19,38
062 Partschins,62,,20,21,41
062 Partschins,63,,9,12,21
062 Partschins,64,,17,19,36
062 Partschins,65,,16,18,34
062 Partschins,66,,25,27,52
062 Partschins,67,,12,15,27
062 Partschins,68,,18,14,32
062 Partschins,69,,21,23,44
062 Partschins,70,,12,16,28
062 Partschins,71,,23,28,51
062 Partschins,72,,13,13,26
062 Partschins,73,,12,13,25
062 Partschins,74,,15,13,28
062 Partschins,75,,13,15,28
062 Partschins,76,,13,16,29
062 Partschins,77,,8,8,16
062 Partschins,78,,9,16,25
062 Partschins,79,,8,16,24
062 Partschins,80,,13,10,23
062 Partschins,81,,11,17,28
062 Partschins,82,,7,9,16
062 Partschins,83,,10,7,17
062 Partschins,84,,7,6,13
062 Partschins,85,,9,10,19
062 Partschins,86,,6,8,14
062 Partschins,87,,4,7,11
062 Partschins,88,,3,9,12
062 Partschins,89,,5,7,12
062 Partschins,90,,2,4,6
062 Partschins,91,,7,3,10
062 Partschins,92,,-,1,1
062 Partschins,93,,2,3,5
062 Partschins,94,,1,-,1
062 Partschins,95,,-,2,2
062 Partschins,96,,-,1,1
062 Partschins,97,,-,1,1
062 Partschins,Insgesamt,,1.774,1.810,3.584
063 Percha,0,,6,8,14
063 Percha,1,,5,10,15
063 Percha,2,,4,12,16
063 Percha,3,,11,7,18
063 Percha,4,,8,6,14
063 Percha,5,,10,6,16
063 Percha,6,,2,3,5
063 Percha,7,,6,9,15
063 Percha,8,,10,16,26
063 Percha,9,,9,7,16
063 Percha,10,,10,7,17
063 Percha,11,,4,5,9
063 Percha,12,,11,9,20
063 Percha,13,,6,8,14
063 Percha,14,,8,8,16
063 Percha,15,,12,15,27
063 Percha,16,,10,5,15
063 Percha,17,,7,8,15
063 Percha,18,,9,12,21
063 Percha,19,,7,8,15
063 Percha,20,,13,7,20
063 Percha,21,,11,10,21
063 Percha,22,,8,7,15
063 Percha,23,,6,10,16
063 Percha,24,,6,4,10
063 Percha,25,,10,20,30
063 Percha,26,,5,10,15
063 Percha,27,,7,12,19
063 Percha,28,,16,4,20
063 Percha,29,,16,12,28
063 Percha,30,,6,14,20
063 Percha,31,,11,8,19
063 Percha,32,,11,5,16
063 Percha,33,,5,12,17
063 Percha,34,,13,13,26
063 Percha,35,,10,5,15
063 Percha,36,,12,16,28
063 Percha,37,,7,12,19
063 Percha,38,,9,11,20
063 Percha,39,,15,12,27
063 Percha,40,,12,10,22
063 Percha,41,,19,18,37
063 Percha,42,,8,9,17
063 Percha,43,,20,13,33
063 Percha,44,,17,16,33
063 Percha,45,,10,10,20
063 Percha,46,,20,6,26
063 Percha,47,,15,20,35
063 Percha,48,,15,7,22
063 Percha,49,,11,15,26
063 Percha,50,,17,10,27
063 Percha,51,,8,13,21
063 Percha,52,,14,8,22
063 Percha,53,,6,11,17
063 Percha,54,,9,8,17
063 Percha,55,,9,5,14
063 Percha,56,,6,14,20
063 Percha,57,,9,9,18
063 Percha,58,,5,6,11
063 Percha,59,,8,6,14
063 Percha,60,,6,10,16
063 Percha,61,,7,7,14
063 Percha,62,,6,7,13
063 Percha,63,,9,5,14
063 Percha,64,,5,5,10
063 Percha,65,,5,6,11
063 Percha,66,,7,8,15
063 Percha,67,,8,5,13
063 Percha,68,,12,4,16
063 Percha,69,,7,8,15
063 Percha,70,,8,7,15
063 Percha,71,,6,7,13
063 Percha,72,,4,5,9
063 Percha,73,,6,5,11
063 Percha,74,,5,9,14
063 Percha,75,,2,5,7
063 Percha,76,,3,1,4
063 Percha,77,,3,4,7
063 Percha,78,,6,5,11
063 Percha,79,,3,5,8
063 Percha,80,,4,3,7
063 Percha,81,,5,1,6
063 Percha,82,,6,2,8
063 Percha,83,,-,3,3
063 Percha,84,,1,2,3
063 Percha,85,,4,2,6
063 Percha,86,,2,5,7
063 Percha,87,,2,4,6
063 Percha,89,,1,2,3
063 Percha,90,,1,-,1
063 Percha,Insgesamt,,734,729,1.463
064 Plaus,0,,3,6,9
064 Plaus,1,,5,1,6
064 Plaus,2,,7,4,11
064 Plaus,3,,4,4,8
064 Plaus,4,,5,4,9
064 Plaus,5,,5,5,10
064 Plaus,6,,4,1,5
064 Plaus,7,,4,1,5
064 Plaus,8,,5,3,8
064 Plaus,9,,3,4,7
064 Plaus,10,,5,7,12
064 Plaus,11,,8,4,12
064 Plaus,12,,11,5,16
064 Plaus,13,,12,7,19
064 Plaus,14,,6,7,13
064 Plaus,15,,7,5,12
064 Plaus,16,,4,3,7
064 Plaus,17,,2,2,4
064 Plaus,18,,8,1,9
064 Plaus,19,,11,3,14
064 Plaus,20,,7,8,15
064 Plaus,21,,3,9,12
064 Plaus,22,,4,3,7
064 Plaus,23,,6,5,11
064 Plaus,24,,5,3,8
064 Plaus,25,,5,3,8
064 Plaus,26,,-,3,3
064 Plaus,27,,3,5,8
064 Plaus,28,,6,3,9
064 Plaus,29,,1,4,5
064 Plaus,30,,-,4,4
064 Plaus,31,,2,7,9
064 Plaus,32,,6,4,10
064 Plaus,33,,4,5,9
064 Plaus,34,,3,4,7
064 Plaus,35,,1,8,9
064 Plaus,36,,5,3,8
064 Plaus,37,,13,5,18
064 Plaus,38,,7,11,18
064 Plaus,39,,11,5,16
064 Plaus,40,,6,6,12
064 Plaus,41,,6,9,15
064 Plaus,42,,6,4,10
064 Plaus,43,,7,10,17
064 Plaus,44,,4,8,12
064 Plaus,45,,9,10,19
064 Plaus,46,,4,5,9
064 Plaus,47,,13,3,16
064 Plaus,48,,7,9,16
064 Plaus,49,,2,4,6
064 Plaus,50,,9,5,14
064 Plaus,51,,7,3,10
064 Plaus,52,,2,8,10
064 Plaus,53,,7,1,8
064 Plaus,54,,3,3,6
064 Plaus,55,,2,3,5
064 Plaus,56,,3,2,5
064 Plaus,57,,1,5,6
064 Plaus,58,,1,1,2
064 Plaus,59,,3,5,8
064 Plaus,60,,4,1,5
064 Plaus,61,,4,3,7
064 Plaus,62,,1,2,3
064 Plaus,63,,5,3,8
064 Plaus,64,,1,4,5
064 Plaus,65,,2,4,6
064 Plaus,66,,4,1,5
064 Plaus,67,,4,1,5
064 Plaus,68,,3,2,5
064 Plaus,69,,5,1,6
064 Plaus,70,,1,4,5
064 Plaus,71,,3,2,5
064 Plaus,72,,3,1,4
064 Plaus,73,,4,2,6
064 Plaus,74,,1,-,1
064 Plaus,75,,3,3,6
064 Plaus,77,,1,2,3
064 Plaus,78,,4,1,5
064 Plaus,79,,2,3,5
064 Plaus,80,,2,3,5
064 Plaus,81,,-,1,1
064 Plaus,83,,1,1,2
064 Plaus,84,,-,1,1
064 Plaus,85,,1,1,2
064 Plaus,86,,-,1,1
064 Plaus,88,,-,2,2
064 Plaus,89,,-,1,1
064 Plaus,93,,-,1,1
064 Plaus,97,,-,1,1
064 Plaus,Insgesamt,,372,336,708
065 Waidbruck,0,,1,-,1
065 Waidbruck,1,,1,2,3
065 Waidbruck,3,,2,4,6
065 Waidbruck,5,,3,-,3
065 Waidbruck,6,,3,-,3
065 Waidbruck,8,,1,1,2
065 Waidbruck,9,,-,2,2
065 Waidbruck,10,,1,1,2
065 Waidbruck,11,,1,-,1
065 Waidbruck,12,,1,2,3
065 Waidbruck,13,,2,1,3
065 Waidbruck,15,,4,3,7
065 Waidbruck,16,,4,1,5
065 Waidbruck,17,,1,2,3
065 Waidbruck,18,,3,2,5
065 Waidbruck,19,,2,2,4
065 Waidbruck,20,,-,4,4
065 Waidbruck,21,,2,-,2
065 Waidbruck,22,,-,2,2
065 Waidbruck,23,,3,1,4
065 Waidbruck,24,,-,1,1
065 Waidbruck,25,,2,1,3
065 Waidbruck,26,,1,2,3
065 Waidbruck,27,,3,-,3
065 Waidbruck,28,,2,-,2
065 Waidbruck,29,,2,-,2
065 Waidbruck,31,,3,2,5
065 Waidbruck,32,,1,1,2
065 Waidbruck,34,,4,-,4
065 Waidbruck,35,,-,1,1
065 Waidbruck,37,,1,1,2
065 Waidbruck,38,,2,2,4
065 Waidbruck,39,,-,1,1
065 Waidbruck,40,,2,2,4
065 Waidbruck,41,,2,-,2
065 Waidbruck,42,,1,2,3
065 Waidbruck,43,,4,2,6
065 Waidbruck,44,,2,2,4
065 Waidbruck,45,,2,4,6
065 Waidbruck,46,,3,3,6
065 Waidbruck,47,,3,1,4
065 Waidbruck,48,,3,-,3
065 Waidbruck,49,,-,2,2
065 Waidbruck,50,,1,1,2
065 Waidbruck,51,,1,2,3
065 Waidbruck,52,,3,1,4
065 Waidbruck,53,,2,1,3
065 Waidbruck,54,,-,1,1
065 Waidbruck,55,,2,1,3
065 Waidbruck,56,,2,-,2
065 Waidbruck,57,,3,-,3
065 Waidbruck,60,,1,1,2
065 Waidbruck,61,,-,1,1
065 Waidbruck,65,,-,1,1
065 Waidbruck,66,,-,3,3
065 Waidbruck,67,,1,1,2
065 Waidbruck,68,,2,1,3
065 Waidbruck,70,,1,1,2
065 Waidbruck,71,,-,1,1
065 Waidbruck,72,,-,3,3
065 Waidbruck,73,,1,-,1
065 Waidbruck,74,,-,2,2
065 Waidbruck,75,,1,-,1
065 Waidbruck,76,,1,1,2
065 Waidbruck,77,,-,3,3
065 Waidbruck,78,,1,1,2
065 Waidbruck,80,,-,3,3
065 Waidbruck,81,,1,-,1
065 Waidbruck,82,,1,-,1
065 Waidbruck,83,,-,1,1
065 Waidbruck,84,,1,-,1
065 Waidbruck,85,,1,1,2
065 Waidbruck,86,,-,1,1
065 Waidbruck,87,,1,-,1
065 Waidbruck,89,,-,1,1
065 Waidbruck,92,,-,1,1
065 Waidbruck,Insgesamt,,106,95,201
066 Burgstall,0,,8,8,16
066 Burgstall,1,,14,16,30
066 Burgstall,2,,11,13,24
066 Burgstall,3,,16,8,24
066 Burgstall,4,,15,15,30
066 Burgstall,5,,11,7,18
066 Burgstall,6,,7,11,18
066 Burgstall,7,,6,7,13
066 Burgstall,8,,14,8,22
066 Burgstall,9,,8,12,20
066 Burgstall,10,,8,12,20
066 Burgstall,11,,9,9,18
066 Burgstall,12,,11,11,22
066 Burgstall,13,,10,9,19
066 Burgstall,14,,9,7,16
066 Burgstall,15,,11,6,17
066 Burgstall,16,,6,7,13
066 Burgstall,17,,13,7,20
066 Burgstall,18,,6,4,10
066 Burgstall,19,,7,11,18
066 Burgstall,20,,7,7,14
066 Burgstall,21,,7,10,17
066 Burgstall,22,,13,10,23
066 Burgstall,23,,13,5,18
066 Burgstall,24,,7,10,17
066 Burgstall,25,,9,12,21
066 Burgstall,26,,10,6,16
066 Burgstall,27,,8,13,21
066 Burgstall,28,,11,17,28
066 Burgstall,29,,11,14,25
066 Burgstall,30,,11,15,26
066 Burgstall,31,,10,9,19
066 Burgstall,32,,12,10,22
066 Burgstall,33,,15,13,28
066 Burgstall,34,,9,10,19
066 Burgstall,35,,12,18,30
066 Burgstall,36,,7,11,18
066 Burgstall,37,,22,17,39
066 Burgstall,38,,8,14,22
066 Burgstall,39,,11,21,32
066 Burgstall,40,,14,21,35
066 Burgstall,41,,17,14,31
066 Burgstall,42,,19,16,35
066 Burgstall,43,,18,11,29
066 Burgstall,44,,21,18,39
066 Burgstall,45,,13,13,26
066 Burgstall,46,,16,18,34
066 Burgstall,47,,18,17,35
066 Burgstall,48,,15,12,27
066 Burgstall,49,,18,16,34
066 Burgstall,50,,15,12,27
066 Burgstall,51,,17,19,36
066 Burgstall,52,,15,12,27
066 Burgstall,53,,11,7,18
066 Burgstall,54,,15,10,25
066 Burgstall,55,,10,10,20
066 Burgstall,56,,13,11,24
066 Burgstall,57,,8,10,18
066 Burgstall,58,,11,17,28
066 Burgstall,59,,9,11,20
066 Burgstall,60,,13,13,26
066 Burgstall,61,,13,6,19
066 Burgstall,62,,10,11,21
066 Burgstall,63,,8,9,17
066 Burgstall,64,,7,11,18
066 Burgstall,65,,7,10,17
066 Burgstall,66,,9,9,18
066 Burgstall,67,,8,8,16
066 Burgstall,68,,8,10,18
066 Burgstall,69,,11,7,18
066 Burgstall,70,,5,5,10
066 Burgstall,71,,6,5,11
066 Burgstall,72,,4,12,16
066 Burgstall,73,,5,8,13
066 Burgstall,74,,9,12,21
066 Burgstall,75,,4,8,12
066 Burgstall,76,,4,6,10
066 Burgstall,77,,7,3,10
066 Burgstall,78,,4,8,12
066 Burgstall,79,,7,4,11
066 Burgstall,80,,2,7,9
066 Burgstall,81,,6,3,9
066 Burgstall,82,,4,5,9
066 Burgstall,83,,-,4,4
066 Burgstall,84,,3,5,8
066 Burgstall,85,,1,10,11
066 Burgstall,86,,3,8,11
066 Burgstall,87,,1,3,4
066 Burgstall,88,,1,5,6
066 Burgstall,89,,1,1,2
066 Burgstall,90,,1,3,4
066 Burgstall,92,,1,-,1
066 Burgstall,93,,-,1,1
066 Burgstall,94,,-,1,1
066 Burgstall,95,,1,-,1
066 Burgstall,97,,-,1,1
066 Burgstall,Insgesamt,,880,927,1.807
067 Prad am Stilfser Joch,0,,12,15,27
067 Prad am Stilfser Joch,1,,13,15,28
067 Prad am Stilfser Joch,2,,19,13,32
067 Prad am Stilfser Joch,3,,14,12,26
067 Prad am Stilfser Joch,4,,16,17,33
067 Prad am Stilfser Joch,5,,13,11,24
067 Prad am Stilfser Joch,6,,17,17,34
067 Prad am Stilfser Joch,7,,20,14,34
067 Prad am Stilfser Joch,8,,20,22,42
067 Prad am Stilfser Joch,9,,14,14,28
067 Prad am Stilfser Joch,10,,10,18,28
067 Prad am Stilfser Joch,11,,24,16,40
067 Prad am Stilfser Joch,12,,18,17,35
067 Prad am Stilfser Joch,13,,19,21,40
067 Prad am Stilfser Joch,14,,20,23,43
067 Prad am Stilfser Joch,15,,28,18,46
067 Prad am Stilfser Joch,16,,22,21,43
067 Prad am Stilfser Joch,17,,20,14,34
067 Prad am Stilfser Joch,18,,24,27,51
067 Prad am Stilfser Joch,19,,23,28,51
067 Prad am Stilfser Joch,20,,19,22,41
067 Prad am Stilfser Joch,21,,19,11,30
067 Prad am Stilfser Joch,22,,20,21,41
067 Prad am Stilfser Joch,23,,18,16,34
067 Prad am Stilfser Joch,24,,35,19,54
067 Prad am Stilfser Joch,25,,12,20,32
067 Prad am Stilfser Joch,26,,24,30,54
067 Prad am Stilfser Joch,27,,26,20,46
067 Prad am Stilfser Joch,28,,29,24,53
067 Prad am Stilfser Joch,29,,24,26,50
067 Prad am Stilfser Joch,30,,24,17,41
067 Prad am Stilfser Joch,31,,20,20,40
067 Prad am Stilfser Joch,32,,30,20,50
067 Prad am Stilfser Joch,33,,16,20,36
067 Prad am Stilfser Joch,34,,24,20,44
067 Prad am Stilfser Joch,35,,21,26,47
067 Prad am Stilfser Joch,36,,26,18,44
067 Prad am Stilfser Joch,37,,21,19,40
067 Prad am Stilfser Joch,38,,27,17,44
067 Prad am Stilfser Joch,39,,19,39,58
067 Prad am Stilfser Joch,40,,24,25,49
067 Prad am Stilfser Joch,41,,27,25,52
067 Prad am Stilfser Joch,42,,27,24,51
067 Prad am Stilfser Joch,43,,30,30,60
067 Prad am Stilfser Joch,44,,32,36,68
067 Prad am Stilfser Joch,45,,27,23,50
067 Prad am Stilfser Joch,46,,35,26,61
067 Prad am Stilfser Joch,47,,34,27,61
067 Prad am Stilfser Joch,48,,22,27,49
067 Prad am Stilfser Joch,49,,30,10,40
067 Prad am Stilfser Joch,50,,28,33,61
067 Prad am Stilfser Joch,51,,23,27,50
067 Prad am Stilfser Joch,52,,18,25,43
067 Prad am Stilfser Joch,53,,34,15,49
067 Prad am Stilfser Joch,54,,20,27,47
067 Prad am Stilfser Joch,55,,27,25,52
067 Prad am Stilfser Joch,56,,24,24,48
067 Prad am Stilfser Joch,57,,25,19,44
067 Prad am Stilfser Joch,58,,26,16,42
067 Prad am Stilfser Joch,59,,28,18,46
067 Prad am Stilfser Joch,60,,14,20,34
067 Prad am Stilfser Joch,61,,17,23,40
067 Prad am Stilfser Joch,62,,19,17,36
067 Prad am Stilfser Joch,63,,21,21,42
067 Prad am Stilfser Joch,64,,19,11,30
067 Prad am Stilfser Joch,65,,15,12,27
067 Prad am Stilfser Joch,66,,17,13,30
067 Prad am Stilfser Joch,67,,13,11,24
067 Prad am Stilfser Joch,68,,10,15,25
067 Prad am Stilfser Joch,69,,23,17,40
067 Prad am Stilfser Joch,70,,15,16,31
067 Prad am Stilfser Joch,71,,25,8,33
067 Prad am Stilfser Joch,72,,7,16,23
067 Prad am Stilfser Joch,73,,11,16,27
067 Prad am Stilfser Joch,74,,15,12,27
067 Prad am Stilfser Joch,75,,5,10,15
067 Prad am Stilfser Joch,76,,7,9,16
067 Prad am Stilfser Joch,77,,14,11,25
067 Prad am Stilfser Joch,78,,6,20,26
067 Prad am Stilfser Joch,79,,12,10,22
067 Prad am Stilfser Joch,80,,8,18,26
067 Prad am Stilfser Joch,81,,6,10,16
067 Prad am Stilfser Joch,82,,8,9,17
067 Prad am Stilfser Joch,83,,7,12,19
067 Prad am Stilfser Joch,84,,5,6,11
067 Prad am Stilfser Joch,85,,4,9,13
067 Prad am Stilfser Joch,86,,4,3,7
067 Prad am Stilfser Joch,87,,4,3,7
067 Prad am Stilfser Joch,88,,2,4,6
067 Prad am Stilfser Joch,89,,2,7,9
067 Prad am Stilfser Joch,90,,-,6,6
067 Prad am Stilfser Joch,91,,1,1,2
067 Prad am Stilfser Joch,92,,-,2,2
067 Prad am Stilfser Joch,93,,3,1,4
067 Prad am Stilfser Joch,96,,-,1,1
067 Prad am Stilfser Joch,98,,-,1,1
067 Prad am Stilfser Joch,Insgesamt,,1.700,1.641,3.341
068 Prettau,0,,2,-,2
068 Prettau,1,,6,3,9
068 Prettau,2,,2,1,3
068 Prettau,3,,2,1,3
068 Prettau,4,,7,3,10
068 Prettau,5,,6,2,8
068 Prettau,6,,5,7,12
068 Prettau,7,,2,1,3
068 Prettau,8,,4,5,9
068 Prettau,9,,2,4,6
068 Prettau,10,,1,2,3
068 Prettau,11,,3,5,8
068 Prettau,12,,1,3,4
068 Prettau,13,,5,6,11
068 Prettau,14,,6,3,9
068 Prettau,15,,1,6,7
068 Prettau,16,,1,2,3
068 Prettau,17,,4,4,8
068 Prettau,18,,3,7,10
068 Prettau,19,,3,5,8
068 Prettau,20,,2,3,5
068 Prettau,21,,1,4,5
068 Prettau,22,,1,7,8
068 Prettau,23,,-,2,2
068 Prettau,24,,4,1,5
068 Prettau,25,,4,1,5
068 Prettau,26,,1,2,3
068 Prettau,27,,2,1,3
068 Prettau,28,,4,8,12
068 Prettau,29,,4,2,6
068 Prettau,30,,2,3,5
068 Prettau,31,,2,-,2
068 Prettau,32,,4,4,8
068 Prettau,33,,5,2,7
068 Prettau,34,,2,2,4
068 Prettau,35,,3,3,6
068 Prettau,36,,1,3,4
068 Prettau,37,,3,2,5
068 Prettau,38,,5,1,6
068 Prettau,39,,5,6,11
068 Prettau,40,,9,4,13
068 Prettau,41,,4,6,10
068 Prettau,42,,3,6,9
068 Prettau,43,,6,5,11
068 Prettau,44,,3,2,5
068 Prettau,45,,10,3,13
068 Prettau,46,,6,1,7
068 Prettau,47,,3,7,10
068 Prettau,48,,6,6,12
068 Prettau,49,,5,5,10
068 Prettau,50,,2,5,7
068 Prettau,51,,5,5,10
068 Prettau,52,,6,4,10
068 Prettau,53,,5,2,7
068 Prettau,54,,7,-,7
068 Prettau,55,,4,1,5
068 Prettau,56,,5,5,10
068 Prettau,57,,6,4,10
068 Prettau,58,,5,2,7
068 Prettau,59,,3,3,6
068 Prettau,60,,4,3,7
068 Prettau,61,,3,2,5
068 Prettau,62,,2,2,4
068 Prettau,63,,2,3,5
068 Prettau,64,,2,1,3
068 Prettau,65,,4,5,9
068 Prettau,66,,6,3,9
068 Prettau,67,,1,2,3
068 Prettau,68,,6,5,11
068 Prettau,69,,4,3,7
068 Prettau,70,,3,2,5
068 Prettau,71,,3,2,5
068 Prettau,72,,4,4,8
068 Prettau,73,,5,3,8
068 Prettau,74,,5,6,11
068 Prettau,75,,2,6,8
068 Prettau,76,,3,3,6
068 Prettau,77,,3,1,4
068 Prettau,78,,1,3,4
068 Prettau,79,,3,3,6
068 Prettau,80,,3,-,3
068 Prettau,81,,1,1,2
068 Prettau,82,,4,4,8
068 Prettau,83,,3,5,8
068 Prettau,84,,-,1,1
068 Prettau,85,,3,1,4
068 Prettau,86,,-,4,4
068 Prettau,87,,-,1,1
068 Prettau,89,,-,1,1
068 Prettau,90,,1,-,1
068 Prettau,94,,1,1,2
068 Prettau,99,,-,1,1
068 Prettau,Insgesamt,,306,285,591
069 Proveis,0,,1,1,2
069 Proveis,1,,-,1,1
069 Proveis,2,,1,1,2
069 Proveis,3,,3,1,4
069 Proveis,4,,-,1,1
069 Proveis,5,,1,1,2
069 Proveis,6,,2,-,2
069 Proveis,7,,-,4,4
069 Proveis,8,,2,2,4
069 Proveis,9,,3,1,4
069 Proveis,10,,4,-,4
069 Proveis,11,,1,1,2
069 Proveis,12,,-,1,1
069 Proveis,13,,4,1,5
069 Proveis,14,,2,2,4
069 Proveis,15,,1,3,4
069 Proveis,16,,1,1,2
069 Proveis,17,,-,5,5
069 Proveis,18,,2,-,2
069 Proveis,19,,2,1,3
069 Proveis,20,,3,1,4
069 Proveis,21,,4,2,6
069 Proveis,22,,-,1,1
069 Proveis,23,,1,1,2
069 Proveis,24,,2,3,5
069 Proveis,25,,1,2,3
069 Proveis,26,,3,-,3
069 Proveis,27,,6,-,6
069 Proveis,28,,3,3,6
069 Proveis,29,,2,-,2
069 Proveis,30,,2,-,2
069 Proveis,31,,2,3,5
069 Proveis,33,,2,1,3
069 Proveis,34,,1,2,3
069 Proveis,35,,2,1,3
069 Proveis,36,,1,1,2
069 Proveis,37,,2,1,3
069 Proveis,38,,3,2,5
069 Proveis,39,,2,-,2
069 Proveis,40,,1,1,2
069 Proveis,41,,-,1,1
069 Proveis,42,,3,3,6
069 Proveis,43,,3,4,7
069 Proveis,44,,3,1,4
069 Proveis,45,,2,1,3
069 Proveis,46,,2,2,4
069 Proveis,47,,1,1,2
069 Proveis,48,,2,1,3
069 Proveis,49,,4,2,6
069 Proveis,50,,4,1,5
069 Proveis,51,,3,1,4
069 Proveis,52,,1,4,5
069 Proveis,53,,4,-,4
069 Proveis,54,,1,3,4
069 Proveis,55,,2,2,4
069 Proveis,56,,4,2,6
069 Proveis,57,,4,4,8
069 Proveis,58,,3,2,5
069 Proveis,59,,1,1,2
069 Proveis,60,,2,3,5
069 Proveis,61,,2,-,2
069 Proveis,62,,1,1,2
069 Proveis,63,,1,-,1
069 Proveis,64,,2,1,3
069 Proveis,65,,1,2,3
069 Proveis,66,,2,-,2
069 Proveis,67,,1,-,1
069 Proveis,68,,2,-,2
069 Proveis,69,,2,1,3
069 Proveis,70,,1,1,2
069 Proveis,71,,1,1,2
069 Proveis,72,,2,-,2
069 Proveis,73,,1,3,4
069 Proveis,74,,-,2,2
069 Proveis,75,,1,1,2
069 Proveis,76,,1,1,2
069 Proveis,77,,1,1,2
069 Proveis,79,,-,2,2
069 Proveis,80,,-,1,1
069 Proveis,81,,1,1,2
069 Proveis,83,,2,1,3
069 Proveis,84,,2,-,2
069 Proveis,85,,-,1,1
069 Proveis,88,,1,-,1
069 Proveis,90,,-,1,1
069 Proveis,92,,-,1,1
069 Proveis,Insgesamt,,150,115,265
070 Ratschings,0,,24,25,49
070 Ratschings,1,,20,21,41
070 Ratschings,2,,28,27,55
070 Ratschings,3,,21,22,43
070 Ratschings,4,,21,17,38
070 Ratschings,5,,29,24,53
070 Ratschings,6,,27,25,52
070 Ratschings,7,,22,28,50
070 Ratschings,8,,35,25,60
070 Ratschings,9,,35,23,58
070 Ratschings,10,,16,27,43
070 Ratschings,11,,27,35,62
070 Ratschings,12,,36,26,62
070 Ratschings,13,,29,22,51
070 Ratschings,14,,35,20,55
070 Ratschings,15,,37,34,71
070 Ratschings,16,,29,31,60
070 Ratschings,17,,27,27,54
070 Ratschings,18,,25,28,53
070 Ratschings,19,,29,21,50
070 Ratschings,20,,37,31,68
070 Ratschings,21,,25,22,47
070 Ratschings,22,,32,31,63
070 Ratschings,23,,27,20,47
070 Ratschings,24,,33,27,60
070 Ratschings,25,,25,27,52
070 Ratschings,26,,30,29,59
070 Ratschings,27,,31,37,68
070 Ratschings,28,,26,24,50
070 Ratschings,29,,34,24,58
070 Ratschings,30,,34,30,64
070 Ratschings,31,,30,27,57
070 Ratschings,32,,24,28,52
070 Ratschings,33,,35,31,66
070 Ratschings,34,,33,25,58
070 Ratschings,35,,32,28,60
070 Ratschings,36,,19,20,39
070 Ratschings,37,,41,37,78
070 Ratschings,38,,36,23,59
070 Ratschings,39,,36,35,71
070 Ratschings,40,,41,38,79
070 Ratschings,41,,40,40,80
070 Ratschings,42,,36,41,77
070 Ratschings,43,,39,44,83
070 Ratschings,44,,53,41,94
070 Ratschings,45,,33,39,72
070 Ratschings,46,,42,48,90
070 Ratschings,47,,35,43,78
070 Ratschings,48,,50,39,89
070 Ratschings,49,,46,25,71
070 Ratschings,50,,35,40,75
070 Ratschings,51,,34,26,60
070 Ratschings,52,,42,26,68
070 Ratschings,53,,42,27,69
070 Ratschings,54,,29,26,55
070 Ratschings,55,,31,19,50
070 Ratschings,56,,39,20,59
070 Ratschings,57,,15,33,48
070 Ratschings,58,,25,15,40
070 Ratschings,59,,22,24,46
070 Ratschings,60,,17,19,36
070 Ratschings,61,,20,14,34
070 Ratschings,62,,27,21,48
070 Ratschings,63,,20,24,44
070 Ratschings,64,,29,18,47
070 Ratschings,65,,17,17,34
070 Ratschings,66,,21,7,28
070 Ratschings,67,,20,19,39
070 Ratschings,68,,15,11,26
070 Ratschings,69,,16,13,29
070 Ratschings,70,,18,17,35
070 Ratschings,71,,18,15,33
070 Ratschings,72,,15,16,31
070 Ratschings,73,,11,17,28
070 Ratschings,74,,14,18,32
070 Ratschings,75,,13,8,21
070 Ratschings,76,,8,10,18
070 Ratschings,77,,11,14,25
070 Ratschings,78,,9,8,17
070 Ratschings,79,,10,18,28
070 Ratschings,80,,11,10,21
070 Ratschings,81,,6,11,17
070 Ratschings,82,,5,15,20
070 Ratschings,83,,7,16,23
070 Ratschings,84,,4,8,12
070 Ratschings,85,,3,9,12
070 Ratschings,86,,5,8,13
070 Ratschings,87,,3,6,9
070 Ratschings,88,,1,7,8
070 Ratschings,89,,3,2,5
070 Ratschings,90,,1,4,5
070 Ratschings,91,,1,4,5
070 Ratschings,92,,-,5,5
070 Ratschings,93,,1,-,1
070 Ratschings,94,,-,1,1
070 Ratschings,97,,-,1,1
070 Ratschings,Insgesamt,,2.281,2.129,4.410
071 Rasen-Antholz,0,,10,21,31
071 Rasen-Antholz,1,,17,16,33
071 Rasen-Antholz,2,,12,8,20
071 Rasen-Antholz,3,,17,18,35
071 Rasen-Antholz,4,,20,6,26
071 Rasen-Antholz,5,,18,18,36
071 Rasen-Antholz,6,,16,20,36
071 Rasen-Antholz,7,,26,16,42
071 Rasen-Antholz,8,,14,21,35
071 Rasen-Antholz,9,,11,23,34
071 Rasen-Antholz,10,,14,20,34
071 Rasen-Antholz,11,,19,21,40
071 Rasen-Antholz,12,,25,22,47
071 Rasen-Antholz,13,,14,19,33
071 Rasen-Antholz,14,,21,15,36
071 Rasen-Antholz,15,,25,23,48
071 Rasen-Antholz,16,,27,19,46
071 Rasen-Antholz,17,,8,16,24
071 Rasen-Antholz,18,,20,11,31
071 Rasen-Antholz,19,,17,16,33
071 Rasen-Antholz,20,,27,20,47
071 Rasen-Antholz,21,,15,16,31
071 Rasen-Antholz,22,,14,22,36
071 Rasen-Antholz,23,,19,18,37
071 Rasen-Antholz,24,,17,17,34
071 Rasen-Antholz,25,,27,10,37
071 Rasen-Antholz,26,,15,24,39
071 Rasen-Antholz,27,,26,12,38
071 Rasen-Antholz,28,,20,23,43
071 Rasen-Antholz,29,,13,20,33
071 Rasen-Antholz,30,,18,19,37
071 Rasen-Antholz,31,,16,13,29
071 Rasen-Antholz,32,,13,10,23
071 Rasen-Antholz,33,,19,25,44
071 Rasen-Antholz,34,,16,23,39
071 Rasen-Antholz,35,,14,15,29
071 Rasen-Antholz,36,,25,11,36
071 Rasen-Antholz,37,,17,22,39
071 Rasen-Antholz,38,,25,18,43
071 Rasen-Antholz,39,,28,25,53
071 Rasen-Antholz,40,,20,21,41
071 Rasen-Antholz,41,,24,24,48
071 Rasen-Antholz,42,,24,24,48
071 Rasen-Antholz,43,,25,25,50
071 Rasen-Antholz,44,,24,27,51
071 Rasen-Antholz,45,,26,28,54
071 Rasen-Antholz,46,,28,19,47
071 Rasen-Antholz,47,,31,23,54
071 Rasen-Antholz,48,,31,22,53
071 Rasen-Antholz,49,,18,21,39
071 Rasen-Antholz,50,,27,19,46
071 Rasen-Antholz,51,,18,25,43
071 Rasen-Antholz,52,,21,25,46
071 Rasen-Antholz,53,,27,18,45
071 Rasen-Antholz,54,,24,15,39
071 Rasen-Antholz,55,,20,9,29
071 Rasen-Antholz,56,,20,14,34
071 Rasen-Antholz,57,,19,14,33
071 Rasen-Antholz,58,,14,14,28
071 Rasen-Antholz,59,,14,9,23
071 Rasen-Antholz,60,,12,15,27
071 Rasen-Antholz,61,,11,11,22
071 Rasen-Antholz,62,,13,8,21
071 Rasen-Antholz,63,,14,9,23
071 Rasen-Antholz,64,,14,11,25
071 Rasen-Antholz,65,,10,14,24
071 Rasen-Antholz,66,,9,15,24
071 Rasen-Antholz,67,,11,9,20
071 Rasen-Antholz,68,,9,8,17
071 Rasen-Antholz,69,,13,12,25
071 Rasen-Antholz,70,,10,13,23
071 Rasen-Antholz,71,,13,12,25
071 Rasen-Antholz,72,,8,16,24
071 Rasen-Antholz,73,,15,12,27
071 Rasen-Antholz,74,,12,7,19
071 Rasen-Antholz,75,,7,10,17
071 Rasen-Antholz,76,,9,11,20
071 Rasen-Antholz,77,,7,9,16
071 Rasen-Antholz,78,,9,10,19
071 Rasen-Antholz,79,,6,12,18
071 Rasen-Antholz,80,,8,10,18
071 Rasen-Antholz,81,,11,14,25
071 Rasen-Antholz,82,,4,9,13
071 Rasen-Antholz,83,,6,3,9
071 Rasen-Antholz,84,,1,4,5
071 Rasen-Antholz,85,,4,4,8
071 Rasen-Antholz,86,,3,6,9
071 Rasen-Antholz,87,,5,6,11
071 Rasen-Antholz,88,,4,3,7
071 Rasen-Antholz,89,,-,6,6
071 Rasen-Antholz,90,,1,4,5
071 Rasen-Antholz,91,,3,-,3
071 Rasen-Antholz,93,,-,1,1
071 Rasen-Antholz,95,,-,2,2
071 Rasen-Antholz,96,,-,1,1
071 Rasen-Antholz,97,,1,-,1
071 Rasen-Antholz,98,,1,-,1
071 Rasen-Antholz,Insgesamt,,1.454,1.405,2.859
072 Ritten,0,,39,42,81
072 Ritten,1,,44,43,87
072 Ritten,2,,46,38,84
072 Ritten,3,,42,46,88
072 Ritten,4,,37,56,93
072 Ritten,5,,46,51,97
072 Ritten,6,,60,49,109
072 Ritten,7,,46,50,96
072 Ritten,8,,51,54,105
072 Ritten,9,,46,40,86
072 Ritten,10,,35,52,87
072 Ritten,11,,51,46,97
072 Ritten,12,,47,45,92
072 Ritten,13,,52,54,106
072 Ritten,14,,42,44,86
072 Ritten,15,,58,55,113
072 Ritten,16,,42,52,94
072 Ritten,17,,59,42,101
072 Ritten,18,,62,49,111
072 Ritten,19,,57,49,106
072 Ritten,20,,47,70,117
072 Ritten,21,,63,50,113
072 Ritten,22,,61,49,110
072 Ritten,23,,53,39,92
072 Ritten,24,,56,50,106
072 Ritten,25,,51,41,92
072 Ritten,26,,50,49,99
072 Ritten,27,,45,56,101
072 Ritten,28,,48,27,75
072 Ritten,29,,49,53,102
072 Ritten,30,,40,52,92
072 Ritten,31,,53,52,105
072 Ritten,32,,47,48,95
072 Ritten,33,,50,53,103
072 Ritten,34,,48,46,94
072 Ritten,35,,62,32,94
072 Ritten,36,,47,51,98
072 Ritten,37,,57,49,106
072 Ritten,38,,58,60,118
072 Ritten,39,,59,50,109
072 Ritten,40,,51,65,116
072 Ritten,41,,55,67,122
072 Ritten,42,,56,72,128
072 Ritten,43,,52,73,125
072 Ritten,44,,72,65,137
072 Ritten,45,,77,49,126
072 Ritten,46,,65,47,112
072 Ritten,47,,75,42,117
072 Ritten,48,,66,58,124
072 Ritten,49,,64,51,115
072 Ritten,50,,52,60,112
072 Ritten,51,,45,58,103
072 Ritten,52,,61,59,120
072 Ritten,53,,70,53,123
072 Ritten,54,,34,46,80
072 Ritten,55,,39,41,80
072 Ritten,56,,49,45,94
072 Ritten,57,,49,39,88
072 Ritten,58,,35,36,71
072 Ritten,59,,48,30,78
072 Ritten,60,,42,44,86
072 Ritten,61,,45,35,80
072 Ritten,62,,32,41,73
072 Ritten,63,,33,47,80
072 Ritten,64,,49,37,86
072 Ritten,65,,30,30,60
072 Ritten,66,,25,38,63
072 Ritten,67,,20,28,48
072 Ritten,68,,36,39,75
072 Ritten,69,,36,37,73
072 Ritten,70,,41,34,75
072 Ritten,71,,39,37,76
072 Ritten,72,,32,23,55
072 Ritten,73,,35,30,65
072 Ritten,74,,29,31,60
072 Ritten,75,,24,22,46
072 Ritten,76,,17,23,40
072 Ritten,77,,21,26,47
072 Ritten,78,,20,27,47
072 Ritten,79,,11,23,34
072 Ritten,80,,11,19,30
072 Ritten,81,,10,27,37
072 Ritten,82,,7,20,27
072 Ritten,83,,15,16,31
072 Ritten,84,,9,12,21
072 Ritten,85,,12,12,24
072 Ritten,86,,7,13,20
072 Ritten,87,,2,21,23
072 Ritten,88,,9,16,25
072 Ritten,89,,11,14,25
072 Ritten,90,,1,8,9
072 Ritten,91,,1,11,12
072 Ritten,92,,3,7,10
072 Ritten,93,,1,2,3
072 Ritten,94,,-,3,3
072 Ritten,96,,-,1,1
072 Ritten,97,,1,3,4
072 Ritten,98,,-,1,1
072 Ritten,100,,1,-,1
072 Ritten,101,,1,1,2
072 Ritten,Insgesamt,,3.840,3.849,7.689
073 Riffian,0,,3,9,12
073 Riffian,1,,13,13,26
073 Riffian,2,,6,8,14
073 Riffian,3,,6,10,16
073 Riffian,4,,13,5,18
073 Riffian,5,,12,9,21
073 Riffian,6,,5,8,13
073 Riffian,7,,11,8,19
073 Riffian,8,,7,3,10
073 Riffian,9,,8,8,16
073 Riffian,10,,9,7,16
073 Riffian,11,,11,9,20
073 Riffian,12,,10,8,18
073 Riffian,13,,9,9,18
073 Riffian,14,,10,7,17
073 Riffian,15,,9,7,16
073 Riffian,16,,5,8,13
073 Riffian,17,,5,10,15
073 Riffian,18,,6,9,15
073 Riffian,19,,6,7,13
073 Riffian,20,,10,9,19
073 Riffian,21,,13,15,28
073 Riffian,22,,7,7,14
073 Riffian,23,,14,2,16
073 Riffian,24,,8,11,19
073 Riffian,25,,6,9,15
073 Riffian,26,,11,9,20
073 Riffian,27,,10,5,15
073 Riffian,28,,7,6,13
073 Riffian,29,,9,8,17
073 Riffian,30,,10,13,23
073 Riffian,31,,8,9,17
073 Riffian,32,,3,6,9
073 Riffian,33,,8,7,15
073 Riffian,34,,13,7,20
073 Riffian,35,,12,13,25
073 Riffian,36,,9,4,13
073 Riffian,37,,9,15,24
073 Riffian,38,,11,12,23
073 Riffian,39,,9,9,18
073 Riffian,40,,12,25,37
073 Riffian,41,,11,13,24
073 Riffian,42,,7,9,16
073 Riffian,43,,15,14,29
073 Riffian,44,,10,14,24
073 Riffian,45,,11,13,24
073 Riffian,46,,13,6,19
073 Riffian,47,,10,5,15
073 Riffian,48,,11,8,19
073 Riffian,49,,16,12,28
073 Riffian,50,,8,12,20
073 Riffian,51,,8,8,16
073 Riffian,52,,13,5,18
073 Riffian,53,,7,13,20
073 Riffian,54,,8,7,15
073 Riffian,55,,6,10,16
073 Riffian,56,,10,5,15
073 Riffian,57,,3,7,10
073 Riffian,58,,10,6,16
073 Riffian,59,,7,4,11
073 Riffian,60,,6,4,10
073 Riffian,61,,6,10,16
073 Riffian,62,,4,3,7
073 Riffian,63,,7,6,13
073 Riffian,64,,5,3,8
073 Riffian,65,,3,4,7
073 Riffian,66,,2,8,10
073 Riffian,67,,6,3,9
073 Riffian,68,,9,8,17
073 Riffian,69,,6,7,13
073 Riffian,70,,14,8,22
073 Riffian,71,,7,3,10
073 Riffian,72,,4,4,8
073 Riffian,73,,4,9,13
073 Riffian,74,,8,4,12
073 Riffian,75,,4,5,9
073 Riffian,76,,3,4,7
073 Riffian,77,,-,3,3
073 Riffian,78,,-,3,3
073 Riffian,79,,4,5,9
073 Riffian,80,,1,5,6
073 Riffian,81,,3,7,10
073 Riffian,82,,4,4,8
073 Riffian,83,,-,7,7
073 Riffian,84,,2,5,7
073 Riffian,85,,2,4,6
073 Riffian,86,,3,3,6
073 Riffian,87,,3,1,4
073 Riffian,88,,2,2,4
073 Riffian,89,,2,5,7
073 Riffian,90,,1,-,1
073 Riffian,91,,-,2,2
073 Riffian,92,,-,2,2
073 Riffian,95,,-,1,1
073 Riffian,97,,-,1,1
073 Riffian,Insgesamt,,672,687,1.359
074 Mühlbach,0,,19,18,37
074 Mühlbach,1,,26,15,41
074 Mühlbach,2,,14,26,40
074 Mühlbach,3,,20,14,34
074 Mühlbach,4,,21,16,37
074 Mühlbach,5,,22,24,46
074 Mühlbach,6,,13,8,21
074 Mühlbach,7,,17,11,28
074 Mühlbach,8,,15,21,36
074 Mühlbach,9,,24,10,34
074 Mühlbach,10,,21,18,39
074 Mühlbach,11,,14,19,33
074 Mühlbach,12,,16,18,34
074 Mühlbach,13,,19,14,33
074 Mühlbach,14,,19,20,39
074 Mühlbach,15,,20,17,37
074 Mühlbach,16,,19,16,35
074 Mühlbach,17,,14,15,29
074 Mühlbach,18,,23,14,37
074 Mühlbach,19,,18,22,40
074 Mühlbach,20,,15,25,40
074 Mühlbach,21,,15,21,36
074 Mühlbach,22,,12,17,29
074 Mühlbach,23,,17,21,38
074 Mühlbach,24,,23,14,37
074 Mühlbach,25,,21,19,40
074 Mühlbach,26,,18,9,27
074 Mühlbach,27,,20,25,45
074 Mühlbach,28,,20,27,47
074 Mühlbach,29,,20,21,41
074 Mühlbach,30,,27,33,60
074 Mühlbach,31,,27,18,45
074 Mühlbach,32,,19,21,40
074 Mühlbach,33,,25,20,45
074 Mühlbach,34,,29,26,55
074 Mühlbach,35,,24,17,41
074 Mühlbach,36,,19,24,43
074 Mühlbach,37,,19,20,39
074 Mühlbach,38,,23,18,41
074 Mühlbach,39,,25,20,45
074 Mühlbach,40,,28,21,49
074 Mühlbach,41,,31,28,59
074 Mühlbach,42,,30,17,47
074 Mühlbach,43,,23,36,59
074 Mühlbach,44,,34,17,51
074 Mühlbach,45,,23,19,42
074 Mühlbach,46,,29,17,46
074 Mühlbach,47,,24,23,47
074 Mühlbach,48,,16,23,39
074 Mühlbach,49,,21,22,43
074 Mühlbach,50,,21,19,40
074 Mühlbach,51,,25,25,50
074 Mühlbach,52,,24,15,39
074 Mühlbach,53,,22,18,40
074 Mühlbach,54,,20,13,33
074 Mühlbach,55,,16,22,38
074 Mühlbach,56,,20,25,45
074 Mühlbach,57,,21,18,39
074 Mühlbach,58,,13,21,34
074 Mühlbach,59,,18,19,37
074 Mühlbach,60,,16,22,38
074 Mühlbach,61,,12,20,32
074 Mühlbach,62,,22,18,40
074 Mühlbach,63,,15,12,27
074 Mühlbach,64,,17,13,30
074 Mühlbach,65,,11,19,30
074 Mühlbach,66,,19,11,30
074 Mühlbach,67,,8,7,15
074 Mühlbach,68,,15,12,27
074 Mühlbach,69,,11,10,21
074 Mühlbach,70,,15,13,28
074 Mühlbach,71,,16,17,33
074 Mühlbach,72,,11,11,22
074 Mühlbach,73,,9,16,25
074 Mühlbach,74,,12,7,19
074 Mühlbach,75,,5,12,17
074 Mühlbach,76,,6,6,12
074 Mühlbach,77,,7,10,17
074 Mühlbach,78,,10,14,24
074 Mühlbach,79,,9,10,19
074 Mühlbach,80,,4,6,10
074 Mühlbach,81,,6,8,14
074 Mühlbach,82,,6,7,13
074 Mühlbach,83,,4,2,6
074 Mühlbach,84,,3,14,17
074 Mühlbach,85,,4,6,10
074 Mühlbach,86,,3,7,10
074 Mühlbach,87,,4,4,8
074 Mühlbach,88,,3,4,7
074 Mühlbach,89,,2,3,5
074 Mühlbach,90,,1,7,8
074 Mühlbach,91,,-,3,3
074 Mühlbach,92,,2,4,6
074 Mühlbach,93,,-,2,2
074 Mühlbach,98,,-,1,1
074 Mühlbach,Insgesamt,,1.539,1.508,3.047
075 Rodeneck,0,,5,3,8
075 Rodeneck,1,,2,7,9
075 Rodeneck,2,,7,4,11
075 Rodeneck,3,,3,7,10
075 Rodeneck,4,,7,10,17
075 Rodeneck,5,,7,7,14
075 Rodeneck,6,,4,3,7
075 Rodeneck,7,,9,8,17
075 Rodeneck,8,,7,4,11
075 Rodeneck,9,,8,7,15
075 Rodeneck,10,,8,3,11
075 Rodeneck,11,,10,3,13
075 Rodeneck,12,,6,14,20
075 Rodeneck,13,,8,11,19
075 Rodeneck,14,,12,7,19
075 Rodeneck,15,,10,7,17
075 Rodeneck,16,,13,9,22
075 Rodeneck,17,,5,9,14
075 Rodeneck,18,,6,12,18
075 Rodeneck,19,,6,7,13
075 Rodeneck,20,,11,10,21
075 Rodeneck,21,,6,7,13
075 Rodeneck,22,,12,9,21
075 Rodeneck,23,,7,5,12
075 Rodeneck,24,,11,10,21
075 Rodeneck,25,,5,5,10
075 Rodeneck,26,,6,11,17
075 Rodeneck,27,,12,8,20
075 Rodeneck,28,,13,9,22
075 Rodeneck,29,,10,11,21
075 Rodeneck,30,,6,6,12
075 Rodeneck,31,,10,5,15
075 Rodeneck,32,,9,11,20
075 Rodeneck,33,,8,3,11
075 Rodeneck,34,,6,6,12
075 Rodeneck,35,,6,6,12
075 Rodeneck,36,,10,8,18
075 Rodeneck,37,,7,8,15
075 Rodeneck,38,,5,6,11
075 Rodeneck,39,,16,10,26
075 Rodeneck,40,,8,9,17
075 Rodeneck,41,,14,4,18
075 Rodeneck,42,,6,11,17
075 Rodeneck,43,,15,10,25
075 Rodeneck,44,,8,11,19
075 Rodeneck,45,,11,10,21
075 Rodeneck,46,,16,8,24
075 Rodeneck,47,,7,7,14
075 Rodeneck,48,,11,13,24
075 Rodeneck,49,,10,10,20
075 Rodeneck,50,,10,11,21
075 Rodeneck,51,,9,10,19
075 Rodeneck,52,,6,10,16
075 Rodeneck,53,,10,6,16
075 Rodeneck,54,,7,4,11
075 Rodeneck,55,,6,7,13
075 Rodeneck,56,,8,4,12
075 Rodeneck,57,,7,6,13
075 Rodeneck,58,,10,3,13
075 Rodeneck,59,,3,1,4
075 Rodeneck,60,,7,4,11
075 Rodeneck,61,,3,3,6
075 Rodeneck,62,,1,8,9
075 Rodeneck,63,,2,5,7
075 Rodeneck,64,,4,7,11
075 Rodeneck,65,,5,4,9
075 Rodeneck,66,,10,7,17
075 Rodeneck,67,,2,5,7
075 Rodeneck,68,,3,4,7
075 Rodeneck,69,,2,2,4
075 Rodeneck,70,,1,6,7
075 Rodeneck,71,,10,3,13
075 Rodeneck,72,,5,4,9
075 Rodeneck,73,,3,9,12
075 Rodeneck,74,,3,3,6
075 Rodeneck,75,,2,4,6
075 Rodeneck,76,,1,2,3
075 Rodeneck,77,,3,2,5
075 Rodeneck,78,,1,10,11
075 Rodeneck,79,,3,-,3
075 Rodeneck,80,,4,6,10
075 Rodeneck,81,,4,2,6
075 Rodeneck,82,,4,5,9
075 Rodeneck,83,,6,1,7
075 Rodeneck,84,,3,4,7
075 Rodeneck,85,,1,3,4
075 Rodeneck,86,,1,4,5
075 Rodeneck,87,,1,3,4
075 Rodeneck,88,,3,2,5
075 Rodeneck,89,,2,-,2
075 Rodeneck,90,,-,1,1
075 Rodeneck,91,,1,-,1
075 Rodeneck,94,,-,2,2
075 Rodeneck,Insgesamt,,602,576,1.178
076 Salurn,0,,23,27,50
076 Salurn,1,,23,21,44
076 Salurn,2,,29,13,42
076 Salurn,3,,20,30,50
076 Salurn,4,,28,24,52
076 Salurn,5,,25,25,50
076 Salurn,6,,25,22,47
076 Salurn,7,,16,23,39
076 Salurn,8,,25,18,43
076 Salurn,9,,30,18,48
076 Salurn,10,,17,17,34
076 Salurn,11,,16,18,34
076 Salurn,12,,19,21,40
076 Salurn,13,,21,16,37
076 Salurn,14,,19,26,45
076 Salurn,15,,13,15,28
076 Salurn,16,,27,22,49
076 Salurn,17,,21,15,36
076 Salurn,18,,19,20,39
076 Salurn,19,,19,20,39
076 Salurn,20,,25,21,46
076 Salurn,21,,15,22,37
076 Salurn,22,,15,19,34
076 Salurn,23,,18,24,42
076 Salurn,24,,23,26,49
076 Salurn,25,,25,21,46
076 Salurn,26,,18,19,37
076 Salurn,27,,18,26,44
076 Salurn,28,,15,21,36
076 Salurn,29,,16,25,41
076 Salurn,30,,20,22,42
076 Salurn,31,,23,30,53
076 Salurn,32,,28,26,54
076 Salurn,33,,17,30,47
076 Salurn,34,,22,26,48
076 Salurn,35,,31,26,57
076 Salurn,36,,27,22,49
076 Salurn,37,,29,25,54
076 Salurn,38,,26,21,47
076 Salurn,39,,28,35,63
076 Salurn,40,,33,24,57
076 Salurn,41,,39,30,69
076 Salurn,42,,32,31,63
076 Salurn,43,,25,28,53
076 Salurn,44,,34,26,60
076 Salurn,45,,26,24,50
076 Salurn,46,,25,27,52
076 Salurn,47,,29,33,62
076 Salurn,48,,35,30,65
076 Salurn,49,,39,31,70
076 Salurn,50,,31,30,61
076 Salurn,51,,33,33,66
076 Salurn,52,,21,26,47
076 Salurn,53,,27,28,55
076 Salurn,54,,31,18,49
076 Salurn,55,,21,21,42
076 Salurn,56,,18,13,31
076 Salurn,57,,21,20,41
076 Salurn,58,,19,19,38
076 Salurn,59,,18,18,36
076 Salurn,60,,28,22,50
076 Salurn,61,,26,20,46
076 Salurn,62,,25,16,41
076 Salurn,63,,26,11,37
076 Salurn,64,,13,22,35
076 Salurn,65,,16,21,37
076 Salurn,66,,22,16,38
076 Salurn,67,,12,10,22
076 Salurn,68,,19,18,37
076 Salurn,69,,16,17,33
076 Salurn,70,,21,17,38
076 Salurn,71,,16,16,32
076 Salurn,72,,11,10,21
076 Salurn,73,,12,7,19
076 Salurn,74,,5,10,15
076 Salurn,75,,10,12,22
076 Salurn,76,,13,19,32
076 Salurn,77,,11,16,27
076 Salurn,78,,9,7,16
076 Salurn,79,,9,6,15
076 Salurn,80,,6,16,22
076 Salurn,81,,6,9,15
076 Salurn,82,,11,10,21
076 Salurn,83,,10,11,21
076 Salurn,84,,7,14,21
076 Salurn,85,,1,15,16
076 Salurn,86,,6,8,14
076 Salurn,87,,4,9,13
076 Salurn,88,,2,8,10
076 Salurn,89,,3,4,7
076 Salurn,90,,1,7,8
076 Salurn,91,,1,5,6
076 Salurn,92,,3,6,9
076 Salurn,93,,1,6,7
076 Salurn,94,,-,3,3
076 Salurn,95,,-,2,2
076 Salurn,97,,1,-,1
076 Salurn,101,,-,2,2
076 Salurn,Insgesamt,,1.814,1.836,3.650
077 Innichen,0,,12,20,32
077 Innichen,1,,25,20,45
077 Innichen,2,,20,12,32
077 Innichen,3,,11,15,26
077 Innichen,4,,22,13,35
077 Innichen,5,,15,17,32
077 Innichen,6,,14,15,29
077 Innichen,7,,15,16,31
077 Innichen,8,,11,12,23
077 Innichen,9,,19,16,35
077 Innichen,10,,15,16,31
077 Innichen,11,,24,16,40
077 Innichen,12,,15,18,33
077 Innichen,13,,11,16,27
077 Innichen,14,,19,14,33
077 Innichen,15,,21,16,37
077 Innichen,16,,17,18,35
077 Innichen,17,,21,11,32
077 Innichen,18,,18,17,35
077 Innichen,19,,25,20,45
077 Innichen,20,,23,16,39
077 Innichen,21,,17,25,42
077 Innichen,22,,20,15,35
077 Innichen,23,,20,24,44
077 Innichen,24,,27,21,48
077 Innichen,25,,23,22,45
077 Innichen,26,,27,19,46
077 Innichen,27,,24,23,47
077 Innichen,28,,21,19,40
077 Innichen,29,,25,24,49
077 Innichen,30,,28,25,53
077 Innichen,31,,18,19,37
077 Innichen,32,,25,17,42
077 Innichen,33,,29,29,58
077 Innichen,34,,13,13,26
077 Innichen,35,,21,23,44
077 Innichen,36,,15,27,42
077 Innichen,37,,19,15,34
077 Innichen,38,,24,17,41
077 Innichen,39,,22,21,43
077 Innichen,40,,23,25,48
077 Innichen,41,,23,18,41
077 Innichen,42,,23,31,54
077 Innichen,43,,18,28,46
077 Innichen,44,,24,22,46
077 Innichen,45,,27,29,56
077 Innichen,46,,26,32,58
077 Innichen,47,,37,29,66
077 Innichen,48,,31,32,63
077 Innichen,49,,29,26,55
077 Innichen,50,,30,24,54
077 Innichen,51,,23,25,48
077 Innichen,52,,28,20,48
077 Innichen,53,,28,22,50
077 Innichen,54,,22,25,47
077 Innichen,55,,17,26,43
077 Innichen,56,,27,14,41
077 Innichen,57,,25,22,47
077 Innichen,58,,23,10,33
077 Innichen,59,,24,19,43
077 Innichen,60,,11,25,36
077 Innichen,61,,12,17,29
077 Innichen,62,,15,20,35
077 Innichen,63,,18,16,34
077 Innichen,64,,16,13,29
077 Innichen,65,,12,14,26
077 Innichen,66,,14,16,30
077 Innichen,67,,10,10,20
077 Innichen,68,,10,14,24
077 Innichen,69,,20,9,29
077 Innichen,70,,17,20,37
077 Innichen,71,,13,20,33
077 Innichen,72,,9,23,32
077 Innichen,73,,12,13,25
077 Innichen,74,,8,12,20
077 Innichen,75,,8,11,19
077 Innichen,76,,8,20,28
077 Innichen,77,,4,17,21
077 Innichen,78,,11,12,23
077 Innichen,79,,9,7,16
077 Innichen,80,,10,16,26
077 Innichen,81,,9,17,26
077 Innichen,82,,13,12,25
077 Innichen,83,,9,13,22
077 Innichen,84,,8,12,20
077 Innichen,85,,2,11,13
077 Innichen,86,,9,10,19
077 Innichen,87,,2,12,14
077 Innichen,88,,5,2,7
077 Innichen,89,,4,7,11
077 Innichen,90,,2,7,9
077 Innichen,91,,2,6,8
077 Innichen,92,,1,6,7
077 Innichen,93,,2,2,4
077 Innichen,96,,1,1,2
077 Innichen,97,,-,1,1
077 Innichen,Insgesamt,,1.615,1.655,3.270
079 Jenesien,0,,14,11,25
079 Jenesien,1,,15,10,25
079 Jenesien,2,,19,18,37
079 Jenesien,3,,18,19,37
079 Jenesien,4,,22,21,43
079 Jenesien,5,,23,18,41
079 Jenesien,6,,22,25,47
079 Jenesien,7,,15,18,33
079 Jenesien,8,,18,19,37
079 Jenesien,9,,18,21,39
079 Jenesien,10,,14,18,32
079 Jenesien,11,,18,22,40
079 Jenesien,12,,18,16,34
079 Jenesien,13,,26,21,47
079 Jenesien,14,,15,29,44
079 Jenesien,15,,21,18,39
079 Jenesien,16,,25,11,36
079 Jenesien,17,,24,17,41
079 Jenesien,18,,21,21,42
079 Jenesien,19,,16,18,34
079 Jenesien,20,,29,20,49
079 Jenesien,21,,22,20,42
079 Jenesien,22,,20,16,36
079 Jenesien,23,,18,15,33
079 Jenesien,24,,25,15,40
079 Jenesien,25,,16,16,32
079 Jenesien,26,,16,15,31
079 Jenesien,27,,17,9,26
079 Jenesien,28,,16,16,32
079 Jenesien,29,,17,17,34
079 Jenesien,30,,16,19,35
079 Jenesien,31,,17,20,37
079 Jenesien,32,,18,16,34
079 Jenesien,33,,20,13,33
079 Jenesien,34,,13,20,33
079 Jenesien,35,,18,15,33
079 Jenesien,36,,17,19,36
079 Jenesien,37,,10,20,30
079 Jenesien,38,,23,25,48
079 Jenesien,39,,24,31,55
079 Jenesien,40,,27,25,52
079 Jenesien,41,,30,26,56
079 Jenesien,42,,30,33,63
079 Jenesien,43,,33,20,53
079 Jenesien,44,,18,25,43
079 Jenesien,45,,18,23,41
079 Jenesien,46,,37,29,66
079 Jenesien,47,,36,30,66
079 Jenesien,48,,33,32,65
079 Jenesien,49,,28,25,53
079 Jenesien,50,,26,23,49
079 Jenesien,51,,31,20,51
079 Jenesien,52,,25,12,37
079 Jenesien,53,,22,16,38
079 Jenesien,54,,23,9,32
079 Jenesien,55,,13,17,30
079 Jenesien,56,,15,14,29
079 Jenesien,57,,10,11,21
079 Jenesien,58,,19,14,33
079 Jenesien,59,,13,10,23
079 Jenesien,60,,12,20,32
079 Jenesien,61,,12,10,22
079 Jenesien,62,,12,21,33
079 Jenesien,63,,12,13,25
079 Jenesien,64,,14,9,23
079 Jenesien,65,,13,12,25
079 Jenesien,66,,10,9,19
079 Jenesien,67,,7,14,21
079 Jenesien,68,,12,11,23
079 Jenesien,69,,16,9,25
079 Jenesien,70,,14,9,23
079 Jenesien,71,,13,21,34
079 Jenesien,72,,15,11,26
079 Jenesien,73,,12,18,30
079 Jenesien,74,,16,10,26
079 Jenesien,75,,9,15,24
079 Jenesien,76,,5,18,23
079 Jenesien,77,,6,8,14
079 Jenesien,78,,8,6,14
079 Jenesien,79,,15,8,23
079 Jenesien,80,,5,9,14
079 Jenesien,81,,6,7,13
079 Jenesien,82,,5,11,16
079 Jenesien,83,,4,12,16
079 Jenesien,84,,6,6,12
079 Jenesien,85,,3,8,11
079 Jenesien,86,,5,7,12
079 Jenesien,87,,-,5,5
079 Jenesien,88,,4,4,8
079 Jenesien,89,,1,2,3
079 Jenesien,90,,1,5,6
079 Jenesien,91,,1,3,4
079 Jenesien,92,,1,1,2
079 Jenesien,93,,-,2,2
079 Jenesien,94,,-,1,1
079 Jenesien,99,,-,1,1
079 Jenesien,Insgesamt,,1.516,1.478,2.994
080 St.Leonhard in Pass.,0,,16,22,38
080 St.Leonhard in Pass.,1,,15,22,37
080 St.Leonhard in Pass.,2,,21,26,47
080 St.Leonhard in Pass.,3,,20,20,40
080 St.Leonhard in Pass.,4,,20,22,42
080 St.Leonhard in Pass.,5,,22,23,45
080 St.Leonhard in Pass.,6,,18,25,43
080 St.Leonhard in Pass.,7,,22,20,42
080 St.Leonhard in Pass.,8,,17,21,38
080 St.Leonhard in Pass.,9,,25,15,40
080 St.Leonhard in Pass.,10,,22,19,41
080 St.Leonhard in Pass.,11,,28,14,42
080 St.Leonhard in Pass.,12,,22,17,39
080 St.Leonhard in Pass.,13,,22,22,44
080 St.Leonhard in Pass.,14,,20,21,41
080 St.Leonhard in Pass.,15,,23,21,44
080 St.Leonhard in Pass.,16,,24,20,44
080 St.Leonhard in Pass.,17,,22,13,35
080 St.Leonhard in Pass.,18,,20,20,40
080 St.Leonhard in Pass.,19,,27,22,49
080 St.Leonhard in Pass.,20,,22,20,42
080 St.Leonhard in Pass.,21,,19,23,42
080 St.Leonhard in Pass.,22,,24,20,44
080 St.Leonhard in Pass.,23,,39,32,71
080 St.Leonhard in Pass.,24,,22,28,50
080 St.Leonhard in Pass.,25,,29,23,52
080 St.Leonhard in Pass.,26,,33,31,64
080 St.Leonhard in Pass.,27,,24,24,48
080 St.Leonhard in Pass.,28,,26,22,48
080 St.Leonhard in Pass.,29,,27,22,49
080 St.Leonhard in Pass.,30,,28,26,54
080 St.Leonhard in Pass.,31,,25,32,57
080 St.Leonhard in Pass.,32,,22,26,48
080 St.Leonhard in Pass.,33,,28,22,50
080 St.Leonhard in Pass.,34,,28,26,54
080 St.Leonhard in Pass.,35,,27,25,52
080 St.Leonhard in Pass.,36,,14,30,44
080 St.Leonhard in Pass.,37,,27,13,40
080 St.Leonhard in Pass.,38,,33,22,55
080 St.Leonhard in Pass.,39,,27,31,58
080 St.Leonhard in Pass.,40,,27,25,52
080 St.Leonhard in Pass.,41,,34,21,55
080 St.Leonhard in Pass.,42,,20,24,44
080 St.Leonhard in Pass.,43,,24,26,50
080 St.Leonhard in Pass.,44,,32,21,53
080 St.Leonhard in Pass.,45,,23,25,48
080 St.Leonhard in Pass.,46,,34,28,62
080 St.Leonhard in Pass.,47,,31,31,62
080 St.Leonhard in Pass.,48,,25,28,53
080 St.Leonhard in Pass.,49,,21,23,44
080 St.Leonhard in Pass.,50,,22,32,54
080 St.Leonhard in Pass.,51,,28,23,51
080 St.Leonhard in Pass.,52,,31,19,50
080 St.Leonhard in Pass.,53,,30,26,56
080 St.Leonhard in Pass.,54,,25,20,45
080 St.Leonhard in Pass.,55,,20,28,48
080 St.Leonhard in Pass.,56,,25,16,41
080 St.Leonhard in Pass.,57,,25,16,41
080 St.Leonhard in Pass.,58,,18,14,32
080 St.Leonhard in Pass.,59,,28,24,52
080 St.Leonhard in Pass.,60,,20,24,44
080 St.Leonhard in Pass.,61,,24,16,40
080 St.Leonhard in Pass.,62,,16,15,31
080 St.Leonhard in Pass.,63,,22,10,32
080 St.Leonhard in Pass.,64,,22,11,33
080 St.Leonhard in Pass.,65,,19,14,33
080 St.Leonhard in Pass.,66,,15,18,33
080 St.Leonhard in Pass.,67,,9,10,19
080 St.Leonhard in Pass.,68,,11,12,23
080 St.Leonhard in Pass.,69,,9,24,33
080 St.Leonhard in Pass.,70,,8,12,20
080 St.Leonhard in Pass.,71,,13,14,27
080 St.Leonhard in Pass.,72,,18,12,30
080 St.Leonhard in Pass.,73,,18,18,36
080 St.Leonhard in Pass.,74,,11,14,25
080 St.Leonhard in Pass.,75,,15,7,22
080 St.Leonhard in Pass.,76,,15,11,26
080 St.Leonhard in Pass.,77,,9,11,20
080 St.Leonhard in Pass.,78,,6,14,20
080 St.Leonhard in Pass.,79,,9,13,22
080 St.Leonhard in Pass.,80,,6,12,18
080 St.Leonhard in Pass.,81,,5,13,18
080 St.Leonhard in Pass.,82,,5,9,14
080 St.Leonhard in Pass.,83,,6,5,11
080 St.Leonhard in Pass.,84,,5,11,16
080 St.Leonhard in Pass.,85,,3,10,13
080 St.Leonhard in Pass.,86,,4,7,11
080 St.Leonhard in Pass.,87,,4,6,10
080 St.Leonhard in Pass.,88,,2,6,8
080 St.Leonhard in Pass.,89,,4,4,8
080 St.Leonhard in Pass.,90,,-,5,5
080 St.Leonhard in Pass.,91,,1,4,5
080 St.Leonhard in Pass.,92,,1,1,2
080 St.Leonhard in Pass.,95,,-,1,1
080 St.Leonhard in Pass.,97,,1,-,1
080 St.Leonhard in Pass.,100,,-,2,2
080 St.Leonhard in Pass.,Insgesamt,,1.809,1.749,3.558
081 St.Lorenzen,0,,19,9,28
081 St.Lorenzen,1,,19,22,41
081 St.Lorenzen,2,,29,20,49
081 St.Lorenzen,3,,19,23,42
081 St.Lorenzen,4,,23,20,43
081 St.Lorenzen,5,,22,21,43
081 St.Lorenzen,6,,15,20,35
081 St.Lorenzen,7,,26,18,44
081 St.Lorenzen,8,,26,22,48
081 St.Lorenzen,9,,26,18,44
081 St.Lorenzen,10,,17,19,36
081 St.Lorenzen,11,,29,21,50
081 St.Lorenzen,12,,21,29,50
081 St.Lorenzen,13,,28,26,54
081 St.Lorenzen,14,,33,25,58
081 St.Lorenzen,15,,17,31,48
081 St.Lorenzen,16,,29,30,59
081 St.Lorenzen,17,,25,14,39
081 St.Lorenzen,18,,32,20,52
081 St.Lorenzen,19,,24,32,56
081 St.Lorenzen,20,,25,21,46
081 St.Lorenzen,21,,23,16,39
081 St.Lorenzen,22,,26,23,49
081 St.Lorenzen,23,,16,16,32
081 St.Lorenzen,24,,19,25,44
081 St.Lorenzen,25,,20,26,46
081 St.Lorenzen,26,,24,27,51
081 St.Lorenzen,27,,27,28,55
081 St.Lorenzen,28,,29,25,54
081 St.Lorenzen,29,,27,22,49
081 St.Lorenzen,30,,30,20,50
081 St.Lorenzen,31,,25,18,43
081 St.Lorenzen,32,,23,26,49
081 St.Lorenzen,33,,26,32,58
081 St.Lorenzen,34,,28,19,47
081 St.Lorenzen,35,,29,18,47
081 St.Lorenzen,36,,27,18,45
081 St.Lorenzen,37,,26,28,54
081 St.Lorenzen,38,,27,33,60
081 St.Lorenzen,39,,33,33,66
081 St.Lorenzen,40,,38,35,73
081 St.Lorenzen,41,,33,31,64
081 St.Lorenzen,42,,28,32,60
081 St.Lorenzen,43,,25,33,58
081 St.Lorenzen,44,,44,34,78
081 St.Lorenzen,45,,30,38,68
081 St.Lorenzen,46,,37,31,68
081 St.Lorenzen,47,,32,28,60
081 St.Lorenzen,48,,33,23,56
081 St.Lorenzen,49,,34,31,65
081 St.Lorenzen,50,,28,36,64
081 St.Lorenzen,51,,24,40,64
081 St.Lorenzen,52,,33,19,52
081 St.Lorenzen,53,,31,23,54
081 St.Lorenzen,54,,31,33,64
081 St.Lorenzen,55,,22,26,48
081 St.Lorenzen,56,,25,28,53
081 St.Lorenzen,57,,16,18,34
081 St.Lorenzen,58,,13,20,33
081 St.Lorenzen,59,,24,18,42
081 St.Lorenzen,60,,18,11,29
081 St.Lorenzen,61,,17,16,33
081 St.Lorenzen,62,,17,19,36
081 St.Lorenzen,63,,10,23,33
081 St.Lorenzen,64,,16,14,30
081 St.Lorenzen,65,,20,8,28
081 St.Lorenzen,66,,18,10,28
081 St.Lorenzen,67,,10,18,28
081 St.Lorenzen,68,,17,15,32
081 St.Lorenzen,69,,13,15,28
081 St.Lorenzen,70,,18,20,38
081 St.Lorenzen,71,,17,16,33
081 St.Lorenzen,72,,13,12,25
081 St.Lorenzen,73,,12,18,30
081 St.Lorenzen,74,,12,12,24
081 St.Lorenzen,75,,18,16,34
081 St.Lorenzen,76,,10,13,23
081 St.Lorenzen,77,,9,12,21
081 St.Lorenzen,78,,13,7,20
081 St.Lorenzen,79,,11,7,18
081 St.Lorenzen,80,,8,10,18
081 St.Lorenzen,81,,7,13,20
081 St.Lorenzen,82,,6,6,12
081 St.Lorenzen,83,,9,16,25
081 St.Lorenzen,84,,4,14,18
081 St.Lorenzen,85,,4,5,9
081 St.Lorenzen,86,,6,5,11
081 St.Lorenzen,87,,1,8,9
081 St.Lorenzen,88,,2,6,8
081 St.Lorenzen,89,,2,6,8
081 St.Lorenzen,90,,-,4,4
081 St.Lorenzen,91,,2,3,5
081 St.Lorenzen,92,,-,2,2
081 St.Lorenzen,93,,1,2,3
081 St.Lorenzen,94,,-,1,1
081 St.Lorenzen,98,,-,1,1
081 St.Lorenzen,Insgesamt,,1.911,1.875,3.786
082 St.Martin in Thurn,0,,7,6,13
082 St.Martin in Thurn,1,,13,6,19
082 St.Martin in Thurn,2,,7,8,15
082 St.Martin in Thurn,3,,5,5,10
082 St.Martin in Thurn,4,,7,3,10
082 St.Martin in Thurn,5,,3,10,13
082 St.Martin in Thurn,6,,9,13,22
082 St.Martin in Thurn,7,,11,9,20
082 St.Martin in Thurn,8,,17,13,30
082 St.Martin in Thurn,9,,4,6,10
082 St.Martin in Thurn,10,,15,8,23
082 St.Martin in Thurn,11,,8,14,22
082 St.Martin in Thurn,12,,7,9,16
082 St.Martin in Thurn,13,,9,19,28
082 St.Martin in Thurn,14,,11,11,22
082 St.Martin in Thurn,15,,15,11,26
082 St.Martin in Thurn,16,,24,14,38
082 St.Martin in Thurn,17,,15,11,26
082 St.Martin in Thurn,18,,15,8,23
082 St.Martin in Thurn,19,,9,9,18
082 St.Martin in Thurn,20,,17,14,31
082 St.Martin in Thurn,21,,11,11,22
082 St.Martin in Thurn,22,,6,16,22
082 St.Martin in Thurn,23,,16,13,29
082 St.Martin in Thurn,24,,6,5,11
082 St.Martin in Thurn,25,,13,10,23
082 St.Martin in Thurn,26,,13,11,24
082 St.Martin in Thurn,27,,11,16,27
082 St.Martin in Thurn,28,,8,7,15
082 St.Martin in Thurn,29,,14,10,24
082 St.Martin in Thurn,30,,14,14,28
082 St.Martin in Thurn,31,,14,7,21
082 St.Martin in Thurn,32,,11,7,18
082 St.Martin in Thurn,33,,8,9,17
082 St.Martin in Thurn,34,,17,8,25
082 St.Martin in Thurn,35,,13,9,22
082 St.Martin in Thurn,36,,13,11,24
082 St.Martin in Thurn,37,,8,9,17
082 St.Martin in Thurn,38,,7,12,19
082 St.Martin in Thurn,39,,10,10,20
082 St.Martin in Thurn,40,,12,9,21
082 St.Martin in Thurn,41,,17,14,31
082 St.Martin in Thurn,42,,12,13,25
082 St.Martin in Thurn,43,,15,16,31
082 St.Martin in Thurn,44,,18,14,32
082 St.Martin in Thurn,45,,11,10,21
082 St.Martin in Thurn,46,,16,26,42
082 St.Martin in Thurn,47,,16,21,37
082 St.Martin in Thurn,48,,11,15,26
082 St.Martin in Thurn,49,,14,14,28
082 St.Martin in Thurn,50,,15,16,31
082 St.Martin in Thurn,51,,15,19,34
082 St.Martin in Thurn,52,,16,5,21
082 St.Martin in Thurn,53,,12,9,21
082 St.Martin in Thurn,54,,12,7,19
082 St.Martin in Thurn,55,,12,9,21
082 St.Martin in Thurn,56,,8,5,13
082 St.Martin in Thurn,57,,13,9,22
082 St.Martin in Thurn,58,,8,8,16
082 St.Martin in Thurn,59,,5,10,15
082 St.Martin in Thurn,60,,3,4,7
082 St.Martin in Thurn,61,,8,8,16
082 St.Martin in Thurn,62,,9,6,15
082 St.Martin in Thurn,63,,3,7,10
082 St.Martin in Thurn,64,,7,6,13
082 St.Martin in Thurn,65,,9,7,16
082 St.Martin in Thurn,66,,8,7,15
082 St.Martin in Thurn,67,,7,4,11
082 St.Martin in Thurn,68,,11,9,20
082 St.Martin in Thurn,69,,4,8,12
082 St.Martin in Thurn,70,,7,6,13
082 St.Martin in Thurn,71,,7,6,13
082 St.Martin in Thurn,72,,4,5,9
082 St.Martin in Thurn,73,,6,8,14
082 St.Martin in Thurn,74,,8,7,15
082 St.Martin in Thurn,75,,5,12,17
082 St.Martin in Thurn,76,,4,6,10
082 St.Martin in Thurn,77,,7,5,12
082 St.Martin in Thurn,78,,5,4,9
082 St.Martin in Thurn,79,,3,9,12
082 St.Martin in Thurn,80,,6,7,13
082 St.Martin in Thurn,81,,6,8,14
082 St.Martin in Thurn,82,,4,6,10
082 St.Martin in Thurn,83,,5,6,11
082 St.Martin in Thurn,84,,2,2,4
082 St.Martin in Thurn,85,,2,4,6
082 St.Martin in Thurn,86,,4,2,6
082 St.Martin in Thurn,87,,4,4,8
082 St.Martin in Thurn,88,,4,5,9
082 St.Martin in Thurn,89,,2,5,7
082 St.Martin in Thurn,90,,5,3,8
082 St.Martin in Thurn,91,,1,1,2
082 St.Martin in Thurn,92,,-,4,4
082 St.Martin in Thurn,93,,1,2,3
082 St.Martin in Thurn,94,,-,1,1
082 St.Martin in Thurn,98,,1,-,1
082 St.Martin in Thurn,99,,1,-,1
082 St.Martin in Thurn,Insgesamt,,872,845,1.717
083 St.Martin in Passeier,0,,18,26,44
083 St.Martin in Passeier,1,,13,22,35
083 St.Martin in Passeier,2,,26,14,40
083 St.Martin in Passeier,3,,14,20,34
083 St.Martin in Passeier,4,,21,27,48
083 St.Martin in Passeier,5,,16,22,38
083 St.Martin in Passeier,6,,24,18,42
083 St.Martin in Passeier,7,,21,19,40
083 St.Martin in Passeier,8,,21,21,42
083 St.Martin in Passeier,9,,19,16,35
083 St.Martin in Passeier,10,,17,13,30
083 St.Martin in Passeier,11,,17,16,33
083 St.Martin in Passeier,12,,12,22,34
083 St.Martin in Passeier,13,,8,20,28
083 St.Martin in Passeier,14,,22,20,42
083 St.Martin in Passeier,15,,26,25,51
083 St.Martin in Passeier,16,,21,21,42
083 St.Martin in Passeier,17,,20,18,38
083 St.Martin in Passeier,18,,22,24,46
083 St.Martin in Passeier,19,,19,22,41
083 St.Martin in Passeier,20,,23,18,41
083 St.Martin in Passeier,21,,23,23,46
083 St.Martin in Passeier,22,,21,26,47
083 St.Martin in Passeier,23,,17,21,38
083 St.Martin in Passeier,24,,16,16,32
083 St.Martin in Passeier,25,,18,27,45
083 St.Martin in Passeier,26,,24,22,46
083 St.Martin in Passeier,27,,19,25,44
083 St.Martin in Passeier,28,,23,27,50
083 St.Martin in Passeier,29,,23,12,35
083 St.Martin in Passeier,30,,21,18,39
083 St.Martin in Passeier,31,,24,24,48
083 St.Martin in Passeier,32,,22,26,48
083 St.Martin in Passeier,33,,19,14,33
083 St.Martin in Passeier,34,,31,19,50
083 St.Martin in Passeier,35,,29,25,54
083 St.Martin in Passeier,36,,21,18,39
083 St.Martin in Passeier,37,,23,19,42
083 St.Martin in Passeier,38,,23,21,44
083 St.Martin in Passeier,39,,25,24,49
083 St.Martin in Passeier,40,,19,20,39
083 St.Martin in Passeier,41,,28,24,52
083 St.Martin in Passeier,42,,31,23,54
083 St.Martin in Passeier,43,,33,25,58
083 St.Martin in Passeier,44,,28,25,53
083 St.Martin in Passeier,45,,22,24,46
083 St.Martin in Passeier,46,,28,34,62
083 St.Martin in Passeier,47,,34,24,58
083 St.Martin in Passeier,48,,18,19,37
083 St.Martin in Passeier,49,,33,20,53
083 St.Martin in Passeier,50,,22,30,52
083 St.Martin in Passeier,51,,34,22,56
083 St.Martin in Passeier,52,,24,22,46
083 St.Martin in Passeier,53,,23,23,46
083 St.Martin in Passeier,54,,25,19,44
083 St.Martin in Passeier,55,,25,11,36
083 St.Martin in Passeier,56,,20,17,37
083 St.Martin in Passeier,57,,28,15,43
083 St.Martin in Passeier,58,,11,12,23
083 St.Martin in Passeier,59,,21,16,37
083 St.Martin in Passeier,60,,6,18,24
083 St.Martin in Passeier,61,,22,12,34
083 St.Martin in Passeier,62,,10,15,25
083 St.Martin in Passeier,63,,14,13,27
083 St.Martin in Passeier,64,,11,11,22
083 St.Martin in Passeier,65,,14,14,28
083 St.Martin in Passeier,66,,13,9,22
083 St.Martin in Passeier,67,,12,10,22
083 St.Martin in Passeier,68,,17,13,30
083 St.Martin in Passeier,69,,11,11,22
083 St.Martin in Passeier,70,,13,14,27
083 St.Martin in Passeier,71,,8,14,22
083 St.Martin in Passeier,72,,4,11,15
083 St.Martin in Passeier,73,,6,13,19
083 St.Martin in Passeier,74,,12,8,20
083 St.Martin in Passeier,75,,14,20,34
083 St.Martin in Passeier,76,,12,13,25
083 St.Martin in Passeier,77,,7,14,21
083 St.Martin in Passeier,78,,15,9,24
083 St.Martin in Passeier,79,,11,9,20
083 St.Martin in Passeier,80,,3,8,11
083 St.Martin in Passeier,81,,3,10,13
083 St.Martin in Passeier,82,,3,10,13
083 St.Martin in Passeier,83,,8,10,18
083 St.Martin in Passeier,84,,5,5,10
083 St.Martin in Passeier,85,,5,2,7
083 St.Martin in Passeier,86,,1,10,11
083 St.Martin in Passeier,87,,3,3,6
083 St.Martin in Passeier,88,,2,8,10
083 St.Martin in Passeier,89,,1,5,6
083 St.Martin in Passeier,90,,-,3,3
083 St.Martin in Passeier,91,,-,6,6
083 St.Martin in Passeier,92,,1,1,2
083 St.Martin in Passeier,93,,1,1,2
083 St.Martin in Passeier,94,,-,1,1
083 St.Martin in Passeier,95,,-,2,2
083 St.Martin in Passeier,97,,1,-,1
083 St.Martin in Passeier,Insgesamt,,1.598,1.592,3.190
084 St.Pankraz,0,,5,4,9
084 St.Pankraz,1,,7,6,13
084 St.Pankraz,2,,8,4,12
084 St.Pankraz,3,,11,12,23
084 St.Pankraz,4,,8,9,17
084 St.Pankraz,5,,10,12,22
084 St.Pankraz,6,,8,12,20
084 St.Pankraz,7,,12,9,21
084 St.Pankraz,8,,13,9,22
084 St.Pankraz,9,,13,8,21
084 St.Pankraz,10,,8,3,11
084 St.Pankraz,11,,14,14,28
084 St.Pankraz,12,,12,12,24
084 St.Pankraz,13,,8,4,12
084 St.Pankraz,14,,13,7,20
084 St.Pankraz,15,,8,11,19
084 St.Pankraz,16,,10,8,18
084 St.Pankraz,17,,9,5,14
084 St.Pankraz,18,,8,10,18
084 St.Pankraz,19,,5,11,16
084 St.Pankraz,20,,8,10,18
084 St.Pankraz,21,,11,11,22
084 St.Pankraz,22,,11,4,15
084 St.Pankraz,23,,12,15,27
084 St.Pankraz,24,,13,8,21
084 St.Pankraz,25,,9,7,16
084 St.Pankraz,26,,10,4,14
084 St.Pankraz,27,,8,5,13
084 St.Pankraz,28,,10,6,16
084 St.Pankraz,29,,9,7,16
084 St.Pankraz,30,,11,8,19
084 St.Pankraz,31,,6,16,22
084 St.Pankraz,32,,12,8,20
084 St.Pankraz,33,,4,4,8
084 St.Pankraz,34,,12,9,21
084 St.Pankraz,35,,9,8,17
084 St.Pankraz,36,,4,12,16
084 St.Pankraz,37,,8,12,20
084 St.Pankraz,38,,13,11,24
084 St.Pankraz,39,,11,6,17
084 St.Pankraz,40,,9,19,28
084 St.Pankraz,41,,15,11,26
084 St.Pankraz,42,,13,12,25
084 St.Pankraz,43,,17,9,26
084 St.Pankraz,44,,16,15,31
084 St.Pankraz,45,,8,15,23
084 St.Pankraz,46,,15,7,22
084 St.Pankraz,47,,22,14,36
084 St.Pankraz,48,,12,12,24
084 St.Pankraz,49,,9,9,18
084 St.Pankraz,50,,17,9,26
084 St.Pankraz,51,,12,13,25
084 St.Pankraz,52,,13,4,17
084 St.Pankraz,53,,14,12,26
084 St.Pankraz,54,,5,8,13
084 St.Pankraz,55,,10,8,18
084 St.Pankraz,56,,10,15,25
084 St.Pankraz,57,,6,4,10
084 St.Pankraz,58,,11,7,18
084 St.Pankraz,59,,9,10,19
084 St.Pankraz,60,,15,9,24
084 St.Pankraz,61,,6,2,8
084 St.Pankraz,62,,10,5,15
084 St.Pankraz,63,,7,6,13
084 St.Pankraz,64,,8,2,10
084 St.Pankraz,65,,7,6,13
084 St.Pankraz,66,,4,7,11
084 St.Pankraz,67,,3,6,9
084 St.Pankraz,68,,4,7,11
084 St.Pankraz,69,,12,14,26
084 St.Pankraz,70,,9,15,24
084 St.Pankraz,71,,8,11,19
084 St.Pankraz,72,,7,6,13
084 St.Pankraz,73,,7,7,14
084 St.Pankraz,74,,5,10,15
084 St.Pankraz,75,,9,8,17
084 St.Pankraz,76,,5,3,8
084 St.Pankraz,77,,5,4,9
084 St.Pankraz,78,,4,7,11
084 St.Pankraz,79,,7,3,10
084 St.Pankraz,80,,6,10,16
084 St.Pankraz,81,,5,4,9
084 St.Pankraz,82,,3,6,9
084 St.Pankraz,83,,5,9,14
084 St.Pankraz,84,,4,7,11
084 St.Pankraz,85,,6,3,9
084 St.Pankraz,86,,1,3,4
084 St.Pankraz,87,,4,4,8
084 St.Pankraz,88,,1,5,6
084 St.Pankraz,89,,3,4,7
084 St.Pankraz,90,,2,3,5
084 St.Pankraz,91,,2,3,5
084 St.Pankraz,92,,-,1,1
084 St.Pankraz,93,,-,1,1
084 St.Pankraz,98,,-,1,1
084 St.Pankraz,Insgesamt,,808,756,1.564
085 St.Christina in Gröden,0,,10,11,21
085 St.Christina in Gröden,1,,12,10,22
085 St.Christina in Gröden,2,,9,7,16
085 St.Christina in Gröden,3,,11,6,17
085 St.Christina in Gröden,4,,13,7,20
085 St.Christina in Gröden,5,,9,7,16
085 St.Christina in Gröden,6,,9,9,18
085 St.Christina in Gröden,7,,16,11,27
085 St.Christina in Gröden,8,,14,12,26
085 St.Christina in Gröden,9,,7,7,14
085 St.Christina in Gröden,10,,10,15,25
085 St.Christina in Gröden,11,,9,11,20
085 St.Christina in Gröden,12,,19,12,31
085 St.Christina in Gröden,13,,20,11,31
085 St.Christina in Gröden,14,,10,15,25
085 St.Christina in Gröden,15,,9,12,21
085 St.Christina in Gröden,16,,12,7,19
085 St.Christina in Gröden,17,,15,10,25
085 St.Christina in Gröden,18,,9,15,24
085 St.Christina in Gröden,19,,13,12,25
085 St.Christina in Gröden,20,,15,14,29
085 St.Christina in Gröden,21,,12,18,30
085 St.Christina in Gröden,22,,8,13,21
085 St.Christina in Gröden,23,,6,10,16
085 St.Christina in Gröden,24,,9,7,16
085 St.Christina in Gröden,25,,12,7,19
085 St.Christina in Gröden,26,,13,10,23
085 St.Christina in Gröden,27,,7,8,15
085 St.Christina in Gröden,28,,10,7,17
085 St.Christina in Gröden,29,,21,15,36
085 St.Christina in Gröden,30,,8,6,14
085 St.Christina in Gröden,31,,8,12,20
085 St.Christina in Gröden,32,,13,18,31
085 St.Christina in Gröden,33,,10,11,21
085 St.Christina in Gröden,34,,4,14,18
085 St.Christina in Gröden,35,,8,10,18
085 St.Christina in Gröden,36,,16,14,30
085 St.Christina in Gröden,37,,12,13,25
085 St.Christina in Gröden,38,,11,22,33
085 St.Christina in Gröden,39,,9,12,21
085 St.Christina in Gröden,40,,19,11,30
085 St.Christina in Gröden,41,,13,15,28
085 St.Christina in Gröden,42,,21,21,42
085 St.Christina in Gröden,43,,21,13,34
085 St.Christina in Gröden,44,,25,24,49
085 St.Christina in Gröden,45,,15,14,29
085 St.Christina in Gröden,46,,22,8,30
085 St.Christina in Gröden,47,,13,14,27
085 St.Christina in Gröden,48,,12,27,39
085 St.Christina in Gröden,49,,13,17,30
085 St.Christina in Gröden,50,,18,14,32
085 St.Christina in Gröden,51,,22,16,38
085 St.Christina in Gröden,52,,21,16,37
085 St.Christina in Gröden,53,,12,10,22
085 St.Christina in Gröden,54,,8,11,19
085 St.Christina in Gröden,55,,16,11,27
085 St.Christina in Gröden,56,,11,10,21
085 St.Christina in Gröden,57,,9,9,18
085 St.Christina in Gröden,58,,12,14,26
085 St.Christina in Gröden,59,,8,9,17
085 St.Christina in Gröden,60,,5,7,12
085 St.Christina in Gröden,61,,11,5,16
085 St.Christina in Gröden,62,,7,5,12
085 St.Christina in Gröden,63,,8,9,17
085 St.Christina in Gröden,64,,8,5,13
085 St.Christina in Gröden,65,,6,8,14
085 St.Christina in Gröden,66,,8,9,17
085 St.Christina in Gröden,67,,6,7,13
085 St.Christina in Gröden,68,,5,12,17
085 St.Christina in Gröden,69,,11,14,25
085 St.Christina in Gröden,70,,9,6,15
085 St.Christina in Gröden,71,,12,7,19
085 St.Christina in Gröden,72,,9,11,20
085 St.Christina in Gröden,73,,9,10,19
085 St.Christina in Gröden,74,,7,7,14
085 St.Christina in Gröden,75,,8,4,12
085 St.Christina in Gröden,76,,10,8,18
085 St.Christina in Gröden,77,,12,3,15
085 St.Christina in Gröden,78,,8,11,19
085 St.Christina in Gröden,79,,4,11,15
085 St.Christina in Gröden,80,,6,8,14
085 St.Christina in Gröden,81,,2,6,8
085 St.Christina in Gröden,82,,10,4,14
085 St.Christina in Gröden,83,,2,8,10
085 St.Christina in Gröden,84,,2,2,4
085 St.Christina in Gröden,85,,5,6,11
085 St.Christina in Gröden,86,,6,3,9
085 St.Christina in Gröden,87,,3,6,9
085 St.Christina in Gröden,88,,-,1,1
085 St.Christina in Gröden,89,,1,4,5
085 St.Christina in Gröden,90,,-,4,4
085 St.Christina in Gröden,91,,1,2,3
085 St.Christina in Gröden,92,,1,2,3
085 St.Christina in Gröden,93,,-,1,1
085 St.Christina in Gröden,97,,1,-,1
085 St.Christina in Gröden,99,,2,-,2
085 St.Christina in Gröden,Insgesamt,,964,948,1.912
086 Sarntal,0,,42,43,85
086 Sarntal,1,,44,45,89
086 Sarntal,2,,43,41,84
086 Sarntal,3,,34,37,71
086 Sarntal,4,,42,55,97
086 Sarntal,5,,53,39,92
086 Sarntal,6,,44,50,94
086 Sarntal,7,,41,36,77
086 Sarntal,8,,40,39,79
086 Sarntal,9,,46,35,81
086 Sarntal,10,,29,42,71
086 Sarntal,11,,50,25,75
086 Sarntal,12,,37,42,79
086 Sarntal,13,,34,36,70
086 Sarntal,14,,52,41,93
086 Sarntal,15,,45,48,93
086 Sarntal,16,,44,41,85
086 Sarntal,17,,43,44,87
086 Sarntal,18,,34,40,74
086 Sarntal,19,,33,41,74
086 Sarntal,20,,43,38,81
086 Sarntal,21,,44,47,91
086 Sarntal,22,,45,33,78
086 Sarntal,23,,56,34,90
086 Sarntal,24,,45,45,90
086 Sarntal,25,,37,36,73
086 Sarntal,26,,39,46,85
086 Sarntal,27,,41,43,84
086 Sarntal,28,,39,37,76
086 Sarntal,29,,55,43,98
086 Sarntal,30,,59,44,103
086 Sarntal,31,,44,53,97
086 Sarntal,32,,53,41,94
086 Sarntal,33,,56,45,101
086 Sarntal,34,,56,55,111
086 Sarntal,35,,54,40,94
086 Sarntal,36,,43,35,78
086 Sarntal,37,,59,50,109
086 Sarntal,38,,45,60,105
086 Sarntal,39,,54,65,119
086 Sarntal,40,,70,39,109
086 Sarntal,41,,47,45,92
086 Sarntal,42,,66,60,126
086 Sarntal,43,,63,53,116
086 Sarntal,44,,53,44,97
086 Sarntal,45,,55,48,103
086 Sarntal,46,,50,47,97
086 Sarntal,47,,65,55,120
086 Sarntal,48,,57,67,124
086 Sarntal,49,,42,44,86
086 Sarntal,50,,55,36,91
086 Sarntal,51,,42,47,89
086 Sarntal,52,,65,47,112
086 Sarntal,53,,42,42,84
086 Sarntal,54,,56,44,100
086 Sarntal,55,,34,41,75
086 Sarntal,56,,39,30,69
086 Sarntal,57,,41,40,81
086 Sarntal,58,,36,30,66
086 Sarntal,59,,42,29,71
086 Sarntal,60,,34,42,76
086 Sarntal,61,,42,32,74
086 Sarntal,62,,35,32,67
086 Sarntal,63,,50,27,77
086 Sarntal,64,,33,39,72
086 Sarntal,65,,35,28,63
086 Sarntal,66,,35,38,73
086 Sarntal,67,,29,32,61
086 Sarntal,68,,30,28,58
086 Sarntal,69,,35,37,72
086 Sarntal,70,,36,35,71
086 Sarntal,71,,31,28,59
086 Sarntal,72,,27,41,68
086 Sarntal,73,,35,29,64
086 Sarntal,74,,29,29,58
086 Sarntal,75,,23,33,56
086 Sarntal,76,,13,21,34
086 Sarntal,77,,17,21,38
086 Sarntal,78,,17,17,34
086 Sarntal,79,,15,16,31
086 Sarntal,80,,17,23,40
086 Sarntal,81,,11,21,32
086 Sarntal,82,,11,20,31
086 Sarntal,83,,12,25,37
086 Sarntal,84,,12,22,34
086 Sarntal,85,,12,27,39
086 Sarntal,86,,7,11,18
086 Sarntal,87,,11,15,26
086 Sarntal,88,,-,17,17
086 Sarntal,89,,1,12,13
086 Sarntal,90,,3,13,16
086 Sarntal,91,,1,6,7
086 Sarntal,92,,2,6,8
086 Sarntal,93,,2,6,8
086 Sarntal,94,,1,2,3
086 Sarntal,95,,-,1,1
086 Sarntal,98,,-,1,1
086 Sarntal,99,,2,1,3
086 Sarntal,105,,1,-,1
086 Sarntal,Insgesamt,,3.524,3.432,6.956
087 Schenna,0,,16,14,30
087 Schenna,1,,13,16,29
087 Schenna,2,,10,20,30
087 Schenna,3,,12,15,27
087 Schenna,4,,14,18,32
087 Schenna,5,,14,14,28
087 Schenna,6,,20,25,45
087 Schenna,7,,11,9,20
087 Schenna,8,,16,17,33
087 Schenna,9,,13,15,28
087 Schenna,10,,16,19,35
087 Schenna,11,,17,14,31
087 Schenna,12,,19,21,40
087 Schenna,13,,24,18,42
087 Schenna,14,,16,10,26
087 Schenna,15,,12,18,30
087 Schenna,16,,17,18,35
087 Schenna,17,,22,18,40
087 Schenna,18,,20,15,35
087 Schenna,19,,12,5,17
087 Schenna,20,,16,17,33
087 Schenna,21,,12,17,29
087 Schenna,22,,17,17,34
087 Schenna,23,,21,11,32
087 Schenna,24,,19,19,38
087 Schenna,25,,22,13,35
087 Schenna,26,,17,14,31
087 Schenna,27,,14,16,30
087 Schenna,28,,14,19,33
087 Schenna,29,,16,11,27
087 Schenna,30,,10,17,27
087 Schenna,31,,20,16,36
087 Schenna,32,,20,27,47
087 Schenna,33,,29,21,50
087 Schenna,34,,17,18,35
087 Schenna,35,,21,24,45
087 Schenna,36,,23,10,33
087 Schenna,37,,17,33,50
087 Schenna,38,,24,20,44
087 Schenna,39,,26,23,49
087 Schenna,40,,27,15,42
087 Schenna,41,,27,25,52
087 Schenna,42,,20,21,41
087 Schenna,43,,29,23,52
087 Schenna,44,,24,20,44
087 Schenna,45,,28,20,48
087 Schenna,46,,18,17,35
087 Schenna,47,,30,30,60
087 Schenna,48,,19,26,45
087 Schenna,49,,24,19,43
087 Schenna,50,,20,11,31
087 Schenna,51,,31,25,56
087 Schenna,52,,31,24,55
087 Schenna,53,,16,12,28
087 Schenna,54,,22,20,42
087 Schenna,55,,16,17,33
087 Schenna,56,,18,17,35
087 Schenna,57,,10,18,28
087 Schenna,58,,15,17,32
087 Schenna,59,,14,16,30
087 Schenna,60,,10,16,26
087 Schenna,61,,14,11,25
087 Schenna,62,,18,14,32
087 Schenna,63,,18,21,39
087 Schenna,64,,15,16,31
087 Schenna,65,,18,18,36
087 Schenna,66,,16,22,38
087 Schenna,67,,12,14,26
087 Schenna,68,,15,9,24
087 Schenna,69,,20,14,34
087 Schenna,70,,9,17,26
087 Schenna,71,,12,12,24
087 Schenna,72,,9,10,19
087 Schenna,73,,9,12,21
087 Schenna,74,,15,17,32
087 Schenna,75,,6,11,17
087 Schenna,76,,7,12,19
087 Schenna,77,,10,8,18
087 Schenna,78,,12,13,25
087 Schenna,79,,7,8,15
087 Schenna,80,,5,10,15
087 Schenna,81,,9,8,17
087 Schenna,82,,9,5,14
087 Schenna,83,,3,10,13
087 Schenna,84,,6,7,13
087 Schenna,85,,2,10,12
087 Schenna,86,,4,6,10
087 Schenna,87,,-,8,8
087 Schenna,88,,6,5,11
087 Schenna,89,,2,3,5
087 Schenna,90,,3,3,6
087 Schenna,91,,3,6,9
087 Schenna,92,,-,1,1
087 Schenna,93,,-,2,2
087 Schenna,96,,-,1,1
087 Schenna,99,,-,2,2
087 Schenna,Insgesamt,,1.432,1.437,2.869
088 Mühlwald,0,,9,5,14
088 Mühlwald,1,,5,9,14
088 Mühlwald,2,,5,8,13
088 Mühlwald,3,,5,6,11
088 Mühlwald,4,,9,8,17
088 Mühlwald,5,,7,8,15
088 Mühlwald,6,,5,13,18
088 Mühlwald,7,,8,5,13
088 Mühlwald,8,,10,9,19
088 Mühlwald,9,,15,9,24
088 Mühlwald,10,,10,12,22
088 Mühlwald,11,,10,13,23
088 Mühlwald,12,,8,10,18
088 Mühlwald,13,,15,11,26
088 Mühlwald,14,,13,14,27
088 Mühlwald,15,,12,9,21
088 Mühlwald,16,,15,13,28
088 Mühlwald,17,,12,4,16
088 Mühlwald,18,,7,6,13
088 Mühlwald,19,,15,13,28
088 Mühlwald,20,,5,4,9
088 Mühlwald,21,,11,8,19
088 Mühlwald,22,,10,6,16
088 Mühlwald,23,,16,9,25
088 Mühlwald,24,,7,5,12
088 Mühlwald,25,,9,15,24
088 Mühlwald,26,,6,7,13
088 Mühlwald,27,,10,15,25
088 Mühlwald,28,,10,12,22
088 Mühlwald,29,,10,7,17
088 Mühlwald,30,,3,8,11
088 Mühlwald,31,,11,11,22
088 Mühlwald,32,,18,3,21
088 Mühlwald,33,,7,12,19
088 Mühlwald,34,,12,6,18
088 Mühlwald,35,,8,6,14
088 Mühlwald,36,,13,10,23
088 Mühlwald,37,,12,6,18
088 Mühlwald,38,,8,5,13
088 Mühlwald,39,,13,12,25
088 Mühlwald,40,,7,9,16
088 Mühlwald,41,,19,15,34
088 Mühlwald,42,,7,10,17
088 Mühlwald,43,,14,15,29
088 Mühlwald,44,,16,9,25
088 Mühlwald,45,,17,14,31
088 Mühlwald,46,,11,7,18
088 Mühlwald,47,,17,12,29
088 Mühlwald,48,,18,10,28
088 Mühlwald,49,,9,11,20
088 Mühlwald,50,,8,11,19
088 Mühlwald,51,,6,11,17
088 Mühlwald,52,,14,9,23
088 Mühlwald,53,,13,5,18
088 Mühlwald,54,,9,5,14
088 Mühlwald,55,,13,12,25
088 Mühlwald,56,,8,8,16
088 Mühlwald,57,,7,7,14
088 Mühlwald,58,,9,4,13
088 Mühlwald,59,,10,9,19
088 Mühlwald,60,,9,7,16
088 Mühlwald,61,,10,4,14
088 Mühlwald,62,,4,9,13
088 Mühlwald,63,,9,3,12
088 Mühlwald,64,,12,4,16
088 Mühlwald,65,,9,7,16
088 Mühlwald,66,,5,3,8
088 Mühlwald,67,,4,4,8
088 Mühlwald,68,,7,4,11
088 Mühlwald,69,,8,2,10
088 Mühlwald,70,,6,7,13
088 Mühlwald,71,,4,7,11
088 Mühlwald,72,,4,9,13
088 Mühlwald,73,,5,11,16
088 Mühlwald,74,,8,4,12
088 Mühlwald,75,,8,2,10
088 Mühlwald,76,,4,3,7
088 Mühlwald,77,,3,3,6
088 Mühlwald,78,,4,5,9
088 Mühlwald,79,,2,9,11
088 Mühlwald,80,,1,2,3
088 Mühlwald,81,,3,4,7
088 Mühlwald,82,,3,4,7
088 Mühlwald,83,,4,5,9
088 Mühlwald,84,,3,4,7
088 Mühlwald,85,,4,1,5
088 Mühlwald,86,,1,3,4
088 Mühlwald,87,,1,1,2
088 Mühlwald,88,,1,1,2
088 Mühlwald,89,,-,3,3
088 Mühlwald,90,,-,2,2
088 Mühlwald,91,,-,4,4
088 Mühlwald,93,,-,1,1
088 Mühlwald,95,,1,-,1
088 Mühlwald,97,,-,1,1
088 Mühlwald,99,,-,1,1
088 Mühlwald,Insgesamt,,773,689,1.462
089 Wolkenstein in Gröden,0,,9,10,19
089 Wolkenstein in Gröden,1,,15,17,32
089 Wolkenstein in Gröden,2,,16,12,28
089 Wolkenstein in Gröden,3,,10,9,19
089 Wolkenstein in Gröden,4,,18,13,31
089 Wolkenstein in Gröden,5,,17,13,30
089 Wolkenstein in Gröden,6,,12,16,28
089 Wolkenstein in Gröden,7,,15,19,34
089 Wolkenstein in Gröden,8,,12,8,20
089 Wolkenstein in Gröden,9,,17,19,36
089 Wolkenstein in Gröden,10,,24,19,43
089 Wolkenstein in Gröden,11,,20,18,38
089 Wolkenstein in Gröden,12,,18,23,41
089 Wolkenstein in Gröden,13,,13,17,30
089 Wolkenstein in Gröden,14,,16,23,39
089 Wolkenstein in Gröden,15,,22,29,51
089 Wolkenstein in Gröden,16,,15,12,27
089 Wolkenstein in Gröden,17,,16,12,28
089 Wolkenstein in Gröden,18,,14,17,31
089 Wolkenstein in Gröden,19,,13,16,29
089 Wolkenstein in Gröden,20,,23,14,37
089 Wolkenstein in Gröden,21,,18,18,36
089 Wolkenstein in Gröden,22,,13,9,22
089 Wolkenstein in Gröden,23,,15,13,28
089 Wolkenstein in Gröden,24,,16,17,33
089 Wolkenstein in Gröden,25,,11,21,32
089 Wolkenstein in Gröden,26,,15,13,28
089 Wolkenstein in Gröden,27,,15,14,29
089 Wolkenstein in Gröden,28,,14,9,23
089 Wolkenstein in Gröden,29,,14,8,22
089 Wolkenstein in Gröden,30,,11,17,28
089 Wolkenstein in Gröden,31,,14,9,23
089 Wolkenstein in Gröden,32,,19,16,35
089 Wolkenstein in Gröden,33,,10,18,28
089 Wolkenstein in Gröden,34,,10,12,22
089 Wolkenstein in Gröden,35,,12,13,25
089 Wolkenstein in Gröden,36,,14,7,21
089 Wolkenstein in Gröden,37,,18,26,44
089 Wolkenstein in Gröden,38,,12,17,29
089 Wolkenstein in Gröden,39,,24,23,47
089 Wolkenstein in Gröden,40,,18,23,41
089 Wolkenstein in Gröden,41,,22,23,45
089 Wolkenstein in Gröden,42,,25,22,47
089 Wolkenstein in Gröden,43,,27,24,51
089 Wolkenstein in Gröden,44,,25,25,50
089 Wolkenstein in Gröden,45,,28,26,54
089 Wolkenstein in Gröden,46,,27,24,51
089 Wolkenstein in Gröden,47,,20,34,54
089 Wolkenstein in Gröden,48,,29,21,50
089 Wolkenstein in Gröden,49,,22,22,44
089 Wolkenstein in Gröden,50,,21,19,40
089 Wolkenstein in Gröden,51,,25,23,48
089 Wolkenstein in Gröden,52,,26,21,47
089 Wolkenstein in Gröden,53,,13,16,29
089 Wolkenstein in Gröden,54,,18,15,33
089 Wolkenstein in Gröden,55,,20,16,36
089 Wolkenstein in Gröden,56,,10,14,24
089 Wolkenstein in Gröden,57,,11,10,21
089 Wolkenstein in Gröden,58,,13,10,23
089 Wolkenstein in Gröden,59,,8,14,22
089 Wolkenstein in Gröden,60,,11,6,17
089 Wolkenstein in Gröden,61,,12,12,24
089 Wolkenstein in Gröden,62,,6,17,23
089 Wolkenstein in Gröden,63,,15,11,26
089 Wolkenstein in Gröden,64,,12,13,25
089 Wolkenstein in Gröden,65,,9,14,23
089 Wolkenstein in Gröden,66,,18,19,37
089 Wolkenstein in Gröden,67,,5,14,19
089 Wolkenstein in Gröden,68,,11,8,19
089 Wolkenstein in Gröden,69,,18,13,31
089 Wolkenstein in Gröden,70,,10,12,22
089 Wolkenstein in Gröden,71,,13,12,25
089 Wolkenstein in Gröden,72,,14,16,30
089 Wolkenstein in Gröden,73,,18,12,30
089 Wolkenstein in Gröden,74,,16,8,24
089 Wolkenstein in Gröden,75,,9,18,27
089 Wolkenstein in Gröden,76,,9,15,24
089 Wolkenstein in Gröden,77,,14,6,20
089 Wolkenstein in Gröden,78,,13,10,23
089 Wolkenstein in Gröden,79,,6,10,16
089 Wolkenstein in Gröden,80,,4,9,13
089 Wolkenstein in Gröden,81,,8,8,16
089 Wolkenstein in Gröden,82,,6,9,15
089 Wolkenstein in Gröden,83,,4,5,9
089 Wolkenstein in Gröden,84,,3,8,11
089 Wolkenstein in Gröden,85,,7,5,12
089 Wolkenstein in Gröden,86,,7,4,11
089 Wolkenstein in Gröden,87,,3,6,9
089 Wolkenstein in Gröden,88,,1,7,8
089 Wolkenstein in Gröden,89,,3,4,7
089 Wolkenstein in Gröden,90,,2,8,10
089 Wolkenstein in Gröden,91,,1,3,4
089 Wolkenstein in Gröden,92,,3,2,5
089 Wolkenstein in Gröden,93,,-,1,1
089 Wolkenstein in Gröden,95,,1,-,1
089 Wolkenstein in Gröden,Insgesamt,,1.310,1.343,2.653
091 Schnals,0,,6,4,10
091 Schnals,1,,5,4,9
091 Schnals,2,,2,6,8
091 Schnals,3,,9,9,18
091 Schnals,4,,10,5,15
091 Schnals,5,,4,5,9
091 Schnals,6,,4,4,8
091 Schnals,7,,3,5,8
091 Schnals,8,,7,5,12
091 Schnals,9,,2,7,9
091 Schnals,10,,12,2,14
091 Schnals,11,,3,4,7
091 Schnals,12,,5,5,10
091 Schnals,13,,6,9,15
091 Schnals,14,,7,15,22
091 Schnals,15,,13,10,23
091 Schnals,16,,6,11,17
091 Schnals,17,,5,8,13
091 Schnals,18,,4,7,11
091 Schnals,19,,10,4,14
091 Schnals,20,,12,10,22
091 Schnals,21,,14,9,23
091 Schnals,22,,4,7,11
091 Schnals,23,,20,6,26
091 Schnals,24,,9,5,14
091 Schnals,25,,10,8,18
091 Schnals,26,,6,8,14
091 Schnals,27,,5,7,12
091 Schnals,28,,14,12,26
091 Schnals,29,,6,5,11
091 Schnals,30,,7,6,13
091 Schnals,31,,13,9,22
091 Schnals,32,,11,9,20
091 Schnals,33,,5,9,14
091 Schnals,34,,10,9,19
091 Schnals,35,,7,9,16
091 Schnals,36,,9,2,11
091 Schnals,37,,4,6,10
091 Schnals,38,,14,7,21
091 Schnals,39,,8,8,16
091 Schnals,40,,9,9,18
091 Schnals,41,,10,6,16
091 Schnals,42,,11,7,18
091 Schnals,43,,10,7,17
091 Schnals,44,,11,9,20
091 Schnals,45,,15,10,25
091 Schnals,46,,14,14,28
091 Schnals,47,,15,8,23
091 Schnals,48,,7,10,17
091 Schnals,49,,9,15,24
091 Schnals,50,,12,10,22
091 Schnals,51,,10,14,24
091 Schnals,52,,12,8,20
091 Schnals,53,,15,12,27
091 Schnals,54,,11,11,22
091 Schnals,55,,11,5,16
091 Schnals,56,,12,4,16
091 Schnals,57,,9,6,15
091 Schnals,58,,9,10,19
091 Schnals,59,,12,8,20
091 Schnals,60,,13,7,20
091 Schnals,61,,12,8,20
091 Schnals,62,,9,7,16
091 Schnals,63,,10,9,19
091 Schnals,64,,3,2,5
091 Schnals,65,,8,7,15
091 Schnals,66,,6,5,11
091 Schnals,67,,6,4,10
091 Schnals,68,,3,7,10
091 Schnals,69,,6,8,14
091 Schnals,70,,4,4,8
091 Schnals,71,,3,4,7
091 Schnals,72,,7,7,14
091 Schnals,73,,5,7,12
091 Schnals,74,,1,11,12
091 Schnals,75,,6,4,10
091 Schnals,76,,4,3,7
091 Schnals,77,,2,5,7
091 Schnals,78,,2,3,5
091 Schnals,79,,3,3,6
091 Schnals,80,,2,7,9
091 Schnals,81,,2,4,6
091 Schnals,82,,-,3,3
091 Schnals,83,,4,6,10
091 Schnals,84,,1,4,5
091 Schnals,85,,1,4,5
091 Schnals,86,,7,2,9
091 Schnals,87,,2,6,8
091 Schnals,88,,-,3,3
091 Schnals,89,,-,1,1
091 Schnals,90,,1,2,3
091 Schnals,91,,-,2,2
091 Schnals,94,,2,1,3
091 Schnals,97,,-,1,1
091 Schnals,99,,-,1,1
091 Schnals,101,,-,1,1
091 Schnals,Insgesamt,,670,626,1.296
092 Sexten,0,,9,8,17
092 Sexten,1,,9,3,12
092 Sexten,2,,9,7,16
092 Sexten,3,,12,8,20
092 Sexten,4,,6,8,14
092 Sexten,5,,8,19,27
092 Sexten,6,,4,6,10
092 Sexten,7,,10,10,20
092 Sexten,8,,13,8,21
092 Sexten,9,,10,11,21
092 Sexten,10,,16,17,33
092 Sexten,11,,16,12,28
092 Sexten,12,,7,16,23
092 Sexten,13,,8,14,22
092 Sexten,14,,13,6,19
092 Sexten,15,,12,10,22
092 Sexten,16,,14,11,25
092 Sexten,17,,15,14,29
092 Sexten,18,,16,9,25
092 Sexten,19,,9,5,14
092 Sexten,20,,14,11,25
092 Sexten,21,,9,13,22
092 Sexten,22,,11,16,27
092 Sexten,23,,10,12,22
092 Sexten,24,,8,6,14
092 Sexten,25,,11,9,20
092 Sexten,26,,6,10,16
092 Sexten,27,,11,10,21
092 Sexten,28,,7,8,15
092 Sexten,29,,12,10,22
092 Sexten,30,,9,12,21
092 Sexten,31,,14,11,25
092 Sexten,32,,15,8,23
092 Sexten,33,,11,18,29
092 Sexten,34,,13,12,25
092 Sexten,35,,8,4,12
092 Sexten,36,,17,16,33
092 Sexten,37,,8,9,17
092 Sexten,38,,9,7,16
092 Sexten,39,,7,9,16
092 Sexten,40,,12,20,32
092 Sexten,41,,16,14,30
092 Sexten,42,,12,18,30
092 Sexten,43,,20,17,37
092 Sexten,44,,16,16,32
092 Sexten,45,,22,19,41
092 Sexten,46,,14,17,31
092 Sexten,47,,19,18,37
092 Sexten,48,,18,17,35
092 Sexten,49,,28,20,48
092 Sexten,50,,13,17,30
092 Sexten,51,,18,12,30
092 Sexten,52,,21,8,29
092 Sexten,53,,15,15,30
092 Sexten,54,,22,14,36
092 Sexten,55,,18,13,31
092 Sexten,56,,13,15,28
092 Sexten,57,,10,11,21
092 Sexten,58,,11,12,23
092 Sexten,59,,5,10,15
092 Sexten,60,,6,13,19
092 Sexten,61,,7,9,16
092 Sexten,62,,10,7,17
092 Sexten,63,,6,4,10
092 Sexten,64,,10,7,17
092 Sexten,65,,10,4,14
092 Sexten,66,,5,9,14
092 Sexten,67,,6,4,10
092 Sexten,68,,6,12,18
092 Sexten,69,,8,5,13
092 Sexten,70,,5,5,10
092 Sexten,71,,8,16,24
092 Sexten,72,,7,12,19
092 Sexten,73,,5,10,15
092 Sexten,74,,12,9,21
092 Sexten,75,,9,6,15
092 Sexten,76,,6,9,15
092 Sexten,77,,8,14,22
092 Sexten,78,,8,7,15
092 Sexten,79,,2,10,12
092 Sexten,80,,3,7,10
092 Sexten,81,,7,13,20
092 Sexten,82,,5,11,16
092 Sexten,83,,4,10,14
092 Sexten,84,,5,10,15
092 Sexten,85,,4,13,17
092 Sexten,86,,4,3,7
092 Sexten,87,,2,7,9
092 Sexten,88,,4,5,9
092 Sexten,89,,1,5,6
092 Sexten,90,,2,6,8
092 Sexten,91,,1,3,4
092 Sexten,92,,-,2,2
092 Sexten,93,,-,3,3
092 Sexten,95,,-,1,1
092 Sexten,Insgesamt,,935,987,1.922
093 Schlanders,0,,35,36,71
093 Schlanders,1,,28,23,51
093 Schlanders,2,,26,28,54
093 Schlanders,3,,26,36,62
093 Schlanders,4,,31,25,56
093 Schlanders,5,,32,33,65
093 Schlanders,6,,26,23,49
093 Schlanders,7,,31,34,65
093 Schlanders,8,,27,37,64
093 Schlanders,9,,27,24,51
093 Schlanders,10,,27,34,61
093 Schlanders,11,,32,34,66
093 Schlanders,12,,38,37,75
093 Schlanders,13,,27,41,68
093 Schlanders,14,,43,37,80
093 Schlanders,15,,59,47,106
093 Schlanders,16,,42,35,77
093 Schlanders,17,,38,27,65
093 Schlanders,18,,39,39,78
093 Schlanders,19,,47,42,89
093 Schlanders,20,,34,47,81
093 Schlanders,21,,40,34,74
093 Schlanders,22,,51,40,91
093 Schlanders,23,,37,37,74
093 Schlanders,24,,34,45,79
093 Schlanders,25,,36,35,71
093 Schlanders,26,,40,38,78
093 Schlanders,27,,38,36,74
093 Schlanders,28,,39,43,82
093 Schlanders,29,,33,39,72
093 Schlanders,30,,48,43,91
093 Schlanders,31,,52,43,95
093 Schlanders,32,,41,38,79
093 Schlanders,33,,31,38,69
093 Schlanders,34,,47,32,79
093 Schlanders,35,,35,47,82
093 Schlanders,36,,32,27,59
093 Schlanders,37,,47,38,85
093 Schlanders,38,,51,38,89
093 Schlanders,39,,40,51,91
093 Schlanders,40,,53,34,87
093 Schlanders,41,,45,48,93
093 Schlanders,42,,45,50,95
093 Schlanders,43,,62,43,105
093 Schlanders,44,,53,35,88
093 Schlanders,45,,45,57,102
093 Schlanders,46,,43,56,99
093 Schlanders,47,,57,50,107
093 Schlanders,48,,39,42,81
093 Schlanders,49,,52,60,112
093 Schlanders,50,,48,48,96
093 Schlanders,51,,36,55,91
093 Schlanders,52,,43,43,86
093 Schlanders,53,,35,40,75
093 Schlanders,54,,48,54,102
093 Schlanders,55,,40,35,75
093 Schlanders,56,,28,35,63
093 Schlanders,57,,25,35,60
093 Schlanders,58,,30,34,64
093 Schlanders,59,,33,38,71
093 Schlanders,60,,32,22,54
093 Schlanders,61,,28,30,58
093 Schlanders,62,,22,34,56
093 Schlanders,63,,27,37,64
093 Schlanders,64,,38,25,63
093 Schlanders,65,,22,22,44
093 Schlanders,66,,25,21,46
093 Schlanders,67,,30,16,46
093 Schlanders,68,,26,32,58
093 Schlanders,69,,28,36,64
093 Schlanders,70,,32,35,67
093 Schlanders,71,,32,35,67
093 Schlanders,72,,24,26,50
093 Schlanders,73,,28,33,61
093 Schlanders,74,,12,18,30
093 Schlanders,75,,24,23,47
093 Schlanders,76,,13,24,37
093 Schlanders,77,,14,24,38
093 Schlanders,78,,14,20,34
093 Schlanders,79,,19,29,48
093 Schlanders,80,,14,13,27
093 Schlanders,81,,18,15,33
093 Schlanders,82,,13,21,34
093 Schlanders,83,,10,14,24
093 Schlanders,84,,10,15,25
093 Schlanders,85,,7,16,23
093 Schlanders,86,,4,14,18
093 Schlanders,87,,7,14,21
093 Schlanders,88,,4,10,14
093 Schlanders,89,,6,9,15
093 Schlanders,90,,2,7,9
093 Schlanders,91,,2,7,9
093 Schlanders,92,,-,10,10
093 Schlanders,93,,1,5,6
093 Schlanders,94,,2,2,4
093 Schlanders,95,,-,1,1
093 Schlanders,96,,-,1,1
093 Schlanders,100,,-,1,1
093 Schlanders,102,,-,1,1
093 Schlanders,103,,-,1,1
093 Schlanders,Insgesamt,,2.937,3.072,6.009
094 Schluderns,0,,8,10,18
094 Schluderns,1,,12,9,21
094 Schluderns,2,,8,4,12
094 Schluderns,3,,11,7,18
094 Schluderns,4,,7,1,8
094 Schluderns,5,,10,14,24
094 Schluderns,6,,9,8,17
094 Schluderns,7,,6,6,12
094 Schluderns,8,,6,10,16
094 Schluderns,9,,16,9,25
094 Schluderns,10,,14,8,22
094 Schluderns,11,,11,7,18
094 Schluderns,12,,19,8,27
094 Schluderns,13,,7,14,21
094 Schluderns,14,,6,10,16
094 Schluderns,15,,11,11,22
094 Schluderns,16,,11,14,25
094 Schluderns,17,,9,11,20
094 Schluderns,18,,13,18,31
094 Schluderns,19,,15,6,21
094 Schluderns,20,,8,9,17
094 Schluderns,21,,8,9,17
094 Schluderns,22,,22,5,27
094 Schluderns,23,,15,14,29
094 Schluderns,24,,9,11,20
094 Schluderns,25,,6,11,17
094 Schluderns,26,,12,18,30
094 Schluderns,27,,14,14,28
094 Schluderns,28,,11,12,23
094 Schluderns,29,,10,7,17
094 Schluderns,30,,12,14,26
094 Schluderns,31,,18,15,33
094 Schluderns,32,,10,11,21
094 Schluderns,33,,2,16,18
094 Schluderns,34,,10,10,20
094 Schluderns,35,,9,10,19
094 Schluderns,36,,11,16,27
094 Schluderns,37,,16,8,24
094 Schluderns,38,,19,13,32
094 Schluderns,39,,17,11,28
094 Schluderns,40,,15,11,26
094 Schluderns,41,,11,12,23
094 Schluderns,42,,9,10,19
094 Schluderns,43,,16,11,27
094 Schluderns,44,,18,17,35
094 Schluderns,45,,13,15,28
094 Schluderns,46,,17,16,33
094 Schluderns,47,,25,9,34
094 Schluderns,48,,26,13,39
094 Schluderns,49,,13,18,31
094 Schluderns,50,,11,19,30
094 Schluderns,51,,14,18,32
094 Schluderns,52,,10,6,16
094 Schluderns,53,,13,17,30
094 Schluderns,54,,10,14,24
094 Schluderns,55,,16,6,22
094 Schluderns,56,,10,16,26
094 Schluderns,57,,16,12,28
094 Schluderns,58,,13,7,20
094 Schluderns,59,,14,7,21
094 Schluderns,60,,6,5,11
094 Schluderns,61,,11,3,14
094 Schluderns,62,,8,13,21
094 Schluderns,63,,11,10,21
094 Schluderns,64,,8,8,16
094 Schluderns,65,,7,7,14
094 Schluderns,66,,6,9,15
094 Schluderns,67,,6,4,10
094 Schluderns,68,,5,12,17
094 Schluderns,69,,3,8,11
094 Schluderns,70,,8,7,15
094 Schluderns,71,,11,15,26
094 Schluderns,72,,6,5,11
094 Schluderns,73,,11,8,19
094 Schluderns,74,,8,8,16
094 Schluderns,75,,5,10,15
094 Schluderns,76,,3,6,9
094 Schluderns,77,,5,10,15
094 Schluderns,78,,7,10,17
094 Schluderns,79,,5,9,14
094 Schluderns,80,,7,9,16
094 Schluderns,81,,3,6,9
094 Schluderns,82,,4,8,12
094 Schluderns,83,,3,6,9
094 Schluderns,84,,3,5,8
094 Schluderns,85,,3,2,5
094 Schluderns,86,,2,9,11
094 Schluderns,87,,1,4,5
094 Schluderns,88,,-,1,1
094 Schluderns,89,,1,3,4
094 Schluderns,90,,2,1,3
094 Schluderns,91,,-,3,3
094 Schluderns,92,,-,1,1
094 Schluderns,93,,-,1,1
094 Schluderns,94,,1,1,2
094 Schluderns,95,,-,1,1
094 Schluderns,97,,-,1,1
094 Schluderns,Insgesamt,,908,902,1.810
095 Stilfs,0,,9,3,12
095 Stilfs,1,,5,4,9
095 Stilfs,2,,2,4,6
095 Stilfs,3,,4,2,6
095 Stilfs,4,,5,6,11
095 Stilfs,5,,4,6,10
095 Stilfs,6,,5,1,6
095 Stilfs,7,,6,5,11
095 Stilfs,8,,5,4,9
095 Stilfs,9,,5,6,11
095 Stilfs,10,,5,3,8
095 Stilfs,11,,5,11,16
095 Stilfs,12,,9,4,13
095 Stilfs,13,,2,6,8
095 Stilfs,14,,8,3,11
095 Stilfs,15,,10,10,20
095 Stilfs,16,,11,1,12
095 Stilfs,17,,5,6,11
095 Stilfs,18,,8,7,15
095 Stilfs,19,,5,14,19
095 Stilfs,20,,4,8,12
095 Stilfs,21,,12,5,17
095 Stilfs,22,,18,8,26
095 Stilfs,23,,7,8,15
095 Stilfs,24,,6,3,9
095 Stilfs,25,,5,7,12
095 Stilfs,26,,10,7,17
095 Stilfs,27,,10,4,14
095 Stilfs,28,,12,8,20
095 Stilfs,29,,8,2,10
095 Stilfs,30,,12,6,18
095 Stilfs,31,,8,7,15
095 Stilfs,32,,4,5,9
095 Stilfs,33,,6,5,11
095 Stilfs,34,,8,10,18
095 Stilfs,35,,7,4,11
095 Stilfs,36,,11,4,15
095 Stilfs,37,,7,8,15
095 Stilfs,38,,5,5,10
095 Stilfs,39,,10,14,24
095 Stilfs,40,,9,10,19
095 Stilfs,41,,11,10,21
095 Stilfs,42,,10,12,22
095 Stilfs,43,,10,11,21
095 Stilfs,44,,8,10,18
095 Stilfs,45,,6,9,15
095 Stilfs,46,,18,8,26
095 Stilfs,47,,12,11,23
095 Stilfs,48,,12,5,17
095 Stilfs,49,,9,6,15
095 Stilfs,50,,6,11,17
095 Stilfs,51,,8,3,11
095 Stilfs,52,,8,8,16
095 Stilfs,53,,9,9,18
095 Stilfs,54,,7,13,20
095 Stilfs,55,,11,6,17
095 Stilfs,56,,5,9,14
095 Stilfs,57,,4,5,9
095 Stilfs,58,,16,9,25
095 Stilfs,59,,8,4,12
095 Stilfs,60,,9,5,14
095 Stilfs,61,,14,10,24
095 Stilfs,62,,1,6,7
095 Stilfs,63,,5,3,8
095 Stilfs,64,,7,9,16
095 Stilfs,65,,7,5,12
095 Stilfs,66,,9,9,18
095 Stilfs,67,,2,4,6
095 Stilfs,68,,12,8,20
095 Stilfs,69,,8,7,15
095 Stilfs,70,,4,12,16
095 Stilfs,71,,7,4,11
095 Stilfs,72,,5,8,13
095 Stilfs,73,,3,7,10
095 Stilfs,74,,3,4,7
095 Stilfs,75,,7,5,12
095 Stilfs,76,,2,9,11
095 Stilfs,77,,1,5,6
095 Stilfs,78,,3,4,7
095 Stilfs,79,,3,5,8
095 Stilfs,80,,3,4,7
095 Stilfs,81,,2,3,5
095 Stilfs,82,,4,5,9
095 Stilfs,83,,2,-,2
095 Stilfs,84,,2,6,8
095 Stilfs,85,,3,2,5
095 Stilfs,86,,1,5,6
095 Stilfs,87,,2,2,4
095 Stilfs,88,,-,5,5
095 Stilfs,89,,-,1,1
095 Stilfs,90,,1,4,5
095 Stilfs,91,,1,3,4
095 Stilfs,92,,-,2,2
095 Stilfs,95,,-,1,1
095 Stilfs,96,,-,1,1
095 Stilfs,98,,1,-,1
095 Stilfs,Insgesamt,,609,576,1.185
096 Terenten,0,,7,10,17
096 Terenten,1,,8,8,16
096 Terenten,2,,3,9,12
096 Terenten,3,,13,7,20
096 Terenten,4,,12,4,16
096 Terenten,5,,9,11,20
096 Terenten,6,,15,9,24
096 Terenten,7,,16,10,26
096 Terenten,8,,11,18,29
096 Terenten,9,,8,12,20
096 Terenten,10,,8,7,15
096 Terenten,11,,12,15,27
096 Terenten,12,,10,8,18
096 Terenten,13,,9,19,28
096 Terenten,14,,21,19,40
096 Terenten,15,,9,8,17
096 Terenten,16,,13,11,24
096 Terenten,17,,12,8,20
096 Terenten,18,,12,13,25
096 Terenten,19,,6,13,19
096 Terenten,20,,9,8,17
096 Terenten,21,,6,16,22
096 Terenten,22,,12,16,28
096 Terenten,23,,14,8,22
096 Terenten,24,,10,9,19
096 Terenten,25,,15,7,22
096 Terenten,26,,10,9,19
096 Terenten,27,,9,12,21
096 Terenten,28,,13,10,23
096 Terenten,29,,14,15,29
096 Terenten,30,,11,13,24
096 Terenten,31,,13,15,28
096 Terenten,32,,8,13,21
096 Terenten,33,,9,10,19
096 Terenten,34,,18,18,36
096 Terenten,35,,11,4,15
096 Terenten,36,,15,11,26
096 Terenten,37,,18,9,27
096 Terenten,38,,16,16,32
096 Terenten,39,,8,16,24
096 Terenten,40,,17,9,26
096 Terenten,41,,17,16,33
096 Terenten,42,,20,12,32
096 Terenten,43,,17,14,31
096 Terenten,44,,14,14,28
096 Terenten,45,,17,19,36
096 Terenten,46,,15,17,32
096 Terenten,47,,16,9,25
096 Terenten,48,,17,13,30
096 Terenten,49,,22,12,34
096 Terenten,50,,20,11,31
096 Terenten,51,,11,16,27
096 Terenten,52,,12,9,21
096 Terenten,53,,14,10,24
096 Terenten,54,,13,9,22
096 Terenten,55,,11,8,19
096 Terenten,56,,9,12,21
096 Terenten,57,,12,10,22
096 Terenten,58,,13,10,23
096 Terenten,59,,9,8,17
096 Terenten,60,,7,7,14
096 Terenten,61,,7,6,13
096 Terenten,62,,7,6,13
096 Terenten,63,,8,6,14
096 Terenten,64,,10,8,18
096 Terenten,65,,7,3,10
096 Terenten,66,,9,3,12
096 Terenten,67,,6,4,10
096 Terenten,68,,3,6,9
096 Terenten,69,,8,5,13
096 Terenten,70,,5,5,10
096 Terenten,71,,5,4,9
096 Terenten,72,,8,5,13
096 Terenten,73,,2,6,8
096 Terenten,74,,5,9,14
096 Terenten,75,,4,4,8
096 Terenten,76,,3,9,12
096 Terenten,77,,5,5,10
096 Terenten,78,,1,3,4
096 Terenten,79,,4,3,7
096 Terenten,80,,2,3,5
096 Terenten,81,,4,10,14
096 Terenten,82,,3,4,7
096 Terenten,83,,4,2,6
096 Terenten,84,,4,5,9
096 Terenten,85,,1,2,3
096 Terenten,86,,1,3,4
096 Terenten,87,,3,1,4
096 Terenten,88,,1,3,4
096 Terenten,89,,2,2,4
096 Terenten,91,,-,2,2
096 Terenten,92,,1,2,3
096 Terenten,93,,1,-,1
096 Terenten,Insgesamt,,890,838,1.728
097 Terlan,0,,35,13,48
097 Terlan,1,,34,26,60
097 Terlan,2,,15,14,29
097 Terlan,3,,36,29,65
097 Terlan,4,,31,23,54
097 Terlan,5,,22,19,41
097 Terlan,6,,21,34,55
097 Terlan,7,,18,25,43
097 Terlan,8,,28,20,48
097 Terlan,9,,23,24,47
097 Terlan,10,,21,15,36
097 Terlan,11,,21,28,49
097 Terlan,12,,36,24,60
097 Terlan,13,,31,19,50
097 Terlan,14,,20,22,42
097 Terlan,15,,38,29,67
097 Terlan,16,,14,28,42
097 Terlan,17,,26,28,54
097 Terlan,18,,22,20,42
097 Terlan,19,,29,24,53
097 Terlan,20,,25,31,56
097 Terlan,21,,26,19,45
097 Terlan,22,,16,21,37
097 Terlan,23,,23,32,55
097 Terlan,24,,27,18,45
097 Terlan,25,,28,18,46
097 Terlan,26,,21,25,46
097 Terlan,27,,26,21,47
097 Terlan,28,,17,18,35
097 Terlan,29,,23,18,41
097 Terlan,30,,22,22,44
097 Terlan,31,,19,22,41
097 Terlan,32,,31,33,64
097 Terlan,33,,22,25,47
097 Terlan,34,,22,33,55
097 Terlan,35,,45,25,70
097 Terlan,36,,35,37,72
097 Terlan,37,,33,40,73
097 Terlan,38,,28,49,77
097 Terlan,39,,33,38,71
097 Terlan,40,,44,30,74
097 Terlan,41,,32,28,60
097 Terlan,42,,44,46,90
097 Terlan,43,,37,37,74
097 Terlan,44,,37,31,68
097 Terlan,45,,33,40,73
097 Terlan,46,,47,35,82
097 Terlan,47,,34,30,64
097 Terlan,48,,37,31,68
097 Terlan,49,,35,31,66
097 Terlan,50,,29,36,65
097 Terlan,51,,44,30,74
097 Terlan,52,,28,33,61
097 Terlan,53,,19,25,44
097 Terlan,54,,33,22,55
097 Terlan,55,,22,30,52
097 Terlan,56,,28,31,59
097 Terlan,57,,23,21,44
097 Terlan,58,,27,20,47
097 Terlan,59,,12,24,36
097 Terlan,60,,15,25,40
097 Terlan,61,,23,18,41
097 Terlan,62,,20,22,42
097 Terlan,63,,18,15,33
097 Terlan,64,,17,23,40
097 Terlan,65,,16,19,35
097 Terlan,66,,12,24,36
097 Terlan,67,,21,21,42
097 Terlan,68,,24,22,46
097 Terlan,69,,14,27,41
097 Terlan,70,,31,21,52
097 Terlan,71,,22,25,47
097 Terlan,72,,18,16,34
097 Terlan,73,,15,18,33
097 Terlan,74,,19,16,35
097 Terlan,75,,12,17,29
097 Terlan,76,,5,11,16
097 Terlan,77,,14,22,36
097 Terlan,78,,9,22,31
097 Terlan,79,,10,14,24
097 Terlan,80,,12,11,23
097 Terlan,81,,17,9,26
097 Terlan,82,,10,13,23
097 Terlan,83,,8,10,18
097 Terlan,84,,9,8,17
097 Terlan,85,,6,9,15
097 Terlan,86,,3,10,13
097 Terlan,87,,5,7,12
097 Terlan,88,,2,9,11
097 Terlan,89,,3,19,22
097 Terlan,90,,2,10,12
097 Terlan,91,,2,6,8
097 Terlan,92,,-,5,5
097 Terlan,93,,-,3,3
097 Terlan,94,,1,2,3
097 Terlan,95,,-,3,3
097 Terlan,96,,-,2,2
097 Terlan,97,,-,1,1
097 Terlan,98,,-,2,2
097 Terlan,99,,-,1,1
097 Terlan,Insgesamt,,2.103,2.158,4.261
098 Tramin a.d. Weinstr.,0,,18,21,39
098 Tramin a.d. Weinstr.,1,,12,12,24
098 Tramin a.d. Weinstr.,2,,18,12,30
098 Tramin a.d. Weinstr.,3,,20,13,33
098 Tramin a.d. Weinstr.,4,,17,12,29
098 Tramin a.d. Weinstr.,5,,16,13,29
098 Tramin a.d. Weinstr.,6,,15,11,26
098 Tramin a.d. Weinstr.,7,,18,12,30
098 Tramin a.d. Weinstr.,8,,11,18,29
098 Tramin a.d. Weinstr.,9,,27,15,42
098 Tramin a.d. Weinstr.,10,,13,17,30
098 Tramin a.d. Weinstr.,11,,22,18,40
098 Tramin a.d. Weinstr.,12,,23,13,36
098 Tramin a.d. Weinstr.,13,,18,18,36
098 Tramin a.d. Weinstr.,14,,14,20,34
098 Tramin a.d. Weinstr.,15,,27,14,41
098 Tramin a.d. Weinstr.,16,,21,27,48
098 Tramin a.d. Weinstr.,17,,19,20,39
098 Tramin a.d. Weinstr.,18,,21,20,41
098 Tramin a.d. Weinstr.,19,,17,20,37
098 Tramin a.d. Weinstr.,20,,21,27,48
098 Tramin a.d. Weinstr.,21,,20,9,29
098 Tramin a.d. Weinstr.,22,,25,20,45
098 Tramin a.d. Weinstr.,23,,15,29,44
098 Tramin a.d. Weinstr.,24,,13,28,41
098 Tramin a.d. Weinstr.,25,,22,25,47
098 Tramin a.d. Weinstr.,26,,13,15,28
098 Tramin a.d. Weinstr.,27,,25,24,49
098 Tramin a.d. Weinstr.,28,,22,14,36
098 Tramin a.d. Weinstr.,29,,15,20,35
098 Tramin a.d. Weinstr.,30,,23,24,47
098 Tramin a.d. Weinstr.,31,,29,12,41
098 Tramin a.d. Weinstr.,32,,23,18,41
098 Tramin a.d. Weinstr.,33,,13,13,26
098 Tramin a.d. Weinstr.,34,,12,23,35
098 Tramin a.d. Weinstr.,35,,19,18,37
098 Tramin a.d. Weinstr.,36,,26,14,40
098 Tramin a.d. Weinstr.,37,,21,22,43
098 Tramin a.d. Weinstr.,38,,24,19,43
098 Tramin a.d. Weinstr.,39,,19,14,33
098 Tramin a.d. Weinstr.,40,,17,29,46
098 Tramin a.d. Weinstr.,41,,22,36,58
098 Tramin a.d. Weinstr.,42,,28,20,48
098 Tramin a.d. Weinstr.,43,,29,30,59
098 Tramin a.d. Weinstr.,44,,25,20,45
098 Tramin a.d. Weinstr.,45,,31,31,62
098 Tramin a.d. Weinstr.,46,,29,25,54
098 Tramin a.d. Weinstr.,47,,35,31,66
098 Tramin a.d. Weinstr.,48,,27,30,57
098 Tramin a.d. Weinstr.,49,,23,21,44
098 Tramin a.d. Weinstr.,50,,23,14,37
098 Tramin a.d. Weinstr.,51,,29,23,52
098 Tramin a.d. Weinstr.,52,,26,34,60
098 Tramin a.d. Weinstr.,53,,16,33,49
098 Tramin a.d. Weinstr.,54,,26,23,49
098 Tramin a.d. Weinstr.,55,,20,23,43
098 Tramin a.d. Weinstr.,56,,24,20,44
098 Tramin a.d. Weinstr.,57,,16,19,35
098 Tramin a.d. Weinstr.,58,,21,19,40
098 Tramin a.d. Weinstr.,59,,17,13,30
098 Tramin a.d. Weinstr.,60,,19,18,37
098 Tramin a.d. Weinstr.,61,,12,13,25
098 Tramin a.d. Weinstr.,62,,15,19,34
098 Tramin a.d. Weinstr.,63,,15,17,32
098 Tramin a.d. Weinstr.,64,,17,19,36
098 Tramin a.d. Weinstr.,65,,14,21,35
098 Tramin a.d. Weinstr.,66,,18,17,35
098 Tramin a.d. Weinstr.,67,,6,9,15
098 Tramin a.d. Weinstr.,68,,22,26,48
098 Tramin a.d. Weinstr.,69,,18,20,38
098 Tramin a.d. Weinstr.,70,,19,16,35
098 Tramin a.d. Weinstr.,71,,12,23,35
098 Tramin a.d. Weinstr.,72,,19,17,36
098 Tramin a.d. Weinstr.,73,,12,11,23
098 Tramin a.d. Weinstr.,74,,6,18,24
098 Tramin a.d. Weinstr.,75,,12,12,24
098 Tramin a.d. Weinstr.,76,,14,12,26
098 Tramin a.d. Weinstr.,77,,13,13,26
098 Tramin a.d. Weinstr.,78,,8,13,21
098 Tramin a.d. Weinstr.,79,,6,13,19
098 Tramin a.d. Weinstr.,80,,10,14,24
098 Tramin a.d. Weinstr.,81,,5,15,20
098 Tramin a.d. Weinstr.,82,,14,11,25
098 Tramin a.d. Weinstr.,83,,8,13,21
098 Tramin a.d. Weinstr.,84,,9,8,17
098 Tramin a.d. Weinstr.,85,,10,9,19
098 Tramin a.d. Weinstr.,86,,7,13,20
098 Tramin a.d. Weinstr.,87,,6,13,19
098 Tramin a.d. Weinstr.,88,,4,11,15
098 Tramin a.d. Weinstr.,89,,3,7,10
098 Tramin a.d. Weinstr.,90,,-,4,4
098 Tramin a.d. Weinstr.,91,,2,5,7
098 Tramin a.d. Weinstr.,92,,1,5,6
098 Tramin a.d. Weinstr.,93,,1,4,5
098 Tramin a.d. Weinstr.,96,,1,-,1
098 Tramin a.d. Weinstr.,97,,-,2,2
098 Tramin a.d. Weinstr.,100,,-,1,1
098 Tramin a.d. Weinstr.,Insgesamt,,1.609,1.670,3.279
099 Tisens,0,,6,11,17
099 Tisens,1,,5,8,13
099 Tisens,2,,7,8,15
099 Tisens,3,,7,2,9
099 Tisens,4,,13,7,20
099 Tisens,5,,12,10,22
099 Tisens,6,,10,7,17
099 Tisens,7,,12,17,29
099 Tisens,8,,12,13,25
099 Tisens,9,,10,12,22
099 Tisens,10,,12,9,21
099 Tisens,11,,11,17,28
099 Tisens,12,,10,12,22
099 Tisens,13,,10,8,18
099 Tisens,14,,12,14,26
099 Tisens,15,,4,7,11
099 Tisens,16,,10,7,17
099 Tisens,17,,10,6,16
099 Tisens,18,,11,11,22
099 Tisens,19,,5,7,12
099 Tisens,20,,6,16,22
099 Tisens,21,,16,9,25
099 Tisens,22,,10,13,23
099 Tisens,23,,11,7,18
099 Tisens,24,,8,12,20
099 Tisens,25,,17,7,24
099 Tisens,26,,14,8,22
099 Tisens,27,,11,11,22
099 Tisens,28,,10,11,21
099 Tisens,29,,17,9,26
099 Tisens,30,,16,12,28
099 Tisens,31,,7,21,28
099 Tisens,32,,15,14,29
099 Tisens,33,,12,10,22
099 Tisens,34,,10,18,28
099 Tisens,35,,12,8,20
099 Tisens,36,,10,7,17
099 Tisens,37,,15,11,26
099 Tisens,38,,15,10,25
099 Tisens,39,,8,11,19
099 Tisens,40,,10,14,24
099 Tisens,41,,15,12,27
099 Tisens,42,,15,19,34
099 Tisens,43,,17,17,34
099 Tisens,44,,19,21,40
099 Tisens,45,,24,20,44
099 Tisens,46,,24,10,34
099 Tisens,47,,18,29,47
099 Tisens,48,,16,9,25
099 Tisens,49,,19,14,33
099 Tisens,50,,20,6,26
099 Tisens,51,,15,13,28
099 Tisens,52,,16,6,22
099 Tisens,53,,11,14,25
099 Tisens,54,,10,14,24
099 Tisens,55,,15,18,33
099 Tisens,56,,10,12,22
099 Tisens,57,,18,13,31
099 Tisens,58,,7,7,14
099 Tisens,59,,10,11,21
099 Tisens,60,,7,12,19
099 Tisens,61,,12,10,22
099 Tisens,62,,10,6,16
099 Tisens,63,,5,6,11
099 Tisens,64,,13,7,20
099 Tisens,65,,9,9,18
099 Tisens,66,,7,6,13
099 Tisens,67,,3,6,9
099 Tisens,68,,9,11,20
099 Tisens,69,,10,9,19
099 Tisens,70,,7,11,18
099 Tisens,71,,7,14,21
099 Tisens,72,,4,8,12
099 Tisens,73,,9,9,18
099 Tisens,74,,6,12,18
099 Tisens,75,,5,4,9
099 Tisens,76,,7,7,14
099 Tisens,77,,3,12,15
099 Tisens,78,,7,6,13
099 Tisens,79,,2,10,12
099 Tisens,80,,5,9,14
099 Tisens,81,,5,8,13
099 Tisens,82,,2,15,17
099 Tisens,83,,5,6,11
099 Tisens,84,,4,9,13
099 Tisens,85,,5,6,11
099 Tisens,86,,3,8,11
099 Tisens,87,,3,7,10
099 Tisens,88,,1,2,3
099 Tisens,89,,-,5,5
099 Tisens,90,,2,3,5
099 Tisens,91,,2,2,4
099 Tisens,92,,1,-,1
099 Tisens,93,,2,3,5
099 Tisens,94,,-,1,1
099 Tisens,96,,-,1,1
099 Tisens,97,,-,1,1
099 Tisens,98,,-,1,1
099 Tisens,100,,-,1,1
099 Tisens,101,,-,1,1
099 Tisens,Insgesamt,,920,961,1.881
100 Tiers,0,,3,8,11
100 Tiers,1,,1,6,7
100 Tiers,2,,9,5,14
100 Tiers,3,,3,3,6
100 Tiers,4,,9,7,16
100 Tiers,5,,9,3,12
100 Tiers,6,,2,6,8
100 Tiers,7,,2,9,11
100 Tiers,8,,5,2,7
100 Tiers,9,,4,9,13
100 Tiers,10,,6,5,11
100 Tiers,11,,3,9,12
100 Tiers,12,,2,8,10
100 Tiers,13,,4,9,13
100 Tiers,14,,4,9,13
100 Tiers,15,,9,6,15
100 Tiers,16,,6,3,9
100 Tiers,17,,7,10,17
100 Tiers,18,,4,7,11
100 Tiers,19,,5,2,7
100 Tiers,20,,6,3,9
100 Tiers,21,,6,3,9
100 Tiers,22,,7,7,14
100 Tiers,23,,5,7,12
100 Tiers,24,,7,9,16
100 Tiers,25,,5,6,11
100 Tiers,26,,8,6,14
100 Tiers,27,,5,4,9
100 Tiers,28,,4,8,12
100 Tiers,29,,7,5,12
100 Tiers,30,,6,3,9
100 Tiers,31,,4,5,9
100 Tiers,32,,4,5,9
100 Tiers,33,,2,3,5
100 Tiers,34,,10,8,18
100 Tiers,35,,5,1,6
100 Tiers,36,,2,4,6
100 Tiers,37,,9,9,18
100 Tiers,38,,5,8,13
100 Tiers,39,,9,7,16
100 Tiers,40,,10,7,17
100 Tiers,41,,5,7,12
100 Tiers,42,,7,7,14
100 Tiers,43,,15,11,26
100 Tiers,44,,7,3,10
100 Tiers,45,,10,12,22
100 Tiers,46,,9,6,15
100 Tiers,47,,5,7,12
100 Tiers,48,,9,5,14
100 Tiers,49,,6,11,17
100 Tiers,50,,6,8,14
100 Tiers,51,,6,6,12
100 Tiers,52,,4,9,13
100 Tiers,53,,12,6,18
100 Tiers,54,,7,4,11
100 Tiers,55,,5,9,14
100 Tiers,56,,9,8,17
100 Tiers,57,,5,4,9
100 Tiers,58,,6,4,10
100 Tiers,59,,6,6,12
100 Tiers,60,,3,2,5
100 Tiers,61,,1,4,5
100 Tiers,62,,7,5,12
100 Tiers,63,,3,4,7
100 Tiers,64,,3,5,8
100 Tiers,65,,-,3,3
100 Tiers,66,,5,4,9
100 Tiers,67,,8,3,11
100 Tiers,68,,2,4,6
100 Tiers,69,,9,10,19
100 Tiers,70,,2,5,7
100 Tiers,71,,4,6,10
100 Tiers,72,,2,2,4
100 Tiers,73,,5,6,11
100 Tiers,74,,6,5,11
100 Tiers,75,,4,4,8
100 Tiers,76,,4,5,9
100 Tiers,77,,6,2,8
100 Tiers,78,,2,5,7
100 Tiers,79,,5,3,8
100 Tiers,80,,2,5,7
100 Tiers,81,,3,3,6
100 Tiers,82,,2,-,2
100 Tiers,83,,2,2,4
100 Tiers,84,,2,2,4
100 Tiers,85,,3,3,6
100 Tiers,86,,3,1,4
100 Tiers,87,,5,1,6
100 Tiers,88,,1,4,5
100 Tiers,89,,-,2,2
100 Tiers,90,,1,-,1
100 Tiers,91,,-,3,3
100 Tiers,92,,1,1,2
100 Tiers,94,,1,1,2
100 Tiers,95,,-,1,1
100 Tiers,97,,1,-,1
100 Tiers,100,,-,1,1
100 Tiers,Insgesamt,,470,494,964
101 Tirol,0,,12,8,20
101 Tirol,1,,9,15,24
101 Tirol,2,,14,13,27
101 Tirol,3,,11,8,19
101 Tirol,4,,10,13,23
101 Tirol,5,,13,9,22
101 Tirol,6,,10,11,21
101 Tirol,7,,14,6,20
101 Tirol,8,,12,16,28
101 Tirol,9,,10,12,22
101 Tirol,10,,16,10,26
101 Tirol,11,,18,9,27
101 Tirol,12,,20,13,33
101 Tirol,13,,13,16,29
101 Tirol,14,,17,12,29
101 Tirol,15,,20,23,43
101 Tirol,16,,19,16,35
101 Tirol,17,,9,17,26
101 Tirol,18,,15,15,30
101 Tirol,19,,21,12,33
101 Tirol,20,,14,14,28
101 Tirol,21,,6,9,15
101 Tirol,22,,17,10,27
101 Tirol,23,,14,17,31
101 Tirol,24,,12,17,29
101 Tirol,25,,15,15,30
101 Tirol,26,,11,13,24
101 Tirol,27,,9,16,25
101 Tirol,28,,16,13,29
101 Tirol,29,,17,14,31
101 Tirol,30,,17,11,28
101 Tirol,31,,17,17,34
101 Tirol,32,,21,7,28
101 Tirol,33,,13,11,24
101 Tirol,34,,6,10,16
101 Tirol,35,,12,22,34
101 Tirol,36,,14,16,30
101 Tirol,37,,20,13,33
101 Tirol,38,,15,22,37
101 Tirol,39,,24,16,40
101 Tirol,40,,25,17,42
101 Tirol,41,,23,20,43
101 Tirol,42,,22,16,38
101 Tirol,43,,23,18,41
101 Tirol,44,,25,26,51
101 Tirol,45,,25,18,43
101 Tirol,46,,23,20,43
101 Tirol,47,,22,19,41
101 Tirol,48,,25,21,46
101 Tirol,49,,18,15,33
101 Tirol,50,,19,19,38
101 Tirol,51,,18,23,41
101 Tirol,52,,24,13,37
101 Tirol,53,,15,16,31
101 Tirol,54,,10,16,26
101 Tirol,55,,16,20,36
101 Tirol,56,,7,14,21
101 Tirol,57,,14,18,32
101 Tirol,58,,13,17,30
101 Tirol,59,,19,17,36
101 Tirol,60,,13,13,26
101 Tirol,61,,14,18,32
101 Tirol,62,,12,10,22
101 Tirol,63,,16,16,32
101 Tirol,64,,19,14,33
101 Tirol,65,,9,13,22
101 Tirol,66,,13,8,21
101 Tirol,67,,11,14,25
101 Tirol,68,,13,15,28
101 Tirol,69,,11,11,22
101 Tirol,70,,13,18,31
101 Tirol,71,,11,16,27
101 Tirol,72,,10,14,24
101 Tirol,73,,9,11,20
101 Tirol,74,,8,9,17
101 Tirol,75,,7,14,21
101 Tirol,76,,6,10,16
101 Tirol,77,,6,7,13
101 Tirol,78,,13,8,21
101 Tirol,79,,5,10,15
101 Tirol,80,,6,6,12
101 Tirol,81,,6,5,11
101 Tirol,82,,4,6,10
101 Tirol,83,,6,9,15
101 Tirol,84,,5,7,12
101 Tirol,85,,9,7,16
101 Tirol,86,,1,3,4
101 Tirol,87,,4,3,7
101 Tirol,88,,3,9,12
101 Tirol,89,,2,4,6
101 Tirol,90,,2,2,4
101 Tirol,91,,1,2,3
101 Tirol,92,,1,2,3
101 Tirol,93,,1,1,2
101 Tirol,94,,1,-,1
101 Tirol,96,,1,-,1
101 Tirol,Insgesamt,,1.231,1.215,2.446
102 Truden im Naturpark,0,,2,7,9
102 Truden im Naturpark,1,,3,1,4
102 Truden im Naturpark,2,,8,5,13
102 Truden im Naturpark,3,,9,8,17
102 Truden im Naturpark,4,,6,9,15
102 Truden im Naturpark,5,,9,9,18
102 Truden im Naturpark,6,,5,1,6
102 Truden im Naturpark,7,,2,5,7
102 Truden im Naturpark,8,,3,7,10
102 Truden im Naturpark,9,,4,5,9
102 Truden im Naturpark,10,,2,4,6
102 Truden im Naturpark,11,,4,2,6
102 Truden im Naturpark,12,,7,8,15
102 Truden im Naturpark,13,,1,2,3
102 Truden im Naturpark,14,,2,8,10
102 Truden im Naturpark,15,,5,6,11
102 Truden im Naturpark,16,,5,6,11
102 Truden im Naturpark,17,,6,5,11
102 Truden im Naturpark,18,,6,5,11
102 Truden im Naturpark,19,,12,6,18
102 Truden im Naturpark,20,,7,5,12
102 Truden im Naturpark,21,,6,8,14
102 Truden im Naturpark,22,,2,5,7
102 Truden im Naturpark,23,,11,9,20
102 Truden im Naturpark,24,,7,12,19
102 Truden im Naturpark,25,,8,5,13
102 Truden im Naturpark,26,,3,9,12
102 Truden im Naturpark,27,,11,8,19
102 Truden im Naturpark,28,,10,5,15
102 Truden im Naturpark,29,,5,5,10
102 Truden im Naturpark,30,,9,5,14
102 Truden im Naturpark,31,,3,11,14
102 Truden im Naturpark,32,,6,5,11
102 Truden im Naturpark,33,,9,6,15
102 Truden im Naturpark,34,,9,7,16
102 Truden im Naturpark,35,,3,6,9
102 Truden im Naturpark,36,,7,6,13
102 Truden im Naturpark,37,,6,3,9
102 Truden im Naturpark,38,,6,9,15
102 Truden im Naturpark,39,,8,9,17
102 Truden im Naturpark,40,,10,10,20
102 Truden im Naturpark,41,,3,3,6
102 Truden im Naturpark,42,,1,8,9
102 Truden im Naturpark,43,,8,9,17
102 Truden im Naturpark,44,,7,9,16
102 Truden im Naturpark,45,,11,5,16
102 Truden im Naturpark,46,,5,9,14
102 Truden im Naturpark,47,,8,7,15
102 Truden im Naturpark,48,,11,8,19
102 Truden im Naturpark,49,,12,7,19
102 Truden im Naturpark,50,,10,5,15
102 Truden im Naturpark,51,,8,7,15
102 Truden im Naturpark,52,,9,12,21
102 Truden im Naturpark,53,,5,9,14
102 Truden im Naturpark,54,,6,12,18
102 Truden im Naturpark,55,,5,8,13
102 Truden im Naturpark,56,,6,6,12
102 Truden im Naturpark,57,,7,10,17
102 Truden im Naturpark,58,,5,7,12
102 Truden im Naturpark,59,,11,6,17
102 Truden im Naturpark,60,,5,6,11
102 Truden im Naturpark,61,,9,5,14
102 Truden im Naturpark,62,,2,3,5
102 Truden im Naturpark,63,,7,4,11
102 Truden im Naturpark,64,,1,5,6
102 Truden im Naturpark,65,,7,2,9
102 Truden im Naturpark,66,,9,7,16
102 Truden im Naturpark,67,,4,3,7
102 Truden im Naturpark,68,,3,6,9
102 Truden im Naturpark,69,,4,5,9
102 Truden im Naturpark,70,,4,4,8
102 Truden im Naturpark,71,,4,6,10
102 Truden im Naturpark,72,,2,4,6
102 Truden im Naturpark,73,,8,2,10
102 Truden im Naturpark,74,,5,7,12
102 Truden im Naturpark,75,,1,4,5
102 Truden im Naturpark,76,,4,2,6
102 Truden im Naturpark,77,,3,1,4
102 Truden im Naturpark,78,,4,1,5
102 Truden im Naturpark,79,,4,7,11
102 Truden im Naturpark,80,,3,3,6
102 Truden im Naturpark,81,,2,3,5
102 Truden im Naturpark,82,,1,6,7
102 Truden im Naturpark,83,,-,5,5
102 Truden im Naturpark,84,,-,4,4
102 Truden im Naturpark,85,,2,4,6
102 Truden im Naturpark,86,,1,6,7
102 Truden im Naturpark,87,,-,4,4
102 Truden im Naturpark,88,,-,4,4
102 Truden im Naturpark,89,,-,4,4
102 Truden im Naturpark,90,,1,3,4
102 Truden im Naturpark,91,,-,2,2
102 Truden im Naturpark,92,,-,1,1
102 Truden im Naturpark,93,,-,1,1
102 Truden im Naturpark,Insgesamt,,485,538,1.023
103 Taufers im Münstertal,0,,4,6,10
103 Taufers im Münstertal,1,,5,6,11
103 Taufers im Münstertal,2,,3,-,3
103 Taufers im Münstertal,3,,7,8,15
103 Taufers im Münstertal,4,,4,5,9
103 Taufers im Münstertal,5,,5,3,8
103 Taufers im Münstertal,6,,4,9,13
103 Taufers im Münstertal,7,,2,5,7
103 Taufers im Münstertal,8,,8,4,12
103 Taufers im Münstertal,9,,3,3,6
103 Taufers im Münstertal,10,,5,5,10
103 Taufers im Münstertal,11,,5,6,11
103 Taufers im Münstertal,12,,4,3,7
103 Taufers im Münstertal,13,,3,4,7
103 Taufers im Münstertal,14,,7,8,15
103 Taufers im Münstertal,15,,4,4,8
103 Taufers im Münstertal,16,,6,4,10
103 Taufers im Münstertal,17,,9,9,18
103 Taufers im Münstertal,18,,6,8,14
103 Taufers im Münstertal,19,,6,5,11
103 Taufers im Münstertal,20,,8,8,16
103 Taufers im Münstertal,21,,5,10,15
103 Taufers im Münstertal,22,,9,7,16
103 Taufers im Münstertal,23,,7,5,12
103 Taufers im Münstertal,24,,8,6,14
103 Taufers im Münstertal,25,,5,6,11
103 Taufers im Münstertal,26,,7,3,10
103 Taufers im Münstertal,27,,6,5,11
103 Taufers im Münstertal,28,,4,6,10
103 Taufers im Münstertal,29,,5,6,11
103 Taufers im Münstertal,30,,4,11,15
103 Taufers im Münstertal,31,,8,8,16
103 Taufers im Münstertal,32,,8,5,13
103 Taufers im Münstertal,33,,6,3,9
103 Taufers im Münstertal,34,,5,3,8
103 Taufers im Münstertal,35,,4,3,7
103 Taufers im Münstertal,36,,1,7,8
103 Taufers im Münstertal,37,,11,5,16
103 Taufers im Münstertal,38,,6,4,10
103 Taufers im Münstertal,39,,1,7,8
103 Taufers im Münstertal,40,,5,7,12
103 Taufers im Münstertal,41,,6,15,21
103 Taufers im Münstertal,42,,6,10,16
103 Taufers im Münstertal,43,,10,5,15
103 Taufers im Münstertal,44,,9,12,21
103 Taufers im Münstertal,45,,4,4,8
103 Taufers im Münstertal,46,,5,10,15
103 Taufers im Münstertal,47,,11,6,17
103 Taufers im Münstertal,48,,9,12,21
103 Taufers im Münstertal,49,,9,9,18
103 Taufers im Münstertal,50,,12,8,20
103 Taufers im Münstertal,51,,9,7,16
103 Taufers im Münstertal,52,,12,7,19
103 Taufers im Münstertal,53,,6,10,16
103 Taufers im Münstertal,54,,5,6,11
103 Taufers im Münstertal,55,,8,7,15
103 Taufers im Münstertal,56,,11,10,21
103 Taufers im Münstertal,57,,4,3,7
103 Taufers im Münstertal,58,,4,6,10
103 Taufers im Münstertal,59,,6,4,10
103 Taufers im Münstertal,60,,7,2,9
103 Taufers im Münstertal,61,,5,5,10
103 Taufers im Münstertal,62,,7,3,10
103 Taufers im Münstertal,63,,5,1,6
103 Taufers im Münstertal,64,,5,1,6
103 Taufers im Münstertal,65,,3,6,9
103 Taufers im Münstertal,66,,3,3,6
103 Taufers im Münstertal,67,,2,4,6
103 Taufers im Münstertal,68,,1,-,1
103 Taufers im Münstertal,69,,6,4,10
103 Taufers im Münstertal,70,,4,4,8
103 Taufers im Münstertal,71,,3,5,8
103 Taufers im Münstertal,72,,2,3,5
103 Taufers im Münstertal,73,,4,4,8
103 Taufers im Münstertal,74,,7,8,15
103 Taufers im Münstertal,75,,3,3,6
103 Taufers im Münstertal,76,,2,8,10
103 Taufers im Münstertal,77,,3,2,5
103 Taufers im Münstertal,78,,2,7,9
103 Taufers im Münstertal,79,,3,5,8
103 Taufers im Münstertal,80,,5,1,6
103 Taufers im Münstertal,81,,7,4,11
103 Taufers im Münstertal,82,,1,3,4
103 Taufers im Münstertal,83,,4,5,9
103 Taufers im Münstertal,84,,3,4,7
103 Taufers im Münstertal,85,,2,3,5
103 Taufers im Münstertal,86,,1,4,5
103 Taufers im Münstertal,87,,1,3,4
103 Taufers im Münstertal,88,,-,2,2
103 Taufers im Münstertal,89,,3,2,5
103 Taufers im Münstertal,90,,-,1,1
103 Taufers im Münstertal,91,,1,-,1
103 Taufers im Münstertal,92,,1,-,1
103 Taufers im Münstertal,94,,-,2,2
103 Taufers im Münstertal,95,,1,-,1
103 Taufers im Münstertal,100,,-,1,1
103 Taufers im Münstertal,Insgesamt,,476,494,970
104 Ulten,0,,12,12,24
104 Ulten,1,,15,20,35
104 Ulten,2,,14,12,26
104 Ulten,3,,19,12,31
104 Ulten,4,,18,10,28
104 Ulten,5,,6,10,16
104 Ulten,6,,14,11,25
104 Ulten,7,,18,21,39
104 Ulten,8,,18,12,30
104 Ulten,9,,23,18,41
104 Ulten,10,,15,18,33
104 Ulten,11,,20,17,37
104 Ulten,12,,16,18,34
104 Ulten,13,,14,14,28
104 Ulten,14,,16,17,33
104 Ulten,15,,13,20,33
104 Ulten,16,,11,14,25
104 Ulten,17,,12,14,26
104 Ulten,18,,18,14,32
104 Ulten,19,,23,14,37
104 Ulten,20,,16,17,33
104 Ulten,21,,25,28,53
104 Ulten,22,,14,16,30
104 Ulten,23,,16,29,45
104 Ulten,24,,14,19,33
104 Ulten,25,,18,17,35
104 Ulten,26,,18,11,29
104 Ulten,27,,17,18,35
104 Ulten,28,,20,16,36
104 Ulten,29,,19,12,31
104 Ulten,30,,15,21,36
104 Ulten,31,,22,19,41
104 Ulten,32,,19,20,39
104 Ulten,33,,16,18,34
104 Ulten,34,,23,13,36
104 Ulten,35,,17,14,31
104 Ulten,36,,17,18,35
104 Ulten,37,,22,20,42
104 Ulten,38,,14,21,35
104 Ulten,39,,25,15,40
104 Ulten,40,,20,17,37
104 Ulten,41,,27,20,47
104 Ulten,42,,21,25,46
104 Ulten,43,,26,22,48
104 Ulten,44,,29,25,54
104 Ulten,45,,16,19,35
104 Ulten,46,,20,17,37
104 Ulten,47,,26,27,53
104 Ulten,48,,24,18,42
104 Ulten,49,,28,25,53
104 Ulten,50,,29,22,51
104 Ulten,51,,29,16,45
104 Ulten,52,,25,21,46
104 Ulten,53,,24,21,45
104 Ulten,54,,26,16,42
104 Ulten,55,,34,22,56
104 Ulten,56,,18,15,33
104 Ulten,57,,13,12,25
104 Ulten,58,,16,14,30
104 Ulten,59,,21,13,34
104 Ulten,60,,18,13,31
104 Ulten,61,,17,17,34
104 Ulten,62,,18,12,30
104 Ulten,63,,16,9,25
104 Ulten,64,,13,13,26
104 Ulten,65,,15,9,24
104 Ulten,66,,16,14,30
104 Ulten,67,,9,13,22
104 Ulten,68,,13,21,34
104 Ulten,69,,16,16,32
104 Ulten,70,,8,13,21
104 Ulten,71,,11,9,20
104 Ulten,72,,14,8,22
104 Ulten,73,,17,17,34
104 Ulten,74,,6,10,16
104 Ulten,75,,10,9,19
104 Ulten,76,,6,9,15
104 Ulten,77,,8,10,18
104 Ulten,78,,10,13,23
104 Ulten,79,,4,12,16
104 Ulten,80,,8,8,16
104 Ulten,81,,8,8,16
104 Ulten,82,,10,15,25
104 Ulten,83,,3,11,14
104 Ulten,84,,6,9,15
104 Ulten,85,,5,16,21
104 Ulten,86,,4,11,15
104 Ulten,87,,6,7,13
104 Ulten,88,,3,7,10
104 Ulten,89,,3,17,20
104 Ulten,90,,3,5,8
104 Ulten,91,,5,7,12
104 Ulten,92,,1,3,4
104 Ulten,93,,1,2,3
104 Ulten,94,,1,-,1
104 Ulten,97,,1,-,1
104 Ulten,98,,-,1,1
104 Ulten,Insgesamt,,1.467,1.421,2.888
105 Pfatten,0,,4,5,9
105 Pfatten,1,,12,7,19
105 Pfatten,2,,6,4,10
105 Pfatten,3,,6,7,13
105 Pfatten,4,,7,6,13
105 Pfatten,5,,8,8,16
105 Pfatten,6,,8,3,11
105 Pfatten,7,,5,11,16
105 Pfatten,8,,1,6,7
105 Pfatten,9,,12,5,17
105 Pfatten,10,,4,5,9
105 Pfatten,11,,5,3,8
105 Pfatten,12,,6,5,11
105 Pfatten,13,,5,7,12
105 Pfatten,14,,8,5,13
105 Pfatten,15,,5,2,7
105 Pfatten,16,,4,9,13
105 Pfatten,17,,5,6,11
105 Pfatten,18,,8,10,18
105 Pfatten,19,,6,5,11
105 Pfatten,20,,6,6,12
105 Pfatten,21,,8,6,14
105 Pfatten,22,,9,9,18
105 Pfatten,23,,7,6,13
105 Pfatten,24,,2,6,8
105 Pfatten,25,,8,4,12
105 Pfatten,26,,6,12,18
105 Pfatten,27,,6,9,15
105 Pfatten,28,,6,6,12
105 Pfatten,29,,8,12,20
105 Pfatten,30,,7,5,12
105 Pfatten,31,,10,4,14
105 Pfatten,32,,1,3,4
105 Pfatten,33,,6,12,18
105 Pfatten,34,,5,9,14
105 Pfatten,35,,7,5,12
105 Pfatten,36,,8,10,18
105 Pfatten,37,,4,9,13
105 Pfatten,38,,15,10,25
105 Pfatten,39,,11,5,16
105 Pfatten,40,,8,9,17
105 Pfatten,41,,12,7,19
105 Pfatten,42,,10,8,18
105 Pfatten,43,,7,4,11
105 Pfatten,44,,7,8,15
105 Pfatten,45,,14,7,21
105 Pfatten,46,,10,9,19
105 Pfatten,47,,11,11,22
105 Pfatten,48,,11,3,14
105 Pfatten,49,,7,9,16
105 Pfatten,50,,10,13,23
105 Pfatten,51,,10,13,23
105 Pfatten,52,,8,8,16
105 Pfatten,53,,5,14,19
105 Pfatten,54,,7,6,13
105 Pfatten,55,,14,6,20
105 Pfatten,56,,9,9,18
105 Pfatten,57,,6,4,10
105 Pfatten,58,,11,3,14
105 Pfatten,59,,6,6,12
105 Pfatten,60,,1,6,7
105 Pfatten,61,,3,5,8
105 Pfatten,62,,5,6,11
105 Pfatten,63,,9,2,11
105 Pfatten,64,,3,1,4
105 Pfatten,65,,6,7,13
105 Pfatten,66,,3,4,7
105 Pfatten,67,,6,2,8
105 Pfatten,68,,4,2,6
105 Pfatten,69,,1,3,4
105 Pfatten,70,,1,2,3
105 Pfatten,71,,3,4,7
105 Pfatten,72,,3,3,6
105 Pfatten,73,,3,1,4
105 Pfatten,74,,2,2,4
105 Pfatten,75,,3,1,4
105 Pfatten,76,,2,3,5
105 Pfatten,77,,4,3,7
105 Pfatten,78,,2,6,8
105 Pfatten,79,,1,1,2
105 Pfatten,80,,-,5,5
105 Pfatten,81,,2,3,5
105 Pfatten,82,,-,2,2
105 Pfatten,83,,-,5,5
105 Pfatten,84,,-,1,1
105 Pfatten,86,,1,1,2
105 Pfatten,87,,1,2,3
105 Pfatten,88,,-,2,2
105 Pfatten,89,,1,-,1
105 Pfatten,91,,-,1,1
105 Pfatten,92,,1,1,2
105 Pfatten,95,,-,1,1
105 Pfatten,Insgesamt,,519,512,1.031
106 Olang,0,,12,22,34
106 Olang,1,,19,21,40
106 Olang,2,,18,22,40
106 Olang,3,,13,20,33
106 Olang,4,,24,22,46
106 Olang,5,,12,23,35
106 Olang,6,,7,18,25
106 Olang,7,,22,12,34
106 Olang,8,,14,13,27
106 Olang,9,,21,11,32
106 Olang,10,,16,12,28
106 Olang,11,,17,20,37
106 Olang,12,,19,22,41
106 Olang,13,,17,12,29
106 Olang,14,,17,22,39
106 Olang,15,,24,15,39
106 Olang,16,,26,22,48
106 Olang,17,,19,10,29
106 Olang,18,,21,11,32
106 Olang,19,,21,23,44
106 Olang,20,,16,15,31
106 Olang,21,,27,16,43
106 Olang,22,,26,22,48
106 Olang,23,,21,19,40
106 Olang,24,,17,18,35
106 Olang,25,,27,20,47
106 Olang,26,,15,21,36
106 Olang,27,,14,22,36
106 Olang,28,,23,18,41
106 Olang,29,,16,18,34
106 Olang,30,,20,24,44
106 Olang,31,,12,26,38
106 Olang,32,,23,21,44
106 Olang,33,,22,29,51
106 Olang,34,,23,20,43
106 Olang,35,,32,30,62
106 Olang,36,,21,21,42
106 Olang,37,,26,25,51
106 Olang,38,,17,26,43
106 Olang,39,,31,25,56
106 Olang,40,,28,18,46
106 Olang,41,,31,18,49
106 Olang,42,,22,20,42
106 Olang,43,,23,32,55
106 Olang,44,,30,26,56
106 Olang,45,,32,26,58
106 Olang,46,,30,24,54
106 Olang,47,,18,24,42
106 Olang,48,,20,27,47
106 Olang,49,,27,24,51
106 Olang,50,,24,14,38
106 Olang,51,,15,25,40
106 Olang,52,,21,26,47
106 Olang,53,,25,15,40
106 Olang,54,,22,14,36
106 Olang,55,,28,12,40
106 Olang,56,,13,28,41
106 Olang,57,,18,16,34
106 Olang,58,,15,19,34
106 Olang,59,,15,20,35
106 Olang,60,,15,13,28
106 Olang,61,,8,14,22
106 Olang,62,,32,17,49
106 Olang,63,,20,11,31
106 Olang,64,,19,20,39
106 Olang,65,,12,25,37
106 Olang,66,,14,12,26
106 Olang,67,,17,11,28
106 Olang,68,,15,6,21
106 Olang,69,,11,17,28
106 Olang,70,,14,16,30
106 Olang,71,,11,13,24
106 Olang,72,,16,10,26
106 Olang,73,,10,9,19
106 Olang,74,,8,13,21
106 Olang,75,,6,8,14
106 Olang,76,,6,7,13
106 Olang,77,,7,14,21
106 Olang,78,,11,9,20
106 Olang,79,,8,13,21
106 Olang,80,,10,9,19
106 Olang,81,,1,6,7
106 Olang,82,,10,6,16
106 Olang,83,,7,10,17
106 Olang,84,,4,6,10
106 Olang,85,,4,4,8
106 Olang,86,,1,9,10
106 Olang,87,,2,1,3
106 Olang,88,,2,8,10
106 Olang,89,,4,3,7
106 Olang,90,,1,4,5
106 Olang,91,,1,2,3
106 Olang,92,,-,3,3
106 Olang,93,,1,1,2
106 Olang,94,,-,1,1
106 Olang,95,,1,-,1
106 Olang,96,,-,1,1
106 Olang,97,,-,1,1
106 Olang,Insgesamt,,1.554,1.550,3.104
107 Pfitsch,0,,23,23,46
107 Pfitsch,1,,19,16,35
107 Pfitsch,2,,22,11,33
107 Pfitsch,3,,17,9,26
107 Pfitsch,4,,13,20,33
107 Pfitsch,5,,18,10,28
107 Pfitsch,6,,27,15,42
107 Pfitsch,7,,17,16,33
107 Pfitsch,8,,21,14,35
107 Pfitsch,9,,17,14,31
107 Pfitsch,10,,22,19,41
107 Pfitsch,11,,11,9,20
107 Pfitsch,12,,24,24,48
107 Pfitsch,13,,19,13,32
107 Pfitsch,14,,11,15,26
107 Pfitsch,15,,14,18,32
107 Pfitsch,16,,11,13,24
107 Pfitsch,17,,17,11,28
107 Pfitsch,18,,14,17,31
107 Pfitsch,19,,14,15,29
107 Pfitsch,20,,16,17,33
107 Pfitsch,21,,21,15,36
107 Pfitsch,22,,18,15,33
107 Pfitsch,23,,14,17,31
107 Pfitsch,24,,15,20,35
107 Pfitsch,25,,11,17,28
107 Pfitsch,26,,12,15,27
107 Pfitsch,27,,17,13,30
107 Pfitsch,28,,24,12,36
107 Pfitsch,29,,24,28,52
107 Pfitsch,30,,28,17,45
107 Pfitsch,31,,23,27,50
107 Pfitsch,32,,19,27,46
107 Pfitsch,33,,27,19,46
107 Pfitsch,34,,28,17,45
107 Pfitsch,35,,18,15,33
107 Pfitsch,36,,19,30,49
107 Pfitsch,37,,22,26,48
107 Pfitsch,38,,18,20,38
107 Pfitsch,39,,23,22,45
107 Pfitsch,40,,25,19,44
107 Pfitsch,41,,30,18,48
107 Pfitsch,42,,21,22,43
107 Pfitsch,43,,28,19,47
107 Pfitsch,44,,22,21,43
107 Pfitsch,45,,24,22,46
107 Pfitsch,46,,25,18,43
107 Pfitsch,47,,22,21,43
107 Pfitsch,48,,15,25,40
107 Pfitsch,49,,18,17,35
107 Pfitsch,50,,24,20,44
107 Pfitsch,51,,22,20,42
107 Pfitsch,52,,16,25,41
107 Pfitsch,53,,14,15,29
107 Pfitsch,54,,23,14,37
107 Pfitsch,55,,25,24,49
107 Pfitsch,56,,19,15,34
107 Pfitsch,57,,14,14,28
107 Pfitsch,58,,19,19,38
107 Pfitsch,59,,24,16,40
107 Pfitsch,60,,15,21,36
107 Pfitsch,61,,21,16,37
107 Pfitsch,62,,18,19,37
107 Pfitsch,63,,12,18,30
107 Pfitsch,64,,7,7,14
107 Pfitsch,65,,8,11,19
107 Pfitsch,66,,14,14,28
107 Pfitsch,67,,11,12,23
107 Pfitsch,68,,11,13,24
107 Pfitsch,69,,19,11,30
107 Pfitsch,70,,19,14,33
107 Pfitsch,71,,12,16,28
107 Pfitsch,72,,11,15,26
107 Pfitsch,73,,13,8,21
107 Pfitsch,74,,4,12,16
107 Pfitsch,75,,8,11,19
107 Pfitsch,76,,6,11,17
107 Pfitsch,77,,6,6,12
107 Pfitsch,78,,10,6,16
107 Pfitsch,79,,12,10,22
107 Pfitsch,80,,4,11,15
107 Pfitsch,81,,7,8,15
107 Pfitsch,82,,2,9,11
107 Pfitsch,83,,9,8,17
107 Pfitsch,84,,2,11,13
107 Pfitsch,85,,6,9,15
107 Pfitsch,86,,2,8,10
107 Pfitsch,87,,4,8,12
107 Pfitsch,88,,1,5,6
107 Pfitsch,89,,2,5,7
107 Pfitsch,90,,3,2,5
107 Pfitsch,91,,-,5,5
107 Pfitsch,92,,-,1,1
107 Pfitsch,93,,-,2,2
107 Pfitsch,94,,-,1,1
107 Pfitsch,95,,1,2,3
107 Pfitsch,97,,-,1,1
107 Pfitsch,Insgesamt,,1.458,1.422,2.880
108 Ahrntal,0,,49,29,78
108 Ahrntal,1,,34,34,68
108 Ahrntal,2,,32,30,62
108 Ahrntal,3,,40,43,83
108 Ahrntal,4,,26,48,74
108 Ahrntal,5,,42,40,82
108 Ahrntal,6,,40,35,75
108 Ahrntal,7,,31,39,70
108 Ahrntal,8,,32,38,70
108 Ahrntal,9,,34,41,75
108 Ahrntal,10,,31,36,67
108 Ahrntal,11,,34,30,64
108 Ahrntal,12,,49,42,91
108 Ahrntal,13,,34,36,70
108 Ahrntal,14,,36,38,74
108 Ahrntal,15,,41,46,87
108 Ahrntal,16,,39,49,88
108 Ahrntal,17,,35,30,65
108 Ahrntal,18,,27,27,54
108 Ahrntal,19,,38,42,80
108 Ahrntal,20,,41,34,75
108 Ahrntal,21,,28,34,62
108 Ahrntal,22,,42,32,74
108 Ahrntal,23,,41,35,76
108 Ahrntal,24,,28,32,60
108 Ahrntal,25,,37,36,73
108 Ahrntal,26,,37,47,84
108 Ahrntal,27,,36,46,82
108 Ahrntal,28,,38,29,67
108 Ahrntal,29,,42,48,90
108 Ahrntal,30,,39,44,83
108 Ahrntal,31,,50,40,90
108 Ahrntal,32,,41,36,77
108 Ahrntal,33,,34,45,79
108 Ahrntal,34,,33,41,74
108 Ahrntal,35,,50,46,96
108 Ahrntal,36,,47,44,91
108 Ahrntal,37,,43,40,83
108 Ahrntal,38,,47,37,84
108 Ahrntal,39,,45,39,84
108 Ahrntal,40,,56,51,107
108 Ahrntal,41,,68,44,112
108 Ahrntal,42,,54,46,100
108 Ahrntal,43,,53,43,96
108 Ahrntal,44,,51,43,94
108 Ahrntal,45,,40,49,89
108 Ahrntal,46,,57,43,100
108 Ahrntal,47,,58,42,100
108 Ahrntal,48,,50,41,91
108 Ahrntal,49,,50,42,92
108 Ahrntal,50,,37,47,84
108 Ahrntal,51,,34,39,73
108 Ahrntal,52,,37,30,67
108 Ahrntal,53,,41,39,80
108 Ahrntal,54,,47,29,76
108 Ahrntal,55,,27,40,67
108 Ahrntal,56,,37,21,58
108 Ahrntal,57,,33,25,58
108 Ahrntal,58,,34,20,54
108 Ahrntal,59,,26,29,55
108 Ahrntal,60,,26,34,60
108 Ahrntal,61,,30,23,53
108 Ahrntal,62,,32,20,52
108 Ahrntal,63,,33,31,64
108 Ahrntal,64,,28,27,55
108 Ahrntal,65,,23,17,40
108 Ahrntal,66,,17,22,39
108 Ahrntal,67,,20,13,33
108 Ahrntal,68,,16,18,34
108 Ahrntal,69,,20,30,50
108 Ahrntal,70,,27,28,55
108 Ahrntal,71,,27,31,58
108 Ahrntal,72,,29,23,52
108 Ahrntal,73,,20,23,43
108 Ahrntal,74,,31,28,59
108 Ahrntal,75,,20,21,41
108 Ahrntal,76,,20,14,34
108 Ahrntal,77,,14,36,50
108 Ahrntal,78,,15,20,35
108 Ahrntal,79,,16,16,32
108 Ahrntal,80,,17,26,43
108 Ahrntal,81,,21,17,38
108 Ahrntal,82,,15,14,29
108 Ahrntal,83,,11,15,26
108 Ahrntal,84,,10,23,33
108 Ahrntal,85,,7,14,21
108 Ahrntal,86,,10,12,22
108 Ahrntal,87,,5,11,16
108 Ahrntal,88,,6,6,12
108 Ahrntal,89,,5,5,10
108 Ahrntal,90,,3,9,12
108 Ahrntal,91,,1,2,3
108 Ahrntal,92,,1,2,3
108 Ahrntal,93,,4,4,8
108 Ahrntal,94,,-,1,1
108 Ahrntal,96,,-,1,1
108 Ahrntal,97,,-,1,1
108 Ahrntal,98,,-,4,4
108 Ahrntal,Insgesamt,,2.993,2.943,5.936
109 Gsies,0,,13,16,29
109 Gsies,1,,10,18,28
109 Gsies,2,,16,15,31
109 Gsies,3,,16,19,35
109 Gsies,4,,15,9,24
109 Gsies,5,,17,13,30
109 Gsies,6,,19,20,39
109 Gsies,7,,16,16,32
109 Gsies,8,,12,13,25
109 Gsies,9,,19,18,37
109 Gsies,10,,13,12,25
109 Gsies,11,,15,14,29
109 Gsies,12,,9,12,21
109 Gsies,13,,31,10,41
109 Gsies,14,,19,5,24
109 Gsies,15,,13,17,30
109 Gsies,16,,11,18,29
109 Gsies,17,,15,16,31
109 Gsies,18,,9,17,26
109 Gsies,19,,17,20,37
109 Gsies,20,,16,10,26
109 Gsies,21,,15,22,37
109 Gsies,22,,17,12,29
109 Gsies,23,,9,13,22
109 Gsies,24,,8,14,22
109 Gsies,25,,18,17,35
109 Gsies,26,,13,18,31
109 Gsies,27,,17,15,32
109 Gsies,28,,12,12,24
109 Gsies,29,,18,8,26
109 Gsies,30,,18,17,35
109 Gsies,31,,16,23,39
109 Gsies,32,,23,22,45
109 Gsies,33,,11,13,24
109 Gsies,34,,17,13,30
109 Gsies,35,,14,18,32
109 Gsies,36,,12,16,28
109 Gsies,37,,17,22,39
109 Gsies,38,,19,13,32
109 Gsies,39,,14,9,23
109 Gsies,40,,8,19,27
109 Gsies,41,,19,18,37
109 Gsies,42,,27,15,42
109 Gsies,43,,23,10,33
109 Gsies,44,,14,15,29
109 Gsies,45,,16,13,29
109 Gsies,46,,15,19,34
109 Gsies,47,,18,5,23
109 Gsies,48,,16,18,34
109 Gsies,49,,14,14,28
109 Gsies,50,,16,8,24
109 Gsies,51,,9,14,23
109 Gsies,52,,15,17,32
109 Gsies,53,,10,14,24
109 Gsies,54,,16,16,32
109 Gsies,55,,12,13,25
109 Gsies,56,,16,7,23
109 Gsies,57,,14,10,24
109 Gsies,58,,16,6,22
109 Gsies,59,,18,6,24
109 Gsies,60,,16,14,30
109 Gsies,61,,14,13,27
109 Gsies,62,,8,9,17
109 Gsies,63,,16,16,32
109 Gsies,64,,7,10,17
109 Gsies,65,,21,7,28
109 Gsies,66,,15,10,25
109 Gsies,67,,5,12,17
109 Gsies,68,,7,13,20
109 Gsies,69,,9,8,17
109 Gsies,70,,5,12,17
109 Gsies,71,,6,10,16
109 Gsies,72,,7,10,17
109 Gsies,73,,6,9,15
109 Gsies,74,,9,8,17
109 Gsies,75,,8,7,15
109 Gsies,76,,5,11,16
109 Gsies,77,,4,7,11
109 Gsies,78,,3,9,12
109 Gsies,79,,5,6,11
109 Gsies,80,,7,5,12
109 Gsies,81,,5,6,11
109 Gsies,82,,10,6,16
109 Gsies,83,,3,4,7
109 Gsies,84,,7,8,15
109 Gsies,85,,-,8,8
109 Gsies,86,,3,2,5
109 Gsies,87,,4,3,7
109 Gsies,88,,1,4,5
109 Gsies,89,,4,5,9
109 Gsies,90,,4,4,8
109 Gsies,91,,1,4,5
109 Gsies,92,,2,-,2
109 Gsies,93,,2,-,2
109 Gsies,94,,-,1,1
109 Gsies,95,,1,-,1
109 Gsies,Insgesamt,,1.151,1.123,2.274
110 Vintl,0,,20,20,40
110 Vintl,1,,12,19,31
110 Vintl,2,,14,17,31
110 Vintl,3,,22,20,42
110 Vintl,4,,22,17,39
110 Vintl,5,,24,15,39
110 Vintl,6,,13,13,26
110 Vintl,7,,20,23,43
110 Vintl,8,,11,14,25
110 Vintl,9,,17,17,34
110 Vintl,10,,14,21,35
110 Vintl,11,,16,21,37
110 Vintl,12,,22,15,37
110 Vintl,13,,21,23,44
110 Vintl,14,,21,29,50
110 Vintl,15,,20,15,35
110 Vintl,16,,21,19,40
110 Vintl,17,,37,25,62
110 Vintl,18,,18,18,36
110 Vintl,19,,26,19,45
110 Vintl,20,,29,21,50
110 Vintl,21,,22,30,52
110 Vintl,22,,28,22,50
110 Vintl,23,,27,14,41
110 Vintl,24,,21,21,42
110 Vintl,25,,20,24,44
110 Vintl,26,,25,21,46
110 Vintl,27,,13,18,31
110 Vintl,28,,26,13,39
110 Vintl,29,,22,13,35
110 Vintl,30,,24,27,51
110 Vintl,31,,19,22,41
110 Vintl,32,,27,18,45
110 Vintl,33,,26,19,45
110 Vintl,34,,19,39,58
110 Vintl,35,,17,23,40
110 Vintl,36,,25,23,48
110 Vintl,37,,24,19,43
110 Vintl,38,,24,23,47
110 Vintl,39,,20,21,41
110 Vintl,40,,27,16,43
110 Vintl,41,,28,29,57
110 Vintl,42,,20,19,39
110 Vintl,43,,28,23,51
110 Vintl,44,,28,23,51
110 Vintl,45,,28,33,61
110 Vintl,46,,32,28,60
110 Vintl,47,,32,30,62
110 Vintl,48,,32,22,54
110 Vintl,49,,35,27,62
110 Vintl,50,,32,22,54
110 Vintl,51,,25,32,57
110 Vintl,52,,16,22,38
110 Vintl,53,,21,22,43
110 Vintl,54,,20,15,35
110 Vintl,55,,22,28,50
110 Vintl,56,,26,19,45
110 Vintl,57,,19,15,34
110 Vintl,58,,15,17,32
110 Vintl,59,,22,9,31
110 Vintl,60,,15,18,33
110 Vintl,61,,21,16,37
110 Vintl,62,,19,21,40
110 Vintl,63,,18,20,38
110 Vintl,64,,12,13,25
110 Vintl,65,,20,14,34
110 Vintl,66,,13,11,24
110 Vintl,67,,13,16,29
110 Vintl,68,,10,5,15
110 Vintl,69,,20,11,31
110 Vintl,70,,10,10,20
110 Vintl,71,,7,14,21
110 Vintl,72,,8,19,27
110 Vintl,73,,12,14,26
110 Vintl,74,,9,6,15
110 Vintl,75,,8,8,16
110 Vintl,76,,11,11,22
110 Vintl,77,,9,10,19
110 Vintl,78,,11,7,18
110 Vintl,79,,3,17,20
110 Vintl,80,,7,12,19
110 Vintl,81,,8,11,19
110 Vintl,82,,4,13,17
110 Vintl,83,,6,12,18
110 Vintl,84,,6,7,13
110 Vintl,85,,4,9,13
110 Vintl,86,,6,1,7
110 Vintl,87,,3,4,7
110 Vintl,88,,2,5,7
110 Vintl,89,,2,4,6
110 Vintl,90,,1,4,5
110 Vintl,91,,-,3,3
110 Vintl,92,,-,6,6
110 Vintl,95,,-,1,1
110 Vintl,96,,-,1,1
110 Vintl,97,,1,-,1
110 Vintl,Insgesamt,,1.656,1.616,3.272
111 Vahrn,0,,30,24,54
111 Vahrn,1,,32,26,58
111 Vahrn,2,,25,24,49
111 Vahrn,3,,31,24,55
111 Vahrn,4,,21,24,45
111 Vahrn,5,,37,22,59
111 Vahrn,6,,34,31,65
111 Vahrn,7,,32,32,64
111 Vahrn,8,,30,30,60
111 Vahrn,9,,29,14,43
111 Vahrn,10,,28,31,59
111 Vahrn,11,,28,21,49
111 Vahrn,12,,27,21,48
111 Vahrn,13,,29,32,61
111 Vahrn,14,,22,26,48
111 Vahrn,15,,23,23,46
111 Vahrn,16,,36,18,54
111 Vahrn,17,,29,24,53
111 Vahrn,18,,22,24,46
111 Vahrn,19,,21,19,40
111 Vahrn,20,,19,30,49
111 Vahrn,21,,23,23,46
111 Vahrn,22,,14,30,44
111 Vahrn,23,,28,21,49
111 Vahrn,24,,26,18,44
111 Vahrn,25,,20,23,43
111 Vahrn,26,,25,13,38
111 Vahrn,27,,25,30,55
111 Vahrn,28,,25,23,48
111 Vahrn,29,,32,37,69
111 Vahrn,30,,33,38,71
111 Vahrn,31,,29,28,57
111 Vahrn,32,,31,33,64
111 Vahrn,33,,25,33,58
111 Vahrn,34,,32,36,68
111 Vahrn,35,,21,30,51
111 Vahrn,36,,44,29,73
111 Vahrn,37,,36,37,73
111 Vahrn,38,,34,40,74
111 Vahrn,39,,39,43,82
111 Vahrn,40,,33,42,75
111 Vahrn,41,,41,31,72
111 Vahrn,42,,46,41,87
111 Vahrn,43,,43,47,90
111 Vahrn,44,,35,37,72
111 Vahrn,45,,43,34,77
111 Vahrn,46,,37,32,69
111 Vahrn,47,,39,40,79
111 Vahrn,48,,35,39,74
111 Vahrn,49,,40,35,75
111 Vahrn,50,,29,36,65
111 Vahrn,51,,27,26,53
111 Vahrn,52,,30,30,60
111 Vahrn,53,,32,28,60
111 Vahrn,54,,20,20,40
111 Vahrn,55,,31,28,59
111 Vahrn,56,,20,23,43
111 Vahrn,57,,25,32,57
111 Vahrn,58,,22,31,53
111 Vahrn,59,,24,27,51
111 Vahrn,60,,21,15,36
111 Vahrn,61,,21,15,36
111 Vahrn,62,,20,21,41
111 Vahrn,63,,24,32,56
111 Vahrn,64,,18,18,36
111 Vahrn,65,,15,26,41
111 Vahrn,66,,18,23,41
111 Vahrn,67,,12,14,26
111 Vahrn,68,,16,20,36
111 Vahrn,69,,20,24,44
111 Vahrn,70,,15,22,37
111 Vahrn,71,,17,22,39
111 Vahrn,72,,21,15,36
111 Vahrn,73,,19,20,39
111 Vahrn,74,,11,10,21
111 Vahrn,75,,15,19,34
111 Vahrn,76,,8,14,22
111 Vahrn,77,,7,13,20
111 Vahrn,78,,13,12,25
111 Vahrn,79,,7,12,19
111 Vahrn,80,,6,11,17
111 Vahrn,81,,8,10,18
111 Vahrn,82,,9,8,17
111 Vahrn,83,,5,18,23
111 Vahrn,84,,6,11,17
111 Vahrn,85,,1,15,16
111 Vahrn,86,,4,3,7
111 Vahrn,87,,2,9,11
111 Vahrn,88,,3,6,9
111 Vahrn,89,,3,7,10
111 Vahrn,90,,1,5,6
111 Vahrn,91,,2,3,5
111 Vahrn,92,,1,3,4
111 Vahrn,94,,-,1,1
111 Vahrn,95,,-,1,1
111 Vahrn,96,,1,-,1
111 Vahrn,98,,-,2,2
111 Vahrn,102,,-,1,1
111 Vahrn,Insgesamt,,2.149,2.225,4.374
112 Vöran,0,,9,6,15
112 Vöran,1,,2,3,5
112 Vöran,2,,9,6,15
112 Vöran,3,,5,6,11
112 Vöran,4,,8,3,11
112 Vöran,5,,5,3,8
112 Vöran,6,,9,3,12
112 Vöran,7,,3,5,8
112 Vöran,8,,3,5,8
112 Vöran,9,,9,5,14
112 Vöran,10,,5,7,12
112 Vöran,11,,9,4,13
112 Vöran,12,,11,6,17
112 Vöran,13,,5,3,8
112 Vöran,14,,5,4,9
112 Vöran,15,,11,7,18
112 Vöran,16,,10,5,15
112 Vöran,17,,5,9,14
112 Vöran,18,,7,7,14
112 Vöran,19,,7,6,13
112 Vöran,20,,7,3,10
112 Vöran,21,,8,4,12
112 Vöran,22,,5,7,12
112 Vöran,23,,11,5,16
112 Vöran,24,,7,8,15
112 Vöran,25,,11,7,18
112 Vöran,26,,6,7,13
112 Vöran,27,,9,8,17
112 Vöran,28,,8,6,14
112 Vöran,29,,4,4,8
112 Vöran,30,,9,8,17
112 Vöran,31,,8,11,19
112 Vöran,32,,5,3,8
112 Vöran,33,,3,6,9
112 Vöran,34,,8,7,15
112 Vöran,35,,10,6,16
112 Vöran,36,,6,6,12
112 Vöran,37,,9,6,15
112 Vöran,38,,15,11,26
112 Vöran,39,,6,6,12
112 Vöran,40,,8,8,16
112 Vöran,41,,7,10,17
112 Vöran,42,,8,5,13
112 Vöran,43,,7,4,11
112 Vöran,44,,13,3,16
112 Vöran,45,,5,6,11
112 Vöran,46,,8,6,14
112 Vöran,47,,4,4,8
112 Vöran,48,,12,4,16
112 Vöran,49,,7,7,14
112 Vöran,50,,13,14,27
112 Vöran,51,,4,5,9
112 Vöran,52,,6,6,12
112 Vöran,53,,4,7,11
112 Vöran,54,,6,6,12
112 Vöran,55,,5,10,15
112 Vöran,56,,2,1,3
112 Vöran,57,,5,2,7
112 Vöran,58,,5,5,10
112 Vöran,59,,5,4,9
112 Vöran,60,,9,2,11
112 Vöran,61,,4,-,4
112 Vöran,62,,7,4,11
112 Vöran,63,,7,5,12
112 Vöran,64,,2,3,5
112 Vöran,65,,5,2,7
112 Vöran,66,,4,2,6
112 Vöran,67,,-,4,4
112 Vöran,68,,4,2,6
112 Vöran,69,,2,4,6
112 Vöran,70,,4,4,8
112 Vöran,71,,4,6,10
112 Vöran,72,,2,5,7
112 Vöran,73,,2,3,5
112 Vöran,74,,7,3,10
112 Vöran,75,,2,2,4
112 Vöran,76,,3,5,8
112 Vöran,77,,2,-,2
112 Vöran,78,,1,6,7
112 Vöran,79,,5,6,11
112 Vöran,80,,2,3,5
112 Vöran,81,,2,-,2
112 Vöran,82,,5,1,6
112 Vöran,83,,1,1,2
112 Vöran,84,,2,1,3
112 Vöran,85,,-,1,1
112 Vöran,86,,-,2,2
112 Vöran,87,,1,2,3
112 Vöran,89,,-,1,1
112 Vöran,90,,1,-,1
112 Vöran,92,,-,1,1
112 Vöran,Insgesamt,,516,430,946
113 Niederdorf,0,,6,9,15
113 Niederdorf,1,,10,6,16
113 Niederdorf,2,,9,6,15
113 Niederdorf,3,,14,10,24
113 Niederdorf,4,,9,8,17
113 Niederdorf,5,,9,11,20
113 Niederdorf,6,,7,8,15
113 Niederdorf,7,,15,8,23
113 Niederdorf,8,,10,18,28
113 Niederdorf,9,,5,13,18
113 Niederdorf,10,,7,13,20
113 Niederdorf,11,,9,10,19
113 Niederdorf,12,,13,12,25
113 Niederdorf,13,,4,6,10
113 Niederdorf,14,,7,12,19
113 Niederdorf,15,,9,9,18
113 Niederdorf,16,,6,6,12
113 Niederdorf,17,,6,10,16
113 Niederdorf,18,,14,8,22
113 Niederdorf,19,,9,7,16
113 Niederdorf,20,,7,9,16
113 Niederdorf,21,,7,15,22
113 Niederdorf,22,,13,11,24
113 Niederdorf,23,,7,8,15
113 Niederdorf,24,,7,9,16
113 Niederdorf,25,,4,8,12
113 Niederdorf,26,,3,7,10
113 Niederdorf,27,,9,5,14
113 Niederdorf,28,,8,5,13
113 Niederdorf,29,,7,9,16
113 Niederdorf,30,,3,19,22
113 Niederdorf,31,,12,7,19
113 Niederdorf,32,,14,6,20
113 Niederdorf,33,,11,8,19
113 Niederdorf,34,,5,6,11
113 Niederdorf,35,,8,8,16
113 Niederdorf,36,,10,10,20
113 Niederdorf,37,,12,13,25
113 Niederdorf,38,,9,8,17
113 Niederdorf,39,,12,12,24
113 Niederdorf,40,,17,9,26
113 Niederdorf,41,,6,14,20
113 Niederdorf,42,,9,12,21
113 Niederdorf,43,,22,17,39
113 Niederdorf,44,,15,13,28
113 Niederdorf,45,,15,18,33
113 Niederdorf,46,,21,10,31
113 Niederdorf,47,,10,14,24
113 Niederdorf,48,,17,15,32
113 Niederdorf,49,,13,9,22
113 Niederdorf,50,,22,8,30
113 Niederdorf,51,,13,10,23
113 Niederdorf,52,,7,10,17
113 Niederdorf,53,,11,10,21
113 Niederdorf,54,,7,5,12
113 Niederdorf,55,,9,10,19
113 Niederdorf,56,,7,11,18
113 Niederdorf,57,,10,8,18
113 Niederdorf,58,,10,6,16
113 Niederdorf,59,,7,5,12
113 Niederdorf,60,,9,5,14
113 Niederdorf,61,,2,2,4
113 Niederdorf,62,,5,5,10
113 Niederdorf,63,,10,4,14
113 Niederdorf,64,,5,9,14
113 Niederdorf,65,,5,6,11
113 Niederdorf,66,,7,7,14
113 Niederdorf,67,,2,6,8
113 Niederdorf,68,,4,7,11
113 Niederdorf,69,,5,9,14
113 Niederdorf,70,,5,8,13
113 Niederdorf,71,,3,4,7
113 Niederdorf,72,,5,7,12
113 Niederdorf,73,,3,3,6
113 Niederdorf,74,,9,5,14
113 Niederdorf,75,,6,7,13
113 Niederdorf,76,,4,8,12
113 Niederdorf,77,,6,7,13
113 Niederdorf,78,,1,12,13
113 Niederdorf,79,,5,6,11
113 Niederdorf,80,,8,5,13
113 Niederdorf,81,,5,5,10
113 Niederdorf,82,,6,8,14
113 Niederdorf,83,,3,7,10
113 Niederdorf,84,,3,4,7
113 Niederdorf,85,,2,9,11
113 Niederdorf,86,,-,3,3
113 Niederdorf,87,,1,5,6
113 Niederdorf,88,,2,5,7
113 Niederdorf,89,,2,-,2
113 Niederdorf,90,,1,4,5
113 Niederdorf,91,,3,2,5
113 Niederdorf,92,,-,2,2
113 Niederdorf,96,,-,1,1
113 Niederdorf,Insgesamt,,731,774,1.505
114 Villanders,0,,9,13,22
114 Villanders,1,,6,5,11
114 Villanders,2,,16,8,24
114 Villanders,3,,10,7,17
114 Villanders,4,,8,9,17
114 Villanders,5,,14,14,28
114 Villanders,6,,12,15,27
114 Villanders,7,,16,7,23
114 Villanders,8,,13,16,29
114 Villanders,9,,6,12,18
114 Villanders,10,,7,10,17
114 Villanders,11,,13,11,24
114 Villanders,12,,10,18,28
114 Villanders,13,,13,11,24
114 Villanders,14,,12,8,20
114 Villanders,15,,10,11,21
114 Villanders,16,,14,7,21
114 Villanders,17,,17,6,23
114 Villanders,18,,11,13,24
114 Villanders,19,,7,18,25
114 Villanders,20,,14,8,22
114 Villanders,21,,16,14,30
114 Villanders,22,,16,15,31
114 Villanders,23,,12,13,25
114 Villanders,24,,11,12,23
114 Villanders,25,,7,8,15
114 Villanders,26,,11,9,20
114 Villanders,27,,8,12,20
114 Villanders,28,,13,13,26
114 Villanders,29,,13,3,16
114 Villanders,30,,14,11,25
114 Villanders,31,,18,13,31
114 Villanders,32,,10,15,25
114 Villanders,33,,17,7,24
114 Villanders,34,,11,11,22
114 Villanders,35,,17,11,28
114 Villanders,36,,15,8,23
114 Villanders,37,,14,11,25
114 Villanders,38,,14,15,29
114 Villanders,39,,11,16,27
114 Villanders,40,,19,19,38
114 Villanders,41,,18,18,36
114 Villanders,42,,15,11,26
114 Villanders,43,,25,17,42
114 Villanders,44,,23,13,36
114 Villanders,45,,20,13,33
114 Villanders,46,,20,18,38
114 Villanders,47,,22,18,40
114 Villanders,48,,19,16,35
114 Villanders,49,,15,11,26
114 Villanders,50,,18,11,29
114 Villanders,51,,15,11,26
114 Villanders,52,,18,6,24
114 Villanders,53,,15,10,25
114 Villanders,54,,16,7,23
114 Villanders,55,,10,8,18
114 Villanders,56,,11,8,19
114 Villanders,57,,11,17,28
114 Villanders,58,,7,6,13
114 Villanders,59,,11,10,21
114 Villanders,60,,11,7,18
114 Villanders,61,,10,7,17
114 Villanders,62,,11,8,19
114 Villanders,63,,10,5,15
114 Villanders,64,,6,11,17
114 Villanders,65,,5,8,13
114 Villanders,66,,8,10,18
114 Villanders,67,,6,2,8
114 Villanders,68,,3,9,12
114 Villanders,69,,6,7,13
114 Villanders,70,,9,8,17
114 Villanders,71,,6,9,15
114 Villanders,72,,9,11,20
114 Villanders,73,,7,4,11
114 Villanders,74,,6,6,12
114 Villanders,75,,4,9,13
114 Villanders,76,,7,7,14
114 Villanders,77,,2,7,9
114 Villanders,78,,1,9,10
114 Villanders,79,,7,9,16
114 Villanders,80,,8,9,17
114 Villanders,81,,4,9,13
114 Villanders,82,,4,5,9
114 Villanders,83,,3,8,11
114 Villanders,84,,2,6,8
114 Villanders,85,,3,3,6
114 Villanders,86,,1,3,4
114 Villanders,87,,1,5,6
114 Villanders,88,,3,1,4
114 Villanders,89,,2,1,3
114 Villanders,90,,1,2,3
114 Villanders,91,,-,5,5
114 Villanders,92,,-,3,3
114 Villanders,93,,-,1,1
114 Villanders,99,,-,1,1
114 Villanders,100,,-,1,1
114 Villanders,Insgesamt,,980,908,1.888
115 Sterzing,0,,41,40,81
115 Sterzing,1,,36,25,61
115 Sterzing,2,,32,33,65
115 Sterzing,3,,34,36,70
115 Sterzing,4,,36,39,75
115 Sterzing,5,,35,30,65
115 Sterzing,6,,36,33,69
115 Sterzing,7,,31,29,60
115 Sterzing,8,,27,33,60
115 Sterzing,9,,33,36,69
115 Sterzing,10,,34,30,64
115 Sterzing,11,,34,33,67
115 Sterzing,12,,29,37,66
115 Sterzing,13,,28,27,55
115 Sterzing,14,,25,27,52
115 Sterzing,15,,34,35,69
115 Sterzing,16,,29,39,68
115 Sterzing,17,,36,25,61
115 Sterzing,18,,31,23,54
115 Sterzing,19,,35,25,60
115 Sterzing,20,,31,38,69
115 Sterzing,21,,38,36,74
115 Sterzing,22,,34,36,70
115 Sterzing,23,,47,31,78
115 Sterzing,24,,45,29,74
115 Sterzing,25,,53,39,92
115 Sterzing,26,,59,41,100
115 Sterzing,27,,40,41,81
115 Sterzing,28,,55,46,101
115 Sterzing,29,,60,43,103
115 Sterzing,30,,80,45,125
115 Sterzing,31,,84,46,130
115 Sterzing,32,,54,58,112
115 Sterzing,33,,52,49,101
115 Sterzing,34,,65,41,106
115 Sterzing,35,,45,34,79
115 Sterzing,36,,44,41,85
115 Sterzing,37,,49,42,91
115 Sterzing,38,,47,46,93
115 Sterzing,39,,55,64,119
115 Sterzing,40,,59,49,108
115 Sterzing,41,,42,48,90
115 Sterzing,42,,57,62,119
115 Sterzing,43,,48,38,86
115 Sterzing,44,,56,60,116
115 Sterzing,45,,67,50,117
115 Sterzing,46,,61,53,114
115 Sterzing,47,,58,46,104
115 Sterzing,48,,48,42,90
115 Sterzing,49,,51,51,102
115 Sterzing,50,,43,49,92
115 Sterzing,51,,40,38,78
115 Sterzing,52,,40,47,87
115 Sterzing,53,,53,44,97
115 Sterzing,54,,38,43,81
115 Sterzing,55,,33,46,79
115 Sterzing,56,,39,26,65
115 Sterzing,57,,33,46,79
115 Sterzing,58,,37,37,74
115 Sterzing,59,,31,43,74
115 Sterzing,60,,42,39,81
115 Sterzing,61,,37,41,78
115 Sterzing,62,,39,35,74
115 Sterzing,63,,36,46,82
115 Sterzing,64,,37,47,84
115 Sterzing,65,,27,26,53
115 Sterzing,66,,44,43,87
115 Sterzing,67,,36,37,73
115 Sterzing,68,,31,27,58
115 Sterzing,69,,38,47,85
115 Sterzing,70,,29,38,67
115 Sterzing,71,,29,30,59
115 Sterzing,72,,36,30,66
115 Sterzing,73,,23,30,53
115 Sterzing,74,,30,28,58
115 Sterzing,75,,19,34,53
115 Sterzing,76,,19,41,60
115 Sterzing,77,,19,23,42
115 Sterzing,78,,11,20,31
115 Sterzing,79,,23,26,49
115 Sterzing,80,,14,13,27
115 Sterzing,81,,18,27,45
115 Sterzing,82,,6,17,23
115 Sterzing,83,,10,16,26
115 Sterzing,84,,14,21,35
115 Sterzing,85,,12,15,27
115 Sterzing,86,,8,16,24
115 Sterzing,87,,3,13,16
115 Sterzing,88,,3,10,13
115 Sterzing,89,,6,12,18
115 Sterzing,90,,4,13,17
115 Sterzing,91,,2,6,8
115 Sterzing,92,,1,3,4
115 Sterzing,93,,1,2,3
115 Sterzing,94,,1,1,2
115 Sterzing,96,,-,1,1
115 Sterzing,97,,-,1,1
115 Sterzing,98,,-,1,1
115 Sterzing,Insgesamt,,3.335,3.275,6.610
116 Feldthurns,0,,21,15,36
116 Feldthurns,1,,15,13,28
116 Feldthurns,2,,24,21,45
116 Feldthurns,3,,14,14,28
116 Feldthurns,4,,17,21,38
116 Feldthurns,5,,25,16,41
116 Feldthurns,6,,27,23,50
116 Feldthurns,7,,26,14,40
116 Feldthurns,8,,20,15,35
116 Feldthurns,9,,11,14,25
116 Feldthurns,10,,23,21,44
116 Feldthurns,11,,16,20,36
116 Feldthurns,12,,25,14,39
116 Feldthurns,13,,18,22,40
116 Feldthurns,14,,22,19,41
116 Feldthurns,15,,22,16,38
116 Feldthurns,16,,16,20,36
116 Feldthurns,17,,17,20,37
116 Feldthurns,18,,15,18,33
116 Feldthurns,19,,29,18,47
116 Feldthurns,20,,21,19,40
116 Feldthurns,21,,13,14,27
116 Feldthurns,22,,13,13,26
116 Feldthurns,23,,20,13,33
116 Feldthurns,24,,14,19,33
116 Feldthurns,25,,21,10,31
116 Feldthurns,26,,16,20,36
116 Feldthurns,27,,14,19,33
116 Feldthurns,28,,20,20,40
116 Feldthurns,29,,19,23,42
116 Feldthurns,30,,15,17,32
116 Feldthurns,31,,21,18,39
116 Feldthurns,32,,12,23,35
116 Feldthurns,33,,12,18,30
116 Feldthurns,34,,32,22,54
116 Feldthurns,35,,23,16,39
116 Feldthurns,36,,23,28,51
116 Feldthurns,37,,24,16,40
116 Feldthurns,38,,27,25,52
116 Feldthurns,39,,21,17,38
116 Feldthurns,40,,31,26,57
116 Feldthurns,41,,20,22,42
116 Feldthurns,42,,21,20,41
116 Feldthurns,43,,28,25,53
116 Feldthurns,44,,20,26,46
116 Feldthurns,45,,23,22,45
116 Feldthurns,46,,19,23,42
116 Feldthurns,47,,25,26,51
116 Feldthurns,48,,22,19,41
116 Feldthurns,49,,29,19,48
116 Feldthurns,50,,14,18,32
116 Feldthurns,51,,17,17,34
116 Feldthurns,52,,14,14,28
116 Feldthurns,53,,16,16,32
116 Feldthurns,54,,13,19,32
116 Feldthurns,55,,15,13,28
116 Feldthurns,56,,12,20,32
116 Feldthurns,57,,13,14,27
116 Feldthurns,58,,15,14,29
116 Feldthurns,59,,16,12,28
116 Feldthurns,60,,22,14,36
116 Feldthurns,61,,12,12,24
116 Feldthurns,62,,14,14,28
116 Feldthurns,63,,7,15,22
116 Feldthurns,64,,12,11,23
116 Feldthurns,65,,14,9,23
116 Feldthurns,66,,11,10,21
116 Feldthurns,67,,12,12,24
116 Feldthurns,68,,17,10,27
116 Feldthurns,69,,10,11,21
116 Feldthurns,70,,8,7,15
116 Feldthurns,71,,4,4,8
116 Feldthurns,72,,9,6,15
116 Feldthurns,73,,8,11,19
116 Feldthurns,74,,11,8,19
116 Feldthurns,75,,4,9,13
116 Feldthurns,76,,6,8,14
116 Feldthurns,77,,8,11,19
116 Feldthurns,78,,2,4,6
116 Feldthurns,79,,6,4,10
116 Feldthurns,80,,5,8,13
116 Feldthurns,81,,4,6,10
116 Feldthurns,82,,4,14,18
116 Feldthurns,83,,2,8,10
116 Feldthurns,84,,6,4,10
116 Feldthurns,85,,1,3,4
116 Feldthurns,86,,-,6,6
116 Feldthurns,87,,4,6,10
116 Feldthurns,88,,1,8,9
116 Feldthurns,89,,4,4,8
116 Feldthurns,90,,1,4,5
116 Feldthurns,91,,1,3,4
116 Feldthurns,92,,-,5,5
116 Feldthurns,93,,2,1,3
116 Feldthurns,96,,-,1,1
116 Feldthurns,97,,-,1,1
116 Feldthurns,98,,-,1,1
116 Feldthurns,Insgesamt,,1.399,1.382,2.781
117 Wengen,0,,11,11,22
117 Wengen,1,,11,3,14
117 Wengen,2,,10,16,26
117 Wengen,3,,7,6,13
117 Wengen,4,,7,9,16
117 Wengen,5,,9,10,19
117 Wengen,6,,7,10,17
117 Wengen,7,,9,4,13
117 Wengen,8,,5,9,14
117 Wengen,9,,5,6,11
117 Wengen,10,,10,4,14
117 Wengen,11,,5,10,15
117 Wengen,12,,9,6,15
117 Wengen,13,,9,5,14
117 Wengen,14,,7,8,15
117 Wengen,15,,12,8,20
117 Wengen,16,,9,8,17
117 Wengen,17,,11,8,19
117 Wengen,18,,12,7,19
117 Wengen,19,,10,7,17
117 Wengen,20,,10,7,17
117 Wengen,21,,17,8,25
117 Wengen,22,,12,8,20
117 Wengen,23,,5,8,13
117 Wengen,24,,7,12,19
117 Wengen,25,,11,5,16
117 Wengen,26,,8,6,14
117 Wengen,27,,8,4,12
117 Wengen,28,,14,10,24
117 Wengen,29,,13,3,16
117 Wengen,30,,11,8,19
117 Wengen,31,,5,6,11
117 Wengen,32,,9,14,23
117 Wengen,33,,12,4,16
117 Wengen,34,,5,7,12
117 Wengen,35,,9,6,15
117 Wengen,36,,6,5,11
117 Wengen,37,,18,10,28
117 Wengen,38,,11,5,16
117 Wengen,39,,17,9,26
117 Wengen,40,,13,12,25
117 Wengen,41,,12,14,26
117 Wengen,42,,11,13,24
117 Wengen,43,,7,9,16
117 Wengen,44,,16,9,25
117 Wengen,45,,10,13,23
117 Wengen,46,,13,7,20
117 Wengen,47,,8,10,18
117 Wengen,48,,11,6,17
117 Wengen,49,,14,12,26
117 Wengen,50,,14,7,21
117 Wengen,51,,7,10,17
117 Wengen,52,,10,13,23
117 Wengen,53,,7,6,13
117 Wengen,54,,6,7,13
117 Wengen,55,,6,11,17
117 Wengen,56,,4,6,10
117 Wengen,57,,7,6,13
117 Wengen,58,,9,4,13
117 Wengen,59,,6,2,8
117 Wengen,60,,5,6,11
117 Wengen,61,,9,6,15
117 Wengen,62,,2,6,8
117 Wengen,63,,4,8,12
117 Wengen,64,,2,11,13
117 Wengen,65,,6,3,9
117 Wengen,66,,5,3,8
117 Wengen,67,,6,3,9
117 Wengen,68,,7,8,15
117 Wengen,69,,3,6,9
117 Wengen,70,,7,6,13
117 Wengen,71,,4,4,8
117 Wengen,72,,5,8,13
117 Wengen,73,,6,4,10
117 Wengen,74,,5,4,9
117 Wengen,75,,7,7,14
117 Wengen,76,,-,1,1
117 Wengen,77,,2,6,8
117 Wengen,78,,2,6,8
117 Wengen,79,,3,2,5
117 Wengen,80,,1,7,8
117 Wengen,81,,5,1,6
117 Wengen,82,,4,2,6
117 Wengen,83,,2,7,9
117 Wengen,84,,1,3,4
117 Wengen,85,,1,2,3
117 Wengen,86,,1,1,2
117 Wengen,87,,-,3,3
117 Wengen,88,,-,4,4
117 Wengen,89,,1,3,4
117 Wengen,90,,2,2,4
117 Wengen,91,,1,5,6
117 Wengen,92,,1,-,1
117 Wengen,Insgesamt,,684,625,1.309
118 U.L.Frau i.W.-St.Felix,0,,2,7,9
118 U.L.Frau i.W.-St.Felix,1,,1,2,3
118 U.L.Frau i.W.-St.Felix,2,,3,4,7
118 U.L.Frau i.W.-St.Felix,3,,4,3,7
118 U.L.Frau i.W.-St.Felix,4,,1,9,10
118 U.L.Frau i.W.-St.Felix,5,,3,-,3
118 U.L.Frau i.W.-St.Felix,6,,3,3,6
118 U.L.Frau i.W.-St.Felix,7,,5,7,12
118 U.L.Frau i.W.-St.Felix,8,,4,3,7
118 U.L.Frau i.W.-St.Felix,9,,8,6,14
118 U.L.Frau i.W.-St.Felix,10,,7,3,10
118 U.L.Frau i.W.-St.Felix,11,,9,5,14
118 U.L.Frau i.W.-St.Felix,12,,3,2,5
118 U.L.Frau i.W.-St.Felix,13,,5,5,10
118 U.L.Frau i.W.-St.Felix,14,,6,9,15
118 U.L.Frau i.W.-St.Felix,15,,5,4,9
118 U.L.Frau i.W.-St.Felix,16,,8,5,13
118 U.L.Frau i.W.-St.Felix,17,,3,10,13
118 U.L.Frau i.W.-St.Felix,18,,7,7,14
118 U.L.Frau i.W.-St.Felix,19,,9,5,14
118 U.L.Frau i.W.-St.Felix,20,,7,4,11
118 U.L.Frau i.W.-St.Felix,21,,11,8,19
118 U.L.Frau i.W.-St.Felix,22,,6,3,9
118 U.L.Frau i.W.-St.Felix,23,,8,6,14
118 U.L.Frau i.W.-St.Felix,24,,8,5,13
118 U.L.Frau i.W.-St.Felix,25,,4,8,12
118 U.L.Frau i.W.-St.Felix,26,,7,1,8
118 U.L.Frau i.W.-St.Felix,27,,6,2,8
118 U.L.Frau i.W.-St.Felix,28,,6,2,8
118 U.L.Frau i.W.-St.Felix,29,,1,8,9
118 U.L.Frau i.W.-St.Felix,30,,4,6,10
118 U.L.Frau i.W.-St.Felix,31,,7,1,8
118 U.L.Frau i.W.-St.Felix,32,,2,5,7
118 U.L.Frau i.W.-St.Felix,33,,1,2,3
118 U.L.Frau i.W.-St.Felix,34,,-,3,3
118 U.L.Frau i.W.-St.Felix,35,,5,3,8
118 U.L.Frau i.W.-St.Felix,36,,4,8,12
118 U.L.Frau i.W.-St.Felix,37,,8,1,9
118 U.L.Frau i.W.-St.Felix,38,,5,5,10
118 U.L.Frau i.W.-St.Felix,39,,2,3,5
118 U.L.Frau i.W.-St.Felix,40,,8,5,13
118 U.L.Frau i.W.-St.Felix,41,,4,4,8
118 U.L.Frau i.W.-St.Felix,42,,5,9,14
118 U.L.Frau i.W.-St.Felix,43,,7,4,11
118 U.L.Frau i.W.-St.Felix,44,,3,9,12
118 U.L.Frau i.W.-St.Felix,45,,3,4,7
118 U.L.Frau i.W.-St.Felix,46,,9,7,16
118 U.L.Frau i.W.-St.Felix,47,,9,6,15
118 U.L.Frau i.W.-St.Felix,48,,4,8,12
118 U.L.Frau i.W.-St.Felix,49,,17,8,25
118 U.L.Frau i.W.-St.Felix,50,,8,9,17
118 U.L.Frau i.W.-St.Felix,51,,4,4,8
118 U.L.Frau i.W.-St.Felix,52,,8,9,17
118 U.L.Frau i.W.-St.Felix,53,,5,4,9
118 U.L.Frau i.W.-St.Felix,54,,4,3,7
118 U.L.Frau i.W.-St.Felix,55,,3,6,9
118 U.L.Frau i.W.-St.Felix,56,,6,6,12
118 U.L.Frau i.W.-St.Felix,57,,3,4,7
118 U.L.Frau i.W.-St.Felix,58,,6,3,9
118 U.L.Frau i.W.-St.Felix,59,,2,3,5
118 U.L.Frau i.W.-St.Felix,60,,6,3,9
118 U.L.Frau i.W.-St.Felix,61,,6,3,9
118 U.L.Frau i.W.-St.Felix,62,,3,4,7
118 U.L.Frau i.W.-St.Felix,63,,4,-,4
118 U.L.Frau i.W.-St.Felix,64,,4,-,4
118 U.L.Frau i.W.-St.Felix,65,,1,7,8
118 U.L.Frau i.W.-St.Felix,66,,1,3,4
118 U.L.Frau i.W.-St.Felix,67,,3,1,4
118 U.L.Frau i.W.-St.Felix,68,,5,1,6
118 U.L.Frau i.W.-St.Felix,69,,5,4,9
118 U.L.Frau i.W.-St.Felix,70,,2,3,5
118 U.L.Frau i.W.-St.Felix,71,,4,8,12
118 U.L.Frau i.W.-St.Felix,72,,2,-,2
118 U.L.Frau i.W.-St.Felix,73,,1,3,4
118 U.L.Frau i.W.-St.Felix,74,,2,4,6
118 U.L.Frau i.W.-St.Felix,75,,3,-,3
118 U.L.Frau i.W.-St.Felix,76,,4,2,6
118 U.L.Frau i.W.-St.Felix,77,,3,4,7
118 U.L.Frau i.W.-St.Felix,78,,3,2,5
118 U.L.Frau i.W.-St.Felix,79,,4,3,7
118 U.L.Frau i.W.-St.Felix,80,,4,1,5
118 U.L.Frau i.W.-St.Felix,81,,2,-,2
118 U.L.Frau i.W.-St.Felix,82,,3,5,8
118 U.L.Frau i.W.-St.Felix,83,,1,3,4
118 U.L.Frau i.W.-St.Felix,84,,1,3,4
118 U.L.Frau i.W.-St.Felix,85,,2,4,6
118 U.L.Frau i.W.-St.Felix,86,,2,3,5
118 U.L.Frau i.W.-St.Felix,87,,-,5,5
118 U.L.Frau i.W.-St.Felix,88,,1,1,2
118 U.L.Frau i.W.-St.Felix,89,,2,4,6
118 U.L.Frau i.W.-St.Felix,95,,-,1,1
118 U.L.Frau i.W.-St.Felix,Insgesamt,,400,383,783
Insgesamt,,,253.910,260.606,514.516
