Gemeinde,Altersklassen,Geschlecht,Männer,Frauen,Insgesamt
001 Aldein,0,,14,4,18
001 Aldein,1,,2,9,11
001 Aldein,2,,10,3,13
001 Aldein,3,,11,10,21
001 Aldein,4,,8,9,17
001 Aldein,5,,7,11,18
001 Aldein,6,,8,13,21
001 Aldein,7,,8,14,22
001 Aldein,8,,9,8,17
001 Aldein,9,,18,8,26
001 Aldein,10,,16,10,26
001 Aldein,11,,13,7,20
001 Aldein,12,,16,8,24
001 Aldein,13,,13,4,17
001 Aldein,14,,17,15,32
001 Aldein,15,,12,17,29
001 Aldein,16,,17,9,26
001 Aldein,17,,8,8,16
001 Aldein,18,,8,12,20
001 Aldein,19,,15,7,22
001 Aldein,20,,13,13,26
001 Aldein,21,,9,12,21
001 Aldein,22,,7,7,14
001 Aldein,23,,7,7,14
001 Aldein,24,,10,14,24
001 Aldein,25,,10,7,17
001 Aldein,26,,12,5,17
001 Aldein,27,,9,4,13
001 Aldein,28,,13,12,25
001 Aldein,29,,10,7,17
001 Aldein,30,,9,9,18
001 Aldein,31,,11,6,17
001 Aldein,32,,11,12,23
001 Aldein,33,,8,15,23
001 Aldein,34,,10,14,24
001 Aldein,35,,11,8,19
001 Aldein,36,,7,20,27
001 Aldein,37,,7,14,21
001 Aldein,38,,17,11,28
001 Aldein,39,,15,11,26
001 Aldein,40,,13,10,23
001 Aldein,41,,16,9,25
001 Aldein,42,,15,15,30
001 Aldein,43,,13,15,28
001 Aldein,44,,17,7,24
001 Aldein,45,,12,16,28
001 Aldein,46,,6,14,20
001 Aldein,47,,7,20,27
001 Aldein,48,,16,11,27
001 Aldein,49,,15,10,25
001 Aldein,50,,13,6,19
001 Aldein,51,,8,17,25
001 Aldein,52,,17,13,30
001 Aldein,53,,14,9,23
001 Aldein,54,,10,12,22
001 Aldein,55,,8,5,13
001 Aldein,56,,10,10,20
001 Aldein,57,,9,8,17
001 Aldein,58,,9,9,18
001 Aldein,59,,9,7,16
001 Aldein,60,,9,9,18
001 Aldein,61,,7,4,11
001 Aldein,62,,14,10,24
001 Aldein,63,,5,13,18
001 Aldein,64,,9,6,15
001 Aldein,65,,9,10,19
001 Aldein,66,,5,11,16
001 Aldein,67,,6,10,16
001 Aldein,68,,8,5,13
001 Aldein,69,,5,7,12
001 Aldein,70,,10,9,19
001 Aldein,71,,6,11,17
001 Aldein,72,,5,12,17
001 Aldein,73,,4,8,12
001 Aldein,74,,4,9,13
001 Aldein,75,,7,7,14
001 Aldein,76,,5,9,14
001 Aldein,77,,4,6,10
001 Aldein,78,,3,4,7
001 Aldein,79,,11,4,15
001 Aldein,80,,4,4,8
001 Aldein,81,,2,5,7
001 Aldein,82,,5,2,7
001 Aldein,83,,1,3,4
001 Aldein,84,,5,7,12
001 Aldein,85,,2,1,3
001 Aldein,86,,5,4,9
001 Aldein,87,,-,2,2
001 Aldein,88,,1,4,5
001 Aldein,89,,-,6,6
001 Aldein,90,,1,4,5
001 Aldein,91,,-,5,5
001 Aldein,92,,1,4,5
001 Aldein,93,,1,-,1
001 Aldein,94,,-,2,2
002 Andrian,0,,5,2,7
002 Andrian,1,,9,5,14
002 Andrian,2,,9,5,14
002 Andrian,3,,7,5,12
002 Andrian,4,,7,11,18
002 Andrian,5,,6,6,12
002 Andrian,6,,4,6,10
002 Andrian,7,,8,3,11
002 Andrian,8,,6,6,12
002 Andrian,9,,9,4,13
002 Andrian,10,,6,11,17
002 Andrian,11,,3,4,7
002 Andrian,12,,3,3,6
002 Andrian,13,,6,5,11
002 Andrian,14,,3,5,8
002 Andrian,15,,8,2,10
002 Andrian,16,,9,9,18
002 Andrian,17,,3,10,13
002 Andrian,18,,8,4,12
002 Andrian,19,,6,6,12
002 Andrian,20,,4,4,8
002 Andrian,21,,7,6,13
002 Andrian,22,,6,10,16
002 Andrian,23,,5,6,11
002 Andrian,24,,6,5,11
002 Andrian,25,,12,6,18
002 Andrian,26,,7,5,12
002 Andrian,27,,8,6,14
002 Andrian,28,,3,9,12
002 Andrian,29,,8,7,15
002 Andrian,30,,7,4,11
002 Andrian,31,,10,6,16
002 Andrian,32,,7,6,13
002 Andrian,33,,6,4,10
002 Andrian,34,,8,7,15
002 Andrian,35,,7,7,14
002 Andrian,36,,7,8,15
002 Andrian,37,,9,12,21
002 Andrian,38,,12,5,17
002 Andrian,39,,5,9,14
002 Andrian,40,,12,11,23
002 Andrian,41,,7,11,18
002 Andrian,42,,11,10,21
002 Andrian,43,,11,5,16
002 Andrian,44,,5,7,12
002 Andrian,45,,10,9,19
002 Andrian,46,,10,10,20
002 Andrian,47,,10,9,19
002 Andrian,48,,13,10,23
002 Andrian,49,,9,7,16
002 Andrian,50,,7,14,21
002 Andrian,51,,11,8,19
002 Andrian,52,,8,3,11
002 Andrian,53,,7,6,13
002 Andrian,54,,8,4,12
002 Andrian,55,,7,7,14
002 Andrian,56,,7,7,14
002 Andrian,57,,4,10,14
002 Andrian,58,,3,4,7
002 Andrian,59,,6,3,9
002 Andrian,60,,7,7,14
002 Andrian,61,,1,3,4
002 Andrian,62,,3,2,5
002 Andrian,63,,6,6,12
002 Andrian,64,,3,2,5
002 Andrian,65,,3,5,8
002 Andrian,66,,6,4,10
002 Andrian,67,,6,8,14
002 Andrian,68,,2,2,4
002 Andrian,69,,1,4,5
002 Andrian,70,,6,7,13
002 Andrian,71,,3,4,7
002 Andrian,72,,5,4,9
002 Andrian,73,,2,7,9
002 Andrian,74,,1,7,8
002 Andrian,75,,4,3,7
002 Andrian,76,,4,4,8
002 Andrian,77,,2,3,5
002 Andrian,78,,4,2,6
002 Andrian,79,,5,1,6
002 Andrian,80,,2,4,6
002 Andrian,81,,7,2,9
002 Andrian,82,,-,4,4
002 Andrian,83,,2,1,3
002 Andrian,84,,2,1,3
002 Andrian,85,,1,3,4
002 Andrian,86,,-,2,2
002 Andrian,87,,3,4,7
002 Andrian,88,,2,2,4
002 Andrian,89,,1,1,2
002 Andrian,91,,-,1,1
002 Andrian,92,,-,2,2
002 Andrian,93,,1,-,1
002 Andrian,94,,1,-,1
002 Andrian,98,,-,1,1
002 Andrian,99,,-,1,1
003 Altrei,0,,2,1,3
003 Altrei,1,,1,3,4
003 Altrei,2,,-,1,1
003 Altrei,4,,2,2,4
003 Altrei,5,,2,4,6
003 Altrei,6,,6,4,10
003 Altrei,7,,2,-,2
003 Altrei,8,,4,1,5
003 Altrei,9,,2,1,3
003 Altrei,10,,-,1,1
003 Altrei,11,,2,1,3
003 Altrei,12,,4,1,5
003 Altrei,13,,1,1,2
003 Altrei,14,,3,-,3
003 Altrei,15,,3,1,4
003 Altrei,16,,-,1,1
003 Altrei,17,,-,2,2
003 Altrei,18,,1,2,3
003 Altrei,19,,3,2,5
003 Altrei,20,,3,-,3
003 Altrei,21,,6,3,9
003 Altrei,22,,1,1,2
003 Altrei,23,,3,1,4
003 Altrei,24,,1,2,3
003 Altrei,25,,3,5,8
003 Altrei,26,,2,1,3
003 Altrei,27,,3,3,6
003 Altrei,28,,3,1,4
003 Altrei,29,,3,3,6
003 Altrei,30,,4,1,5
003 Altrei,31,,2,2,4
003 Altrei,32,,1,2,3
003 Altrei,33,,1,2,3
003 Altrei,34,,1,2,3
003 Altrei,35,,2,4,6
003 Altrei,36,,-,2,2
003 Altrei,37,,2,3,5
003 Altrei,38,,2,2,4
003 Altrei,39,,1,-,1
003 Altrei,40,,2,3,5
003 Altrei,41,,3,-,3
003 Altrei,42,,4,3,7
003 Altrei,43,,2,3,5
003 Altrei,44,,3,5,8
003 Altrei,45,,1,4,5
003 Altrei,46,,3,1,4
003 Altrei,47,,2,4,6
003 Altrei,48,,3,4,7
003 Altrei,49,,3,6,9
003 Altrei,50,,2,2,4
003 Altrei,51,,10,2,12
003 Altrei,52,,2,3,5
003 Altrei,53,,4,2,6
003 Altrei,54,,5,4,9
003 Altrei,55,,2,4,6
003 Altrei,56,,1,2,3
003 Altrei,57,,5,1,6
003 Altrei,58,,3,3,6
003 Altrei,59,,2,1,3
003 Altrei,60,,2,2,4
003 Altrei,61,,6,3,9
003 Altrei,62,,4,3,7
003 Altrei,63,,-,3,3
003 Altrei,64,,1,-,1
003 Altrei,65,,2,2,4
003 Altrei,66,,3,2,5
003 Altrei,67,,2,3,5
003 Altrei,68,,3,1,4
003 Altrei,69,,2,3,5
003 Altrei,70,,1,3,4
003 Altrei,71,,3,1,4
003 Altrei,72,,1,3,4
003 Altrei,73,,3,3,6
003 Altrei,74,,2,3,5
003 Altrei,75,,1,1,2
003 Altrei,76,,3,1,4
003 Altrei,77,,3,1,4
003 Altrei,78,,2,1,3
003 Altrei,79,,-,2,2
003 Altrei,80,,2,2,4
003 Altrei,81,,-,2,2
003 Altrei,82,,-,2,2
003 Altrei,83,,1,1,2
003 Altrei,84,,2,2,4
003 Altrei,85,,-,2,2
003 Altrei,86,,2,3,5
003 Altrei,87,,-,2,2
003 Altrei,89,,-,2,2
003 Altrei,90,,-,1,1
003 Altrei,91,,-,1,1
004 Eppan a.d. Weinstr.,0,,76,73,149
004 Eppan a.d. Weinstr.,1,,94,79,173
004 Eppan a.d. Weinstr.,2,,80,76,156
004 Eppan a.d. Weinstr.,3,,80,73,153
004 Eppan a.d. Weinstr.,4,,73,64,137
004 Eppan a.d. Weinstr.,5,,82,96,178
004 Eppan a.d. Weinstr.,6,,77,68,145
004 Eppan a.d. Weinstr.,7,,104,77,181
004 Eppan a.d. Weinstr.,8,,84,109,193
004 Eppan a.d. Weinstr.,9,,90,68,158
004 Eppan a.d. Weinstr.,10,,86,67,153
004 Eppan a.d. Weinstr.,11,,80,77,157
004 Eppan a.d. Weinstr.,12,,82,73,155
004 Eppan a.d. Weinstr.,13,,74,81,155
004 Eppan a.d. Weinstr.,14,,89,59,148
004 Eppan a.d. Weinstr.,15,,82,84,166
004 Eppan a.d. Weinstr.,16,,73,70,143
004 Eppan a.d. Weinstr.,17,,77,73,150
004 Eppan a.d. Weinstr.,18,,73,67,140
004 Eppan a.d. Weinstr.,19,,82,78,160
004 Eppan a.d. Weinstr.,20,,87,94,181
004 Eppan a.d. Weinstr.,21,,75,71,146
004 Eppan a.d. Weinstr.,22,,84,76,160
004 Eppan a.d. Weinstr.,23,,88,73,161
004 Eppan a.d. Weinstr.,24,,86,69,155
004 Eppan a.d. Weinstr.,25,,90,85,175
004 Eppan a.d. Weinstr.,26,,77,77,154
004 Eppan a.d. Weinstr.,27,,99,100,199
004 Eppan a.d. Weinstr.,28,,86,63,149
004 Eppan a.d. Weinstr.,29,,88,90,178
004 Eppan a.d. Weinstr.,30,,89,90,179
004 Eppan a.d. Weinstr.,31,,82,93,175
004 Eppan a.d. Weinstr.,32,,77,90,167
004 Eppan a.d. Weinstr.,33,,87,100,187
004 Eppan a.d. Weinstr.,34,,93,95,188
004 Eppan a.d. Weinstr.,35,,113,95,208
004 Eppan a.d. Weinstr.,36,,95,97,192
004 Eppan a.d. Weinstr.,37,,94,91,185
004 Eppan a.d. Weinstr.,38,,107,110,217
004 Eppan a.d. Weinstr.,39,,98,109,207
004 Eppan a.d. Weinstr.,40,,115,112,227
004 Eppan a.d. Weinstr.,41,,115,134,249
004 Eppan a.d. Weinstr.,42,,122,108,230
004 Eppan a.d. Weinstr.,43,,133,121,254
004 Eppan a.d. Weinstr.,44,,144,128,272
004 Eppan a.d. Weinstr.,45,,123,126,249
004 Eppan a.d. Weinstr.,46,,118,132,250
004 Eppan a.d. Weinstr.,47,,128,142,270
004 Eppan a.d. Weinstr.,48,,113,120,233
004 Eppan a.d. Weinstr.,49,,131,114,245
004 Eppan a.d. Weinstr.,50,,110,117,227
004 Eppan a.d. Weinstr.,51,,131,118,249
004 Eppan a.d. Weinstr.,52,,128,107,235
004 Eppan a.d. Weinstr.,53,,109,124,233
004 Eppan a.d. Weinstr.,54,,111,104,215
004 Eppan a.d. Weinstr.,55,,99,107,206
004 Eppan a.d. Weinstr.,56,,93,96,189
004 Eppan a.d. Weinstr.,57,,91,84,175
004 Eppan a.d. Weinstr.,58,,83,89,172
004 Eppan a.d. Weinstr.,59,,74,95,169
004 Eppan a.d. Weinstr.,60,,91,86,177
004 Eppan a.d. Weinstr.,61,,68,83,151
004 Eppan a.d. Weinstr.,62,,85,67,152
004 Eppan a.d. Weinstr.,63,,64,78,142
004 Eppan a.d. Weinstr.,64,,66,57,123
004 Eppan a.d. Weinstr.,65,,74,72,146
004 Eppan a.d. Weinstr.,66,,59,78,137
004 Eppan a.d. Weinstr.,67,,78,71,149
004 Eppan a.d. Weinstr.,68,,54,57,111
004 Eppan a.d. Weinstr.,69,,67,76,143
004 Eppan a.d. Weinstr.,70,,89,82,171
004 Eppan a.d. Weinstr.,71,,85,74,159
004 Eppan a.d. Weinstr.,72,,58,102,160
004 Eppan a.d. Weinstr.,73,,66,51,117
004 Eppan a.d. Weinstr.,74,,60,78,138
004 Eppan a.d. Weinstr.,75,,47,49,96
004 Eppan a.d. Weinstr.,76,,40,54,94
004 Eppan a.d. Weinstr.,77,,44,41,85
004 Eppan a.d. Weinstr.,78,,28,40,68
004 Eppan a.d. Weinstr.,79,,27,43,70
004 Eppan a.d. Weinstr.,80,,43,49,92
004 Eppan a.d. Weinstr.,81,,36,45,81
004 Eppan a.d. Weinstr.,82,,22,45,67
004 Eppan a.d. Weinstr.,83,,28,51,79
004 Eppan a.d. Weinstr.,84,,25,41,66
004 Eppan a.d. Weinstr.,85,,27,32,59
004 Eppan a.d. Weinstr.,86,,17,39,56
004 Eppan a.d. Weinstr.,87,,16,40,56
004 Eppan a.d. Weinstr.,88,,13,31,44
004 Eppan a.d. Weinstr.,89,,6,33,39
004 Eppan a.d. Weinstr.,90,,5,26,31
004 Eppan a.d. Weinstr.,91,,6,24,30
004 Eppan a.d. Weinstr.,92,,8,17,25
004 Eppan a.d. Weinstr.,93,,6,11,17
004 Eppan a.d. Weinstr.,94,,2,5,7
004 Eppan a.d. Weinstr.,95,,1,5,6
004 Eppan a.d. Weinstr.,96,,-,1,1
004 Eppan a.d. Weinstr.,98,,1,-,1
004 Eppan a.d. Weinstr.,99,,-,2,2
004 Eppan a.d. Weinstr.,100,,2,2,4
004 Eppan a.d. Weinstr.,101,,-,2,2
004 Eppan a.d. Weinstr.,102,,-,2,2
004 Eppan a.d. Weinstr.,104,,-,1,1
005 Hafling,0,,4,7,11
005 Hafling,1,,5,3,8
005 Hafling,2,,1,3,4
005 Hafling,3,,2,4,6
005 Hafling,4,,3,7,10
005 Hafling,5,,5,5,10
005 Hafling,6,,3,2,5
005 Hafling,7,,6,6,12
005 Hafling,8,,3,2,5
005 Hafling,9,,1,7,8
005 Hafling,10,,-,4,4
005 Hafling,11,,6,1,7
005 Hafling,12,,4,3,7
005 Hafling,13,,4,7,11
005 Hafling,14,,5,3,8
005 Hafling,15,,2,7,9
005 Hafling,16,,2,9,11
005 Hafling,17,,12,4,16
005 Hafling,18,,6,4,10
005 Hafling,19,,4,5,9
005 Hafling,20,,3,8,11
005 Hafling,21,,5,4,9
005 Hafling,22,,7,2,9
005 Hafling,23,,4,8,12
005 Hafling,24,,4,2,6
005 Hafling,25,,2,6,8
005 Hafling,26,,5,4,9
005 Hafling,27,,3,2,5
005 Hafling,28,,4,3,7
005 Hafling,29,,3,10,13
005 Hafling,30,,3,-,3
005 Hafling,31,,5,2,7
005 Hafling,32,,5,9,14
005 Hafling,33,,4,10,14
005 Hafling,34,,6,5,11
005 Hafling,35,,5,5,10
005 Hafling,36,,5,6,11
005 Hafling,37,,6,6,12
005 Hafling,38,,8,4,12
005 Hafling,39,,7,6,13
005 Hafling,40,,11,2,13
005 Hafling,41,,9,1,10
005 Hafling,42,,11,6,17
005 Hafling,43,,9,11,20
005 Hafling,44,,7,12,19
005 Hafling,45,,3,11,14
005 Hafling,46,,3,1,4
005 Hafling,47,,11,6,17
005 Hafling,48,,7,12,19
005 Hafling,49,,4,2,6
005 Hafling,50,,7,3,10
005 Hafling,51,,4,4,8
005 Hafling,52,,8,5,13
005 Hafling,53,,10,7,17
005 Hafling,54,,6,5,11
005 Hafling,55,,3,5,8
005 Hafling,56,,3,4,7
005 Hafling,57,,3,8,11
005 Hafling,58,,6,2,8
005 Hafling,59,,3,1,4
005 Hafling,60,,2,3,5
005 Hafling,61,,7,2,9
005 Hafling,62,,2,3,5
005 Hafling,63,,5,4,9
005 Hafling,64,,4,4,8
005 Hafling,65,,6,2,8
005 Hafling,66,,2,4,6
005 Hafling,67,,1,3,4
005 Hafling,68,,3,2,5
005 Hafling,69,,3,2,5
005 Hafling,70,,4,4,8
005 Hafling,71,,5,3,8
005 Hafling,72,,3,4,7
005 Hafling,73,,2,1,3
005 Hafling,74,,4,5,9
005 Hafling,75,,2,2,4
005 Hafling,76,,2,1,3
005 Hafling,77,,1,1,2
005 Hafling,78,,2,2,4
005 Hafling,79,,-,2,2
005 Hafling,80,,4,3,7
005 Hafling,81,,3,2,5
005 Hafling,82,,2,4,6
005 Hafling,83,,1,4,5
005 Hafling,84,,2,1,3
005 Hafling,85,,-,1,1
005 Hafling,86,,3,2,5
005 Hafling,87,,-,2,2
005 Hafling,89,,1,-,1
005 Hafling,91,,-,1,1
005 Hafling,92,,-,1,1
005 Hafling,93,,2,1,3
005 Hafling,94,,-,1,1
005 Hafling,96,,-,1,1
006 Abtei,0,,14,20,34
006 Abtei,1,,25,14,39
006 Abtei,2,,20,12,32
006 Abtei,3,,25,15,40
006 Abtei,4,,22,19,41
006 Abtei,5,,25,19,44
006 Abtei,6,,28,21,49
006 Abtei,7,,29,22,51
006 Abtei,8,,22,28,50
006 Abtei,9,,29,12,41
006 Abtei,10,,21,19,40
006 Abtei,11,,12,31,43
006 Abtei,12,,24,23,47
006 Abtei,13,,23,31,54
006 Abtei,14,,21,26,47
006 Abtei,15,,13,15,28
006 Abtei,16,,26,22,48
006 Abtei,17,,25,14,39
006 Abtei,18,,24,28,52
006 Abtei,19,,19,15,34
006 Abtei,20,,17,20,37
006 Abtei,21,,24,16,40
006 Abtei,22,,24,14,38
006 Abtei,23,,24,16,40
006 Abtei,24,,13,15,28
006 Abtei,25,,18,11,29
006 Abtei,26,,20,14,34
006 Abtei,27,,19,21,40
006 Abtei,28,,14,13,27
006 Abtei,29,,12,18,30
006 Abtei,30,,14,15,29
006 Abtei,31,,25,15,40
006 Abtei,32,,21,17,38
006 Abtei,33,,25,17,42
006 Abtei,34,,17,24,41
006 Abtei,35,,22,36,58
006 Abtei,36,,26,34,60
006 Abtei,37,,26,24,50
006 Abtei,38,,14,32,46
006 Abtei,39,,20,29,49
006 Abtei,40,,28,22,50
006 Abtei,41,,45,33,78
006 Abtei,42,,17,30,47
006 Abtei,43,,29,36,65
006 Abtei,44,,30,33,63
006 Abtei,45,,30,34,64
006 Abtei,46,,36,35,71
006 Abtei,47,,24,29,53
006 Abtei,48,,35,24,59
006 Abtei,49,,26,34,60
006 Abtei,50,,29,29,58
006 Abtei,51,,26,29,55
006 Abtei,52,,26,26,52
006 Abtei,53,,26,24,50
006 Abtei,54,,28,23,51
006 Abtei,55,,19,21,40
006 Abtei,56,,19,15,34
006 Abtei,57,,20,18,38
006 Abtei,58,,17,15,32
006 Abtei,59,,11,15,26
006 Abtei,60,,14,19,33
006 Abtei,61,,10,15,25
006 Abtei,62,,11,12,23
006 Abtei,63,,13,20,33
006 Abtei,64,,10,18,28
006 Abtei,65,,22,18,40
006 Abtei,66,,15,15,30
006 Abtei,67,,23,18,41
006 Abtei,68,,16,20,36
006 Abtei,69,,11,15,26
006 Abtei,70,,11,12,23
006 Abtei,71,,20,12,32
006 Abtei,72,,14,22,36
006 Abtei,73,,14,16,30
006 Abtei,74,,13,13,26
006 Abtei,75,,14,16,30
006 Abtei,76,,6,16,22
006 Abtei,77,,14,9,23
006 Abtei,78,,9,16,25
006 Abtei,79,,10,13,23
006 Abtei,80,,5,15,20
006 Abtei,81,,4,3,7
006 Abtei,82,,8,9,17
006 Abtei,83,,11,10,21
006 Abtei,84,,5,5,10
006 Abtei,85,,3,10,13
006 Abtei,86,,5,7,12
006 Abtei,87,,3,3,6
006 Abtei,88,,3,3,6
006 Abtei,89,,4,7,11
006 Abtei,90,,2,4,6
006 Abtei,91,,3,2,5
006 Abtei,92,,1,1,2
006 Abtei,93,,-,3,3
006 Abtei,94,,-,1,1
006 Abtei,95,,-,2,2
006 Abtei,97,,-,2,2
006 Abtei,99,,-,1,1
006 Abtei,101,,-,1,1
007 Barbian,0,,9,12,21
007 Barbian,1,,11,13,24
007 Barbian,2,,12,8,20
007 Barbian,3,,8,7,15
007 Barbian,4,,8,13,21
007 Barbian,5,,11,5,16
007 Barbian,6,,7,11,18
007 Barbian,7,,6,2,8
007 Barbian,8,,17,6,23
007 Barbian,9,,6,5,11
007 Barbian,10,,8,15,23
007 Barbian,11,,6,8,14
007 Barbian,12,,12,16,28
007 Barbian,13,,14,7,21
007 Barbian,14,,11,11,22
007 Barbian,15,,13,7,20
007 Barbian,16,,9,10,19
007 Barbian,17,,11,10,21
007 Barbian,18,,11,9,20
007 Barbian,19,,8,4,12
007 Barbian,20,,9,14,23
007 Barbian,21,,13,7,20
007 Barbian,22,,12,13,25
007 Barbian,23,,16,14,30
007 Barbian,24,,8,12,20
007 Barbian,25,,14,5,19
007 Barbian,26,,8,8,16
007 Barbian,27,,14,9,23
007 Barbian,28,,6,7,13
007 Barbian,29,,10,7,17
007 Barbian,30,,11,15,26
007 Barbian,31,,10,14,24
007 Barbian,32,,11,13,24
007 Barbian,33,,12,5,17
007 Barbian,34,,17,9,26
007 Barbian,35,,12,9,21
007 Barbian,36,,11,19,30
007 Barbian,37,,8,14,22
007 Barbian,38,,9,10,19
007 Barbian,39,,14,10,24
007 Barbian,40,,12,19,31
007 Barbian,41,,14,16,30
007 Barbian,42,,18,9,27
007 Barbian,43,,13,13,26
007 Barbian,44,,15,7,22
007 Barbian,45,,14,11,25
007 Barbian,46,,8,8,16
007 Barbian,47,,12,12,24
007 Barbian,48,,9,12,21
007 Barbian,49,,15,15,30
007 Barbian,50,,14,15,29
007 Barbian,51,,15,14,29
007 Barbian,52,,16,11,27
007 Barbian,53,,13,15,28
007 Barbian,54,,10,9,19
007 Barbian,55,,8,9,17
007 Barbian,56,,16,7,23
007 Barbian,57,,5,10,15
007 Barbian,58,,7,7,14
007 Barbian,59,,7,15,22
007 Barbian,60,,7,12,19
007 Barbian,61,,7,5,12
007 Barbian,62,,10,9,19
007 Barbian,63,,11,11,22
007 Barbian,64,,5,6,11
007 Barbian,65,,3,5,8
007 Barbian,66,,6,8,14
007 Barbian,67,,17,6,23
007 Barbian,68,,4,6,10
007 Barbian,69,,10,9,19
007 Barbian,70,,9,6,15
007 Barbian,71,,11,10,21
007 Barbian,72,,8,12,20
007 Barbian,73,,9,3,12
007 Barbian,74,,5,4,9
007 Barbian,75,,5,9,14
007 Barbian,76,,8,9,17
007 Barbian,77,,3,4,7
007 Barbian,78,,2,5,7
007 Barbian,79,,5,5,10
007 Barbian,80,,5,4,9
007 Barbian,81,,6,6,12
007 Barbian,82,,2,6,8
007 Barbian,83,,2,4,6
007 Barbian,84,,3,6,9
007 Barbian,85,,4,4,8
007 Barbian,86,,2,-,2
007 Barbian,87,,2,1,3
007 Barbian,88,,3,-,3
007 Barbian,89,,1,3,4
007 Barbian,90,,-,3,3
007 Barbian,91,,1,2,3
007 Barbian,92,,1,1,2
007 Barbian,95,,1,-,1
008 Bozen,0,,501,470,971
008 Bozen,1,,524,468,992
008 Bozen,2,,495,479,974
008 Bozen,3,,515,499,1.014
008 Bozen,4,,533,475,1.008
008 Bozen,5,,530,516,1.046
008 Bozen,6,,573,488,1.061
008 Bozen,7,,497,499,996
008 Bozen,8,,552,495,1.047
008 Bozen,9,,558,508,1.066
008 Bozen,10,,535,526,1.061
008 Bozen,11,,549,471,1.020
008 Bozen,12,,534,481,1.015
008 Bozen,13,,471,520,991
008 Bozen,14,,528,503,1.031
008 Bozen,15,,529,485,1.014
008 Bozen,16,,515,455,970
008 Bozen,17,,488,507,995
008 Bozen,18,,482,442,924
008 Bozen,19,,526,499,1.025
008 Bozen,20,,474,485,959
008 Bozen,21,,521,458,979
008 Bozen,22,,552,495,1.047
008 Bozen,23,,561,515,1.076
008 Bozen,24,,549,527,1.076
008 Bozen,25,,573,541,1.114
008 Bozen,26,,485,518,1.003
008 Bozen,27,,549,529,1.078
008 Bozen,28,,567,541,1.108
008 Bozen,29,,570,583,1.153
008 Bozen,30,,616,558,1.174
008 Bozen,31,,611,577,1.188
008 Bozen,32,,626,588,1.214
008 Bozen,33,,652,622,1.274
008 Bozen,34,,613,616,1.229
008 Bozen,35,,625,642,1.267
008 Bozen,36,,654,659,1.313
008 Bozen,37,,659,700,1.359
008 Bozen,38,,722,760,1.482
008 Bozen,39,,768,774,1.542
008 Bozen,40,,756,845,1.601
008 Bozen,41,,824,857,1.681
008 Bozen,42,,860,909,1.769
008 Bozen,43,,836,833,1.669
008 Bozen,44,,906,886,1.792
008 Bozen,45,,835,814,1.649
008 Bozen,46,,793,878,1.671
008 Bozen,47,,879,926,1.805
008 Bozen,48,,920,912,1.832
008 Bozen,49,,900,920,1.820
008 Bozen,50,,772,872,1.644
008 Bozen,51,,756,811,1.567
008 Bozen,52,,760,747,1.507
008 Bozen,53,,701,755,1.456
008 Bozen,54,,687,720,1.407
008 Bozen,55,,686,724,1.410
008 Bozen,56,,608,734,1.342
008 Bozen,57,,606,678,1.284
008 Bozen,58,,588,663,1.251
008 Bozen,59,,580,612,1.192
008 Bozen,60,,516,616,1.132
008 Bozen,61,,506,642,1.148
008 Bozen,62,,513,617,1.130
008 Bozen,63,,522,666,1.188
008 Bozen,64,,539,626,1.165
008 Bozen,65,,584,706,1.290
008 Bozen,66,,560,777,1.337
008 Bozen,67,,639,847,1.486
008 Bozen,68,,474,560,1.034
008 Bozen,69,,512,681,1.193
008 Bozen,70,,542,692,1.234
008 Bozen,71,,575,675,1.250
008 Bozen,72,,611,716,1.327
008 Bozen,73,,572,684,1.256
008 Bozen,74,,516,675,1.191
008 Bozen,75,,529,616,1.145
008 Bozen,76,,446,531,977
008 Bozen,77,,392,508,900
008 Bozen,78,,365,514,879
008 Bozen,79,,376,503,879
008 Bozen,80,,319,488,807
008 Bozen,81,,313,472,785
008 Bozen,82,,297,440,737
008 Bozen,83,,275,423,698
008 Bozen,84,,176,363,539
008 Bozen,85,,216,360,576
008 Bozen,86,,178,335,513
008 Bozen,87,,183,295,478
008 Bozen,88,,130,291,421
008 Bozen,89,,110,237,347
008 Bozen,90,,84,244,328
008 Bozen,91,,64,218,282
008 Bozen,92,,60,168,228
008 Bozen,93,,36,142,178
008 Bozen,94,,13,86,99
008 Bozen,95,,8,39,47
008 Bozen,96,,6,25,31
008 Bozen,97,,6,33,39
008 Bozen,98,,3,30,33
008 Bozen,99,,4,21,25
008 Bozen,100,,3,9,12
008 Bozen,101,,3,10,13
008 Bozen,102,,1,7,8
008 Bozen,103,,-,1,1
008 Bozen,107,,-,1,1
009 Prags,0,,3,-,3
009 Prags,1,,2,1,3
009 Prags,2,,5,2,7
009 Prags,3,,1,4,5
009 Prags,4,,1,2,3
009 Prags,5,,4,6,10
009 Prags,6,,4,6,10
009 Prags,7,,4,3,7
009 Prags,8,,3,1,4
009 Prags,9,,3,3,6
009 Prags,10,,2,5,7
009 Prags,11,,2,6,8
009 Prags,12,,8,5,13
009 Prags,13,,2,3,5
009 Prags,14,,5,9,14
009 Prags,15,,1,4,5
009 Prags,16,,3,5,8
009 Prags,17,,3,6,9
009 Prags,18,,3,1,4
009 Prags,19,,4,5,9
009 Prags,20,,7,2,9
009 Prags,21,,6,2,8
009 Prags,22,,8,2,10
009 Prags,23,,4,1,5
009 Prags,24,,8,2,10
009 Prags,25,,2,4,6
009 Prags,26,,3,3,6
009 Prags,27,,5,4,9
009 Prags,28,,8,3,11
009 Prags,29,,4,4,8
009 Prags,30,,3,3,6
009 Prags,31,,3,5,8
009 Prags,32,,3,6,9
009 Prags,33,,5,1,6
009 Prags,34,,2,2,4
009 Prags,35,,5,7,12
009 Prags,36,,3,3,6
009 Prags,37,,5,3,8
009 Prags,38,,2,5,7
009 Prags,39,,2,5,7
009 Prags,40,,8,2,10
009 Prags,41,,4,3,7
009 Prags,42,,5,4,9
009 Prags,43,,4,6,10
009 Prags,44,,9,5,14
009 Prags,45,,8,9,17
009 Prags,46,,7,6,13
009 Prags,47,,8,5,13
009 Prags,48,,7,7,14
009 Prags,49,,5,3,8
009 Prags,50,,6,5,11
009 Prags,51,,3,5,8
009 Prags,52,,5,12,17
009 Prags,53,,5,3,8
009 Prags,54,,11,6,17
009 Prags,55,,6,2,8
009 Prags,56,,6,4,10
009 Prags,57,,1,6,7
009 Prags,58,,4,5,9
009 Prags,59,,6,4,10
009 Prags,60,,3,1,4
009 Prags,61,,2,5,7
009 Prags,62,,3,1,4
009 Prags,63,,4,1,5
009 Prags,64,,1,1,2
009 Prags,65,,4,1,5
009 Prags,66,,1,-,1
009 Prags,67,,2,4,6
009 Prags,68,,2,2,4
009 Prags,69,,4,4,8
009 Prags,70,,1,3,4
009 Prags,71,,4,4,8
009 Prags,72,,5,2,7
009 Prags,73,,1,3,4
009 Prags,74,,3,5,8
009 Prags,75,,3,2,5
009 Prags,76,,-,2,2
009 Prags,77,,1,3,4
009 Prags,78,,1,3,4
009 Prags,79,,2,2,4
009 Prags,80,,3,1,4
009 Prags,81,,3,4,7
009 Prags,82,,-,3,3
009 Prags,84,,1,1,2
009 Prags,85,,-,2,2
009 Prags,86,,1,4,5
009 Prags,87,,1,4,5
009 Prags,88,,1,3,4
009 Prags,89,,3,1,4
009 Prags,90,,-,2,2
009 Prags,91,,2,1,3
009 Prags,92,,1,1,2
009 Prags,93,,1,-,1
009 Prags,94,,-,1,1
010 Brenner,0,,17,8,25
010 Brenner,1,,8,8,16
010 Brenner,2,,7,19,26
010 Brenner,3,,11,16,27
010 Brenner,4,,13,6,19
010 Brenner,5,,11,17,28
010 Brenner,6,,12,11,23
010 Brenner,7,,7,15,22
010 Brenner,8,,13,11,24
010 Brenner,9,,11,17,28
010 Brenner,10,,12,9,21
010 Brenner,11,,13,13,26
010 Brenner,12,,8,6,14
010 Brenner,13,,18,12,30
010 Brenner,14,,11,14,25
010 Brenner,15,,15,6,21
010 Brenner,16,,16,7,23
010 Brenner,17,,8,12,20
010 Brenner,18,,8,9,17
010 Brenner,19,,20,11,31
010 Brenner,20,,14,6,20
010 Brenner,21,,15,11,26
010 Brenner,22,,14,17,31
010 Brenner,23,,13,10,23
010 Brenner,24,,13,7,20
010 Brenner,25,,14,9,23
010 Brenner,26,,12,12,24
010 Brenner,27,,11,11,22
010 Brenner,28,,19,6,25
010 Brenner,29,,18,18,36
010 Brenner,30,,15,17,32
010 Brenner,31,,15,10,25
010 Brenner,32,,14,16,30
010 Brenner,33,,13,17,30
010 Brenner,34,,14,13,27
010 Brenner,35,,16,15,31
010 Brenner,36,,20,11,31
010 Brenner,37,,12,8,20
010 Brenner,38,,20,23,43
010 Brenner,39,,16,7,23
010 Brenner,40,,13,7,20
010 Brenner,41,,17,25,42
010 Brenner,42,,21,17,38
010 Brenner,43,,19,14,33
010 Brenner,44,,14,16,30
010 Brenner,45,,13,18,31
010 Brenner,46,,17,16,33
010 Brenner,47,,17,18,35
010 Brenner,48,,20,17,37
010 Brenner,49,,22,16,38
010 Brenner,50,,11,18,29
010 Brenner,51,,17,11,28
010 Brenner,52,,20,12,32
010 Brenner,53,,21,15,36
010 Brenner,54,,12,14,26
010 Brenner,55,,15,10,25
010 Brenner,56,,15,17,32
010 Brenner,57,,17,13,30
010 Brenner,58,,11,9,20
010 Brenner,59,,9,13,22
010 Brenner,60,,7,14,21
010 Brenner,61,,18,8,26
010 Brenner,62,,12,12,24
010 Brenner,63,,12,12,24
010 Brenner,64,,15,12,27
010 Brenner,65,,6,9,15
010 Brenner,66,,20,10,30
010 Brenner,67,,9,18,27
010 Brenner,68,,4,7,11
010 Brenner,69,,15,12,27
010 Brenner,70,,14,12,26
010 Brenner,71,,7,10,17
010 Brenner,72,,10,11,21
010 Brenner,73,,9,11,20
010 Brenner,74,,7,10,17
010 Brenner,75,,9,14,23
010 Brenner,76,,8,13,21
010 Brenner,77,,10,6,16
010 Brenner,78,,3,5,8
010 Brenner,79,,8,5,13
010 Brenner,80,,4,4,8
010 Brenner,81,,-,4,4
010 Brenner,82,,5,7,12
010 Brenner,83,,6,9,15
010 Brenner,84,,4,5,9
010 Brenner,85,,5,5,10
010 Brenner,86,,5,2,7
010 Brenner,87,,3,4,7
010 Brenner,88,,2,5,7
010 Brenner,89,,1,4,5
010 Brenner,90,,2,3,5
010 Brenner,91,,-,3,3
010 Brenner,92,,-,1,1
010 Brenner,93,,1,2,3
011 Brixen,0,,102,116,218
011 Brixen,1,,115,113,228
011 Brixen,2,,94,87,181
011 Brixen,3,,130,118,248
011 Brixen,4,,131,122,253
011 Brixen,5,,114,106,220
011 Brixen,6,,132,102,234
011 Brixen,7,,133,104,237
011 Brixen,8,,132,118,250
011 Brixen,9,,120,120,240
011 Brixen,10,,110,114,224
011 Brixen,11,,118,117,235
011 Brixen,12,,128,123,251
011 Brixen,13,,126,106,232
011 Brixen,14,,145,128,273
011 Brixen,15,,115,136,251
011 Brixen,16,,120,108,228
011 Brixen,17,,124,118,242
011 Brixen,18,,117,124,241
011 Brixen,19,,131,130,261
011 Brixen,20,,118,111,229
011 Brixen,21,,119,130,249
011 Brixen,22,,130,112,242
011 Brixen,23,,109,110,219
011 Brixen,24,,127,99,226
011 Brixen,25,,125,114,239
011 Brixen,26,,119,128,247
011 Brixen,27,,107,135,242
011 Brixen,28,,136,111,247
011 Brixen,29,,125,109,234
011 Brixen,30,,129,148,277
011 Brixen,31,,128,127,255
011 Brixen,32,,135,132,267
011 Brixen,33,,117,133,250
011 Brixen,34,,153,132,285
011 Brixen,35,,116,144,260
011 Brixen,36,,147,150,297
011 Brixen,37,,152,155,307
011 Brixen,38,,142,131,273
011 Brixen,39,,132,164,296
011 Brixen,40,,160,161,321
011 Brixen,41,,166,178,344
011 Brixen,42,,161,174,335
011 Brixen,43,,176,166,342
011 Brixen,44,,194,200,394
011 Brixen,45,,173,200,373
011 Brixen,46,,179,169,348
011 Brixen,47,,173,195,368
011 Brixen,48,,186,166,352
011 Brixen,49,,181,192,373
011 Brixen,50,,152,170,322
011 Brixen,51,,168,168,336
011 Brixen,52,,137,169,306
011 Brixen,53,,141,148,289
011 Brixen,54,,152,146,298
011 Brixen,55,,145,126,271
011 Brixen,56,,131,146,277
011 Brixen,57,,110,142,252
011 Brixen,58,,123,99,222
011 Brixen,59,,88,120,208
011 Brixen,60,,86,113,199
011 Brixen,61,,105,107,212
011 Brixen,62,,94,107,201
011 Brixen,63,,118,104,222
011 Brixen,64,,80,131,211
011 Brixen,65,,102,117,219
011 Brixen,66,,89,115,204
011 Brixen,67,,101,103,204
011 Brixen,68,,63,99,162
011 Brixen,69,,112,116,228
011 Brixen,70,,117,112,229
011 Brixen,71,,86,101,187
011 Brixen,72,,103,115,218
011 Brixen,73,,80,113,193
011 Brixen,74,,82,98,180
011 Brixen,75,,74,86,160
011 Brixen,76,,76,90,166
011 Brixen,77,,60,88,148
011 Brixen,78,,65,81,146
011 Brixen,79,,60,82,142
011 Brixen,80,,62,63,125
011 Brixen,81,,57,74,131
011 Brixen,82,,52,70,122
011 Brixen,83,,36,73,109
011 Brixen,84,,32,68,100
011 Brixen,85,,38,54,92
011 Brixen,86,,19,72,91
011 Brixen,87,,23,49,72
011 Brixen,88,,25,54,79
011 Brixen,89,,16,45,61
011 Brixen,90,,17,34,51
011 Brixen,91,,7,34,41
011 Brixen,92,,8,27,35
011 Brixen,93,,4,25,29
011 Brixen,94,,2,12,14
011 Brixen,95,,3,6,9
011 Brixen,96,,5,8,13
011 Brixen,97,,1,3,4
011 Brixen,98,,-,1,1
011 Brixen,99,,1,3,4
011 Brixen,100,,1,-,1
011 Brixen,101,,1,2,3
011 Brixen,102,,-,1,1
011 Brixen,103,,-,1,1
012 Branzoll,0,,12,18,30
012 Branzoll,1,,16,19,35
012 Branzoll,2,,16,13,29
012 Branzoll,3,,14,24,38
012 Branzoll,4,,16,17,33
012 Branzoll,5,,13,14,27
012 Branzoll,6,,13,15,28
012 Branzoll,7,,13,10,23
012 Branzoll,8,,8,9,17
012 Branzoll,9,,16,15,31
012 Branzoll,10,,15,22,37
012 Branzoll,11,,14,12,26
012 Branzoll,12,,8,12,20
012 Branzoll,13,,22,8,30
012 Branzoll,14,,10,13,23
012 Branzoll,15,,14,4,18
012 Branzoll,16,,15,22,37
012 Branzoll,17,,17,8,25
012 Branzoll,18,,14,16,30
012 Branzoll,19,,18,9,27
012 Branzoll,20,,22,15,37
012 Branzoll,21,,15,14,29
012 Branzoll,22,,12,19,31
012 Branzoll,23,,15,20,35
012 Branzoll,24,,10,14,24
012 Branzoll,25,,15,14,29
012 Branzoll,26,,15,13,28
012 Branzoll,27,,13,16,29
012 Branzoll,28,,18,19,37
012 Branzoll,29,,18,20,38
012 Branzoll,30,,14,13,27
012 Branzoll,31,,17,16,33
012 Branzoll,32,,17,15,32
012 Branzoll,33,,14,16,30
012 Branzoll,34,,14,12,26
012 Branzoll,35,,11,21,32
012 Branzoll,36,,14,19,33
012 Branzoll,37,,19,18,37
012 Branzoll,38,,20,17,37
012 Branzoll,39,,23,27,50
012 Branzoll,40,,25,12,37
012 Branzoll,41,,23,18,41
012 Branzoll,42,,23,27,50
012 Branzoll,43,,20,18,38
012 Branzoll,44,,24,28,52
012 Branzoll,45,,21,22,43
012 Branzoll,46,,22,19,41
012 Branzoll,47,,17,20,37
012 Branzoll,48,,23,22,45
012 Branzoll,49,,30,27,57
012 Branzoll,50,,20,20,40
012 Branzoll,51,,15,16,31
012 Branzoll,52,,25,31,56
012 Branzoll,53,,29,20,49
012 Branzoll,54,,20,22,42
012 Branzoll,55,,19,18,37
012 Branzoll,56,,19,14,33
012 Branzoll,57,,15,18,33
012 Branzoll,58,,16,19,35
012 Branzoll,59,,20,17,37
012 Branzoll,60,,11,18,29
012 Branzoll,61,,14,21,35
012 Branzoll,62,,15,15,30
012 Branzoll,63,,17,14,31
012 Branzoll,64,,15,15,30
012 Branzoll,65,,14,15,29
012 Branzoll,66,,16,17,33
012 Branzoll,67,,14,19,33
012 Branzoll,68,,9,8,17
012 Branzoll,69,,12,11,23
012 Branzoll,70,,14,10,24
012 Branzoll,71,,18,12,30
012 Branzoll,72,,18,12,30
012 Branzoll,73,,8,13,21
012 Branzoll,74,,14,12,26
012 Branzoll,75,,9,9,18
012 Branzoll,76,,3,7,10
012 Branzoll,77,,6,8,14
012 Branzoll,78,,8,8,16
012 Branzoll,79,,5,8,13
012 Branzoll,80,,17,10,27
012 Branzoll,81,,9,7,16
012 Branzoll,82,,1,9,10
012 Branzoll,83,,5,11,16
012 Branzoll,84,,2,10,12
012 Branzoll,85,,3,7,10
012 Branzoll,86,,2,5,7
012 Branzoll,87,,4,9,13
012 Branzoll,88,,2,4,6
012 Branzoll,89,,1,4,5
012 Branzoll,90,,1,6,7
012 Branzoll,91,,-,1,1
012 Branzoll,92,,-,4,4
012 Branzoll,93,,1,2,3
012 Branzoll,94,,1,-,1
012 Branzoll,95,,1,-,1
012 Branzoll,99,,-,1,1
013 Bruneck,0,,80,68,148
013 Bruneck,1,,90,69,159
013 Bruneck,2,,80,64,144
013 Bruneck,3,,80,76,156
013 Bruneck,4,,96,65,161
013 Bruneck,5,,78,69,147
013 Bruneck,6,,88,70,158
013 Bruneck,7,,102,73,175
013 Bruneck,8,,84,89,173
013 Bruneck,9,,88,103,191
013 Bruneck,10,,97,79,176
013 Bruneck,11,,83,91,174
013 Bruneck,12,,98,82,180
013 Bruneck,13,,89,92,181
013 Bruneck,14,,94,99,193
013 Bruneck,15,,100,95,195
013 Bruneck,16,,115,74,189
013 Bruneck,17,,82,101,183
013 Bruneck,18,,67,81,148
013 Bruneck,19,,89,83,172
013 Bruneck,20,,92,73,165
013 Bruneck,21,,101,87,188
013 Bruneck,22,,90,77,167
013 Bruneck,23,,99,85,184
013 Bruneck,24,,87,93,180
013 Bruneck,25,,79,88,167
013 Bruneck,26,,68,74,142
013 Bruneck,27,,115,86,201
013 Bruneck,28,,94,91,185
013 Bruneck,29,,90,96,186
013 Bruneck,30,,106,90,196
013 Bruneck,31,,109,107,216
013 Bruneck,32,,105,111,216
013 Bruneck,33,,98,104,202
013 Bruneck,34,,92,108,200
013 Bruneck,35,,115,121,236
013 Bruneck,36,,119,113,232
013 Bruneck,37,,98,134,232
013 Bruneck,38,,122,126,248
013 Bruneck,39,,136,115,251
013 Bruneck,40,,134,128,262
013 Bruneck,41,,116,131,247
013 Bruneck,42,,137,113,250
013 Bruneck,43,,120,144,264
013 Bruneck,44,,134,121,255
013 Bruneck,45,,124,152,276
013 Bruneck,46,,131,131,262
013 Bruneck,47,,128,132,260
013 Bruneck,48,,157,150,307
013 Bruneck,49,,135,139,274
013 Bruneck,50,,137,113,250
013 Bruneck,51,,129,121,250
013 Bruneck,52,,122,100,222
013 Bruneck,53,,110,117,227
013 Bruneck,54,,108,106,214
013 Bruneck,55,,105,115,220
013 Bruneck,56,,85,98,183
013 Bruneck,57,,91,94,185
013 Bruneck,58,,73,79,152
013 Bruneck,59,,87,79,166
013 Bruneck,60,,77,98,175
013 Bruneck,61,,89,95,184
013 Bruneck,62,,63,104,167
013 Bruneck,63,,78,93,171
013 Bruneck,64,,82,88,170
013 Bruneck,65,,76,109,185
013 Bruneck,66,,93,71,164
013 Bruneck,67,,97,83,180
013 Bruneck,68,,62,66,128
013 Bruneck,69,,79,94,173
013 Bruneck,70,,95,83,178
013 Bruneck,71,,78,85,163
013 Bruneck,72,,72,90,162
013 Bruneck,73,,66,81,147
013 Bruneck,74,,72,90,162
013 Bruneck,75,,55,50,105
013 Bruneck,76,,50,52,102
013 Bruneck,77,,46,56,102
013 Bruneck,78,,40,48,88
013 Bruneck,79,,28,48,76
013 Bruneck,80,,39,54,93
013 Bruneck,81,,37,46,83
013 Bruneck,82,,30,39,69
013 Bruneck,83,,27,47,74
013 Bruneck,84,,19,43,62
013 Bruneck,85,,21,48,69
013 Bruneck,86,,20,29,49
013 Bruneck,87,,14,23,37
013 Bruneck,88,,13,29,42
013 Bruneck,89,,5,32,37
013 Bruneck,90,,9,20,29
013 Bruneck,91,,12,15,27
013 Bruneck,92,,1,12,13
013 Bruneck,93,,2,13,15
013 Bruneck,94,,4,4,8
013 Bruneck,95,,-,5,5
013 Bruneck,96,,2,7,9
013 Bruneck,97,,-,3,3
013 Bruneck,98,,1,1,2
013 Bruneck,100,,-,3,3
013 Bruneck,101,,-,2,2
013 Bruneck,102,,-,1,1
013 Bruneck,104,,-,1,1
014 Kuens,0,,3,5,8
014 Kuens,1,,2,2,4
014 Kuens,2,,2,5,7
014 Kuens,3,,1,1,2
014 Kuens,4,,4,3,7
014 Kuens,5,,4,3,7
014 Kuens,6,,2,4,6
014 Kuens,7,,1,1,2
014 Kuens,8,,6,2,8
014 Kuens,9,,-,3,3
014 Kuens,10,,5,4,9
014 Kuens,11,,2,1,3
014 Kuens,12,,5,2,7
014 Kuens,13,,2,6,8
014 Kuens,14,,2,3,5
014 Kuens,15,,2,6,8
014 Kuens,16,,1,1,2
014 Kuens,17,,5,2,7
014 Kuens,18,,2,3,5
014 Kuens,19,,1,4,5
014 Kuens,20,,3,2,5
014 Kuens,21,,4,3,7
014 Kuens,22,,2,2,4
014 Kuens,23,,3,2,5
014 Kuens,24,,2,2,4
014 Kuens,25,,1,3,4
014 Kuens,26,,2,2,4
014 Kuens,27,,1,-,1
014 Kuens,28,,1,1,2
014 Kuens,29,,-,2,2
014 Kuens,30,,-,1,1
014 Kuens,31,,2,1,3
014 Kuens,32,,1,4,5
014 Kuens,33,,5,6,11
014 Kuens,34,,1,1,2
014 Kuens,35,,3,2,5
014 Kuens,36,,2,1,3
014 Kuens,37,,3,1,4
014 Kuens,38,,3,6,9
014 Kuens,39,,4,5,9
014 Kuens,40,,2,4,6
014 Kuens,41,,5,1,6
014 Kuens,42,,2,4,6
014 Kuens,43,,6,5,11
014 Kuens,44,,4,1,5
014 Kuens,45,,4,5,9
014 Kuens,46,,6,10,16
014 Kuens,47,,1,6,7
014 Kuens,48,,7,1,8
014 Kuens,49,,5,6,11
014 Kuens,50,,10,2,12
014 Kuens,51,,5,1,6
014 Kuens,52,,-,5,5
014 Kuens,54,,1,-,1
014 Kuens,55,,-,3,3
014 Kuens,56,,3,-,3
014 Kuens,57,,2,-,2
014 Kuens,58,,1,2,3
014 Kuens,59,,-,1,1
014 Kuens,60,,2,2,4
014 Kuens,61,,1,3,4
014 Kuens,63,,-,3,3
014 Kuens,64,,-,2,2
014 Kuens,65,,3,1,4
014 Kuens,66,,1,2,3
014 Kuens,67,,1,2,3
014 Kuens,68,,3,1,4
014 Kuens,69,,1,-,1
014 Kuens,70,,-,2,2
014 Kuens,71,,1,3,4
014 Kuens,72,,-,2,2
014 Kuens,73,,-,1,1
014 Kuens,74,,5,2,7
014 Kuens,75,,3,2,5
014 Kuens,76,,1,3,4
014 Kuens,77,,2,2,4
014 Kuens,78,,1,2,3
014 Kuens,79,,-,1,1
014 Kuens,80,,-,1,1
014 Kuens,81,,4,2,6
014 Kuens,82,,2,2,4
014 Kuens,83,,2,1,3
014 Kuens,84,,1,-,1
014 Kuens,85,,1,-,1
014 Kuens,86,,1,-,1
014 Kuens,87,,1,1,2
014 Kuens,91,,-,1,1
015 Kaltern a.d. Weinstr.,0,,42,52,94
015 Kaltern a.d. Weinstr.,1,,51,30,81
015 Kaltern a.d. Weinstr.,2,,44,50,94
015 Kaltern a.d. Weinstr.,3,,55,36,91
015 Kaltern a.d. Weinstr.,4,,47,30,77
015 Kaltern a.d. Weinstr.,5,,42,43,85
015 Kaltern a.d. Weinstr.,6,,43,40,83
015 Kaltern a.d. Weinstr.,7,,44,42,86
015 Kaltern a.d. Weinstr.,8,,46,44,90
015 Kaltern a.d. Weinstr.,9,,45,47,92
015 Kaltern a.d. Weinstr.,10,,46,38,84
015 Kaltern a.d. Weinstr.,11,,40,34,74
015 Kaltern a.d. Weinstr.,12,,31,51,82
015 Kaltern a.d. Weinstr.,13,,35,38,73
015 Kaltern a.d. Weinstr.,14,,44,39,83
015 Kaltern a.d. Weinstr.,15,,41,46,87
015 Kaltern a.d. Weinstr.,16,,46,43,89
015 Kaltern a.d. Weinstr.,17,,42,44,86
015 Kaltern a.d. Weinstr.,18,,42,37,79
015 Kaltern a.d. Weinstr.,19,,30,39,69
015 Kaltern a.d. Weinstr.,20,,31,41,72
015 Kaltern a.d. Weinstr.,21,,38,42,80
015 Kaltern a.d. Weinstr.,22,,38,44,82
015 Kaltern a.d. Weinstr.,23,,39,36,75
015 Kaltern a.d. Weinstr.,24,,56,32,88
015 Kaltern a.d. Weinstr.,25,,41,44,85
015 Kaltern a.d. Weinstr.,26,,40,39,79
015 Kaltern a.d. Weinstr.,27,,54,45,99
015 Kaltern a.d. Weinstr.,28,,54,41,95
015 Kaltern a.d. Weinstr.,29,,44,44,88
015 Kaltern a.d. Weinstr.,30,,42,49,91
015 Kaltern a.d. Weinstr.,31,,60,57,117
015 Kaltern a.d. Weinstr.,32,,49,48,97
015 Kaltern a.d. Weinstr.,33,,50,56,106
015 Kaltern a.d. Weinstr.,34,,51,45,96
015 Kaltern a.d. Weinstr.,35,,52,48,100
015 Kaltern a.d. Weinstr.,36,,44,57,101
015 Kaltern a.d. Weinstr.,37,,50,53,103
015 Kaltern a.d. Weinstr.,38,,45,63,108
015 Kaltern a.d. Weinstr.,39,,58,55,113
015 Kaltern a.d. Weinstr.,40,,43,56,99
015 Kaltern a.d. Weinstr.,41,,62,69,131
015 Kaltern a.d. Weinstr.,42,,62,63,125
015 Kaltern a.d. Weinstr.,43,,61,66,127
015 Kaltern a.d. Weinstr.,44,,58,66,124
015 Kaltern a.d. Weinstr.,45,,84,69,153
015 Kaltern a.d. Weinstr.,46,,61,65,126
015 Kaltern a.d. Weinstr.,47,,61,71,132
015 Kaltern a.d. Weinstr.,48,,58,61,119
015 Kaltern a.d. Weinstr.,49,,88,52,140
015 Kaltern a.d. Weinstr.,50,,52,59,111
015 Kaltern a.d. Weinstr.,51,,55,64,119
015 Kaltern a.d. Weinstr.,52,,64,68,132
015 Kaltern a.d. Weinstr.,53,,51,66,117
015 Kaltern a.d. Weinstr.,54,,52,56,108
015 Kaltern a.d. Weinstr.,55,,54,65,119
015 Kaltern a.d. Weinstr.,56,,50,61,111
015 Kaltern a.d. Weinstr.,57,,62,40,102
015 Kaltern a.d. Weinstr.,58,,48,43,91
015 Kaltern a.d. Weinstr.,59,,36,49,85
015 Kaltern a.d. Weinstr.,60,,37,36,73
015 Kaltern a.d. Weinstr.,61,,42,58,100
015 Kaltern a.d. Weinstr.,62,,32,39,71
015 Kaltern a.d. Weinstr.,63,,43,34,77
015 Kaltern a.d. Weinstr.,64,,30,34,64
015 Kaltern a.d. Weinstr.,65,,38,33,71
015 Kaltern a.d. Weinstr.,66,,35,54,89
015 Kaltern a.d. Weinstr.,67,,48,47,95
015 Kaltern a.d. Weinstr.,68,,35,39,74
015 Kaltern a.d. Weinstr.,69,,30,43,73
015 Kaltern a.d. Weinstr.,70,,30,37,67
015 Kaltern a.d. Weinstr.,71,,38,40,78
015 Kaltern a.d. Weinstr.,72,,44,41,85
015 Kaltern a.d. Weinstr.,73,,27,42,69
015 Kaltern a.d. Weinstr.,74,,20,34,54
015 Kaltern a.d. Weinstr.,75,,33,37,70
015 Kaltern a.d. Weinstr.,76,,24,29,53
015 Kaltern a.d. Weinstr.,77,,23,22,45
015 Kaltern a.d. Weinstr.,78,,23,26,49
015 Kaltern a.d. Weinstr.,79,,21,26,47
015 Kaltern a.d. Weinstr.,80,,19,35,54
015 Kaltern a.d. Weinstr.,81,,18,31,49
015 Kaltern a.d. Weinstr.,82,,13,28,41
015 Kaltern a.d. Weinstr.,83,,19,27,46
015 Kaltern a.d. Weinstr.,84,,18,28,46
015 Kaltern a.d. Weinstr.,85,,10,22,32
015 Kaltern a.d. Weinstr.,86,,11,23,34
015 Kaltern a.d. Weinstr.,87,,7,17,24
015 Kaltern a.d. Weinstr.,88,,9,25,34
015 Kaltern a.d. Weinstr.,89,,5,12,17
015 Kaltern a.d. Weinstr.,90,,1,12,13
015 Kaltern a.d. Weinstr.,91,,5,15,20
015 Kaltern a.d. Weinstr.,92,,5,8,13
015 Kaltern a.d. Weinstr.,93,,1,12,13
015 Kaltern a.d. Weinstr.,94,,-,1,1
015 Kaltern a.d. Weinstr.,95,,-,3,3
015 Kaltern a.d. Weinstr.,97,,-,1,1
015 Kaltern a.d. Weinstr.,98,,-,1,1
015 Kaltern a.d. Weinstr.,99,,-,3,3
015 Kaltern a.d. Weinstr.,100,,-,1,1
015 Kaltern a.d. Weinstr.,101,,-,1,1
016 Freienfeld,0,,7,13,20
016 Freienfeld,1,,11,13,24
016 Freienfeld,2,,16,19,35
016 Freienfeld,3,,16,15,31
016 Freienfeld,4,,17,16,33
016 Freienfeld,5,,13,13,26
016 Freienfeld,6,,23,11,34
016 Freienfeld,7,,15,14,29
016 Freienfeld,8,,19,17,36
016 Freienfeld,9,,16,10,26
016 Freienfeld,10,,21,15,36
016 Freienfeld,11,,19,19,38
016 Freienfeld,12,,16,19,35
016 Freienfeld,13,,14,14,28
016 Freienfeld,14,,19,21,40
016 Freienfeld,15,,14,21,35
016 Freienfeld,16,,19,18,37
016 Freienfeld,17,,23,13,36
016 Freienfeld,18,,17,15,32
016 Freienfeld,19,,15,12,27
016 Freienfeld,20,,14,11,25
016 Freienfeld,21,,18,22,40
016 Freienfeld,22,,11,10,21
016 Freienfeld,23,,23,15,38
016 Freienfeld,24,,26,20,46
016 Freienfeld,25,,18,16,34
016 Freienfeld,26,,18,15,33
016 Freienfeld,27,,15,13,28
016 Freienfeld,28,,18,15,33
016 Freienfeld,29,,21,13,34
016 Freienfeld,30,,26,18,44
016 Freienfeld,31,,17,18,35
016 Freienfeld,32,,22,17,39
016 Freienfeld,33,,18,15,33
016 Freienfeld,34,,14,23,37
016 Freienfeld,35,,13,13,26
016 Freienfeld,36,,22,24,46
016 Freienfeld,37,,13,16,29
016 Freienfeld,38,,17,14,31
016 Freienfeld,39,,21,25,46
016 Freienfeld,40,,20,18,38
016 Freienfeld,41,,18,23,41
016 Freienfeld,42,,25,25,50
016 Freienfeld,43,,25,16,41
016 Freienfeld,44,,24,24,48
016 Freienfeld,45,,21,20,41
016 Freienfeld,46,,21,29,50
016 Freienfeld,47,,24,21,45
016 Freienfeld,48,,26,21,47
016 Freienfeld,49,,27,19,46
016 Freienfeld,50,,22,15,37
016 Freienfeld,51,,26,30,56
016 Freienfeld,52,,26,15,41
016 Freienfeld,53,,21,22,43
016 Freienfeld,54,,25,14,39
016 Freienfeld,55,,16,19,35
016 Freienfeld,56,,15,19,34
016 Freienfeld,57,,18,17,35
016 Freienfeld,58,,19,10,29
016 Freienfeld,59,,17,18,35
016 Freienfeld,60,,18,12,30
016 Freienfeld,61,,15,18,33
016 Freienfeld,62,,12,10,22
016 Freienfeld,63,,18,10,28
016 Freienfeld,64,,16,12,28
016 Freienfeld,65,,18,13,31
016 Freienfeld,66,,4,9,13
016 Freienfeld,67,,11,15,26
016 Freienfeld,68,,9,2,11
016 Freienfeld,69,,8,5,13
016 Freienfeld,70,,11,9,20
016 Freienfeld,71,,11,9,20
016 Freienfeld,72,,10,9,19
016 Freienfeld,73,,10,4,14
016 Freienfeld,74,,6,9,15
016 Freienfeld,75,,11,12,23
016 Freienfeld,76,,3,11,14
016 Freienfeld,77,,8,11,19
016 Freienfeld,78,,5,11,16
016 Freienfeld,79,,4,4,8
016 Freienfeld,80,,6,9,15
016 Freienfeld,81,,6,9,15
016 Freienfeld,82,,4,7,11
016 Freienfeld,83,,5,5,10
016 Freienfeld,84,,2,4,6
016 Freienfeld,85,,4,3,7
016 Freienfeld,86,,3,5,8
016 Freienfeld,87,,6,6,12
016 Freienfeld,88,,1,2,3
016 Freienfeld,89,,-,2,2
016 Freienfeld,90,,-,6,6
016 Freienfeld,91,,-,2,2
016 Freienfeld,93,,1,1,2
016 Freienfeld,99,,-,1,1
017 Sand in Taufers,0,,22,23,45
017 Sand in Taufers,1,,24,34,58
017 Sand in Taufers,2,,23,29,52
017 Sand in Taufers,3,,25,24,49
017 Sand in Taufers,4,,35,43,78
017 Sand in Taufers,5,,28,30,58
017 Sand in Taufers,6,,48,41,89
017 Sand in Taufers,7,,37,21,58
017 Sand in Taufers,8,,36,29,65
017 Sand in Taufers,9,,35,22,57
017 Sand in Taufers,10,,33,30,63
017 Sand in Taufers,11,,28,27,55
017 Sand in Taufers,12,,31,38,69
017 Sand in Taufers,13,,43,21,64
017 Sand in Taufers,14,,36,38,74
017 Sand in Taufers,15,,28,36,64
017 Sand in Taufers,16,,35,35,70
017 Sand in Taufers,17,,29,30,59
017 Sand in Taufers,18,,32,26,58
017 Sand in Taufers,19,,43,36,79
017 Sand in Taufers,20,,25,37,62
017 Sand in Taufers,21,,34,37,71
017 Sand in Taufers,22,,28,34,62
017 Sand in Taufers,23,,24,36,60
017 Sand in Taufers,24,,28,33,61
017 Sand in Taufers,25,,29,33,62
017 Sand in Taufers,26,,21,30,51
017 Sand in Taufers,27,,20,22,42
017 Sand in Taufers,28,,23,28,51
017 Sand in Taufers,29,,34,26,60
017 Sand in Taufers,30,,32,31,63
017 Sand in Taufers,31,,27,37,64
017 Sand in Taufers,32,,30,32,62
017 Sand in Taufers,33,,36,41,77
017 Sand in Taufers,34,,32,41,73
017 Sand in Taufers,35,,40,34,74
017 Sand in Taufers,36,,41,41,82
017 Sand in Taufers,37,,38,35,73
017 Sand in Taufers,38,,43,38,81
017 Sand in Taufers,39,,57,49,106
017 Sand in Taufers,40,,53,43,96
017 Sand in Taufers,41,,46,51,97
017 Sand in Taufers,42,,46,47,93
017 Sand in Taufers,43,,43,62,105
017 Sand in Taufers,44,,60,43,103
017 Sand in Taufers,45,,51,40,91
017 Sand in Taufers,46,,34,41,75
017 Sand in Taufers,47,,50,35,85
017 Sand in Taufers,48,,55,38,93
017 Sand in Taufers,49,,50,42,92
017 Sand in Taufers,50,,46,40,86
017 Sand in Taufers,51,,37,46,83
017 Sand in Taufers,52,,47,43,90
017 Sand in Taufers,53,,41,32,73
017 Sand in Taufers,54,,32,33,65
017 Sand in Taufers,55,,30,23,53
017 Sand in Taufers,56,,24,38,62
017 Sand in Taufers,57,,23,33,56
017 Sand in Taufers,58,,24,27,51
017 Sand in Taufers,59,,24,30,54
017 Sand in Taufers,60,,30,24,54
017 Sand in Taufers,61,,15,28,43
017 Sand in Taufers,62,,24,23,47
017 Sand in Taufers,63,,32,32,64
017 Sand in Taufers,64,,30,23,53
017 Sand in Taufers,65,,23,23,46
017 Sand in Taufers,66,,24,28,52
017 Sand in Taufers,67,,27,23,50
017 Sand in Taufers,68,,24,8,32
017 Sand in Taufers,69,,15,29,44
017 Sand in Taufers,70,,25,28,53
017 Sand in Taufers,71,,27,32,59
017 Sand in Taufers,72,,25,30,55
017 Sand in Taufers,73,,22,18,40
017 Sand in Taufers,74,,23,29,52
017 Sand in Taufers,75,,17,23,40
017 Sand in Taufers,76,,24,13,37
017 Sand in Taufers,77,,13,26,39
017 Sand in Taufers,78,,23,16,39
017 Sand in Taufers,79,,13,11,24
017 Sand in Taufers,80,,12,16,28
017 Sand in Taufers,81,,7,16,23
017 Sand in Taufers,82,,8,11,19
017 Sand in Taufers,83,,10,17,27
017 Sand in Taufers,84,,9,10,19
017 Sand in Taufers,85,,5,11,16
017 Sand in Taufers,86,,3,6,9
017 Sand in Taufers,87,,4,12,16
017 Sand in Taufers,88,,2,7,9
017 Sand in Taufers,89,,4,9,13
017 Sand in Taufers,90,,3,3,6
017 Sand in Taufers,91,,1,8,9
017 Sand in Taufers,92,,-,6,6
017 Sand in Taufers,93,,1,1,2
017 Sand in Taufers,94,,-,2,2
017 Sand in Taufers,95,,2,1,3
017 Sand in Taufers,96,,-,1,1
017 Sand in Taufers,98,,1,3,4
017 Sand in Taufers,99,,-,1,1
017 Sand in Taufers,102,,-,1,1
018 Kastelbell-Tschars,0,,18,13,31
018 Kastelbell-Tschars,1,,18,7,25
018 Kastelbell-Tschars,2,,15,13,28
018 Kastelbell-Tschars,3,,12,21,33
018 Kastelbell-Tschars,4,,9,8,17
018 Kastelbell-Tschars,5,,11,6,17
018 Kastelbell-Tschars,6,,12,9,21
018 Kastelbell-Tschars,7,,19,6,25
018 Kastelbell-Tschars,8,,9,8,17
018 Kastelbell-Tschars,9,,12,11,23
018 Kastelbell-Tschars,10,,11,9,20
018 Kastelbell-Tschars,11,,7,10,17
018 Kastelbell-Tschars,12,,14,15,29
018 Kastelbell-Tschars,13,,12,9,21
018 Kastelbell-Tschars,14,,24,11,35
018 Kastelbell-Tschars,15,,17,7,24
018 Kastelbell-Tschars,16,,10,11,21
018 Kastelbell-Tschars,17,,17,16,33
018 Kastelbell-Tschars,18,,15,10,25
018 Kastelbell-Tschars,19,,14,15,29
018 Kastelbell-Tschars,20,,13,15,28
018 Kastelbell-Tschars,21,,12,11,23
018 Kastelbell-Tschars,22,,15,15,30
018 Kastelbell-Tschars,23,,17,14,31
018 Kastelbell-Tschars,24,,15,10,25
018 Kastelbell-Tschars,25,,18,8,26
018 Kastelbell-Tschars,26,,19,17,36
018 Kastelbell-Tschars,27,,16,21,37
018 Kastelbell-Tschars,28,,24,17,41
018 Kastelbell-Tschars,29,,7,15,22
018 Kastelbell-Tschars,30,,15,20,35
018 Kastelbell-Tschars,31,,28,13,41
018 Kastelbell-Tschars,32,,13,14,27
018 Kastelbell-Tschars,33,,11,14,25
018 Kastelbell-Tschars,34,,13,14,27
018 Kastelbell-Tschars,35,,15,15,30
018 Kastelbell-Tschars,36,,12,15,27
018 Kastelbell-Tschars,37,,20,17,37
018 Kastelbell-Tschars,38,,17,12,29
018 Kastelbell-Tschars,39,,20,11,31
018 Kastelbell-Tschars,40,,14,24,38
018 Kastelbell-Tschars,41,,12,18,30
018 Kastelbell-Tschars,42,,18,16,34
018 Kastelbell-Tschars,43,,16,15,31
018 Kastelbell-Tschars,44,,24,24,48
018 Kastelbell-Tschars,45,,16,18,34
018 Kastelbell-Tschars,46,,14,21,35
018 Kastelbell-Tschars,47,,19,13,32
018 Kastelbell-Tschars,48,,19,12,31
018 Kastelbell-Tschars,49,,22,15,37
018 Kastelbell-Tschars,50,,22,21,43
018 Kastelbell-Tschars,51,,7,21,28
018 Kastelbell-Tschars,52,,20,17,37
018 Kastelbell-Tschars,53,,22,19,41
018 Kastelbell-Tschars,54,,22,21,43
018 Kastelbell-Tschars,55,,19,14,33
018 Kastelbell-Tschars,56,,16,9,25
018 Kastelbell-Tschars,57,,13,13,26
018 Kastelbell-Tschars,58,,21,18,39
018 Kastelbell-Tschars,59,,9,13,22
018 Kastelbell-Tschars,60,,9,16,25
018 Kastelbell-Tschars,61,,13,15,28
018 Kastelbell-Tschars,62,,15,13,28
018 Kastelbell-Tschars,63,,10,13,23
018 Kastelbell-Tschars,64,,16,10,26
018 Kastelbell-Tschars,65,,11,13,24
018 Kastelbell-Tschars,66,,9,8,17
018 Kastelbell-Tschars,67,,11,13,24
018 Kastelbell-Tschars,68,,11,4,15
018 Kastelbell-Tschars,69,,12,6,18
018 Kastelbell-Tschars,70,,7,7,14
018 Kastelbell-Tschars,71,,11,11,22
018 Kastelbell-Tschars,72,,8,8,16
018 Kastelbell-Tschars,73,,8,8,16
018 Kastelbell-Tschars,74,,11,11,22
018 Kastelbell-Tschars,75,,7,15,22
018 Kastelbell-Tschars,76,,11,11,22
018 Kastelbell-Tschars,77,,9,15,24
018 Kastelbell-Tschars,78,,8,8,16
018 Kastelbell-Tschars,79,,5,12,17
018 Kastelbell-Tschars,80,,14,12,26
018 Kastelbell-Tschars,81,,7,12,19
018 Kastelbell-Tschars,82,,8,10,18
018 Kastelbell-Tschars,83,,15,13,28
018 Kastelbell-Tschars,84,,7,9,16
018 Kastelbell-Tschars,85,,5,10,15
018 Kastelbell-Tschars,86,,4,5,9
018 Kastelbell-Tschars,87,,5,11,16
018 Kastelbell-Tschars,88,,8,6,14
018 Kastelbell-Tschars,89,,2,3,5
018 Kastelbell-Tschars,90,,1,4,5
018 Kastelbell-Tschars,91,,-,3,3
018 Kastelbell-Tschars,92,,1,-,1
018 Kastelbell-Tschars,93,,2,1,3
018 Kastelbell-Tschars,95,,-,1,1
019 Kastelruth,0,,29,35,64
019 Kastelruth,1,,38,39,77
019 Kastelruth,2,,41,37,78
019 Kastelruth,3,,42,36,78
019 Kastelruth,4,,28,39,67
019 Kastelruth,5,,55,38,93
019 Kastelruth,6,,43,38,81
019 Kastelruth,7,,45,35,80
019 Kastelruth,8,,47,33,80
019 Kastelruth,9,,46,38,84
019 Kastelruth,10,,47,39,86
019 Kastelruth,11,,38,35,73
019 Kastelruth,12,,42,37,79
019 Kastelruth,13,,37,26,63
019 Kastelruth,14,,31,45,76
019 Kastelruth,15,,46,42,88
019 Kastelruth,16,,45,45,90
019 Kastelruth,17,,45,39,84
019 Kastelruth,18,,51,40,91
019 Kastelruth,19,,39,29,68
019 Kastelruth,20,,37,35,72
019 Kastelruth,21,,38,51,89
019 Kastelruth,22,,37,39,76
019 Kastelruth,23,,43,45,88
019 Kastelruth,24,,49,44,93
019 Kastelruth,25,,26,29,55
019 Kastelruth,26,,33,46,79
019 Kastelruth,27,,38,27,65
019 Kastelruth,28,,31,42,73
019 Kastelruth,29,,31,37,68
019 Kastelruth,30,,43,32,75
019 Kastelruth,31,,51,40,91
019 Kastelruth,32,,33,38,71
019 Kastelruth,33,,50,41,91
019 Kastelruth,34,,39,36,75
019 Kastelruth,35,,33,42,75
019 Kastelruth,36,,33,40,73
019 Kastelruth,37,,47,63,110
019 Kastelruth,38,,52,44,96
019 Kastelruth,39,,60,44,104
019 Kastelruth,40,,42,73,115
019 Kastelruth,41,,69,43,112
019 Kastelruth,42,,51,44,95
019 Kastelruth,43,,52,50,102
019 Kastelruth,44,,58,45,103
019 Kastelruth,45,,61,59,120
019 Kastelruth,46,,66,55,121
019 Kastelruth,47,,69,46,115
019 Kastelruth,48,,49,76,125
019 Kastelruth,49,,53,35,88
019 Kastelruth,50,,51,36,87
019 Kastelruth,51,,35,52,87
019 Kastelruth,52,,54,42,96
019 Kastelruth,53,,48,38,86
019 Kastelruth,54,,45,46,91
019 Kastelruth,55,,48,43,91
019 Kastelruth,56,,37,41,78
019 Kastelruth,57,,37,32,69
019 Kastelruth,58,,40,39,79
019 Kastelruth,59,,36,32,68
019 Kastelruth,60,,29,29,58
019 Kastelruth,61,,34,26,60
019 Kastelruth,62,,29,22,51
019 Kastelruth,63,,44,26,70
019 Kastelruth,64,,18,34,52
019 Kastelruth,65,,30,41,71
019 Kastelruth,66,,32,32,64
019 Kastelruth,67,,24,37,61
019 Kastelruth,68,,22,21,43
019 Kastelruth,69,,22,44,66
019 Kastelruth,70,,35,38,73
019 Kastelruth,71,,32,26,58
019 Kastelruth,72,,26,44,70
019 Kastelruth,73,,25,34,59
019 Kastelruth,74,,26,26,52
019 Kastelruth,75,,22,26,48
019 Kastelruth,76,,23,22,45
019 Kastelruth,77,,26,16,42
019 Kastelruth,78,,22,25,47
019 Kastelruth,79,,17,20,37
019 Kastelruth,80,,29,28,57
019 Kastelruth,81,,14,34,48
019 Kastelruth,82,,28,19,47
019 Kastelruth,83,,7,22,29
019 Kastelruth,84,,15,20,35
019 Kastelruth,85,,6,12,18
019 Kastelruth,86,,14,23,37
019 Kastelruth,87,,8,12,20
019 Kastelruth,88,,7,12,19
019 Kastelruth,89,,5,13,18
019 Kastelruth,90,,3,11,14
019 Kastelruth,91,,5,6,11
019 Kastelruth,92,,4,9,13
019 Kastelruth,93,,1,4,5
019 Kastelruth,94,,1,2,3
019 Kastelruth,95,,1,-,1
019 Kastelruth,96,,-,1,1
019 Kastelruth,97,,-,1,1
019 Kastelruth,99,,-,1,1
019 Kastelruth,102,,-,1,1
020 Tscherms,0,,4,6,10
020 Tscherms,1,,9,11,20
020 Tscherms,2,,18,5,23
020 Tscherms,3,,9,6,15
020 Tscherms,4,,5,7,12
020 Tscherms,5,,8,11,19
020 Tscherms,6,,7,10,17
020 Tscherms,7,,6,6,12
020 Tscherms,8,,3,10,13
020 Tscherms,9,,8,7,15
020 Tscherms,10,,9,7,16
020 Tscherms,11,,7,7,14
020 Tscherms,12,,5,10,15
020 Tscherms,13,,9,6,15
020 Tscherms,14,,8,8,16
020 Tscherms,15,,4,8,12
020 Tscherms,16,,12,8,20
020 Tscherms,17,,7,4,11
020 Tscherms,18,,11,10,21
020 Tscherms,19,,9,17,26
020 Tscherms,20,,7,10,17
020 Tscherms,21,,11,8,19
020 Tscherms,22,,5,7,12
020 Tscherms,23,,8,6,14
020 Tscherms,24,,5,5,10
020 Tscherms,25,,5,13,18
020 Tscherms,26,,6,9,15
020 Tscherms,27,,8,6,14
020 Tscherms,28,,12,12,24
020 Tscherms,29,,14,9,23
020 Tscherms,30,,12,13,25
020 Tscherms,31,,6,9,15
020 Tscherms,32,,11,11,22
020 Tscherms,33,,10,16,26
020 Tscherms,34,,3,8,11
020 Tscherms,35,,7,10,17
020 Tscherms,36,,11,6,17
020 Tscherms,37,,8,10,18
020 Tscherms,38,,14,7,21
020 Tscherms,39,,11,9,20
020 Tscherms,40,,11,13,24
020 Tscherms,41,,10,12,22
020 Tscherms,42,,8,14,22
020 Tscherms,43,,14,6,20
020 Tscherms,44,,8,15,23
020 Tscherms,45,,13,7,20
020 Tscherms,46,,13,11,24
020 Tscherms,47,,17,7,24
020 Tscherms,48,,16,18,34
020 Tscherms,49,,16,18,34
020 Tscherms,50,,16,12,28
020 Tscherms,51,,16,15,31
020 Tscherms,52,,13,11,24
020 Tscherms,53,,10,15,25
020 Tscherms,54,,6,18,24
020 Tscherms,55,,9,7,16
020 Tscherms,56,,8,11,19
020 Tscherms,57,,8,6,14
020 Tscherms,58,,9,7,16
020 Tscherms,59,,6,8,14
020 Tscherms,60,,10,9,19
020 Tscherms,61,,11,5,16
020 Tscherms,62,,5,10,15
020 Tscherms,63,,10,6,16
020 Tscherms,64,,4,3,7
020 Tscherms,65,,6,6,12
020 Tscherms,66,,7,8,15
020 Tscherms,67,,4,9,13
020 Tscherms,68,,4,6,10
020 Tscherms,69,,5,8,13
020 Tscherms,70,,5,4,9
020 Tscherms,71,,8,4,12
020 Tscherms,72,,10,9,19
020 Tscherms,73,,4,4,8
020 Tscherms,74,,6,6,12
020 Tscherms,75,,6,3,9
020 Tscherms,76,,6,8,14
020 Tscherms,77,,6,7,13
020 Tscherms,78,,3,3,6
020 Tscherms,79,,2,9,11
020 Tscherms,80,,4,3,7
020 Tscherms,81,,5,4,9
020 Tscherms,82,,2,3,5
020 Tscherms,83,,2,5,7
020 Tscherms,84,,1,2,3
020 Tscherms,85,,4,3,7
020 Tscherms,86,,3,3,6
020 Tscherms,87,,1,1,2
020 Tscherms,88,,3,5,8
020 Tscherms,89,,3,3,6
020 Tscherms,90,,-,2,2
020 Tscherms,91,,-,2,2
020 Tscherms,94,,-,1,1
020 Tscherms,95,,-,1,1
021 Kiens,0,,20,5,25
021 Kiens,1,,17,25,42
021 Kiens,2,,9,11,20
021 Kiens,3,,16,15,31
021 Kiens,4,,10,22,32
021 Kiens,5,,15,10,25
021 Kiens,6,,13,12,25
021 Kiens,7,,16,9,25
021 Kiens,8,,17,20,37
021 Kiens,9,,16,12,28
021 Kiens,10,,13,19,32
021 Kiens,11,,11,14,25
021 Kiens,12,,18,22,40
021 Kiens,13,,9,22,31
021 Kiens,14,,16,19,35
021 Kiens,15,,21,10,31
021 Kiens,16,,17,15,32
021 Kiens,17,,15,17,32
021 Kiens,18,,14,21,35
021 Kiens,19,,21,16,37
021 Kiens,20,,19,19,38
021 Kiens,21,,26,19,45
021 Kiens,22,,13,23,36
021 Kiens,23,,15,20,35
021 Kiens,24,,13,22,35
021 Kiens,25,,15,12,27
021 Kiens,26,,13,18,31
021 Kiens,27,,17,12,29
021 Kiens,28,,20,10,30
021 Kiens,29,,17,12,29
021 Kiens,30,,17,18,35
021 Kiens,31,,23,17,40
021 Kiens,32,,14,19,33
021 Kiens,33,,17,17,34
021 Kiens,34,,12,16,28
021 Kiens,35,,29,15,44
021 Kiens,36,,18,15,33
021 Kiens,37,,19,21,40
021 Kiens,38,,17,21,38
021 Kiens,39,,20,20,40
021 Kiens,40,,30,23,53
021 Kiens,41,,23,17,40
021 Kiens,42,,27,23,50
021 Kiens,43,,26,29,55
021 Kiens,44,,32,23,55
021 Kiens,45,,38,21,59
021 Kiens,46,,22,25,47
021 Kiens,47,,29,26,55
021 Kiens,48,,22,23,45
021 Kiens,49,,31,24,55
021 Kiens,50,,18,23,41
021 Kiens,51,,30,18,48
021 Kiens,52,,19,23,42
021 Kiens,53,,22,18,40
021 Kiens,54,,24,16,40
021 Kiens,55,,15,13,28
021 Kiens,56,,12,14,26
021 Kiens,57,,16,16,32
021 Kiens,58,,15,8,23
021 Kiens,59,,12,15,27
021 Kiens,60,,15,23,38
021 Kiens,61,,11,11,22
021 Kiens,62,,14,12,26
021 Kiens,63,,16,10,26
021 Kiens,64,,10,13,23
021 Kiens,65,,15,18,33
021 Kiens,66,,12,15,27
021 Kiens,67,,20,14,34
021 Kiens,68,,8,11,19
021 Kiens,69,,7,12,19
021 Kiens,70,,17,9,26
021 Kiens,71,,15,10,25
021 Kiens,72,,15,11,26
021 Kiens,73,,10,16,26
021 Kiens,74,,11,9,20
021 Kiens,75,,9,12,21
021 Kiens,76,,10,11,21
021 Kiens,77,,8,8,16
021 Kiens,78,,3,15,18
021 Kiens,79,,7,9,16
021 Kiens,80,,9,8,17
021 Kiens,81,,11,8,19
021 Kiens,82,,10,7,17
021 Kiens,83,,3,10,13
021 Kiens,84,,2,7,9
021 Kiens,85,,1,3,4
021 Kiens,86,,2,4,6
021 Kiens,87,,-,3,3
021 Kiens,88,,1,3,4
021 Kiens,89,,1,4,5
021 Kiens,90,,1,2,3
021 Kiens,91,,2,1,3
021 Kiens,92,,-,2,2
021 Kiens,93,,1,1,2
021 Kiens,99,,-,1,1
022 Klausen,0,,33,22,55
022 Klausen,1,,42,29,71
022 Klausen,2,,31,32,63
022 Klausen,3,,21,35,56
022 Klausen,4,,28,18,46
022 Klausen,5,,23,26,49
022 Klausen,6,,27,27,54
022 Klausen,7,,42,41,83
022 Klausen,8,,37,31,68
022 Klausen,9,,39,36,75
022 Klausen,10,,28,30,58
022 Klausen,11,,41,30,71
022 Klausen,12,,31,30,61
022 Klausen,13,,28,33,61
022 Klausen,14,,26,32,58
022 Klausen,15,,24,29,53
022 Klausen,16,,38,34,72
022 Klausen,17,,30,26,56
022 Klausen,18,,31,28,59
022 Klausen,19,,16,34,50
022 Klausen,20,,34,25,59
022 Klausen,21,,39,26,65
022 Klausen,22,,36,36,72
022 Klausen,23,,42,28,70
022 Klausen,24,,28,32,60
022 Klausen,25,,34,38,72
022 Klausen,26,,28,32,60
022 Klausen,27,,37,25,62
022 Klausen,28,,40,38,78
022 Klausen,29,,30,22,52
022 Klausen,30,,30,29,59
022 Klausen,31,,38,42,80
022 Klausen,32,,41,31,72
022 Klausen,33,,32,42,74
022 Klausen,34,,28,28,56
022 Klausen,35,,39,36,75
022 Klausen,36,,31,27,58
022 Klausen,37,,38,27,65
022 Klausen,38,,38,46,84
022 Klausen,39,,39,32,71
022 Klausen,40,,43,31,74
022 Klausen,41,,38,38,76
022 Klausen,42,,38,45,83
022 Klausen,43,,40,41,81
022 Klausen,44,,46,46,92
022 Klausen,45,,47,45,92
022 Klausen,46,,51,43,94
022 Klausen,47,,64,42,106
022 Klausen,48,,41,48,89
022 Klausen,49,,43,45,88
022 Klausen,50,,40,38,78
022 Klausen,51,,33,41,74
022 Klausen,52,,52,45,97
022 Klausen,53,,40,26,66
022 Klausen,54,,34,38,72
022 Klausen,55,,30,29,59
022 Klausen,56,,30,28,58
022 Klausen,57,,30,24,54
022 Klausen,58,,26,32,58
022 Klausen,59,,27,39,66
022 Klausen,60,,19,29,48
022 Klausen,61,,29,17,46
022 Klausen,62,,33,25,58
022 Klausen,63,,28,21,49
022 Klausen,64,,30,26,56
022 Klausen,65,,27,28,55
022 Klausen,66,,24,20,44
022 Klausen,67,,30,23,53
022 Klausen,68,,12,17,29
022 Klausen,69,,23,17,40
022 Klausen,70,,15,28,43
022 Klausen,71,,21,24,45
022 Klausen,72,,26,18,44
022 Klausen,73,,17,22,39
022 Klausen,74,,20,20,40
022 Klausen,75,,13,20,33
022 Klausen,76,,14,17,31
022 Klausen,77,,16,21,37
022 Klausen,78,,10,16,26
022 Klausen,79,,14,11,25
022 Klausen,80,,17,15,32
022 Klausen,81,,9,18,27
022 Klausen,82,,11,11,22
022 Klausen,83,,8,14,22
022 Klausen,84,,12,14,26
022 Klausen,85,,3,13,16
022 Klausen,86,,3,12,15
022 Klausen,87,,4,6,10
022 Klausen,88,,4,5,9
022 Klausen,89,,3,7,10
022 Klausen,90,,2,6,8
022 Klausen,91,,2,4,6
022 Klausen,92,,-,4,4
022 Klausen,93,,-,3,3
022 Klausen,94,,-,2,2
022 Klausen,95,,1,2,3
022 Klausen,96,,-,2,2
022 Klausen,100,,-,1,1
023 Karneid,0,,14,16,30
023 Karneid,1,,20,21,41
023 Karneid,2,,27,17,44
023 Karneid,3,,13,18,31
023 Karneid,4,,15,17,32
023 Karneid,5,,28,16,44
023 Karneid,6,,24,22,46
023 Karneid,7,,22,14,36
023 Karneid,8,,24,20,44
023 Karneid,9,,20,25,45
023 Karneid,10,,28,18,46
023 Karneid,11,,16,12,28
023 Karneid,12,,20,21,41
023 Karneid,13,,15,17,32
023 Karneid,14,,25,25,50
023 Karneid,15,,17,19,36
023 Karneid,16,,27,18,45
023 Karneid,17,,19,24,43
023 Karneid,18,,27,20,47
023 Karneid,19,,22,20,42
023 Karneid,20,,21,20,41
023 Karneid,21,,22,18,40
023 Karneid,22,,16,19,35
023 Karneid,23,,21,16,37
023 Karneid,24,,17,17,34
023 Karneid,25,,16,19,35
023 Karneid,26,,14,22,36
023 Karneid,27,,21,21,42
023 Karneid,28,,22,13,35
023 Karneid,29,,24,17,41
023 Karneid,30,,16,14,30
023 Karneid,31,,19,18,37
023 Karneid,32,,29,26,55
023 Karneid,33,,24,17,41
023 Karneid,34,,25,25,50
023 Karneid,35,,22,15,37
023 Karneid,36,,21,24,45
023 Karneid,37,,27,28,55
023 Karneid,38,,22,15,37
023 Karneid,39,,25,25,50
023 Karneid,40,,28,29,57
023 Karneid,41,,29,25,54
023 Karneid,42,,31,37,68
023 Karneid,43,,32,23,55
023 Karneid,44,,24,28,52
023 Karneid,45,,36,32,68
023 Karneid,46,,31,31,62
023 Karneid,47,,34,31,65
023 Karneid,48,,31,25,56
023 Karneid,49,,36,25,61
023 Karneid,50,,37,24,61
023 Karneid,51,,28,39,67
023 Karneid,52,,28,23,51
023 Karneid,53,,29,26,55
023 Karneid,54,,26,18,44
023 Karneid,55,,25,19,44
023 Karneid,56,,16,12,28
023 Karneid,57,,20,18,38
023 Karneid,58,,15,10,25
023 Karneid,59,,14,12,26
023 Karneid,60,,16,12,28
023 Karneid,61,,10,21,31
023 Karneid,62,,16,11,27
023 Karneid,63,,21,14,35
023 Karneid,64,,9,14,23
023 Karneid,65,,13,26,39
023 Karneid,66,,7,15,22
023 Karneid,67,,12,21,33
023 Karneid,68,,11,14,25
023 Karneid,69,,12,14,26
023 Karneid,70,,20,15,35
023 Karneid,71,,16,25,41
023 Karneid,72,,18,13,31
023 Karneid,73,,10,14,24
023 Karneid,74,,14,14,28
023 Karneid,75,,17,12,29
023 Karneid,76,,8,8,16
023 Karneid,77,,12,11,23
023 Karneid,78,,9,8,17
023 Karneid,79,,8,13,21
023 Karneid,80,,6,13,19
023 Karneid,81,,12,5,17
023 Karneid,82,,10,10,20
023 Karneid,83,,5,7,12
023 Karneid,84,,6,5,11
023 Karneid,85,,7,5,12
023 Karneid,86,,2,7,9
023 Karneid,87,,4,5,9
023 Karneid,88,,1,4,5
023 Karneid,89,,3,2,5
023 Karneid,90,,-,1,1
023 Karneid,91,,-,4,4
023 Karneid,92,,-,3,3
023 Karneid,93,,1,3,4
023 Karneid,94,,1,-,1
023 Karneid,101,,-,1,1
024 Kurtatsch a.d.Weinstr.,0,,19,7,26
024 Kurtatsch a.d.Weinstr.,1,,15,10,25
024 Kurtatsch a.d.Weinstr.,2,,11,10,21
024 Kurtatsch a.d.Weinstr.,3,,6,10,16
024 Kurtatsch a.d.Weinstr.,4,,8,11,19
024 Kurtatsch a.d.Weinstr.,5,,15,7,22
024 Kurtatsch a.d.Weinstr.,6,,6,4,10
024 Kurtatsch a.d.Weinstr.,7,,8,15,23
024 Kurtatsch a.d.Weinstr.,8,,13,15,28
024 Kurtatsch a.d.Weinstr.,9,,11,11,22
024 Kurtatsch a.d.Weinstr.,10,,12,12,24
024 Kurtatsch a.d.Weinstr.,11,,12,17,29
024 Kurtatsch a.d.Weinstr.,12,,16,10,26
024 Kurtatsch a.d.Weinstr.,13,,18,15,33
024 Kurtatsch a.d.Weinstr.,14,,19,11,30
024 Kurtatsch a.d.Weinstr.,15,,18,14,32
024 Kurtatsch a.d.Weinstr.,16,,13,14,27
024 Kurtatsch a.d.Weinstr.,17,,23,20,43
024 Kurtatsch a.d.Weinstr.,18,,18,11,29
024 Kurtatsch a.d.Weinstr.,19,,14,7,21
024 Kurtatsch a.d.Weinstr.,20,,23,17,40
024 Kurtatsch a.d.Weinstr.,21,,20,11,31
024 Kurtatsch a.d.Weinstr.,22,,17,14,31
024 Kurtatsch a.d.Weinstr.,23,,12,7,19
024 Kurtatsch a.d.Weinstr.,24,,10,17,27
024 Kurtatsch a.d.Weinstr.,25,,8,13,21
024 Kurtatsch a.d.Weinstr.,26,,12,16,28
024 Kurtatsch a.d.Weinstr.,27,,8,14,22
024 Kurtatsch a.d.Weinstr.,28,,15,11,26
024 Kurtatsch a.d.Weinstr.,29,,13,6,19
024 Kurtatsch a.d.Weinstr.,30,,14,4,18
024 Kurtatsch a.d.Weinstr.,31,,13,16,29
024 Kurtatsch a.d.Weinstr.,32,,13,15,28
024 Kurtatsch a.d.Weinstr.,33,,12,12,24
024 Kurtatsch a.d.Weinstr.,34,,11,14,25
024 Kurtatsch a.d.Weinstr.,35,,10,15,25
024 Kurtatsch a.d.Weinstr.,36,,9,17,26
024 Kurtatsch a.d.Weinstr.,37,,10,12,22
024 Kurtatsch a.d.Weinstr.,38,,12,11,23
024 Kurtatsch a.d.Weinstr.,39,,12,18,30
024 Kurtatsch a.d.Weinstr.,40,,15,20,35
024 Kurtatsch a.d.Weinstr.,41,,11,14,25
024 Kurtatsch a.d.Weinstr.,42,,17,20,37
024 Kurtatsch a.d.Weinstr.,43,,15,24,39
024 Kurtatsch a.d.Weinstr.,44,,25,24,49
024 Kurtatsch a.d.Weinstr.,45,,27,13,40
024 Kurtatsch a.d.Weinstr.,46,,17,21,38
024 Kurtatsch a.d.Weinstr.,47,,28,17,45
024 Kurtatsch a.d.Weinstr.,48,,25,26,51
024 Kurtatsch a.d.Weinstr.,49,,18,25,43
024 Kurtatsch a.d.Weinstr.,50,,22,20,42
024 Kurtatsch a.d.Weinstr.,51,,24,15,39
024 Kurtatsch a.d.Weinstr.,52,,18,17,35
024 Kurtatsch a.d.Weinstr.,53,,17,21,38
024 Kurtatsch a.d.Weinstr.,54,,20,9,29
024 Kurtatsch a.d.Weinstr.,55,,14,14,28
024 Kurtatsch a.d.Weinstr.,56,,13,11,24
024 Kurtatsch a.d.Weinstr.,57,,13,8,21
024 Kurtatsch a.d.Weinstr.,58,,13,20,33
024 Kurtatsch a.d.Weinstr.,59,,14,7,21
024 Kurtatsch a.d.Weinstr.,60,,16,18,34
024 Kurtatsch a.d.Weinstr.,61,,10,8,18
024 Kurtatsch a.d.Weinstr.,62,,9,13,22
024 Kurtatsch a.d.Weinstr.,63,,13,4,17
024 Kurtatsch a.d.Weinstr.,64,,11,9,20
024 Kurtatsch a.d.Weinstr.,65,,9,10,19
024 Kurtatsch a.d.Weinstr.,66,,10,8,18
024 Kurtatsch a.d.Weinstr.,67,,12,9,21
024 Kurtatsch a.d.Weinstr.,68,,6,8,14
024 Kurtatsch a.d.Weinstr.,69,,5,8,13
024 Kurtatsch a.d.Weinstr.,70,,9,6,15
024 Kurtatsch a.d.Weinstr.,71,,9,11,20
024 Kurtatsch a.d.Weinstr.,72,,8,11,19
024 Kurtatsch a.d.Weinstr.,73,,10,11,21
024 Kurtatsch a.d.Weinstr.,74,,3,16,19
024 Kurtatsch a.d.Weinstr.,75,,9,12,21
024 Kurtatsch a.d.Weinstr.,76,,4,9,13
024 Kurtatsch a.d.Weinstr.,77,,8,8,16
024 Kurtatsch a.d.Weinstr.,78,,4,7,11
024 Kurtatsch a.d.Weinstr.,79,,1,6,7
024 Kurtatsch a.d.Weinstr.,80,,8,6,14
024 Kurtatsch a.d.Weinstr.,81,,9,14,23
024 Kurtatsch a.d.Weinstr.,82,,5,8,13
024 Kurtatsch a.d.Weinstr.,83,,5,14,19
024 Kurtatsch a.d.Weinstr.,84,,5,6,11
024 Kurtatsch a.d.Weinstr.,85,,6,7,13
024 Kurtatsch a.d.Weinstr.,86,,6,3,9
024 Kurtatsch a.d.Weinstr.,87,,1,2,3
024 Kurtatsch a.d.Weinstr.,88,,2,6,8
024 Kurtatsch a.d.Weinstr.,89,,2,6,8
024 Kurtatsch a.d.Weinstr.,90,,4,9,13
024 Kurtatsch a.d.Weinstr.,91,,-,2,2
024 Kurtatsch a.d.Weinstr.,92,,-,4,4
024 Kurtatsch a.d.Weinstr.,93,,3,2,5
024 Kurtatsch a.d.Weinstr.,96,,-,1,1
024 Kurtatsch a.d.Weinstr.,101,,1,-,1
024 Kurtatsch a.d.Weinstr.,102,,-,1,1
025 Kurtinig a.d. Weinstr.,0,,3,2,5
025 Kurtinig a.d. Weinstr.,1,,3,5,8
025 Kurtinig a.d. Weinstr.,2,,4,5,9
025 Kurtinig a.d. Weinstr.,3,,4,6,10
025 Kurtinig a.d. Weinstr.,4,,6,2,8
025 Kurtinig a.d. Weinstr.,5,,4,-,4
025 Kurtinig a.d. Weinstr.,6,,5,2,7
025 Kurtinig a.d. Weinstr.,7,,3,1,4
025 Kurtinig a.d. Weinstr.,8,,-,3,3
025 Kurtinig a.d. Weinstr.,9,,1,2,3
025 Kurtinig a.d. Weinstr.,10,,6,2,8
025 Kurtinig a.d. Weinstr.,11,,3,3,6
025 Kurtinig a.d. Weinstr.,12,,1,8,9
025 Kurtinig a.d. Weinstr.,13,,3,5,8
025 Kurtinig a.d. Weinstr.,14,,3,2,5
025 Kurtinig a.d. Weinstr.,15,,3,5,8
025 Kurtinig a.d. Weinstr.,16,,3,5,8
025 Kurtinig a.d. Weinstr.,17,,1,2,3
025 Kurtinig a.d. Weinstr.,18,,6,3,9
025 Kurtinig a.d. Weinstr.,19,,3,2,5
025 Kurtinig a.d. Weinstr.,20,,5,5,10
025 Kurtinig a.d. Weinstr.,21,,2,4,6
025 Kurtinig a.d. Weinstr.,22,,6,1,7
025 Kurtinig a.d. Weinstr.,23,,2,2,4
025 Kurtinig a.d. Weinstr.,24,,6,2,8
025 Kurtinig a.d. Weinstr.,25,,4,4,8
025 Kurtinig a.d. Weinstr.,26,,8,8,16
025 Kurtinig a.d. Weinstr.,27,,8,4,12
025 Kurtinig a.d. Weinstr.,28,,3,2,5
025 Kurtinig a.d. Weinstr.,29,,3,6,9
025 Kurtinig a.d. Weinstr.,30,,5,1,6
025 Kurtinig a.d. Weinstr.,31,,5,7,12
025 Kurtinig a.d. Weinstr.,32,,7,3,10
025 Kurtinig a.d. Weinstr.,33,,4,6,10
025 Kurtinig a.d. Weinstr.,34,,5,7,12
025 Kurtinig a.d. Weinstr.,35,,5,3,8
025 Kurtinig a.d. Weinstr.,36,,2,2,4
025 Kurtinig a.d. Weinstr.,37,,1,-,1
025 Kurtinig a.d. Weinstr.,38,,2,7,9
025 Kurtinig a.d. Weinstr.,39,,4,4,8
025 Kurtinig a.d. Weinstr.,40,,7,5,12
025 Kurtinig a.d. Weinstr.,41,,3,7,10
025 Kurtinig a.d. Weinstr.,42,,3,3,6
025 Kurtinig a.d. Weinstr.,43,,6,4,10
025 Kurtinig a.d. Weinstr.,44,,6,5,11
025 Kurtinig a.d. Weinstr.,45,,4,2,6
025 Kurtinig a.d. Weinstr.,46,,5,4,9
025 Kurtinig a.d. Weinstr.,47,,2,5,7
025 Kurtinig a.d. Weinstr.,48,,3,5,8
025 Kurtinig a.d. Weinstr.,49,,6,5,11
025 Kurtinig a.d. Weinstr.,50,,9,5,14
025 Kurtinig a.d. Weinstr.,51,,4,5,9
025 Kurtinig a.d. Weinstr.,52,,7,10,17
025 Kurtinig a.d. Weinstr.,53,,5,4,9
025 Kurtinig a.d. Weinstr.,54,,11,6,17
025 Kurtinig a.d. Weinstr.,55,,3,8,11
025 Kurtinig a.d. Weinstr.,56,,7,9,16
025 Kurtinig a.d. Weinstr.,57,,5,1,6
025 Kurtinig a.d. Weinstr.,58,,2,1,3
025 Kurtinig a.d. Weinstr.,59,,7,3,10
025 Kurtinig a.d. Weinstr.,60,,4,7,11
025 Kurtinig a.d. Weinstr.,61,,2,4,6
025 Kurtinig a.d. Weinstr.,62,,2,5,7
025 Kurtinig a.d. Weinstr.,63,,1,3,4
025 Kurtinig a.d. Weinstr.,64,,3,3,6
025 Kurtinig a.d. Weinstr.,65,,3,3,6
025 Kurtinig a.d. Weinstr.,66,,5,2,7
025 Kurtinig a.d. Weinstr.,67,,-,5,5
025 Kurtinig a.d. Weinstr.,68,,3,2,5
025 Kurtinig a.d. Weinstr.,69,,3,2,5
025 Kurtinig a.d. Weinstr.,70,,4,2,6
025 Kurtinig a.d. Weinstr.,71,,2,2,4
025 Kurtinig a.d. Weinstr.,72,,4,2,6
025 Kurtinig a.d. Weinstr.,73,,2,2,4
025 Kurtinig a.d. Weinstr.,74,,5,3,8
025 Kurtinig a.d. Weinstr.,75,,2,2,4
025 Kurtinig a.d. Weinstr.,76,,2,3,5
025 Kurtinig a.d. Weinstr.,77,,3,3,6
025 Kurtinig a.d. Weinstr.,78,,-,5,5
025 Kurtinig a.d. Weinstr.,79,,2,4,6
025 Kurtinig a.d. Weinstr.,80,,-,2,2
025 Kurtinig a.d. Weinstr.,81,,3,3,6
025 Kurtinig a.d. Weinstr.,82,,1,2,3
025 Kurtinig a.d. Weinstr.,83,,2,3,5
025 Kurtinig a.d. Weinstr.,84,,1,1,2
025 Kurtinig a.d. Weinstr.,85,,1,3,4
025 Kurtinig a.d. Weinstr.,86,,2,1,3
025 Kurtinig a.d. Weinstr.,87,,1,-,1
025 Kurtinig a.d. Weinstr.,88,,-,4,4
025 Kurtinig a.d. Weinstr.,89,,-,1,1
025 Kurtinig a.d. Weinstr.,92,,1,1,2
025 Kurtinig a.d. Weinstr.,95,,-,1,1
025 Kurtinig a.d. Weinstr.,98,,-,1,1
025 Kurtinig a.d. Weinstr.,99,,-,1,1
026 Corvara,0,,6,9,15
026 Corvara,1,,8,7,15
026 Corvara,2,,6,4,10
026 Corvara,3,,12,9,21
026 Corvara,4,,9,7,16
026 Corvara,5,,7,7,14
026 Corvara,6,,5,9,14
026 Corvara,7,,8,3,11
026 Corvara,8,,7,7,14
026 Corvara,9,,6,3,9
026 Corvara,10,,12,5,17
026 Corvara,11,,5,3,8
026 Corvara,12,,5,6,11
026 Corvara,13,,8,5,13
026 Corvara,14,,8,7,15
026 Corvara,15,,10,9,19
026 Corvara,16,,3,5,8
026 Corvara,17,,9,4,13
026 Corvara,18,,8,7,15
026 Corvara,19,,7,3,10
026 Corvara,20,,5,3,8
026 Corvara,21,,6,10,16
026 Corvara,22,,6,6,12
026 Corvara,23,,11,9,20
026 Corvara,24,,7,5,12
026 Corvara,25,,5,4,9
026 Corvara,26,,8,8,16
026 Corvara,27,,5,2,7
026 Corvara,28,,6,9,15
026 Corvara,29,,6,4,10
026 Corvara,30,,6,7,13
026 Corvara,31,,11,14,25
026 Corvara,32,,13,3,16
026 Corvara,33,,10,9,19
026 Corvara,34,,10,7,17
026 Corvara,35,,11,3,14
026 Corvara,36,,17,10,27
026 Corvara,37,,12,7,19
026 Corvara,38,,9,22,31
026 Corvara,39,,6,15,21
026 Corvara,40,,10,13,23
026 Corvara,41,,9,8,17
026 Corvara,42,,12,6,18
026 Corvara,43,,10,14,24
026 Corvara,44,,15,13,28
026 Corvara,45,,8,16,24
026 Corvara,46,,15,20,35
026 Corvara,47,,12,16,28
026 Corvara,48,,16,17,33
026 Corvara,49,,8,9,17
026 Corvara,50,,15,7,22
026 Corvara,51,,12,11,23
026 Corvara,52,,8,8,16
026 Corvara,53,,15,14,29
026 Corvara,54,,8,7,15
026 Corvara,55,,11,8,19
026 Corvara,56,,8,4,12
026 Corvara,57,,5,6,11
026 Corvara,58,,11,7,18
026 Corvara,59,,9,9,18
026 Corvara,60,,6,12,18
026 Corvara,61,,4,8,12
026 Corvara,62,,5,9,14
026 Corvara,63,,7,8,15
026 Corvara,64,,2,9,11
026 Corvara,65,,4,5,9
026 Corvara,66,,4,10,14
026 Corvara,67,,12,9,21
026 Corvara,68,,5,3,8
026 Corvara,69,,5,8,13
026 Corvara,70,,5,10,15
026 Corvara,71,,6,8,14
026 Corvara,72,,10,9,19
026 Corvara,73,,8,6,14
026 Corvara,74,,6,5,11
026 Corvara,75,,3,7,10
026 Corvara,76,,6,9,15
026 Corvara,77,,3,6,9
026 Corvara,78,,6,3,9
026 Corvara,79,,3,9,12
026 Corvara,80,,3,3,6
026 Corvara,81,,4,4,8
026 Corvara,82,,3,9,12
026 Corvara,83,,2,3,5
026 Corvara,84,,3,4,7
026 Corvara,85,,1,1,2
026 Corvara,86,,4,2,6
026 Corvara,87,,2,1,3
026 Corvara,88,,1,2,3
026 Corvara,89,,1,-,1
026 Corvara,90,,3,1,4
026 Corvara,91,,1,2,3
026 Corvara,92,,1,-,1
026 Corvara,94,,1,1,2
026 Corvara,95,,-,1,1
027 Graun im Vinschgau,0,,15,11,26
027 Graun im Vinschgau,1,,12,19,31
027 Graun im Vinschgau,2,,19,13,32
027 Graun im Vinschgau,3,,10,11,21
027 Graun im Vinschgau,4,,19,17,36
027 Graun im Vinschgau,5,,14,7,21
027 Graun im Vinschgau,6,,19,14,33
027 Graun im Vinschgau,7,,15,20,35
027 Graun im Vinschgau,8,,13,14,27
027 Graun im Vinschgau,9,,12,16,28
027 Graun im Vinschgau,10,,10,11,21
027 Graun im Vinschgau,11,,10,11,21
027 Graun im Vinschgau,12,,16,11,27
027 Graun im Vinschgau,13,,14,16,30
027 Graun im Vinschgau,14,,14,9,23
027 Graun im Vinschgau,15,,10,15,25
027 Graun im Vinschgau,16,,19,17,36
027 Graun im Vinschgau,17,,20,15,35
027 Graun im Vinschgau,18,,18,16,34
027 Graun im Vinschgau,19,,19,11,30
027 Graun im Vinschgau,20,,20,15,35
027 Graun im Vinschgau,21,,17,14,31
027 Graun im Vinschgau,22,,9,12,21
027 Graun im Vinschgau,23,,18,18,36
027 Graun im Vinschgau,24,,27,21,48
027 Graun im Vinschgau,25,,22,12,34
027 Graun im Vinschgau,26,,18,8,26
027 Graun im Vinschgau,27,,7,5,12
027 Graun im Vinschgau,28,,20,8,28
027 Graun im Vinschgau,29,,17,10,27
027 Graun im Vinschgau,30,,7,15,22
027 Graun im Vinschgau,31,,16,11,27
027 Graun im Vinschgau,32,,22,18,40
027 Graun im Vinschgau,33,,18,17,35
027 Graun im Vinschgau,34,,14,18,32
027 Graun im Vinschgau,35,,13,15,28
027 Graun im Vinschgau,36,,14,21,35
027 Graun im Vinschgau,37,,10,19,29
027 Graun im Vinschgau,38,,20,17,37
027 Graun im Vinschgau,39,,19,14,33
027 Graun im Vinschgau,40,,18,19,37
027 Graun im Vinschgau,41,,21,17,38
027 Graun im Vinschgau,42,,21,11,32
027 Graun im Vinschgau,43,,21,15,36
027 Graun im Vinschgau,44,,23,18,41
027 Graun im Vinschgau,45,,15,21,36
027 Graun im Vinschgau,46,,23,21,44
027 Graun im Vinschgau,47,,18,23,41
027 Graun im Vinschgau,48,,16,19,35
027 Graun im Vinschgau,49,,23,22,45
027 Graun im Vinschgau,50,,21,17,38
027 Graun im Vinschgau,51,,22,24,46
027 Graun im Vinschgau,52,,19,12,31
027 Graun im Vinschgau,53,,19,19,38
027 Graun im Vinschgau,54,,21,11,32
027 Graun im Vinschgau,55,,17,16,33
027 Graun im Vinschgau,56,,11,13,24
027 Graun im Vinschgau,57,,14,9,23
027 Graun im Vinschgau,58,,13,9,22
027 Graun im Vinschgau,59,,15,14,29
027 Graun im Vinschgau,60,,12,7,19
027 Graun im Vinschgau,61,,16,10,26
027 Graun im Vinschgau,62,,11,16,27
027 Graun im Vinschgau,63,,11,12,23
027 Graun im Vinschgau,64,,7,20,27
027 Graun im Vinschgau,65,,14,12,26
027 Graun im Vinschgau,66,,5,10,15
027 Graun im Vinschgau,67,,10,7,17
027 Graun im Vinschgau,68,,6,8,14
027 Graun im Vinschgau,69,,9,9,18
027 Graun im Vinschgau,70,,9,11,20
027 Graun im Vinschgau,71,,8,12,20
027 Graun im Vinschgau,72,,15,10,25
027 Graun im Vinschgau,73,,12,10,22
027 Graun im Vinschgau,74,,10,11,21
027 Graun im Vinschgau,75,,8,11,19
027 Graun im Vinschgau,76,,11,3,14
027 Graun im Vinschgau,77,,11,13,24
027 Graun im Vinschgau,78,,6,7,13
027 Graun im Vinschgau,79,,10,9,19
027 Graun im Vinschgau,80,,5,7,12
027 Graun im Vinschgau,81,,8,5,13
027 Graun im Vinschgau,82,,6,8,14
027 Graun im Vinschgau,83,,3,5,8
027 Graun im Vinschgau,84,,4,12,16
027 Graun im Vinschgau,85,,4,7,11
027 Graun im Vinschgau,86,,4,7,11
027 Graun im Vinschgau,87,,4,10,14
027 Graun im Vinschgau,88,,1,3,4
027 Graun im Vinschgau,89,,2,3,5
027 Graun im Vinschgau,90,,3,6,9
027 Graun im Vinschgau,91,,1,3,4
027 Graun im Vinschgau,92,,-,3,3
027 Graun im Vinschgau,93,,1,1,2
027 Graun im Vinschgau,94,,-,1,1
028 Toblach,0,,25,15,40
028 Toblach,1,,21,25,46
028 Toblach,2,,17,26,43
028 Toblach,3,,22,21,43
028 Toblach,4,,17,17,34
028 Toblach,5,,24,22,46
028 Toblach,6,,23,15,38
028 Toblach,7,,22,10,32
028 Toblach,8,,14,19,33
028 Toblach,9,,18,22,40
028 Toblach,10,,20,28,48
028 Toblach,11,,13,18,31
028 Toblach,12,,24,19,43
028 Toblach,13,,23,18,41
028 Toblach,14,,16,22,38
028 Toblach,15,,18,14,32
028 Toblach,16,,23,16,39
028 Toblach,17,,26,19,45
028 Toblach,18,,17,10,27
028 Toblach,19,,20,17,37
028 Toblach,20,,20,19,39
028 Toblach,21,,14,17,31
028 Toblach,22,,17,27,44
028 Toblach,23,,13,23,36
028 Toblach,24,,10,17,27
028 Toblach,25,,15,21,36
028 Toblach,26,,33,17,50
028 Toblach,27,,13,21,34
028 Toblach,28,,24,24,48
028 Toblach,29,,24,21,45
028 Toblach,30,,22,23,45
028 Toblach,31,,25,28,53
028 Toblach,32,,25,23,48
028 Toblach,33,,24,26,50
028 Toblach,34,,29,24,53
028 Toblach,35,,18,18,36
028 Toblach,36,,14,24,38
028 Toblach,37,,27,32,59
028 Toblach,38,,20,22,42
028 Toblach,39,,28,20,48
028 Toblach,40,,31,27,58
028 Toblach,41,,25,31,56
028 Toblach,42,,27,22,49
028 Toblach,43,,22,24,46
028 Toblach,44,,42,25,67
028 Toblach,45,,32,26,58
028 Toblach,46,,28,20,48
028 Toblach,47,,32,30,62
028 Toblach,48,,33,28,61
028 Toblach,49,,38,29,67
028 Toblach,50,,24,26,50
028 Toblach,51,,37,28,65
028 Toblach,52,,22,34,56
028 Toblach,53,,22,18,40
028 Toblach,54,,33,26,59
028 Toblach,55,,21,17,38
028 Toblach,56,,27,23,50
028 Toblach,57,,16,25,41
028 Toblach,58,,15,26,41
028 Toblach,59,,20,18,38
028 Toblach,60,,21,24,45
028 Toblach,61,,20,15,35
028 Toblach,62,,24,12,36
028 Toblach,63,,13,15,28
028 Toblach,64,,20,14,34
028 Toblach,65,,16,24,40
028 Toblach,66,,16,14,30
028 Toblach,67,,12,14,26
028 Toblach,68,,9,17,26
028 Toblach,69,,16,10,26
028 Toblach,70,,13,17,30
028 Toblach,71,,13,18,31
028 Toblach,72,,16,12,28
028 Toblach,73,,11,12,23
028 Toblach,74,,12,12,24
028 Toblach,75,,13,6,19
028 Toblach,76,,3,10,13
028 Toblach,77,,5,13,18
028 Toblach,78,,6,15,21
028 Toblach,79,,12,15,27
028 Toblach,80,,6,9,15
028 Toblach,81,,8,13,21
028 Toblach,82,,8,10,18
028 Toblach,83,,6,7,13
028 Toblach,84,,6,9,15
028 Toblach,85,,7,8,15
028 Toblach,86,,3,6,9
028 Toblach,87,,3,6,9
028 Toblach,88,,4,4,8
028 Toblach,89,,3,4,7
028 Toblach,90,,4,1,5
028 Toblach,91,,2,3,5
028 Toblach,92,,-,3,3
028 Toblach,93,,2,1,3
028 Toblach,94,,1,3,4
029 Neumarkt,0,,21,24,45
029 Neumarkt,1,,37,32,69
029 Neumarkt,2,,26,24,50
029 Neumarkt,3,,29,27,56
029 Neumarkt,4,,32,25,57
029 Neumarkt,5,,28,25,53
029 Neumarkt,6,,33,24,57
029 Neumarkt,7,,27,28,55
029 Neumarkt,8,,38,35,73
029 Neumarkt,9,,27,19,46
029 Neumarkt,10,,34,30,64
029 Neumarkt,11,,30,23,53
029 Neumarkt,12,,32,33,65
029 Neumarkt,13,,32,25,57
029 Neumarkt,14,,25,27,52
029 Neumarkt,15,,22,42,64
029 Neumarkt,16,,21,21,42
029 Neumarkt,17,,20,25,45
029 Neumarkt,18,,29,24,53
029 Neumarkt,19,,26,25,51
029 Neumarkt,20,,23,35,58
029 Neumarkt,21,,31,28,59
029 Neumarkt,22,,26,28,54
029 Neumarkt,23,,25,26,51
029 Neumarkt,24,,27,32,59
029 Neumarkt,25,,24,29,53
029 Neumarkt,26,,25,30,55
029 Neumarkt,27,,25,27,52
029 Neumarkt,28,,20,18,38
029 Neumarkt,29,,30,24,54
029 Neumarkt,30,,23,33,56
029 Neumarkt,31,,28,31,59
029 Neumarkt,32,,32,28,60
029 Neumarkt,33,,26,47,73
029 Neumarkt,34,,34,36,70
029 Neumarkt,35,,41,38,79
029 Neumarkt,36,,31,31,62
029 Neumarkt,37,,33,32,65
029 Neumarkt,38,,40,45,85
029 Neumarkt,39,,37,48,85
029 Neumarkt,40,,34,38,72
029 Neumarkt,41,,39,34,73
029 Neumarkt,42,,34,47,81
029 Neumarkt,43,,41,39,80
029 Neumarkt,44,,43,38,81
029 Neumarkt,45,,32,51,83
029 Neumarkt,46,,48,48,96
029 Neumarkt,47,,51,52,103
029 Neumarkt,48,,57,41,98
029 Neumarkt,49,,50,50,100
029 Neumarkt,50,,50,49,99
029 Neumarkt,51,,47,37,84
029 Neumarkt,52,,33,44,77
029 Neumarkt,53,,50,41,91
029 Neumarkt,54,,46,30,76
029 Neumarkt,55,,30,36,66
029 Neumarkt,56,,40,31,71
029 Neumarkt,57,,28,32,60
029 Neumarkt,58,,41,43,84
029 Neumarkt,59,,35,27,62
029 Neumarkt,60,,18,17,35
029 Neumarkt,61,,29,21,50
029 Neumarkt,62,,27,22,49
029 Neumarkt,63,,20,25,45
029 Neumarkt,64,,15,25,40
029 Neumarkt,65,,20,25,45
029 Neumarkt,66,,25,30,55
029 Neumarkt,67,,29,35,64
029 Neumarkt,68,,22,21,43
029 Neumarkt,69,,20,21,41
029 Neumarkt,70,,20,24,44
029 Neumarkt,71,,24,22,46
029 Neumarkt,72,,35,25,60
029 Neumarkt,73,,21,30,51
029 Neumarkt,74,,18,28,46
029 Neumarkt,75,,19,14,33
029 Neumarkt,76,,19,13,32
029 Neumarkt,77,,15,18,33
029 Neumarkt,78,,14,21,35
029 Neumarkt,79,,13,17,30
029 Neumarkt,80,,15,16,31
029 Neumarkt,81,,13,20,33
029 Neumarkt,82,,20,29,49
029 Neumarkt,83,,9,22,31
029 Neumarkt,84,,10,14,24
029 Neumarkt,85,,2,13,15
029 Neumarkt,86,,8,8,16
029 Neumarkt,87,,9,14,23
029 Neumarkt,88,,5,11,16
029 Neumarkt,89,,1,12,13
029 Neumarkt,90,,7,4,11
029 Neumarkt,91,,2,5,7
029 Neumarkt,92,,2,9,11
029 Neumarkt,93,,1,4,5
029 Neumarkt,94,,2,1,3
029 Neumarkt,96,,-,1,1
030 Pfalzen,0,,13,26,39
030 Pfalzen,1,,21,13,34
030 Pfalzen,2,,20,22,42
030 Pfalzen,3,,22,14,36
030 Pfalzen,4,,16,18,34
030 Pfalzen,5,,17,22,39
030 Pfalzen,6,,13,9,22
030 Pfalzen,7,,21,21,42
030 Pfalzen,8,,21,18,39
030 Pfalzen,9,,13,21,34
030 Pfalzen,10,,21,13,34
030 Pfalzen,11,,13,18,31
030 Pfalzen,12,,18,13,31
030 Pfalzen,13,,15,18,33
030 Pfalzen,14,,20,20,40
030 Pfalzen,15,,17,15,32
030 Pfalzen,16,,13,16,29
030 Pfalzen,17,,15,15,30
030 Pfalzen,18,,22,20,42
030 Pfalzen,19,,12,18,30
030 Pfalzen,20,,12,20,32
030 Pfalzen,21,,14,22,36
030 Pfalzen,22,,12,20,32
030 Pfalzen,23,,18,13,31
030 Pfalzen,24,,19,22,41
030 Pfalzen,25,,16,10,26
030 Pfalzen,26,,14,20,34
030 Pfalzen,27,,21,21,42
030 Pfalzen,28,,26,17,43
030 Pfalzen,29,,17,13,30
030 Pfalzen,30,,13,12,25
030 Pfalzen,31,,19,18,37
030 Pfalzen,32,,20,17,37
030 Pfalzen,33,,23,22,45
030 Pfalzen,34,,22,18,40
030 Pfalzen,35,,18,24,42
030 Pfalzen,36,,22,26,48
030 Pfalzen,37,,19,13,32
030 Pfalzen,38,,17,15,32
030 Pfalzen,39,,25,17,42
030 Pfalzen,40,,18,25,43
030 Pfalzen,41,,24,25,49
030 Pfalzen,42,,32,25,57
030 Pfalzen,43,,21,24,45
030 Pfalzen,44,,28,14,42
030 Pfalzen,45,,26,35,61
030 Pfalzen,46,,23,23,46
030 Pfalzen,47,,24,20,44
030 Pfalzen,48,,23,30,53
030 Pfalzen,49,,22,23,45
030 Pfalzen,50,,30,21,51
030 Pfalzen,51,,21,30,51
030 Pfalzen,52,,25,20,45
030 Pfalzen,53,,22,16,38
030 Pfalzen,54,,15,16,31
030 Pfalzen,55,,15,21,36
030 Pfalzen,56,,25,19,44
030 Pfalzen,57,,16,15,31
030 Pfalzen,58,,17,14,31
030 Pfalzen,59,,16,11,27
030 Pfalzen,60,,14,11,25
030 Pfalzen,61,,10,11,21
030 Pfalzen,62,,16,16,32
030 Pfalzen,63,,11,13,24
030 Pfalzen,64,,16,7,23
030 Pfalzen,65,,11,11,22
030 Pfalzen,66,,12,3,15
030 Pfalzen,67,,8,10,18
030 Pfalzen,68,,6,9,15
030 Pfalzen,69,,11,6,17
030 Pfalzen,70,,8,10,18
030 Pfalzen,71,,7,12,19
030 Pfalzen,72,,10,7,17
030 Pfalzen,73,,12,9,21
030 Pfalzen,74,,8,5,13
030 Pfalzen,75,,11,10,21
030 Pfalzen,76,,5,5,10
030 Pfalzen,77,,2,7,9
030 Pfalzen,78,,6,7,13
030 Pfalzen,79,,7,9,16
030 Pfalzen,80,,5,8,13
030 Pfalzen,81,,6,3,9
030 Pfalzen,82,,8,7,15
030 Pfalzen,83,,7,7,14
030 Pfalzen,84,,8,3,11
030 Pfalzen,85,,-,2,2
030 Pfalzen,86,,4,4,8
030 Pfalzen,87,,2,2,4
030 Pfalzen,88,,3,2,5
030 Pfalzen,89,,2,4,6
030 Pfalzen,90,,3,2,5
030 Pfalzen,91,,2,-,2
030 Pfalzen,92,,-,3,3
030 Pfalzen,93,,-,1,1
031 Völs am Schlern,0,,21,15,36
031 Völs am Schlern,1,,18,26,44
031 Völs am Schlern,2,,13,22,35
031 Völs am Schlern,3,,28,18,46
031 Völs am Schlern,4,,25,18,43
031 Völs am Schlern,5,,23,32,55
031 Völs am Schlern,6,,19,24,43
031 Völs am Schlern,7,,21,25,46
031 Völs am Schlern,8,,35,15,50
031 Völs am Schlern,9,,19,11,30
031 Völs am Schlern,10,,15,22,37
031 Völs am Schlern,11,,17,31,48
031 Völs am Schlern,12,,19,27,46
031 Völs am Schlern,13,,24,26,50
031 Völs am Schlern,14,,18,19,37
031 Völs am Schlern,15,,24,30,54
031 Völs am Schlern,16,,19,25,44
031 Völs am Schlern,17,,15,20,35
031 Völs am Schlern,18,,23,23,46
031 Völs am Schlern,19,,20,12,32
031 Völs am Schlern,20,,16,14,30
031 Völs am Schlern,21,,23,18,41
031 Völs am Schlern,22,,12,22,34
031 Völs am Schlern,23,,23,20,43
031 Völs am Schlern,24,,25,16,41
031 Völs am Schlern,25,,19,20,39
031 Völs am Schlern,26,,19,24,43
031 Völs am Schlern,27,,25,17,42
031 Völs am Schlern,28,,17,17,34
031 Völs am Schlern,29,,21,10,31
031 Völs am Schlern,30,,11,28,39
031 Völs am Schlern,31,,19,24,43
031 Völs am Schlern,32,,36,22,58
031 Völs am Schlern,33,,36,14,50
031 Völs am Schlern,34,,29,31,60
031 Völs am Schlern,35,,28,26,54
031 Völs am Schlern,36,,23,22,45
031 Völs am Schlern,37,,34,21,55
031 Völs am Schlern,38,,21,18,39
031 Völs am Schlern,39,,30,26,56
031 Völs am Schlern,40,,27,32,59
031 Völs am Schlern,41,,43,28,71
031 Völs am Schlern,42,,38,41,79
031 Völs am Schlern,43,,31,39,70
031 Völs am Schlern,44,,38,31,69
031 Völs am Schlern,45,,37,37,74
031 Völs am Schlern,46,,27,25,52
031 Völs am Schlern,47,,36,34,70
031 Völs am Schlern,48,,23,30,53
031 Völs am Schlern,49,,32,26,58
031 Völs am Schlern,50,,26,23,49
031 Völs am Schlern,51,,26,23,49
031 Völs am Schlern,52,,27,24,51
031 Völs am Schlern,53,,21,18,39
031 Völs am Schlern,54,,23,12,35
031 Völs am Schlern,55,,18,17,35
031 Völs am Schlern,56,,18,18,36
031 Völs am Schlern,57,,17,18,35
031 Völs am Schlern,58,,17,14,31
031 Völs am Schlern,59,,18,25,43
031 Völs am Schlern,60,,17,26,43
031 Völs am Schlern,61,,18,19,37
031 Völs am Schlern,62,,18,21,39
031 Völs am Schlern,63,,18,17,35
031 Völs am Schlern,64,,15,9,24
031 Völs am Schlern,65,,16,14,30
031 Völs am Schlern,66,,14,20,34
031 Völs am Schlern,67,,15,12,27
031 Völs am Schlern,68,,7,13,20
031 Völs am Schlern,69,,14,9,23
031 Völs am Schlern,70,,15,20,35
031 Völs am Schlern,71,,14,17,31
031 Völs am Schlern,72,,16,17,33
031 Völs am Schlern,73,,10,22,32
031 Völs am Schlern,74,,12,11,23
031 Völs am Schlern,75,,10,13,23
031 Völs am Schlern,76,,9,9,18
031 Völs am Schlern,77,,8,17,25
031 Völs am Schlern,78,,14,11,25
031 Völs am Schlern,79,,12,6,18
031 Völs am Schlern,80,,4,14,18
031 Völs am Schlern,81,,12,9,21
031 Völs am Schlern,82,,8,12,20
031 Völs am Schlern,83,,3,10,13
031 Völs am Schlern,84,,2,7,9
031 Völs am Schlern,85,,2,11,13
031 Völs am Schlern,86,,1,5,6
031 Völs am Schlern,87,,5,5,10
031 Völs am Schlern,88,,4,7,11
031 Völs am Schlern,89,,5,8,13
031 Völs am Schlern,90,,1,3,4
031 Völs am Schlern,91,,-,2,2
031 Völs am Schlern,92,,-,6,6
031 Völs am Schlern,93,,1,2,3
031 Völs am Schlern,94,,-,1,1
031 Völs am Schlern,95,,-,2,2
031 Völs am Schlern,96,,1,2,3
031 Völs am Schlern,98,,-,1,1
032 Franzensfeste,0,,6,3,9
032 Franzensfeste,1,,6,5,11
032 Franzensfeste,2,,7,7,14
032 Franzensfeste,3,,10,9,19
032 Franzensfeste,4,,2,4,6
032 Franzensfeste,5,,5,8,13
032 Franzensfeste,6,,8,5,13
032 Franzensfeste,7,,4,4,8
032 Franzensfeste,8,,3,5,8
032 Franzensfeste,9,,8,4,12
032 Franzensfeste,10,,8,3,11
032 Franzensfeste,11,,9,1,10
032 Franzensfeste,12,,3,6,9
032 Franzensfeste,13,,3,5,8
032 Franzensfeste,14,,4,4,8
032 Franzensfeste,15,,7,6,13
032 Franzensfeste,16,,4,5,9
032 Franzensfeste,17,,7,4,11
032 Franzensfeste,18,,4,2,6
032 Franzensfeste,19,,5,7,12
032 Franzensfeste,20,,8,6,14
032 Franzensfeste,21,,8,6,14
032 Franzensfeste,22,,5,7,12
032 Franzensfeste,23,,1,9,10
032 Franzensfeste,24,,7,5,12
032 Franzensfeste,25,,3,5,8
032 Franzensfeste,26,,10,6,16
032 Franzensfeste,27,,7,4,11
032 Franzensfeste,28,,6,6,12
032 Franzensfeste,29,,5,9,14
032 Franzensfeste,30,,4,10,14
032 Franzensfeste,31,,4,9,13
032 Franzensfeste,32,,9,7,16
032 Franzensfeste,33,,6,11,17
032 Franzensfeste,34,,12,4,16
032 Franzensfeste,35,,7,9,16
032 Franzensfeste,36,,5,5,10
032 Franzensfeste,37,,3,5,8
032 Franzensfeste,38,,7,11,18
032 Franzensfeste,39,,12,5,17
032 Franzensfeste,40,,2,6,8
032 Franzensfeste,41,,6,9,15
032 Franzensfeste,42,,5,5,10
032 Franzensfeste,43,,7,6,13
032 Franzensfeste,44,,9,7,16
032 Franzensfeste,45,,9,12,21
032 Franzensfeste,46,,11,3,14
032 Franzensfeste,47,,10,5,15
032 Franzensfeste,48,,11,9,20
032 Franzensfeste,49,,14,8,22
032 Franzensfeste,50,,8,11,19
032 Franzensfeste,51,,11,3,14
032 Franzensfeste,52,,5,5,10
032 Franzensfeste,53,,2,8,10
032 Franzensfeste,54,,6,8,14
032 Franzensfeste,55,,11,3,14
032 Franzensfeste,56,,4,6,10
032 Franzensfeste,57,,5,6,11
032 Franzensfeste,58,,9,6,15
032 Franzensfeste,59,,7,7,14
032 Franzensfeste,60,,5,7,12
032 Franzensfeste,61,,4,3,7
032 Franzensfeste,62,,7,1,8
032 Franzensfeste,63,,11,3,14
032 Franzensfeste,64,,2,4,6
032 Franzensfeste,65,,4,4,8
032 Franzensfeste,66,,2,3,5
032 Franzensfeste,67,,8,4,12
032 Franzensfeste,68,,3,6,9
032 Franzensfeste,69,,4,7,11
032 Franzensfeste,70,,4,2,6
032 Franzensfeste,71,,4,1,5
032 Franzensfeste,72,,4,3,7
032 Franzensfeste,73,,2,4,6
032 Franzensfeste,74,,3,2,5
032 Franzensfeste,75,,1,3,4
032 Franzensfeste,76,,6,5,11
032 Franzensfeste,77,,1,1,2
032 Franzensfeste,78,,1,2,3
032 Franzensfeste,79,,2,3,5
032 Franzensfeste,80,,-,3,3
032 Franzensfeste,81,,3,4,7
032 Franzensfeste,82,,1,4,5
032 Franzensfeste,83,,6,3,9
032 Franzensfeste,84,,-,5,5
032 Franzensfeste,85,,-,4,4
032 Franzensfeste,86,,2,2,4
032 Franzensfeste,87,,-,6,6
032 Franzensfeste,88,,1,1,2
032 Franzensfeste,89,,3,3,6
032 Franzensfeste,90,,2,5,7
032 Franzensfeste,91,,2,2,4
032 Franzensfeste,92,,-,1,1
032 Franzensfeste,93,,-,1,1
033 Villnöss,0,,13,11,24
033 Villnöss,1,,17,16,33
033 Villnöss,2,,9,22,31
033 Villnöss,3,,17,18,35
033 Villnöss,4,,17,13,30
033 Villnöss,5,,18,9,27
033 Villnöss,6,,16,14,30
033 Villnöss,7,,15,25,40
033 Villnöss,8,,20,22,42
033 Villnöss,9,,11,16,27
033 Villnöss,10,,17,14,31
033 Villnöss,11,,21,15,36
033 Villnöss,12,,16,23,39
033 Villnöss,13,,18,14,32
033 Villnöss,14,,16,30,46
033 Villnöss,15,,24,19,43
033 Villnöss,16,,20,23,43
033 Villnöss,17,,21,17,38
033 Villnöss,18,,18,13,31
033 Villnöss,19,,14,11,25
033 Villnöss,20,,17,12,29
033 Villnöss,21,,14,14,28
033 Villnöss,22,,22,16,38
033 Villnöss,23,,14,12,26
033 Villnöss,24,,13,11,24
033 Villnöss,25,,14,19,33
033 Villnöss,26,,17,16,33
033 Villnöss,27,,12,16,28
033 Villnöss,28,,13,15,28
033 Villnöss,29,,16,17,33
033 Villnöss,30,,16,15,31
033 Villnöss,31,,10,13,23
033 Villnöss,32,,11,19,30
033 Villnöss,33,,24,11,35
033 Villnöss,34,,9,13,22
033 Villnöss,35,,15,14,29
033 Villnöss,36,,12,13,25
033 Villnöss,37,,17,13,30
033 Villnöss,38,,21,16,37
033 Villnöss,39,,19,14,33
033 Villnöss,40,,13,18,31
033 Villnöss,41,,16,27,43
033 Villnöss,42,,22,24,46
033 Villnöss,43,,17,28,45
033 Villnöss,44,,29,23,52
033 Villnöss,45,,27,20,47
033 Villnöss,46,,17,19,36
033 Villnöss,47,,28,19,47
033 Villnöss,48,,29,22,51
033 Villnöss,49,,32,25,57
033 Villnöss,50,,31,20,51
033 Villnöss,51,,28,20,48
033 Villnöss,52,,21,14,35
033 Villnöss,53,,21,12,33
033 Villnöss,54,,11,10,21
033 Villnöss,55,,11,14,25
033 Villnöss,56,,14,13,27
033 Villnöss,57,,15,16,31
033 Villnöss,58,,12,3,15
033 Villnöss,59,,16,13,29
033 Villnöss,60,,14,15,29
033 Villnöss,61,,10,13,23
033 Villnöss,62,,11,10,21
033 Villnöss,63,,6,9,15
033 Villnöss,64,,7,13,20
033 Villnöss,65,,8,10,18
033 Villnöss,66,,13,11,24
033 Villnöss,67,,9,5,14
033 Villnöss,68,,8,4,12
033 Villnöss,69,,6,12,18
033 Villnöss,70,,11,9,20
033 Villnöss,71,,12,19,31
033 Villnöss,72,,11,9,20
033 Villnöss,73,,6,17,23
033 Villnöss,74,,12,13,25
033 Villnöss,75,,10,8,18
033 Villnöss,76,,7,15,22
033 Villnöss,77,,4,15,19
033 Villnöss,78,,2,8,10
033 Villnöss,79,,7,8,15
033 Villnöss,80,,9,10,19
033 Villnöss,81,,11,11,22
033 Villnöss,82,,7,11,18
033 Villnöss,83,,6,11,17
033 Villnöss,84,,7,9,16
033 Villnöss,85,,10,6,16
033 Villnöss,86,,5,7,12
033 Villnöss,87,,1,6,7
033 Villnöss,88,,2,6,8
033 Villnöss,89,,1,6,7
033 Villnöss,90,,2,7,9
033 Villnöss,91,,1,4,5
033 Villnöss,92,,-,3,3
033 Villnöss,93,,-,3,3
033 Villnöss,94,,-,1,1
033 Villnöss,100,,-,1,1
034 Gais,0,,18,14,32
034 Gais,1,,16,15,31
034 Gais,2,,20,21,41
034 Gais,3,,27,16,43
034 Gais,4,,27,14,41
034 Gais,5,,14,18,32
034 Gais,6,,15,19,34
034 Gais,7,,22,15,37
034 Gais,8,,26,16,42
034 Gais,9,,15,26,41
034 Gais,10,,16,16,32
034 Gais,11,,22,22,44
034 Gais,12,,20,17,37
034 Gais,13,,20,16,36
034 Gais,14,,20,23,43
034 Gais,15,,25,19,44
034 Gais,16,,28,14,42
034 Gais,17,,7,16,23
034 Gais,18,,27,18,45
034 Gais,19,,26,26,52
034 Gais,20,,14,20,34
034 Gais,21,,20,31,51
034 Gais,22,,25,29,54
034 Gais,23,,14,20,34
034 Gais,24,,17,11,28
034 Gais,25,,14,18,32
034 Gais,26,,19,19,38
034 Gais,27,,16,24,40
034 Gais,28,,15,14,29
034 Gais,29,,26,19,45
034 Gais,30,,18,26,44
034 Gais,31,,24,20,44
034 Gais,32,,20,22,42
034 Gais,33,,25,24,49
034 Gais,34,,21,17,38
034 Gais,35,,19,22,41
034 Gais,36,,18,23,41
034 Gais,37,,22,22,44
034 Gais,38,,25,21,46
034 Gais,39,,33,29,62
034 Gais,40,,26,24,50
034 Gais,41,,33,40,73
034 Gais,42,,35,27,62
034 Gais,43,,29,26,55
034 Gais,44,,40,33,73
034 Gais,45,,24,20,44
034 Gais,46,,27,31,58
034 Gais,47,,32,22,54
034 Gais,48,,22,24,46
034 Gais,49,,30,32,62
034 Gais,50,,18,18,36
034 Gais,51,,29,21,50
034 Gais,52,,21,30,51
034 Gais,53,,16,12,28
034 Gais,54,,17,22,39
034 Gais,55,,23,18,41
034 Gais,56,,12,16,28
034 Gais,57,,22,20,42
034 Gais,58,,18,10,28
034 Gais,59,,17,14,31
034 Gais,60,,12,12,24
034 Gais,61,,14,18,32
034 Gais,62,,14,20,34
034 Gais,63,,21,23,44
034 Gais,64,,14,11,25
034 Gais,65,,22,13,35
034 Gais,66,,20,11,31
034 Gais,67,,16,15,31
034 Gais,68,,13,8,21
034 Gais,69,,12,13,25
034 Gais,70,,11,16,27
034 Gais,71,,10,13,23
034 Gais,72,,18,12,30
034 Gais,73,,16,12,28
034 Gais,74,,11,14,25
034 Gais,75,,14,13,27
034 Gais,76,,14,14,28
034 Gais,77,,7,13,20
034 Gais,78,,10,11,21
034 Gais,79,,4,5,9
034 Gais,80,,5,9,14
034 Gais,81,,3,6,9
034 Gais,82,,8,5,13
034 Gais,83,,4,9,13
034 Gais,84,,1,1,2
034 Gais,85,,4,7,11
034 Gais,86,,6,7,13
034 Gais,87,,4,4,8
034 Gais,88,,2,2,4
034 Gais,89,,1,2,3
034 Gais,90,,-,3,3
034 Gais,91,,1,2,3
034 Gais,92,,-,1,1
034 Gais,93,,1,-,1
034 Gais,95,,1,1,2
035 Gargazon,0,,12,7,19
035 Gargazon,1,,8,12,20
035 Gargazon,2,,8,9,17
035 Gargazon,3,,7,12,19
035 Gargazon,4,,6,11,17
035 Gargazon,5,,12,8,20
035 Gargazon,6,,8,6,14
035 Gargazon,7,,10,13,23
035 Gargazon,8,,7,7,14
035 Gargazon,9,,8,7,15
035 Gargazon,10,,6,14,20
035 Gargazon,11,,6,12,18
035 Gargazon,12,,5,7,12
035 Gargazon,13,,11,4,15
035 Gargazon,14,,14,8,22
035 Gargazon,15,,14,10,24
035 Gargazon,16,,5,14,19
035 Gargazon,17,,11,7,18
035 Gargazon,18,,11,4,15
035 Gargazon,19,,4,8,12
035 Gargazon,20,,10,6,16
035 Gargazon,21,,14,9,23
035 Gargazon,22,,18,11,29
035 Gargazon,23,,8,13,21
035 Gargazon,24,,10,5,15
035 Gargazon,25,,11,5,16
035 Gargazon,26,,8,10,18
035 Gargazon,27,,6,12,18
035 Gargazon,28,,14,10,24
035 Gargazon,29,,9,6,15
035 Gargazon,30,,7,12,19
035 Gargazon,31,,9,8,17
035 Gargazon,32,,12,11,23
035 Gargazon,33,,11,15,26
035 Gargazon,34,,4,4,8
035 Gargazon,35,,5,16,21
035 Gargazon,36,,10,12,22
035 Gargazon,37,,6,13,19
035 Gargazon,38,,10,10,20
035 Gargazon,39,,13,18,31
035 Gargazon,40,,14,10,24
035 Gargazon,41,,12,19,31
035 Gargazon,42,,17,16,33
035 Gargazon,43,,15,12,27
035 Gargazon,44,,24,13,37
035 Gargazon,45,,19,18,37
035 Gargazon,46,,13,15,28
035 Gargazon,47,,13,18,31
035 Gargazon,48,,14,9,23
035 Gargazon,49,,17,16,33
035 Gargazon,50,,19,21,40
035 Gargazon,51,,17,14,31
035 Gargazon,52,,9,15,24
035 Gargazon,53,,9,12,21
035 Gargazon,54,,18,14,32
035 Gargazon,55,,7,11,18
035 Gargazon,56,,14,13,27
035 Gargazon,57,,12,6,18
035 Gargazon,58,,9,5,14
035 Gargazon,59,,10,11,21
035 Gargazon,60,,19,11,30
035 Gargazon,61,,4,9,13
035 Gargazon,62,,9,8,17
035 Gargazon,63,,8,8,16
035 Gargazon,64,,6,9,15
035 Gargazon,65,,7,9,16
035 Gargazon,66,,5,7,12
035 Gargazon,67,,11,15,26
035 Gargazon,68,,10,6,16
035 Gargazon,69,,2,4,6
035 Gargazon,70,,6,10,16
035 Gargazon,71,,5,8,13
035 Gargazon,72,,9,9,18
035 Gargazon,73,,5,16,21
035 Gargazon,74,,8,6,14
035 Gargazon,75,,8,7,15
035 Gargazon,76,,7,11,18
035 Gargazon,77,,3,3,6
035 Gargazon,78,,11,2,13
035 Gargazon,79,,5,7,12
035 Gargazon,80,,1,9,10
035 Gargazon,81,,5,2,7
035 Gargazon,82,,3,7,10
035 Gargazon,83,,3,4,7
035 Gargazon,84,,1,3,4
035 Gargazon,85,,2,2,4
035 Gargazon,86,,2,5,7
035 Gargazon,87,,3,1,4
035 Gargazon,88,,1,1,2
035 Gargazon,89,,-,3,3
035 Gargazon,90,,3,3,6
035 Gargazon,91,,1,3,4
035 Gargazon,92,,-,2,2
035 Gargazon,97,,-,1,1
035 Gargazon,100,,-,2,2
036 Glurns,0,,8,4,12
036 Glurns,1,,8,3,11
036 Glurns,2,,3,5,8
036 Glurns,3,,4,4,8
036 Glurns,4,,3,4,7
036 Glurns,5,,9,2,11
036 Glurns,6,,5,2,7
036 Glurns,7,,4,8,12
036 Glurns,8,,6,6,12
036 Glurns,9,,3,5,8
036 Glurns,10,,6,6,12
036 Glurns,11,,5,4,9
036 Glurns,12,,5,1,6
036 Glurns,13,,5,3,8
036 Glurns,14,,3,2,5
036 Glurns,15,,10,3,13
036 Glurns,16,,4,7,11
036 Glurns,17,,7,4,11
036 Glurns,18,,6,4,10
036 Glurns,19,,2,3,5
036 Glurns,20,,7,7,14
036 Glurns,21,,4,8,12
036 Glurns,22,,8,2,10
036 Glurns,23,,8,6,14
036 Glurns,24,,4,4,8
036 Glurns,25,,5,8,13
036 Glurns,26,,3,7,10
036 Glurns,27,,5,7,12
036 Glurns,28,,3,3,6
036 Glurns,29,,8,6,14
036 Glurns,30,,9,5,14
036 Glurns,31,,11,7,18
036 Glurns,32,,7,4,11
036 Glurns,33,,12,5,17
036 Glurns,34,,3,7,10
036 Glurns,35,,6,6,12
036 Glurns,36,,2,2,4
036 Glurns,37,,13,3,16
036 Glurns,38,,6,8,14
036 Glurns,39,,8,11,19
036 Glurns,40,,3,3,6
036 Glurns,41,,5,7,12
036 Glurns,42,,7,5,12
036 Glurns,43,,5,2,7
036 Glurns,44,,2,6,8
036 Glurns,45,,7,4,11
036 Glurns,46,,4,9,13
036 Glurns,47,,6,7,13
036 Glurns,48,,2,7,9
036 Glurns,49,,10,5,15
036 Glurns,50,,5,8,13
036 Glurns,51,,6,5,11
036 Glurns,52,,6,6,12
036 Glurns,53,,5,9,14
036 Glurns,54,,12,6,18
036 Glurns,55,,3,9,12
036 Glurns,56,,6,12,18
036 Glurns,57,,6,6,12
036 Glurns,58,,8,7,15
036 Glurns,59,,12,3,15
036 Glurns,60,,8,10,18
036 Glurns,61,,4,8,12
036 Glurns,62,,8,9,17
036 Glurns,63,,6,5,11
036 Glurns,64,,6,3,9
036 Glurns,65,,7,5,12
036 Glurns,66,,10,7,17
036 Glurns,67,,8,2,10
036 Glurns,68,,6,1,7
036 Glurns,69,,5,4,9
036 Glurns,70,,1,4,5
036 Glurns,71,,4,6,10
036 Glurns,72,,3,2,5
036 Glurns,73,,6,1,7
036 Glurns,74,,2,3,5
036 Glurns,75,,4,4,8
036 Glurns,76,,4,4,8
036 Glurns,77,,-,2,2
036 Glurns,78,,2,4,6
036 Glurns,79,,1,5,6
036 Glurns,80,,1,1,2
036 Glurns,81,,5,2,7
036 Glurns,82,,4,1,5
036 Glurns,83,,-,2,2
036 Glurns,84,,2,6,8
036 Glurns,85,,-,1,1
036 Glurns,86,,-,2,2
036 Glurns,88,,1,1,2
036 Glurns,89,,-,1,1
036 Glurns,92,,2,-,2
036 Glurns,98,,-,1,1
037 Latsch,0,,28,33,61
037 Latsch,1,,32,29,61
037 Latsch,2,,24,20,44
037 Latsch,3,,23,18,41
037 Latsch,4,,21,32,53
037 Latsch,5,,17,24,41
037 Latsch,6,,31,29,60
037 Latsch,7,,28,24,52
037 Latsch,8,,21,29,50
037 Latsch,9,,30,24,54
037 Latsch,10,,28,23,51
037 Latsch,11,,27,28,55
037 Latsch,12,,36,19,55
037 Latsch,13,,36,32,68
037 Latsch,14,,33,19,52
037 Latsch,15,,26,20,46
037 Latsch,16,,36,39,75
037 Latsch,17,,37,33,70
037 Latsch,18,,48,32,80
037 Latsch,19,,41,23,64
037 Latsch,20,,32,32,64
037 Latsch,21,,34,36,70
037 Latsch,22,,29,37,66
037 Latsch,23,,41,50,91
037 Latsch,24,,33,31,64
037 Latsch,25,,38,39,77
037 Latsch,26,,27,33,60
037 Latsch,27,,41,30,71
037 Latsch,28,,35,37,72
037 Latsch,29,,41,30,71
037 Latsch,30,,25,29,54
037 Latsch,31,,33,37,70
037 Latsch,32,,28,44,72
037 Latsch,33,,31,33,64
037 Latsch,34,,39,35,74
037 Latsch,35,,33,25,58
037 Latsch,36,,34,33,67
037 Latsch,37,,28,25,53
037 Latsch,38,,32,37,69
037 Latsch,39,,28,27,55
037 Latsch,40,,32,33,65
037 Latsch,41,,34,42,76
037 Latsch,42,,45,40,85
037 Latsch,43,,34,35,69
037 Latsch,44,,42,41,83
037 Latsch,45,,45,52,97
037 Latsch,46,,50,50,100
037 Latsch,47,,29,47,76
037 Latsch,48,,56,47,103
037 Latsch,49,,58,44,102
037 Latsch,50,,54,48,102
037 Latsch,51,,41,49,90
037 Latsch,52,,43,42,85
037 Latsch,53,,37,49,86
037 Latsch,54,,43,46,89
037 Latsch,55,,40,29,69
037 Latsch,56,,28,34,62
037 Latsch,57,,30,33,63
037 Latsch,58,,35,27,62
037 Latsch,59,,26,18,44
037 Latsch,60,,23,23,46
037 Latsch,61,,37,20,57
037 Latsch,62,,20,31,51
037 Latsch,63,,31,15,46
037 Latsch,64,,16,20,36
037 Latsch,65,,13,20,33
037 Latsch,66,,17,16,33
037 Latsch,67,,16,20,36
037 Latsch,68,,15,20,35
037 Latsch,69,,20,12,32
037 Latsch,70,,23,21,44
037 Latsch,71,,22,25,47
037 Latsch,72,,16,23,39
037 Latsch,73,,19,22,41
037 Latsch,74,,18,18,36
037 Latsch,75,,14,25,39
037 Latsch,76,,11,23,34
037 Latsch,77,,16,13,29
037 Latsch,78,,23,13,36
037 Latsch,79,,14,25,39
037 Latsch,80,,13,23,36
037 Latsch,81,,18,18,36
037 Latsch,82,,11,18,29
037 Latsch,83,,13,14,27
037 Latsch,84,,14,11,25
037 Latsch,85,,15,16,31
037 Latsch,86,,6,14,20
037 Latsch,87,,8,10,18
037 Latsch,88,,9,11,20
037 Latsch,89,,3,7,10
037 Latsch,90,,3,5,8
037 Latsch,91,,3,5,8
037 Latsch,92,,3,4,7
037 Latsch,93,,3,1,4
037 Latsch,94,,1,-,1
037 Latsch,100,,-,1,1
037 Latsch,101,,-,1,1
037 Latsch,104,,-,1,1
038 Algund,0,,23,29,52
038 Algund,1,,21,31,52
038 Algund,2,,23,20,43
038 Algund,3,,25,24,49
038 Algund,4,,19,38,57
038 Algund,5,,23,20,43
038 Algund,6,,20,20,40
038 Algund,7,,24,22,46
038 Algund,8,,22,26,48
038 Algund,9,,24,23,47
038 Algund,10,,30,27,57
038 Algund,11,,25,26,51
038 Algund,12,,35,24,59
038 Algund,13,,22,35,57
038 Algund,14,,43,27,70
038 Algund,15,,25,22,47
038 Algund,16,,30,21,51
038 Algund,17,,20,23,43
038 Algund,18,,30,22,52
038 Algund,19,,30,25,55
038 Algund,20,,28,23,51
038 Algund,21,,32,24,56
038 Algund,22,,29,23,52
038 Algund,23,,36,22,58
038 Algund,24,,23,35,58
038 Algund,25,,26,34,60
038 Algund,26,,30,27,57
038 Algund,27,,28,31,59
038 Algund,28,,30,27,57
038 Algund,29,,24,32,56
038 Algund,30,,28,34,62
038 Algund,31,,25,30,55
038 Algund,32,,33,33,66
038 Algund,33,,36,37,73
038 Algund,34,,25,39,64
038 Algund,35,,33,36,69
038 Algund,36,,32,40,72
038 Algund,37,,32,36,68
038 Algund,38,,38,43,81
038 Algund,39,,36,42,78
038 Algund,40,,37,35,72
038 Algund,41,,49,39,88
038 Algund,42,,44,44,88
038 Algund,43,,50,45,95
038 Algund,44,,46,51,97
038 Algund,45,,42,34,76
038 Algund,46,,39,48,87
038 Algund,47,,40,45,85
038 Algund,48,,42,49,91
038 Algund,49,,54,26,80
038 Algund,50,,42,41,83
038 Algund,51,,37,44,81
038 Algund,52,,31,56,87
038 Algund,53,,38,45,83
038 Algund,54,,38,39,77
038 Algund,55,,41,31,72
038 Algund,56,,26,36,62
038 Algund,57,,35,30,65
038 Algund,58,,24,29,53
038 Algund,59,,37,26,63
038 Algund,60,,18,30,48
038 Algund,61,,26,26,52
038 Algund,62,,28,31,59
038 Algund,63,,23,28,51
038 Algund,64,,19,26,45
038 Algund,65,,26,21,47
038 Algund,66,,16,20,36
038 Algund,67,,28,30,58
038 Algund,68,,25,24,49
038 Algund,69,,23,28,51
038 Algund,70,,21,22,43
038 Algund,71,,15,32,47
038 Algund,72,,17,20,37
038 Algund,73,,17,23,40
038 Algund,74,,21,28,49
038 Algund,75,,17,20,37
038 Algund,76,,16,15,31
038 Algund,77,,13,25,38
038 Algund,78,,11,17,28
038 Algund,79,,22,23,45
038 Algund,80,,15,19,34
038 Algund,81,,11,18,29
038 Algund,82,,9,19,28
038 Algund,83,,10,19,29
038 Algund,84,,6,18,24
038 Algund,85,,6,14,20
038 Algund,86,,7,10,17
038 Algund,87,,7,11,18
038 Algund,88,,6,10,16
038 Algund,89,,3,8,11
038 Algund,90,,-,3,3
038 Algund,91,,2,10,12
038 Algund,92,,1,5,6
038 Algund,93,,3,2,5
038 Algund,94,,1,5,6
038 Algund,95,,-,2,2
038 Algund,96,,-,1,1
038 Algund,97,,1,1,2
038 Algund,99,,-,1,1
038 Algund,101,,-,1,1
038 Algund,102,,-,1,1
039 Lajen,0,,22,17,39
039 Lajen,1,,22,16,38
039 Lajen,2,,19,15,34
039 Lajen,3,,17,21,38
039 Lajen,4,,19,8,27
039 Lajen,5,,18,16,34
039 Lajen,6,,17,23,40
039 Lajen,7,,12,21,33
039 Lajen,8,,19,15,34
039 Lajen,9,,17,23,40
039 Lajen,10,,20,22,42
039 Lajen,11,,22,8,30
039 Lajen,12,,20,21,41
039 Lajen,13,,28,16,44
039 Lajen,14,,17,16,33
039 Lajen,15,,18,18,36
039 Lajen,16,,15,23,38
039 Lajen,17,,15,12,27
039 Lajen,18,,10,11,21
039 Lajen,19,,14,13,27
039 Lajen,20,,12,13,25
039 Lajen,21,,15,9,24
039 Lajen,22,,20,19,39
039 Lajen,23,,9,9,18
039 Lajen,24,,17,14,31
039 Lajen,25,,11,13,24
039 Lajen,26,,12,10,22
039 Lajen,27,,16,16,32
039 Lajen,28,,21,11,32
039 Lajen,29,,12,12,24
039 Lajen,30,,11,24,35
039 Lajen,31,,15,18,33
039 Lajen,32,,10,25,35
039 Lajen,33,,20,18,38
039 Lajen,34,,23,19,42
039 Lajen,35,,22,24,46
039 Lajen,36,,21,15,36
039 Lajen,37,,28,19,47
039 Lajen,38,,20,26,46
039 Lajen,39,,33,18,51
039 Lajen,40,,23,21,44
039 Lajen,41,,18,29,47
039 Lajen,42,,18,22,40
039 Lajen,43,,15,29,44
039 Lajen,44,,35,24,59
039 Lajen,45,,22,23,45
039 Lajen,46,,23,26,49
039 Lajen,47,,23,16,39
039 Lajen,48,,29,20,49
039 Lajen,49,,23,20,43
039 Lajen,50,,18,12,30
039 Lajen,51,,33,19,52
039 Lajen,52,,10,18,28
039 Lajen,53,,11,9,20
039 Lajen,54,,19,25,44
039 Lajen,55,,22,12,34
039 Lajen,56,,13,12,25
039 Lajen,57,,11,13,24
039 Lajen,58,,12,13,25
039 Lajen,59,,7,14,21
039 Lajen,60,,10,7,17
039 Lajen,61,,8,11,19
039 Lajen,62,,9,11,20
039 Lajen,63,,13,11,24
039 Lajen,64,,4,14,18
039 Lajen,65,,9,15,24
039 Lajen,66,,15,6,21
039 Lajen,67,,13,16,29
039 Lajen,68,,9,12,21
039 Lajen,69,,14,9,23
039 Lajen,70,,12,13,25
039 Lajen,71,,12,13,25
039 Lajen,72,,14,15,29
039 Lajen,73,,15,8,23
039 Lajen,74,,9,8,17
039 Lajen,75,,6,16,22
039 Lajen,76,,6,11,17
039 Lajen,77,,5,7,12
039 Lajen,78,,5,6,11
039 Lajen,79,,6,6,12
039 Lajen,80,,5,10,15
039 Lajen,81,,10,3,13
039 Lajen,82,,2,6,8
039 Lajen,83,,6,4,10
039 Lajen,84,,3,6,9
039 Lajen,85,,5,5,10
039 Lajen,86,,5,7,12
039 Lajen,87,,3,6,9
039 Lajen,88,,1,2,3
039 Lajen,89,,1,7,8
039 Lajen,90,,-,4,4
039 Lajen,91,,1,5,6
039 Lajen,92,,-,2,2
039 Lajen,93,,-,1,1
039 Lajen,100,,1,-,1
039 Lajen,103,,-,1,1
040 Leifers,0,,91,77,168
040 Leifers,1,,109,86,195
040 Leifers,2,,114,88,202
040 Leifers,3,,107,101,208
040 Leifers,4,,94,83,177
040 Leifers,5,,108,95,203
040 Leifers,6,,99,91,190
040 Leifers,7,,90,88,178
040 Leifers,8,,98,71,169
040 Leifers,9,,87,76,163
040 Leifers,10,,107,92,199
040 Leifers,11,,89,95,184
040 Leifers,12,,89,84,173
040 Leifers,13,,95,96,191
040 Leifers,14,,94,92,186
040 Leifers,15,,81,109,190
040 Leifers,16,,111,76,187
040 Leifers,17,,104,88,192
040 Leifers,18,,97,96,193
040 Leifers,19,,96,95,191
040 Leifers,20,,94,80,174
040 Leifers,21,,87,87,174
040 Leifers,22,,100,89,189
040 Leifers,23,,94,93,187
040 Leifers,24,,87,105,192
040 Leifers,25,,88,96,184
040 Leifers,26,,96,87,183
040 Leifers,27,,103,98,201
040 Leifers,28,,102,86,188
040 Leifers,29,,119,86,205
040 Leifers,30,,145,118,263
040 Leifers,31,,121,99,220
040 Leifers,32,,97,97,194
040 Leifers,33,,94,103,197
040 Leifers,34,,104,121,225
040 Leifers,35,,125,98,223
040 Leifers,36,,117,135,252
040 Leifers,37,,126,120,246
040 Leifers,38,,146,142,288
040 Leifers,39,,156,158,314
040 Leifers,40,,156,153,309
040 Leifers,41,,150,147,297
040 Leifers,42,,143,142,285
040 Leifers,43,,167,152,319
040 Leifers,44,,171,138,309
040 Leifers,45,,150,172,322
040 Leifers,46,,143,128,271
040 Leifers,47,,148,143,291
040 Leifers,48,,152,133,285
040 Leifers,49,,159,163,322
040 Leifers,50,,145,136,281
040 Leifers,51,,142,127,269
040 Leifers,52,,136,144,280
040 Leifers,53,,135,122,257
040 Leifers,54,,117,112,229
040 Leifers,55,,97,112,209
040 Leifers,56,,97,115,212
040 Leifers,57,,138,126,264
040 Leifers,58,,105,125,230
040 Leifers,59,,86,110,196
040 Leifers,60,,103,119,222
040 Leifers,61,,102,101,203
040 Leifers,62,,89,90,179
040 Leifers,63,,97,92,189
040 Leifers,64,,84,95,179
040 Leifers,65,,103,104,207
040 Leifers,66,,90,99,189
040 Leifers,67,,104,143,247
040 Leifers,68,,72,77,149
040 Leifers,69,,81,89,170
040 Leifers,70,,89,90,179
040 Leifers,71,,82,92,174
040 Leifers,72,,78,79,157
040 Leifers,73,,86,83,169
040 Leifers,74,,83,91,174
040 Leifers,75,,74,72,146
040 Leifers,76,,46,73,119
040 Leifers,77,,43,62,105
040 Leifers,78,,46,61,107
040 Leifers,79,,47,57,104
040 Leifers,80,,33,55,88
040 Leifers,81,,51,67,118
040 Leifers,82,,33,52,85
040 Leifers,83,,28,48,76
040 Leifers,84,,25,39,64
040 Leifers,85,,23,26,49
040 Leifers,86,,18,38,56
040 Leifers,87,,10,32,42
040 Leifers,88,,12,33,45
040 Leifers,89,,11,28,39
040 Leifers,90,,6,28,34
040 Leifers,91,,10,16,26
040 Leifers,92,,5,11,16
040 Leifers,93,,4,5,9
040 Leifers,94,,1,14,15
040 Leifers,95,,1,3,4
040 Leifers,96,,-,3,3
040 Leifers,97,,-,3,3
040 Leifers,98,,-,3,3
040 Leifers,99,,-,1,1
040 Leifers,100,,-,4,4
040 Leifers,101,,-,1,1
040 Leifers,102,,1,-,1
041 Lana,0,,59,79,138
041 Lana,1,,63,55,118
041 Lana,2,,71,70,141
041 Lana,3,,58,65,123
041 Lana,4,,66,47,113
041 Lana,5,,67,63,130
041 Lana,6,,71,56,127
041 Lana,7,,68,57,125
041 Lana,8,,70,68,138
041 Lana,9,,75,55,130
041 Lana,10,,62,63,125
041 Lana,11,,61,54,115
041 Lana,12,,73,55,128
041 Lana,13,,72,70,142
041 Lana,14,,71,63,134
041 Lana,15,,64,61,125
041 Lana,16,,60,67,127
041 Lana,17,,76,81,157
041 Lana,18,,67,68,135
041 Lana,19,,69,74,143
041 Lana,20,,60,63,123
041 Lana,21,,60,58,118
041 Lana,22,,66,61,127
041 Lana,23,,51,74,125
041 Lana,24,,48,73,121
041 Lana,25,,67,66,133
041 Lana,26,,76,60,136
041 Lana,27,,70,61,131
041 Lana,28,,57,82,139
041 Lana,29,,61,73,134
041 Lana,30,,96,81,177
041 Lana,31,,88,77,165
041 Lana,32,,65,85,150
041 Lana,33,,65,72,137
041 Lana,34,,77,96,173
041 Lana,35,,82,84,166
041 Lana,36,,66,71,137
041 Lana,37,,82,93,175
041 Lana,38,,71,94,165
041 Lana,39,,97,89,186
041 Lana,40,,80,92,172
041 Lana,41,,109,96,205
041 Lana,42,,98,108,206
041 Lana,43,,104,105,209
041 Lana,44,,125,81,206
041 Lana,45,,82,106,188
041 Lana,46,,95,96,191
041 Lana,47,,99,111,210
041 Lana,48,,97,95,192
041 Lana,49,,107,106,213
041 Lana,50,,104,80,184
041 Lana,51,,88,80,168
041 Lana,52,,88,90,178
041 Lana,53,,77,80,157
041 Lana,54,,83,80,163
041 Lana,55,,77,87,164
041 Lana,56,,74,80,154
041 Lana,57,,58,62,120
041 Lana,58,,59,75,134
041 Lana,59,,55,64,119
041 Lana,60,,56,61,117
041 Lana,61,,49,58,107
041 Lana,62,,48,66,114
041 Lana,63,,49,55,104
041 Lana,64,,51,56,107
041 Lana,65,,51,65,116
041 Lana,66,,56,49,105
041 Lana,67,,62,61,123
041 Lana,68,,40,52,92
041 Lana,69,,43,63,106
041 Lana,70,,53,54,107
041 Lana,71,,50,67,117
041 Lana,72,,49,42,91
041 Lana,73,,39,45,84
041 Lana,74,,49,51,100
041 Lana,75,,39,54,93
041 Lana,76,,32,32,64
041 Lana,77,,36,48,84
041 Lana,78,,28,30,58
041 Lana,79,,28,41,69
041 Lana,80,,23,43,66
041 Lana,81,,19,30,49
041 Lana,82,,20,36,56
041 Lana,83,,16,29,45
041 Lana,84,,15,31,46
041 Lana,85,,15,23,38
041 Lana,86,,17,23,40
041 Lana,87,,9,22,31
041 Lana,88,,10,29,39
041 Lana,89,,3,11,14
041 Lana,90,,7,18,25
041 Lana,91,,6,16,22
041 Lana,92,,4,13,17
041 Lana,93,,3,10,13
041 Lana,94,,1,4,5
041 Lana,95,,-,3,3
041 Lana,96,,1,3,4
041 Lana,97,,-,2,2
041 Lana,98,,-,1,1
041 Lana,99,,1,2,3
041 Lana,100,,-,2,2
042 Laas,0,,25,27,52
042 Laas,1,,24,25,49
042 Laas,2,,21,24,45
042 Laas,3,,36,28,64
042 Laas,4,,21,29,50
042 Laas,5,,22,24,46
042 Laas,6,,29,16,45
042 Laas,7,,18,30,48
042 Laas,8,,36,15,51
042 Laas,9,,22,21,43
042 Laas,10,,24,20,44
042 Laas,11,,30,16,46
042 Laas,12,,17,21,38
042 Laas,13,,26,24,50
042 Laas,14,,18,15,33
042 Laas,15,,26,32,58
042 Laas,16,,26,24,50
042 Laas,17,,30,35,65
042 Laas,18,,31,25,56
042 Laas,19,,24,25,49
042 Laas,20,,20,19,39
042 Laas,21,,17,26,43
042 Laas,22,,22,23,45
042 Laas,23,,18,24,42
042 Laas,24,,21,23,44
042 Laas,25,,23,18,41
042 Laas,26,,29,18,47
042 Laas,27,,30,15,45
042 Laas,28,,32,25,57
042 Laas,29,,26,37,63
042 Laas,30,,18,45,63
042 Laas,31,,29,29,58
042 Laas,32,,27,31,58
042 Laas,33,,20,23,43
042 Laas,34,,33,28,61
042 Laas,35,,20,30,50
042 Laas,36,,26,22,48
042 Laas,37,,28,28,56
042 Laas,38,,27,18,45
042 Laas,39,,41,31,72
042 Laas,40,,36,29,65
042 Laas,41,,27,24,51
042 Laas,42,,24,25,49
042 Laas,43,,39,25,64
042 Laas,44,,32,38,70
042 Laas,45,,36,32,68
042 Laas,46,,30,24,54
042 Laas,47,,35,25,60
042 Laas,48,,34,30,64
042 Laas,49,,28,29,57
042 Laas,50,,25,27,52
042 Laas,51,,37,28,65
042 Laas,52,,25,28,53
042 Laas,53,,40,25,65
042 Laas,54,,31,26,57
042 Laas,55,,25,25,50
042 Laas,56,,17,26,43
042 Laas,57,,22,17,39
042 Laas,58,,16,16,32
042 Laas,59,,16,25,41
042 Laas,60,,20,13,33
042 Laas,61,,29,25,54
042 Laas,62,,12,15,27
042 Laas,63,,19,24,43
042 Laas,64,,18,19,37
042 Laas,65,,17,21,38
042 Laas,66,,25,11,36
042 Laas,67,,13,14,27
042 Laas,68,,14,11,25
042 Laas,69,,10,15,25
042 Laas,70,,11,15,26
042 Laas,71,,16,18,34
042 Laas,72,,13,20,33
042 Laas,73,,17,21,38
042 Laas,74,,12,24,36
042 Laas,75,,16,11,27
042 Laas,76,,10,14,24
042 Laas,77,,17,10,27
042 Laas,78,,17,21,38
042 Laas,79,,7,18,25
042 Laas,80,,14,11,25
042 Laas,81,,11,14,25
042 Laas,82,,10,18,28
042 Laas,83,,8,12,20
042 Laas,84,,8,7,15
042 Laas,85,,8,10,18
042 Laas,86,,6,12,18
042 Laas,87,,11,6,17
042 Laas,88,,3,6,9
042 Laas,89,,2,12,14
042 Laas,90,,5,5,10
042 Laas,91,,2,8,10
042 Laas,92,,1,2,3
042 Laas,93,,2,4,6
042 Laas,94,,1,-,1
042 Laas,95,,1,-,1
042 Laas,97,,1,2,3
042 Laas,100,,-,1,1
042 Laas,101,,-,1,1
042 Laas,102,,-,1,1
043 Laurein,0,,1,1,2
043 Laurein,1,,1,1,2
043 Laurein,2,,3,-,3
043 Laurein,3,,2,1,3
043 Laurein,4,,2,3,5
043 Laurein,5,,2,1,3
043 Laurein,6,,1,-,1
043 Laurein,7,,7,-,7
043 Laurein,8,,3,4,7
043 Laurein,9,,3,1,4
043 Laurein,10,,2,3,5
043 Laurein,11,,2,3,5
043 Laurein,12,,7,1,8
043 Laurein,13,,3,7,10
043 Laurein,14,,2,1,3
043 Laurein,15,,4,3,7
043 Laurein,16,,3,5,8
043 Laurein,17,,1,2,3
043 Laurein,18,,2,2,4
043 Laurein,19,,2,4,6
043 Laurein,20,,1,5,6
043 Laurein,21,,1,1,2
043 Laurein,22,,1,1,2
043 Laurein,23,,4,-,4
043 Laurein,24,,3,2,5
043 Laurein,25,,1,-,1
043 Laurein,26,,2,3,5
043 Laurein,27,,4,1,5
043 Laurein,28,,2,2,4
043 Laurein,29,,1,1,2
043 Laurein,31,,1,1,2
043 Laurein,32,,3,-,3
043 Laurein,33,,2,-,2
043 Laurein,34,,2,-,2
043 Laurein,35,,3,5,8
043 Laurein,36,,1,2,3
043 Laurein,37,,5,1,6
043 Laurein,38,,-,3,3
043 Laurein,39,,-,1,1
043 Laurein,40,,5,2,7
043 Laurein,41,,1,2,3
043 Laurein,42,,5,5,10
043 Laurein,43,,4,3,7
043 Laurein,44,,5,3,8
043 Laurein,45,,-,2,2
043 Laurein,46,,4,6,10
043 Laurein,47,,5,3,8
043 Laurein,48,,5,1,6
043 Laurein,49,,4,3,7
043 Laurein,50,,-,2,2
043 Laurein,51,,2,2,4
043 Laurein,52,,5,3,8
043 Laurein,53,,1,-,1
043 Laurein,54,,4,4,8
043 Laurein,55,,2,2,4
043 Laurein,56,,7,-,7
043 Laurein,58,,2,-,2
043 Laurein,59,,3,1,4
043 Laurein,60,,2,1,3
043 Laurein,61,,2,-,2
043 Laurein,63,,1,1,2
043 Laurein,64,,2,2,4
043 Laurein,65,,2,-,2
043 Laurein,66,,2,3,5
043 Laurein,67,,-,1,1
043 Laurein,68,,-,1,1
043 Laurein,69,,-,1,1
043 Laurein,70,,1,-,1
043 Laurein,71,,1,-,1
043 Laurein,73,,2,2,4
043 Laurein,74,,1,2,3
043 Laurein,75,,1,1,2
043 Laurein,76,,2,1,3
043 Laurein,77,,1,2,3
043 Laurein,78,,-,3,3
043 Laurein,79,,1,5,6
043 Laurein,81,,2,2,4
043 Laurein,82,,-,2,2
043 Laurein,83,,-,4,4
043 Laurein,84,,1,-,1
043 Laurein,85,,3,-,3
043 Laurein,86,,2,1,3
043 Laurein,87,,1,-,1
043 Laurein,88,,-,1,1
043 Laurein,89,,-,1,1
043 Laurein,91,,-,1,1
043 Laurein,92,,-,1,1
043 Laurein,93,,1,-,1
044 Lüsen,0,,2,12,14
044 Lüsen,1,,8,7,15
044 Lüsen,2,,12,8,20
044 Lüsen,3,,12,11,23
044 Lüsen,4,,10,9,19
044 Lüsen,5,,8,7,15
044 Lüsen,6,,12,11,23
044 Lüsen,7,,10,14,24
044 Lüsen,8,,9,8,17
044 Lüsen,9,,10,10,20
044 Lüsen,10,,12,9,21
044 Lüsen,11,,9,9,18
044 Lüsen,12,,10,11,21
044 Lüsen,13,,13,11,24
044 Lüsen,14,,5,9,14
044 Lüsen,15,,11,11,22
044 Lüsen,16,,15,6,21
044 Lüsen,17,,7,11,18
044 Lüsen,18,,10,12,22
044 Lüsen,19,,13,13,26
044 Lüsen,20,,8,8,16
044 Lüsen,21,,11,8,19
044 Lüsen,22,,8,6,14
044 Lüsen,23,,7,10,17
044 Lüsen,24,,15,10,25
044 Lüsen,25,,9,10,19
044 Lüsen,26,,7,5,12
044 Lüsen,27,,12,7,19
044 Lüsen,28,,5,3,8
044 Lüsen,29,,8,15,23
044 Lüsen,30,,5,9,14
044 Lüsen,31,,9,9,18
044 Lüsen,32,,10,12,22
044 Lüsen,33,,13,9,22
044 Lüsen,34,,10,10,20
044 Lüsen,35,,17,18,35
044 Lüsen,36,,8,14,22
044 Lüsen,37,,12,9,21
044 Lüsen,38,,12,12,24
044 Lüsen,39,,14,14,28
044 Lüsen,40,,8,7,15
044 Lüsen,41,,8,9,17
044 Lüsen,42,,16,9,25
044 Lüsen,43,,18,13,31
044 Lüsen,44,,10,11,21
044 Lüsen,45,,13,15,28
044 Lüsen,46,,11,19,30
044 Lüsen,47,,15,11,26
044 Lüsen,48,,17,12,29
044 Lüsen,49,,12,8,20
044 Lüsen,50,,12,12,24
044 Lüsen,51,,7,11,18
044 Lüsen,52,,12,9,21
044 Lüsen,53,,9,13,22
044 Lüsen,54,,9,6,15
044 Lüsen,55,,11,12,23
044 Lüsen,56,,10,9,19
044 Lüsen,57,,7,10,17
044 Lüsen,58,,6,7,13
044 Lüsen,59,,10,7,17
044 Lüsen,60,,7,10,17
044 Lüsen,61,,9,4,13
044 Lüsen,62,,5,6,11
044 Lüsen,63,,6,9,15
044 Lüsen,64,,7,10,17
044 Lüsen,65,,7,1,8
044 Lüsen,66,,5,5,10
044 Lüsen,67,,9,6,15
044 Lüsen,68,,3,9,12
044 Lüsen,69,,5,2,7
044 Lüsen,70,,7,8,15
044 Lüsen,71,,2,6,8
044 Lüsen,72,,5,2,7
044 Lüsen,73,,3,10,13
044 Lüsen,74,,8,7,15
044 Lüsen,75,,6,5,11
044 Lüsen,76,,7,4,11
044 Lüsen,77,,4,8,12
044 Lüsen,78,,3,4,7
044 Lüsen,79,,3,3,6
044 Lüsen,80,,7,2,9
044 Lüsen,81,,2,7,9
044 Lüsen,82,,4,3,7
044 Lüsen,83,,-,4,4
044 Lüsen,84,,1,3,4
044 Lüsen,85,,2,4,6
044 Lüsen,86,,2,2,4
044 Lüsen,87,,2,3,5
044 Lüsen,88,,1,2,3
044 Lüsen,89,,1,1,2
044 Lüsen,90,,1,3,4
044 Lüsen,91,,1,-,1
044 Lüsen,92,,-,4,4
044 Lüsen,100,,-,1,1
045 Margreid a.d. Weinstr.,0,,9,7,16
045 Margreid a.d. Weinstr.,1,,3,7,10
045 Margreid a.d. Weinstr.,2,,3,9,12
045 Margreid a.d. Weinstr.,3,,4,8,12
045 Margreid a.d. Weinstr.,4,,7,5,12
045 Margreid a.d. Weinstr.,5,,10,9,19
045 Margreid a.d. Weinstr.,6,,6,6,12
045 Margreid a.d. Weinstr.,7,,8,4,12
045 Margreid a.d. Weinstr.,8,,7,10,17
045 Margreid a.d. Weinstr.,9,,9,10,19
045 Margreid a.d. Weinstr.,10,,6,3,9
045 Margreid a.d. Weinstr.,11,,9,8,17
045 Margreid a.d. Weinstr.,12,,12,9,21
045 Margreid a.d. Weinstr.,13,,8,6,14
045 Margreid a.d. Weinstr.,14,,7,9,16
045 Margreid a.d. Weinstr.,15,,2,11,13
045 Margreid a.d. Weinstr.,16,,10,15,25
045 Margreid a.d. Weinstr.,17,,5,2,7
045 Margreid a.d. Weinstr.,18,,2,6,8
045 Margreid a.d. Weinstr.,19,,7,6,13
045 Margreid a.d. Weinstr.,20,,5,14,19
045 Margreid a.d. Weinstr.,21,,1,3,4
045 Margreid a.d. Weinstr.,22,,5,7,12
045 Margreid a.d. Weinstr.,23,,7,9,16
045 Margreid a.d. Weinstr.,24,,7,6,13
045 Margreid a.d. Weinstr.,25,,7,8,15
045 Margreid a.d. Weinstr.,26,,7,9,16
045 Margreid a.d. Weinstr.,27,,6,11,17
045 Margreid a.d. Weinstr.,28,,14,2,16
045 Margreid a.d. Weinstr.,29,,8,9,17
045 Margreid a.d. Weinstr.,30,,8,6,14
045 Margreid a.d. Weinstr.,31,,11,10,21
045 Margreid a.d. Weinstr.,32,,16,10,26
045 Margreid a.d. Weinstr.,33,,5,8,13
045 Margreid a.d. Weinstr.,34,,13,3,16
045 Margreid a.d. Weinstr.,35,,8,9,17
045 Margreid a.d. Weinstr.,36,,7,11,18
045 Margreid a.d. Weinstr.,37,,13,16,29
045 Margreid a.d. Weinstr.,38,,8,8,16
045 Margreid a.d. Weinstr.,39,,10,6,16
045 Margreid a.d. Weinstr.,40,,10,10,20
045 Margreid a.d. Weinstr.,41,,6,6,12
045 Margreid a.d. Weinstr.,42,,10,12,22
045 Margreid a.d. Weinstr.,43,,11,10,21
045 Margreid a.d. Weinstr.,44,,8,10,18
045 Margreid a.d. Weinstr.,45,,21,17,38
045 Margreid a.d. Weinstr.,46,,13,18,31
045 Margreid a.d. Weinstr.,47,,18,8,26
045 Margreid a.d. Weinstr.,48,,12,3,15
045 Margreid a.d. Weinstr.,49,,5,3,8
045 Margreid a.d. Weinstr.,50,,8,11,19
045 Margreid a.d. Weinstr.,51,,7,14,21
045 Margreid a.d. Weinstr.,52,,15,14,29
045 Margreid a.d. Weinstr.,53,,13,10,23
045 Margreid a.d. Weinstr.,54,,9,11,20
045 Margreid a.d. Weinstr.,55,,7,6,13
045 Margreid a.d. Weinstr.,56,,9,6,15
045 Margreid a.d. Weinstr.,57,,15,7,22
045 Margreid a.d. Weinstr.,58,,8,8,16
045 Margreid a.d. Weinstr.,59,,5,5,10
045 Margreid a.d. Weinstr.,60,,7,9,16
045 Margreid a.d. Weinstr.,61,,5,7,12
045 Margreid a.d. Weinstr.,62,,4,8,12
045 Margreid a.d. Weinstr.,63,,7,6,13
045 Margreid a.d. Weinstr.,64,,7,3,10
045 Margreid a.d. Weinstr.,65,,5,9,14
045 Margreid a.d. Weinstr.,66,,6,6,12
045 Margreid a.d. Weinstr.,67,,2,3,5
045 Margreid a.d. Weinstr.,68,,6,7,13
045 Margreid a.d. Weinstr.,69,,3,5,8
045 Margreid a.d. Weinstr.,70,,6,3,9
045 Margreid a.d. Weinstr.,71,,8,5,13
045 Margreid a.d. Weinstr.,72,,7,5,12
045 Margreid a.d. Weinstr.,73,,6,4,10
045 Margreid a.d. Weinstr.,74,,3,6,9
045 Margreid a.d. Weinstr.,75,,3,9,12
045 Margreid a.d. Weinstr.,76,,4,3,7
045 Margreid a.d. Weinstr.,77,,6,4,10
045 Margreid a.d. Weinstr.,78,,2,6,8
045 Margreid a.d. Weinstr.,79,,5,4,9
045 Margreid a.d. Weinstr.,80,,2,3,5
045 Margreid a.d. Weinstr.,81,,4,3,7
045 Margreid a.d. Weinstr.,82,,3,5,8
045 Margreid a.d. Weinstr.,83,,5,1,6
045 Margreid a.d. Weinstr.,84,,1,2,3
045 Margreid a.d. Weinstr.,85,,1,1,2
045 Margreid a.d. Weinstr.,86,,-,3,3
045 Margreid a.d. Weinstr.,87,,1,6,7
045 Margreid a.d. Weinstr.,88,,2,2,4
045 Margreid a.d. Weinstr.,89,,1,4,5
045 Margreid a.d. Weinstr.,90,,1,3,4
045 Margreid a.d. Weinstr.,92,,-,1,1
045 Margreid a.d. Weinstr.,93,,-,1,1
045 Margreid a.d. Weinstr.,94,,-,3,3
045 Margreid a.d. Weinstr.,95,,1,-,1
045 Margreid a.d. Weinstr.,97,,-,1,1
046 Mals,0,,30,28,58
046 Mals,1,,28,22,50
046 Mals,2,,31,22,53
046 Mals,3,,34,27,61
046 Mals,4,,31,19,50
046 Mals,5,,28,24,52
046 Mals,6,,23,32,55
046 Mals,7,,35,37,72
046 Mals,8,,25,32,57
046 Mals,9,,30,25,55
046 Mals,10,,31,22,53
046 Mals,11,,23,28,51
046 Mals,12,,31,30,61
046 Mals,13,,30,36,66
046 Mals,14,,42,29,71
046 Mals,15,,34,33,67
046 Mals,16,,30,32,62
046 Mals,17,,36,26,62
046 Mals,18,,35,40,75
046 Mals,19,,38,31,69
046 Mals,20,,38,34,72
046 Mals,21,,31,31,62
046 Mals,22,,36,34,70
046 Mals,23,,33,31,64
046 Mals,24,,40,35,75
046 Mals,25,,32,26,58
046 Mals,26,,31,33,64
046 Mals,27,,28,40,68
046 Mals,28,,35,33,68
046 Mals,29,,37,30,67
046 Mals,30,,32,33,65
046 Mals,31,,30,30,60
046 Mals,32,,32,34,66
046 Mals,33,,44,30,74
046 Mals,34,,31,33,64
046 Mals,35,,43,33,76
046 Mals,36,,35,27,62
046 Mals,37,,28,31,59
046 Mals,38,,38,32,70
046 Mals,39,,50,26,76
046 Mals,40,,34,38,72
046 Mals,41,,30,47,77
046 Mals,42,,35,46,81
046 Mals,43,,47,47,94
046 Mals,44,,46,44,90
046 Mals,45,,56,39,95
046 Mals,46,,48,32,80
046 Mals,47,,53,54,107
046 Mals,48,,49,40,89
046 Mals,49,,47,43,90
046 Mals,50,,48,54,102
046 Mals,51,,37,28,65
046 Mals,52,,51,35,86
046 Mals,53,,32,41,73
046 Mals,54,,35,33,68
046 Mals,55,,32,24,56
046 Mals,56,,34,34,68
046 Mals,57,,32,26,58
046 Mals,58,,29,24,53
046 Mals,59,,19,22,41
046 Mals,60,,33,30,63
046 Mals,61,,27,24,51
046 Mals,62,,30,21,51
046 Mals,63,,34,23,57
046 Mals,64,,20,24,44
046 Mals,65,,26,14,40
046 Mals,66,,21,19,40
046 Mals,67,,18,27,45
046 Mals,68,,10,18,28
046 Mals,69,,28,14,42
046 Mals,70,,23,19,42
046 Mals,71,,18,23,41
046 Mals,72,,13,16,29
046 Mals,73,,18,27,45
046 Mals,74,,22,27,49
046 Mals,75,,18,20,38
046 Mals,76,,12,26,38
046 Mals,77,,15,16,31
046 Mals,78,,12,18,30
046 Mals,79,,11,12,23
046 Mals,80,,12,19,31
046 Mals,81,,13,10,23
046 Mals,82,,7,16,23
046 Mals,83,,18,13,31
046 Mals,84,,10,8,18
046 Mals,85,,7,8,15
046 Mals,86,,7,10,17
046 Mals,87,,4,12,16
046 Mals,88,,3,9,12
046 Mals,89,,2,7,9
046 Mals,90,,-,5,5
046 Mals,91,,7,8,15
046 Mals,92,,2,4,6
046 Mals,93,,-,5,5
046 Mals,94,,1,4,5
046 Mals,95,,1,-,1
046 Mals,96,,1,1,2
046 Mals,98,,-,1,1
046 Mals,99,,1,-,1
047 Enneberg,0,,15,20,35
047 Enneberg,1,,20,18,38
047 Enneberg,2,,25,17,42
047 Enneberg,3,,19,10,29
047 Enneberg,4,,14,12,26
047 Enneberg,5,,15,20,35
047 Enneberg,6,,16,17,33
047 Enneberg,7,,23,19,42
047 Enneberg,8,,20,16,36
047 Enneberg,9,,14,18,32
047 Enneberg,10,,21,27,48
047 Enneberg,11,,18,14,32
047 Enneberg,12,,28,16,44
047 Enneberg,13,,19,21,40
047 Enneberg,14,,26,19,45
047 Enneberg,15,,18,9,27
047 Enneberg,16,,23,15,38
047 Enneberg,17,,17,13,30
047 Enneberg,18,,23,9,32
047 Enneberg,19,,21,15,36
047 Enneberg,20,,20,19,39
047 Enneberg,21,,15,15,30
047 Enneberg,22,,17,22,39
047 Enneberg,23,,16,18,34
047 Enneberg,24,,24,16,40
047 Enneberg,25,,20,14,34
047 Enneberg,26,,18,14,32
047 Enneberg,27,,19,13,32
047 Enneberg,28,,23,19,42
047 Enneberg,29,,22,15,37
047 Enneberg,30,,16,16,32
047 Enneberg,31,,23,20,43
047 Enneberg,32,,19,26,45
047 Enneberg,33,,21,22,43
047 Enneberg,34,,15,19,34
047 Enneberg,35,,20,22,42
047 Enneberg,36,,22,22,44
047 Enneberg,37,,13,17,30
047 Enneberg,38,,14,28,42
047 Enneberg,39,,26,32,58
047 Enneberg,40,,27,22,49
047 Enneberg,41,,25,27,52
047 Enneberg,42,,27,36,63
047 Enneberg,43,,28,20,48
047 Enneberg,44,,34,18,52
047 Enneberg,45,,24,24,48
047 Enneberg,46,,25,19,44
047 Enneberg,47,,18,20,38
047 Enneberg,48,,27,21,48
047 Enneberg,49,,22,22,44
047 Enneberg,50,,21,19,40
047 Enneberg,51,,17,15,32
047 Enneberg,52,,18,17,35
047 Enneberg,53,,15,16,31
047 Enneberg,54,,23,15,38
047 Enneberg,55,,21,11,32
047 Enneberg,56,,15,16,31
047 Enneberg,57,,14,19,33
047 Enneberg,58,,14,15,29
047 Enneberg,59,,14,13,27
047 Enneberg,60,,17,20,37
047 Enneberg,61,,14,17,31
047 Enneberg,62,,17,10,27
047 Enneberg,63,,11,14,25
047 Enneberg,64,,17,8,25
047 Enneberg,65,,15,14,29
047 Enneberg,66,,8,11,19
047 Enneberg,67,,11,16,27
047 Enneberg,68,,3,12,15
047 Enneberg,69,,19,17,36
047 Enneberg,70,,16,10,26
047 Enneberg,71,,10,19,29
047 Enneberg,72,,13,12,25
047 Enneberg,73,,9,7,16
047 Enneberg,74,,14,9,23
047 Enneberg,75,,12,16,28
047 Enneberg,76,,14,12,26
047 Enneberg,77,,9,11,20
047 Enneberg,78,,11,15,26
047 Enneberg,79,,6,10,16
047 Enneberg,80,,9,8,17
047 Enneberg,81,,5,16,21
047 Enneberg,82,,8,10,18
047 Enneberg,83,,10,12,22
047 Enneberg,84,,4,7,11
047 Enneberg,85,,5,7,12
047 Enneberg,86,,4,4,8
047 Enneberg,87,,4,5,9
047 Enneberg,88,,6,5,11
047 Enneberg,89,,-,3,3
047 Enneberg,90,,-,7,7
047 Enneberg,91,,3,5,8
047 Enneberg,92,,1,3,4
047 Enneberg,93,,2,1,3
047 Enneberg,94,,-,2,2
047 Enneberg,95,,-,2,2
047 Enneberg,96,,-,1,1
047 Enneberg,97,,-,2,2
047 Enneberg,98,,-,2,2
047 Enneberg,99,,-,1,1
048 Marling,0,,13,7,20
048 Marling,1,,13,10,23
048 Marling,2,,16,8,24
048 Marling,3,,17,7,24
048 Marling,4,,19,8,27
048 Marling,5,,11,13,24
048 Marling,6,,19,13,32
048 Marling,7,,11,18,29
048 Marling,8,,26,13,39
048 Marling,9,,14,16,30
048 Marling,10,,11,11,22
048 Marling,11,,14,18,32
048 Marling,12,,11,16,27
048 Marling,13,,17,15,32
048 Marling,14,,14,10,24
048 Marling,15,,11,11,22
048 Marling,16,,15,10,25
048 Marling,17,,12,14,26
048 Marling,18,,21,13,34
048 Marling,19,,12,8,20
048 Marling,20,,18,11,29
048 Marling,21,,18,18,36
048 Marling,22,,13,17,30
048 Marling,23,,12,18,30
048 Marling,24,,14,23,37
048 Marling,25,,15,14,29
048 Marling,26,,10,16,26
048 Marling,27,,11,11,22
048 Marling,28,,10,18,28
048 Marling,29,,12,7,19
048 Marling,30,,17,21,38
048 Marling,31,,15,12,27
048 Marling,32,,20,13,33
048 Marling,33,,20,16,36
048 Marling,34,,16,21,37
048 Marling,35,,18,20,38
048 Marling,36,,20,19,39
048 Marling,37,,18,27,45
048 Marling,38,,25,16,41
048 Marling,39,,17,11,28
048 Marling,40,,18,20,38
048 Marling,41,,18,21,39
048 Marling,42,,22,18,40
048 Marling,43,,21,21,42
048 Marling,44,,21,21,42
048 Marling,45,,28,21,49
048 Marling,46,,19,20,39
048 Marling,47,,25,28,53
048 Marling,48,,25,19,44
048 Marling,49,,27,22,49
048 Marling,50,,30,29,59
048 Marling,51,,20,18,38
048 Marling,52,,25,14,39
048 Marling,53,,17,20,37
048 Marling,54,,19,16,35
048 Marling,55,,16,11,27
048 Marling,56,,14,9,23
048 Marling,57,,10,12,22
048 Marling,58,,12,9,21
048 Marling,59,,18,12,30
048 Marling,60,,10,15,25
048 Marling,61,,13,15,28
048 Marling,62,,6,16,22
048 Marling,63,,13,14,27
048 Marling,64,,19,18,37
048 Marling,65,,5,15,20
048 Marling,66,,15,14,29
048 Marling,67,,11,15,26
048 Marling,68,,18,11,29
048 Marling,69,,15,16,31
048 Marling,70,,9,17,26
048 Marling,71,,9,10,19
048 Marling,72,,19,17,36
048 Marling,73,,11,12,23
048 Marling,74,,14,15,29
048 Marling,75,,8,12,20
048 Marling,76,,10,14,24
048 Marling,77,,14,8,22
048 Marling,78,,3,16,19
048 Marling,79,,8,8,16
048 Marling,80,,6,12,18
048 Marling,81,,7,9,16
048 Marling,82,,8,8,16
048 Marling,83,,4,8,12
048 Marling,84,,5,5,10
048 Marling,85,,5,-,5
048 Marling,86,,7,6,13
048 Marling,87,,1,8,9
048 Marling,88,,1,9,10
048 Marling,89,,-,5,5
048 Marling,90,,1,4,5
048 Marling,91,,1,2,3
048 Marling,92,,1,2,3
048 Marling,93,,-,1,1
048 Marling,94,,1,-,1
048 Marling,95,,-,1,1
048 Marling,97,,-,1,1
048 Marling,99,,1,-,1
049 Martell,0,,9,2,11
049 Martell,1,,5,5,10
049 Martell,2,,8,4,12
049 Martell,3,,8,4,12
049 Martell,4,,3,2,5
049 Martell,5,,6,1,7
049 Martell,6,,7,1,8
049 Martell,7,,4,5,9
049 Martell,8,,8,2,10
049 Martell,9,,6,1,7
049 Martell,10,,5,5,10
049 Martell,11,,3,5,8
049 Martell,12,,4,7,11
049 Martell,13,,7,2,9
049 Martell,14,,1,6,7
049 Martell,15,,6,6,12
049 Martell,16,,5,7,12
049 Martell,17,,4,6,10
049 Martell,18,,7,7,14
049 Martell,19,,6,8,14
049 Martell,20,,6,5,11
049 Martell,21,,4,3,7
049 Martell,22,,9,5,14
049 Martell,23,,6,4,10
049 Martell,24,,8,4,12
049 Martell,25,,4,1,5
049 Martell,26,,8,6,14
049 Martell,27,,-,3,3
049 Martell,28,,4,5,9
049 Martell,29,,5,1,6
049 Martell,30,,7,5,12
049 Martell,31,,5,9,14
049 Martell,32,,4,6,10
049 Martell,33,,9,3,12
049 Martell,34,,7,2,9
049 Martell,35,,4,4,8
049 Martell,36,,7,3,10
049 Martell,37,,6,4,10
049 Martell,38,,2,7,9
049 Martell,39,,7,12,19
049 Martell,40,,9,4,13
049 Martell,41,,6,8,14
049 Martell,42,,9,5,14
049 Martell,43,,8,4,12
049 Martell,44,,6,12,18
049 Martell,45,,9,6,15
049 Martell,46,,5,7,12
049 Martell,47,,15,6,21
049 Martell,48,,16,11,27
049 Martell,49,,7,9,16
049 Martell,50,,14,1,15
049 Martell,51,,11,7,18
049 Martell,52,,8,5,13
049 Martell,53,,9,3,12
049 Martell,54,,8,6,14
049 Martell,55,,7,6,13
049 Martell,56,,7,3,10
049 Martell,57,,5,4,9
049 Martell,58,,7,3,10
049 Martell,59,,5,6,11
049 Martell,60,,4,4,8
049 Martell,61,,3,3,6
049 Martell,62,,5,7,12
049 Martell,63,,2,5,7
049 Martell,64,,3,1,4
049 Martell,65,,4,4,8
049 Martell,66,,3,3,6
049 Martell,67,,3,-,3
049 Martell,68,,4,1,5
049 Martell,69,,1,3,4
049 Martell,70,,3,4,7
049 Martell,71,,6,5,11
049 Martell,72,,3,4,7
049 Martell,73,,6,2,8
049 Martell,74,,2,4,6
049 Martell,75,,2,5,7
049 Martell,76,,2,4,6
049 Martell,77,,2,4,6
049 Martell,78,,4,7,11
049 Martell,79,,6,1,7
049 Martell,80,,4,6,10
049 Martell,81,,2,1,3
049 Martell,82,,4,-,4
049 Martell,83,,4,4,8
049 Martell,84,,2,3,5
049 Martell,85,,1,1,2
049 Martell,86,,2,3,5
049 Martell,87,,-,4,4
049 Martell,88,,1,1,2
049 Martell,89,,2,3,5
049 Martell,90,,-,2,2
049 Martell,91,,1,1,2
049 Martell,98,,-,1,1
050 Mölten,0,,15,13,28
050 Mölten,1,,8,7,15
050 Mölten,2,,15,14,29
050 Mölten,3,,6,13,19
050 Mölten,4,,14,14,28
050 Mölten,5,,11,14,25
050 Mölten,6,,14,9,23
050 Mölten,7,,8,8,16
050 Mölten,8,,10,13,23
050 Mölten,9,,11,11,22
050 Mölten,10,,11,9,20
050 Mölten,11,,16,11,27
050 Mölten,12,,16,16,32
050 Mölten,13,,13,14,27
050 Mölten,14,,12,16,28
050 Mölten,15,,7,15,22
050 Mölten,16,,9,7,16
050 Mölten,17,,15,13,28
050 Mölten,18,,12,9,21
050 Mölten,19,,13,5,18
050 Mölten,20,,11,11,22
050 Mölten,21,,6,13,19
050 Mölten,22,,8,7,15
050 Mölten,23,,11,5,16
050 Mölten,24,,12,4,16
050 Mölten,25,,8,9,17
050 Mölten,26,,9,9,18
050 Mölten,27,,10,5,15
050 Mölten,28,,9,8,17
050 Mölten,29,,7,4,11
050 Mölten,30,,9,12,21
050 Mölten,31,,10,13,23
050 Mölten,32,,13,11,24
050 Mölten,33,,17,9,26
050 Mölten,34,,11,12,23
050 Mölten,35,,13,8,21
050 Mölten,36,,8,13,21
050 Mölten,37,,10,20,30
050 Mölten,38,,25,11,36
050 Mölten,39,,12,9,21
050 Mölten,40,,16,17,33
050 Mölten,41,,9,11,20
050 Mölten,42,,13,15,28
050 Mölten,43,,18,11,29
050 Mölten,44,,15,13,28
050 Mölten,45,,17,16,33
050 Mölten,46,,18,15,33
050 Mölten,47,,17,12,29
050 Mölten,48,,11,14,25
050 Mölten,49,,20,16,36
050 Mölten,50,,18,7,25
050 Mölten,51,,16,10,26
050 Mölten,52,,15,10,25
050 Mölten,53,,10,9,19
050 Mölten,54,,14,5,19
050 Mölten,55,,3,8,11
050 Mölten,56,,7,3,10
050 Mölten,57,,7,9,16
050 Mölten,58,,11,8,19
050 Mölten,59,,6,8,14
050 Mölten,60,,7,7,14
050 Mölten,61,,6,6,12
050 Mölten,62,,5,5,10
050 Mölten,63,,9,9,18
050 Mölten,64,,8,5,13
050 Mölten,65,,8,4,12
050 Mölten,66,,4,8,12
050 Mölten,67,,8,3,11
050 Mölten,68,,6,5,11
050 Mölten,69,,3,7,10
050 Mölten,70,,11,8,19
050 Mölten,71,,7,9,16
050 Mölten,72,,8,5,13
050 Mölten,73,,4,7,11
050 Mölten,74,,5,6,11
050 Mölten,75,,3,3,6
050 Mölten,76,,4,6,10
050 Mölten,77,,2,3,5
050 Mölten,78,,7,6,13
050 Mölten,79,,7,4,11
050 Mölten,80,,5,8,13
050 Mölten,81,,2,6,8
050 Mölten,82,,8,2,10
050 Mölten,83,,5,2,7
050 Mölten,84,,1,6,7
050 Mölten,85,,1,3,4
050 Mölten,86,,1,1,2
050 Mölten,87,,1,4,5
050 Mölten,88,,1,3,4
050 Mölten,90,,2,2,4
050 Mölten,91,,1,1,2
050 Mölten,92,,-,2,2
050 Mölten,93,,-,4,4
050 Mölten,94,,-,2,2
050 Mölten,99,,-,1,1
051 Meran,0,,189,170,359
051 Meran,1,,182,169,351
051 Meran,2,,192,198,390
051 Meran,3,,200,193,393
051 Meran,4,,202,179,381
051 Meran,5,,197,178,375
051 Meran,6,,223,201,424
051 Meran,7,,205,210,415
051 Meran,8,,192,178,370
051 Meran,9,,239,168,407
051 Meran,10,,187,163,350
051 Meran,11,,184,169,353
051 Meran,12,,204,190,394
051 Meran,13,,203,166,369
051 Meran,14,,186,190,376
051 Meran,15,,169,173,342
051 Meran,16,,198,175,373
051 Meran,17,,216,172,388
051 Meran,18,,201,170,371
051 Meran,19,,189,210,399
051 Meran,20,,159,166,325
051 Meran,21,,192,163,355
051 Meran,22,,181,209,390
051 Meran,23,,183,184,367
051 Meran,24,,222,204,426
051 Meran,25,,213,185,398
051 Meran,26,,202,202,404
051 Meran,27,,219,183,402
051 Meran,28,,199,243,442
051 Meran,29,,233,220,453
051 Meran,30,,210,237,447
051 Meran,31,,229,243,472
051 Meran,32,,244,252,496
051 Meran,33,,258,218,476
051 Meran,34,,233,226,459
051 Meran,35,,255,236,491
051 Meran,36,,246,265,511
051 Meran,37,,235,277,512
051 Meran,38,,248,278,526
051 Meran,39,,274,312,586
051 Meran,40,,266,312,578
051 Meran,41,,294,307,601
051 Meran,42,,321,297,618
051 Meran,43,,304,333,637
051 Meran,44,,338,337,675
051 Meran,45,,357,351,708
051 Meran,46,,355,342,697
051 Meran,47,,321,306,627
051 Meran,48,,317,334,651
051 Meran,49,,333,318,651
051 Meran,50,,339,303,642
051 Meran,51,,273,301,574
051 Meran,52,,283,315,598
051 Meran,53,,287,282,569
051 Meran,54,,264,251,515
051 Meran,55,,259,256,515
051 Meran,56,,220,259,479
051 Meran,57,,217,230,447
051 Meran,58,,200,224,424
051 Meran,59,,182,232,414
051 Meran,60,,179,238,417
051 Meran,61,,211,224,435
051 Meran,62,,193,220,413
051 Meran,63,,188,228,416
051 Meran,64,,228,252,480
051 Meran,65,,201,268,469
051 Meran,66,,223,277,500
051 Meran,67,,236,286,522
051 Meran,68,,184,213,397
051 Meran,69,,185,225,410
051 Meran,70,,252,234,486
051 Meran,71,,230,289,519
051 Meran,72,,207,275,482
051 Meran,73,,159,222,381
051 Meran,74,,174,240,414
051 Meran,75,,156,219,375
051 Meran,76,,158,215,373
051 Meran,77,,135,188,323
051 Meran,78,,132,191,323
051 Meran,79,,126,160,286
051 Meran,80,,126,150,276
051 Meran,81,,99,165,264
051 Meran,82,,80,146,226
051 Meran,83,,88,155,243
051 Meran,84,,71,125,196
051 Meran,85,,62,136,198
051 Meran,86,,59,92,151
051 Meran,87,,46,114,160
051 Meran,88,,34,108,142
051 Meran,89,,40,93,133
051 Meran,90,,25,82,107
051 Meran,91,,31,75,106
051 Meran,92,,12,77,89
051 Meran,93,,13,51,64
051 Meran,94,,12,32,44
051 Meran,95,,1,14,15
051 Meran,96,,5,19,24
051 Meran,97,,2,6,8
051 Meran,98,,2,9,11
051 Meran,99,,3,9,12
051 Meran,100,,1,3,4
051 Meran,101,,2,3,5
051 Meran,102,,-,1,1
051 Meran,103,,-,1,1
051 Meran,105,,-,2,2
052 Welsberg-Taisten,0,,19,11,30
052 Welsberg-Taisten,1,,12,15,27
052 Welsberg-Taisten,2,,15,18,33
052 Welsberg-Taisten,3,,10,20,30
052 Welsberg-Taisten,4,,13,14,27
052 Welsberg-Taisten,5,,23,20,43
052 Welsberg-Taisten,6,,22,22,44
052 Welsberg-Taisten,7,,11,26,37
052 Welsberg-Taisten,8,,21,28,49
052 Welsberg-Taisten,9,,14,20,34
052 Welsberg-Taisten,10,,19,18,37
052 Welsberg-Taisten,11,,22,23,45
052 Welsberg-Taisten,12,,32,20,52
052 Welsberg-Taisten,13,,19,13,32
052 Welsberg-Taisten,14,,20,22,42
052 Welsberg-Taisten,15,,23,12,35
052 Welsberg-Taisten,16,,20,20,40
052 Welsberg-Taisten,17,,16,15,31
052 Welsberg-Taisten,18,,19,16,35
052 Welsberg-Taisten,19,,12,16,28
052 Welsberg-Taisten,20,,16,21,37
052 Welsberg-Taisten,21,,8,9,17
052 Welsberg-Taisten,22,,20,18,38
052 Welsberg-Taisten,23,,12,17,29
052 Welsberg-Taisten,24,,6,18,24
052 Welsberg-Taisten,25,,11,21,32
052 Welsberg-Taisten,26,,11,9,20
052 Welsberg-Taisten,27,,16,12,28
052 Welsberg-Taisten,28,,7,21,28
052 Welsberg-Taisten,29,,31,19,50
052 Welsberg-Taisten,30,,23,21,44
052 Welsberg-Taisten,31,,17,20,37
052 Welsberg-Taisten,32,,12,16,28
052 Welsberg-Taisten,33,,19,15,34
052 Welsberg-Taisten,34,,20,19,39
052 Welsberg-Taisten,35,,17,18,35
052 Welsberg-Taisten,36,,14,30,44
052 Welsberg-Taisten,37,,16,10,26
052 Welsberg-Taisten,38,,16,25,41
052 Welsberg-Taisten,39,,30,24,54
052 Welsberg-Taisten,40,,24,12,36
052 Welsberg-Taisten,41,,15,27,42
052 Welsberg-Taisten,42,,32,21,53
052 Welsberg-Taisten,43,,29,27,56
052 Welsberg-Taisten,44,,20,22,42
052 Welsberg-Taisten,45,,26,22,48
052 Welsberg-Taisten,46,,32,23,55
052 Welsberg-Taisten,47,,33,22,55
052 Welsberg-Taisten,48,,22,16,38
052 Welsberg-Taisten,49,,33,20,53
052 Welsberg-Taisten,50,,28,24,52
052 Welsberg-Taisten,51,,22,23,45
052 Welsberg-Taisten,52,,17,14,31
052 Welsberg-Taisten,53,,10,17,27
052 Welsberg-Taisten,54,,20,20,40
052 Welsberg-Taisten,55,,24,17,41
052 Welsberg-Taisten,56,,13,19,32
052 Welsberg-Taisten,57,,17,20,37
052 Welsberg-Taisten,58,,15,8,23
052 Welsberg-Taisten,59,,15,14,29
052 Welsberg-Taisten,60,,18,12,30
052 Welsberg-Taisten,61,,16,12,28
052 Welsberg-Taisten,62,,15,9,24
052 Welsberg-Taisten,63,,16,13,29
052 Welsberg-Taisten,64,,15,11,26
052 Welsberg-Taisten,65,,16,16,32
052 Welsberg-Taisten,66,,9,11,20
052 Welsberg-Taisten,67,,12,14,26
052 Welsberg-Taisten,68,,9,11,20
052 Welsberg-Taisten,69,,11,12,23
052 Welsberg-Taisten,70,,9,14,23
052 Welsberg-Taisten,71,,10,13,23
052 Welsberg-Taisten,72,,14,17,31
052 Welsberg-Taisten,73,,6,11,17
052 Welsberg-Taisten,74,,11,9,20
052 Welsberg-Taisten,75,,8,13,21
052 Welsberg-Taisten,76,,8,8,16
052 Welsberg-Taisten,77,,6,8,14
052 Welsberg-Taisten,78,,3,14,17
052 Welsberg-Taisten,79,,14,14,28
052 Welsberg-Taisten,80,,7,10,17
052 Welsberg-Taisten,81,,7,8,15
052 Welsberg-Taisten,82,,4,11,15
052 Welsberg-Taisten,83,,6,6,12
052 Welsberg-Taisten,84,,6,8,14
052 Welsberg-Taisten,85,,5,12,17
052 Welsberg-Taisten,86,,1,8,9
052 Welsberg-Taisten,87,,3,5,8
052 Welsberg-Taisten,88,,-,3,3
052 Welsberg-Taisten,89,,1,5,6
052 Welsberg-Taisten,90,,3,3,6
052 Welsberg-Taisten,91,,2,2,4
052 Welsberg-Taisten,92,,1,3,4
052 Welsberg-Taisten,93,,1,1,2
052 Welsberg-Taisten,94,,-,1,1
052 Welsberg-Taisten,96,,-,1,1
053 Montan,0,,7,6,13
053 Montan,1,,9,10,19
053 Montan,2,,10,2,12
053 Montan,3,,12,10,22
053 Montan,4,,6,8,14
053 Montan,5,,12,7,19
053 Montan,6,,7,5,12
053 Montan,7,,8,7,15
053 Montan,8,,9,9,18
053 Montan,9,,6,10,16
053 Montan,10,,11,12,23
053 Montan,11,,7,4,11
053 Montan,12,,14,4,18
053 Montan,13,,9,6,15
053 Montan,14,,8,11,19
053 Montan,15,,9,15,24
053 Montan,16,,7,9,16
053 Montan,17,,14,10,24
053 Montan,18,,16,16,32
053 Montan,19,,13,6,19
053 Montan,20,,5,9,14
053 Montan,21,,5,8,13
053 Montan,22,,13,10,23
053 Montan,23,,10,7,17
053 Montan,24,,10,11,21
053 Montan,25,,11,17,28
053 Montan,26,,11,17,28
053 Montan,27,,16,7,23
053 Montan,28,,10,10,20
053 Montan,29,,6,4,10
053 Montan,30,,14,9,23
053 Montan,31,,7,9,16
053 Montan,32,,11,14,25
053 Montan,33,,9,6,15
053 Montan,34,,13,8,21
053 Montan,35,,13,6,19
053 Montan,36,,9,6,15
053 Montan,37,,8,6,14
053 Montan,38,,10,16,26
053 Montan,39,,9,17,26
053 Montan,40,,12,6,18
053 Montan,41,,9,8,17
053 Montan,42,,12,10,22
053 Montan,43,,14,13,27
053 Montan,44,,15,18,33
053 Montan,45,,11,19,30
053 Montan,46,,12,13,25
053 Montan,47,,13,15,28
053 Montan,48,,26,15,41
053 Montan,49,,13,10,23
053 Montan,50,,15,20,35
053 Montan,51,,16,16,32
053 Montan,52,,18,11,29
053 Montan,53,,14,10,24
053 Montan,54,,14,9,23
053 Montan,55,,11,10,21
053 Montan,56,,12,11,23
053 Montan,57,,8,15,23
053 Montan,58,,8,14,22
053 Montan,59,,10,12,22
053 Montan,60,,11,7,18
053 Montan,61,,12,3,15
053 Montan,62,,6,7,13
053 Montan,63,,4,4,8
053 Montan,64,,9,4,13
053 Montan,65,,5,5,10
053 Montan,66,,6,10,16
053 Montan,67,,5,3,8
053 Montan,68,,5,3,8
053 Montan,69,,3,4,7
053 Montan,70,,5,7,12
053 Montan,71,,5,6,11
053 Montan,72,,6,6,12
053 Montan,73,,8,7,15
053 Montan,74,,4,11,15
053 Montan,75,,5,10,15
053 Montan,76,,1,5,6
053 Montan,77,,6,9,15
053 Montan,78,,1,8,9
053 Montan,79,,2,6,8
053 Montan,80,,13,3,16
053 Montan,81,,5,5,10
053 Montan,82,,6,10,16
053 Montan,83,,7,12,19
053 Montan,84,,3,6,9
053 Montan,85,,4,3,7
053 Montan,86,,1,3,4
053 Montan,87,,4,5,9
053 Montan,88,,-,8,8
053 Montan,89,,1,3,4
053 Montan,90,,-,5,5
053 Montan,91,,3,1,4
053 Montan,92,,-,1,1
053 Montan,93,,1,1,2
053 Montan,94,,-,1,1
053 Montan,95,,-,2,2
053 Montan,98,,-,1,1
054 Moos in Passeier,0,,12,11,23
054 Moos in Passeier,1,,10,13,23
054 Moos in Passeier,2,,21,12,33
054 Moos in Passeier,3,,8,8,16
054 Moos in Passeier,4,,9,14,23
054 Moos in Passeier,5,,16,11,27
054 Moos in Passeier,6,,18,7,25
054 Moos in Passeier,7,,16,9,25
054 Moos in Passeier,8,,17,13,30
054 Moos in Passeier,9,,17,19,36
054 Moos in Passeier,10,,16,10,26
054 Moos in Passeier,11,,21,18,39
054 Moos in Passeier,12,,14,11,25
054 Moos in Passeier,13,,11,19,30
054 Moos in Passeier,14,,24,9,33
054 Moos in Passeier,15,,16,14,30
054 Moos in Passeier,16,,12,17,29
054 Moos in Passeier,17,,18,19,37
054 Moos in Passeier,18,,8,11,19
054 Moos in Passeier,19,,17,19,36
054 Moos in Passeier,20,,17,12,29
054 Moos in Passeier,21,,19,16,35
054 Moos in Passeier,22,,16,16,32
054 Moos in Passeier,23,,14,14,28
054 Moos in Passeier,24,,15,16,31
054 Moos in Passeier,25,,17,13,30
054 Moos in Passeier,26,,15,11,26
054 Moos in Passeier,27,,15,11,26
054 Moos in Passeier,28,,18,12,30
054 Moos in Passeier,29,,19,19,38
054 Moos in Passeier,30,,13,11,24
054 Moos in Passeier,31,,13,13,26
054 Moos in Passeier,32,,12,14,26
054 Moos in Passeier,33,,11,13,24
054 Moos in Passeier,34,,16,10,26
054 Moos in Passeier,35,,17,14,31
054 Moos in Passeier,36,,17,13,30
054 Moos in Passeier,37,,14,8,22
054 Moos in Passeier,38,,15,11,26
054 Moos in Passeier,39,,23,14,37
054 Moos in Passeier,40,,7,20,27
054 Moos in Passeier,41,,17,13,30
054 Moos in Passeier,42,,17,16,33
054 Moos in Passeier,43,,19,10,29
054 Moos in Passeier,44,,15,18,33
054 Moos in Passeier,45,,16,16,32
054 Moos in Passeier,46,,22,15,37
054 Moos in Passeier,47,,23,17,40
054 Moos in Passeier,48,,19,8,27
054 Moos in Passeier,49,,20,11,31
054 Moos in Passeier,50,,14,18,32
054 Moos in Passeier,51,,10,18,28
054 Moos in Passeier,52,,9,7,16
054 Moos in Passeier,53,,14,15,29
054 Moos in Passeier,54,,14,12,26
054 Moos in Passeier,55,,12,15,27
054 Moos in Passeier,56,,19,6,25
054 Moos in Passeier,57,,9,8,17
054 Moos in Passeier,58,,8,8,16
054 Moos in Passeier,59,,14,9,23
054 Moos in Passeier,60,,7,8,15
054 Moos in Passeier,61,,8,3,11
054 Moos in Passeier,62,,10,10,20
054 Moos in Passeier,63,,6,10,16
054 Moos in Passeier,64,,12,9,21
054 Moos in Passeier,65,,6,6,12
054 Moos in Passeier,66,,16,10,26
054 Moos in Passeier,67,,9,8,17
054 Moos in Passeier,68,,9,6,15
054 Moos in Passeier,69,,9,7,16
054 Moos in Passeier,70,,12,11,23
054 Moos in Passeier,71,,4,12,16
054 Moos in Passeier,72,,8,13,21
054 Moos in Passeier,73,,8,6,14
054 Moos in Passeier,74,,5,4,9
054 Moos in Passeier,75,,9,6,15
054 Moos in Passeier,76,,4,6,10
054 Moos in Passeier,77,,8,6,14
054 Moos in Passeier,78,,8,5,13
054 Moos in Passeier,79,,10,13,23
054 Moos in Passeier,80,,5,9,14
054 Moos in Passeier,81,,8,2,10
054 Moos in Passeier,82,,5,4,9
054 Moos in Passeier,83,,6,6,12
054 Moos in Passeier,84,,6,9,15
054 Moos in Passeier,85,,3,7,10
054 Moos in Passeier,86,,3,4,7
054 Moos in Passeier,87,,3,2,5
054 Moos in Passeier,88,,3,4,7
054 Moos in Passeier,89,,2,4,6
054 Moos in Passeier,90,,2,1,3
054 Moos in Passeier,91,,-,1,1
054 Moos in Passeier,93,,-,1,1
054 Moos in Passeier,94,,-,2,2
055 Nals,0,,14,16,30
055 Nals,1,,10,9,19
055 Nals,2,,12,12,24
055 Nals,3,,8,14,22
055 Nals,4,,9,11,20
055 Nals,5,,13,6,19
055 Nals,6,,9,11,20
055 Nals,7,,11,3,14
055 Nals,8,,7,12,19
055 Nals,9,,7,8,15
055 Nals,10,,13,5,18
055 Nals,11,,11,12,23
055 Nals,12,,7,9,16
055 Nals,13,,6,13,19
055 Nals,14,,14,9,23
055 Nals,15,,13,8,21
055 Nals,16,,11,10,21
055 Nals,17,,12,11,23
055 Nals,18,,7,6,13
055 Nals,19,,10,8,18
055 Nals,20,,7,14,21
055 Nals,21,,11,9,20
055 Nals,22,,11,10,21
055 Nals,23,,8,9,17
055 Nals,24,,13,10,23
055 Nals,25,,13,14,27
055 Nals,26,,12,12,24
055 Nals,27,,8,7,15
055 Nals,28,,13,9,22
055 Nals,29,,8,10,18
055 Nals,30,,7,13,20
055 Nals,31,,8,15,23
055 Nals,32,,13,11,24
055 Nals,33,,16,12,28
055 Nals,34,,12,13,25
055 Nals,35,,12,16,28
055 Nals,36,,9,19,28
055 Nals,37,,15,17,32
055 Nals,38,,8,12,20
055 Nals,39,,21,16,37
055 Nals,40,,15,9,24
055 Nals,41,,13,19,32
055 Nals,42,,17,19,36
055 Nals,43,,24,11,35
055 Nals,44,,23,21,44
055 Nals,45,,24,16,40
055 Nals,46,,19,16,35
055 Nals,47,,15,16,31
055 Nals,48,,17,16,33
055 Nals,49,,15,20,35
055 Nals,50,,12,23,35
055 Nals,51,,10,14,24
055 Nals,52,,18,15,33
055 Nals,53,,16,11,27
055 Nals,54,,14,17,31
055 Nals,55,,16,16,32
055 Nals,56,,10,5,15
055 Nals,57,,7,7,14
055 Nals,58,,22,13,35
055 Nals,59,,7,6,13
055 Nals,60,,7,8,15
055 Nals,61,,7,6,13
055 Nals,62,,3,10,13
055 Nals,63,,7,11,18
055 Nals,64,,9,8,17
055 Nals,65,,10,12,22
055 Nals,66,,11,5,16
055 Nals,67,,8,14,22
055 Nals,68,,7,11,18
055 Nals,69,,6,11,17
055 Nals,70,,9,7,16
055 Nals,71,,5,9,14
055 Nals,72,,11,5,16
055 Nals,73,,7,12,19
055 Nals,74,,7,11,18
055 Nals,75,,4,8,12
055 Nals,76,,3,13,16
055 Nals,77,,6,4,10
055 Nals,78,,5,6,11
055 Nals,79,,4,6,10
055 Nals,80,,6,10,16
055 Nals,81,,5,5,10
055 Nals,82,,2,5,7
055 Nals,83,,1,5,6
055 Nals,84,,5,6,11
055 Nals,85,,5,5,10
055 Nals,86,,1,5,6
055 Nals,87,,5,2,7
055 Nals,88,,2,-,2
055 Nals,89,,1,-,1
055 Nals,90,,-,3,3
055 Nals,91,,1,2,3
055 Nals,92,,-,2,2
055 Nals,94,,-,1,1
055 Nals,97,,-,1,1
056 Naturns,0,,34,32,66
056 Naturns,1,,34,31,65
056 Naturns,2,,36,27,63
056 Naturns,3,,39,22,61
056 Naturns,4,,23,28,51
056 Naturns,5,,34,21,55
056 Naturns,6,,34,33,67
056 Naturns,7,,38,30,68
056 Naturns,8,,33,23,56
056 Naturns,9,,35,33,68
056 Naturns,10,,38,23,61
056 Naturns,11,,28,27,55
056 Naturns,12,,33,29,62
056 Naturns,13,,31,25,56
056 Naturns,14,,30,29,59
056 Naturns,15,,29,37,66
056 Naturns,16,,21,19,40
056 Naturns,17,,33,38,71
056 Naturns,18,,46,36,82
056 Naturns,19,,32,38,70
056 Naturns,20,,35,40,75
056 Naturns,21,,32,41,73
056 Naturns,22,,45,43,88
056 Naturns,23,,37,33,70
056 Naturns,24,,45,30,75
056 Naturns,25,,51,35,86
056 Naturns,26,,35,21,56
056 Naturns,27,,28,31,59
056 Naturns,28,,42,30,72
056 Naturns,29,,39,23,62
056 Naturns,30,,36,40,76
056 Naturns,31,,44,44,88
056 Naturns,32,,42,48,90
056 Naturns,33,,36,40,76
056 Naturns,34,,51,37,88
056 Naturns,35,,46,47,93
056 Naturns,36,,40,40,80
056 Naturns,37,,45,33,78
056 Naturns,38,,49,40,89
056 Naturns,39,,44,46,90
056 Naturns,40,,47,50,97
056 Naturns,41,,51,48,99
056 Naturns,42,,40,41,81
056 Naturns,43,,55,42,97
056 Naturns,44,,44,47,91
056 Naturns,45,,48,40,88
056 Naturns,46,,49,48,97
056 Naturns,47,,56,44,100
056 Naturns,48,,36,55,91
056 Naturns,49,,52,37,89
056 Naturns,50,,43,49,92
056 Naturns,51,,40,44,84
056 Naturns,52,,40,52,92
056 Naturns,53,,57,40,97
056 Naturns,54,,43,41,84
056 Naturns,55,,32,36,68
056 Naturns,56,,35,32,67
056 Naturns,57,,44,45,89
056 Naturns,58,,30,31,61
056 Naturns,59,,39,31,70
056 Naturns,60,,32,22,54
056 Naturns,61,,28,37,65
056 Naturns,62,,33,32,65
056 Naturns,63,,30,33,63
056 Naturns,64,,24,20,44
056 Naturns,65,,27,22,49
056 Naturns,66,,9,23,32
056 Naturns,67,,22,30,52
056 Naturns,68,,25,18,43
056 Naturns,69,,18,19,37
056 Naturns,70,,24,33,57
056 Naturns,71,,29,33,62
056 Naturns,72,,35,29,64
056 Naturns,73,,22,20,42
056 Naturns,74,,17,21,38
056 Naturns,75,,19,17,36
056 Naturns,76,,20,19,39
056 Naturns,77,,17,21,38
056 Naturns,78,,15,12,27
056 Naturns,79,,14,18,32
056 Naturns,80,,13,13,26
056 Naturns,81,,8,15,23
056 Naturns,82,,7,17,24
056 Naturns,83,,10,19,29
056 Naturns,84,,10,15,25
056 Naturns,85,,8,10,18
056 Naturns,86,,2,11,13
056 Naturns,87,,9,9,18
056 Naturns,88,,7,9,16
056 Naturns,89,,8,7,15
056 Naturns,90,,1,7,8
056 Naturns,91,,1,3,4
056 Naturns,92,,-,5,5
056 Naturns,93,,1,2,3
056 Naturns,94,,-,4,4
056 Naturns,100,,1,1,2
057 Natz-Schabs,0,,17,22,39
057 Natz-Schabs,1,,15,28,43
057 Natz-Schabs,2,,27,15,42
057 Natz-Schabs,3,,15,13,28
057 Natz-Schabs,4,,12,23,35
057 Natz-Schabs,5,,17,21,38
057 Natz-Schabs,6,,14,14,28
057 Natz-Schabs,7,,15,19,34
057 Natz-Schabs,8,,13,15,28
057 Natz-Schabs,9,,15,19,34
057 Natz-Schabs,10,,18,17,35
057 Natz-Schabs,11,,24,18,42
057 Natz-Schabs,12,,15,15,30
057 Natz-Schabs,13,,22,17,39
057 Natz-Schabs,14,,16,20,36
057 Natz-Schabs,15,,24,17,41
057 Natz-Schabs,16,,20,17,37
057 Natz-Schabs,17,,23,17,40
057 Natz-Schabs,18,,13,12,25
057 Natz-Schabs,19,,20,15,35
057 Natz-Schabs,20,,18,21,39
057 Natz-Schabs,21,,16,16,32
057 Natz-Schabs,22,,21,23,44
057 Natz-Schabs,23,,13,25,38
057 Natz-Schabs,24,,17,27,44
057 Natz-Schabs,25,,24,13,37
057 Natz-Schabs,26,,21,20,41
057 Natz-Schabs,27,,18,17,35
057 Natz-Schabs,28,,20,24,44
057 Natz-Schabs,29,,20,13,33
057 Natz-Schabs,30,,20,25,45
057 Natz-Schabs,31,,15,30,45
057 Natz-Schabs,32,,22,23,45
057 Natz-Schabs,33,,28,19,47
057 Natz-Schabs,34,,20,16,36
057 Natz-Schabs,35,,20,28,48
057 Natz-Schabs,36,,23,17,40
057 Natz-Schabs,37,,14,24,38
057 Natz-Schabs,38,,20,27,47
057 Natz-Schabs,39,,28,31,59
057 Natz-Schabs,40,,29,22,51
057 Natz-Schabs,41,,26,23,49
057 Natz-Schabs,42,,28,24,52
057 Natz-Schabs,43,,33,25,58
057 Natz-Schabs,44,,28,25,53
057 Natz-Schabs,45,,31,22,53
057 Natz-Schabs,46,,28,23,51
057 Natz-Schabs,47,,32,21,53
057 Natz-Schabs,48,,33,36,69
057 Natz-Schabs,49,,30,27,57
057 Natz-Schabs,50,,25,29,54
057 Natz-Schabs,51,,17,22,39
057 Natz-Schabs,52,,16,20,36
057 Natz-Schabs,53,,32,22,54
057 Natz-Schabs,54,,20,20,40
057 Natz-Schabs,55,,22,20,42
057 Natz-Schabs,56,,19,22,41
057 Natz-Schabs,57,,16,22,38
057 Natz-Schabs,58,,20,17,37
057 Natz-Schabs,59,,11,16,27
057 Natz-Schabs,60,,21,14,35
057 Natz-Schabs,61,,12,10,22
057 Natz-Schabs,62,,15,13,28
057 Natz-Schabs,63,,14,14,28
057 Natz-Schabs,64,,18,15,33
057 Natz-Schabs,65,,15,12,27
057 Natz-Schabs,66,,11,14,25
057 Natz-Schabs,67,,15,12,27
057 Natz-Schabs,68,,8,6,14
057 Natz-Schabs,69,,13,10,23
057 Natz-Schabs,70,,14,6,20
057 Natz-Schabs,71,,12,8,20
057 Natz-Schabs,72,,12,8,20
057 Natz-Schabs,73,,4,7,11
057 Natz-Schabs,74,,1,5,6
057 Natz-Schabs,75,,6,5,11
057 Natz-Schabs,76,,8,6,14
057 Natz-Schabs,77,,6,4,10
057 Natz-Schabs,78,,5,5,10
057 Natz-Schabs,79,,2,3,5
057 Natz-Schabs,80,,6,9,15
057 Natz-Schabs,81,,3,6,9
057 Natz-Schabs,82,,3,4,7
057 Natz-Schabs,83,,3,8,11
057 Natz-Schabs,84,,7,3,10
057 Natz-Schabs,85,,2,5,7
057 Natz-Schabs,86,,-,2,2
057 Natz-Schabs,87,,2,1,3
057 Natz-Schabs,88,,2,1,3
057 Natz-Schabs,89,,-,2,2
057 Natz-Schabs,90,,-,1,1
057 Natz-Schabs,91,,2,2,4
057 Natz-Schabs,92,,1,1,2
057 Natz-Schabs,93,,1,2,3
057 Natz-Schabs,95,,-,1,1
058 Welschnofen,0,,7,4,11
058 Welschnofen,1,,10,12,22
058 Welschnofen,2,,13,4,17
058 Welschnofen,3,,4,7,11
058 Welschnofen,4,,9,4,13
058 Welschnofen,5,,9,8,17
058 Welschnofen,6,,9,7,16
058 Welschnofen,7,,7,7,14
058 Welschnofen,8,,8,12,20
058 Welschnofen,9,,15,7,22
058 Welschnofen,10,,10,8,18
058 Welschnofen,11,,17,7,24
058 Welschnofen,12,,7,10,17
058 Welschnofen,13,,8,8,16
058 Welschnofen,14,,10,13,23
058 Welschnofen,15,,13,10,23
058 Welschnofen,16,,12,12,24
058 Welschnofen,17,,9,10,19
058 Welschnofen,18,,14,14,28
058 Welschnofen,19,,12,10,22
058 Welschnofen,20,,11,10,21
058 Welschnofen,21,,18,14,32
058 Welschnofen,22,,15,12,27
058 Welschnofen,23,,10,13,23
058 Welschnofen,24,,14,9,23
058 Welschnofen,25,,12,16,28
058 Welschnofen,26,,10,9,19
058 Welschnofen,27,,8,10,18
058 Welschnofen,28,,11,14,25
058 Welschnofen,29,,9,5,14
058 Welschnofen,30,,12,14,26
058 Welschnofen,31,,12,16,28
058 Welschnofen,32,,14,16,30
058 Welschnofen,33,,13,10,23
058 Welschnofen,34,,9,10,19
058 Welschnofen,35,,12,18,30
058 Welschnofen,36,,13,14,27
058 Welschnofen,37,,16,10,26
058 Welschnofen,38,,20,14,34
058 Welschnofen,39,,12,17,29
058 Welschnofen,40,,15,16,31
058 Welschnofen,41,,12,12,24
058 Welschnofen,42,,18,21,39
058 Welschnofen,43,,19,15,34
058 Welschnofen,44,,11,15,26
058 Welschnofen,45,,22,19,41
058 Welschnofen,46,,17,16,33
058 Welschnofen,47,,13,14,27
058 Welschnofen,48,,22,14,36
058 Welschnofen,49,,16,8,24
058 Welschnofen,50,,18,15,33
058 Welschnofen,51,,15,13,28
058 Welschnofen,52,,17,18,35
058 Welschnofen,53,,17,10,27
058 Welschnofen,54,,15,13,28
058 Welschnofen,55,,17,10,27
058 Welschnofen,56,,10,16,26
058 Welschnofen,57,,12,11,23
058 Welschnofen,58,,15,14,29
058 Welschnofen,59,,13,11,24
058 Welschnofen,60,,11,13,24
058 Welschnofen,61,,11,11,22
058 Welschnofen,62,,14,7,21
058 Welschnofen,63,,8,10,18
058 Welschnofen,64,,10,12,22
058 Welschnofen,65,,8,11,19
058 Welschnofen,66,,8,6,14
058 Welschnofen,67,,12,10,22
058 Welschnofen,68,,12,4,16
058 Welschnofen,69,,7,9,16
058 Welschnofen,70,,12,9,21
058 Welschnofen,71,,10,12,22
058 Welschnofen,72,,9,6,15
058 Welschnofen,73,,5,7,12
058 Welschnofen,74,,9,6,15
058 Welschnofen,75,,6,7,13
058 Welschnofen,76,,8,3,11
058 Welschnofen,77,,5,12,17
058 Welschnofen,78,,7,6,13
058 Welschnofen,79,,8,9,17
058 Welschnofen,80,,6,12,18
058 Welschnofen,81,,6,6,12
058 Welschnofen,82,,3,6,9
058 Welschnofen,83,,4,7,11
058 Welschnofen,84,,2,11,13
058 Welschnofen,85,,5,2,7
058 Welschnofen,86,,-,3,3
058 Welschnofen,87,,1,4,5
058 Welschnofen,88,,3,4,7
058 Welschnofen,89,,1,5,6
058 Welschnofen,90,,3,4,7
058 Welschnofen,91,,3,4,7
058 Welschnofen,92,,1,6,7
058 Welschnofen,93,,-,2,2
058 Welschnofen,94,,1,2,3
059 Deutschnofen,0,,30,12,42
059 Deutschnofen,1,,23,19,42
059 Deutschnofen,2,,15,19,34
059 Deutschnofen,3,,22,17,39
059 Deutschnofen,4,,30,19,49
059 Deutschnofen,5,,19,19,38
059 Deutschnofen,6,,18,16,34
059 Deutschnofen,7,,22,25,47
059 Deutschnofen,8,,28,33,61
059 Deutschnofen,9,,18,31,49
059 Deutschnofen,10,,17,35,52
059 Deutschnofen,11,,32,14,46
059 Deutschnofen,12,,24,32,56
059 Deutschnofen,13,,24,27,51
059 Deutschnofen,14,,28,23,51
059 Deutschnofen,15,,34,12,46
059 Deutschnofen,16,,23,30,53
059 Deutschnofen,17,,20,27,47
059 Deutschnofen,18,,26,25,51
059 Deutschnofen,19,,27,16,43
059 Deutschnofen,20,,24,24,48
059 Deutschnofen,21,,35,30,65
059 Deutschnofen,22,,24,19,43
059 Deutschnofen,23,,33,28,61
059 Deutschnofen,24,,25,21,46
059 Deutschnofen,25,,20,33,53
059 Deutschnofen,26,,22,26,48
059 Deutschnofen,27,,32,20,52
059 Deutschnofen,28,,25,25,50
059 Deutschnofen,29,,33,28,61
059 Deutschnofen,30,,24,28,52
059 Deutschnofen,31,,21,29,50
059 Deutschnofen,32,,22,18,40
059 Deutschnofen,33,,27,27,54
059 Deutschnofen,34,,25,24,49
059 Deutschnofen,35,,22,16,38
059 Deutschnofen,36,,30,23,53
059 Deutschnofen,37,,25,22,47
059 Deutschnofen,38,,19,21,40
059 Deutschnofen,39,,27,33,60
059 Deutschnofen,40,,25,31,56
059 Deutschnofen,41,,32,34,66
059 Deutschnofen,42,,27,26,53
059 Deutschnofen,43,,32,31,63
059 Deutschnofen,44,,41,29,70
059 Deutschnofen,45,,25,34,59
059 Deutschnofen,46,,29,28,57
059 Deutschnofen,47,,36,37,73
059 Deutschnofen,48,,34,20,54
059 Deutschnofen,49,,31,30,61
059 Deutschnofen,50,,33,26,59
059 Deutschnofen,51,,25,29,54
059 Deutschnofen,52,,34,23,57
059 Deutschnofen,53,,42,28,70
059 Deutschnofen,54,,29,20,49
059 Deutschnofen,55,,21,28,49
059 Deutschnofen,56,,20,25,45
059 Deutschnofen,57,,30,28,58
059 Deutschnofen,58,,31,21,52
059 Deutschnofen,59,,29,22,51
059 Deutschnofen,60,,22,18,40
059 Deutschnofen,61,,24,21,45
059 Deutschnofen,62,,20,17,37
059 Deutschnofen,63,,17,18,35
059 Deutschnofen,64,,20,16,36
059 Deutschnofen,65,,22,16,38
059 Deutschnofen,66,,11,12,23
059 Deutschnofen,67,,16,21,37
059 Deutschnofen,68,,14,14,28
059 Deutschnofen,69,,16,15,31
059 Deutschnofen,70,,20,22,42
059 Deutschnofen,71,,16,17,33
059 Deutschnofen,72,,17,22,39
059 Deutschnofen,73,,14,16,30
059 Deutschnofen,74,,23,13,36
059 Deutschnofen,75,,14,19,33
059 Deutschnofen,76,,11,7,18
059 Deutschnofen,77,,13,10,23
059 Deutschnofen,78,,7,11,18
059 Deutschnofen,79,,11,8,19
059 Deutschnofen,80,,5,13,18
059 Deutschnofen,81,,13,13,26
059 Deutschnofen,82,,5,8,13
059 Deutschnofen,83,,5,9,14
059 Deutschnofen,84,,4,5,9
059 Deutschnofen,85,,5,19,24
059 Deutschnofen,86,,6,11,17
059 Deutschnofen,87,,7,7,14
059 Deutschnofen,88,,1,15,16
059 Deutschnofen,89,,1,9,10
059 Deutschnofen,90,,1,6,7
059 Deutschnofen,91,,3,5,8
059 Deutschnofen,92,,2,4,6
059 Deutschnofen,93,,1,3,4
059 Deutschnofen,94,,-,1,1
059 Deutschnofen,95,,-,1,1
059 Deutschnofen,96,,-,1,1
059 Deutschnofen,97,,-,1,1
059 Deutschnofen,98,,-,1,1
059 Deutschnofen,99,,-,1,1
059 Deutschnofen,103,,1,-,1
060 Auer,0,,17,13,30
060 Auer,1,,22,12,34
060 Auer,2,,21,20,41
060 Auer,3,,22,13,35
060 Auer,4,,19,28,47
060 Auer,5,,11,20,31
060 Auer,6,,20,10,30
060 Auer,7,,15,15,30
060 Auer,8,,24,21,45
060 Auer,9,,19,20,39
060 Auer,10,,20,11,31
060 Auer,11,,31,18,49
060 Auer,12,,18,28,46
060 Auer,13,,22,20,42
060 Auer,14,,19,25,44
060 Auer,15,,25,25,50
060 Auer,16,,20,17,37
060 Auer,17,,21,22,43
060 Auer,18,,17,15,32
060 Auer,19,,25,21,46
060 Auer,20,,12,21,33
060 Auer,21,,17,23,40
060 Auer,22,,29,19,48
060 Auer,23,,18,22,40
060 Auer,24,,21,22,43
060 Auer,25,,22,30,52
060 Auer,26,,24,18,42
060 Auer,27,,19,18,37
060 Auer,28,,22,27,49
060 Auer,29,,19,20,39
060 Auer,30,,17,20,37
060 Auer,31,,18,25,43
060 Auer,32,,22,19,41
060 Auer,33,,20,19,39
060 Auer,34,,27,20,47
060 Auer,35,,14,22,36
060 Auer,36,,20,31,51
060 Auer,37,,22,34,56
060 Auer,38,,20,14,34
060 Auer,39,,26,24,50
060 Auer,40,,27,28,55
060 Auer,41,,20,25,45
060 Auer,42,,42,29,71
060 Auer,43,,31,26,57
060 Auer,44,,20,30,50
060 Auer,45,,32,36,68
060 Auer,46,,28,27,55
060 Auer,47,,37,41,78
060 Auer,48,,32,27,59
060 Auer,49,,30,25,55
060 Auer,50,,32,41,73
060 Auer,51,,26,22,48
060 Auer,52,,31,35,66
060 Auer,53,,32,31,63
060 Auer,54,,37,32,69
060 Auer,55,,35,24,59
060 Auer,56,,19,26,45
060 Auer,57,,30,30,60
060 Auer,58,,15,21,36
060 Auer,59,,21,14,35
060 Auer,60,,17,24,41
060 Auer,61,,17,22,39
060 Auer,62,,14,21,35
060 Auer,63,,16,21,37
060 Auer,64,,16,12,28
060 Auer,65,,28,14,42
060 Auer,66,,18,19,37
060 Auer,67,,15,24,39
060 Auer,68,,13,13,26
060 Auer,69,,20,16,36
060 Auer,70,,13,17,30
060 Auer,71,,15,19,34
060 Auer,72,,18,15,33
060 Auer,73,,11,8,19
060 Auer,74,,10,20,30
060 Auer,75,,16,17,33
060 Auer,76,,8,10,18
060 Auer,77,,7,7,14
060 Auer,78,,7,14,21
060 Auer,79,,12,12,24
060 Auer,80,,3,8,11
060 Auer,81,,4,13,17
060 Auer,82,,5,10,15
060 Auer,83,,5,5,10
060 Auer,84,,7,12,19
060 Auer,85,,5,5,10
060 Auer,86,,3,9,12
060 Auer,87,,-,15,15
060 Auer,88,,8,5,13
060 Auer,89,,5,5,10
060 Auer,90,,5,6,11
060 Auer,91,,1,5,6
060 Auer,92,,-,3,3
060 Auer,93,,2,3,5
060 Auer,94,,2,2,4
060 Auer,95,,-,2,2
060 Auer,96,,-,1,1
060 Auer,97,,-,2,2
060 Auer,98,,-,1,1
060 Auer,100,,1,-,1
061 St.Ulrich,0,,18,21,39
061 St.Ulrich,1,,25,15,40
061 St.Ulrich,2,,27,26,53
061 St.Ulrich,3,,22,23,45
061 St.Ulrich,4,,24,18,42
061 St.Ulrich,5,,37,24,61
061 St.Ulrich,6,,29,33,62
061 St.Ulrich,7,,34,26,60
061 St.Ulrich,8,,32,23,55
061 St.Ulrich,9,,23,31,54
061 St.Ulrich,10,,23,30,53
061 St.Ulrich,11,,25,37,62
061 St.Ulrich,12,,23,20,43
061 St.Ulrich,13,,31,35,66
061 St.Ulrich,14,,44,30,74
061 St.Ulrich,15,,49,37,86
061 St.Ulrich,16,,35,27,62
061 St.Ulrich,17,,30,22,52
061 St.Ulrich,18,,32,31,63
061 St.Ulrich,19,,29,31,60
061 St.Ulrich,20,,24,31,55
061 St.Ulrich,21,,34,28,62
061 St.Ulrich,22,,32,34,66
061 St.Ulrich,23,,29,23,52
061 St.Ulrich,24,,18,21,39
061 St.Ulrich,25,,17,24,41
061 St.Ulrich,26,,31,20,51
061 St.Ulrich,27,,22,19,41
061 St.Ulrich,28,,20,22,42
061 St.Ulrich,29,,20,21,41
061 St.Ulrich,30,,16,19,35
061 St.Ulrich,31,,20,33,53
061 St.Ulrich,32,,27,32,59
061 St.Ulrich,33,,23,33,56
061 St.Ulrich,34,,28,34,62
061 St.Ulrich,35,,21,32,53
061 St.Ulrich,36,,24,25,49
061 St.Ulrich,37,,34,34,68
061 St.Ulrich,38,,41,25,66
061 St.Ulrich,39,,37,36,73
061 St.Ulrich,40,,34,28,62
061 St.Ulrich,41,,41,33,74
061 St.Ulrich,42,,41,37,78
061 St.Ulrich,43,,38,36,74
061 St.Ulrich,44,,41,43,84
061 St.Ulrich,45,,40,46,86
061 St.Ulrich,46,,41,38,79
061 St.Ulrich,47,,30,38,68
061 St.Ulrich,48,,38,31,69
061 St.Ulrich,49,,36,40,76
061 St.Ulrich,50,,36,35,71
061 St.Ulrich,51,,31,35,66
061 St.Ulrich,52,,25,26,51
061 St.Ulrich,53,,32,27,59
061 St.Ulrich,54,,36,25,61
061 St.Ulrich,55,,25,19,44
061 St.Ulrich,56,,24,31,55
061 St.Ulrich,57,,17,33,50
061 St.Ulrich,58,,25,36,61
061 St.Ulrich,59,,27,32,59
061 St.Ulrich,60,,27,22,49
061 St.Ulrich,61,,13,29,42
061 St.Ulrich,62,,25,25,50
061 St.Ulrich,63,,19,26,45
061 St.Ulrich,64,,16,29,45
061 St.Ulrich,65,,28,28,56
061 St.Ulrich,66,,21,23,44
061 St.Ulrich,67,,30,23,53
061 St.Ulrich,68,,16,16,32
061 St.Ulrich,69,,25,32,57
061 St.Ulrich,70,,36,35,71
061 St.Ulrich,71,,27,34,61
061 St.Ulrich,72,,34,42,76
061 St.Ulrich,73,,26,28,54
061 St.Ulrich,74,,15,19,34
061 St.Ulrich,75,,21,23,44
061 St.Ulrich,76,,20,25,45
061 St.Ulrich,77,,19,16,35
061 St.Ulrich,78,,11,22,33
061 St.Ulrich,79,,14,9,23
061 St.Ulrich,80,,12,11,23
061 St.Ulrich,81,,12,20,32
061 St.Ulrich,82,,13,13,26
061 St.Ulrich,83,,15,8,23
061 St.Ulrich,84,,8,4,12
061 St.Ulrich,85,,10,12,22
061 St.Ulrich,86,,6,10,16
061 St.Ulrich,87,,4,10,14
061 St.Ulrich,88,,6,8,14
061 St.Ulrich,89,,2,10,12
061 St.Ulrich,90,,-,11,11
061 St.Ulrich,91,,2,5,7
061 St.Ulrich,92,,4,7,11
061 St.Ulrich,93,,2,8,10
061 St.Ulrich,94,,1,4,5
061 St.Ulrich,95,,1,2,3
061 St.Ulrich,97,,-,1,1
061 St.Ulrich,98,,1,1,2
061 St.Ulrich,99,,1,-,1
061 St.Ulrich,100,,-,2,2
061 St.Ulrich,101,,-,1,1
061 St.Ulrich,103,,-,1,1
062 Partschins,0,,14,20,34
062 Partschins,1,,25,17,42
062 Partschins,2,,18,15,33
062 Partschins,3,,19,19,38
062 Partschins,4,,18,18,36
062 Partschins,5,,22,14,36
062 Partschins,6,,16,20,36
062 Partschins,7,,17,18,35
062 Partschins,8,,18,23,41
062 Partschins,9,,17,24,41
062 Partschins,10,,25,17,42
062 Partschins,11,,26,18,44
062 Partschins,12,,14,14,28
062 Partschins,13,,22,15,37
062 Partschins,14,,16,20,36
062 Partschins,15,,20,10,30
062 Partschins,16,,24,23,47
062 Partschins,17,,14,17,31
062 Partschins,18,,25,15,40
062 Partschins,19,,22,20,42
062 Partschins,20,,26,20,46
062 Partschins,21,,25,17,42
062 Partschins,22,,26,30,56
062 Partschins,23,,22,27,49
062 Partschins,24,,11,28,39
062 Partschins,25,,19,30,49
062 Partschins,26,,18,19,37
062 Partschins,27,,25,19,44
062 Partschins,28,,11,13,24
062 Partschins,29,,23,24,47
062 Partschins,30,,18,23,41
062 Partschins,31,,16,24,40
062 Partschins,32,,25,31,56
062 Partschins,33,,29,29,58
062 Partschins,34,,20,26,46
062 Partschins,35,,24,12,36
062 Partschins,36,,26,20,46
062 Partschins,37,,19,19,38
062 Partschins,38,,29,19,48
062 Partschins,39,,25,27,52
062 Partschins,40,,32,28,60
062 Partschins,41,,28,27,55
062 Partschins,42,,25,37,62
062 Partschins,43,,27,34,61
062 Partschins,44,,38,27,65
062 Partschins,45,,25,34,59
062 Partschins,46,,35,27,62
062 Partschins,47,,37,37,74
062 Partschins,48,,30,27,57
062 Partschins,49,,30,41,71
062 Partschins,50,,31,25,56
062 Partschins,51,,33,22,55
062 Partschins,52,,22,23,45
062 Partschins,53,,28,39,67
062 Partschins,54,,29,25,54
062 Partschins,55,,20,22,42
062 Partschins,56,,24,26,50
062 Partschins,57,,23,18,41
062 Partschins,58,,28,22,50
062 Partschins,59,,16,31,47
062 Partschins,60,,20,19,39
062 Partschins,61,,14,15,29
062 Partschins,62,,20,18,38
062 Partschins,63,,19,20,39
062 Partschins,64,,9,12,21
062 Partschins,65,,17,19,36
062 Partschins,66,,15,19,34
062 Partschins,67,,25,26,51
062 Partschins,68,,12,15,27
062 Partschins,69,,16,14,30
062 Partschins,70,,21,23,44
062 Partschins,71,,13,16,29
062 Partschins,72,,23,29,52
062 Partschins,73,,14,13,27
062 Partschins,74,,11,13,24
062 Partschins,75,,15,12,27
062 Partschins,76,,13,15,28
062 Partschins,77,,13,17,30
062 Partschins,78,,8,8,16
062 Partschins,79,,9,15,24
062 Partschins,80,,7,14,21
062 Partschins,81,,13,10,23
062 Partschins,82,,9,16,25
062 Partschins,83,,6,7,13
062 Partschins,84,,7,6,13
062 Partschins,85,,7,5,12
062 Partschins,86,,8,10,18
062 Partschins,87,,6,8,14
062 Partschins,88,,3,7,10
062 Partschins,89,,3,8,11
062 Partschins,90,,5,7,12
062 Partschins,91,,2,3,5
062 Partschins,92,,7,3,10
062 Partschins,93,,-,1,1
062 Partschins,94,,2,2,4
062 Partschins,95,,1,-,1
062 Partschins,96,,-,1,1
062 Partschins,97,,-,1,1
063 Percha,0,,13,12,25
063 Percha,1,,6,7,13
063 Percha,2,,5,9,14
063 Percha,3,,5,11,16
063 Percha,4,,11,7,18
063 Percha,5,,8,5,13
063 Percha,6,,10,6,16
063 Percha,7,,2,3,5
063 Percha,8,,6,9,15
063 Percha,9,,10,16,26
063 Percha,10,,9,7,16
063 Percha,11,,10,7,17
063 Percha,12,,4,5,9
063 Percha,13,,11,10,21
063 Percha,14,,7,7,14
063 Percha,15,,8,8,16
063 Percha,16,,12,16,28
063 Percha,17,,10,6,16
063 Percha,18,,7,8,15
063 Percha,19,,10,11,21
063 Percha,20,,7,8,15
063 Percha,21,,13,6,19
063 Percha,22,,11,10,21
063 Percha,23,,9,9,18
063 Percha,24,,7,9,16
063 Percha,25,,6,4,10
063 Percha,26,,11,20,31
063 Percha,27,,4,9,13
063 Percha,28,,9,10,19
063 Percha,29,,14,5,19
063 Percha,30,,17,12,29
063 Percha,31,,7,13,20
063 Percha,32,,11,9,20
063 Percha,33,,10,6,16
063 Percha,34,,5,12,17
063 Percha,35,,13,13,26
063 Percha,36,,12,4,16
063 Percha,37,,13,17,30
063 Percha,38,,7,12,19
063 Percha,39,,8,11,19
063 Percha,40,,16,12,28
063 Percha,41,,12,9,21
063 Percha,42,,19,18,37
063 Percha,43,,8,9,17
063 Percha,44,,20,13,33
063 Percha,45,,18,16,34
063 Percha,46,,11,10,21
063 Percha,47,,20,6,26
063 Percha,48,,14,20,34
063 Percha,49,,16,8,24
063 Percha,50,,11,15,26
063 Percha,51,,18,10,28
063 Percha,52,,8,12,20
063 Percha,53,,13,8,21
063 Percha,54,,7,11,18
063 Percha,55,,9,8,17
063 Percha,56,,9,5,14
063 Percha,57,,6,15,21
063 Percha,58,,9,9,18
063 Percha,59,,5,6,11
063 Percha,60,,8,7,15
063 Percha,61,,6,10,16
063 Percha,62,,7,7,14
063 Percha,63,,6,7,13
063 Percha,64,,9,5,14
063 Percha,65,,5,5,10
063 Percha,66,,6,7,13
063 Percha,67,,7,8,15
063 Percha,68,,8,5,13
063 Percha,69,,12,5,17
063 Percha,70,,7,8,15
063 Percha,71,,8,7,15
063 Percha,72,,6,7,13
063 Percha,73,,4,5,9
063 Percha,74,,6,5,11
063 Percha,75,,5,9,14
063 Percha,76,,2,5,7
063 Percha,77,,3,1,4
063 Percha,78,,3,4,7
063 Percha,79,,6,5,11
063 Percha,80,,1,5,6
063 Percha,81,,4,3,7
063 Percha,82,,5,-,5
063 Percha,83,,6,2,8
063 Percha,84,,-,3,3
063 Percha,85,,1,2,3
063 Percha,86,,4,2,6
063 Percha,87,,2,5,7
063 Percha,88,,1,3,4
063 Percha,90,,1,2,3
064 Plaus,0,,6,2,8
064 Plaus,1,,3,6,9
064 Plaus,2,,4,1,5
064 Plaus,3,,6,4,10
064 Plaus,4,,4,4,8
064 Plaus,5,,5,4,9
064 Plaus,6,,5,5,10
064 Plaus,7,,4,1,5
064 Plaus,8,,4,1,5
064 Plaus,9,,5,3,8
064 Plaus,10,,3,3,6
064 Plaus,11,,4,6,10
064 Plaus,12,,8,4,12
064 Plaus,13,,11,4,15
064 Plaus,14,,13,6,19
064 Plaus,15,,6,7,13
064 Plaus,16,,8,4,12
064 Plaus,17,,4,3,7
064 Plaus,18,,2,2,4
064 Plaus,19,,8,1,9
064 Plaus,20,,11,2,13
064 Plaus,21,,7,7,14
064 Plaus,22,,3,9,12
064 Plaus,23,,4,2,6
064 Plaus,24,,6,4,10
064 Plaus,25,,5,4,9
064 Plaus,26,,4,3,7
064 Plaus,27,,-,4,4
064 Plaus,28,,4,5,9
064 Plaus,29,,6,4,10
064 Plaus,30,,1,3,4
064 Plaus,31,,-,4,4
064 Plaus,32,,2,6,8
064 Plaus,33,,7,4,11
064 Plaus,34,,4,5,9
064 Plaus,35,,3,5,8
064 Plaus,36,,2,8,10
064 Plaus,37,,5,4,9
064 Plaus,38,,14,5,19
064 Plaus,39,,6,11,17
064 Plaus,40,,11,6,17
064 Plaus,41,,8,6,14
064 Plaus,42,,6,9,15
064 Plaus,43,,7,4,11
064 Plaus,44,,6,10,16
064 Plaus,45,,4,8,12
064 Plaus,46,,9,10,19
064 Plaus,47,,4,5,9
064 Plaus,48,,12,3,15
064 Plaus,49,,7,9,16
064 Plaus,50,,2,5,7
064 Plaus,51,,8,6,14
064 Plaus,52,,7,3,10
064 Plaus,53,,3,7,10
064 Plaus,54,,7,1,8
064 Plaus,55,,3,3,6
064 Plaus,56,,3,3,6
064 Plaus,57,,3,2,5
064 Plaus,58,,1,5,6
064 Plaus,59,,1,2,3
064 Plaus,60,,3,5,8
064 Plaus,61,,4,1,5
064 Plaus,62,,4,3,7
064 Plaus,63,,1,2,3
064 Plaus,64,,4,3,7
064 Plaus,65,,1,3,4
064 Plaus,66,,2,4,6
064 Plaus,67,,4,1,5
064 Plaus,68,,4,1,5
064 Plaus,69,,2,2,4
064 Plaus,70,,5,1,6
064 Plaus,71,,-,4,4
064 Plaus,72,,3,2,5
064 Plaus,73,,3,1,4
064 Plaus,74,,4,2,6
064 Plaus,75,,1,-,1
064 Plaus,76,,3,3,6
064 Plaus,78,,1,2,3
064 Plaus,79,,4,1,5
064 Plaus,80,,2,3,5
064 Plaus,81,,2,3,5
064 Plaus,82,,-,1,1
064 Plaus,84,,1,1,2
064 Plaus,85,,-,1,1
064 Plaus,86,,1,1,2
064 Plaus,87,,-,1,1
064 Plaus,89,,-,1,1
064 Plaus,90,,-,1,1
064 Plaus,94,,-,1,1
064 Plaus,98,,-,1,1
065 Waidbruck,0,,1,2,3
065 Waidbruck,1,,1,-,1
065 Waidbruck,2,,1,1,2
065 Waidbruck,4,,2,4,6
065 Waidbruck,6,,3,-,3
065 Waidbruck,7,,3,-,3
065 Waidbruck,9,,1,1,2
065 Waidbruck,10,,-,2,2
065 Waidbruck,11,,1,1,2
065 Waidbruck,12,,1,-,1
065 Waidbruck,13,,1,2,3
065 Waidbruck,14,,2,1,3
065 Waidbruck,16,,4,3,7
065 Waidbruck,17,,4,1,5
065 Waidbruck,18,,2,2,4
065 Waidbruck,19,,3,2,5
065 Waidbruck,20,,2,2,4
065 Waidbruck,21,,-,5,5
065 Waidbruck,22,,2,-,2
065 Waidbruck,23,,-,1,1
065 Waidbruck,24,,3,2,5
065 Waidbruck,25,,-,1,1
065 Waidbruck,26,,2,1,3
065 Waidbruck,27,,1,2,3
065 Waidbruck,28,,3,-,3
065 Waidbruck,29,,2,-,2
065 Waidbruck,30,,2,-,2
065 Waidbruck,32,,3,1,4
065 Waidbruck,33,,1,1,2
065 Waidbruck,35,,4,-,4
065 Waidbruck,36,,-,1,1
065 Waidbruck,38,,1,1,2
065 Waidbruck,39,,2,3,5
065 Waidbruck,40,,-,1,1
065 Waidbruck,41,,2,2,4
065 Waidbruck,42,,2,-,2
065 Waidbruck,43,,2,2,4
065 Waidbruck,44,,4,2,6
065 Waidbruck,45,,2,2,4
065 Waidbruck,46,,2,4,6
065 Waidbruck,47,,3,3,6
065 Waidbruck,48,,3,1,4
065 Waidbruck,49,,3,-,3
065 Waidbruck,50,,-,2,2
065 Waidbruck,51,,1,-,1
065 Waidbruck,52,,1,2,3
065 Waidbruck,53,,3,1,4
065 Waidbruck,54,,2,1,3
065 Waidbruck,55,,-,1,1
065 Waidbruck,56,,2,1,3
065 Waidbruck,57,,2,-,2
065 Waidbruck,58,,3,-,3
065 Waidbruck,61,,1,1,2
065 Waidbruck,62,,-,1,1
065 Waidbruck,66,,-,1,1
065 Waidbruck,67,,-,3,3
065 Waidbruck,68,,1,1,2
065 Waidbruck,69,,2,1,3
065 Waidbruck,70,,-,1,1
065 Waidbruck,71,,1,1,2
065 Waidbruck,72,,-,1,1
065 Waidbruck,73,,-,3,3
065 Waidbruck,74,,1,-,1
065 Waidbruck,75,,-,2,2
065 Waidbruck,76,,1,-,1
065 Waidbruck,77,,1,1,2
065 Waidbruck,78,,-,3,3
065 Waidbruck,79,,1,1,2
065 Waidbruck,81,,-,3,3
065 Waidbruck,82,,1,-,1
065 Waidbruck,83,,1,-,1
065 Waidbruck,84,,-,1,1
065 Waidbruck,85,,1,-,1
065 Waidbruck,86,,1,1,2
065 Waidbruck,87,,-,1,1
065 Waidbruck,88,,1,-,1
065 Waidbruck,93,,-,1,1
066 Burgstall,0,,14,16,30
066 Burgstall,1,,8,10,18
066 Burgstall,2,,13,17,30
066 Burgstall,3,,11,12,23
066 Burgstall,4,,15,7,22
066 Burgstall,5,,13,15,28
066 Burgstall,6,,10,7,17
066 Burgstall,7,,8,10,18
066 Burgstall,8,,7,7,14
066 Burgstall,9,,14,7,21
066 Burgstall,10,,10,11,21
066 Burgstall,11,,7,13,20
066 Burgstall,12,,8,9,17
066 Burgstall,13,,10,11,21
066 Burgstall,14,,11,10,21
066 Burgstall,15,,9,8,17
066 Burgstall,16,,12,8,20
066 Burgstall,17,,8,7,15
066 Burgstall,18,,12,7,19
066 Burgstall,19,,6,4,10
066 Burgstall,20,,6,10,16
066 Burgstall,21,,6,7,13
066 Burgstall,22,,7,10,17
066 Burgstall,23,,13,10,23
066 Burgstall,24,,11,7,18
066 Burgstall,25,,10,10,20
066 Burgstall,26,,8,14,22
066 Burgstall,27,,10,7,17
066 Burgstall,28,,6,10,16
066 Burgstall,29,,11,15,26
066 Burgstall,30,,11,13,24
066 Burgstall,31,,11,14,25
066 Burgstall,32,,9,9,18
066 Burgstall,33,,14,9,23
066 Burgstall,34,,15,13,28
066 Burgstall,35,,8,11,19
066 Burgstall,36,,13,19,32
066 Burgstall,37,,6,10,16
066 Burgstall,38,,22,16,38
066 Burgstall,39,,8,16,24
066 Burgstall,40,,9,21,30
066 Burgstall,41,,14,21,35
066 Burgstall,42,,16,15,31
066 Burgstall,43,,21,16,37
066 Burgstall,44,,19,11,30
066 Burgstall,45,,22,19,41
066 Burgstall,46,,14,15,29
066 Burgstall,47,,14,17,31
066 Burgstall,48,,19,18,37
066 Burgstall,49,,16,13,29
066 Burgstall,50,,19,17,36
066 Burgstall,51,,16,11,27
066 Burgstall,52,,16,19,35
066 Burgstall,53,,15,13,28
066 Burgstall,54,,11,7,18
066 Burgstall,55,,15,10,25
066 Burgstall,56,,10,11,21
066 Burgstall,57,,14,11,25
066 Burgstall,58,,8,12,20
066 Burgstall,59,,10,17,27
066 Burgstall,60,,10,11,21
066 Burgstall,61,,14,13,27
066 Burgstall,62,,13,6,19
066 Burgstall,63,,10,11,21
066 Burgstall,64,,8,9,17
066 Burgstall,65,,7,11,18
066 Burgstall,66,,7,10,17
066 Burgstall,67,,9,9,18
066 Burgstall,68,,8,8,16
066 Burgstall,69,,8,10,18
066 Burgstall,70,,11,7,18
066 Burgstall,71,,5,5,10
066 Burgstall,72,,6,5,11
066 Burgstall,73,,5,12,17
066 Burgstall,74,,5,8,13
066 Burgstall,75,,9,12,21
066 Burgstall,76,,4,8,12
066 Burgstall,77,,4,6,10
066 Burgstall,78,,7,3,10
066 Burgstall,79,,3,7,10
066 Burgstall,80,,6,4,10
066 Burgstall,81,,2,6,8
066 Burgstall,82,,6,3,9
066 Burgstall,83,,4,5,9
066 Burgstall,84,,-,4,4
066 Burgstall,85,,3,4,7
066 Burgstall,86,,1,10,11
066 Burgstall,87,,3,8,11
066 Burgstall,88,,1,3,4
066 Burgstall,89,,1,5,6
066 Burgstall,90,,1,1,2
066 Burgstall,91,,1,3,4
066 Burgstall,93,,1,-,1
066 Burgstall,94,,-,1,1
066 Burgstall,95,,-,1,1
066 Burgstall,96,,1,-,1
067 Prad am Stilfser Joch,0,,11,13,24
067 Prad am Stilfser Joch,1,,13,15,28
067 Prad am Stilfser Joch,2,,15,14,29
067 Prad am Stilfser Joch,3,,19,13,32
067 Prad am Stilfser Joch,4,,13,12,25
067 Prad am Stilfser Joch,5,,16,17,33
067 Prad am Stilfser Joch,6,,14,9,23
067 Prad am Stilfser Joch,7,,18,17,35
067 Prad am Stilfser Joch,8,,21,14,35
067 Prad am Stilfser Joch,9,,20,22,42
067 Prad am Stilfser Joch,10,,15,14,29
067 Prad am Stilfser Joch,11,,13,17,30
067 Prad am Stilfser Joch,12,,24,17,41
067 Prad am Stilfser Joch,13,,18,18,36
067 Prad am Stilfser Joch,14,,19,21,40
067 Prad am Stilfser Joch,15,,20,23,43
067 Prad am Stilfser Joch,16,,28,19,47
067 Prad am Stilfser Joch,17,,22,21,43
067 Prad am Stilfser Joch,18,,22,14,36
067 Prad am Stilfser Joch,19,,24,27,51
067 Prad am Stilfser Joch,20,,23,28,51
067 Prad am Stilfser Joch,21,,19,23,42
067 Prad am Stilfser Joch,22,,18,11,29
067 Prad am Stilfser Joch,23,,19,21,40
067 Prad am Stilfser Joch,24,,18,17,35
067 Prad am Stilfser Joch,25,,31,18,49
067 Prad am Stilfser Joch,26,,12,23,35
067 Prad am Stilfser Joch,27,,25,31,56
067 Prad am Stilfser Joch,28,,27,20,47
067 Prad am Stilfser Joch,29,,28,28,56
067 Prad am Stilfser Joch,30,,23,23,46
067 Prad am Stilfser Joch,31,,24,18,42
067 Prad am Stilfser Joch,32,,20,21,41
067 Prad am Stilfser Joch,33,,27,18,45
067 Prad am Stilfser Joch,34,,16,19,35
067 Prad am Stilfser Joch,35,,22,18,40
067 Prad am Stilfser Joch,36,,22,29,51
067 Prad am Stilfser Joch,37,,28,18,46
067 Prad am Stilfser Joch,38,,23,18,41
067 Prad am Stilfser Joch,39,,27,18,45
067 Prad am Stilfser Joch,40,,20,40,60
067 Prad am Stilfser Joch,41,,22,25,47
067 Prad am Stilfser Joch,42,,26,26,52
067 Prad am Stilfser Joch,43,,26,24,50
067 Prad am Stilfser Joch,44,,30,32,62
067 Prad am Stilfser Joch,45,,32,36,68
067 Prad am Stilfser Joch,46,,29,22,51
067 Prad am Stilfser Joch,47,,35,26,61
067 Prad am Stilfser Joch,48,,34,27,61
067 Prad am Stilfser Joch,49,,22,26,48
067 Prad am Stilfser Joch,50,,29,11,40
067 Prad am Stilfser Joch,51,,28,33,61
067 Prad am Stilfser Joch,52,,23,27,50
067 Prad am Stilfser Joch,53,,21,26,47
067 Prad am Stilfser Joch,54,,34,17,51
067 Prad am Stilfser Joch,55,,20,27,47
067 Prad am Stilfser Joch,56,,26,25,51
067 Prad am Stilfser Joch,57,,24,24,48
067 Prad am Stilfser Joch,58,,25,19,44
067 Prad am Stilfser Joch,59,,25,16,41
067 Prad am Stilfser Joch,60,,28,18,46
067 Prad am Stilfser Joch,61,,14,20,34
067 Prad am Stilfser Joch,62,,17,23,40
067 Prad am Stilfser Joch,63,,18,17,35
067 Prad am Stilfser Joch,64,,21,21,42
067 Prad am Stilfser Joch,65,,18,11,29
067 Prad am Stilfser Joch,66,,14,13,27
067 Prad am Stilfser Joch,67,,16,14,30
067 Prad am Stilfser Joch,68,,13,11,24
067 Prad am Stilfser Joch,69,,10,15,25
067 Prad am Stilfser Joch,70,,22,17,39
067 Prad am Stilfser Joch,71,,15,16,31
067 Prad am Stilfser Joch,72,,25,8,33
067 Prad am Stilfser Joch,73,,7,16,23
067 Prad am Stilfser Joch,74,,11,15,26
067 Prad am Stilfser Joch,75,,14,12,26
067 Prad am Stilfser Joch,76,,5,9,14
067 Prad am Stilfser Joch,77,,7,9,16
067 Prad am Stilfser Joch,78,,13,11,24
067 Prad am Stilfser Joch,79,,6,20,26
067 Prad am Stilfser Joch,80,,11,10,21
067 Prad am Stilfser Joch,81,,8,18,26
067 Prad am Stilfser Joch,82,,6,9,15
067 Prad am Stilfser Joch,83,,7,9,16
067 Prad am Stilfser Joch,84,,7,12,19
067 Prad am Stilfser Joch,85,,5,5,10
067 Prad am Stilfser Joch,86,,4,9,13
067 Prad am Stilfser Joch,87,,4,3,7
067 Prad am Stilfser Joch,88,,4,1,5
067 Prad am Stilfser Joch,89,,2,4,6
067 Prad am Stilfser Joch,90,,2,7,9
067 Prad am Stilfser Joch,91,,-,5,5
067 Prad am Stilfser Joch,92,,1,1,2
067 Prad am Stilfser Joch,93,,-,2,2
067 Prad am Stilfser Joch,94,,2,1,3
067 Prad am Stilfser Joch,97,,-,1,1
067 Prad am Stilfser Joch,99,,-,1,1
068 Prettau,0,,2,3,5
068 Prettau,1,,2,-,2
068 Prettau,2,,5,3,8
068 Prettau,3,,1,1,2
068 Prettau,4,,1,1,2
068 Prettau,5,,7,3,10
068 Prettau,6,,5,2,7
068 Prettau,7,,5,7,12
068 Prettau,8,,2,1,3
068 Prettau,9,,4,5,9
068 Prettau,10,,2,4,6
068 Prettau,11,,1,2,3
068 Prettau,12,,3,5,8
068 Prettau,13,,1,3,4
068 Prettau,14,,5,6,11
068 Prettau,15,,6,4,10
068 Prettau,16,,1,6,7
068 Prettau,17,,1,2,3
068 Prettau,18,,4,4,8
068 Prettau,19,,3,7,10
068 Prettau,20,,3,5,8
068 Prettau,21,,2,3,5
068 Prettau,22,,1,4,5
068 Prettau,23,,1,6,7
068 Prettau,24,,-,2,2
068 Prettau,25,,4,2,6
068 Prettau,26,,5,1,6
068 Prettau,27,,1,2,3
068 Prettau,28,,1,1,2
068 Prettau,29,,4,8,12
068 Prettau,30,,4,1,5
068 Prettau,31,,2,3,5
068 Prettau,32,,3,-,3
068 Prettau,33,,4,4,8
068 Prettau,34,,5,3,8
068 Prettau,35,,1,2,3
068 Prettau,36,,3,2,5
068 Prettau,37,,1,3,4
068 Prettau,38,,3,1,4
068 Prettau,39,,5,1,6
068 Prettau,40,,6,6,12
068 Prettau,41,,9,4,13
068 Prettau,42,,4,6,10
068 Prettau,43,,3,6,9
068 Prettau,44,,6,5,11
068 Prettau,45,,3,1,4
068 Prettau,46,,10,3,13
068 Prettau,47,,6,-,6
068 Prettau,48,,3,7,10
068 Prettau,49,,6,6,12
068 Prettau,50,,5,5,10
068 Prettau,51,,2,5,7
068 Prettau,52,,5,5,10
068 Prettau,53,,5,4,9
068 Prettau,54,,5,2,7
068 Prettau,55,,7,-,7
068 Prettau,56,,4,1,5
068 Prettau,57,,5,6,11
068 Prettau,58,,6,4,10
068 Prettau,59,,5,2,7
068 Prettau,60,,3,3,6
068 Prettau,61,,4,3,7
068 Prettau,62,,3,2,5
068 Prettau,63,,2,2,4
068 Prettau,64,,2,3,5
068 Prettau,65,,2,1,3
068 Prettau,66,,4,5,9
068 Prettau,67,,6,3,9
068 Prettau,68,,1,2,3
068 Prettau,69,,6,5,11
068 Prettau,70,,4,3,7
068 Prettau,71,,3,2,5
068 Prettau,72,,3,2,5
068 Prettau,73,,4,4,8
068 Prettau,74,,5,3,8
068 Prettau,75,,5,6,11
068 Prettau,76,,2,6,8
068 Prettau,77,,3,3,6
068 Prettau,78,,3,1,4
068 Prettau,79,,1,3,4
068 Prettau,80,,3,3,6
068 Prettau,81,,2,-,2
068 Prettau,82,,1,1,2
068 Prettau,83,,4,4,8
068 Prettau,84,,3,5,8
068 Prettau,85,,-,1,1
068 Prettau,86,,2,1,3
068 Prettau,87,,-,2,2
068 Prettau,88,,-,1,1
068 Prettau,90,,-,1,1
068 Prettau,91,,1,-,1
068 Prettau,95,,-,1,1
068 Prettau,100,,-,1,1
069 Proveis,0,,-,1,1
069 Proveis,1,,1,2,3
069 Proveis,2,,-,1,1
069 Proveis,3,,2,1,3
069 Proveis,4,,3,1,4
069 Proveis,5,,-,1,1
069 Proveis,6,,1,1,2
069 Proveis,7,,2,-,2
069 Proveis,8,,-,4,4
069 Proveis,9,,2,2,4
069 Proveis,10,,3,1,4
069 Proveis,11,,4,-,4
069 Proveis,12,,1,1,2
069 Proveis,13,,-,1,1
069 Proveis,14,,4,1,5
069 Proveis,15,,2,2,4
069 Proveis,16,,1,3,4
069 Proveis,17,,1,1,2
069 Proveis,18,,-,5,5
069 Proveis,19,,3,-,3
069 Proveis,20,,2,1,3
069 Proveis,21,,3,1,4
069 Proveis,22,,4,2,6
069 Proveis,24,,1,1,2
069 Proveis,25,,2,1,3
069 Proveis,26,,1,4,5
069 Proveis,27,,3,-,3
069 Proveis,28,,7,-,7
069 Proveis,29,,3,3,6
069 Proveis,30,,3,-,3
069 Proveis,31,,2,-,2
069 Proveis,32,,2,3,5
069 Proveis,34,,2,1,3
069 Proveis,35,,1,3,4
069 Proveis,36,,2,1,3
069 Proveis,37,,1,1,2
069 Proveis,38,,2,1,3
069 Proveis,39,,3,2,5
069 Proveis,40,,2,-,2
069 Proveis,41,,1,1,2
069 Proveis,42,,-,1,1
069 Proveis,43,,3,3,6
069 Proveis,44,,3,4,7
069 Proveis,45,,4,1,5
069 Proveis,46,,2,1,3
069 Proveis,47,,2,2,4
069 Proveis,48,,1,1,2
069 Proveis,49,,2,1,3
069 Proveis,50,,4,2,6
069 Proveis,51,,3,1,4
069 Proveis,52,,3,1,4
069 Proveis,53,,1,4,5
069 Proveis,54,,4,-,4
069 Proveis,55,,1,3,4
069 Proveis,56,,2,2,4
069 Proveis,57,,4,2,6
069 Proveis,58,,4,4,8
069 Proveis,59,,3,2,5
069 Proveis,60,,1,1,2
069 Proveis,61,,2,3,5
069 Proveis,62,,2,-,2
069 Proveis,63,,1,1,2
069 Proveis,64,,1,-,1
069 Proveis,65,,2,-,2
069 Proveis,66,,1,2,3
069 Proveis,67,,2,-,2
069 Proveis,68,,1,-,1
069 Proveis,69,,2,-,2
069 Proveis,70,,2,1,3
069 Proveis,71,,1,1,2
069 Proveis,72,,1,1,2
069 Proveis,73,,2,-,2
069 Proveis,74,,1,3,4
069 Proveis,75,,-,2,2
069 Proveis,76,,1,1,2
069 Proveis,77,,1,1,2
069 Proveis,78,,1,-,1
069 Proveis,80,,-,1,1
069 Proveis,81,,-,1,1
069 Proveis,82,,1,1,2
069 Proveis,84,,2,1,3
069 Proveis,85,,2,-,2
069 Proveis,86,,-,1,1
069 Proveis,89,,1,-,1
069 Proveis,91,,-,1,1
070 Ratschings,0,,22,28,50
070 Ratschings,1,,24,27,51
070 Ratschings,2,,20,24,44
070 Ratschings,3,,25,27,52
070 Ratschings,4,,22,21,43
070 Ratschings,5,,20,16,36
070 Ratschings,6,,29,25,54
070 Ratschings,7,,27,27,54
070 Ratschings,8,,22,28,50
070 Ratschings,9,,34,25,59
070 Ratschings,10,,34,23,57
070 Ratschings,11,,16,26,42
070 Ratschings,12,,26,35,61
070 Ratschings,13,,35,26,61
070 Ratschings,14,,29,22,51
070 Ratschings,15,,34,20,54
070 Ratschings,16,,36,35,71
070 Ratschings,17,,29,31,60
070 Ratschings,18,,27,27,54
070 Ratschings,19,,26,28,54
070 Ratschings,20,,27,20,47
070 Ratschings,21,,37,31,68
070 Ratschings,22,,26,21,47
070 Ratschings,23,,31,29,60
070 Ratschings,24,,28,22,50
070 Ratschings,25,,33,27,60
070 Ratschings,26,,24,24,48
070 Ratschings,27,,30,33,63
070 Ratschings,28,,31,40,71
070 Ratschings,29,,29,22,51
070 Ratschings,30,,34,22,56
070 Ratschings,31,,36,29,65
070 Ratschings,32,,31,29,60
070 Ratschings,33,,23,26,49
070 Ratschings,34,,32,30,62
070 Ratschings,35,,33,24,57
070 Ratschings,36,,31,28,59
070 Ratschings,37,,20,21,41
070 Ratschings,38,,41,35,76
070 Ratschings,39,,36,21,57
070 Ratschings,40,,34,34,68
070 Ratschings,41,,42,38,80
070 Ratschings,42,,39,40,79
070 Ratschings,43,,36,43,79
070 Ratschings,44,,36,43,79
070 Ratschings,45,,53,43,96
070 Ratschings,46,,32,39,71
070 Ratschings,47,,43,48,91
070 Ratschings,48,,35,43,78
070 Ratschings,49,,50,39,89
070 Ratschings,50,,45,26,71
070 Ratschings,51,,35,40,75
070 Ratschings,52,,35,27,62
070 Ratschings,53,,40,26,66
070 Ratschings,54,,43,27,70
070 Ratschings,55,,29,28,57
070 Ratschings,56,,30,19,49
070 Ratschings,57,,40,20,60
070 Ratschings,58,,15,33,48
070 Ratschings,59,,23,16,39
070 Ratschings,60,,23,24,47
070 Ratschings,61,,17,19,36
070 Ratschings,62,,20,14,34
070 Ratschings,63,,27,20,47
070 Ratschings,64,,19,24,43
070 Ratschings,65,,29,18,47
070 Ratschings,66,,17,17,34
070 Ratschings,67,,22,6,28
070 Ratschings,68,,20,19,39
070 Ratschings,69,,15,11,26
070 Ratschings,70,,16,13,29
070 Ratschings,71,,17,15,32
070 Ratschings,72,,18,15,33
070 Ratschings,73,,15,16,31
070 Ratschings,74,,10,17,27
070 Ratschings,75,,14,18,32
070 Ratschings,76,,12,8,20
070 Ratschings,77,,8,10,18
070 Ratschings,78,,10,14,24
070 Ratschings,79,,9,6,15
070 Ratschings,80,,9,17,26
070 Ratschings,81,,10,9,19
070 Ratschings,82,,6,10,16
070 Ratschings,83,,4,13,17
070 Ratschings,84,,6,15,21
070 Ratschings,85,,3,8,11
070 Ratschings,86,,3,8,11
070 Ratschings,87,,5,7,12
070 Ratschings,88,,3,4,7
070 Ratschings,89,,1,6,7
070 Ratschings,90,,2,1,3
070 Ratschings,91,,1,2,3
070 Ratschings,92,,1,4,5
070 Ratschings,93,,-,2,2
070 Ratschings,94,,1,-,1
070 Ratschings,95,,-,1,1
071 Rasen-Antholz,0,,15,9,24
071 Rasen-Antholz,1,,10,22,32
071 Rasen-Antholz,2,,16,20,36
071 Rasen-Antholz,3,,12,8,20
071 Rasen-Antholz,4,,14,16,30
071 Rasen-Antholz,5,,21,6,27
071 Rasen-Antholz,6,,17,17,34
071 Rasen-Antholz,7,,16,21,37
071 Rasen-Antholz,8,,25,16,41
071 Rasen-Antholz,9,,14,21,35
071 Rasen-Antholz,10,,11,23,34
071 Rasen-Antholz,11,,14,19,33
071 Rasen-Antholz,12,,19,21,40
071 Rasen-Antholz,13,,24,22,46
071 Rasen-Antholz,14,,13,18,31
071 Rasen-Antholz,15,,21,15,36
071 Rasen-Antholz,16,,25,23,48
071 Rasen-Antholz,17,,26,19,45
071 Rasen-Antholz,18,,8,14,22
071 Rasen-Antholz,19,,21,11,32
071 Rasen-Antholz,20,,17,17,34
071 Rasen-Antholz,21,,27,19,46
071 Rasen-Antholz,22,,15,17,32
071 Rasen-Antholz,23,,14,22,36
071 Rasen-Antholz,24,,20,17,37
071 Rasen-Antholz,25,,18,18,36
071 Rasen-Antholz,26,,26,10,36
071 Rasen-Antholz,27,,17,21,38
071 Rasen-Antholz,28,,22,11,33
071 Rasen-Antholz,29,,20,22,42
071 Rasen-Antholz,30,,12,21,33
071 Rasen-Antholz,31,,17,19,36
071 Rasen-Antholz,32,,21,13,34
071 Rasen-Antholz,33,,14,10,24
071 Rasen-Antholz,34,,19,25,44
071 Rasen-Antholz,35,,16,22,38
071 Rasen-Antholz,36,,14,15,29
071 Rasen-Antholz,37,,24,11,35
071 Rasen-Antholz,38,,17,23,40
071 Rasen-Antholz,39,,25,20,45
071 Rasen-Antholz,40,,28,23,51
071 Rasen-Antholz,41,,19,21,40
071 Rasen-Antholz,42,,24,26,50
071 Rasen-Antholz,43,,25,25,50
071 Rasen-Antholz,44,,25,25,50
071 Rasen-Antholz,45,,25,27,52
071 Rasen-Antholz,46,,25,28,53
071 Rasen-Antholz,47,,28,19,47
071 Rasen-Antholz,48,,31,24,55
071 Rasen-Antholz,49,,29,23,52
071 Rasen-Antholz,50,,19,21,40
071 Rasen-Antholz,51,,27,19,46
071 Rasen-Antholz,52,,18,24,42
071 Rasen-Antholz,53,,21,25,46
071 Rasen-Antholz,54,,28,19,47
071 Rasen-Antholz,55,,23,15,38
071 Rasen-Antholz,56,,20,9,29
071 Rasen-Antholz,57,,20,14,34
071 Rasen-Antholz,58,,19,14,33
071 Rasen-Antholz,59,,14,14,28
071 Rasen-Antholz,60,,14,9,23
071 Rasen-Antholz,61,,12,15,27
071 Rasen-Antholz,62,,11,11,22
071 Rasen-Antholz,63,,13,8,21
071 Rasen-Antholz,64,,14,9,23
071 Rasen-Antholz,65,,14,11,25
071 Rasen-Antholz,66,,10,14,24
071 Rasen-Antholz,67,,9,14,23
071 Rasen-Antholz,68,,11,9,20
071 Rasen-Antholz,69,,9,8,17
071 Rasen-Antholz,70,,13,12,25
071 Rasen-Antholz,71,,8,13,21
071 Rasen-Antholz,72,,13,12,25
071 Rasen-Antholz,73,,8,16,24
071 Rasen-Antholz,74,,15,12,27
071 Rasen-Antholz,75,,11,7,18
071 Rasen-Antholz,76,,7,10,17
071 Rasen-Antholz,77,,9,11,20
071 Rasen-Antholz,78,,7,9,16
071 Rasen-Antholz,79,,7,10,17
071 Rasen-Antholz,80,,5,12,17
071 Rasen-Antholz,81,,8,10,18
071 Rasen-Antholz,82,,11,14,25
071 Rasen-Antholz,83,,4,8,12
071 Rasen-Antholz,84,,5,3,8
071 Rasen-Antholz,85,,1,4,5
071 Rasen-Antholz,86,,3,3,6
071 Rasen-Antholz,87,,2,5,7
071 Rasen-Antholz,88,,5,5,10
071 Rasen-Antholz,89,,4,3,7
071 Rasen-Antholz,90,,-,5,5
071 Rasen-Antholz,91,,1,4,5
071 Rasen-Antholz,92,,2,-,2
071 Rasen-Antholz,94,,-,1,1
071 Rasen-Antholz,96,,-,1,1
072 Ritten,0,,36,39,75
072 Ritten,1,,40,44,84
072 Ritten,2,,45,41,86
072 Ritten,3,,46,41,87
072 Ritten,4,,41,47,88
072 Ritten,5,,37,54,91
072 Ritten,6,,46,53,99
072 Ritten,7,,55,49,104
072 Ritten,8,,47,51,98
072 Ritten,9,,51,55,106
072 Ritten,10,,45,41,86
072 Ritten,11,,35,50,85
072 Ritten,12,,51,45,96
072 Ritten,13,,48,44,92
072 Ritten,14,,52,53,105
072 Ritten,15,,42,46,88
072 Ritten,16,,57,55,112
072 Ritten,17,,42,52,94
072 Ritten,18,,59,42,101
072 Ritten,19,,61,45,106
072 Ritten,20,,58,48,106
072 Ritten,21,,45,69,114
072 Ritten,22,,64,48,112
072 Ritten,23,,62,43,105
072 Ritten,24,,50,38,88
072 Ritten,25,,55,53,108
072 Ritten,26,,52,43,95
072 Ritten,27,,49,50,99
072 Ritten,28,,47,53,100
072 Ritten,29,,49,27,76
072 Ritten,30,,51,55,106
072 Ritten,31,,39,50,89
072 Ritten,32,,50,54,104
072 Ritten,33,,47,45,92
072 Ritten,34,,51,54,105
072 Ritten,35,,46,46,92
072 Ritten,36,,62,34,96
072 Ritten,37,,46,54,100
072 Ritten,38,,56,49,105
072 Ritten,39,,59,59,118
072 Ritten,40,,57,50,107
072 Ritten,41,,51,66,117
072 Ritten,42,,56,68,124
072 Ritten,43,,55,74,129
072 Ritten,44,,54,70,124
072 Ritten,45,,72,65,137
072 Ritten,46,,77,49,126
072 Ritten,47,,64,46,110
072 Ritten,48,,77,41,118
072 Ritten,49,,66,56,122
072 Ritten,50,,63,50,113
072 Ritten,51,,54,62,116
072 Ritten,52,,45,59,104
072 Ritten,53,,59,59,118
072 Ritten,54,,70,51,121
072 Ritten,55,,35,45,80
072 Ritten,56,,39,44,83
072 Ritten,57,,45,45,90
072 Ritten,58,,49,39,88
072 Ritten,59,,35,35,70
072 Ritten,60,,50,31,81
072 Ritten,61,,42,43,85
072 Ritten,62,,45,35,80
072 Ritten,63,,32,41,73
072 Ritten,64,,33,47,80
072 Ritten,65,,48,37,85
072 Ritten,66,,30,30,60
072 Ritten,67,,24,38,62
072 Ritten,68,,20,27,47
072 Ritten,69,,36,39,75
072 Ritten,70,,35,37,72
072 Ritten,71,,42,36,78
072 Ritten,72,,35,37,72
072 Ritten,73,,33,23,56
072 Ritten,74,,36,29,65
072 Ritten,75,,29,31,60
072 Ritten,76,,22,22,44
072 Ritten,77,,16,23,39
072 Ritten,78,,18,26,44
072 Ritten,79,,19,27,46
072 Ritten,80,,11,23,34
072 Ritten,81,,10,19,29
072 Ritten,82,,9,27,36
072 Ritten,83,,6,18,24
072 Ritten,84,,14,15,29
072 Ritten,85,,8,11,19
072 Ritten,86,,9,11,20
072 Ritten,87,,7,11,18
072 Ritten,88,,2,20,22
072 Ritten,89,,9,16,25
072 Ritten,90,,11,12,23
072 Ritten,91,,1,7,8
072 Ritten,92,,1,10,11
072 Ritten,93,,1,4,5
072 Ritten,94,,1,1,2
072 Ritten,95,,-,2,2
072 Ritten,98,,-,1,1
072 Ritten,99,,-,1,1
072 Ritten,101,,1,-,1
072 Ritten,102,,1,1,2
073 Riffian,0,,9,6,15
073 Riffian,1,,2,9,11
073 Riffian,2,,13,13,26
073 Riffian,3,,6,8,14
073 Riffian,4,,7,10,17
073 Riffian,5,,14,5,19
073 Riffian,6,,12,9,21
073 Riffian,7,,5,10,15
073 Riffian,8,,10,9,19
073 Riffian,9,,8,3,11
073 Riffian,10,,8,8,16
073 Riffian,11,,9,7,16
073 Riffian,12,,11,9,20
073 Riffian,13,,10,8,18
073 Riffian,14,,9,9,18
073 Riffian,15,,10,7,17
073 Riffian,16,,9,7,16
073 Riffian,17,,5,8,13
073 Riffian,18,,5,9,14
073 Riffian,19,,6,10,16
073 Riffian,20,,6,6,12
073 Riffian,21,,10,8,18
073 Riffian,22,,13,16,29
073 Riffian,23,,7,7,14
073 Riffian,24,,14,1,15
073 Riffian,25,,8,9,17
073 Riffian,26,,6,10,16
073 Riffian,27,,11,9,20
073 Riffian,28,,10,5,15
073 Riffian,29,,6,7,13
073 Riffian,30,,9,6,15
073 Riffian,31,,10,12,22
073 Riffian,32,,7,8,15
073 Riffian,33,,2,6,8
073 Riffian,34,,9,7,16
073 Riffian,35,,12,7,19
073 Riffian,36,,12,13,25
073 Riffian,37,,9,4,13
073 Riffian,38,,9,15,24
073 Riffian,39,,11,12,23
073 Riffian,40,,9,10,19
073 Riffian,41,,12,25,37
073 Riffian,42,,11,13,24
073 Riffian,43,,7,9,16
073 Riffian,44,,14,14,28
073 Riffian,45,,9,13,22
073 Riffian,46,,11,14,25
073 Riffian,47,,12,6,18
073 Riffian,48,,10,6,16
073 Riffian,49,,10,8,18
073 Riffian,50,,16,12,28
073 Riffian,51,,9,12,21
073 Riffian,52,,7,8,15
073 Riffian,53,,13,5,18
073 Riffian,54,,7,13,20
073 Riffian,55,,8,6,14
073 Riffian,56,,6,10,16
073 Riffian,57,,11,6,17
073 Riffian,58,,3,7,10
073 Riffian,59,,10,6,16
073 Riffian,60,,7,4,11
073 Riffian,61,,6,4,10
073 Riffian,62,,6,9,15
073 Riffian,63,,4,3,7
073 Riffian,64,,8,6,14
073 Riffian,65,,4,4,8
073 Riffian,66,,3,4,7
073 Riffian,67,,2,8,10
073 Riffian,68,,6,3,9
073 Riffian,69,,8,8,16
073 Riffian,70,,6,7,13
073 Riffian,71,,14,8,22
073 Riffian,72,,7,3,10
073 Riffian,73,,4,4,8
073 Riffian,74,,4,9,13
073 Riffian,75,,8,4,12
073 Riffian,76,,4,5,9
073 Riffian,77,,3,4,7
073 Riffian,78,,-,3,3
073 Riffian,79,,-,3,3
073 Riffian,80,,3,5,8
073 Riffian,81,,1,5,6
073 Riffian,82,,3,7,10
073 Riffian,83,,4,3,7
073 Riffian,84,,-,7,7
073 Riffian,85,,2,5,7
073 Riffian,86,,2,3,5
073 Riffian,87,,3,2,5
073 Riffian,88,,2,-,2
073 Riffian,89,,2,2,4
073 Riffian,90,,2,5,7
073 Riffian,91,,1,-,1
073 Riffian,92,,-,1,1
073 Riffian,93,,-,1,1
073 Riffian,96,,-,1,1
073 Riffian,98,,-,1,1
074 Mühlbach,0,,28,11,39
074 Mühlbach,1,,18,20,38
074 Mühlbach,2,,21,15,36
074 Mühlbach,3,,15,23,38
074 Mühlbach,4,,20,13,33
074 Mühlbach,5,,21,17,38
074 Mühlbach,6,,21,24,45
074 Mühlbach,7,,14,8,22
074 Mühlbach,8,,19,11,30
074 Mühlbach,9,,15,22,37
074 Mühlbach,10,,24,11,35
074 Mühlbach,11,,21,19,40
074 Mühlbach,12,,15,22,37
074 Mühlbach,13,,16,17,33
074 Mühlbach,14,,20,14,34
074 Mühlbach,15,,20,19,39
074 Mühlbach,16,,20,17,37
074 Mühlbach,17,,20,17,37
074 Mühlbach,18,,14,17,31
074 Mühlbach,19,,23,15,38
074 Mühlbach,20,,18,23,41
074 Mühlbach,21,,15,24,39
074 Mühlbach,22,,17,21,38
074 Mühlbach,23,,13,16,29
074 Mühlbach,24,,14,22,36
074 Mühlbach,25,,20,16,36
074 Mühlbach,26,,23,17,40
074 Mühlbach,27,,18,9,27
074 Mühlbach,28,,19,23,42
074 Mühlbach,29,,22,25,47
074 Mühlbach,30,,19,17,36
074 Mühlbach,31,,29,31,60
074 Mühlbach,32,,25,19,44
074 Mühlbach,33,,19,19,38
074 Mühlbach,34,,22,18,40
074 Mühlbach,35,,27,27,54
074 Mühlbach,36,,25,17,42
074 Mühlbach,37,,24,21,45
074 Mühlbach,38,,19,20,39
074 Mühlbach,39,,22,16,38
074 Mühlbach,40,,23,20,43
074 Mühlbach,41,,26,22,48
074 Mühlbach,42,,30,27,57
074 Mühlbach,43,,28,17,45
074 Mühlbach,44,,24,33,57
074 Mühlbach,45,,34,18,52
074 Mühlbach,46,,22,22,44
074 Mühlbach,47,,28,17,45
074 Mühlbach,48,,25,23,48
074 Mühlbach,49,,15,22,37
074 Mühlbach,50,,21,22,43
074 Mühlbach,51,,22,17,39
074 Mühlbach,52,,24,24,48
074 Mühlbach,53,,24,15,39
074 Mühlbach,54,,22,18,40
074 Mühlbach,55,,20,13,33
074 Mühlbach,56,,15,23,38
074 Mühlbach,57,,20,24,44
074 Mühlbach,58,,20,18,38
074 Mühlbach,59,,13,20,33
074 Mühlbach,60,,18,17,35
074 Mühlbach,61,,16,23,39
074 Mühlbach,62,,12,19,31
074 Mühlbach,63,,21,19,40
074 Mühlbach,64,,16,12,28
074 Mühlbach,65,,16,13,29
074 Mühlbach,66,,11,17,28
074 Mühlbach,67,,18,11,29
074 Mühlbach,68,,8,7,15
074 Mühlbach,69,,14,11,25
074 Mühlbach,70,,10,10,20
074 Mühlbach,71,,15,13,28
074 Mühlbach,72,,16,17,33
074 Mühlbach,73,,11,11,22
074 Mühlbach,74,,9,16,25
074 Mühlbach,75,,11,6,17
074 Mühlbach,76,,5,11,16
074 Mühlbach,77,,6,6,12
074 Mühlbach,78,,6,9,15
074 Mühlbach,79,,9,12,21
074 Mühlbach,80,,8,10,18
074 Mühlbach,81,,4,6,10
074 Mühlbach,82,,5,6,11
074 Mühlbach,83,,5,7,12
074 Mühlbach,84,,4,2,6
074 Mühlbach,85,,3,14,17
074 Mühlbach,86,,4,6,10
074 Mühlbach,87,,3,6,9
074 Mühlbach,88,,3,4,7
074 Mühlbach,89,,3,4,7
074 Mühlbach,90,,1,3,4
074 Mühlbach,91,,1,7,8
074 Mühlbach,92,,-,3,3
074 Mühlbach,93,,2,2,4
074 Mühlbach,94,,-,2,2
074 Mühlbach,96,,1,-,1
075 Rodeneck,0,,9,5,14
075 Rodeneck,1,,6,3,9
075 Rodeneck,2,,2,6,8
075 Rodeneck,3,,7,4,11
075 Rodeneck,4,,3,7,10
075 Rodeneck,5,,7,10,17
075 Rodeneck,6,,7,7,14
075 Rodeneck,7,,4,3,7
075 Rodeneck,8,,9,8,17
075 Rodeneck,9,,7,4,11
075 Rodeneck,10,,8,7,15
075 Rodeneck,11,,8,3,11
075 Rodeneck,12,,10,3,13
075 Rodeneck,13,,6,13,19
075 Rodeneck,14,,8,11,19
075 Rodeneck,15,,11,7,18
075 Rodeneck,16,,10,7,17
075 Rodeneck,17,,13,9,22
075 Rodeneck,18,,5,9,14
075 Rodeneck,19,,6,12,18
075 Rodeneck,20,,6,7,13
075 Rodeneck,21,,11,10,21
075 Rodeneck,22,,6,8,14
075 Rodeneck,23,,12,8,20
075 Rodeneck,24,,7,5,12
075 Rodeneck,25,,11,10,21
075 Rodeneck,26,,5,5,10
075 Rodeneck,27,,5,11,16
075 Rodeneck,28,,12,8,20
075 Rodeneck,29,,11,9,20
075 Rodeneck,30,,10,11,21
075 Rodeneck,31,,7,6,13
075 Rodeneck,32,,10,5,15
075 Rodeneck,33,,9,11,20
075 Rodeneck,34,,6,4,10
075 Rodeneck,35,,6,6,12
075 Rodeneck,36,,6,6,12
075 Rodeneck,37,,9,8,17
075 Rodeneck,38,,7,7,14
075 Rodeneck,39,,5,6,11
075 Rodeneck,40,,17,10,27
075 Rodeneck,41,,8,9,17
075 Rodeneck,42,,14,4,18
075 Rodeneck,43,,6,11,17
075 Rodeneck,44,,14,10,24
075 Rodeneck,45,,8,11,19
075 Rodeneck,46,,11,10,21
075 Rodeneck,47,,16,8,24
075 Rodeneck,48,,7,7,14
075 Rodeneck,49,,11,12,23
075 Rodeneck,50,,10,11,21
075 Rodeneck,51,,10,11,21
075 Rodeneck,52,,9,10,19
075 Rodeneck,53,,6,10,16
075 Rodeneck,54,,10,6,16
075 Rodeneck,55,,7,4,11
075 Rodeneck,56,,6,7,13
075 Rodeneck,57,,8,4,12
075 Rodeneck,58,,6,6,12
075 Rodeneck,59,,10,3,13
075 Rodeneck,60,,3,1,4
075 Rodeneck,61,,8,4,12
075 Rodeneck,62,,3,3,6
075 Rodeneck,63,,2,8,10
075 Rodeneck,64,,2,5,7
075 Rodeneck,65,,4,7,11
075 Rodeneck,66,,5,5,10
075 Rodeneck,67,,9,7,16
075 Rodeneck,68,,2,5,7
075 Rodeneck,69,,3,4,7
075 Rodeneck,70,,2,2,4
075 Rodeneck,71,,1,6,7
075 Rodeneck,72,,10,3,13
075 Rodeneck,73,,5,4,9
075 Rodeneck,74,,3,9,12
075 Rodeneck,75,,3,3,6
075 Rodeneck,76,,2,4,6
075 Rodeneck,77,,1,2,3
075 Rodeneck,78,,3,2,5
075 Rodeneck,79,,1,9,10
075 Rodeneck,80,,3,-,3
075 Rodeneck,81,,4,5,9
075 Rodeneck,82,,4,2,6
075 Rodeneck,83,,4,4,8
075 Rodeneck,84,,5,1,6
075 Rodeneck,85,,3,4,7
075 Rodeneck,86,,1,3,4
075 Rodeneck,87,,1,3,4
075 Rodeneck,88,,1,3,4
075 Rodeneck,89,,2,2,4
075 Rodeneck,90,,2,-,2
075 Rodeneck,91,,-,1,1
075 Rodeneck,95,,-,1,1
076 Salurn,0,,18,18,36
076 Salurn,1,,23,24,47
076 Salurn,2,,25,18,43
076 Salurn,3,,29,15,44
076 Salurn,4,,22,31,53
076 Salurn,5,,27,22,49
076 Salurn,6,,25,23,48
076 Salurn,7,,25,21,46
076 Salurn,8,,15,23,38
076 Salurn,9,,25,18,43
076 Salurn,10,,29,19,48
076 Salurn,11,,17,18,35
076 Salurn,12,,17,17,34
076 Salurn,13,,20,21,41
076 Salurn,14,,21,16,37
076 Salurn,15,,18,27,45
076 Salurn,16,,13,14,27
076 Salurn,17,,27,22,49
076 Salurn,18,,21,16,37
076 Salurn,19,,20,20,40
076 Salurn,20,,20,23,43
076 Salurn,21,,25,23,48
076 Salurn,22,,15,22,37
076 Salurn,23,,16,22,38
076 Salurn,24,,17,24,41
076 Salurn,25,,24,26,50
076 Salurn,26,,25,21,46
076 Salurn,27,,19,20,39
076 Salurn,28,,18,23,41
076 Salurn,29,,14,21,35
076 Salurn,30,,18,25,43
076 Salurn,31,,21,21,42
076 Salurn,32,,21,29,50
076 Salurn,33,,27,25,52
076 Salurn,34,,19,31,50
076 Salurn,35,,21,24,45
076 Salurn,36,,31,26,57
076 Salurn,37,,30,22,52
076 Salurn,38,,27,26,53
076 Salurn,39,,25,23,48
076 Salurn,40,,30,35,65
076 Salurn,41,,31,24,55
076 Salurn,42,,38,30,68
076 Salurn,43,,33,31,64
076 Salurn,44,,27,28,55
076 Salurn,45,,35,27,62
076 Salurn,46,,27,25,52
076 Salurn,47,,26,27,53
076 Salurn,48,,27,34,61
076 Salurn,49,,35,31,66
076 Salurn,50,,39,31,70
076 Salurn,51,,31,31,62
076 Salurn,52,,29,34,63
076 Salurn,53,,22,26,48
076 Salurn,54,,25,29,54
076 Salurn,55,,30,18,48
076 Salurn,56,,22,21,43
076 Salurn,57,,17,14,31
076 Salurn,58,,19,20,39
076 Salurn,59,,20,19,39
076 Salurn,60,,18,18,36
076 Salurn,61,,29,21,50
076 Salurn,62,,25,22,47
076 Salurn,63,,25,15,40
076 Salurn,64,,26,10,36
076 Salurn,65,,13,22,35
076 Salurn,66,,16,21,37
076 Salurn,67,,22,15,37
076 Salurn,68,,12,10,22
076 Salurn,69,,18,17,35
076 Salurn,70,,16,16,32
076 Salurn,71,,21,17,38
076 Salurn,72,,16,17,33
076 Salurn,73,,11,10,21
076 Salurn,74,,11,7,18
076 Salurn,75,,5,10,15
076 Salurn,76,,10,12,22
076 Salurn,77,,12,20,32
076 Salurn,78,,11,16,27
076 Salurn,79,,9,7,16
076 Salurn,80,,9,6,15
076 Salurn,81,,5,15,20
076 Salurn,82,,6,8,14
076 Salurn,83,,9,10,19
076 Salurn,84,,8,11,19
076 Salurn,85,,7,15,22
076 Salurn,86,,1,14,15
076 Salurn,87,,6,8,14
076 Salurn,88,,4,7,11
076 Salurn,89,,2,8,10
076 Salurn,90,,3,2,5
076 Salurn,91,,-,6,6
076 Salurn,92,,1,4,5
076 Salurn,93,,3,6,9
076 Salurn,94,,1,6,7
076 Salurn,95,,-,2,2
076 Salurn,96,,-,2,2
076 Salurn,98,,1,-,1
076 Salurn,102,,-,2,2
077 Innichen,0,,14,19,33
077 Innichen,1,,12,19,31
077 Innichen,2,,25,21,46
077 Innichen,3,,21,11,32
077 Innichen,4,,9,18,27
077 Innichen,5,,20,13,33
077 Innichen,6,,16,17,33
077 Innichen,7,,12,16,28
077 Innichen,8,,15,16,31
077 Innichen,9,,12,14,26
077 Innichen,10,,19,16,35
077 Innichen,11,,14,16,30
077 Innichen,12,,24,17,41
077 Innichen,13,,15,17,32
077 Innichen,14,,11,16,27
077 Innichen,15,,22,13,35
077 Innichen,16,,21,16,37
077 Innichen,17,,17,18,35
077 Innichen,18,,22,12,34
077 Innichen,19,,18,17,35
077 Innichen,20,,25,20,45
077 Innichen,21,,23,15,38
077 Innichen,22,,16,24,40
077 Innichen,23,,20,15,35
077 Innichen,24,,23,27,50
077 Innichen,25,,29,19,48
077 Innichen,26,,25,21,46
077 Innichen,27,,27,17,44
077 Innichen,28,,25,24,49
077 Innichen,29,,20,21,41
077 Innichen,30,,22,23,45
077 Innichen,31,,26,24,50
077 Innichen,32,,16,17,33
077 Innichen,33,,25,16,41
077 Innichen,34,,28,28,56
077 Innichen,35,,14,15,29
077 Innichen,36,,20,23,43
077 Innichen,37,,15,28,43
077 Innichen,38,,19,14,33
077 Innichen,39,,24,19,43
077 Innichen,40,,22,21,43
077 Innichen,41,,23,25,48
077 Innichen,42,,25,17,42
077 Innichen,43,,24,29,53
077 Innichen,44,,18,27,45
077 Innichen,45,,25,23,48
077 Innichen,46,,27,28,55
077 Innichen,47,,27,32,59
077 Innichen,48,,37,29,66
077 Innichen,49,,31,31,62
077 Innichen,50,,30,26,56
077 Innichen,51,,30,24,54
077 Innichen,52,,22,25,47
077 Innichen,53,,28,19,47
077 Innichen,54,,28,22,50
077 Innichen,55,,22,27,49
077 Innichen,56,,18,25,43
077 Innichen,57,,26,15,41
077 Innichen,58,,25,22,47
077 Innichen,59,,23,10,33
077 Innichen,60,,24,19,43
077 Innichen,61,,11,25,36
077 Innichen,62,,12,17,29
077 Innichen,63,,15,20,35
077 Innichen,64,,18,16,34
077 Innichen,65,,14,14,28
077 Innichen,66,,12,14,26
077 Innichen,67,,14,16,30
077 Innichen,68,,10,10,20
077 Innichen,69,,10,14,24
077 Innichen,70,,20,9,29
077 Innichen,71,,16,20,36
077 Innichen,72,,13,18,31
077 Innichen,73,,8,24,32
077 Innichen,74,,12,13,25
077 Innichen,75,,8,12,20
077 Innichen,76,,8,11,19
077 Innichen,77,,8,19,27
077 Innichen,78,,4,17,21
077 Innichen,79,,10,12,22
077 Innichen,80,,9,8,17
077 Innichen,81,,10,16,26
077 Innichen,82,,10,18,28
077 Innichen,83,,11,11,22
077 Innichen,84,,8,12,20
077 Innichen,85,,8,12,20
077 Innichen,86,,2,11,13
077 Innichen,87,,7,10,17
077 Innichen,88,,2,12,14
077 Innichen,89,,3,2,5
077 Innichen,90,,4,8,12
077 Innichen,91,,1,6,7
077 Innichen,92,,2,6,8
077 Innichen,93,,1,5,6
077 Innichen,94,,1,1,2
077 Innichen,97,,-,1,1
079 Jenesien,0,,18,16,34
079 Jenesien,1,,14,13,27
079 Jenesien,2,,14,10,24
079 Jenesien,3,,18,18,36
079 Jenesien,4,,18,18,36
079 Jenesien,5,,18,20,38
079 Jenesien,6,,23,18,41
079 Jenesien,7,,20,25,45
079 Jenesien,8,,15,17,32
079 Jenesien,9,,18,19,37
079 Jenesien,10,,18,22,40
079 Jenesien,11,,14,18,32
079 Jenesien,12,,20,22,42
079 Jenesien,13,,18,16,34
079 Jenesien,14,,27,21,48
079 Jenesien,15,,15,29,44
079 Jenesien,16,,21,18,39
079 Jenesien,17,,25,12,37
079 Jenesien,18,,24,17,41
079 Jenesien,19,,20,21,41
079 Jenesien,20,,16,18,34
079 Jenesien,21,,29,21,50
079 Jenesien,22,,21,22,43
079 Jenesien,23,,18,16,34
079 Jenesien,24,,18,17,35
079 Jenesien,25,,25,14,39
079 Jenesien,26,,16,18,34
079 Jenesien,27,,16,13,29
079 Jenesien,28,,18,11,29
079 Jenesien,29,,17,16,33
079 Jenesien,30,,18,18,36
079 Jenesien,31,,16,19,35
079 Jenesien,32,,16,20,36
079 Jenesien,33,,18,18,36
079 Jenesien,34,,19,16,35
079 Jenesien,35,,13,21,34
079 Jenesien,36,,19,13,32
079 Jenesien,37,,17,21,38
079 Jenesien,38,,12,19,31
079 Jenesien,39,,23,24,47
079 Jenesien,40,,23,31,54
079 Jenesien,41,,26,26,52
079 Jenesien,42,,29,26,55
079 Jenesien,43,,30,33,63
079 Jenesien,44,,33,20,53
079 Jenesien,45,,18,25,43
079 Jenesien,46,,18,24,42
079 Jenesien,47,,37,30,67
079 Jenesien,48,,36,29,65
079 Jenesien,49,,34,33,67
079 Jenesien,50,,27,26,53
079 Jenesien,51,,26,21,47
079 Jenesien,52,,31,21,52
079 Jenesien,53,,23,12,35
079 Jenesien,54,,22,16,38
079 Jenesien,55,,23,9,32
079 Jenesien,56,,13,17,30
079 Jenesien,57,,15,14,29
079 Jenesien,58,,10,11,21
079 Jenesien,59,,19,14,33
079 Jenesien,60,,13,10,23
079 Jenesien,61,,13,18,31
079 Jenesien,62,,12,10,22
079 Jenesien,63,,14,21,35
079 Jenesien,64,,13,13,26
079 Jenesien,65,,14,9,23
079 Jenesien,66,,13,12,25
079 Jenesien,67,,10,9,19
079 Jenesien,68,,6,14,20
079 Jenesien,69,,11,11,22
079 Jenesien,70,,16,9,25
079 Jenesien,71,,14,9,23
079 Jenesien,72,,12,21,33
079 Jenesien,73,,15,11,26
079 Jenesien,74,,11,18,29
079 Jenesien,75,,16,10,26
079 Jenesien,76,,8,15,23
079 Jenesien,77,,5,18,23
079 Jenesien,78,,6,8,14
079 Jenesien,79,,8,6,14
079 Jenesien,80,,15,8,23
079 Jenesien,81,,5,7,12
079 Jenesien,82,,6,7,13
079 Jenesien,83,,4,11,15
079 Jenesien,84,,3,11,14
079 Jenesien,85,,6,6,12
079 Jenesien,86,,3,7,10
079 Jenesien,87,,5,6,11
079 Jenesien,88,,-,4,4
079 Jenesien,89,,4,2,6
079 Jenesien,90,,1,1,2
079 Jenesien,91,,1,4,5
079 Jenesien,92,,1,2,3
079 Jenesien,93,,1,1,2
079 Jenesien,94,,-,2,2
079 Jenesien,95,,-,1,1
080 St.Leonhard in Pass.,0,,22,21,43
080 St.Leonhard in Pass.,1,,13,22,35
080 St.Leonhard in Pass.,2,,16,21,37
080 St.Leonhard in Pass.,3,,21,26,47
080 St.Leonhard in Pass.,4,,18,20,38
080 St.Leonhard in Pass.,5,,18,20,38
080 St.Leonhard in Pass.,6,,21,22,43
080 St.Leonhard in Pass.,7,,18,25,43
080 St.Leonhard in Pass.,8,,21,20,41
080 St.Leonhard in Pass.,9,,17,22,39
080 St.Leonhard in Pass.,10,,25,15,40
080 St.Leonhard in Pass.,11,,24,19,43
080 St.Leonhard in Pass.,12,,29,14,43
080 St.Leonhard in Pass.,13,,23,18,41
080 St.Leonhard in Pass.,14,,22,22,44
080 St.Leonhard in Pass.,15,,20,21,41
080 St.Leonhard in Pass.,16,,23,21,44
080 St.Leonhard in Pass.,17,,23,20,43
080 St.Leonhard in Pass.,18,,22,13,35
080 St.Leonhard in Pass.,19,,20,22,42
080 St.Leonhard in Pass.,20,,26,22,48
080 St.Leonhard in Pass.,21,,23,20,43
080 St.Leonhard in Pass.,22,,20,23,43
080 St.Leonhard in Pass.,23,,25,19,44
080 St.Leonhard in Pass.,24,,37,32,69
080 St.Leonhard in Pass.,25,,22,28,50
080 St.Leonhard in Pass.,26,,28,21,49
080 St.Leonhard in Pass.,27,,33,31,64
080 St.Leonhard in Pass.,28,,23,23,46
080 St.Leonhard in Pass.,29,,28,20,48
080 St.Leonhard in Pass.,30,,24,22,46
080 St.Leonhard in Pass.,31,,26,29,55
080 St.Leonhard in Pass.,32,,24,31,55
080 St.Leonhard in Pass.,33,,22,25,47
080 St.Leonhard in Pass.,34,,28,20,48
080 St.Leonhard in Pass.,35,,27,26,53
080 St.Leonhard in Pass.,36,,30,26,56
080 St.Leonhard in Pass.,37,,14,31,45
080 St.Leonhard in Pass.,38,,27,12,39
080 St.Leonhard in Pass.,39,,31,21,52
080 St.Leonhard in Pass.,40,,27,30,57
080 St.Leonhard in Pass.,41,,27,25,52
080 St.Leonhard in Pass.,42,,33,20,53
080 St.Leonhard in Pass.,43,,21,23,44
080 St.Leonhard in Pass.,44,,23,26,49
080 St.Leonhard in Pass.,45,,32,22,54
080 St.Leonhard in Pass.,46,,22,25,47
080 St.Leonhard in Pass.,47,,34,29,63
080 St.Leonhard in Pass.,48,,33,31,64
080 St.Leonhard in Pass.,49,,25,28,53
080 St.Leonhard in Pass.,50,,22,23,45
080 St.Leonhard in Pass.,51,,24,32,56
080 St.Leonhard in Pass.,52,,28,22,50
080 St.Leonhard in Pass.,53,,32,19,51
080 St.Leonhard in Pass.,54,,30,26,56
080 St.Leonhard in Pass.,55,,25,20,45
080 St.Leonhard in Pass.,56,,20,28,48
080 St.Leonhard in Pass.,57,,25,16,41
080 St.Leonhard in Pass.,58,,25,17,42
080 St.Leonhard in Pass.,59,,18,13,31
080 St.Leonhard in Pass.,60,,28,24,52
080 St.Leonhard in Pass.,61,,19,24,43
080 St.Leonhard in Pass.,62,,24,16,40
080 St.Leonhard in Pass.,63,,15,15,30
080 St.Leonhard in Pass.,64,,21,10,31
080 St.Leonhard in Pass.,65,,22,11,33
080 St.Leonhard in Pass.,66,,19,14,33
080 St.Leonhard in Pass.,67,,14,18,32
080 St.Leonhard in Pass.,68,,9,10,19
080 St.Leonhard in Pass.,69,,11,12,23
080 St.Leonhard in Pass.,70,,8,24,32
080 St.Leonhard in Pass.,71,,8,12,20
080 St.Leonhard in Pass.,72,,13,14,27
080 St.Leonhard in Pass.,73,,18,12,30
080 St.Leonhard in Pass.,74,,18,18,36
080 St.Leonhard in Pass.,75,,11,14,25
080 St.Leonhard in Pass.,76,,16,8,24
080 St.Leonhard in Pass.,77,,15,11,26
080 St.Leonhard in Pass.,78,,9,11,20
080 St.Leonhard in Pass.,79,,6,13,19
080 St.Leonhard in Pass.,80,,9,13,22
080 St.Leonhard in Pass.,81,,6,12,18
080 St.Leonhard in Pass.,82,,4,13,17
080 St.Leonhard in Pass.,83,,5,9,14
080 St.Leonhard in Pass.,84,,6,5,11
080 St.Leonhard in Pass.,85,,5,10,15
080 St.Leonhard in Pass.,86,,3,8,11
080 St.Leonhard in Pass.,87,,4,7,11
080 St.Leonhard in Pass.,88,,4,6,10
080 St.Leonhard in Pass.,89,,2,5,7
080 St.Leonhard in Pass.,90,,3,4,7
080 St.Leonhard in Pass.,91,,-,5,5
080 St.Leonhard in Pass.,92,,1,4,5
080 St.Leonhard in Pass.,93,,1,-,1
080 St.Leonhard in Pass.,98,,1,-,1
080 St.Leonhard in Pass.,101,,-,2,2
081 St.Lorenzen,0,,24,24,48
081 St.Lorenzen,1,,19,10,29
081 St.Lorenzen,2,,20,19,39
081 St.Lorenzen,3,,28,19,47
081 St.Lorenzen,4,,20,22,42
081 St.Lorenzen,5,,24,21,45
081 St.Lorenzen,6,,21,21,42
081 St.Lorenzen,7,,15,19,34
081 St.Lorenzen,8,,26,19,45
081 St.Lorenzen,9,,26,21,47
081 St.Lorenzen,10,,26,17,43
081 St.Lorenzen,11,,18,19,37
081 St.Lorenzen,12,,30,21,51
081 St.Lorenzen,13,,21,26,47
081 St.Lorenzen,14,,28,26,54
081 St.Lorenzen,15,,33,24,57
081 St.Lorenzen,16,,18,31,49
081 St.Lorenzen,17,,29,29,58
081 St.Lorenzen,18,,26,14,40
081 St.Lorenzen,19,,30,20,50
081 St.Lorenzen,20,,26,32,58
081 St.Lorenzen,21,,24,21,45
081 St.Lorenzen,22,,23,15,38
081 St.Lorenzen,23,,24,23,47
081 St.Lorenzen,24,,16,17,33
081 St.Lorenzen,25,,20,27,47
081 St.Lorenzen,26,,20,25,45
081 St.Lorenzen,27,,24,28,52
081 St.Lorenzen,28,,24,28,52
081 St.Lorenzen,29,,30,25,55
081 St.Lorenzen,30,,26,21,47
081 St.Lorenzen,31,,31,20,51
081 St.Lorenzen,32,,24,18,42
081 St.Lorenzen,33,,21,27,48
081 St.Lorenzen,34,,25,32,57
081 St.Lorenzen,35,,27,20,47
081 St.Lorenzen,36,,25,20,45
081 St.Lorenzen,37,,28,17,45
081 St.Lorenzen,38,,28,28,56
081 St.Lorenzen,39,,26,33,59
081 St.Lorenzen,40,,33,34,67
081 St.Lorenzen,41,,40,35,75
081 St.Lorenzen,42,,34,31,65
081 St.Lorenzen,43,,28,31,59
081 St.Lorenzen,44,,23,32,55
081 St.Lorenzen,45,,44,34,78
081 St.Lorenzen,46,,30,39,69
081 St.Lorenzen,47,,37,32,69
081 St.Lorenzen,48,,31,27,58
081 St.Lorenzen,49,,35,23,58
081 St.Lorenzen,50,,33,31,64
081 St.Lorenzen,51,,30,36,66
081 St.Lorenzen,52,,24,39,63
081 St.Lorenzen,53,,33,19,52
081 St.Lorenzen,54,,31,24,55
081 St.Lorenzen,55,,29,34,63
081 St.Lorenzen,56,,23,26,49
081 St.Lorenzen,57,,25,28,53
081 St.Lorenzen,58,,16,18,34
081 St.Lorenzen,59,,13,20,33
081 St.Lorenzen,60,,24,18,42
081 St.Lorenzen,61,,18,11,29
081 St.Lorenzen,62,,17,16,33
081 St.Lorenzen,63,,17,19,36
081 St.Lorenzen,64,,10,23,33
081 St.Lorenzen,65,,16,14,30
081 St.Lorenzen,66,,20,9,29
081 St.Lorenzen,67,,18,10,28
081 St.Lorenzen,68,,10,18,28
081 St.Lorenzen,69,,17,15,32
081 St.Lorenzen,70,,13,15,28
081 St.Lorenzen,71,,18,20,38
081 St.Lorenzen,72,,16,16,32
081 St.Lorenzen,73,,13,11,24
081 St.Lorenzen,74,,12,18,30
081 St.Lorenzen,75,,12,12,24
081 St.Lorenzen,76,,18,16,34
081 St.Lorenzen,77,,10,12,22
081 St.Lorenzen,78,,9,12,21
081 St.Lorenzen,79,,14,7,21
081 St.Lorenzen,80,,11,7,18
081 St.Lorenzen,81,,8,10,18
081 St.Lorenzen,82,,7,13,20
081 St.Lorenzen,83,,5,5,10
081 St.Lorenzen,84,,9,15,24
081 St.Lorenzen,85,,3,14,17
081 St.Lorenzen,86,,4,5,9
081 St.Lorenzen,87,,5,5,10
081 St.Lorenzen,88,,1,8,9
081 St.Lorenzen,89,,2,6,8
081 St.Lorenzen,90,,1,6,7
081 St.Lorenzen,91,,-,2,2
081 St.Lorenzen,92,,2,2,4
081 St.Lorenzen,93,,-,2,2
081 St.Lorenzen,94,,1,2,3
081 St.Lorenzen,95,,-,1,1
082 St.Martin in Thurn,0,,12,7,19
082 St.Martin in Thurn,1,,7,6,13
082 St.Martin in Thurn,2,,13,5,18
082 St.Martin in Thurn,3,,6,8,14
082 St.Martin in Thurn,4,,5,5,10
082 St.Martin in Thurn,5,,7,3,10
082 St.Martin in Thurn,6,,3,10,13
082 St.Martin in Thurn,7,,9,13,22
082 St.Martin in Thurn,8,,11,9,20
082 St.Martin in Thurn,9,,17,13,30
082 St.Martin in Thurn,10,,4,6,10
082 St.Martin in Thurn,11,,15,8,23
082 St.Martin in Thurn,12,,8,15,23
082 St.Martin in Thurn,13,,7,9,16
082 St.Martin in Thurn,14,,9,19,28
082 St.Martin in Thurn,15,,11,10,21
082 St.Martin in Thurn,16,,15,11,26
082 St.Martin in Thurn,17,,24,15,39
082 St.Martin in Thurn,18,,15,11,26
082 St.Martin in Thurn,19,,15,8,23
082 St.Martin in Thurn,20,,9,9,18
082 St.Martin in Thurn,21,,17,14,31
082 St.Martin in Thurn,22,,11,11,22
082 St.Martin in Thurn,23,,6,18,24
082 St.Martin in Thurn,24,,17,12,29
082 St.Martin in Thurn,25,,6,5,11
082 St.Martin in Thurn,26,,12,9,21
082 St.Martin in Thurn,27,,12,11,23
082 St.Martin in Thurn,28,,10,15,25
082 St.Martin in Thurn,29,,7,6,13
082 St.Martin in Thurn,30,,14,10,24
082 St.Martin in Thurn,31,,14,13,27
082 St.Martin in Thurn,32,,14,6,20
082 St.Martin in Thurn,33,,11,7,18
082 St.Martin in Thurn,34,,7,9,16
082 St.Martin in Thurn,35,,17,8,25
082 St.Martin in Thurn,36,,14,11,25
082 St.Martin in Thurn,37,,13,11,24
082 St.Martin in Thurn,38,,8,9,17
082 St.Martin in Thurn,39,,7,12,19
082 St.Martin in Thurn,40,,10,10,20
082 St.Martin in Thurn,41,,12,8,20
082 St.Martin in Thurn,42,,16,14,30
082 St.Martin in Thurn,43,,12,14,26
082 St.Martin in Thurn,44,,15,16,31
082 St.Martin in Thurn,45,,17,14,31
082 St.Martin in Thurn,46,,10,10,20
082 St.Martin in Thurn,47,,16,26,42
082 St.Martin in Thurn,48,,16,21,37
082 St.Martin in Thurn,49,,11,15,26
082 St.Martin in Thurn,50,,14,14,28
082 St.Martin in Thurn,51,,15,16,31
082 St.Martin in Thurn,52,,15,19,34
082 St.Martin in Thurn,53,,16,5,21
082 St.Martin in Thurn,54,,12,9,21
082 St.Martin in Thurn,55,,12,7,19
082 St.Martin in Thurn,56,,12,9,21
082 St.Martin in Thurn,57,,8,5,13
082 St.Martin in Thurn,58,,13,9,22
082 St.Martin in Thurn,59,,8,8,16
082 St.Martin in Thurn,60,,5,10,15
082 St.Martin in Thurn,61,,3,4,7
082 St.Martin in Thurn,62,,8,8,16
082 St.Martin in Thurn,63,,8,6,14
082 St.Martin in Thurn,64,,3,6,9
082 St.Martin in Thurn,65,,7,6,13
082 St.Martin in Thurn,66,,9,7,16
082 St.Martin in Thurn,67,,7,7,14
082 St.Martin in Thurn,68,,6,4,10
082 St.Martin in Thurn,69,,11,9,20
082 St.Martin in Thurn,70,,4,8,12
082 St.Martin in Thurn,71,,7,6,13
082 St.Martin in Thurn,72,,7,6,13
082 St.Martin in Thurn,73,,3,5,8
082 St.Martin in Thurn,74,,6,8,14
082 St.Martin in Thurn,75,,8,6,14
082 St.Martin in Thurn,76,,5,12,17
082 St.Martin in Thurn,77,,4,6,10
082 St.Martin in Thurn,78,,7,4,11
082 St.Martin in Thurn,79,,5,3,8
082 St.Martin in Thurn,80,,2,9,11
082 St.Martin in Thurn,81,,6,6,12
082 St.Martin in Thurn,82,,6,6,12
082 St.Martin in Thurn,83,,4,6,10
082 St.Martin in Thurn,84,,5,6,11
082 St.Martin in Thurn,85,,2,2,4
082 St.Martin in Thurn,86,,1,3,4
082 St.Martin in Thurn,87,,4,2,6
082 St.Martin in Thurn,88,,3,4,7
082 St.Martin in Thurn,89,,4,5,9
082 St.Martin in Thurn,90,,-,5,5
082 St.Martin in Thurn,91,,5,1,6
082 St.Martin in Thurn,92,,1,1,2
082 St.Martin in Thurn,93,,-,2,2
082 St.Martin in Thurn,94,,-,2,2
082 St.Martin in Thurn,95,,-,1,1
083 St.Martin in Passeier,0,,21,12,33
083 St.Martin in Passeier,1,,20,27,47
083 St.Martin in Passeier,2,,12,23,35
083 St.Martin in Passeier,3,,27,15,42
083 St.Martin in Passeier,4,,15,20,35
083 St.Martin in Passeier,5,,22,27,49
083 St.Martin in Passeier,6,,16,21,37
083 St.Martin in Passeier,7,,24,18,42
083 St.Martin in Passeier,8,,21,18,39
083 St.Martin in Passeier,9,,21,21,42
083 St.Martin in Passeier,10,,19,16,35
083 St.Martin in Passeier,11,,16,14,30
083 St.Martin in Passeier,12,,17,17,34
083 St.Martin in Passeier,13,,12,23,35
083 St.Martin in Passeier,14,,8,20,28
083 St.Martin in Passeier,15,,22,21,43
083 St.Martin in Passeier,16,,26,25,51
083 St.Martin in Passeier,17,,21,21,42
083 St.Martin in Passeier,18,,20,19,39
083 St.Martin in Passeier,19,,22,23,45
083 St.Martin in Passeier,20,,19,22,41
083 St.Martin in Passeier,21,,23,17,40
083 St.Martin in Passeier,22,,25,25,50
083 St.Martin in Passeier,23,,22,27,49
083 St.Martin in Passeier,24,,19,20,39
083 St.Martin in Passeier,25,,15,15,30
083 St.Martin in Passeier,26,,20,27,47
083 St.Martin in Passeier,27,,23,20,43
083 St.Martin in Passeier,28,,20,27,47
083 St.Martin in Passeier,29,,21,26,47
083 St.Martin in Passeier,30,,20,12,32
083 St.Martin in Passeier,31,,20,17,37
083 St.Martin in Passeier,32,,25,22,47
083 St.Martin in Passeier,33,,21,26,47
083 St.Martin in Passeier,34,,20,15,35
083 St.Martin in Passeier,35,,33,20,53
083 St.Martin in Passeier,36,,27,25,52
083 St.Martin in Passeier,37,,21,18,39
083 St.Martin in Passeier,38,,23,21,44
083 St.Martin in Passeier,39,,23,22,45
083 St.Martin in Passeier,40,,27,22,49
083 St.Martin in Passeier,41,,21,23,44
083 St.Martin in Passeier,42,,26,24,50
083 St.Martin in Passeier,43,,32,22,54
083 St.Martin in Passeier,44,,34,25,59
083 St.Martin in Passeier,45,,28,25,53
083 St.Martin in Passeier,46,,21,24,45
083 St.Martin in Passeier,47,,26,32,58
083 St.Martin in Passeier,48,,34,24,58
083 St.Martin in Passeier,49,,19,19,38
083 St.Martin in Passeier,50,,32,20,52
083 St.Martin in Passeier,51,,22,30,52
083 St.Martin in Passeier,52,,34,22,56
083 St.Martin in Passeier,53,,25,21,46
083 St.Martin in Passeier,54,,22,23,45
083 St.Martin in Passeier,55,,25,19,44
083 St.Martin in Passeier,56,,26,11,37
083 St.Martin in Passeier,57,,19,17,36
083 St.Martin in Passeier,58,,27,14,41
083 St.Martin in Passeier,59,,11,12,23
083 St.Martin in Passeier,60,,22,16,38
083 St.Martin in Passeier,61,,6,19,25
083 St.Martin in Passeier,62,,23,11,34
083 St.Martin in Passeier,63,,11,14,25
083 St.Martin in Passeier,64,,14,13,27
083 St.Martin in Passeier,65,,10,10,20
083 St.Martin in Passeier,66,,14,14,28
083 St.Martin in Passeier,67,,12,9,21
083 St.Martin in Passeier,68,,10,10,20
083 St.Martin in Passeier,69,,17,12,29
083 St.Martin in Passeier,70,,11,11,22
083 St.Martin in Passeier,71,,13,14,27
083 St.Martin in Passeier,72,,8,14,22
083 St.Martin in Passeier,73,,4,11,15
083 St.Martin in Passeier,74,,6,13,19
083 St.Martin in Passeier,75,,11,8,19
083 St.Martin in Passeier,76,,13,19,32
083 St.Martin in Passeier,77,,12,12,24
083 St.Martin in Passeier,78,,7,13,20
083 St.Martin in Passeier,79,,13,8,21
083 St.Martin in Passeier,80,,10,9,19
083 St.Martin in Passeier,81,,3,8,11
083 St.Martin in Passeier,82,,3,10,13
083 St.Martin in Passeier,83,,3,9,12
083 St.Martin in Passeier,84,,6,10,16
083 St.Martin in Passeier,85,,3,4,7
083 St.Martin in Passeier,86,,5,2,7
083 St.Martin in Passeier,87,,-,10,10
083 St.Martin in Passeier,88,,3,4,7
083 St.Martin in Passeier,89,,2,6,8
083 St.Martin in Passeier,90,,1,3,4
083 St.Martin in Passeier,91,,-,2,2
083 St.Martin in Passeier,92,,-,5,5
083 St.Martin in Passeier,93,,1,1,2
083 St.Martin in Passeier,94,,1,1,2
083 St.Martin in Passeier,96,,-,1,1
084 St.Pankraz,0,,5,3,8
084 St.Pankraz,1,,7,4,11
084 St.Pankraz,2,,7,5,12
084 St.Pankraz,3,,8,5,13
084 St.Pankraz,4,,10,11,21
084 St.Pankraz,5,,9,9,18
084 St.Pankraz,6,,10,13,23
084 St.Pankraz,7,,8,12,20
084 St.Pankraz,8,,12,10,22
084 St.Pankraz,9,,13,9,22
084 St.Pankraz,10,,14,8,22
084 St.Pankraz,11,,8,3,11
084 St.Pankraz,12,,14,14,28
084 St.Pankraz,13,,12,12,24
084 St.Pankraz,14,,8,4,12
084 St.Pankraz,15,,13,7,20
084 St.Pankraz,16,,9,11,20
084 St.Pankraz,17,,9,9,18
084 St.Pankraz,18,,9,6,15
084 St.Pankraz,19,,8,9,17
084 St.Pankraz,20,,5,9,14
084 St.Pankraz,21,,8,11,19
084 St.Pankraz,22,,11,11,22
084 St.Pankraz,23,,12,5,17
084 St.Pankraz,24,,13,17,30
084 St.Pankraz,25,,12,8,20
084 St.Pankraz,26,,9,4,13
084 St.Pankraz,27,,10,2,12
084 St.Pankraz,28,,9,4,13
084 St.Pankraz,29,,9,6,15
084 St.Pankraz,30,,9,6,15
084 St.Pankraz,31,,11,8,19
084 St.Pankraz,32,,6,15,21
084 St.Pankraz,33,,11,9,20
084 St.Pankraz,34,,5,4,9
084 St.Pankraz,35,,12,9,21
084 St.Pankraz,36,,10,8,18
084 St.Pankraz,37,,5,11,16
084 St.Pankraz,38,,8,12,20
084 St.Pankraz,39,,13,10,23
084 St.Pankraz,40,,11,6,17
084 St.Pankraz,41,,10,19,29
084 St.Pankraz,42,,15,11,26
084 St.Pankraz,43,,13,12,25
084 St.Pankraz,44,,18,8,26
084 St.Pankraz,45,,16,16,32
084 St.Pankraz,46,,8,16,24
084 St.Pankraz,47,,15,7,22
084 St.Pankraz,48,,22,14,36
084 St.Pankraz,49,,12,12,24
084 St.Pankraz,50,,9,8,17
084 St.Pankraz,51,,15,8,23
084 St.Pankraz,52,,12,14,26
084 St.Pankraz,53,,14,4,18
084 St.Pankraz,54,,13,12,25
084 St.Pankraz,55,,5,8,13
084 St.Pankraz,56,,10,8,18
084 St.Pankraz,57,,10,15,25
084 St.Pankraz,58,,6,4,10
084 St.Pankraz,59,,11,7,18
084 St.Pankraz,60,,10,10,20
084 St.Pankraz,61,,15,9,24
084 St.Pankraz,62,,5,2,7
084 St.Pankraz,63,,10,5,15
084 St.Pankraz,64,,7,6,13
084 St.Pankraz,65,,7,2,9
084 St.Pankraz,66,,7,6,13
084 St.Pankraz,67,,4,7,11
084 St.Pankraz,68,,3,6,9
084 St.Pankraz,69,,4,7,11
084 St.Pankraz,70,,12,14,26
084 St.Pankraz,71,,9,15,24
084 St.Pankraz,72,,8,11,19
084 St.Pankraz,73,,7,6,13
084 St.Pankraz,74,,7,7,14
084 St.Pankraz,75,,5,10,15
084 St.Pankraz,76,,9,8,17
084 St.Pankraz,77,,5,3,8
084 St.Pankraz,78,,5,4,9
084 St.Pankraz,79,,5,8,13
084 St.Pankraz,80,,6,3,9
084 St.Pankraz,81,,6,10,16
084 St.Pankraz,82,,4,4,8
084 St.Pankraz,83,,3,6,9
084 St.Pankraz,84,,5,8,13
084 St.Pankraz,85,,4,7,11
084 St.Pankraz,86,,6,3,9
084 St.Pankraz,87,,1,2,3
084 St.Pankraz,88,,3,2,5
084 St.Pankraz,89,,1,4,5
084 St.Pankraz,90,,2,4,6
084 St.Pankraz,91,,2,3,5
084 St.Pankraz,92,,2,2,4
084 St.Pankraz,93,,-,1,1
084 St.Pankraz,94,,-,1,1
084 St.Pankraz,99,,-,1,1
085 St.Christina in Gröden,0,,11,11,22
085 St.Christina in Gröden,1,,8,13,21
085 St.Christina in Gröden,2,,12,10,22
085 St.Christina in Gröden,3,,8,6,14
085 St.Christina in Gröden,4,,11,6,17
085 St.Christina in Gröden,5,,15,7,22
085 St.Christina in Gröden,6,,9,7,16
085 St.Christina in Gröden,7,,9,9,18
085 St.Christina in Gröden,8,,16,10,26
085 St.Christina in Gröden,9,,14,12,26
085 St.Christina in Gröden,10,,7,7,14
085 St.Christina in Gröden,11,,11,14,25
085 St.Christina in Gröden,12,,10,11,21
085 St.Christina in Gröden,13,,18,12,30
085 St.Christina in Gröden,14,,22,10,32
085 St.Christina in Gröden,15,,10,15,25
085 St.Christina in Gröden,16,,10,12,22
085 St.Christina in Gröden,17,,12,7,19
085 St.Christina in Gröden,18,,15,10,25
085 St.Christina in Gröden,19,,8,16,24
085 St.Christina in Gröden,20,,13,12,25
085 St.Christina in Gröden,21,,14,16,30
085 St.Christina in Gröden,22,,12,18,30
085 St.Christina in Gröden,23,,8,14,22
085 St.Christina in Gröden,24,,4,10,14
085 St.Christina in Gröden,25,,10,7,17
085 St.Christina in Gröden,26,,11,7,18
085 St.Christina in Gröden,27,,14,13,27
085 St.Christina in Gröden,28,,7,7,14
085 St.Christina in Gröden,29,,9,9,18
085 St.Christina in Gröden,30,,21,16,37
085 St.Christina in Gröden,31,,9,7,16
085 St.Christina in Gröden,32,,7,12,19
085 St.Christina in Gröden,33,,13,18,31
085 St.Christina in Gröden,34,,10,12,22
085 St.Christina in Gröden,35,,4,13,17
085 St.Christina in Gröden,36,,9,11,20
085 St.Christina in Gröden,37,,16,14,30
085 St.Christina in Gröden,38,,11,13,24
085 St.Christina in Gröden,39,,11,22,33
085 St.Christina in Gröden,40,,9,12,21
085 St.Christina in Gröden,41,,18,11,29
085 St.Christina in Gröden,42,,13,14,27
085 St.Christina in Gröden,43,,21,22,43
085 St.Christina in Gröden,44,,19,13,32
085 St.Christina in Gröden,45,,26,25,51
085 St.Christina in Gröden,46,,16,14,30
085 St.Christina in Gröden,47,,20,8,28
085 St.Christina in Gröden,48,,13,16,29
085 St.Christina in Gröden,49,,12,27,39
085 St.Christina in Gröden,50,,13,18,31
085 St.Christina in Gröden,51,,18,14,32
085 St.Christina in Gröden,52,,22,17,39
085 St.Christina in Gröden,53,,21,18,39
085 St.Christina in Gröden,54,,11,12,23
085 St.Christina in Gröden,55,,8,11,19
085 St.Christina in Gröden,56,,16,11,27
085 St.Christina in Gröden,57,,11,10,21
085 St.Christina in Gröden,58,,9,9,18
085 St.Christina in Gröden,59,,11,14,25
085 St.Christina in Gröden,60,,9,9,18
085 St.Christina in Gröden,61,,5,7,12
085 St.Christina in Gröden,62,,10,5,15
085 St.Christina in Gröden,63,,7,5,12
085 St.Christina in Gröden,64,,8,9,17
085 St.Christina in Gröden,65,,8,5,13
085 St.Christina in Gröden,66,,6,8,14
085 St.Christina in Gröden,67,,8,9,17
085 St.Christina in Gröden,68,,6,6,12
085 St.Christina in Gröden,69,,5,12,17
085 St.Christina in Gröden,70,,11,14,25
085 St.Christina in Gröden,71,,8,5,13
085 St.Christina in Gröden,72,,12,7,19
085 St.Christina in Gröden,73,,9,10,19
085 St.Christina in Gröden,74,,10,9,19
085 St.Christina in Gröden,75,,7,7,14
085 St.Christina in Gröden,76,,8,4,12
085 St.Christina in Gröden,77,,10,8,18
085 St.Christina in Gröden,78,,12,3,15
085 St.Christina in Gröden,79,,7,11,18
085 St.Christina in Gröden,80,,4,9,13
085 St.Christina in Gröden,81,,6,7,13
085 St.Christina in Gröden,82,,2,6,8
085 St.Christina in Gröden,83,,10,3,13
085 St.Christina in Gröden,84,,2,8,10
085 St.Christina in Gröden,85,,2,2,4
085 St.Christina in Gröden,86,,5,6,11
085 St.Christina in Gröden,87,,5,3,8
085 St.Christina in Gröden,88,,3,5,8
085 St.Christina in Gröden,90,,1,4,5
085 St.Christina in Gröden,91,,-,2,2
085 St.Christina in Gröden,92,,-,1,1
085 St.Christina in Gröden,93,,-,1,1
085 St.Christina in Gröden,94,,-,1,1
085 St.Christina in Gröden,98,,1,-,1
085 St.Christina in Gröden,100,,2,-,2
086 Sarntal,0,,47,31,78
086 Sarntal,1,,43,44,87
086 Sarntal,2,,45,44,89
086 Sarntal,3,,43,40,83
086 Sarntal,4,,35,37,72
086 Sarntal,5,,41,55,96
086 Sarntal,6,,55,39,94
086 Sarntal,7,,43,51,94
086 Sarntal,8,,41,36,77
086 Sarntal,9,,40,39,79
086 Sarntal,10,,46,35,81
086 Sarntal,11,,29,42,71
086 Sarntal,12,,51,25,76
086 Sarntal,13,,37,42,79
086 Sarntal,14,,34,36,70
086 Sarntal,15,,51,42,93
086 Sarntal,16,,45,47,92
086 Sarntal,17,,44,41,85
086 Sarntal,18,,44,44,88
086 Sarntal,19,,34,40,74
086 Sarntal,20,,32,44,76
086 Sarntal,21,,42,38,80
086 Sarntal,22,,45,50,95
086 Sarntal,23,,45,32,77
086 Sarntal,24,,56,35,91
086 Sarntal,25,,45,46,91
086 Sarntal,26,,36,34,70
086 Sarntal,27,,37,46,83
086 Sarntal,28,,38,43,81
086 Sarntal,29,,40,38,78
086 Sarntal,30,,54,40,94
086 Sarntal,31,,57,41,98
086 Sarntal,32,,44,53,97
086 Sarntal,33,,55,38,93
086 Sarntal,34,,56,48,104
086 Sarntal,35,,55,56,111
086 Sarntal,36,,51,41,92
086 Sarntal,37,,43,36,79
086 Sarntal,38,,58,50,108
086 Sarntal,39,,45,59,104
086 Sarntal,40,,54,66,120
086 Sarntal,41,,71,40,111
086 Sarntal,42,,46,45,91
086 Sarntal,43,,65,59,124
086 Sarntal,44,,62,53,115
086 Sarntal,45,,50,44,94
086 Sarntal,46,,53,48,101
086 Sarntal,47,,49,47,96
086 Sarntal,48,,64,56,120
086 Sarntal,49,,58,67,125
086 Sarntal,50,,41,44,85
086 Sarntal,51,,56,36,92
086 Sarntal,52,,42,47,89
086 Sarntal,53,,65,46,111
086 Sarntal,54,,42,42,84
086 Sarntal,55,,56,44,100
086 Sarntal,56,,33,40,73
086 Sarntal,57,,39,29,68
086 Sarntal,58,,39,41,80
086 Sarntal,59,,36,30,66
086 Sarntal,60,,41,29,70
086 Sarntal,61,,34,42,76
086 Sarntal,62,,42,33,75
086 Sarntal,63,,34,32,66
086 Sarntal,64,,50,28,78
086 Sarntal,65,,31,39,70
086 Sarntal,66,,35,29,64
086 Sarntal,67,,34,38,72
086 Sarntal,68,,30,30,60
086 Sarntal,69,,30,29,59
086 Sarntal,70,,35,37,72
086 Sarntal,71,,35,35,70
086 Sarntal,72,,31,28,59
086 Sarntal,73,,27,41,68
086 Sarntal,74,,35,28,63
086 Sarntal,75,,28,28,56
086 Sarntal,76,,22,33,55
086 Sarntal,77,,12,21,33
086 Sarntal,78,,17,20,37
086 Sarntal,79,,15,16,31
086 Sarntal,80,,14,15,29
086 Sarntal,81,,16,23,39
086 Sarntal,82,,9,21,30
086 Sarntal,83,,11,16,27
086 Sarntal,84,,11,23,34
086 Sarntal,85,,11,19,30
086 Sarntal,86,,10,27,37
086 Sarntal,87,,7,8,15
086 Sarntal,88,,8,13,21
086 Sarntal,89,,-,12,12
086 Sarntal,90,,1,8,9
086 Sarntal,91,,2,13,15
086 Sarntal,92,,1,6,7
086 Sarntal,93,,-,6,6
086 Sarntal,94,,2,4,6
086 Sarntal,95,,-,2,2
086 Sarntal,96,,-,1,1
086 Sarntal,100,,-,1,1
087 Schenna,0,,10,16,26
087 Schenna,1,,17,12,29
087 Schenna,2,,13,17,30
087 Schenna,3,,10,20,30
087 Schenna,4,,11,15,26
087 Schenna,5,,14,18,32
087 Schenna,6,,15,14,29
087 Schenna,7,,20,25,45
087 Schenna,8,,11,8,19
087 Schenna,9,,16,17,33
087 Schenna,10,,13,16,29
087 Schenna,11,,17,19,36
087 Schenna,12,,16,14,30
087 Schenna,13,,19,21,40
087 Schenna,14,,25,18,43
087 Schenna,15,,18,10,28
087 Schenna,16,,12,18,30
087 Schenna,17,,17,18,35
087 Schenna,18,,22,18,40
087 Schenna,19,,21,15,36
087 Schenna,20,,12,6,18
087 Schenna,21,,16,16,32
087 Schenna,22,,11,16,27
087 Schenna,23,,16,16,32
087 Schenna,24,,22,14,36
087 Schenna,25,,19,20,39
087 Schenna,26,,22,12,34
087 Schenna,27,,15,13,28
087 Schenna,28,,14,17,31
087 Schenna,29,,14,19,33
087 Schenna,30,,15,15,30
087 Schenna,31,,13,16,29
087 Schenna,32,,20,16,36
087 Schenna,33,,21,26,47
087 Schenna,34,,29,19,48
087 Schenna,35,,15,19,34
087 Schenna,36,,17,25,42
087 Schenna,37,,22,13,35
087 Schenna,38,,16,33,49
087 Schenna,39,,25,19,44
087 Schenna,40,,27,20,47
087 Schenna,41,,27,15,42
087 Schenna,42,,27,25,52
087 Schenna,43,,20,22,42
087 Schenna,44,,25,22,47
087 Schenna,45,,25,20,45
087 Schenna,46,,29,19,48
087 Schenna,47,,18,17,35
087 Schenna,48,,31,29,60
087 Schenna,49,,19,25,44
087 Schenna,50,,24,19,43
087 Schenna,51,,21,11,32
087 Schenna,52,,31,24,55
087 Schenna,53,,31,26,57
087 Schenna,54,,16,12,28
087 Schenna,55,,22,20,42
087 Schenna,56,,15,18,33
087 Schenna,57,,19,18,37
087 Schenna,58,,10,17,27
087 Schenna,59,,15,18,33
087 Schenna,60,,13,15,28
087 Schenna,61,,9,16,25
087 Schenna,62,,14,12,26
087 Schenna,63,,18,14,32
087 Schenna,64,,17,21,38
087 Schenna,65,,15,16,31
087 Schenna,66,,18,18,36
087 Schenna,67,,16,19,35
087 Schenna,68,,12,14,26
087 Schenna,69,,15,9,24
087 Schenna,70,,20,14,34
087 Schenna,71,,8,17,25
087 Schenna,72,,12,12,24
087 Schenna,73,,9,10,19
087 Schenna,74,,9,11,20
087 Schenna,75,,15,17,32
087 Schenna,76,,6,11,17
087 Schenna,77,,7,13,20
087 Schenna,78,,10,8,18
087 Schenna,79,,12,11,23
087 Schenna,80,,6,8,14
087 Schenna,81,,5,9,14
087 Schenna,82,,8,8,16
087 Schenna,83,,9,6,15
087 Schenna,84,,2,10,12
087 Schenna,85,,6,7,13
087 Schenna,86,,2,9,11
087 Schenna,87,,4,6,10
087 Schenna,88,,-,8,8
087 Schenna,89,,6,4,10
087 Schenna,90,,2,2,4
087 Schenna,91,,2,3,5
087 Schenna,92,,3,4,7
087 Schenna,93,,-,1,1
087 Schenna,94,,-,2,2
087 Schenna,97,,-,1,1
087 Schenna,100,,-,2,2
088 Mühlwald,0,,11,11,22
088 Mühlwald,1,,9,5,14
088 Mühlwald,2,,5,9,14
088 Mühlwald,3,,5,9,14
088 Mühlwald,4,,5,6,11
088 Mühlwald,5,,9,8,17
088 Mühlwald,6,,7,8,15
088 Mühlwald,7,,5,13,18
088 Mühlwald,8,,8,5,13
088 Mühlwald,9,,10,9,19
088 Mühlwald,10,,15,9,24
088 Mühlwald,11,,10,12,22
088 Mühlwald,12,,10,13,23
088 Mühlwald,13,,8,10,18
088 Mühlwald,14,,15,11,26
088 Mühlwald,15,,13,14,27
088 Mühlwald,16,,12,8,20
088 Mühlwald,17,,15,13,28
088 Mühlwald,18,,12,4,16
088 Mühlwald,19,,7,6,13
088 Mühlwald,20,,15,13,28
088 Mühlwald,21,,5,4,9
088 Mühlwald,22,,11,8,19
088 Mühlwald,23,,10,5,15
088 Mühlwald,24,,16,8,24
088 Mühlwald,25,,7,5,12
088 Mühlwald,26,,9,13,22
088 Mühlwald,27,,6,5,11
088 Mühlwald,28,,8,14,22
088 Mühlwald,29,,8,13,21
088 Mühlwald,30,,10,7,17
088 Mühlwald,31,,3,9,12
088 Mühlwald,32,,11,10,21
088 Mühlwald,33,,18,4,22
088 Mühlwald,34,,7,12,19
088 Mühlwald,35,,13,6,19
088 Mühlwald,36,,7,6,13
088 Mühlwald,37,,13,10,23
088 Mühlwald,38,,11,6,17
088 Mühlwald,39,,8,5,13
088 Mühlwald,40,,13,12,25
088 Mühlwald,41,,7,9,16
088 Mühlwald,42,,19,15,34
088 Mühlwald,43,,7,9,16
088 Mühlwald,44,,14,15,29
088 Mühlwald,45,,14,9,23
088 Mühlwald,46,,17,14,31
088 Mühlwald,47,,11,7,18
088 Mühlwald,48,,17,12,29
088 Mühlwald,49,,18,10,28
088 Mühlwald,50,,9,11,20
088 Mühlwald,51,,8,11,19
088 Mühlwald,52,,6,11,17
088 Mühlwald,53,,14,9,23
088 Mühlwald,54,,13,5,18
088 Mühlwald,55,,9,5,14
088 Mühlwald,56,,13,12,25
088 Mühlwald,57,,8,8,16
088 Mühlwald,58,,7,7,14
088 Mühlwald,59,,9,4,13
088 Mühlwald,60,,9,9,18
088 Mühlwald,61,,9,7,16
088 Mühlwald,62,,10,4,14
088 Mühlwald,63,,4,9,13
088 Mühlwald,64,,9,2,11
088 Mühlwald,65,,12,4,16
088 Mühlwald,66,,9,7,16
088 Mühlwald,67,,5,3,8
088 Mühlwald,68,,4,4,8
088 Mühlwald,69,,7,4,11
088 Mühlwald,70,,8,2,10
088 Mühlwald,71,,6,7,13
088 Mühlwald,72,,4,7,11
088 Mühlwald,73,,4,9,13
088 Mühlwald,74,,5,11,16
088 Mühlwald,75,,8,4,12
088 Mühlwald,76,,7,2,9
088 Mühlwald,77,,4,3,7
088 Mühlwald,78,,3,3,6
088 Mühlwald,79,,4,5,9
088 Mühlwald,80,,2,9,11
088 Mühlwald,81,,1,2,3
088 Mühlwald,82,,3,4,7
088 Mühlwald,83,,3,3,6
088 Mühlwald,84,,4,4,8
088 Mühlwald,85,,2,3,5
088 Mühlwald,86,,3,1,4
088 Mühlwald,87,,1,3,4
088 Mühlwald,88,,1,1,2
088 Mühlwald,89,,1,1,2
088 Mühlwald,90,,-,3,3
088 Mühlwald,91,,-,2,2
088 Mühlwald,92,,-,3,3
088 Mühlwald,96,,1,-,1
089 Wolkenstein in Gröden,0,,18,9,27
089 Wolkenstein in Gröden,1,,9,8,17
089 Wolkenstein in Gröden,2,,13,17,30
089 Wolkenstein in Gröden,3,,18,11,29
089 Wolkenstein in Gröden,4,,11,9,20
089 Wolkenstein in Gröden,5,,17,13,30
089 Wolkenstein in Gröden,6,,17,13,30
089 Wolkenstein in Gröden,7,,12,15,27
089 Wolkenstein in Gröden,8,,16,19,35
089 Wolkenstein in Gröden,9,,12,8,20
089 Wolkenstein in Gröden,10,,18,19,37
089 Wolkenstein in Gröden,11,,23,19,42
089 Wolkenstein in Gröden,12,,20,18,38
089 Wolkenstein in Gröden,13,,18,23,41
089 Wolkenstein in Gröden,14,,13,18,31
089 Wolkenstein in Gröden,15,,16,23,39
089 Wolkenstein in Gröden,16,,21,29,50
089 Wolkenstein in Gröden,17,,15,12,27
089 Wolkenstein in Gröden,18,,16,12,28
089 Wolkenstein in Gröden,19,,14,17,31
089 Wolkenstein in Gröden,20,,14,16,30
089 Wolkenstein in Gröden,21,,23,14,37
089 Wolkenstein in Gröden,22,,18,18,36
089 Wolkenstein in Gröden,23,,14,9,23
089 Wolkenstein in Gröden,24,,15,14,29
089 Wolkenstein in Gröden,25,,16,17,33
089 Wolkenstein in Gröden,26,,13,21,34
089 Wolkenstein in Gröden,27,,14,13,27
089 Wolkenstein in Gröden,28,,15,14,29
089 Wolkenstein in Gröden,29,,14,9,23
089 Wolkenstein in Gröden,30,,14,7,21
089 Wolkenstein in Gröden,31,,11,17,28
089 Wolkenstein in Gröden,32,,15,10,25
089 Wolkenstein in Gröden,33,,19,19,38
089 Wolkenstein in Gröden,34,,10,18,28
089 Wolkenstein in Gröden,35,,11,10,21
089 Wolkenstein in Gröden,36,,13,13,26
089 Wolkenstein in Gröden,37,,16,9,25
089 Wolkenstein in Gröden,38,,19,25,44
089 Wolkenstein in Gröden,39,,12,17,29
089 Wolkenstein in Gröden,40,,26,23,49
089 Wolkenstein in Gröden,41,,17,23,40
089 Wolkenstein in Gröden,42,,23,23,46
089 Wolkenstein in Gröden,43,,24,22,46
089 Wolkenstein in Gröden,44,,26,23,49
089 Wolkenstein in Gröden,45,,24,25,49
089 Wolkenstein in Gröden,46,,30,27,57
089 Wolkenstein in Gröden,47,,27,24,51
089 Wolkenstein in Gröden,48,,20,33,53
089 Wolkenstein in Gröden,49,,28,22,50
089 Wolkenstein in Gröden,50,,22,21,43
089 Wolkenstein in Gröden,51,,22,19,41
089 Wolkenstein in Gröden,52,,25,21,46
089 Wolkenstein in Gröden,53,,26,22,48
089 Wolkenstein in Gröden,54,,14,15,29
089 Wolkenstein in Gröden,55,,17,15,32
089 Wolkenstein in Gröden,56,,20,16,36
089 Wolkenstein in Gröden,57,,10,14,24
089 Wolkenstein in Gröden,58,,11,10,21
089 Wolkenstein in Gröden,59,,14,10,24
089 Wolkenstein in Gröden,60,,8,14,22
089 Wolkenstein in Gröden,61,,12,6,18
089 Wolkenstein in Gröden,62,,12,12,24
089 Wolkenstein in Gröden,63,,6,17,23
089 Wolkenstein in Gröden,64,,15,11,26
089 Wolkenstein in Gröden,65,,12,13,25
089 Wolkenstein in Gröden,66,,9,14,23
089 Wolkenstein in Gröden,67,,18,19,37
089 Wolkenstein in Gröden,68,,5,14,19
089 Wolkenstein in Gröden,69,,9,8,17
089 Wolkenstein in Gröden,70,,18,13,31
089 Wolkenstein in Gröden,71,,10,12,22
089 Wolkenstein in Gröden,72,,13,11,24
089 Wolkenstein in Gröden,73,,14,16,30
089 Wolkenstein in Gröden,74,,17,12,29
089 Wolkenstein in Gröden,75,,15,8,23
089 Wolkenstein in Gröden,76,,9,17,26
089 Wolkenstein in Gröden,77,,9,12,21
089 Wolkenstein in Gröden,78,,14,6,20
089 Wolkenstein in Gröden,79,,10,10,20
089 Wolkenstein in Gröden,80,,4,9,13
089 Wolkenstein in Gröden,81,,4,9,13
089 Wolkenstein in Gröden,82,,7,8,15
089 Wolkenstein in Gröden,83,,6,9,15
089 Wolkenstein in Gröden,84,,3,5,8
089 Wolkenstein in Gröden,85,,3,8,11
089 Wolkenstein in Gröden,86,,7,4,11
089 Wolkenstein in Gröden,87,,6,4,10
089 Wolkenstein in Gröden,88,,2,6,8
089 Wolkenstein in Gröden,89,,1,5,6
089 Wolkenstein in Gröden,90,,2,4,6
089 Wolkenstein in Gröden,91,,2,5,7
089 Wolkenstein in Gröden,92,,1,2,3
089 Wolkenstein in Gröden,93,,3,2,5
089 Wolkenstein in Gröden,94,,-,1,1
089 Wolkenstein in Gröden,96,,1,-,1
091 Schnals,0,,8,3,11
091 Schnals,1,,7,4,11
091 Schnals,2,,5,4,9
091 Schnals,3,,2,6,8
091 Schnals,4,,9,9,18
091 Schnals,5,,10,5,15
091 Schnals,6,,4,5,9
091 Schnals,7,,4,4,8
091 Schnals,8,,3,5,8
091 Schnals,9,,7,5,12
091 Schnals,10,,2,8,10
091 Schnals,11,,12,2,14
091 Schnals,12,,3,4,7
091 Schnals,13,,5,5,10
091 Schnals,14,,5,9,14
091 Schnals,15,,7,15,22
091 Schnals,16,,12,10,22
091 Schnals,17,,6,10,16
091 Schnals,18,,5,8,13
091 Schnals,19,,4,7,11
091 Schnals,20,,10,6,16
091 Schnals,21,,11,10,21
091 Schnals,22,,12,8,20
091 Schnals,23,,4,7,11
091 Schnals,24,,20,7,27
091 Schnals,25,,9,4,13
091 Schnals,26,,9,8,17
091 Schnals,27,,5,8,13
091 Schnals,28,,5,6,11
091 Schnals,29,,14,12,26
091 Schnals,30,,6,6,12
091 Schnals,31,,8,6,14
091 Schnals,32,,15,9,24
091 Schnals,33,,10,9,19
091 Schnals,34,,5,9,14
091 Schnals,35,,10,9,19
091 Schnals,36,,6,10,16
091 Schnals,37,,8,1,9
091 Schnals,38,,7,7,14
091 Schnals,39,,14,7,21
091 Schnals,40,,8,9,17
091 Schnals,41,,8,8,16
091 Schnals,42,,10,6,16
091 Schnals,43,,10,7,17
091 Schnals,44,,12,7,19
091 Schnals,45,,11,9,20
091 Schnals,46,,15,10,25
091 Schnals,47,,14,13,27
091 Schnals,48,,15,8,23
091 Schnals,49,,6,10,16
091 Schnals,50,,10,15,25
091 Schnals,51,,12,10,22
091 Schnals,52,,9,13,22
091 Schnals,53,,12,8,20
091 Schnals,54,,15,12,27
091 Schnals,55,,11,11,22
091 Schnals,56,,11,5,16
091 Schnals,57,,12,4,16
091 Schnals,58,,9,6,15
091 Schnals,59,,9,10,19
091 Schnals,60,,12,8,20
091 Schnals,61,,13,7,20
091 Schnals,62,,12,8,20
091 Schnals,63,,8,7,15
091 Schnals,64,,10,9,19
091 Schnals,65,,3,2,5
091 Schnals,66,,8,7,15
091 Schnals,67,,6,5,11
091 Schnals,68,,6,4,10
091 Schnals,69,,3,7,10
091 Schnals,70,,6,8,14
091 Schnals,71,,4,4,8
091 Schnals,72,,3,4,7
091 Schnals,73,,7,7,14
091 Schnals,74,,5,7,12
091 Schnals,75,,1,11,12
091 Schnals,76,,6,4,10
091 Schnals,77,,4,3,7
091 Schnals,78,,2,4,6
091 Schnals,79,,2,3,5
091 Schnals,80,,3,3,6
091 Schnals,81,,2,7,9
091 Schnals,82,,2,4,6
091 Schnals,83,,-,3,3
091 Schnals,84,,3,6,9
091 Schnals,85,,1,4,5
091 Schnals,86,,1,3,4
091 Schnals,87,,6,2,8
091 Schnals,88,,2,5,7
091 Schnals,89,,-,2,2
091 Schnals,90,,-,1,1
091 Schnals,91,,1,2,3
091 Schnals,92,,-,2,2
091 Schnals,95,,2,1,3
091 Schnals,98,,-,1,1
092 Sexten,0,,10,7,17
092 Sexten,1,,10,7,17
092 Sexten,2,,11,3,14
092 Sexten,3,,8,6,14
092 Sexten,4,,12,6,18
092 Sexten,5,,6,8,14
092 Sexten,6,,9,18,27
092 Sexten,7,,4,6,10
092 Sexten,8,,11,9,20
092 Sexten,9,,13,8,21
092 Sexten,10,,10,10,20
092 Sexten,11,,15,17,32
092 Sexten,12,,16,11,27
092 Sexten,13,,7,17,24
092 Sexten,14,,8,14,22
092 Sexten,15,,14,6,20
092 Sexten,16,,12,10,22
092 Sexten,17,,14,12,26
092 Sexten,18,,15,14,29
092 Sexten,19,,15,9,24
092 Sexten,20,,9,5,14
092 Sexten,21,,14,10,24
092 Sexten,22,,9,13,22
092 Sexten,23,,10,17,27
092 Sexten,24,,10,12,22
092 Sexten,25,,8,5,13
092 Sexten,26,,11,9,20
092 Sexten,27,,6,11,17
092 Sexten,28,,11,11,22
092 Sexten,29,,7,8,15
092 Sexten,30,,12,9,21
092 Sexten,31,,9,9,18
092 Sexten,32,,16,11,27
092 Sexten,33,,13,8,21
092 Sexten,34,,14,19,33
092 Sexten,35,,13,11,24
092 Sexten,36,,8,4,12
092 Sexten,37,,17,15,32
092 Sexten,38,,7,11,18
092 Sexten,39,,11,8,19
092 Sexten,40,,7,9,16
092 Sexten,41,,11,18,29
092 Sexten,42,,17,14,31
092 Sexten,43,,12,18,30
092 Sexten,44,,21,16,37
092 Sexten,45,,15,16,31
092 Sexten,46,,23,19,42
092 Sexten,47,,14,16,30
092 Sexten,48,,18,17,35
092 Sexten,49,,18,15,33
092 Sexten,50,,27,19,46
092 Sexten,51,,13,16,29
092 Sexten,52,,18,12,30
092 Sexten,53,,20,8,28
092 Sexten,54,,15,14,29
092 Sexten,55,,22,14,36
092 Sexten,56,,18,12,30
092 Sexten,57,,13,14,27
092 Sexten,58,,10,11,21
092 Sexten,59,,11,12,23
092 Sexten,60,,4,10,14
092 Sexten,61,,6,12,18
092 Sexten,62,,7,9,16
092 Sexten,63,,10,7,17
092 Sexten,64,,6,4,10
092 Sexten,65,,10,7,17
092 Sexten,66,,10,4,14
092 Sexten,67,,5,8,13
092 Sexten,68,,6,4,10
092 Sexten,69,,5,12,17
092 Sexten,70,,9,5,14
092 Sexten,71,,5,5,10
092 Sexten,72,,6,17,23
092 Sexten,73,,7,12,19
092 Sexten,74,,5,10,15
092 Sexten,75,,12,10,22
092 Sexten,76,,9,6,15
092 Sexten,77,,6,9,15
092 Sexten,78,,7,14,21
092 Sexten,79,,8,7,15
092 Sexten,80,,2,10,12
092 Sexten,81,,3,7,10
092 Sexten,82,,6,11,17
092 Sexten,83,,4,11,15
092 Sexten,84,,4,10,14
092 Sexten,85,,5,10,15
092 Sexten,86,,4,13,17
092 Sexten,87,,3,3,6
092 Sexten,88,,1,6,7
092 Sexten,89,,4,5,9
092 Sexten,90,,1,5,6
092 Sexten,91,,2,5,7
092 Sexten,92,,1,3,4
092 Sexten,93,,-,2,2
092 Sexten,94,,-,3,3
092 Sexten,96,,-,1,1
093 Schlanders,0,,32,25,57
093 Schlanders,1,,35,38,73
093 Schlanders,2,,24,23,47
093 Schlanders,3,,27,28,55
093 Schlanders,4,,25,36,61
093 Schlanders,5,,32,25,57
093 Schlanders,6,,30,32,62
093 Schlanders,7,,27,25,52
093 Schlanders,8,,30,34,64
093 Schlanders,9,,27,36,63
093 Schlanders,10,,27,23,50
093 Schlanders,11,,25,34,59
093 Schlanders,12,,32,34,66
093 Schlanders,13,,38,38,76
093 Schlanders,14,,27,40,67
093 Schlanders,15,,42,38,80
093 Schlanders,16,,56,48,104
093 Schlanders,17,,43,34,77
093 Schlanders,18,,37,28,65
093 Schlanders,19,,40,40,80
093 Schlanders,20,,49,43,92
093 Schlanders,21,,34,44,78
093 Schlanders,22,,38,32,70
093 Schlanders,23,,53,39,92
093 Schlanders,24,,37,38,75
093 Schlanders,25,,33,40,73
093 Schlanders,26,,38,37,75
093 Schlanders,27,,37,34,71
093 Schlanders,28,,37,35,72
093 Schlanders,29,,39,42,81
093 Schlanders,30,,34,37,71
093 Schlanders,31,,45,44,89
093 Schlanders,32,,50,40,90
093 Schlanders,33,,38,38,76
093 Schlanders,34,,29,34,63
093 Schlanders,35,,44,32,76
093 Schlanders,36,,33,46,79
093 Schlanders,37,,31,28,59
093 Schlanders,38,,49,38,87
093 Schlanders,39,,50,38,88
093 Schlanders,40,,36,52,88
093 Schlanders,41,,51,35,86
093 Schlanders,42,,45,49,94
093 Schlanders,43,,45,49,94
093 Schlanders,44,,62,45,107
093 Schlanders,45,,52,36,88
093 Schlanders,46,,44,55,99
093 Schlanders,47,,44,57,101
093 Schlanders,48,,53,50,103
093 Schlanders,49,,39,43,82
093 Schlanders,50,,52,57,109
093 Schlanders,51,,48,45,93
093 Schlanders,52,,37,55,92
093 Schlanders,53,,41,44,85
093 Schlanders,54,,35,41,76
093 Schlanders,55,,48,53,101
093 Schlanders,56,,43,38,81
093 Schlanders,57,,27,33,60
093 Schlanders,58,,26,36,62
093 Schlanders,59,,30,33,63
093 Schlanders,60,,33,37,70
093 Schlanders,61,,31,21,52
093 Schlanders,62,,28,30,58
093 Schlanders,63,,22,33,55
093 Schlanders,64,,26,37,63
093 Schlanders,65,,38,25,63
093 Schlanders,66,,23,23,46
093 Schlanders,67,,24,21,45
093 Schlanders,68,,30,16,46
093 Schlanders,69,,25,32,57
093 Schlanders,70,,27,36,63
093 Schlanders,71,,33,35,68
093 Schlanders,72,,32,35,67
093 Schlanders,73,,23,24,47
093 Schlanders,74,,28,32,60
093 Schlanders,75,,12,17,29
093 Schlanders,76,,24,23,47
093 Schlanders,77,,13,24,37
093 Schlanders,78,,14,23,37
093 Schlanders,79,,14,20,34
093 Schlanders,80,,16,29,45
093 Schlanders,81,,14,13,27
093 Schlanders,82,,18,14,32
093 Schlanders,83,,12,18,30
093 Schlanders,84,,8,13,21
093 Schlanders,85,,9,15,24
093 Schlanders,86,,6,16,22
093 Schlanders,87,,3,15,18
093 Schlanders,88,,6,11,17
093 Schlanders,89,,3,8,11
093 Schlanders,90,,5,5,10
093 Schlanders,91,,2,5,7
093 Schlanders,92,,-,6,6
093 Schlanders,93,,-,7,7
093 Schlanders,94,,1,3,4
093 Schlanders,95,,2,2,4
093 Schlanders,97,,-,1,1
093 Schlanders,101,,-,1,1
093 Schlanders,103,,-,1,1
093 Schlanders,104,,-,1,1
094 Schluderns,0,,13,5,18
094 Schluderns,1,,7,11,18
094 Schluderns,2,,12,9,21
094 Schluderns,3,,7,4,11
094 Schluderns,4,,11,7,18
094 Schluderns,5,,7,1,8
094 Schluderns,6,,9,14,23
094 Schluderns,7,,9,8,17
094 Schluderns,8,,6,6,12
094 Schluderns,9,,6,10,16
094 Schluderns,10,,15,9,24
094 Schluderns,11,,14,8,22
094 Schluderns,12,,11,7,18
094 Schluderns,13,,17,8,25
094 Schluderns,14,,7,14,21
094 Schluderns,15,,6,11,17
094 Schluderns,16,,11,12,23
094 Schluderns,17,,10,14,24
094 Schluderns,18,,9,12,21
094 Schluderns,19,,13,18,31
094 Schluderns,20,,16,6,22
094 Schluderns,21,,9,8,17
094 Schluderns,22,,8,9,17
094 Schluderns,23,,22,7,29
094 Schluderns,24,,15,11,26
094 Schluderns,25,,9,11,20
094 Schluderns,26,,5,9,14
094 Schluderns,27,,9,17,26
094 Schluderns,28,,15,12,27
094 Schluderns,29,,9,11,20
094 Schluderns,30,,10,9,19
094 Schluderns,31,,12,14,26
094 Schluderns,32,,19,14,33
094 Schluderns,33,,11,12,23
094 Schluderns,34,,2,15,17
094 Schluderns,35,,12,12,24
094 Schluderns,36,,7,10,17
094 Schluderns,37,,11,14,25
094 Schluderns,38,,17,8,25
094 Schluderns,39,,19,13,32
094 Schluderns,40,,17,12,29
094 Schluderns,41,,15,11,26
094 Schluderns,42,,11,12,23
094 Schluderns,43,,9,10,19
094 Schluderns,44,,16,10,26
094 Schluderns,45,,17,17,34
094 Schluderns,46,,12,15,27
094 Schluderns,47,,16,16,32
094 Schluderns,48,,25,9,34
094 Schluderns,49,,24,13,37
094 Schluderns,50,,13,18,31
094 Schluderns,51,,11,19,30
094 Schluderns,52,,13,18,31
094 Schluderns,53,,9,6,15
094 Schluderns,54,,12,17,29
094 Schluderns,55,,10,15,25
094 Schluderns,56,,17,6,23
094 Schluderns,57,,10,16,26
094 Schluderns,58,,15,11,26
094 Schluderns,59,,13,7,20
094 Schluderns,60,,14,7,21
094 Schluderns,61,,6,5,11
094 Schluderns,62,,11,3,14
094 Schluderns,63,,8,13,21
094 Schluderns,64,,11,10,21
094 Schluderns,65,,8,8,16
094 Schluderns,66,,7,7,14
094 Schluderns,67,,6,9,15
094 Schluderns,68,,5,4,9
094 Schluderns,69,,5,12,17
094 Schluderns,70,,3,7,10
094 Schluderns,71,,8,7,15
094 Schluderns,72,,11,14,25
094 Schluderns,73,,6,5,11
094 Schluderns,74,,11,8,19
094 Schluderns,75,,7,7,14
094 Schluderns,76,,5,10,15
094 Schluderns,77,,2,6,8
094 Schluderns,78,,5,10,15
094 Schluderns,79,,7,10,17
094 Schluderns,80,,6,8,14
094 Schluderns,81,,7,9,16
094 Schluderns,82,,3,5,8
094 Schluderns,83,,4,8,12
094 Schluderns,84,,3,5,8
094 Schluderns,85,,3,5,8
094 Schluderns,86,,3,2,5
094 Schluderns,87,,2,9,11
094 Schluderns,88,,1,3,4
094 Schluderns,90,,1,2,3
094 Schluderns,91,,2,1,3
094 Schluderns,92,,-,3,3
094 Schluderns,93,,-,1,1
094 Schluderns,94,,-,1,1
094 Schluderns,96,,-,1,1
094 Schluderns,98,,-,1,1
095 Stilfs,0,,5,1,6
095 Stilfs,1,,9,4,13
095 Stilfs,2,,4,4,8
095 Stilfs,3,,2,4,6
095 Stilfs,4,,4,2,6
095 Stilfs,5,,5,6,11
095 Stilfs,6,,4,6,10
095 Stilfs,7,,5,1,6
095 Stilfs,8,,6,5,11
095 Stilfs,9,,5,4,9
095 Stilfs,10,,5,6,11
095 Stilfs,11,,5,3,8
095 Stilfs,12,,5,11,16
095 Stilfs,13,,9,4,13
095 Stilfs,14,,2,6,8
095 Stilfs,15,,8,3,11
095 Stilfs,16,,10,9,19
095 Stilfs,17,,11,1,12
095 Stilfs,18,,5,6,11
095 Stilfs,19,,8,7,15
095 Stilfs,20,,5,14,19
095 Stilfs,21,,4,8,12
095 Stilfs,22,,12,5,17
095 Stilfs,23,,17,8,25
095 Stilfs,24,,7,9,16
095 Stilfs,25,,7,2,9
095 Stilfs,26,,6,7,13
095 Stilfs,27,,11,7,18
095 Stilfs,28,,12,4,16
095 Stilfs,29,,10,8,18
095 Stilfs,30,,9,2,11
095 Stilfs,31,,13,5,18
095 Stilfs,32,,10,7,17
095 Stilfs,33,,4,5,9
095 Stilfs,34,,5,5,10
095 Stilfs,35,,8,10,18
095 Stilfs,36,,6,4,10
095 Stilfs,37,,9,4,13
095 Stilfs,38,,7,8,15
095 Stilfs,39,,6,4,10
095 Stilfs,40,,9,13,22
095 Stilfs,41,,9,9,18
095 Stilfs,42,,11,10,21
095 Stilfs,43,,10,12,22
095 Stilfs,44,,9,12,21
095 Stilfs,45,,8,8,16
095 Stilfs,46,,6,8,14
095 Stilfs,47,,19,8,27
095 Stilfs,48,,12,10,22
095 Stilfs,49,,12,5,17
095 Stilfs,50,,9,6,15
095 Stilfs,51,,6,12,18
095 Stilfs,52,,8,3,11
095 Stilfs,53,,9,7,16
095 Stilfs,54,,9,10,19
095 Stilfs,55,,7,13,20
095 Stilfs,56,,10,6,16
095 Stilfs,57,,5,8,13
095 Stilfs,58,,4,5,9
095 Stilfs,59,,16,9,25
095 Stilfs,60,,8,4,12
095 Stilfs,61,,9,5,14
095 Stilfs,62,,14,10,24
095 Stilfs,63,,1,6,7
095 Stilfs,64,,5,3,8
095 Stilfs,65,,7,9,16
095 Stilfs,66,,6,5,11
095 Stilfs,67,,9,9,18
095 Stilfs,68,,2,4,6
095 Stilfs,69,,12,8,20
095 Stilfs,70,,8,7,15
095 Stilfs,71,,4,12,16
095 Stilfs,72,,6,4,10
095 Stilfs,73,,5,8,13
095 Stilfs,74,,3,6,9
095 Stilfs,75,,2,4,6
095 Stilfs,76,,6,5,11
095 Stilfs,77,,2,9,11
095 Stilfs,78,,1,5,6
095 Stilfs,79,,2,4,6
095 Stilfs,80,,3,5,8
095 Stilfs,81,,3,4,7
095 Stilfs,82,,2,3,5
095 Stilfs,83,,4,3,7
095 Stilfs,84,,2,-,2
095 Stilfs,85,,2,6,8
095 Stilfs,86,,2,2,4
095 Stilfs,87,,1,4,5
095 Stilfs,88,,2,1,3
095 Stilfs,89,,-,5,5
095 Stilfs,91,,1,4,5
095 Stilfs,92,,1,3,4
095 Stilfs,93,,-,2,2
095 Stilfs,96,,-,1,1
095 Stilfs,99,,1,-,1
096 Terenten,0,,11,12,23
096 Terenten,1,,6,9,15
096 Terenten,2,,8,7,15
096 Terenten,3,,3,9,12
096 Terenten,4,,12,7,19
096 Terenten,5,,11,4,15
096 Terenten,6,,9,11,20
096 Terenten,7,,15,9,24
096 Terenten,8,,16,10,26
096 Terenten,9,,11,19,30
096 Terenten,10,,9,12,21
096 Terenten,11,,8,7,15
096 Terenten,12,,14,15,29
096 Terenten,13,,10,8,18
096 Terenten,14,,10,19,29
096 Terenten,15,,21,19,40
096 Terenten,16,,9,8,17
096 Terenten,17,,13,11,24
096 Terenten,18,,12,8,20
096 Terenten,19,,12,13,25
096 Terenten,20,,6,14,20
096 Terenten,21,,9,8,17
096 Terenten,22,,6,16,22
096 Terenten,23,,12,15,27
096 Terenten,24,,14,8,22
096 Terenten,25,,10,8,18
096 Terenten,26,,14,8,22
096 Terenten,27,,10,9,19
096 Terenten,28,,9,14,23
096 Terenten,29,,13,9,22
096 Terenten,30,,14,15,29
096 Terenten,31,,11,12,23
096 Terenten,32,,13,15,28
096 Terenten,33,,7,12,19
096 Terenten,34,,8,10,18
096 Terenten,35,,18,19,37
096 Terenten,36,,10,4,14
096 Terenten,37,,14,10,24
096 Terenten,38,,16,10,26
096 Terenten,39,,15,15,30
096 Terenten,40,,8,16,24
096 Terenten,41,,17,9,26
096 Terenten,42,,17,16,33
096 Terenten,43,,20,12,32
096 Terenten,44,,17,14,31
096 Terenten,45,,14,14,28
096 Terenten,46,,17,19,36
096 Terenten,47,,15,18,33
096 Terenten,48,,15,10,25
096 Terenten,49,,17,14,31
096 Terenten,50,,22,12,34
096 Terenten,51,,20,12,32
096 Terenten,52,,11,16,27
096 Terenten,53,,12,9,21
096 Terenten,54,,13,10,23
096 Terenten,55,,13,9,22
096 Terenten,56,,12,8,20
096 Terenten,57,,10,12,22
096 Terenten,58,,12,10,22
096 Terenten,59,,13,10,23
096 Terenten,60,,9,8,17
096 Terenten,61,,7,7,14
096 Terenten,62,,7,6,13
096 Terenten,63,,7,6,13
096 Terenten,64,,8,6,14
096 Terenten,65,,10,8,18
096 Terenten,66,,7,3,10
096 Terenten,67,,9,3,12
096 Terenten,68,,6,4,10
096 Terenten,69,,3,6,9
096 Terenten,70,,7,5,12
096 Terenten,71,,5,5,10
096 Terenten,72,,5,4,9
096 Terenten,73,,8,5,13
096 Terenten,74,,2,6,8
096 Terenten,75,,4,9,13
096 Terenten,76,,4,5,9
096 Terenten,77,,2,8,10
096 Terenten,78,,4,4,8
096 Terenten,79,,1,3,4
096 Terenten,80,,4,3,7
096 Terenten,81,,2,3,5
096 Terenten,82,,4,9,13
096 Terenten,83,,3,4,7
096 Terenten,84,,4,2,6
096 Terenten,85,,3,4,7
096 Terenten,86,,1,2,3
096 Terenten,87,,1,3,4
096 Terenten,88,,2,1,3
096 Terenten,89,,1,2,3
096 Terenten,90,,1,2,3
096 Terenten,92,,-,2,2
096 Terenten,93,,1,2,3
096 Terenten,94,,1,-,1
097 Terlan,0,,21,29,50
097 Terlan,1,,37,16,53
097 Terlan,2,,33,25,58
097 Terlan,3,,15,15,30
097 Terlan,4,,34,28,62
097 Terlan,5,,31,21,52
097 Terlan,6,,21,19,40
097 Terlan,7,,21,32,53
097 Terlan,8,,18,27,45
097 Terlan,9,,28,21,49
097 Terlan,10,,23,24,47
097 Terlan,11,,22,16,38
097 Terlan,12,,21,29,50
097 Terlan,13,,36,24,60
097 Terlan,14,,32,19,51
097 Terlan,15,,21,20,41
097 Terlan,16,,37,29,66
097 Terlan,17,,15,27,42
097 Terlan,18,,25,27,52
097 Terlan,19,,23,19,42
097 Terlan,20,,28,23,51
097 Terlan,21,,25,30,55
097 Terlan,22,,26,18,44
097 Terlan,23,,17,25,42
097 Terlan,24,,24,25,49
097 Terlan,25,,29,18,47
097 Terlan,26,,26,18,44
097 Terlan,27,,20,26,46
097 Terlan,28,,26,23,49
097 Terlan,29,,16,19,35
097 Terlan,30,,21,17,38
097 Terlan,31,,22,24,46
097 Terlan,32,,19,24,43
097 Terlan,33,,33,33,66
097 Terlan,34,,22,25,47
097 Terlan,35,,21,34,55
097 Terlan,36,,46,27,73
097 Terlan,37,,37,37,74
097 Terlan,38,,35,39,74
097 Terlan,39,,30,46,76
097 Terlan,40,,32,38,70
097 Terlan,41,,43,30,73
097 Terlan,42,,31,28,59
097 Terlan,43,,45,47,92
097 Terlan,44,,36,37,73
097 Terlan,45,,38,33,71
097 Terlan,46,,33,38,71
097 Terlan,47,,45,33,78
097 Terlan,48,,33,29,62
097 Terlan,49,,38,29,67
097 Terlan,50,,33,31,64
097 Terlan,51,,27,35,62
097 Terlan,52,,42,27,69
097 Terlan,53,,27,33,60
097 Terlan,54,,19,25,44
097 Terlan,55,,33,22,55
097 Terlan,56,,24,30,54
097 Terlan,57,,29,32,61
097 Terlan,58,,23,22,45
097 Terlan,59,,27,20,47
097 Terlan,60,,12,22,34
097 Terlan,61,,15,25,40
097 Terlan,62,,22,17,39
097 Terlan,63,,22,22,44
097 Terlan,64,,17,15,32
097 Terlan,65,,17,23,40
097 Terlan,66,,15,19,34
097 Terlan,67,,12,23,35
097 Terlan,68,,21,21,42
097 Terlan,69,,24,22,46
097 Terlan,70,,14,27,41
097 Terlan,71,,30,21,51
097 Terlan,72,,21,24,45
097 Terlan,73,,17,16,33
097 Terlan,74,,15,17,32
097 Terlan,75,,18,15,33
097 Terlan,76,,11,16,27
097 Terlan,77,,5,11,16
097 Terlan,78,,14,21,35
097 Terlan,79,,9,20,29
097 Terlan,80,,10,14,24
097 Terlan,81,,12,11,23
097 Terlan,82,,16,9,25
097 Terlan,83,,9,13,22
097 Terlan,84,,8,11,19
097 Terlan,85,,8,8,16
097 Terlan,86,,5,9,14
097 Terlan,87,,3,10,13
097 Terlan,88,,5,5,10
097 Terlan,89,,1,9,10
097 Terlan,90,,3,17,20
097 Terlan,91,,2,7,9
097 Terlan,92,,2,5,7
097 Terlan,93,,-,5,5
097 Terlan,94,,-,3,3
097 Terlan,95,,-,2,2
097 Terlan,96,,-,2,2
097 Terlan,97,,-,2,2
097 Terlan,99,,-,1,1
098 Tramin a.d. Weinstr.,0,,22,13,35
098 Tramin a.d. Weinstr.,1,,18,23,41
098 Tramin a.d. Weinstr.,2,,12,10,22
098 Tramin a.d. Weinstr.,3,,20,14,34
098 Tramin a.d. Weinstr.,4,,20,13,33
098 Tramin a.d. Weinstr.,5,,17,12,29
098 Tramin a.d. Weinstr.,6,,16,14,30
098 Tramin a.d. Weinstr.,7,,14,10,24
098 Tramin a.d. Weinstr.,8,,16,12,28
098 Tramin a.d. Weinstr.,9,,12,18,30
098 Tramin a.d. Weinstr.,10,,26,14,40
098 Tramin a.d. Weinstr.,11,,14,16,30
098 Tramin a.d. Weinstr.,12,,20,17,37
098 Tramin a.d. Weinstr.,13,,23,12,35
098 Tramin a.d. Weinstr.,14,,17,17,34
098 Tramin a.d. Weinstr.,15,,15,20,35
098 Tramin a.d. Weinstr.,16,,27,14,41
098 Tramin a.d. Weinstr.,17,,21,26,47
098 Tramin a.d. Weinstr.,18,,18,20,38
098 Tramin a.d. Weinstr.,19,,20,21,41
098 Tramin a.d. Weinstr.,20,,17,19,36
098 Tramin a.d. Weinstr.,21,,20,25,45
098 Tramin a.d. Weinstr.,22,,20,7,27
098 Tramin a.d. Weinstr.,23,,24,20,44
098 Tramin a.d. Weinstr.,24,,18,32,50
098 Tramin a.d. Weinstr.,25,,11,30,41
098 Tramin a.d. Weinstr.,26,,20,26,46
098 Tramin a.d. Weinstr.,27,,13,17,30
098 Tramin a.d. Weinstr.,28,,25,22,47
098 Tramin a.d. Weinstr.,29,,20,15,35
098 Tramin a.d. Weinstr.,30,,15,21,36
098 Tramin a.d. Weinstr.,31,,23,27,50
098 Tramin a.d. Weinstr.,32,,29,11,40
098 Tramin a.d. Weinstr.,33,,23,19,42
098 Tramin a.d. Weinstr.,34,,15,13,28
098 Tramin a.d. Weinstr.,35,,12,21,33
098 Tramin a.d. Weinstr.,36,,19,16,35
098 Tramin a.d. Weinstr.,37,,28,16,44
098 Tramin a.d. Weinstr.,38,,21,18,39
098 Tramin a.d. Weinstr.,39,,25,18,43
098 Tramin a.d. Weinstr.,40,,19,13,32
098 Tramin a.d. Weinstr.,41,,17,28,45
098 Tramin a.d. Weinstr.,42,,24,36,60
098 Tramin a.d. Weinstr.,43,,27,19,46
098 Tramin a.d. Weinstr.,44,,30,32,62
098 Tramin a.d. Weinstr.,45,,26,20,46
098 Tramin a.d. Weinstr.,46,,30,30,60
098 Tramin a.d. Weinstr.,47,,28,28,56
098 Tramin a.d. Weinstr.,48,,34,29,63
098 Tramin a.d. Weinstr.,49,,26,30,56
098 Tramin a.d. Weinstr.,50,,23,21,44
098 Tramin a.d. Weinstr.,51,,24,13,37
098 Tramin a.d. Weinstr.,52,,28,23,51
098 Tramin a.d. Weinstr.,53,,27,35,62
098 Tramin a.d. Weinstr.,54,,17,33,50
098 Tramin a.d. Weinstr.,55,,24,23,47
098 Tramin a.d. Weinstr.,56,,19,23,42
098 Tramin a.d. Weinstr.,57,,24,20,44
098 Tramin a.d. Weinstr.,58,,18,19,37
098 Tramin a.d. Weinstr.,59,,20,19,39
098 Tramin a.d. Weinstr.,60,,17,12,29
098 Tramin a.d. Weinstr.,61,,19,18,37
098 Tramin a.d. Weinstr.,62,,14,14,28
098 Tramin a.d. Weinstr.,63,,15,19,34
098 Tramin a.d. Weinstr.,64,,15,17,32
098 Tramin a.d. Weinstr.,65,,17,19,36
098 Tramin a.d. Weinstr.,66,,13,21,34
098 Tramin a.d. Weinstr.,67,,18,17,35
098 Tramin a.d. Weinstr.,68,,7,9,16
098 Tramin a.d. Weinstr.,69,,22,25,47
098 Tramin a.d. Weinstr.,70,,18,20,38
098 Tramin a.d. Weinstr.,71,,19,16,35
098 Tramin a.d. Weinstr.,72,,12,23,35
098 Tramin a.d. Weinstr.,73,,19,16,35
098 Tramin a.d. Weinstr.,74,,12,11,23
098 Tramin a.d. Weinstr.,75,,6,18,24
098 Tramin a.d. Weinstr.,76,,13,12,25
098 Tramin a.d. Weinstr.,77,,13,12,25
098 Tramin a.d. Weinstr.,78,,13,12,25
098 Tramin a.d. Weinstr.,79,,8,13,21
098 Tramin a.d. Weinstr.,80,,5,11,16
098 Tramin a.d. Weinstr.,81,,9,14,23
098 Tramin a.d. Weinstr.,82,,5,15,20
098 Tramin a.d. Weinstr.,83,,11,10,21
098 Tramin a.d. Weinstr.,84,,7,13,20
098 Tramin a.d. Weinstr.,85,,9,7,16
098 Tramin a.d. Weinstr.,86,,9,9,18
098 Tramin a.d. Weinstr.,87,,5,13,18
098 Tramin a.d. Weinstr.,88,,6,12,18
098 Tramin a.d. Weinstr.,89,,4,9,13
098 Tramin a.d. Weinstr.,90,,-,7,7
098 Tramin a.d. Weinstr.,91,,-,3,3
098 Tramin a.d. Weinstr.,92,,1,5,6
098 Tramin a.d. Weinstr.,93,,1,3,4
098 Tramin a.d. Weinstr.,94,,-,3,3
099 Tisens,0,,4,10,14
099 Tisens,1,,6,11,17
099 Tisens,2,,6,8,14
099 Tisens,3,,7,8,15
099 Tisens,4,,7,2,9
099 Tisens,5,,13,8,21
099 Tisens,6,,11,9,20
099 Tisens,7,,9,7,16
099 Tisens,8,,12,17,29
099 Tisens,9,,12,12,24
099 Tisens,10,,10,12,22
099 Tisens,11,,12,9,21
099 Tisens,12,,11,17,28
099 Tisens,13,,10,11,21
099 Tisens,14,,10,8,18
099 Tisens,15,,13,14,27
099 Tisens,16,,4,7,11
099 Tisens,17,,9,7,16
099 Tisens,18,,10,7,17
099 Tisens,19,,11,11,22
099 Tisens,20,,5,9,14
099 Tisens,21,,6,16,22
099 Tisens,22,,16,8,24
099 Tisens,23,,11,13,24
099 Tisens,24,,10,7,17
099 Tisens,25,,8,11,19
099 Tisens,26,,15,6,21
099 Tisens,27,,14,8,22
099 Tisens,28,,9,13,22
099 Tisens,29,,11,13,24
099 Tisens,30,,16,9,25
099 Tisens,31,,16,12,28
099 Tisens,32,,10,18,28
099 Tisens,33,,13,14,27
099 Tisens,34,,13,11,24
099 Tisens,35,,10,17,27
099 Tisens,36,,13,7,20
099 Tisens,37,,12,7,19
099 Tisens,38,,15,9,24
099 Tisens,39,,13,10,23
099 Tisens,40,,8,11,19
099 Tisens,41,,10,14,24
099 Tisens,42,,16,12,28
099 Tisens,43,,15,18,33
099 Tisens,44,,16,17,33
099 Tisens,45,,19,19,38
099 Tisens,46,,23,20,43
099 Tisens,47,,24,10,34
099 Tisens,48,,18,29,47
099 Tisens,49,,16,9,25
099 Tisens,50,,19,14,33
099 Tisens,51,,20,6,26
099 Tisens,52,,15,12,27
099 Tisens,53,,15,6,21
099 Tisens,54,,11,13,24
099 Tisens,55,,10,13,23
099 Tisens,56,,15,19,34
099 Tisens,57,,10,12,22
099 Tisens,58,,18,12,30
099 Tisens,59,,8,8,16
099 Tisens,60,,10,10,20
099 Tisens,61,,7,11,18
099 Tisens,62,,13,10,23
099 Tisens,63,,10,5,15
099 Tisens,64,,5,6,11
099 Tisens,65,,13,7,20
099 Tisens,66,,9,9,18
099 Tisens,67,,7,7,14
099 Tisens,68,,3,6,9
099 Tisens,69,,9,12,21
099 Tisens,70,,11,8,19
099 Tisens,71,,8,10,18
099 Tisens,72,,6,12,18
099 Tisens,73,,4,8,12
099 Tisens,74,,8,9,17
099 Tisens,75,,6,12,18
099 Tisens,76,,4,4,8
099 Tisens,77,,7,7,14
099 Tisens,78,,4,11,15
099 Tisens,79,,7,6,13
099 Tisens,80,,2,10,12
099 Tisens,81,,4,9,13
099 Tisens,82,,5,7,12
099 Tisens,83,,2,15,17
099 Tisens,84,,5,6,11
099 Tisens,85,,3,9,12
099 Tisens,86,,4,7,11
099 Tisens,87,,3,8,11
099 Tisens,88,,3,7,10
099 Tisens,89,,-,2,2
099 Tisens,90,,-,4,4
099 Tisens,91,,2,3,5
099 Tisens,92,,2,2,4
099 Tisens,93,,1,2,3
099 Tisens,94,,2,3,5
099 Tisens,95,,-,1,1
099 Tisens,98,,-,1,1
099 Tisens,99,,-,1,1
099 Tisens,101,,-,1,1
100 Tiers,0,,5,6,11
100 Tiers,1,,3,8,11
100 Tiers,2,,1,6,7
100 Tiers,3,,7,5,12
100 Tiers,4,,3,3,6
100 Tiers,5,,9,7,16
100 Tiers,6,,9,2,11
100 Tiers,7,,1,6,7
100 Tiers,8,,2,9,11
100 Tiers,9,,5,2,7
100 Tiers,10,,4,8,12
100 Tiers,11,,6,4,10
100 Tiers,12,,2,9,11
100 Tiers,13,,2,7,9
100 Tiers,14,,4,9,13
100 Tiers,15,,4,9,13
100 Tiers,16,,9,6,15
100 Tiers,17,,6,3,9
100 Tiers,18,,7,10,17
100 Tiers,19,,4,6,10
100 Tiers,20,,5,2,7
100 Tiers,21,,6,3,9
100 Tiers,22,,7,3,10
100 Tiers,23,,7,7,14
100 Tiers,24,,4,6,10
100 Tiers,25,,7,9,16
100 Tiers,26,,6,6,12
100 Tiers,27,,8,7,15
100 Tiers,28,,5,4,9
100 Tiers,29,,4,9,13
100 Tiers,30,,8,4,12
100 Tiers,31,,7,3,10
100 Tiers,32,,4,5,9
100 Tiers,33,,4,5,9
100 Tiers,34,,2,2,4
100 Tiers,35,,11,6,17
100 Tiers,36,,5,1,6
100 Tiers,37,,2,4,6
100 Tiers,38,,9,9,18
100 Tiers,39,,5,8,13
100 Tiers,40,,9,7,16
100 Tiers,41,,9,7,16
100 Tiers,42,,5,7,12
100 Tiers,43,,7,7,14
100 Tiers,44,,15,11,26
100 Tiers,45,,7,3,10
100 Tiers,46,,10,12,22
100 Tiers,47,,9,6,15
100 Tiers,48,,5,6,11
100 Tiers,49,,9,5,14
100 Tiers,50,,6,10,16
100 Tiers,51,,6,7,13
100 Tiers,52,,6,5,11
100 Tiers,53,,4,9,13
100 Tiers,54,,12,6,18
100 Tiers,55,,8,4,12
100 Tiers,56,,5,9,14
100 Tiers,57,,9,8,17
100 Tiers,58,,6,4,10
100 Tiers,59,,6,4,10
100 Tiers,60,,6,6,12
100 Tiers,61,,3,2,5
100 Tiers,62,,1,4,5
100 Tiers,63,,7,5,12
100 Tiers,64,,3,4,7
100 Tiers,65,,3,5,8
100 Tiers,66,,-,3,3
100 Tiers,67,,5,4,9
100 Tiers,68,,8,3,11
100 Tiers,69,,2,4,6
100 Tiers,70,,9,10,19
100 Tiers,71,,2,5,7
100 Tiers,72,,4,6,10
100 Tiers,73,,2,2,4
100 Tiers,74,,5,6,11
100 Tiers,75,,6,5,11
100 Tiers,76,,4,4,8
100 Tiers,77,,3,5,8
100 Tiers,78,,6,2,8
100 Tiers,79,,2,5,7
100 Tiers,80,,5,3,8
100 Tiers,81,,2,5,7
100 Tiers,82,,3,3,6
100 Tiers,83,,2,-,2
100 Tiers,84,,2,2,4
100 Tiers,85,,2,2,4
100 Tiers,86,,3,3,6
100 Tiers,87,,3,1,4
100 Tiers,88,,5,1,6
100 Tiers,89,,1,3,4
100 Tiers,90,,-,2,2
100 Tiers,91,,1,-,1
100 Tiers,92,,-,3,3
100 Tiers,93,,1,-,1
100 Tiers,95,,1,1,2
100 Tiers,96,,-,1,1
100 Tiers,98,,1,-,1
101 Tirol,0,,11,6,17
101 Tirol,1,,13,13,26
101 Tirol,2,,8,11,19
101 Tirol,3,,15,13,28
101 Tirol,4,,12,6,18
101 Tirol,5,,9,13,22
101 Tirol,6,,13,8,21
101 Tirol,7,,11,10,21
101 Tirol,8,,14,6,20
101 Tirol,9,,12,16,28
101 Tirol,10,,10,11,21
101 Tirol,11,,17,10,27
101 Tirol,12,,18,9,27
101 Tirol,13,,20,13,33
101 Tirol,14,,14,16,30
101 Tirol,15,,16,12,28
101 Tirol,16,,20,23,43
101 Tirol,17,,19,18,37
101 Tirol,18,,10,17,27
101 Tirol,19,,15,15,30
101 Tirol,20,,21,14,35
101 Tirol,21,,15,16,31
101 Tirol,22,,6,8,14
101 Tirol,23,,17,10,27
101 Tirol,24,,14,17,31
101 Tirol,25,,10,17,27
101 Tirol,26,,15,15,30
101 Tirol,27,,10,14,24
101 Tirol,28,,8,15,23
101 Tirol,29,,18,13,31
101 Tirol,30,,14,15,29
101 Tirol,31,,16,11,27
101 Tirol,32,,16,19,35
101 Tirol,33,,20,7,27
101 Tirol,34,,13,13,26
101 Tirol,35,,6,12,18
101 Tirol,36,,14,20,34
101 Tirol,37,,13,14,27
101 Tirol,38,,18,13,31
101 Tirol,39,,17,21,38
101 Tirol,40,,23,16,39
101 Tirol,41,,26,20,46
101 Tirol,42,,24,21,45
101 Tirol,43,,23,16,39
101 Tirol,44,,23,21,44
101 Tirol,45,,25,27,52
101 Tirol,46,,26,19,45
101 Tirol,47,,22,19,41
101 Tirol,48,,23,19,42
101 Tirol,49,,26,21,47
101 Tirol,50,,18,15,33
101 Tirol,51,,19,18,37
101 Tirol,52,,18,24,42
101 Tirol,53,,24,14,38
101 Tirol,54,,15,16,31
101 Tirol,55,,10,16,26
101 Tirol,56,,15,21,36
101 Tirol,57,,7,15,22
101 Tirol,58,,14,18,32
101 Tirol,59,,14,17,31
101 Tirol,60,,18,16,34
101 Tirol,61,,13,13,26
101 Tirol,62,,14,18,32
101 Tirol,63,,12,11,23
101 Tirol,64,,16,16,32
101 Tirol,65,,19,14,33
101 Tirol,66,,8,13,21
101 Tirol,67,,13,8,21
101 Tirol,68,,11,14,25
101 Tirol,69,,14,15,29
101 Tirol,70,,11,12,23
101 Tirol,71,,13,17,30
101 Tirol,72,,11,16,27
101 Tirol,73,,10,14,24
101 Tirol,74,,9,11,20
101 Tirol,75,,7,9,16
101 Tirol,76,,6,14,20
101 Tirol,77,,5,10,15
101 Tirol,78,,6,7,13
101 Tirol,79,,13,8,21
101 Tirol,80,,5,10,15
101 Tirol,81,,5,6,11
101 Tirol,82,,4,5,9
101 Tirol,83,,4,6,10
101 Tirol,84,,5,9,14
101 Tirol,85,,4,7,11
101 Tirol,86,,8,7,15
101 Tirol,87,,1,3,4
101 Tirol,88,,3,3,6
101 Tirol,89,,2,9,11
101 Tirol,90,,1,4,5
101 Tirol,91,,2,2,4
101 Tirol,92,,1,1,2
101 Tirol,93,,1,1,2
101 Tirol,94,,1,1,2
101 Tirol,95,,1,-,1
101 Tirol,97,,1,-,1
102 Truden im Naturpark,0,,11,6,17
102 Truden im Naturpark,1,,2,7,9
102 Truden im Naturpark,2,,4,2,6
102 Truden im Naturpark,3,,8,6,14
102 Truden im Naturpark,4,,10,8,18
102 Truden im Naturpark,5,,6,8,14
102 Truden im Naturpark,6,,9,10,19
102 Truden im Naturpark,7,,5,1,6
102 Truden im Naturpark,8,,2,5,7
102 Truden im Naturpark,9,,5,8,13
102 Truden im Naturpark,10,,5,5,10
102 Truden im Naturpark,11,,2,4,6
102 Truden im Naturpark,12,,4,2,6
102 Truden im Naturpark,13,,8,8,16
102 Truden im Naturpark,14,,1,2,3
102 Truden im Naturpark,15,,2,9,11
102 Truden im Naturpark,16,,5,6,11
102 Truden im Naturpark,17,,5,6,11
102 Truden im Naturpark,18,,7,5,12
102 Truden im Naturpark,19,,6,5,11
102 Truden im Naturpark,20,,12,6,18
102 Truden im Naturpark,21,,7,4,11
102 Truden im Naturpark,22,,6,8,14
102 Truden im Naturpark,23,,2,5,7
102 Truden im Naturpark,24,,11,8,19
102 Truden im Naturpark,25,,7,13,20
102 Truden im Naturpark,26,,6,4,10
102 Truden im Naturpark,27,,4,9,13
102 Truden im Naturpark,28,,10,6,16
102 Truden im Naturpark,29,,11,4,15
102 Truden im Naturpark,30,,4,4,8
102 Truden im Naturpark,31,,9,6,15
102 Truden im Naturpark,32,,4,10,14
102 Truden im Naturpark,33,,6,6,12
102 Truden im Naturpark,34,,9,6,15
102 Truden im Naturpark,35,,9,8,17
102 Truden im Naturpark,36,,3,7,10
102 Truden im Naturpark,37,,8,6,14
102 Truden im Naturpark,38,,7,4,11
102 Truden im Naturpark,39,,7,11,18
102 Truden im Naturpark,40,,8,10,18
102 Truden im Naturpark,41,,9,10,19
102 Truden im Naturpark,42,,3,3,6
102 Truden im Naturpark,43,,1,7,8
102 Truden im Naturpark,44,,8,9,17
102 Truden im Naturpark,45,,7,9,16
102 Truden im Naturpark,46,,11,6,17
102 Truden im Naturpark,47,,6,11,17
102 Truden im Naturpark,48,,9,7,16
102 Truden im Naturpark,49,,11,7,18
102 Truden im Naturpark,50,,12,7,19
102 Truden im Naturpark,51,,10,6,16
102 Truden im Naturpark,52,,9,7,16
102 Truden im Naturpark,53,,9,12,21
102 Truden im Naturpark,54,,5,8,13
102 Truden im Naturpark,55,,6,11,17
102 Truden im Naturpark,56,,5,7,12
102 Truden im Naturpark,57,,6,6,12
102 Truden im Naturpark,58,,7,10,17
102 Truden im Naturpark,59,,5,7,12
102 Truden im Naturpark,60,,11,6,17
102 Truden im Naturpark,61,,4,6,10
102 Truden im Naturpark,62,,9,5,14
102 Truden im Naturpark,63,,2,3,5
102 Truden im Naturpark,64,,7,3,10
102 Truden im Naturpark,65,,1,5,6
102 Truden im Naturpark,66,,7,2,9
102 Truden im Naturpark,67,,9,7,16
102 Truden im Naturpark,68,,4,3,7
102 Truden im Naturpark,69,,3,6,9
102 Truden im Naturpark,70,,4,5,9
102 Truden im Naturpark,71,,4,4,8
102 Truden im Naturpark,72,,4,6,10
102 Truden im Naturpark,73,,2,4,6
102 Truden im Naturpark,74,,8,2,10
102 Truden im Naturpark,75,,5,7,12
102 Truden im Naturpark,76,,1,4,5
102 Truden im Naturpark,77,,4,2,6
102 Truden im Naturpark,78,,3,1,4
102 Truden im Naturpark,79,,4,1,5
102 Truden im Naturpark,80,,4,7,11
102 Truden im Naturpark,81,,2,3,5
102 Truden im Naturpark,82,,2,3,5
102 Truden im Naturpark,83,,-,6,6
102 Truden im Naturpark,84,,-,5,5
102 Truden im Naturpark,85,,-,4,4
102 Truden im Naturpark,86,,2,4,6
102 Truden im Naturpark,87,,1,6,7
102 Truden im Naturpark,88,,-,4,4
102 Truden im Naturpark,89,,-,3,3
102 Truden im Naturpark,90,,-,4,4
102 Truden im Naturpark,91,,1,3,4
102 Truden im Naturpark,92,,-,2,2
102 Truden im Naturpark,93,,-,1,1
102 Truden im Naturpark,94,,-,1,1
103 Taufers im Münstertal,0,,4,2,6
103 Taufers im Münstertal,1,,4,6,10
103 Taufers im Münstertal,2,,6,7,13
103 Taufers im Münstertal,3,,4,-,4
103 Taufers im Münstertal,4,,7,8,15
103 Taufers im Münstertal,5,,4,5,9
103 Taufers im Münstertal,6,,6,3,9
103 Taufers im Münstertal,7,,3,9,12
103 Taufers im Münstertal,8,,2,5,7
103 Taufers im Münstertal,9,,8,4,12
103 Taufers im Münstertal,10,,3,3,6
103 Taufers im Münstertal,11,,5,5,10
103 Taufers im Münstertal,12,,5,6,11
103 Taufers im Münstertal,13,,4,3,7
103 Taufers im Münstertal,14,,3,4,7
103 Taufers im Münstertal,15,,7,8,15
103 Taufers im Münstertal,16,,4,4,8
103 Taufers im Münstertal,17,,6,4,10
103 Taufers im Münstertal,18,,9,9,18
103 Taufers im Münstertal,19,,6,8,14
103 Taufers im Münstertal,20,,6,5,11
103 Taufers im Münstertal,21,,8,8,16
103 Taufers im Münstertal,22,,6,10,16
103 Taufers im Münstertal,23,,9,7,16
103 Taufers im Münstertal,24,,6,5,11
103 Taufers im Münstertal,25,,7,6,13
103 Taufers im Münstertal,26,,5,6,11
103 Taufers im Münstertal,27,,7,3,10
103 Taufers im Münstertal,28,,6,5,11
103 Taufers im Münstertal,29,,4,5,9
103 Taufers im Münstertal,30,,5,6,11
103 Taufers im Münstertal,31,,4,11,15
103 Taufers im Münstertal,32,,7,8,15
103 Taufers im Münstertal,33,,7,4,11
103 Taufers im Münstertal,34,,6,3,9
103 Taufers im Münstertal,35,,6,3,9
103 Taufers im Münstertal,36,,4,3,7
103 Taufers im Münstertal,37,,1,6,7
103 Taufers im Münstertal,38,,11,5,16
103 Taufers im Münstertal,39,,6,4,10
103 Taufers im Münstertal,40,,1,7,8
103 Taufers im Münstertal,41,,5,8,13
103 Taufers im Münstertal,42,,6,15,21
103 Taufers im Münstertal,43,,6,8,14
103 Taufers im Münstertal,44,,10,6,16
103 Taufers im Münstertal,45,,8,12,20
103 Taufers im Münstertal,46,,5,4,9
103 Taufers im Münstertal,47,,5,10,15
103 Taufers im Münstertal,48,,11,6,17
103 Taufers im Münstertal,49,,9,12,21
103 Taufers im Münstertal,50,,10,10,20
103 Taufers im Münstertal,51,,11,8,19
103 Taufers im Münstertal,52,,9,7,16
103 Taufers im Münstertal,53,,12,7,19
103 Taufers im Münstertal,54,,6,10,16
103 Taufers im Münstertal,55,,5,6,11
103 Taufers im Münstertal,56,,8,7,15
103 Taufers im Münstertal,57,,11,10,21
103 Taufers im Münstertal,58,,4,3,7
103 Taufers im Münstertal,59,,4,6,10
103 Taufers im Münstertal,60,,6,4,10
103 Taufers im Münstertal,61,,7,2,9
103 Taufers im Münstertal,62,,5,4,9
103 Taufers im Münstertal,63,,7,3,10
103 Taufers im Münstertal,64,,5,1,6
103 Taufers im Münstertal,65,,5,1,6
103 Taufers im Münstertal,66,,3,6,9
103 Taufers im Münstertal,67,,2,3,5
103 Taufers im Münstertal,68,,2,4,6
103 Taufers im Münstertal,69,,1,-,1
103 Taufers im Münstertal,70,,6,4,10
103 Taufers im Münstertal,71,,4,4,8
103 Taufers im Münstertal,72,,3,4,7
103 Taufers im Münstertal,73,,2,3,5
103 Taufers im Münstertal,74,,4,4,8
103 Taufers im Münstertal,75,,7,8,15
103 Taufers im Münstertal,76,,3,3,6
103 Taufers im Münstertal,77,,2,8,10
103 Taufers im Münstertal,78,,2,2,4
103 Taufers im Münstertal,79,,2,7,9
103 Taufers im Münstertal,80,,3,5,8
103 Taufers im Münstertal,81,,4,1,5
103 Taufers im Münstertal,82,,7,4,11
103 Taufers im Münstertal,83,,1,3,4
103 Taufers im Münstertal,84,,4,4,8
103 Taufers im Münstertal,85,,3,3,6
103 Taufers im Münstertal,86,,2,2,4
103 Taufers im Münstertal,87,,1,4,5
103 Taufers im Münstertal,88,,1,3,4
103 Taufers im Münstertal,89,,-,1,1
103 Taufers im Münstertal,90,,2,2,4
103 Taufers im Münstertal,91,,-,1,1
103 Taufers im Münstertal,92,,1,-,1
103 Taufers im Münstertal,95,,-,1,1
103 Taufers im Münstertal,96,,1,-,1
104 Ulten,0,,20,14,34
104 Ulten,1,,11,11,22
104 Ulten,2,,15,21,36
104 Ulten,3,,14,11,25
104 Ulten,4,,17,13,30
104 Ulten,5,,18,10,28
104 Ulten,6,,6,9,15
104 Ulten,7,,14,11,25
104 Ulten,8,,18,20,38
104 Ulten,9,,17,12,29
104 Ulten,10,,23,18,41
104 Ulten,11,,15,18,33
104 Ulten,12,,20,17,37
104 Ulten,13,,16,18,34
104 Ulten,14,,14,14,28
104 Ulten,15,,16,17,33
104 Ulten,16,,14,20,34
104 Ulten,17,,11,14,25
104 Ulten,18,,12,14,26
104 Ulten,19,,18,14,32
104 Ulten,20,,23,16,39
104 Ulten,21,,16,17,33
104 Ulten,22,,24,29,53
104 Ulten,23,,14,17,31
104 Ulten,24,,16,27,43
104 Ulten,25,,15,17,32
104 Ulten,26,,15,17,32
104 Ulten,27,,19,10,29
104 Ulten,28,,16,20,36
104 Ulten,29,,19,16,35
104 Ulten,30,,19,13,32
104 Ulten,31,,15,21,36
104 Ulten,32,,21,19,40
104 Ulten,33,,19,21,40
104 Ulten,34,,16,17,33
104 Ulten,35,,23,13,36
104 Ulten,36,,17,14,31
104 Ulten,37,,16,19,35
104 Ulten,38,,22,20,42
104 Ulten,39,,13,23,36
104 Ulten,40,,25,15,40
104 Ulten,41,,20,17,37
104 Ulten,42,,27,20,47
104 Ulten,43,,21,25,46
104 Ulten,44,,26,22,48
104 Ulten,45,,29,25,54
104 Ulten,46,,16,19,35
104 Ulten,47,,20,17,37
104 Ulten,48,,26,29,55
104 Ulten,49,,23,18,41
104 Ulten,50,,27,24,51
104 Ulten,51,,29,22,51
104 Ulten,52,,26,17,43
104 Ulten,53,,25,21,46
104 Ulten,54,,24,21,45
104 Ulten,55,,26,16,42
104 Ulten,56,,33,22,55
104 Ulten,57,,18,15,33
104 Ulten,58,,13,12,25
104 Ulten,59,,17,14,31
104 Ulten,60,,21,13,34
104 Ulten,61,,17,13,30
104 Ulten,62,,16,17,33
104 Ulten,63,,18,12,30
104 Ulten,64,,16,9,25
104 Ulten,65,,13,13,26
104 Ulten,66,,15,9,24
104 Ulten,67,,16,14,30
104 Ulten,68,,9,12,21
104 Ulten,69,,11,21,32
104 Ulten,70,,16,15,31
104 Ulten,71,,8,13,21
104 Ulten,72,,10,10,20
104 Ulten,73,,13,8,21
104 Ulten,74,,17,17,34
104 Ulten,75,,6,10,16
104 Ulten,76,,9,9,18
104 Ulten,77,,6,9,15
104 Ulten,78,,6,10,16
104 Ulten,79,,10,13,23
104 Ulten,80,,4,11,15
104 Ulten,81,,8,8,16
104 Ulten,82,,6,8,14
104 Ulten,83,,10,15,25
104 Ulten,84,,2,11,13
104 Ulten,85,,4,8,12
104 Ulten,86,,5,14,19
104 Ulten,87,,4,10,14
104 Ulten,88,,5,7,12
104 Ulten,89,,3,5,8
104 Ulten,90,,3,15,18
104 Ulten,91,,3,4,7
104 Ulten,92,,5,3,8
104 Ulten,93,,1,2,3
104 Ulten,94,,-,2,2
104 Ulten,95,,1,-,1
104 Ulten,98,,1,-,1
104 Ulten,99,,-,1,1
105 Pfatten,0,,9,8,17
105 Pfatten,1,,4,6,10
105 Pfatten,2,,14,6,20
105 Pfatten,3,,6,4,10
105 Pfatten,4,,6,6,12
105 Pfatten,5,,8,6,14
105 Pfatten,6,,8,8,16
105 Pfatten,7,,9,3,12
105 Pfatten,8,,5,11,16
105 Pfatten,9,,1,6,7
105 Pfatten,10,,10,5,15
105 Pfatten,11,,4,5,9
105 Pfatten,12,,5,3,8
105 Pfatten,13,,3,5,8
105 Pfatten,14,,5,7,12
105 Pfatten,15,,7,5,12
105 Pfatten,16,,5,2,7
105 Pfatten,17,,4,8,12
105 Pfatten,18,,6,6,12
105 Pfatten,19,,8,10,18
105 Pfatten,20,,5,5,10
105 Pfatten,21,,6,7,13
105 Pfatten,22,,8,4,12
105 Pfatten,23,,8,7,15
105 Pfatten,24,,8,7,15
105 Pfatten,25,,2,4,6
105 Pfatten,26,,8,5,13
105 Pfatten,27,,4,12,16
105 Pfatten,28,,5,11,16
105 Pfatten,29,,7,6,13
105 Pfatten,30,,8,12,20
105 Pfatten,31,,8,5,13
105 Pfatten,32,,11,5,16
105 Pfatten,33,,2,3,5
105 Pfatten,34,,7,11,18
105 Pfatten,35,,5,9,14
105 Pfatten,36,,6,7,13
105 Pfatten,37,,6,10,16
105 Pfatten,38,,4,10,14
105 Pfatten,39,,15,11,26
105 Pfatten,40,,10,5,15
105 Pfatten,41,,8,8,16
105 Pfatten,42,,12,6,18
105 Pfatten,43,,10,8,18
105 Pfatten,44,,6,4,10
105 Pfatten,45,,7,9,16
105 Pfatten,46,,13,5,18
105 Pfatten,47,,10,9,19
105 Pfatten,48,,11,10,21
105 Pfatten,49,,11,4,15
105 Pfatten,50,,7,9,16
105 Pfatten,51,,11,13,24
105 Pfatten,52,,10,13,23
105 Pfatten,53,,8,8,16
105 Pfatten,54,,5,14,19
105 Pfatten,55,,7,6,13
105 Pfatten,56,,14,6,20
105 Pfatten,57,,9,9,18
105 Pfatten,58,,6,5,11
105 Pfatten,59,,10,2,12
105 Pfatten,60,,5,5,10
105 Pfatten,61,,1,6,7
105 Pfatten,62,,5,4,9
105 Pfatten,63,,5,5,10
105 Pfatten,64,,8,2,10
105 Pfatten,65,,3,1,4
105 Pfatten,66,,5,7,12
105 Pfatten,67,,3,4,7
105 Pfatten,68,,6,2,8
105 Pfatten,69,,4,2,6
105 Pfatten,70,,1,2,3
105 Pfatten,71,,1,2,3
105 Pfatten,72,,3,4,7
105 Pfatten,73,,3,3,6
105 Pfatten,74,,3,1,4
105 Pfatten,75,,2,2,4
105 Pfatten,76,,3,1,4
105 Pfatten,77,,2,3,5
105 Pfatten,78,,4,3,7
105 Pfatten,79,,1,6,7
105 Pfatten,80,,1,1,2
105 Pfatten,81,,-,5,5
105 Pfatten,82,,2,3,5
105 Pfatten,83,,-,2,2
105 Pfatten,84,,-,5,5
105 Pfatten,85,,-,1,1
105 Pfatten,87,,1,1,2
105 Pfatten,88,,1,2,3
105 Pfatten,89,,-,2,2
105 Pfatten,90,,1,-,1
105 Pfatten,92,,-,1,1
105 Pfatten,93,,1,-,1
105 Pfatten,96,,-,1,1
106 Olang,0,,22,16,38
106 Olang,1,,12,24,36
106 Olang,2,,18,21,39
106 Olang,3,,20,19,39
106 Olang,4,,13,21,34
106 Olang,5,,24,22,46
106 Olang,6,,12,23,35
106 Olang,7,,7,18,25
106 Olang,8,,23,11,34
106 Olang,9,,14,13,27
106 Olang,10,,21,11,32
106 Olang,11,,15,13,28
106 Olang,12,,16,20,36
106 Olang,13,,20,21,41
106 Olang,14,,16,12,28
106 Olang,15,,17,22,39
106 Olang,16,,23,15,38
106 Olang,17,,25,22,47
106 Olang,18,,19,10,29
106 Olang,19,,20,11,31
106 Olang,20,,21,22,43
106 Olang,21,,16,18,34
106 Olang,22,,27,14,41
106 Olang,23,,26,22,48
106 Olang,24,,20,20,40
106 Olang,25,,15,18,33
106 Olang,26,,24,20,44
106 Olang,27,,15,20,35
106 Olang,28,,13,19,32
106 Olang,29,,22,16,38
106 Olang,30,,15,19,34
106 Olang,31,,20,20,40
106 Olang,32,,11,25,36
106 Olang,33,,23,18,41
106 Olang,34,,23,26,49
106 Olang,35,,21,20,41
106 Olang,36,,33,28,61
106 Olang,37,,21,21,42
106 Olang,38,,27,25,52
106 Olang,39,,17,26,43
106 Olang,40,,30,25,55
106 Olang,41,,27,18,45
106 Olang,42,,31,17,48
106 Olang,43,,21,19,40
106 Olang,44,,23,32,55
106 Olang,45,,31,26,57
106 Olang,46,,34,25,59
106 Olang,47,,29,24,53
106 Olang,48,,18,24,42
106 Olang,49,,20,26,46
106 Olang,50,,29,25,54
106 Olang,51,,24,14,38
106 Olang,52,,15,25,40
106 Olang,53,,21,26,47
106 Olang,54,,25,15,40
106 Olang,55,,22,14,36
106 Olang,56,,28,13,41
106 Olang,57,,12,28,40
106 Olang,58,,18,16,34
106 Olang,59,,15,19,34
106 Olang,60,,16,20,36
106 Olang,61,,15,13,28
106 Olang,62,,8,15,23
106 Olang,63,,32,17,49
106 Olang,64,,20,11,31
106 Olang,65,,19,20,39
106 Olang,66,,12,23,35
106 Olang,67,,14,13,27
106 Olang,68,,17,11,28
106 Olang,69,,15,6,21
106 Olang,70,,11,16,27
106 Olang,71,,14,16,30
106 Olang,72,,12,13,25
106 Olang,73,,16,10,26
106 Olang,74,,8,9,17
106 Olang,75,,8,12,20
106 Olang,76,,5,8,13
106 Olang,77,,5,7,12
106 Olang,78,,6,14,20
106 Olang,79,,11,8,19
106 Olang,80,,8,14,22
106 Olang,81,,9,9,18
106 Olang,82,,1,6,7
106 Olang,83,,10,6,16
106 Olang,84,,7,11,18
106 Olang,85,,4,5,9
106 Olang,86,,4,5,9
106 Olang,87,,1,7,8
106 Olang,88,,2,-,2
106 Olang,89,,2,9,11
106 Olang,90,,2,2,4
106 Olang,91,,-,2,2
106 Olang,92,,1,2,3
106 Olang,93,,1,2,3
106 Olang,94,,1,1,2
106 Olang,95,,-,1,1
106 Olang,97,,-,1,1
106 Olang,98,,1,1,2
107 Pfitsch,0,,19,21,40
107 Pfitsch,1,,27,21,48
107 Pfitsch,2,,17,14,31
107 Pfitsch,3,,22,12,34
107 Pfitsch,4,,16,9,25
107 Pfitsch,5,,15,20,35
107 Pfitsch,6,,17,10,27
107 Pfitsch,7,,26,15,41
107 Pfitsch,8,,17,18,35
107 Pfitsch,9,,20,13,33
107 Pfitsch,10,,16,17,33
107 Pfitsch,11,,22,20,42
107 Pfitsch,12,,11,9,20
107 Pfitsch,13,,24,23,47
107 Pfitsch,14,,19,13,32
107 Pfitsch,15,,9,14,23
107 Pfitsch,16,,15,18,33
107 Pfitsch,17,,11,13,24
107 Pfitsch,18,,17,11,28
107 Pfitsch,19,,14,17,31
107 Pfitsch,20,,14,15,29
107 Pfitsch,21,,16,16,32
107 Pfitsch,22,,20,16,36
107 Pfitsch,23,,18,13,31
107 Pfitsch,24,,13,15,28
107 Pfitsch,25,,13,18,31
107 Pfitsch,26,,8,18,26
107 Pfitsch,27,,12,13,25
107 Pfitsch,28,,13,11,24
107 Pfitsch,29,,22,13,35
107 Pfitsch,30,,21,28,49
107 Pfitsch,31,,28,19,47
107 Pfitsch,32,,18,27,45
107 Pfitsch,33,,19,27,46
107 Pfitsch,34,,24,19,43
107 Pfitsch,35,,30,18,48
107 Pfitsch,36,,18,15,33
107 Pfitsch,37,,22,31,53
107 Pfitsch,38,,22,25,47
107 Pfitsch,39,,19,18,37
107 Pfitsch,40,,24,21,45
107 Pfitsch,41,,22,22,44
107 Pfitsch,42,,30,17,47
107 Pfitsch,43,,20,23,43
107 Pfitsch,44,,28,21,49
107 Pfitsch,45,,21,20,41
107 Pfitsch,46,,24,20,44
107 Pfitsch,47,,24,20,44
107 Pfitsch,48,,20,20,40
107 Pfitsch,49,,15,26,41
107 Pfitsch,50,,19,17,36
107 Pfitsch,51,,24,21,45
107 Pfitsch,52,,22,19,41
107 Pfitsch,53,,15,24,39
107 Pfitsch,54,,12,16,28
107 Pfitsch,55,,23,14,37
107 Pfitsch,56,,24,24,48
107 Pfitsch,57,,19,16,35
107 Pfitsch,58,,13,14,27
107 Pfitsch,59,,19,19,38
107 Pfitsch,60,,23,16,39
107 Pfitsch,61,,15,21,36
107 Pfitsch,62,,21,17,38
107 Pfitsch,63,,18,19,37
107 Pfitsch,64,,12,17,29
107 Pfitsch,65,,8,7,15
107 Pfitsch,66,,8,12,20
107 Pfitsch,67,,14,13,27
107 Pfitsch,68,,10,13,23
107 Pfitsch,69,,11,13,24
107 Pfitsch,70,,19,11,30
107 Pfitsch,71,,19,14,33
107 Pfitsch,72,,13,16,29
107 Pfitsch,73,,11,13,24
107 Pfitsch,74,,13,8,21
107 Pfitsch,75,,4,11,15
107 Pfitsch,76,,8,11,19
107 Pfitsch,77,,6,11,17
107 Pfitsch,78,,6,6,12
107 Pfitsch,79,,10,6,16
107 Pfitsch,80,,13,10,23
107 Pfitsch,81,,4,11,15
107 Pfitsch,82,,7,7,14
107 Pfitsch,83,,2,9,11
107 Pfitsch,84,,9,8,17
107 Pfitsch,85,,2,10,12
107 Pfitsch,86,,5,9,14
107 Pfitsch,87,,2,8,10
107 Pfitsch,88,,3,6,9
107 Pfitsch,89,,-,5,5
107 Pfitsch,90,,2,5,7
107 Pfitsch,91,,3,2,5
107 Pfitsch,92,,-,5,5
107 Pfitsch,93,,-,1,1
107 Pfitsch,94,,-,2,2
107 Pfitsch,95,,-,1,1
107 Pfitsch,96,,-,1,1
107 Pfitsch,98,,-,1,1
108 Ahrntal,0,,31,26,57
108 Ahrntal,1,,48,29,77
108 Ahrntal,2,,37,34,71
108 Ahrntal,3,,30,29,59
108 Ahrntal,4,,43,42,85
108 Ahrntal,5,,27,47,74
108 Ahrntal,6,,42,40,82
108 Ahrntal,7,,40,35,75
108 Ahrntal,8,,31,39,70
108 Ahrntal,9,,32,39,71
108 Ahrntal,10,,35,40,75
108 Ahrntal,11,,31,36,67
108 Ahrntal,12,,34,30,64
108 Ahrntal,13,,49,42,91
108 Ahrntal,14,,35,37,72
108 Ahrntal,15,,36,37,73
108 Ahrntal,16,,42,46,88
108 Ahrntal,17,,39,49,88
108 Ahrntal,18,,36,30,66
108 Ahrntal,19,,28,28,56
108 Ahrntal,20,,37,43,80
108 Ahrntal,21,,42,32,74
108 Ahrntal,22,,29,33,62
108 Ahrntal,23,,42,34,76
108 Ahrntal,24,,39,33,72
108 Ahrntal,25,,30,31,61
108 Ahrntal,26,,37,36,73
108 Ahrntal,27,,38,47,85
108 Ahrntal,28,,39,46,85
108 Ahrntal,29,,38,26,64
108 Ahrntal,30,,45,48,93
108 Ahrntal,31,,41,42,83
108 Ahrntal,32,,50,37,87
108 Ahrntal,33,,38,36,74
108 Ahrntal,34,,34,43,77
108 Ahrntal,35,,32,39,71
108 Ahrntal,36,,47,45,92
108 Ahrntal,37,,49,44,93
108 Ahrntal,38,,44,41,85
108 Ahrntal,39,,46,38,84
108 Ahrntal,40,,46,39,85
108 Ahrntal,41,,55,51,106
108 Ahrntal,42,,68,44,112
108 Ahrntal,43,,53,47,100
108 Ahrntal,44,,51,44,95
108 Ahrntal,45,,51,43,94
108 Ahrntal,46,,41,49,90
108 Ahrntal,47,,58,43,101
108 Ahrntal,48,,56,43,99
108 Ahrntal,49,,50,42,92
108 Ahrntal,50,,49,42,91
108 Ahrntal,51,,37,48,85
108 Ahrntal,52,,34,38,72
108 Ahrntal,53,,37,29,66
108 Ahrntal,54,,41,41,82
108 Ahrntal,55,,46,29,75
108 Ahrntal,56,,26,40,66
108 Ahrntal,57,,35,21,56
108 Ahrntal,58,,34,24,58
108 Ahrntal,59,,34,20,54
108 Ahrntal,60,,26,29,55
108 Ahrntal,61,,27,34,61
108 Ahrntal,62,,30,22,52
108 Ahrntal,63,,32,19,51
108 Ahrntal,64,,33,30,63
108 Ahrntal,65,,27,27,54
108 Ahrntal,66,,22,17,39
108 Ahrntal,67,,17,22,39
108 Ahrntal,68,,20,13,33
108 Ahrntal,69,,15,18,33
108 Ahrntal,70,,20,30,50
108 Ahrntal,71,,27,27,54
108 Ahrntal,72,,25,31,56
108 Ahrntal,73,,29,23,52
108 Ahrntal,74,,20,22,42
108 Ahrntal,75,,31,28,59
108 Ahrntal,76,,20,19,39
108 Ahrntal,77,,19,13,32
108 Ahrntal,78,,13,35,48
108 Ahrntal,79,,15,20,35
108 Ahrntal,80,,16,16,32
108 Ahrntal,81,,17,26,43
108 Ahrntal,82,,19,16,35
108 Ahrntal,83,,15,14,29
108 Ahrntal,84,,11,15,26
108 Ahrntal,85,,10,23,33
108 Ahrntal,86,,5,12,17
108 Ahrntal,87,,9,12,21
108 Ahrntal,88,,3,11,14
108 Ahrntal,89,,4,4,8
108 Ahrntal,90,,4,4,8
108 Ahrntal,91,,3,9,12
108 Ahrntal,92,,-,1,1
108 Ahrntal,93,,-,2,2
108 Ahrntal,94,,3,2,5
108 Ahrntal,97,,-,1,1
108 Ahrntal,98,,-,1,1
108 Ahrntal,99,,-,3,3
109 Gsies,0,,19,14,33
109 Gsies,1,,15,16,31
109 Gsies,2,,12,17,29
109 Gsies,3,,16,15,31
109 Gsies,4,,16,19,35
109 Gsies,5,,15,10,25
109 Gsies,6,,17,13,30
109 Gsies,7,,19,20,39
109 Gsies,8,,16,17,33
109 Gsies,9,,11,13,24
109 Gsies,10,,19,19,38
109 Gsies,11,,13,12,25
109 Gsies,12,,15,14,29
109 Gsies,13,,9,12,21
109 Gsies,14,,30,10,40
109 Gsies,15,,19,5,24
109 Gsies,16,,13,17,30
109 Gsies,17,,10,18,28
109 Gsies,18,,15,16,31
109 Gsies,19,,9,17,26
109 Gsies,20,,17,20,37
109 Gsies,21,,16,10,26
109 Gsies,22,,15,22,37
109 Gsies,23,,16,12,28
109 Gsies,24,,9,13,22
109 Gsies,25,,8,15,23
109 Gsies,26,,18,17,35
109 Gsies,27,,14,17,31
109 Gsies,28,,17,14,31
109 Gsies,29,,12,13,25
109 Gsies,30,,18,8,26
109 Gsies,31,,19,16,35
109 Gsies,32,,16,23,39
109 Gsies,33,,23,20,43
109 Gsies,34,,11,15,26
109 Gsies,35,,16,13,29
109 Gsies,36,,14,16,30
109 Gsies,37,,12,17,29
109 Gsies,38,,18,22,40
109 Gsies,39,,18,13,31
109 Gsies,40,,14,10,24
109 Gsies,41,,8,19,27
109 Gsies,42,,19,18,37
109 Gsies,43,,27,15,42
109 Gsies,44,,24,10,34
109 Gsies,45,,15,15,30
109 Gsies,46,,16,13,29
109 Gsies,47,,15,19,34
109 Gsies,48,,18,5,23
109 Gsies,49,,16,18,34
109 Gsies,50,,14,14,28
109 Gsies,51,,16,8,24
109 Gsies,52,,9,14,23
109 Gsies,53,,15,18,33
109 Gsies,54,,10,14,24
109 Gsies,55,,16,16,32
109 Gsies,56,,11,13,24
109 Gsies,57,,16,7,23
109 Gsies,58,,14,10,24
109 Gsies,59,,16,6,22
109 Gsies,60,,18,6,24
109 Gsies,61,,16,14,30
109 Gsies,62,,14,13,27
109 Gsies,63,,7,8,15
109 Gsies,64,,16,17,33
109 Gsies,65,,7,10,17
109 Gsies,66,,20,7,27
109 Gsies,67,,15,10,25
109 Gsies,68,,5,12,17
109 Gsies,69,,7,13,20
109 Gsies,70,,9,8,17
109 Gsies,71,,5,12,17
109 Gsies,72,,6,10,16
109 Gsies,73,,6,10,16
109 Gsies,74,,5,9,14
109 Gsies,75,,9,8,17
109 Gsies,76,,8,7,15
109 Gsies,77,,4,11,15
109 Gsies,78,,3,7,10
109 Gsies,79,,3,8,11
109 Gsies,80,,5,6,11
109 Gsies,81,,6,4,10
109 Gsies,82,,5,6,11
109 Gsies,83,,10,6,16
109 Gsies,84,,3,4,7
109 Gsies,85,,6,8,14
109 Gsies,86,,-,8,8
109 Gsies,87,,2,2,4
109 Gsies,88,,3,3,6
109 Gsies,89,,1,4,5
109 Gsies,90,,3,5,8
109 Gsies,91,,3,3,6
109 Gsies,92,,1,3,4
109 Gsies,93,,2,-,2
109 Gsies,94,,2,-,2
110 Vintl,0,,15,23,38
110 Vintl,1,,19,21,40
110 Vintl,2,,11,19,30
110 Vintl,3,,14,15,29
110 Vintl,4,,22,20,42
110 Vintl,5,,21,18,39
110 Vintl,6,,23,15,38
110 Vintl,7,,13,14,27
110 Vintl,8,,20,23,43
110 Vintl,9,,11,14,25
110 Vintl,10,,17,17,34
110 Vintl,11,,14,23,37
110 Vintl,12,,17,21,38
110 Vintl,13,,23,15,38
110 Vintl,14,,21,23,44
110 Vintl,15,,20,29,49
110 Vintl,16,,20,15,35
110 Vintl,17,,21,20,41
110 Vintl,18,,37,25,62
110 Vintl,19,,18,18,36
110 Vintl,20,,27,19,46
110 Vintl,21,,28,21,49
110 Vintl,22,,20,30,50
110 Vintl,23,,27,21,48
110 Vintl,24,,27,14,41
110 Vintl,25,,21,23,44
110 Vintl,26,,20,25,45
110 Vintl,27,,26,22,48
110 Vintl,28,,12,17,29
110 Vintl,29,,25,13,38
110 Vintl,30,,22,14,36
110 Vintl,31,,23,26,49
110 Vintl,32,,18,23,41
110 Vintl,33,,28,17,45
110 Vintl,34,,26,20,46
110 Vintl,35,,18,36,54
110 Vintl,36,,15,21,36
110 Vintl,37,,24,19,43
110 Vintl,38,,25,20,45
110 Vintl,39,,24,22,46
110 Vintl,40,,21,21,42
110 Vintl,41,,28,17,45
110 Vintl,42,,26,28,54
110 Vintl,43,,19,20,39
110 Vintl,44,,28,24,52
110 Vintl,45,,28,23,51
110 Vintl,46,,29,33,62
110 Vintl,47,,32,28,60
110 Vintl,48,,32,28,60
110 Vintl,49,,31,22,53
110 Vintl,50,,35,27,62
110 Vintl,51,,33,22,55
110 Vintl,52,,24,33,57
110 Vintl,53,,15,22,37
110 Vintl,54,,20,24,44
110 Vintl,55,,21,16,37
110 Vintl,56,,22,28,50
110 Vintl,57,,25,19,44
110 Vintl,58,,20,15,35
110 Vintl,59,,15,17,32
110 Vintl,60,,23,10,33
110 Vintl,61,,15,19,34
110 Vintl,62,,21,16,37
110 Vintl,63,,19,20,39
110 Vintl,64,,18,20,38
110 Vintl,65,,12,13,25
110 Vintl,66,,20,14,34
110 Vintl,67,,12,11,23
110 Vintl,68,,12,18,30
110 Vintl,69,,10,5,15
110 Vintl,70,,19,11,30
110 Vintl,71,,9,10,19
110 Vintl,72,,7,14,21
110 Vintl,73,,8,18,26
110 Vintl,74,,12,14,26
110 Vintl,75,,9,5,14
110 Vintl,76,,8,8,16
110 Vintl,77,,11,10,21
110 Vintl,78,,9,10,19
110 Vintl,79,,11,7,18
110 Vintl,80,,3,17,20
110 Vintl,81,,7,12,19
110 Vintl,82,,7,11,18
110 Vintl,83,,3,13,16
110 Vintl,84,,6,11,17
110 Vintl,85,,6,6,12
110 Vintl,86,,4,8,12
110 Vintl,87,,5,1,6
110 Vintl,88,,3,4,7
110 Vintl,89,,2,5,7
110 Vintl,90,,1,4,5
110 Vintl,91,,1,4,5
110 Vintl,92,,-,3,3
110 Vintl,93,,-,4,4
110 Vintl,96,,-,1,1
110 Vintl,98,,1,-,1
111 Vahrn,0,,38,26,64
111 Vahrn,1,,33,28,61
111 Vahrn,2,,34,27,61
111 Vahrn,3,,24,24,48
111 Vahrn,4,,32,23,55
111 Vahrn,5,,23,25,48
111 Vahrn,6,,37,22,59
111 Vahrn,7,,32,32,64
111 Vahrn,8,,30,32,62
111 Vahrn,9,,28,28,56
111 Vahrn,10,,29,14,43
111 Vahrn,11,,28,30,58
111 Vahrn,12,,29,19,48
111 Vahrn,13,,27,21,48
111 Vahrn,14,,28,31,59
111 Vahrn,15,,23,28,51
111 Vahrn,16,,23,23,46
111 Vahrn,17,,36,17,53
111 Vahrn,18,,28,24,52
111 Vahrn,19,,25,25,50
111 Vahrn,20,,19,17,36
111 Vahrn,21,,21,31,52
111 Vahrn,22,,21,25,46
111 Vahrn,23,,16,31,47
111 Vahrn,24,,26,20,46
111 Vahrn,25,,26,19,45
111 Vahrn,26,,18,25,43
111 Vahrn,27,,28,13,41
111 Vahrn,28,,21,27,48
111 Vahrn,29,,25,27,52
111 Vahrn,30,,31,36,67
111 Vahrn,31,,34,37,71
111 Vahrn,32,,32,30,62
111 Vahrn,33,,28,35,63
111 Vahrn,34,,25,32,57
111 Vahrn,35,,32,35,67
111 Vahrn,36,,20,31,51
111 Vahrn,37,,42,30,72
111 Vahrn,38,,33,35,68
111 Vahrn,39,,36,38,74
111 Vahrn,40,,42,41,83
111 Vahrn,41,,35,45,80
111 Vahrn,42,,40,32,72
111 Vahrn,43,,46,43,89
111 Vahrn,44,,41,47,88
111 Vahrn,45,,35,35,70
111 Vahrn,46,,42,35,77
111 Vahrn,47,,37,34,71
111 Vahrn,48,,38,40,78
111 Vahrn,49,,38,38,76
111 Vahrn,50,,36,33,69
111 Vahrn,51,,28,39,67
111 Vahrn,52,,26,26,52
111 Vahrn,53,,30,30,60
111 Vahrn,54,,33,26,59
111 Vahrn,55,,20,20,40
111 Vahrn,56,,30,29,59
111 Vahrn,57,,20,23,43
111 Vahrn,58,,25,33,58
111 Vahrn,59,,23,31,54
111 Vahrn,60,,24,27,51
111 Vahrn,61,,20,16,36
111 Vahrn,62,,20,14,34
111 Vahrn,63,,20,21,41
111 Vahrn,64,,24,32,56
111 Vahrn,65,,18,18,36
111 Vahrn,66,,14,26,40
111 Vahrn,67,,20,22,42
111 Vahrn,68,,12,14,26
111 Vahrn,69,,15,19,34
111 Vahrn,70,,20,23,43
111 Vahrn,71,,14,22,36
111 Vahrn,72,,15,22,37
111 Vahrn,73,,20,15,35
111 Vahrn,74,,19,20,39
111 Vahrn,75,,12,9,21
111 Vahrn,76,,13,19,32
111 Vahrn,77,,7,15,22
111 Vahrn,78,,6,13,19
111 Vahrn,79,,13,12,25
111 Vahrn,80,,7,11,18
111 Vahrn,81,,5,11,16
111 Vahrn,82,,8,10,18
111 Vahrn,83,,9,7,16
111 Vahrn,84,,5,16,21
111 Vahrn,85,,5,10,15
111 Vahrn,86,,1,12,13
111 Vahrn,87,,4,3,7
111 Vahrn,88,,1,9,10
111 Vahrn,89,,3,4,7
111 Vahrn,90,,3,7,10
111 Vahrn,91,,-,5,5
111 Vahrn,92,,1,3,4
111 Vahrn,93,,1,3,4
111 Vahrn,95,,-,1,1
111 Vahrn,96,,-,1,1
111 Vahrn,97,,1,-,1
111 Vahrn,99,,-,1,1
112 Vöran,0,,4,3,7
112 Vöran,1,,9,6,15
112 Vöran,2,,2,3,5
112 Vöran,3,,10,6,16
112 Vöran,4,,5,6,11
112 Vöran,5,,9,3,12
112 Vöran,6,,5,3,8
112 Vöran,7,,9,3,12
112 Vöran,8,,3,5,8
112 Vöran,9,,3,5,8
112 Vöran,10,,9,5,14
112 Vöran,11,,5,7,12
112 Vöran,12,,9,4,13
112 Vöran,13,,11,6,17
112 Vöran,14,,5,3,8
112 Vöran,15,,5,4,9
112 Vöran,16,,11,7,18
112 Vöran,17,,10,5,15
112 Vöran,18,,5,9,14
112 Vöran,19,,7,7,14
112 Vöran,20,,7,5,12
112 Vöran,21,,6,3,9
112 Vöran,22,,7,4,11
112 Vöran,23,,5,7,12
112 Vöran,24,,10,5,15
112 Vöran,25,,7,8,15
112 Vöran,26,,11,7,18
112 Vöran,27,,6,7,13
112 Vöran,28,,8,6,14
112 Vöran,29,,7,6,13
112 Vöran,30,,4,5,9
112 Vöran,31,,9,9,18
112 Vöran,32,,8,11,19
112 Vöran,33,,5,3,8
112 Vöran,34,,2,6,8
112 Vöran,35,,7,7,14
112 Vöran,36,,10,6,16
112 Vöran,37,,4,6,10
112 Vöran,38,,9,6,15
112 Vöran,39,,15,11,26
112 Vöran,40,,6,6,12
112 Vöran,41,,8,8,16
112 Vöran,42,,7,10,17
112 Vöran,43,,8,6,14
112 Vöran,44,,7,4,11
112 Vöran,45,,14,3,17
112 Vöran,46,,5,6,11
112 Vöran,47,,7,6,13
112 Vöran,48,,4,4,8
112 Vöran,49,,12,4,16
112 Vöran,50,,7,8,15
112 Vöran,51,,12,14,26
112 Vöran,52,,4,5,9
112 Vöran,53,,6,6,12
112 Vöran,54,,4,7,11
112 Vöran,55,,6,6,12
112 Vöran,56,,5,10,15
112 Vöran,57,,2,2,4
112 Vöran,58,,5,2,7
112 Vöran,59,,5,5,10
112 Vöran,60,,5,4,9
112 Vöran,61,,9,2,11
112 Vöran,62,,4,-,4
112 Vöran,63,,7,4,11
112 Vöran,64,,7,5,12
112 Vöran,65,,3,3,6
112 Vöran,66,,5,2,7
112 Vöran,67,,4,2,6
112 Vöran,68,,-,4,4
112 Vöran,69,,4,2,6
112 Vöran,70,,2,4,6
112 Vöran,71,,4,4,8
112 Vöran,72,,5,6,11
112 Vöran,73,,2,5,7
112 Vöran,74,,2,3,5
112 Vöran,75,,6,3,9
112 Vöran,76,,2,2,4
112 Vöran,77,,3,5,8
112 Vöran,78,,2,-,2
112 Vöran,79,,1,5,6
112 Vöran,80,,5,6,11
112 Vöran,81,,2,3,5
112 Vöran,82,,2,-,2
112 Vöran,83,,5,1,6
112 Vöran,84,,1,1,2
112 Vöran,85,,2,1,3
112 Vöran,86,,-,1,1
112 Vöran,87,,-,2,2
112 Vöran,88,,1,2,3
112 Vöran,90,,-,1,1
112 Vöran,91,,1,-,1
112 Vöran,93,,-,1,1
113 Niederdorf,0,,11,9,20
113 Niederdorf,1,,6,8,14
113 Niederdorf,2,,10,4,14
113 Niederdorf,3,,9,6,15
113 Niederdorf,4,,14,10,24
113 Niederdorf,5,,10,8,18
113 Niederdorf,6,,9,11,20
113 Niederdorf,7,,7,9,16
113 Niederdorf,8,,15,8,23
113 Niederdorf,9,,10,17,27
113 Niederdorf,10,,5,13,18
113 Niederdorf,11,,8,13,21
113 Niederdorf,12,,9,10,19
113 Niederdorf,13,,13,12,25
113 Niederdorf,14,,4,6,10
113 Niederdorf,15,,7,12,19
113 Niederdorf,16,,9,9,18
113 Niederdorf,17,,6,7,13
113 Niederdorf,18,,7,11,18
113 Niederdorf,19,,14,8,22
113 Niederdorf,20,,8,7,15
113 Niederdorf,21,,7,9,16
113 Niederdorf,22,,7,13,20
113 Niederdorf,23,,13,11,24
113 Niederdorf,24,,7,7,14
113 Niederdorf,25,,7,9,16
113 Niederdorf,26,,4,8,12
113 Niederdorf,27,,3,7,10
113 Niederdorf,28,,10,4,14
113 Niederdorf,29,,9,3,12
113 Niederdorf,30,,6,9,15
113 Niederdorf,31,,4,17,21
113 Niederdorf,32,,10,8,18
113 Niederdorf,33,,14,6,20
113 Niederdorf,34,,11,8,19
113 Niederdorf,35,,6,6,12
113 Niederdorf,36,,8,9,17
113 Niederdorf,37,,12,9,21
113 Niederdorf,38,,11,13,24
113 Niederdorf,39,,8,7,15
113 Niederdorf,40,,13,12,25
113 Niederdorf,41,,17,10,27
113 Niederdorf,42,,6,14,20
113 Niederdorf,43,,9,12,21
113 Niederdorf,44,,24,17,41
113 Niederdorf,45,,15,13,28
113 Niederdorf,46,,15,16,31
113 Niederdorf,47,,21,10,31
113 Niederdorf,48,,10,13,23
113 Niederdorf,49,,17,15,32
113 Niederdorf,50,,14,9,23
113 Niederdorf,51,,23,8,31
113 Niederdorf,52,,13,10,23
113 Niederdorf,53,,9,10,19
113 Niederdorf,54,,11,11,22
113 Niederdorf,55,,7,5,12
113 Niederdorf,56,,9,10,19
113 Niederdorf,57,,8,11,19
113 Niederdorf,58,,10,8,18
113 Niederdorf,59,,10,6,16
113 Niederdorf,60,,7,5,12
113 Niederdorf,61,,9,5,14
113 Niederdorf,62,,2,2,4
113 Niederdorf,63,,5,6,11
113 Niederdorf,64,,10,4,14
113 Niederdorf,65,,5,9,14
113 Niederdorf,66,,6,6,12
113 Niederdorf,67,,8,7,15
113 Niederdorf,68,,2,7,9
113 Niederdorf,69,,4,7,11
113 Niederdorf,70,,5,9,14
113 Niederdorf,71,,6,8,14
113 Niederdorf,72,,3,4,7
113 Niederdorf,73,,5,7,12
113 Niederdorf,74,,3,3,6
113 Niederdorf,75,,8,5,13
113 Niederdorf,76,,6,7,13
113 Niederdorf,77,,4,8,12
113 Niederdorf,78,,5,7,12
113 Niederdorf,79,,2,12,14
113 Niederdorf,80,,3,6,9
113 Niederdorf,81,,8,5,13
113 Niederdorf,82,,5,4,9
113 Niederdorf,83,,5,8,13
113 Niederdorf,84,,3,8,11
113 Niederdorf,85,,3,3,6
113 Niederdorf,86,,1,10,11
113 Niederdorf,87,,-,3,3
113 Niederdorf,88,,1,5,6
113 Niederdorf,89,,2,5,7
113 Niederdorf,90,,1,-,1
113 Niederdorf,91,,1,3,4
113 Niederdorf,92,,2,3,5
113 Niederdorf,93,,-,2,2
113 Niederdorf,97,,-,1,1
114 Villanders,0,,5,9,14
114 Villanders,1,,10,13,23
114 Villanders,2,,6,5,11
114 Villanders,3,,16,8,24
114 Villanders,4,,10,7,17
114 Villanders,5,,7,9,16
114 Villanders,6,,14,14,28
114 Villanders,7,,12,15,27
114 Villanders,8,,16,7,23
114 Villanders,9,,13,15,28
114 Villanders,10,,5,12,17
114 Villanders,11,,7,10,17
114 Villanders,12,,13,11,24
114 Villanders,13,,10,17,27
114 Villanders,14,,12,11,23
114 Villanders,15,,12,8,20
114 Villanders,16,,10,11,21
114 Villanders,17,,14,7,21
114 Villanders,18,,17,6,23
114 Villanders,19,,12,13,25
114 Villanders,20,,8,18,26
114 Villanders,21,,14,8,22
114 Villanders,22,,16,15,31
114 Villanders,23,,16,15,31
114 Villanders,24,,12,13,25
114 Villanders,25,,11,13,24
114 Villanders,26,,8,10,18
114 Villanders,27,,11,8,19
114 Villanders,28,,6,12,18
114 Villanders,29,,11,13,24
114 Villanders,30,,13,5,18
114 Villanders,31,,13,12,25
114 Villanders,32,,19,12,31
114 Villanders,33,,9,14,23
114 Villanders,34,,16,7,23
114 Villanders,35,,10,9,19
114 Villanders,36,,17,11,28
114 Villanders,37,,12,7,19
114 Villanders,38,,15,11,26
114 Villanders,39,,13,14,27
114 Villanders,40,,12,16,28
114 Villanders,41,,17,19,36
114 Villanders,42,,17,17,34
114 Villanders,43,,15,10,25
114 Villanders,44,,24,17,41
114 Villanders,45,,23,13,36
114 Villanders,46,,21,15,36
114 Villanders,47,,20,18,38
114 Villanders,48,,22,18,40
114 Villanders,49,,20,16,36
114 Villanders,50,,15,11,26
114 Villanders,51,,18,11,29
114 Villanders,52,,14,11,25
114 Villanders,53,,18,6,24
114 Villanders,54,,15,9,24
114 Villanders,55,,16,7,23
114 Villanders,56,,10,7,17
114 Villanders,57,,10,7,17
114 Villanders,58,,11,17,28
114 Villanders,59,,7,6,13
114 Villanders,60,,11,10,21
114 Villanders,61,,11,7,18
114 Villanders,62,,10,7,17
114 Villanders,63,,10,8,18
114 Villanders,64,,9,5,14
114 Villanders,65,,6,11,17
114 Villanders,66,,5,8,13
114 Villanders,67,,8,10,18
114 Villanders,68,,6,2,8
114 Villanders,69,,3,9,12
114 Villanders,70,,6,7,13
114 Villanders,71,,9,8,17
114 Villanders,72,,6,9,15
114 Villanders,73,,9,11,20
114 Villanders,74,,7,4,11
114 Villanders,75,,6,6,12
114 Villanders,76,,4,9,13
114 Villanders,77,,7,6,13
114 Villanders,78,,2,6,8
114 Villanders,79,,1,9,10
114 Villanders,80,,7,9,16
114 Villanders,81,,7,9,16
114 Villanders,82,,4,10,14
114 Villanders,83,,3,5,8
114 Villanders,84,,3,8,11
114 Villanders,85,,2,6,8
114 Villanders,86,,3,3,6
114 Villanders,87,,1,2,3
114 Villanders,88,,-,4,4
114 Villanders,89,,3,1,4
114 Villanders,90,,2,1,3
114 Villanders,91,,1,2,3
114 Villanders,92,,-,4,4
114 Villanders,93,,-,3,3
114 Villanders,100,,-,1,1
115 Sterzing,0,,31,25,56
115 Sterzing,1,,40,43,83
115 Sterzing,2,,37,29,66
115 Sterzing,3,,36,36,72
115 Sterzing,4,,36,36,72
115 Sterzing,5,,37,41,78
115 Sterzing,6,,35,34,69
115 Sterzing,7,,37,32,69
115 Sterzing,8,,30,28,58
115 Sterzing,9,,30,32,62
115 Sterzing,10,,35,34,69
115 Sterzing,11,,35,32,67
115 Sterzing,12,,34,32,66
115 Sterzing,13,,32,38,70
115 Sterzing,14,,28,27,55
115 Sterzing,15,,26,28,54
115 Sterzing,16,,32,35,67
115 Sterzing,17,,28,40,68
115 Sterzing,18,,35,29,64
115 Sterzing,19,,33,23,56
115 Sterzing,20,,38,26,64
115 Sterzing,21,,33,41,74
115 Sterzing,22,,38,38,76
115 Sterzing,23,,40,43,83
115 Sterzing,24,,56,31,87
115 Sterzing,25,,49,34,83
115 Sterzing,26,,60,47,107
115 Sterzing,27,,67,40,107
115 Sterzing,28,,47,44,91
115 Sterzing,29,,58,45,103
115 Sterzing,30,,67,44,111
115 Sterzing,31,,74,46,120
115 Sterzing,32,,75,45,120
115 Sterzing,33,,56,58,114
115 Sterzing,34,,54,51,105
115 Sterzing,35,,62,38,100
115 Sterzing,36,,44,34,78
115 Sterzing,37,,41,42,83
115 Sterzing,38,,47,45,92
115 Sterzing,39,,48,48,96
115 Sterzing,40,,60,67,127
115 Sterzing,41,,58,45,103
115 Sterzing,42,,42,49,91
115 Sterzing,43,,56,60,116
115 Sterzing,44,,44,36,80
115 Sterzing,45,,55,56,111
115 Sterzing,46,,66,49,115
115 Sterzing,47,,61,51,112
115 Sterzing,48,,56,50,106
115 Sterzing,49,,47,42,89
115 Sterzing,50,,51,50,101
115 Sterzing,51,,42,50,92
115 Sterzing,52,,41,38,79
115 Sterzing,53,,46,46,92
115 Sterzing,54,,52,44,96
115 Sterzing,55,,38,44,82
115 Sterzing,56,,33,47,80
115 Sterzing,57,,39,26,65
115 Sterzing,58,,35,46,81
115 Sterzing,59,,37,36,73
115 Sterzing,60,,31,42,73
115 Sterzing,61,,41,39,80
115 Sterzing,62,,36,43,79
115 Sterzing,63,,38,35,73
115 Sterzing,64,,35,47,82
115 Sterzing,65,,36,45,81
115 Sterzing,66,,27,26,53
115 Sterzing,67,,42,43,85
115 Sterzing,68,,33,37,70
115 Sterzing,69,,31,26,57
115 Sterzing,70,,38,49,87
115 Sterzing,71,,27,39,66
115 Sterzing,72,,27,28,55
115 Sterzing,73,,35,33,68
115 Sterzing,74,,23,29,52
115 Sterzing,75,,29,28,57
115 Sterzing,76,,19,33,52
115 Sterzing,77,,19,41,60
115 Sterzing,78,,19,22,41
115 Sterzing,79,,9,19,28
115 Sterzing,80,,22,25,47
115 Sterzing,81,,14,12,26
115 Sterzing,82,,15,26,41
115 Sterzing,83,,6,16,22
115 Sterzing,84,,9,13,22
115 Sterzing,85,,12,20,32
115 Sterzing,86,,12,15,27
115 Sterzing,87,,9,15,24
115 Sterzing,88,,2,12,14
115 Sterzing,89,,2,8,10
115 Sterzing,90,,5,9,14
115 Sterzing,91,,3,10,13
115 Sterzing,92,,1,4,5
115 Sterzing,93,,-,2,2
115 Sterzing,94,,2,2,4
115 Sterzing,95,,1,1,2
115 Sterzing,97,,-,1,1
115 Sterzing,98,,-,1,1
115 Sterzing,99,,-,1,1
116 Feldthurns,0,,16,16,32
116 Feldthurns,1,,20,14,34
116 Feldthurns,2,,13,13,26
116 Feldthurns,3,,24,21,45
116 Feldthurns,4,,13,15,28
116 Feldthurns,5,,17,20,37
116 Feldthurns,6,,24,16,40
116 Feldthurns,7,,27,21,48
116 Feldthurns,8,,25,14,39
116 Feldthurns,9,,20,16,36
116 Feldthurns,10,,11,14,25
116 Feldthurns,11,,23,20,43
116 Feldthurns,12,,16,20,36
116 Feldthurns,13,,23,14,37
116 Feldthurns,14,,18,22,40
116 Feldthurns,15,,23,19,42
116 Feldthurns,16,,22,17,39
116 Feldthurns,17,,16,20,36
116 Feldthurns,18,,18,20,38
116 Feldthurns,19,,15,17,32
116 Feldthurns,20,,29,18,47
116 Feldthurns,21,,21,19,40
116 Feldthurns,22,,14,13,27
116 Feldthurns,23,,13,13,26
116 Feldthurns,24,,20,11,31
116 Feldthurns,25,,14,18,32
116 Feldthurns,26,,21,7,28
116 Feldthurns,27,,14,20,34
116 Feldthurns,28,,13,18,31
116 Feldthurns,29,,21,19,40
116 Feldthurns,30,,20,21,41
116 Feldthurns,31,,14,15,29
116 Feldthurns,32,,19,18,37
116 Feldthurns,33,,12,22,34
116 Feldthurns,34,,12,18,30
116 Feldthurns,35,,33,19,52
116 Feldthurns,36,,23,15,38
116 Feldthurns,37,,22,28,50
116 Feldthurns,38,,24,14,38
116 Feldthurns,39,,27,24,51
116 Feldthurns,40,,20,15,35
116 Feldthurns,41,,31,26,57
116 Feldthurns,42,,20,21,41
116 Feldthurns,43,,19,20,39
116 Feldthurns,44,,28,25,53
116 Feldthurns,45,,20,26,46
116 Feldthurns,46,,23,22,45
116 Feldthurns,47,,19,23,42
116 Feldthurns,48,,26,26,52
116 Feldthurns,49,,22,19,41
116 Feldthurns,50,,30,19,49
116 Feldthurns,51,,14,18,32
116 Feldthurns,52,,17,17,34
116 Feldthurns,53,,14,14,28
116 Feldthurns,54,,17,16,33
116 Feldthurns,55,,13,19,32
116 Feldthurns,56,,15,13,28
116 Feldthurns,57,,12,21,33
116 Feldthurns,58,,13,14,27
116 Feldthurns,59,,15,14,29
116 Feldthurns,60,,16,12,28
116 Feldthurns,61,,22,14,36
116 Feldthurns,62,,12,11,23
116 Feldthurns,63,,14,14,28
116 Feldthurns,64,,7,15,22
116 Feldthurns,65,,12,11,23
116 Feldthurns,66,,14,9,23
116 Feldthurns,67,,11,9,20
116 Feldthurns,68,,10,12,22
116 Feldthurns,69,,17,10,27
116 Feldthurns,70,,10,11,21
116 Feldthurns,71,,8,7,15
116 Feldthurns,72,,5,4,9
116 Feldthurns,73,,9,6,15
116 Feldthurns,74,,8,10,18
116 Feldthurns,75,,11,8,19
116 Feldthurns,76,,4,9,13
116 Feldthurns,77,,6,8,14
116 Feldthurns,78,,8,10,18
116 Feldthurns,79,,2,4,6
116 Feldthurns,80,,5,4,9
116 Feldthurns,81,,5,7,12
116 Feldthurns,82,,4,6,10
116 Feldthurns,83,,4,12,16
116 Feldthurns,84,,2,8,10
116 Feldthurns,85,,6,4,10
116 Feldthurns,86,,1,2,3
116 Feldthurns,87,,-,4,4
116 Feldthurns,88,,4,6,10
116 Feldthurns,89,,1,7,8
116 Feldthurns,90,,4,4,8
116 Feldthurns,91,,1,3,4
116 Feldthurns,92,,1,2,3
116 Feldthurns,93,,-,5,5
116 Feldthurns,94,,3,1,4
116 Feldthurns,97,,-,1,1
116 Feldthurns,98,,-,1,1
116 Feldthurns,99,,-,1,1
117 Wengen,0,,7,8,15
117 Wengen,1,,12,11,23
117 Wengen,2,,10,3,13
117 Wengen,3,,12,16,28
117 Wengen,4,,7,7,14
117 Wengen,5,,7,9,16
117 Wengen,6,,9,10,19
117 Wengen,7,,7,10,17
117 Wengen,8,,9,4,13
117 Wengen,9,,5,9,14
117 Wengen,10,,5,6,11
117 Wengen,11,,10,4,14
117 Wengen,12,,5,10,15
117 Wengen,13,,9,6,15
117 Wengen,14,,9,5,14
117 Wengen,15,,7,8,15
117 Wengen,16,,12,9,21
117 Wengen,17,,10,8,18
117 Wengen,18,,11,8,19
117 Wengen,19,,12,7,19
117 Wengen,20,,10,7,17
117 Wengen,21,,10,7,17
117 Wengen,22,,17,8,25
117 Wengen,23,,12,8,20
117 Wengen,24,,4,9,13
117 Wengen,25,,7,14,21
117 Wengen,26,,12,5,17
117 Wengen,27,,8,6,14
117 Wengen,28,,8,4,12
117 Wengen,29,,14,11,25
117 Wengen,30,,13,3,16
117 Wengen,31,,11,8,19
117 Wengen,32,,5,6,11
117 Wengen,33,,9,14,23
117 Wengen,34,,12,4,16
117 Wengen,35,,5,7,12
117 Wengen,36,,9,6,15
117 Wengen,37,,6,5,11
117 Wengen,38,,18,10,28
117 Wengen,39,,11,5,16
117 Wengen,40,,17,9,26
117 Wengen,41,,13,12,25
117 Wengen,42,,12,14,26
117 Wengen,43,,11,14,25
117 Wengen,44,,7,9,16
117 Wengen,45,,16,9,25
117 Wengen,46,,11,13,24
117 Wengen,47,,13,6,19
117 Wengen,48,,8,10,18
117 Wengen,49,,11,6,17
117 Wengen,50,,14,12,26
117 Wengen,51,,14,7,21
117 Wengen,52,,7,10,17
117 Wengen,53,,10,12,22
117 Wengen,54,,7,6,13
117 Wengen,55,,6,7,13
117 Wengen,56,,6,11,17
117 Wengen,57,,4,6,10
117 Wengen,58,,7,7,14
117 Wengen,59,,9,5,14
117 Wengen,60,,6,2,8
117 Wengen,61,,5,6,11
117 Wengen,62,,9,6,15
117 Wengen,63,,2,6,8
117 Wengen,64,,4,8,12
117 Wengen,65,,1,11,12
117 Wengen,66,,6,3,9
117 Wengen,67,,5,3,8
117 Wengen,68,,6,3,9
117 Wengen,69,,6,8,14
117 Wengen,70,,3,6,9
117 Wengen,71,,7,6,13
117 Wengen,72,,4,4,8
117 Wengen,73,,5,8,13
117 Wengen,74,,6,4,10
117 Wengen,75,,5,3,8
117 Wengen,76,,7,7,14
117 Wengen,77,,-,1,1
117 Wengen,78,,2,6,8
117 Wengen,79,,2,6,8
117 Wengen,80,,3,2,5
117 Wengen,81,,1,6,7
117 Wengen,82,,5,1,6
117 Wengen,83,,4,2,6
117 Wengen,84,,1,7,8
117 Wengen,85,,1,3,4
117 Wengen,86,,1,1,2
117 Wengen,87,,1,-,1
117 Wengen,88,,-,3,3
117 Wengen,89,,-,4,4
117 Wengen,90,,-,2,2
117 Wengen,91,,2,2,4
117 Wengen,92,,1,5,6
117 Wengen,93,,1,-,1
118 U.L.Frau i.W.-St.Felix,0,,5,2,7
118 U.L.Frau i.W.-St.Felix,1,,2,7,9
118 U.L.Frau i.W.-St.Felix,2,,1,2,3
118 U.L.Frau i.W.-St.Felix,3,,3,4,7
118 U.L.Frau i.W.-St.Felix,4,,4,3,7
118 U.L.Frau i.W.-St.Felix,5,,1,9,10
118 U.L.Frau i.W.-St.Felix,6,,3,-,3
118 U.L.Frau i.W.-St.Felix,7,,3,3,6
118 U.L.Frau i.W.-St.Felix,8,,5,7,12
118 U.L.Frau i.W.-St.Felix,9,,4,3,7
118 U.L.Frau i.W.-St.Felix,10,,8,6,14
118 U.L.Frau i.W.-St.Felix,11,,7,3,10
118 U.L.Frau i.W.-St.Felix,12,,9,5,14
118 U.L.Frau i.W.-St.Felix,13,,3,2,5
118 U.L.Frau i.W.-St.Felix,14,,5,5,10
118 U.L.Frau i.W.-St.Felix,15,,6,9,15
118 U.L.Frau i.W.-St.Felix,16,,5,4,9
118 U.L.Frau i.W.-St.Felix,17,,8,5,13
118 U.L.Frau i.W.-St.Felix,18,,3,10,13
118 U.L.Frau i.W.-St.Felix,19,,7,7,14
118 U.L.Frau i.W.-St.Felix,20,,9,4,13
118 U.L.Frau i.W.-St.Felix,21,,7,4,11
118 U.L.Frau i.W.-St.Felix,22,,9,7,16
118 U.L.Frau i.W.-St.Felix,23,,7,3,10
118 U.L.Frau i.W.-St.Felix,24,,8,5,13
118 U.L.Frau i.W.-St.Felix,25,,8,5,13
118 U.L.Frau i.W.-St.Felix,26,,4,7,11
118 U.L.Frau i.W.-St.Felix,27,,7,1,8
118 U.L.Frau i.W.-St.Felix,28,,7,2,9
118 U.L.Frau i.W.-St.Felix,29,,5,2,7
118 U.L.Frau i.W.-St.Felix,30,,1,8,9
118 U.L.Frau i.W.-St.Felix,31,,4,6,10
118 U.L.Frau i.W.-St.Felix,32,,6,1,7
118 U.L.Frau i.W.-St.Felix,33,,2,4,6
118 U.L.Frau i.W.-St.Felix,34,,1,2,3
118 U.L.Frau i.W.-St.Felix,35,,-,3,3
118 U.L.Frau i.W.-St.Felix,36,,5,3,8
118 U.L.Frau i.W.-St.Felix,37,,4,8,12
118 U.L.Frau i.W.-St.Felix,38,,8,1,9
118 U.L.Frau i.W.-St.Felix,39,,5,5,10
118 U.L.Frau i.W.-St.Felix,40,,2,2,4
118 U.L.Frau i.W.-St.Felix,41,,8,5,13
118 U.L.Frau i.W.-St.Felix,42,,4,4,8
118 U.L.Frau i.W.-St.Felix,43,,5,9,14
118 U.L.Frau i.W.-St.Felix,44,,7,4,11
118 U.L.Frau i.W.-St.Felix,45,,3,9,12
118 U.L.Frau i.W.-St.Felix,46,,3,4,7
118 U.L.Frau i.W.-St.Felix,47,,9,7,16
118 U.L.Frau i.W.-St.Felix,48,,9,6,15
118 U.L.Frau i.W.-St.Felix,49,,4,8,12
118 U.L.Frau i.W.-St.Felix,50,,17,8,25
118 U.L.Frau i.W.-St.Felix,51,,7,9,16
118 U.L.Frau i.W.-St.Felix,52,,4,4,8
118 U.L.Frau i.W.-St.Felix,53,,8,8,16
118 U.L.Frau i.W.-St.Felix,54,,5,4,9
118 U.L.Frau i.W.-St.Felix,55,,4,3,7
118 U.L.Frau i.W.-St.Felix,56,,3,6,9
118 U.L.Frau i.W.-St.Felix,57,,5,6,11
118 U.L.Frau i.W.-St.Felix,58,,3,4,7
118 U.L.Frau i.W.-St.Felix,59,,6,3,9
118 U.L.Frau i.W.-St.Felix,60,,2,3,5
118 U.L.Frau i.W.-St.Felix,61,,6,3,9
118 U.L.Frau i.W.-St.Felix,62,,6,3,9
118 U.L.Frau i.W.-St.Felix,63,,3,4,7
118 U.L.Frau i.W.-St.Felix,64,,4,-,4
118 U.L.Frau i.W.-St.Felix,65,,4,-,4
118 U.L.Frau i.W.-St.Felix,66,,1,7,8
118 U.L.Frau i.W.-St.Felix,67,,1,3,4
118 U.L.Frau i.W.-St.Felix,68,,3,1,4
118 U.L.Frau i.W.-St.Felix,69,,5,1,6
118 U.L.Frau i.W.-St.Felix,70,,5,4,9
118 U.L.Frau i.W.-St.Felix,71,,2,3,5
118 U.L.Frau i.W.-St.Felix,72,,4,7,11
118 U.L.Frau i.W.-St.Felix,73,,2,-,2
118 U.L.Frau i.W.-St.Felix,74,,1,3,4
118 U.L.Frau i.W.-St.Felix,75,,2,4,6
118 U.L.Frau i.W.-St.Felix,76,,3,-,3
118 U.L.Frau i.W.-St.Felix,77,,4,2,6
118 U.L.Frau i.W.-St.Felix,78,,3,4,7
118 U.L.Frau i.W.-St.Felix,79,,3,2,5
118 U.L.Frau i.W.-St.Felix,80,,3,3,6
118 U.L.Frau i.W.-St.Felix,81,,4,1,5
118 U.L.Frau i.W.-St.Felix,82,,2,-,2
118 U.L.Frau i.W.-St.Felix,83,,3,5,8
118 U.L.Frau i.W.-St.Felix,84,,-,3,3
118 U.L.Frau i.W.-St.Felix,85,,-,2,2
118 U.L.Frau i.W.-St.Felix,86,,2,3,5
118 U.L.Frau i.W.-St.Felix,87,,2,3,5
118 U.L.Frau i.W.-St.Felix,88,,-,4,4
118 U.L.Frau i.W.-St.Felix,89,,1,1,2
118 U.L.Frau i.W.-St.Felix,90,,2,4,6
118 U.L.Frau i.W.-St.Felix,96,,-,1,1

