Gemeinde,Altersklassen,Geschlecht,Männer,Frauen,Insgesamt
001 Aldein,0,,13,6,19
001 Aldein,1,,9,12,21
001 Aldein,2,,14,4,18
001 Aldein,3,,2,10,12
001 Aldein,4,,9,3,12
001 Aldein,5,,11,10,21
001 Aldein,6,,7,9,16
001 Aldein,7,,6,11,17
001 Aldein,8,,8,13,21
001 Aldein,9,,8,14,22
001 Aldein,10,,10,8,18
001 Aldein,11,,17,8,25
001 Aldein,12,,17,10,27
001 Aldein,13,,14,7,21
001 Aldein,14,,17,8,25
001 Aldein,15,,13,4,17
001 Aldein,16,,16,15,31
001 Aldein,17,,12,18,30
001 Aldein,18,,16,8,24
001 Aldein,19,,8,7,15
001 Aldein,20,,10,13,23
001 Aldein,21,,14,7,21
001 Aldein,22,,14,10,24
001 Aldein,23,,8,12,20
001 Aldein,24,,5,6,11
001 Aldein,25,,8,6,14
001 Aldein,26,,12,12,24
001 Aldein,27,,10,6,16
001 Aldein,28,,11,5,16
001 Aldein,29,,9,3,12
001 Aldein,30,,15,12,27
001 Aldein,31,,7,7,14
001 Aldein,32,,7,9,16
001 Aldein,33,,11,7,18
001 Aldein,34,,10,13,23
001 Aldein,35,,8,12,20
001 Aldein,36,,11,14,25
001 Aldein,37,,11,8,19
001 Aldein,38,,8,20,28
001 Aldein,39,,7,14,21
001 Aldein,40,,16,11,27
001 Aldein,41,,14,12,26
001 Aldein,42,,13,10,23
001 Aldein,43,,17,7,24
001 Aldein,44,,16,15,31
001 Aldein,45,,14,15,29
001 Aldein,46,,17,8,25
001 Aldein,47,,12,16,28
001 Aldein,48,,6,14,20
001 Aldein,49,,7,20,27
001 Aldein,50,,16,10,26
001 Aldein,51,,16,10,26
001 Aldein,52,,13,6,19
001 Aldein,53,,9,16,25
001 Aldein,54,,17,14,31
001 Aldein,55,,14,9,23
001 Aldein,56,,10,12,22
001 Aldein,57,,7,4,11
001 Aldein,58,,10,10,20
001 Aldein,59,,9,8,17
001 Aldein,60,,9,9,18
001 Aldein,61,,9,7,16
001 Aldein,62,,9,9,18
001 Aldein,63,,7,4,11
001 Aldein,64,,14,10,24
001 Aldein,65,,5,13,18
001 Aldein,66,,9,6,15
001 Aldein,67,,9,9,18
001 Aldein,68,,5,11,16
001 Aldein,69,,6,10,16
001 Aldein,70,,6,5,11
001 Aldein,71,,5,6,11
001 Aldein,72,,8,9,17
001 Aldein,73,,6,10,16
001 Aldein,74,,5,12,17
001 Aldein,75,,4,8,12
001 Aldein,76,,4,9,13
001 Aldein,77,,7,7,14
001 Aldein,78,,5,7,12
001 Aldein,79,,4,4,8
001 Aldein,80,,4,3,7
001 Aldein,81,,10,4,14
001 Aldein,82,,3,3,6
001 Aldein,83,,2,4,6
001 Aldein,84,,4,2,6
001 Aldein,85,,1,3,4
001 Aldein,86,,5,6,11
001 Aldein,87,,1,1,2
001 Aldein,88,,3,3,6
001 Aldein,89,,-,2,2
001 Aldein,90,,1,4,5
001 Aldein,91,,-,5,5
001 Aldein,92,,1,4,5
001 Aldein,93,,-,3,3
001 Aldein,94,,1,2,3
001 Aldein,Insgesamt,,848,822,1.670
002 Andrian,0,,2,2,4
002 Andrian,1,,8,3,11
002 Andrian,2,,3,4,7
002 Andrian,3,,8,5,13
002 Andrian,4,,7,5,12
002 Andrian,5,,6,5,11
002 Andrian,6,,8,11,19
002 Andrian,7,,4,6,10
002 Andrian,8,,4,7,11
002 Andrian,9,,8,3,11
002 Andrian,10,,6,6,12
002 Andrian,11,,8,4,12
002 Andrian,12,,6,11,17
002 Andrian,13,,3,3,6
002 Andrian,14,,3,2,5
002 Andrian,15,,6,5,11
002 Andrian,16,,3,5,8
002 Andrian,17,,9,1,10
002 Andrian,18,,9,7,16
002 Andrian,19,,2,10,12
002 Andrian,20,,8,2,10
002 Andrian,21,,6,7,13
002 Andrian,22,,4,4,8
002 Andrian,23,,6,5,11
002 Andrian,24,,6,10,16
002 Andrian,25,,8,5,13
002 Andrian,26,,6,4,10
002 Andrian,27,,11,7,18
002 Andrian,28,,7,6,13
002 Andrian,29,,7,7,14
002 Andrian,30,,2,5,7
002 Andrian,31,,7,4,11
002 Andrian,32,,5,5,10
002 Andrian,33,,9,11,20
002 Andrian,34,,6,5,11
002 Andrian,35,,6,6,12
002 Andrian,36,,7,7,14
002 Andrian,37,,7,5,12
002 Andrian,38,,6,10,16
002 Andrian,39,,8,10,18
002 Andrian,40,,10,4,14
002 Andrian,41,,4,10,14
002 Andrian,42,,11,8,19
002 Andrian,43,,8,9,17
002 Andrian,44,,10,10,20
002 Andrian,45,,10,7,17
002 Andrian,46,,6,8,14
002 Andrian,47,,11,10,21
002 Andrian,48,,10,9,19
002 Andrian,49,,10,9,19
002 Andrian,50,,13,9,22
002 Andrian,51,,9,8,17
002 Andrian,52,,7,15,22
002 Andrian,53,,12,7,19
002 Andrian,54,,9,4,13
002 Andrian,55,,8,5,13
002 Andrian,56,,7,4,11
002 Andrian,57,,8,9,17
002 Andrian,58,,7,7,14
002 Andrian,59,,6,10,16
002 Andrian,60,,3,3,6
002 Andrian,61,,5,3,8
002 Andrian,62,,7,7,14
002 Andrian,63,,2,3,5
002 Andrian,64,,4,3,7
002 Andrian,65,,6,6,12
002 Andrian,66,,3,2,5
002 Andrian,67,,2,6,8
002 Andrian,68,,6,4,10
002 Andrian,69,,7,8,15
002 Andrian,70,,1,2,3
002 Andrian,71,,1,4,5
002 Andrian,72,,6,7,13
002 Andrian,73,,3,3,6
002 Andrian,74,,5,4,9
002 Andrian,75,,2,6,8
002 Andrian,76,,1,7,8
002 Andrian,77,,4,3,7
002 Andrian,78,,3,3,6
002 Andrian,79,,2,3,5
002 Andrian,80,,3,2,5
002 Andrian,81,,5,1,6
002 Andrian,82,,2,4,6
002 Andrian,83,,5,2,7
002 Andrian,84,,-,3,3
002 Andrian,85,,2,1,3
002 Andrian,86,,2,1,3
002 Andrian,87,,1,3,4
002 Andrian,88,,-,2,2
002 Andrian,89,,1,3,4
002 Andrian,90,,-,2,2
002 Andrian,91,,-,1,1
002 Andrian,94,,-,2,2
002 Andrian,95,,1,-,1
002 Andrian,101,,-,1,1
002 Andrian,Insgesamt,,516,507,1.023
003 Altrei,0,,4,2,6
003 Altrei,1,,2,5,7
003 Altrei,2,,2,2,4
003 Altrei,3,,2,3,5
003 Altrei,4,,-,2,2
003 Altrei,6,,2,2,4
003 Altrei,7,,2,4,6
003 Altrei,8,,6,4,10
003 Altrei,9,,2,-,2
003 Altrei,10,,4,1,5
003 Altrei,11,,2,1,3
003 Altrei,12,,-,1,1
003 Altrei,13,,2,1,3
003 Altrei,14,,4,1,5
003 Altrei,15,,1,1,2
003 Altrei,16,,3,-,3
003 Altrei,17,,3,1,4
003 Altrei,18,,-,1,1
003 Altrei,19,,-,2,2
003 Altrei,20,,1,2,3
003 Altrei,21,,3,1,4
003 Altrei,22,,2,-,2
003 Altrei,23,,7,2,9
003 Altrei,24,,-,1,1
003 Altrei,25,,3,2,5
003 Altrei,26,,1,2,3
003 Altrei,27,,3,6,9
003 Altrei,28,,2,2,4
003 Altrei,29,,1,3,4
003 Altrei,30,,3,2,5
003 Altrei,31,,3,3,6
003 Altrei,32,,5,1,6
003 Altrei,33,,2,3,5
003 Altrei,34,,1,2,3
003 Altrei,35,,1,2,3
003 Altrei,36,,1,3,4
003 Altrei,37,,3,4,7
003 Altrei,38,,-,2,2
003 Altrei,39,,2,3,5
003 Altrei,40,,2,2,4
003 Altrei,41,,1,-,1
003 Altrei,42,,2,4,6
003 Altrei,43,,3,-,3
003 Altrei,44,,5,3,8
003 Altrei,45,,2,3,5
003 Altrei,46,,3,5,8
003 Altrei,47,,1,4,5
003 Altrei,48,,3,1,4
003 Altrei,49,,2,4,6
003 Altrei,50,,3,4,7
003 Altrei,51,,3,6,9
003 Altrei,52,,2,2,4
003 Altrei,53,,10,2,12
003 Altrei,54,,2,3,5
003 Altrei,55,,4,2,6
003 Altrei,56,,5,4,9
003 Altrei,57,,2,4,6
003 Altrei,58,,1,2,3
003 Altrei,59,,5,1,6
003 Altrei,60,,3,3,6
003 Altrei,61,,2,1,3
003 Altrei,62,,2,2,4
003 Altrei,63,,6,2,8
003 Altrei,64,,4,3,7
003 Altrei,65,,-,3,3
003 Altrei,66,,1,-,1
003 Altrei,67,,2,2,4
003 Altrei,68,,3,2,5
003 Altrei,69,,2,3,5
003 Altrei,70,,3,1,4
003 Altrei,71,,1,3,4
003 Altrei,72,,2,3,5
003 Altrei,73,,3,1,4
003 Altrei,74,,1,3,4
003 Altrei,75,,3,3,6
003 Altrei,76,,2,3,5
003 Altrei,77,,-,1,1
003 Altrei,78,,2,1,3
003 Altrei,79,,4,1,5
003 Altrei,80,,2,1,3
003 Altrei,81,,-,2,2
003 Altrei,82,,2,2,4
003 Altrei,83,,-,2,2
003 Altrei,84,,-,1,1
003 Altrei,85,,-,1,1
003 Altrei,86,,2,2,4
003 Altrei,87,,-,2,2
003 Altrei,88,,1,3,4
003 Altrei,89,,-,1,1
003 Altrei,91,,-,1,1
003 Altrei,93,,-,1,1
003 Altrei,Insgesamt,,199,196,395
004 Eppan a.d. Weinstr.,0,,67,82,149
004 Eppan a.d. Weinstr.,1,,85,76,161
004 Eppan a.d. Weinstr.,2,,78,73,151
004 Eppan a.d. Weinstr.,3,,93,82,175
004 Eppan a.d. Weinstr.,4,,81,83,164
004 Eppan a.d. Weinstr.,5,,79,74,153
004 Eppan a.d. Weinstr.,6,,76,65,141
004 Eppan a.d. Weinstr.,7,,79,100,179
004 Eppan a.d. Weinstr.,8,,78,69,147
004 Eppan a.d. Weinstr.,9,,105,78,183
004 Eppan a.d. Weinstr.,10,,87,110,197
004 Eppan a.d. Weinstr.,11,,90,62,152
004 Eppan a.d. Weinstr.,12,,89,71,160
004 Eppan a.d. Weinstr.,13,,77,76,153
004 Eppan a.d. Weinstr.,14,,78,76,154
004 Eppan a.d. Weinstr.,15,,75,81,156
004 Eppan a.d. Weinstr.,16,,91,66,157
004 Eppan a.d. Weinstr.,17,,84,82,166
004 Eppan a.d. Weinstr.,18,,71,76,147
004 Eppan a.d. Weinstr.,19,,79,80,159
004 Eppan a.d. Weinstr.,20,,73,70,143
004 Eppan a.d. Weinstr.,21,,82,77,159
004 Eppan a.d. Weinstr.,22,,87,96,183
004 Eppan a.d. Weinstr.,23,,75,77,152
004 Eppan a.d. Weinstr.,24,,81,76,157
004 Eppan a.d. Weinstr.,25,,89,71,160
004 Eppan a.d. Weinstr.,26,,86,75,161
004 Eppan a.d. Weinstr.,27,,84,81,165
004 Eppan a.d. Weinstr.,28,,77,78,155
004 Eppan a.d. Weinstr.,29,,95,87,182
004 Eppan a.d. Weinstr.,30,,85,71,156
004 Eppan a.d. Weinstr.,31,,97,97,194
004 Eppan a.d. Weinstr.,32,,80,98,178
004 Eppan a.d. Weinstr.,33,,96,99,195
004 Eppan a.d. Weinstr.,34,,73,96,169
004 Eppan a.d. Weinstr.,35,,91,95,186
004 Eppan a.d. Weinstr.,36,,90,90,180
004 Eppan a.d. Weinstr.,37,,108,101,209
004 Eppan a.d. Weinstr.,38,,101,95,196
004 Eppan a.d. Weinstr.,39,,95,93,188
004 Eppan a.d. Weinstr.,40,,115,110,225
004 Eppan a.d. Weinstr.,41,,103,108,211
004 Eppan a.d. Weinstr.,42,,116,110,226
004 Eppan a.d. Weinstr.,43,,111,130,241
004 Eppan a.d. Weinstr.,44,,129,117,246
004 Eppan a.d. Weinstr.,45,,132,122,254
004 Eppan a.d. Weinstr.,46,,142,127,269
004 Eppan a.d. Weinstr.,47,,122,120,242
004 Eppan a.d. Weinstr.,48,,115,135,250
004 Eppan a.d. Weinstr.,49,,120,143,263
004 Eppan a.d. Weinstr.,50,,110,116,226
004 Eppan a.d. Weinstr.,51,,133,117,250
004 Eppan a.d. Weinstr.,52,,109,118,227
004 Eppan a.d. Weinstr.,53,,129,120,249
004 Eppan a.d. Weinstr.,54,,129,105,234
004 Eppan a.d. Weinstr.,55,,105,128,233
004 Eppan a.d. Weinstr.,56,,109,100,209
004 Eppan a.d. Weinstr.,57,,96,106,202
004 Eppan a.d. Weinstr.,58,,91,93,184
004 Eppan a.d. Weinstr.,59,,89,82,171
004 Eppan a.d. Weinstr.,60,,86,87,173
004 Eppan a.d. Weinstr.,61,,72,95,167
004 Eppan a.d. Weinstr.,62,,90,87,177
004 Eppan a.d. Weinstr.,63,,63,85,148
004 Eppan a.d. Weinstr.,64,,82,65,147
004 Eppan a.d. Weinstr.,65,,65,78,143
004 Eppan a.d. Weinstr.,66,,63,53,116
004 Eppan a.d. Weinstr.,67,,72,72,144
004 Eppan a.d. Weinstr.,68,,58,79,137
004 Eppan a.d. Weinstr.,69,,78,71,149
004 Eppan a.d. Weinstr.,70,,52,52,104
004 Eppan a.d. Weinstr.,71,,64,71,135
004 Eppan a.d. Weinstr.,72,,87,77,164
004 Eppan a.d. Weinstr.,73,,80,75,155
004 Eppan a.d. Weinstr.,74,,50,100,150
004 Eppan a.d. Weinstr.,75,,63,53,116
004 Eppan a.d. Weinstr.,76,,58,79,137
004 Eppan a.d. Weinstr.,77,,41,49,90
004 Eppan a.d. Weinstr.,78,,36,50,86
004 Eppan a.d. Weinstr.,79,,42,38,80
004 Eppan a.d. Weinstr.,80,,26,37,63
004 Eppan a.d. Weinstr.,81,,24,41,65
004 Eppan a.d. Weinstr.,82,,39,46,85
004 Eppan a.d. Weinstr.,83,,36,40,76
004 Eppan a.d. Weinstr.,84,,20,45,65
004 Eppan a.d. Weinstr.,85,,23,50,73
004 Eppan a.d. Weinstr.,86,,16,37,53
004 Eppan a.d. Weinstr.,87,,23,29,52
004 Eppan a.d. Weinstr.,88,,13,34,47
004 Eppan a.d. Weinstr.,89,,13,35,48
004 Eppan a.d. Weinstr.,90,,9,24,33
004 Eppan a.d. Weinstr.,91,,5,25,30
004 Eppan a.d. Weinstr.,92,,4,27,31
004 Eppan a.d. Weinstr.,93,,3,19,22
004 Eppan a.d. Weinstr.,94,,5,13,18
004 Eppan a.d. Weinstr.,95,,4,5,9
004 Eppan a.d. Weinstr.,96,,2,4,6
004 Eppan a.d. Weinstr.,97,,-,4,4
004 Eppan a.d. Weinstr.,98,,-,1,1
004 Eppan a.d. Weinstr.,102,,1,-,1
004 Eppan a.d. Weinstr.,103,,-,1,1
004 Eppan a.d. Weinstr.,104,,-,1,1
004 Eppan a.d. Weinstr.,Insgesamt,,7.260,7.526,14.786
005 Hafling,0,,2,6,8
005 Hafling,1,,6,4,10
005 Hafling,2,,5,8,13
005 Hafling,3,,5,3,8
005 Hafling,4,,2,4,6
005 Hafling,5,,3,4,7
005 Hafling,6,,3,8,11
005 Hafling,7,,5,5,10
005 Hafling,8,,3,2,5
005 Hafling,9,,7,5,12
005 Hafling,10,,3,2,5
005 Hafling,11,,1,7,8
005 Hafling,12,,-,4,4
005 Hafling,13,,6,1,7
005 Hafling,14,,4,3,7
005 Hafling,15,,4,7,11
005 Hafling,16,,6,3,9
005 Hafling,17,,3,7,10
005 Hafling,18,,2,9,11
005 Hafling,19,,12,4,16
005 Hafling,20,,5,4,9
005 Hafling,21,,4,5,9
005 Hafling,22,,3,8,11
005 Hafling,23,,3,4,7
005 Hafling,24,,7,2,9
005 Hafling,25,,4,8,12
005 Hafling,26,,4,2,6
005 Hafling,27,,2,5,7
005 Hafling,28,,3,5,8
005 Hafling,29,,3,1,4
005 Hafling,30,,3,3,6
005 Hafling,31,,2,11,13
005 Hafling,32,,4,1,5
005 Hafling,33,,6,2,8
005 Hafling,34,,5,9,14
005 Hafling,35,,6,11,17
005 Hafling,36,,4,5,9
005 Hafling,37,,5,5,10
005 Hafling,38,,4,6,10
005 Hafling,39,,7,6,13
005 Hafling,40,,7,4,11
005 Hafling,41,,10,6,16
005 Hafling,42,,12,3,15
005 Hafling,43,,8,1,9
005 Hafling,44,,11,6,17
005 Hafling,45,,9,11,20
005 Hafling,46,,6,12,18
005 Hafling,47,,4,10,14
005 Hafling,48,,4,1,5
005 Hafling,49,,11,6,17
005 Hafling,50,,7,11,18
005 Hafling,51,,3,2,5
005 Hafling,52,,7,3,10
005 Hafling,53,,6,4,10
005 Hafling,54,,8,5,13
005 Hafling,55,,10,7,17
005 Hafling,56,,6,5,11
005 Hafling,57,,3,5,8
005 Hafling,58,,2,4,6
005 Hafling,59,,3,8,11
005 Hafling,60,,6,2,8
005 Hafling,61,,3,1,4
005 Hafling,62,,2,3,5
005 Hafling,63,,7,2,9
005 Hafling,64,,2,3,5
005 Hafling,65,,5,5,10
005 Hafling,66,,4,4,8
005 Hafling,67,,6,2,8
005 Hafling,68,,2,2,4
005 Hafling,69,,1,3,4
005 Hafling,70,,2,2,4
005 Hafling,71,,2,2,4
005 Hafling,72,,4,4,8
005 Hafling,73,,5,3,8
005 Hafling,74,,3,4,7
005 Hafling,75,,2,1,3
005 Hafling,76,,4,4,8
005 Hafling,77,,1,1,2
005 Hafling,78,,2,1,3
005 Hafling,79,,-,1,1
005 Hafling,80,,1,2,3
005 Hafling,81,,1,2,3
005 Hafling,82,,4,2,6
005 Hafling,83,,2,2,4
005 Hafling,84,,2,4,6
005 Hafling,85,,1,3,4
005 Hafling,86,,2,1,3
005 Hafling,87,,-,1,1
005 Hafling,88,,-,2,2
005 Hafling,89,,-,2,2
005 Hafling,91,,1,-,1
005 Hafling,93,,-,1,1
005 Hafling,94,,-,1,1
005 Hafling,95,,2,-,2
005 Hafling,98,,-,1,1
005 Hafling,Insgesamt,,382,387,769
006 Abtei,0,,17,20,37
006 Abtei,1,,28,18,46
006 Abtei,2,,13,20,33
006 Abtei,3,,23,14,37
006 Abtei,4,,21,14,35
006 Abtei,5,,24,16,40
006 Abtei,6,,21,19,40
006 Abtei,7,,28,20,48
006 Abtei,8,,28,21,49
006 Abtei,9,,30,21,51
006 Abtei,10,,20,28,48
006 Abtei,11,,29,12,41
006 Abtei,12,,20,19,39
006 Abtei,13,,13,31,44
006 Abtei,14,,24,23,47
006 Abtei,15,,23,31,54
006 Abtei,16,,21,26,47
006 Abtei,17,,13,15,28
006 Abtei,18,,27,22,49
006 Abtei,19,,25,14,39
006 Abtei,20,,24,27,51
006 Abtei,21,,18,14,32
006 Abtei,22,,17,19,36
006 Abtei,23,,24,17,41
006 Abtei,24,,23,14,37
006 Abtei,25,,26,16,42
006 Abtei,26,,13,15,28
006 Abtei,27,,22,13,35
006 Abtei,28,,20,16,36
006 Abtei,29,,20,26,46
006 Abtei,30,,15,13,28
006 Abtei,31,,13,18,31
006 Abtei,32,,14,16,30
006 Abtei,33,,23,13,36
006 Abtei,34,,23,16,39
006 Abtei,35,,26,19,45
006 Abtei,36,,16,26,42
006 Abtei,37,,22,36,58
006 Abtei,38,,27,33,60
006 Abtei,39,,25,27,52
006 Abtei,40,,15,34,49
006 Abtei,41,,20,29,49
006 Abtei,42,,25,22,47
006 Abtei,43,,43,32,75
006 Abtei,44,,17,30,47
006 Abtei,45,,29,37,66
006 Abtei,46,,27,31,58
006 Abtei,47,,29,35,64
006 Abtei,48,,36,36,72
006 Abtei,49,,24,28,52
006 Abtei,50,,34,23,57
006 Abtei,51,,26,34,60
006 Abtei,52,,30,29,59
006 Abtei,53,,26,29,55
006 Abtei,54,,26,26,52
006 Abtei,55,,27,26,53
006 Abtei,56,,29,23,52
006 Abtei,57,,18,23,41
006 Abtei,58,,17,15,32
006 Abtei,59,,21,18,39
006 Abtei,60,,18,15,33
006 Abtei,61,,11,15,26
006 Abtei,62,,14,20,34
006 Abtei,63,,10,14,24
006 Abtei,64,,11,11,22
006 Abtei,65,,12,20,32
006 Abtei,66,,10,18,28
006 Abtei,67,,21,17,38
006 Abtei,68,,15,15,30
006 Abtei,69,,22,17,39
006 Abtei,70,,16,19,35
006 Abtei,71,,11,14,25
006 Abtei,72,,10,12,22
006 Abtei,73,,19,11,30
006 Abtei,74,,14,20,34
006 Abtei,75,,14,16,30
006 Abtei,76,,13,12,25
006 Abtei,77,,14,16,30
006 Abtei,78,,5,16,21
006 Abtei,79,,13,9,22
006 Abtei,80,,7,16,23
006 Abtei,81,,10,12,22
006 Abtei,82,,5,14,19
006 Abtei,83,,4,3,7
006 Abtei,84,,7,8,15
006 Abtei,85,,11,9,20
006 Abtei,86,,4,5,9
006 Abtei,87,,2,8,10
006 Abtei,88,,4,6,10
006 Abtei,89,,2,2,4
006 Abtei,90,,3,3,6
006 Abtei,91,,4,7,11
006 Abtei,92,,-,2,2
006 Abtei,93,,3,2,5
006 Abtei,95,,-,3,3
006 Abtei,97,,-,2,2
006 Abtei,99,,-,2,2
006 Abtei,101,,-,1,1
006 Abtei,Insgesamt,,1.717,1.770,3.487
007 Barbian,0,,9,11,20
007 Barbian,1,,13,15,28
007 Barbian,2,,8,12,20
007 Barbian,3,,10,10,20
007 Barbian,4,,13,9,22
007 Barbian,5,,8,7,15
007 Barbian,6,,8,13,21
007 Barbian,7,,12,5,17
007 Barbian,8,,7,12,19
007 Barbian,9,,6,3,9
007 Barbian,10,,15,7,22
007 Barbian,11,,6,6,12
007 Barbian,12,,8,16,24
007 Barbian,13,,6,8,14
007 Barbian,14,,13,16,29
007 Barbian,15,,15,8,23
007 Barbian,16,,11,11,22
007 Barbian,17,,15,9,24
007 Barbian,18,,9,11,20
007 Barbian,19,,11,10,21
007 Barbian,20,,12,9,21
007 Barbian,21,,8,4,12
007 Barbian,22,,9,11,20
007 Barbian,23,,15,8,23
007 Barbian,24,,11,13,24
007 Barbian,25,,16,12,28
007 Barbian,26,,8,13,21
007 Barbian,27,,13,5,18
007 Barbian,28,,6,9,15
007 Barbian,29,,14,12,26
007 Barbian,30,,6,9,15
007 Barbian,31,,11,6,17
007 Barbian,32,,10,14,24
007 Barbian,33,,8,16,24
007 Barbian,34,,12,15,27
007 Barbian,35,,14,5,19
007 Barbian,36,,16,8,24
007 Barbian,37,,12,9,21
007 Barbian,38,,12,18,30
007 Barbian,39,,8,14,22
007 Barbian,40,,9,11,20
007 Barbian,41,,14,11,25
007 Barbian,42,,15,20,35
007 Barbian,43,,13,15,28
007 Barbian,44,,17,9,26
007 Barbian,45,,13,13,26
007 Barbian,46,,15,7,22
007 Barbian,47,,14,10,24
007 Barbian,48,,10,9,19
007 Barbian,49,,10,12,22
007 Barbian,50,,9,13,22
007 Barbian,51,,16,17,33
007 Barbian,52,,14,15,29
007 Barbian,53,,15,14,29
007 Barbian,54,,16,11,27
007 Barbian,55,,13,15,28
007 Barbian,56,,10,8,18
007 Barbian,57,,7,9,16
007 Barbian,58,,15,6,21
007 Barbian,59,,6,9,15
007 Barbian,60,,7,8,15
007 Barbian,61,,6,15,21
007 Barbian,62,,7,11,18
007 Barbian,63,,6,5,11
007 Barbian,64,,10,8,18
007 Barbian,65,,11,11,22
007 Barbian,66,,5,6,11
007 Barbian,67,,3,5,8
007 Barbian,68,,5,8,13
007 Barbian,69,,16,6,22
007 Barbian,70,,3,7,10
007 Barbian,71,,9,9,18
007 Barbian,72,,9,6,15
007 Barbian,73,,11,10,21
007 Barbian,74,,8,12,20
007 Barbian,75,,9,3,12
007 Barbian,76,,5,3,8
007 Barbian,77,,5,9,14
007 Barbian,78,,8,9,17
007 Barbian,79,,3,3,6
007 Barbian,80,,2,5,7
007 Barbian,81,,5,5,10
007 Barbian,82,,5,3,8
007 Barbian,83,,5,6,11
007 Barbian,84,,1,6,7
007 Barbian,85,,1,3,4
007 Barbian,86,,2,5,7
007 Barbian,87,,3,4,7
007 Barbian,88,,2,-,2
007 Barbian,89,,1,1,2
007 Barbian,90,,2,-,2
007 Barbian,91,,-,1,1
007 Barbian,92,,-,1,1
007 Barbian,93,,-,1,1
007 Barbian,94,,-,1,1
007 Barbian,97,,1,-,1
007 Barbian,Insgesamt,,851,839,1.690
008 Bozen,0,,478,477,955
008 Bozen,1,,505,514,1.019
008 Bozen,2,,506,482,988
008 Bozen,3,,518,481,999
008 Bozen,4,,497,504,1.001
008 Bozen,5,,516,500,1.016
008 Bozen,6,,543,480,1.023
008 Bozen,7,,542,522,1.064
008 Bozen,8,,574,494,1.068
008 Bozen,9,,507,515,1.022
008 Bozen,10,,563,508,1.071
008 Bozen,11,,569,518,1.087
008 Bozen,12,,554,531,1.085
008 Bozen,13,,559,483,1.042
008 Bozen,14,,551,487,1.038
008 Bozen,15,,491,527,1.018
008 Bozen,16,,550,510,1.060
008 Bozen,17,,538,492,1.030
008 Bozen,18,,531,464,995
008 Bozen,19,,521,510,1.031
008 Bozen,20,,516,479,995
008 Bozen,21,,561,514,1.075
008 Bozen,22,,505,507,1.012
008 Bozen,23,,564,476,1.040
008 Bozen,24,,591,514,1.105
008 Bozen,25,,593,523,1.116
008 Bozen,26,,560,549,1.109
008 Bozen,27,,585,570,1.155
008 Bozen,28,,510,555,1.065
008 Bozen,29,,572,561,1.133
008 Bozen,30,,605,568,1.173
008 Bozen,31,,579,617,1.196
008 Bozen,32,,635,551,1.186
008 Bozen,33,,622,593,1.215
008 Bozen,34,,612,588,1.200
008 Bozen,35,,648,624,1.272
008 Bozen,36,,614,632,1.246
008 Bozen,37,,641,666,1.307
008 Bozen,38,,660,672,1.332
008 Bozen,39,,675,713,1.388
008 Bozen,40,,720,754,1.474
008 Bozen,41,,773,793,1.566
008 Bozen,42,,772,838,1.610
008 Bozen,43,,830,870,1.700
008 Bozen,44,,859,918,1.777
008 Bozen,45,,832,855,1.687
008 Bozen,46,,911,888,1.799
008 Bozen,47,,840,818,1.658
008 Bozen,48,,786,900,1.686
008 Bozen,49,,877,920,1.797
008 Bozen,50,,917,925,1.842
008 Bozen,51,,898,922,1.820
008 Bozen,52,,759,879,1.638
008 Bozen,53,,753,814,1.567
008 Bozen,54,,753,756,1.509
008 Bozen,55,,685,743,1.428
008 Bozen,56,,682,720,1.402
008 Bozen,57,,675,720,1.395
008 Bozen,58,,603,731,1.334
008 Bozen,59,,602,683,1.285
008 Bozen,60,,575,647,1.222
008 Bozen,61,,569,607,1.176
008 Bozen,62,,511,613,1.124
008 Bozen,63,,496,636,1.132
008 Bozen,64,,505,612,1.117
008 Bozen,65,,499,658,1.157
008 Bozen,66,,530,626,1.156
008 Bozen,67,,578,694,1.272
008 Bozen,68,,550,767,1.317
008 Bozen,69,,611,830,1.441
008 Bozen,70,,462,548,1.010
008 Bozen,71,,499,680,1.179
008 Bozen,72,,527,681,1.208
008 Bozen,73,,550,658,1.208
008 Bozen,74,,588,698,1.286
008 Bozen,75,,548,667,1.215
008 Bozen,76,,491,653,1.144
008 Bozen,77,,485,592,1.077
008 Bozen,78,,422,505,927
008 Bozen,79,,358,492,850
008 Bozen,80,,346,495,841
008 Bozen,81,,349,482,831
008 Bozen,82,,287,461,748
008 Bozen,83,,280,429,709
008 Bozen,84,,261,410,671
008 Bozen,85,,242,381,623
008 Bozen,86,,146,340,486
008 Bozen,87,,176,309,485
008 Bozen,88,,136,285,421
008 Bozen,89,,138,243,381
008 Bozen,90,,93,225,318
008 Bozen,91,,74,190,264
008 Bozen,92,,59,186,245
008 Bozen,93,,42,156,198
008 Bozen,94,,40,118,158
008 Bozen,95,,22,97,119
008 Bozen,96,,6,57,63
008 Bozen,97,,5,24,29
008 Bozen,98,,4,14,18
008 Bozen,99,,2,16,18
008 Bozen,100,,-,12,12
008 Bozen,101,,2,8,10
008 Bozen,102,,-,4,4
008 Bozen,103,,2,4,6
008 Bozen,104,,-,4,4
008 Bozen,Insgesamt,,51.054,55.732,106.786
009 Prags,0,,4,2,6
009 Prags,1,,3,3,6
009 Prags,2,,3,-,3
009 Prags,3,,2,1,3
009 Prags,4,,5,2,7
009 Prags,5,,3,4,7
009 Prags,6,,1,2,3
009 Prags,7,,4,6,10
009 Prags,8,,3,6,9
009 Prags,9,,4,2,6
009 Prags,10,,3,1,4
009 Prags,11,,2,3,5
009 Prags,12,,2,5,7
009 Prags,13,,2,6,8
009 Prags,14,,8,5,13
009 Prags,15,,2,3,5
009 Prags,16,,5,9,14
009 Prags,17,,1,4,5
009 Prags,18,,3,5,8
009 Prags,19,,3,7,10
009 Prags,20,,3,1,4
009 Prags,21,,4,5,9
009 Prags,22,,7,2,9
009 Prags,23,,7,2,9
009 Prags,24,,7,2,9
009 Prags,25,,3,2,5
009 Prags,26,,7,3,10
009 Prags,27,,2,4,6
009 Prags,28,,3,3,6
009 Prags,29,,5,5,10
009 Prags,30,,7,2,9
009 Prags,31,,4,3,7
009 Prags,32,,3,3,6
009 Prags,33,,3,5,8
009 Prags,34,,2,7,9
009 Prags,35,,5,1,6
009 Prags,36,,2,3,5
009 Prags,37,,5,6,11
009 Prags,38,,3,2,5
009 Prags,39,,5,3,8
009 Prags,40,,3,4,7
009 Prags,41,,1,5,6
009 Prags,42,,8,3,11
009 Prags,43,,3,3,6
009 Prags,44,,5,4,9
009 Prags,45,,6,6,12
009 Prags,46,,9,4,13
009 Prags,47,,8,9,17
009 Prags,48,,7,6,13
009 Prags,49,,8,5,13
009 Prags,50,,7,6,13
009 Prags,51,,5,3,8
009 Prags,52,,7,5,12
009 Prags,53,,3,5,8
009 Prags,54,,5,13,18
009 Prags,55,,5,3,8
009 Prags,56,,11,5,16
009 Prags,57,,4,2,6
009 Prags,58,,6,4,10
009 Prags,59,,1,6,7
009 Prags,60,,4,5,9
009 Prags,61,,6,4,10
009 Prags,62,,3,-,3
009 Prags,63,,2,5,7
009 Prags,64,,3,1,4
009 Prags,65,,4,1,5
009 Prags,66,,1,1,2
009 Prags,67,,3,1,4
009 Prags,68,,1,-,1
009 Prags,69,,2,4,6
009 Prags,70,,2,2,4
009 Prags,71,,4,4,8
009 Prags,72,,1,3,4
009 Prags,73,,4,4,8
009 Prags,74,,5,3,8
009 Prags,75,,1,3,4
009 Prags,76,,3,4,7
009 Prags,77,,2,2,4
009 Prags,78,,-,2,2
009 Prags,79,,1,3,4
009 Prags,80,,1,3,4
009 Prags,81,,1,2,3
009 Prags,82,,3,1,4
009 Prags,83,,1,4,5
009 Prags,84,,-,3,3
009 Prags,86,,1,1,2
009 Prags,87,,-,2,2
009 Prags,88,,1,3,4
009 Prags,89,,1,4,5
009 Prags,90,,-,3,3
009 Prags,91,,2,1,3
009 Prags,92,,-,2,2
009 Prags,93,,1,1,2
009 Prags,94,,1,1,2
009 Prags,96,,-,1,1
009 Prags,Insgesamt,,327,325,652
010 Brenner,0,,11,10,21
010 Brenner,1,,9,13,22
010 Brenner,2,,15,8,23
010 Brenner,3,,8,5,13
010 Brenner,4,,9,19,28
010 Brenner,5,,11,17,28
010 Brenner,6,,12,8,20
010 Brenner,7,,9,17,26
010 Brenner,8,,12,10,22
010 Brenner,9,,6,13,19
010 Brenner,10,,13,12,25
010 Brenner,11,,11,16,27
010 Brenner,12,,11,9,20
010 Brenner,13,,14,14,28
010 Brenner,14,,7,7,14
010 Brenner,15,,19,13,32
010 Brenner,16,,10,14,24
010 Brenner,17,,15,9,24
010 Brenner,18,,18,7,25
010 Brenner,19,,7,14,21
010 Brenner,20,,7,13,20
010 Brenner,21,,23,14,37
010 Brenner,22,,14,5,19
010 Brenner,23,,15,12,27
010 Brenner,24,,13,19,32
010 Brenner,25,,15,11,26
010 Brenner,26,,16,7,23
010 Brenner,27,,18,12,30
010 Brenner,28,,12,14,26
010 Brenner,29,,13,14,27
010 Brenner,30,,20,9,29
010 Brenner,31,,16,16,32
010 Brenner,32,,14,13,27
010 Brenner,33,,17,11,28
010 Brenner,34,,15,17,32
010 Brenner,35,,13,15,28
010 Brenner,36,,13,14,27
010 Brenner,37,,17,10,27
010 Brenner,38,,22,13,35
010 Brenner,39,,12,7,19
010 Brenner,40,,17,22,39
010 Brenner,41,,16,10,26
010 Brenner,42,,15,9,24
010 Brenner,43,,17,26,43
010 Brenner,44,,22,14,36
010 Brenner,45,,17,13,30
010 Brenner,46,,14,17,31
010 Brenner,47,,12,18,30
010 Brenner,48,,19,16,35
010 Brenner,49,,18,17,35
010 Brenner,50,,22,17,39
010 Brenner,51,,24,14,38
010 Brenner,52,,12,19,31
010 Brenner,53,,16,12,28
010 Brenner,54,,18,12,30
010 Brenner,55,,21,16,37
010 Brenner,56,,12,14,26
010 Brenner,57,,15,10,25
010 Brenner,58,,14,17,31
010 Brenner,59,,18,15,33
010 Brenner,60,,12,9,21
010 Brenner,61,,9,14,23
010 Brenner,62,,8,14,22
010 Brenner,63,,18,7,25
010 Brenner,64,,12,13,25
010 Brenner,65,,10,12,22
010 Brenner,66,,14,12,26
010 Brenner,67,,7,8,15
010 Brenner,68,,19,10,29
010 Brenner,69,,9,16,25
010 Brenner,70,,5,7,12
010 Brenner,71,,15,12,27
010 Brenner,72,,14,12,26
010 Brenner,73,,7,11,18
010 Brenner,74,,9,11,20
010 Brenner,75,,9,11,20
010 Brenner,76,,6,10,16
010 Brenner,77,,8,13,21
010 Brenner,78,,7,12,19
010 Brenner,79,,8,6,14
010 Brenner,80,,2,5,7
010 Brenner,81,,7,5,12
010 Brenner,82,,3,4,7
010 Brenner,83,,-,3,3
010 Brenner,84,,5,7,12
010 Brenner,85,,6,8,14
010 Brenner,86,,4,5,9
010 Brenner,87,,5,4,9
010 Brenner,88,,4,2,6
010 Brenner,89,,2,2,4
010 Brenner,90,,2,3,5
010 Brenner,91,,1,3,4
010 Brenner,92,,1,3,4
010 Brenner,93,,-,2,2
010 Brenner,94,,-,1,1
010 Brenner,95,,-,2,2
010 Brenner,Insgesamt,,1.119,1.068,2.187
011 Brixen,0,,115,127,242
011 Brixen,1,,112,113,225
011 Brixen,2,,100,114,214
011 Brixen,3,,115,110,225
011 Brixen,4,,101,96,197
011 Brixen,5,,132,124,256
011 Brixen,6,,140,128,268
011 Brixen,7,,116,110,226
011 Brixen,8,,135,108,243
011 Brixen,9,,135,104,239
011 Brixen,10,,133,123,256
011 Brixen,11,,129,122,251
011 Brixen,12,,112,118,230
011 Brixen,13,,126,119,245
011 Brixen,14,,130,124,254
011 Brixen,15,,129,107,236
011 Brixen,16,,146,127,273
011 Brixen,17,,118,136,254
011 Brixen,18,,125,106,231
011 Brixen,19,,127,121,248
011 Brixen,20,,121,129,250
011 Brixen,21,,135,135,270
011 Brixen,22,,121,118,239
011 Brixen,23,,124,126,250
011 Brixen,24,,128,116,244
011 Brixen,25,,105,115,220
011 Brixen,26,,131,99,230
011 Brixen,27,,131,114,245
011 Brixen,28,,117,124,241
011 Brixen,29,,101,131,232
011 Brixen,30,,138,102,240
011 Brixen,31,,121,130,251
011 Brixen,32,,135,154,289
011 Brixen,33,,122,122,244
011 Brixen,34,,141,130,271
011 Brixen,35,,123,138,261
011 Brixen,36,,155,133,288
011 Brixen,37,,115,141,256
011 Brixen,38,,148,145,293
011 Brixen,39,,148,168,316
011 Brixen,40,,141,142,283
011 Brixen,41,,140,173,313
011 Brixen,42,,162,167,329
011 Brixen,43,,166,181,347
011 Brixen,44,,164,172,336
011 Brixen,45,,176,170,346
011 Brixen,46,,197,204,401
011 Brixen,47,,183,199,382
011 Brixen,48,,186,168,354
011 Brixen,49,,176,197,373
011 Brixen,50,,186,172,358
011 Brixen,51,,175,190,365
011 Brixen,52,,150,176,326
011 Brixen,53,,164,166,330
011 Brixen,54,,135,173,308
011 Brixen,55,,139,149,288
011 Brixen,56,,143,150,293
011 Brixen,57,,143,123,266
011 Brixen,58,,132,142,274
011 Brixen,59,,113,144,257
011 Brixen,60,,127,101,228
011 Brixen,61,,86,116,202
011 Brixen,62,,81,110,191
011 Brixen,63,,103,108,211
011 Brixen,64,,95,110,205
011 Brixen,65,,116,107,223
011 Brixen,66,,77,134,211
011 Brixen,67,,101,119,220
011 Brixen,68,,85,112,197
011 Brixen,69,,97,100,197
011 Brixen,70,,61,96,157
011 Brixen,71,,110,117,227
011 Brixen,72,,116,108,224
011 Brixen,73,,85,101,186
011 Brixen,74,,96,114,210
011 Brixen,75,,75,108,183
011 Brixen,76,,80,93,173
011 Brixen,77,,70,85,155
011 Brixen,78,,70,90,160
011 Brixen,79,,52,86,138
011 Brixen,80,,61,77,138
011 Brixen,81,,54,80,134
011 Brixen,82,,50,64,114
011 Brixen,83,,50,66,116
011 Brixen,84,,48,64,112
011 Brixen,85,,32,65,97
011 Brixen,86,,27,54,81
011 Brixen,87,,30,47,77
011 Brixen,88,,16,60,76
011 Brixen,89,,18,37,55
011 Brixen,90,,17,43,60
011 Brixen,91,,11,35,46
011 Brixen,92,,11,25,36
011 Brixen,93,,5,25,30
011 Brixen,94,,5,19,24
011 Brixen,95,,3,15,18
011 Brixen,96,,2,6,8
011 Brixen,97,,2,3,5
011 Brixen,98,,-,3,3
011 Brixen,99,,1,2,3
011 Brixen,102,,1,-,1
011 Brixen,103,,-,1,1
011 Brixen,104,,-,1,1
011 Brixen,Insgesamt,,10.434,11.172,21.606
012 Branzoll,0,,22,15,37
012 Branzoll,1,,19,11,30
012 Branzoll,2,,12,16,28
012 Branzoll,3,,14,17,31
012 Branzoll,4,,16,10,26
012 Branzoll,5,,13,22,35
012 Branzoll,6,,14,18,32
012 Branzoll,7,,17,12,29
012 Branzoll,8,,11,16,27
012 Branzoll,9,,12,10,22
012 Branzoll,10,,11,9,20
012 Branzoll,11,,16,15,31
012 Branzoll,12,,16,22,38
012 Branzoll,13,,14,11,25
012 Branzoll,14,,8,12,20
012 Branzoll,15,,21,7,28
012 Branzoll,16,,10,12,22
012 Branzoll,17,,14,5,19
012 Branzoll,18,,16,22,38
012 Branzoll,19,,16,8,24
012 Branzoll,20,,13,19,32
012 Branzoll,21,,17,11,28
012 Branzoll,22,,22,15,37
012 Branzoll,23,,14,16,30
012 Branzoll,24,,16,19,35
012 Branzoll,25,,17,18,35
012 Branzoll,26,,12,15,27
012 Branzoll,27,,15,15,30
012 Branzoll,28,,19,17,36
012 Branzoll,29,,19,13,32
012 Branzoll,30,,20,17,37
012 Branzoll,31,,17,17,34
012 Branzoll,32,,16,19,35
012 Branzoll,33,,22,16,38
012 Branzoll,34,,16,15,31
012 Branzoll,35,,13,15,28
012 Branzoll,36,,14,11,25
012 Branzoll,37,,16,22,38
012 Branzoll,38,,11,21,32
012 Branzoll,39,,21,18,39
012 Branzoll,40,,20,16,36
012 Branzoll,41,,26,26,52
012 Branzoll,42,,23,15,38
012 Branzoll,43,,26,19,45
012 Branzoll,44,,23,26,49
012 Branzoll,45,,19,18,37
012 Branzoll,46,,26,29,55
012 Branzoll,47,,22,23,45
012 Branzoll,48,,23,20,43
012 Branzoll,49,,20,19,39
012 Branzoll,50,,25,23,48
012 Branzoll,51,,28,26,54
012 Branzoll,52,,20,20,40
012 Branzoll,53,,16,17,33
012 Branzoll,54,,24,29,53
012 Branzoll,55,,27,20,47
012 Branzoll,56,,18,21,39
012 Branzoll,57,,20,16,36
012 Branzoll,58,,19,13,32
012 Branzoll,59,,14,18,32
012 Branzoll,60,,16,18,34
012 Branzoll,61,,20,19,39
012 Branzoll,62,,12,20,32
012 Branzoll,63,,14,20,34
012 Branzoll,64,,12,16,28
012 Branzoll,65,,17,14,31
012 Branzoll,66,,14,16,30
012 Branzoll,67,,14,15,29
012 Branzoll,68,,17,17,34
012 Branzoll,69,,14,17,31
012 Branzoll,70,,9,7,16
012 Branzoll,71,,10,11,21
012 Branzoll,72,,14,11,25
012 Branzoll,73,,18,12,30
012 Branzoll,74,,19,12,31
012 Branzoll,75,,8,14,22
012 Branzoll,76,,13,14,27
012 Branzoll,77,,9,8,17
012 Branzoll,78,,3,8,11
012 Branzoll,79,,6,8,14
012 Branzoll,80,,8,8,16
012 Branzoll,81,,5,7,12
012 Branzoll,82,,15,10,25
012 Branzoll,83,,7,6,13
012 Branzoll,84,,1,9,10
012 Branzoll,85,,5,11,16
012 Branzoll,86,,2,9,11
012 Branzoll,87,,3,5,8
012 Branzoll,88,,2,3,5
012 Branzoll,89,,2,5,7
012 Branzoll,90,,1,3,4
012 Branzoll,91,,1,4,5
012 Branzoll,92,,1,5,6
012 Branzoll,93,,-,1,1
012 Branzoll,94,,-,3,3
012 Branzoll,95,,1,1,2
012 Branzoll,Insgesamt,,1.374,1.380,2.754
013 Bruneck,0,,90,63,153
013 Bruneck,1,,85,95,180
013 Bruneck,2,,85,70,155
013 Bruneck,3,,96,74,170
013 Bruneck,4,,83,64,147
013 Bruneck,5,,83,77,160
013 Bruneck,6,,102,67,169
013 Bruneck,7,,80,66,146
013 Bruneck,8,,88,72,160
013 Bruneck,9,,97,74,171
013 Bruneck,10,,91,86,177
013 Bruneck,11,,88,102,190
013 Bruneck,12,,98,83,181
013 Bruneck,13,,80,91,171
013 Bruneck,14,,100,80,180
013 Bruneck,15,,87,92,179
013 Bruneck,16,,95,97,192
013 Bruneck,17,,103,90,193
013 Bruneck,18,,118,76,194
013 Bruneck,19,,86,106,192
013 Bruneck,20,,71,85,156
013 Bruneck,21,,91,89,180
013 Bruneck,22,,93,80,173
013 Bruneck,23,,111,87,198
013 Bruneck,24,,93,77,170
013 Bruneck,25,,102,85,187
013 Bruneck,26,,87,94,181
013 Bruneck,27,,83,77,160
013 Bruneck,28,,69,85,154
013 Bruneck,29,,120,81,201
013 Bruneck,30,,87,93,180
013 Bruneck,31,,93,94,187
013 Bruneck,32,,97,93,190
013 Bruneck,33,,109,108,217
013 Bruneck,34,,99,116,215
013 Bruneck,35,,106,108,214
013 Bruneck,36,,95,101,196
013 Bruneck,37,,120,126,246
013 Bruneck,38,,117,113,230
013 Bruneck,39,,105,136,241
013 Bruneck,40,,122,122,244
013 Bruneck,41,,140,112,252
013 Bruneck,42,,138,123,261
013 Bruneck,43,,119,131,250
013 Bruneck,44,,136,112,248
013 Bruneck,45,,116,146,262
013 Bruneck,46,,135,123,258
013 Bruneck,47,,123,143,266
013 Bruneck,48,,128,137,265
013 Bruneck,49,,131,132,263
013 Bruneck,50,,159,153,312
013 Bruneck,51,,137,140,277
013 Bruneck,52,,142,112,254
013 Bruneck,53,,129,120,249
013 Bruneck,54,,122,103,225
013 Bruneck,55,,109,120,229
013 Bruneck,56,,108,108,216
013 Bruneck,57,,103,115,218
013 Bruneck,58,,85,98,183
013 Bruneck,59,,90,91,181
013 Bruneck,60,,74,78,152
013 Bruneck,61,,87,83,170
013 Bruneck,62,,76,99,175
013 Bruneck,63,,87,99,186
013 Bruneck,64,,64,102,166
013 Bruneck,65,,76,97,173
013 Bruneck,66,,80,87,167
013 Bruneck,67,,74,108,182
013 Bruneck,68,,92,71,163
013 Bruneck,69,,95,84,179
013 Bruneck,70,,62,66,128
013 Bruneck,71,,79,91,170
013 Bruneck,72,,97,83,180
013 Bruneck,73,,77,83,160
013 Bruneck,74,,69,87,156
013 Bruneck,75,,61,82,143
013 Bruneck,76,,68,89,157
013 Bruneck,77,,52,49,101
013 Bruneck,78,,48,52,100
013 Bruneck,79,,40,52,92
013 Bruneck,80,,37,49,86
013 Bruneck,81,,24,48,72
013 Bruneck,82,,37,52,89
013 Bruneck,83,,33,44,77
013 Bruneck,84,,27,37,64
013 Bruneck,85,,21,45,66
013 Bruneck,86,,17,38,55
013 Bruneck,87,,15,43,58
013 Bruneck,88,,17,22,39
013 Bruneck,89,,13,20,33
013 Bruneck,90,,10,24,34
013 Bruneck,91,,2,24,26
013 Bruneck,92,,6,15,21
013 Bruneck,93,,8,12,20
013 Bruneck,94,,1,9,10
013 Bruneck,95,,1,9,10
013 Bruneck,96,,3,3,6
013 Bruneck,97,,-,1,1
013 Bruneck,98,,1,3,4
013 Bruneck,99,,-,2,2
013 Bruneck,102,,-,1,1
013 Bruneck,103,,-,1,1
013 Bruneck,Insgesamt,,7.986,8.138,16.124
014 Kuens,0,,1,1,2
014 Kuens,1,,1,1,2
014 Kuens,2,,3,5,8
014 Kuens,3,,1,1,2
014 Kuens,4,,2,5,7
014 Kuens,5,,1,2,3
014 Kuens,6,,4,3,7
014 Kuens,7,,4,3,7
014 Kuens,8,,2,4,6
014 Kuens,9,,1,1,2
014 Kuens,10,,6,2,8
014 Kuens,11,,-,3,3
014 Kuens,12,,5,4,9
014 Kuens,13,,2,1,3
014 Kuens,14,,5,2,7
014 Kuens,15,,2,6,8
014 Kuens,16,,1,3,4
014 Kuens,17,,2,6,8
014 Kuens,18,,1,1,2
014 Kuens,19,,5,2,7
014 Kuens,20,,2,3,5
014 Kuens,21,,1,4,5
014 Kuens,22,,3,2,5
014 Kuens,23,,4,2,6
014 Kuens,24,,2,2,4
014 Kuens,25,,3,3,6
014 Kuens,26,,3,1,4
014 Kuens,27,,1,2,3
014 Kuens,28,,1,-,1
014 Kuens,29,,1,-,1
014 Kuens,30,,1,3,4
014 Kuens,31,,1,1,2
014 Kuens,32,,1,1,2
014 Kuens,33,,2,1,3
014 Kuens,34,,1,4,5
014 Kuens,35,,5,4,9
014 Kuens,36,,1,2,3
014 Kuens,37,,3,1,4
014 Kuens,38,,2,1,3
014 Kuens,39,,3,1,4
014 Kuens,40,,3,6,9
014 Kuens,41,,3,5,8
014 Kuens,42,,2,4,6
014 Kuens,43,,6,1,7
014 Kuens,44,,2,3,5
014 Kuens,45,,7,5,12
014 Kuens,46,,4,1,5
014 Kuens,47,,4,4,8
014 Kuens,48,,6,10,16
014 Kuens,49,,1,6,7
014 Kuens,50,,7,1,8
014 Kuens,51,,5,6,11
014 Kuens,52,,9,2,11
014 Kuens,53,,5,1,6
014 Kuens,54,,-,5,5
014 Kuens,56,,1,-,1
014 Kuens,57,,-,4,4
014 Kuens,58,,3,-,3
014 Kuens,59,,2,-,2
014 Kuens,60,,1,2,3
014 Kuens,61,,-,1,1
014 Kuens,62,,2,-,2
014 Kuens,63,,1,4,5
014 Kuens,65,,-,3,3
014 Kuens,66,,-,2,2
014 Kuens,67,,3,1,4
014 Kuens,68,,1,2,3
014 Kuens,69,,1,2,3
014 Kuens,70,,3,1,4
014 Kuens,72,,-,2,2
014 Kuens,73,,1,3,4
014 Kuens,74,,-,2,2
014 Kuens,75,,-,1,1
014 Kuens,76,,4,2,6
014 Kuens,77,,3,2,5
014 Kuens,78,,1,3,4
014 Kuens,79,,1,2,3
014 Kuens,80,,1,2,3
014 Kuens,81,,-,1,1
014 Kuens,82,,-,1,1
014 Kuens,83,,3,2,5
014 Kuens,84,,2,2,4
014 Kuens,85,,2,1,3
014 Kuens,87,,1,-,1
014 Kuens,88,,1,-,1
014 Kuens,89,,1,-,1
014 Kuens,93,,-,1,1
014 Kuens,Insgesamt,,193,203,396
015 Kaltern a.d. Weinstr.,0,,44,34,78
015 Kaltern a.d. Weinstr.,1,,50,52,102
015 Kaltern a.d. Weinstr.,2,,45,52,97
015 Kaltern a.d. Weinstr.,3,,55,36,91
015 Kaltern a.d. Weinstr.,4,,43,50,93
015 Kaltern a.d. Weinstr.,5,,50,34,84
015 Kaltern a.d. Weinstr.,6,,48,29,77
015 Kaltern a.d. Weinstr.,7,,43,41,84
015 Kaltern a.d. Weinstr.,8,,42,37,79
015 Kaltern a.d. Weinstr.,9,,44,43,87
015 Kaltern a.d. Weinstr.,10,,44,44,88
015 Kaltern a.d. Weinstr.,11,,43,48,91
015 Kaltern a.d. Weinstr.,12,,44,38,82
015 Kaltern a.d. Weinstr.,13,,39,35,74
015 Kaltern a.d. Weinstr.,14,,31,52,83
015 Kaltern a.d. Weinstr.,15,,33,37,70
015 Kaltern a.d. Weinstr.,16,,47,39,86
015 Kaltern a.d. Weinstr.,17,,41,45,86
015 Kaltern a.d. Weinstr.,18,,45,44,89
015 Kaltern a.d. Weinstr.,19,,43,43,86
015 Kaltern a.d. Weinstr.,20,,45,40,85
015 Kaltern a.d. Weinstr.,21,,28,40,68
015 Kaltern a.d. Weinstr.,22,,34,38,72
015 Kaltern a.d. Weinstr.,23,,40,42,82
015 Kaltern a.d. Weinstr.,24,,43,42,85
015 Kaltern a.d. Weinstr.,25,,41,44,85
015 Kaltern a.d. Weinstr.,26,,60,37,97
015 Kaltern a.d. Weinstr.,27,,46,44,90
015 Kaltern a.d. Weinstr.,28,,40,38,78
015 Kaltern a.d. Weinstr.,29,,56,45,101
015 Kaltern a.d. Weinstr.,30,,56,39,95
015 Kaltern a.d. Weinstr.,31,,42,53,95
015 Kaltern a.d. Weinstr.,32,,48,59,107
015 Kaltern a.d. Weinstr.,33,,57,57,114
015 Kaltern a.d. Weinstr.,34,,50,50,100
015 Kaltern a.d. Weinstr.,35,,50,62,112
015 Kaltern a.d. Weinstr.,36,,51,46,97
015 Kaltern a.d. Weinstr.,37,,60,46,106
015 Kaltern a.d. Weinstr.,38,,45,61,106
015 Kaltern a.d. Weinstr.,39,,53,53,106
015 Kaltern a.d. Weinstr.,40,,49,64,113
015 Kaltern a.d. Weinstr.,41,,56,54,110
015 Kaltern a.d. Weinstr.,42,,41,54,95
015 Kaltern a.d. Weinstr.,43,,63,70,133
015 Kaltern a.d. Weinstr.,44,,64,64,128
015 Kaltern a.d. Weinstr.,45,,62,63,125
015 Kaltern a.d. Weinstr.,46,,58,65,123
015 Kaltern a.d. Weinstr.,47,,80,72,152
015 Kaltern a.d. Weinstr.,48,,64,65,129
015 Kaltern a.d. Weinstr.,49,,63,69,132
015 Kaltern a.d. Weinstr.,50,,59,64,123
015 Kaltern a.d. Weinstr.,51,,86,53,139
015 Kaltern a.d. Weinstr.,52,,51,61,112
015 Kaltern a.d. Weinstr.,53,,55,59,114
015 Kaltern a.d. Weinstr.,54,,68,69,137
015 Kaltern a.d. Weinstr.,55,,51,67,118
015 Kaltern a.d. Weinstr.,56,,53,58,111
015 Kaltern a.d. Weinstr.,57,,54,66,120
015 Kaltern a.d. Weinstr.,58,,49,62,111
015 Kaltern a.d. Weinstr.,59,,59,42,101
015 Kaltern a.d. Weinstr.,60,,51,43,94
015 Kaltern a.d. Weinstr.,61,,38,48,86
015 Kaltern a.d. Weinstr.,62,,36,36,72
015 Kaltern a.d. Weinstr.,63,,40,56,96
015 Kaltern a.d. Weinstr.,64,,31,39,70
015 Kaltern a.d. Weinstr.,65,,42,35,77
015 Kaltern a.d. Weinstr.,66,,29,34,63
015 Kaltern a.d. Weinstr.,67,,35,32,67
015 Kaltern a.d. Weinstr.,68,,36,53,89
015 Kaltern a.d. Weinstr.,69,,47,45,92
015 Kaltern a.d. Weinstr.,70,,33,37,70
015 Kaltern a.d. Weinstr.,71,,31,44,75
015 Kaltern a.d. Weinstr.,72,,31,38,69
015 Kaltern a.d. Weinstr.,73,,35,41,76
015 Kaltern a.d. Weinstr.,74,,44,40,84
015 Kaltern a.d. Weinstr.,75,,24,39,63
015 Kaltern a.d. Weinstr.,76,,20,31,51
015 Kaltern a.d. Weinstr.,77,,30,37,67
015 Kaltern a.d. Weinstr.,78,,23,28,51
015 Kaltern a.d. Weinstr.,79,,22,20,42
015 Kaltern a.d. Weinstr.,80,,17,22,39
015 Kaltern a.d. Weinstr.,81,,17,24,41
015 Kaltern a.d. Weinstr.,82,,17,32,49
015 Kaltern a.d. Weinstr.,83,,18,26,44
015 Kaltern a.d. Weinstr.,84,,12,27,39
015 Kaltern a.d. Weinstr.,85,,17,26,43
015 Kaltern a.d. Weinstr.,86,,11,22,33
015 Kaltern a.d. Weinstr.,87,,8,18,26
015 Kaltern a.d. Weinstr.,88,,9,21,30
015 Kaltern a.d. Weinstr.,89,,6,14,20
015 Kaltern a.d. Weinstr.,90,,5,19,24
015 Kaltern a.d. Weinstr.,91,,3,8,11
015 Kaltern a.d. Weinstr.,92,,1,11,12
015 Kaltern a.d. Weinstr.,93,,3,14,17
015 Kaltern a.d. Weinstr.,94,,1,5,6
015 Kaltern a.d. Weinstr.,95,,-,8,8
015 Kaltern a.d. Weinstr.,96,,-,1,1
015 Kaltern a.d. Weinstr.,97,,-,2,2
015 Kaltern a.d. Weinstr.,100,,-,1,1
015 Kaltern a.d. Weinstr.,102,,-,1,1
015 Kaltern a.d. Weinstr.,Insgesamt,,3.827,4.088,7.915
016 Freienfeld,0,,15,12,27
016 Freienfeld,1,,14,10,24
016 Freienfeld,2,,7,12,19
016 Freienfeld,3,,11,14,25
016 Freienfeld,4,,16,16,32
016 Freienfeld,5,,16,15,31
016 Freienfeld,6,,17,16,33
016 Freienfeld,7,,12,12,24
016 Freienfeld,8,,24,12,36
016 Freienfeld,9,,14,15,29
016 Freienfeld,10,,19,17,36
016 Freienfeld,11,,15,11,26
016 Freienfeld,12,,21,17,38
016 Freienfeld,13,,18,19,37
016 Freienfeld,14,,16,19,35
016 Freienfeld,15,,15,14,29
016 Freienfeld,16,,18,21,39
016 Freienfeld,17,,13,23,36
016 Freienfeld,18,,19,19,38
016 Freienfeld,19,,22,13,35
016 Freienfeld,20,,15,15,30
016 Freienfeld,21,,13,10,23
016 Freienfeld,22,,13,12,25
016 Freienfeld,23,,18,21,39
016 Freienfeld,24,,12,12,24
016 Freienfeld,25,,23,15,38
016 Freienfeld,26,,28,22,50
016 Freienfeld,27,,18,17,35
016 Freienfeld,28,,19,17,36
016 Freienfeld,29,,16,16,32
016 Freienfeld,30,,15,16,31
016 Freienfeld,31,,20,14,34
016 Freienfeld,32,,24,16,40
016 Freienfeld,33,,16,17,33
016 Freienfeld,34,,22,17,39
016 Freienfeld,35,,17,13,30
016 Freienfeld,36,,11,21,32
016 Freienfeld,37,,13,14,27
016 Freienfeld,38,,22,22,44
016 Freienfeld,39,,15,14,29
016 Freienfeld,40,,14,15,29
016 Freienfeld,41,,21,24,45
016 Freienfeld,42,,20,19,39
016 Freienfeld,43,,16,23,39
016 Freienfeld,44,,25,23,48
016 Freienfeld,45,,24,16,40
016 Freienfeld,46,,24,24,48
016 Freienfeld,47,,20,19,39
016 Freienfeld,48,,22,27,49
016 Freienfeld,49,,22,21,43
016 Freienfeld,50,,26,21,47
016 Freienfeld,51,,27,18,45
016 Freienfeld,52,,21,15,36
016 Freienfeld,53,,27,30,57
016 Freienfeld,54,,25,16,41
016 Freienfeld,55,,19,22,41
016 Freienfeld,56,,24,14,38
016 Freienfeld,57,,17,18,35
016 Freienfeld,58,,13,19,32
016 Freienfeld,59,,19,18,37
016 Freienfeld,60,,19,10,29
016 Freienfeld,61,,16,18,34
016 Freienfeld,62,,18,11,29
016 Freienfeld,63,,14,18,32
016 Freienfeld,64,,13,10,23
016 Freienfeld,65,,18,10,28
016 Freienfeld,66,,16,11,27
016 Freienfeld,67,,16,11,27
016 Freienfeld,68,,4,9,13
016 Freienfeld,69,,11,16,27
016 Freienfeld,70,,9,2,11
016 Freienfeld,71,,8,5,13
016 Freienfeld,72,,11,9,20
016 Freienfeld,73,,10,8,18
016 Freienfeld,74,,10,9,19
016 Freienfeld,75,,10,4,14
016 Freienfeld,76,,5,9,14
016 Freienfeld,77,,10,12,22
016 Freienfeld,78,,3,11,14
016 Freienfeld,79,,8,11,19
016 Freienfeld,80,,5,11,16
016 Freienfeld,81,,4,4,8
016 Freienfeld,82,,6,9,15
016 Freienfeld,83,,5,6,11
016 Freienfeld,84,,4,6,10
016 Freienfeld,85,,5,5,10
016 Freienfeld,86,,1,3,4
016 Freienfeld,87,,3,3,6
016 Freienfeld,88,,2,4,6
016 Freienfeld,89,,4,1,5
016 Freienfeld,90,,-,2,2
016 Freienfeld,91,,-,2,2
016 Freienfeld,92,,-,5,5
016 Freienfeld,93,,-,2,2
016 Freienfeld,95,,-,2,2
016 Freienfeld,101,,-,1,1
016 Freienfeld,Insgesamt,,1.366,1.300,2.666
017 Sand in Taufers,0,,24,31,55
017 Sand in Taufers,1,,30,28,58
017 Sand in Taufers,2,,25,22,47
017 Sand in Taufers,3,,21,35,56
017 Sand in Taufers,4,,23,27,50
017 Sand in Taufers,5,,24,23,47
017 Sand in Taufers,6,,34,42,76
017 Sand in Taufers,7,,27,30,57
017 Sand in Taufers,8,,45,38,83
017 Sand in Taufers,9,,36,20,56
017 Sand in Taufers,10,,36,29,65
017 Sand in Taufers,11,,36,22,58
017 Sand in Taufers,12,,35,30,65
017 Sand in Taufers,13,,27,28,55
017 Sand in Taufers,14,,30,38,68
017 Sand in Taufers,15,,42,22,64
017 Sand in Taufers,16,,36,39,75
017 Sand in Taufers,17,,29,35,64
017 Sand in Taufers,18,,35,36,71
017 Sand in Taufers,19,,29,30,59
017 Sand in Taufers,20,,32,26,58
017 Sand in Taufers,21,,44,36,80
017 Sand in Taufers,22,,23,36,59
017 Sand in Taufers,23,,31,38,69
017 Sand in Taufers,24,,30,31,61
017 Sand in Taufers,25,,28,36,64
017 Sand in Taufers,26,,29,35,64
017 Sand in Taufers,27,,29,30,59
017 Sand in Taufers,28,,20,31,51
017 Sand in Taufers,29,,22,22,44
017 Sand in Taufers,30,,28,32,60
017 Sand in Taufers,31,,35,27,62
017 Sand in Taufers,32,,31,32,63
017 Sand in Taufers,33,,24,36,60
017 Sand in Taufers,34,,31,38,69
017 Sand in Taufers,35,,37,38,75
017 Sand in Taufers,36,,34,43,77
017 Sand in Taufers,37,,43,34,77
017 Sand in Taufers,38,,38,38,76
017 Sand in Taufers,39,,36,34,70
017 Sand in Taufers,40,,46,39,85
017 Sand in Taufers,41,,56,47,103
017 Sand in Taufers,42,,51,44,95
017 Sand in Taufers,43,,43,50,93
017 Sand in Taufers,44,,48,49,97
017 Sand in Taufers,45,,44,63,107
017 Sand in Taufers,46,,59,44,103
017 Sand in Taufers,47,,50,40,90
017 Sand in Taufers,48,,35,41,76
017 Sand in Taufers,49,,47,37,84
017 Sand in Taufers,50,,54,37,91
017 Sand in Taufers,51,,51,43,94
017 Sand in Taufers,52,,45,40,85
017 Sand in Taufers,53,,38,46,84
017 Sand in Taufers,54,,46,43,89
017 Sand in Taufers,55,,41,33,74
017 Sand in Taufers,56,,36,33,69
017 Sand in Taufers,57,,30,24,54
017 Sand in Taufers,58,,25,38,63
017 Sand in Taufers,59,,23,34,57
017 Sand in Taufers,60,,21,24,45
017 Sand in Taufers,61,,25,28,53
017 Sand in Taufers,62,,28,24,52
017 Sand in Taufers,63,,15,27,42
017 Sand in Taufers,64,,24,21,45
017 Sand in Taufers,65,,30,32,62
017 Sand in Taufers,66,,29,23,52
017 Sand in Taufers,67,,23,24,47
017 Sand in Taufers,68,,24,29,53
017 Sand in Taufers,69,,25,24,49
017 Sand in Taufers,70,,22,8,30
017 Sand in Taufers,71,,14,29,43
017 Sand in Taufers,72,,25,27,52
017 Sand in Taufers,73,,27,30,57
017 Sand in Taufers,74,,24,30,54
017 Sand in Taufers,75,,22,18,40
017 Sand in Taufers,76,,19,30,49
017 Sand in Taufers,77,,16,22,38
017 Sand in Taufers,78,,23,13,36
017 Sand in Taufers,79,,12,23,35
017 Sand in Taufers,80,,17,15,32
017 Sand in Taufers,81,,12,10,22
017 Sand in Taufers,82,,11,15,26
017 Sand in Taufers,83,,7,15,22
017 Sand in Taufers,84,,5,10,15
017 Sand in Taufers,85,,9,16,25
017 Sand in Taufers,86,,7,10,17
017 Sand in Taufers,87,,2,9,11
017 Sand in Taufers,88,,2,3,5
017 Sand in Taufers,89,,4,9,13
017 Sand in Taufers,90,,2,6,8
017 Sand in Taufers,91,,1,7,8
017 Sand in Taufers,92,,2,3,5
017 Sand in Taufers,93,,-,4,4
017 Sand in Taufers,94,,-,2,2
017 Sand in Taufers,95,,-,1,1
017 Sand in Taufers,97,,-,1,1
017 Sand in Taufers,98,,-,1,1
017 Sand in Taufers,100,,1,-,1
017 Sand in Taufers,Insgesamt,,2.647,2.726,5.373
018 Kastelbell-Tschars,0,,9,9,18
018 Kastelbell-Tschars,1,,8,12,20
018 Kastelbell-Tschars,2,,15,14,29
018 Kastelbell-Tschars,3,,15,7,22
018 Kastelbell-Tschars,4,,14,11,25
018 Kastelbell-Tschars,5,,11,20,31
018 Kastelbell-Tschars,6,,9,8,17
018 Kastelbell-Tschars,7,,10,6,16
018 Kastelbell-Tschars,8,,12,9,21
018 Kastelbell-Tschars,9,,19,6,25
018 Kastelbell-Tschars,10,,9,8,17
018 Kastelbell-Tschars,11,,12,11,23
018 Kastelbell-Tschars,12,,11,9,20
018 Kastelbell-Tschars,13,,8,9,17
018 Kastelbell-Tschars,14,,14,15,29
018 Kastelbell-Tschars,15,,13,10,23
018 Kastelbell-Tschars,16,,24,11,35
018 Kastelbell-Tschars,17,,17,7,24
018 Kastelbell-Tschars,18,,11,11,22
018 Kastelbell-Tschars,19,,16,17,33
018 Kastelbell-Tschars,20,,16,13,29
018 Kastelbell-Tschars,21,,14,13,27
018 Kastelbell-Tschars,22,,14,14,28
018 Kastelbell-Tschars,23,,12,7,19
018 Kastelbell-Tschars,24,,16,12,28
018 Kastelbell-Tschars,25,,13,15,28
018 Kastelbell-Tschars,26,,13,8,21
018 Kastelbell-Tschars,27,,14,8,22
018 Kastelbell-Tschars,28,,15,15,30
018 Kastelbell-Tschars,29,,16,15,31
018 Kastelbell-Tschars,30,,25,16,41
018 Kastelbell-Tschars,31,,7,16,23
018 Kastelbell-Tschars,32,,12,15,27
018 Kastelbell-Tschars,33,,24,9,33
018 Kastelbell-Tschars,34,,12,13,25
018 Kastelbell-Tschars,35,,10,13,23
018 Kastelbell-Tschars,36,,11,14,25
018 Kastelbell-Tschars,37,,15,14,29
018 Kastelbell-Tschars,38,,13,14,27
018 Kastelbell-Tschars,39,,18,17,35
018 Kastelbell-Tschars,40,,18,13,31
018 Kastelbell-Tschars,41,,18,11,29
018 Kastelbell-Tschars,42,,15,24,39
018 Kastelbell-Tschars,43,,12,20,32
018 Kastelbell-Tschars,44,,17,16,33
018 Kastelbell-Tschars,45,,16,14,30
018 Kastelbell-Tschars,46,,24,23,47
018 Kastelbell-Tschars,47,,15,18,33
018 Kastelbell-Tschars,48,,15,20,35
018 Kastelbell-Tschars,49,,20,12,32
018 Kastelbell-Tschars,50,,19,11,30
018 Kastelbell-Tschars,51,,21,15,36
018 Kastelbell-Tschars,52,,23,20,43
018 Kastelbell-Tschars,53,,6,21,27
018 Kastelbell-Tschars,54,,19,18,37
018 Kastelbell-Tschars,55,,22,19,41
018 Kastelbell-Tschars,56,,23,20,43
018 Kastelbell-Tschars,57,,19,15,34
018 Kastelbell-Tschars,58,,13,10,23
018 Kastelbell-Tschars,59,,13,14,27
018 Kastelbell-Tschars,60,,20,17,37
018 Kastelbell-Tschars,61,,9,10,19
018 Kastelbell-Tschars,62,,9,16,25
018 Kastelbell-Tschars,63,,12,14,26
018 Kastelbell-Tschars,64,,16,14,30
018 Kastelbell-Tschars,65,,10,13,23
018 Kastelbell-Tschars,66,,14,10,24
018 Kastelbell-Tschars,67,,11,13,24
018 Kastelbell-Tschars,68,,9,8,17
018 Kastelbell-Tschars,69,,10,13,23
018 Kastelbell-Tschars,70,,11,4,15
018 Kastelbell-Tschars,71,,12,6,18
018 Kastelbell-Tschars,72,,8,7,15
018 Kastelbell-Tschars,73,,9,10,19
018 Kastelbell-Tschars,74,,7,8,15
018 Kastelbell-Tschars,75,,8,7,15
018 Kastelbell-Tschars,76,,11,11,22
018 Kastelbell-Tschars,77,,6,14,20
018 Kastelbell-Tschars,78,,11,10,21
018 Kastelbell-Tschars,79,,9,14,23
018 Kastelbell-Tschars,80,,8,7,15
018 Kastelbell-Tschars,81,,4,11,15
018 Kastelbell-Tschars,82,,13,10,23
018 Kastelbell-Tschars,83,,6,11,17
018 Kastelbell-Tschars,84,,7,9,16
018 Kastelbell-Tschars,85,,13,11,24
018 Kastelbell-Tschars,86,,7,7,14
018 Kastelbell-Tschars,87,,4,8,12
018 Kastelbell-Tschars,88,,3,3,6
018 Kastelbell-Tschars,89,,3,9,12
018 Kastelbell-Tschars,90,,7,5,12
018 Kastelbell-Tschars,91,,1,2,3
018 Kastelbell-Tschars,92,,1,4,5
018 Kastelbell-Tschars,93,,-,2,2
018 Kastelbell-Tschars,94,,1,-,1
018 Kastelbell-Tschars,95,,1,-,1
018 Kastelbell-Tschars,Insgesamt,,1.186,1.123,2.309
019 Kastelruth,0,,33,35,68
019 Kastelruth,1,,44,35,79
019 Kastelruth,2,,36,36,72
019 Kastelruth,3,,39,44,83
019 Kastelruth,4,,43,37,80
019 Kastelruth,5,,40,34,74
019 Kastelruth,6,,31,38,69
019 Kastelruth,7,,51,37,88
019 Kastelruth,8,,45,37,82
019 Kastelruth,9,,44,38,82
019 Kastelruth,10,,50,32,82
019 Kastelruth,11,,47,39,86
019 Kastelruth,12,,50,42,92
019 Kastelruth,13,,39,35,74
019 Kastelruth,14,,43,37,80
019 Kastelruth,15,,38,27,65
019 Kastelruth,16,,33,47,80
019 Kastelruth,17,,47,43,90
019 Kastelruth,18,,44,45,89
019 Kastelruth,19,,42,38,80
019 Kastelruth,20,,55,40,95
019 Kastelruth,21,,39,33,72
019 Kastelruth,22,,37,35,72
019 Kastelruth,23,,42,50,92
019 Kastelruth,24,,41,38,79
019 Kastelruth,25,,47,43,90
019 Kastelruth,26,,48,46,94
019 Kastelruth,27,,25,37,62
019 Kastelruth,28,,34,45,79
019 Kastelruth,29,,32,30,62
019 Kastelruth,30,,31,47,78
019 Kastelruth,31,,28,36,64
019 Kastelruth,32,,46,33,79
019 Kastelruth,33,,50,42,92
019 Kastelruth,34,,39,50,89
019 Kastelruth,35,,56,47,103
019 Kastelruth,36,,42,38,80
019 Kastelruth,37,,41,42,83
019 Kastelruth,38,,37,47,84
019 Kastelruth,39,,47,66,113
019 Kastelruth,40,,54,44,98
019 Kastelruth,41,,62,46,108
019 Kastelruth,42,,42,70,112
019 Kastelruth,43,,70,44,114
019 Kastelruth,44,,54,44,98
019 Kastelruth,45,,53,48,101
019 Kastelruth,46,,59,44,103
019 Kastelruth,47,,62,61,123
019 Kastelruth,48,,68,58,126
019 Kastelruth,49,,70,47,117
019 Kastelruth,50,,46,76,122
019 Kastelruth,51,,55,36,91
019 Kastelruth,52,,51,35,86
019 Kastelruth,53,,34,52,86
019 Kastelruth,54,,55,41,96
019 Kastelruth,55,,49,39,88
019 Kastelruth,56,,44,47,91
019 Kastelruth,57,,47,45,92
019 Kastelruth,58,,39,38,77
019 Kastelruth,59,,37,31,68
019 Kastelruth,60,,39,39,78
019 Kastelruth,61,,35,33,68
019 Kastelruth,62,,30,28,58
019 Kastelruth,63,,34,25,59
019 Kastelruth,64,,27,21,48
019 Kastelruth,65,,43,26,69
019 Kastelruth,66,,17,34,51
019 Kastelruth,67,,27,41,68
019 Kastelruth,68,,28,30,58
019 Kastelruth,69,,24,37,61
019 Kastelruth,70,,22,21,43
019 Kastelruth,71,,23,43,66
019 Kastelruth,72,,36,38,74
019 Kastelruth,73,,30,24,54
019 Kastelruth,74,,25,42,67
019 Kastelruth,75,,25,36,61
019 Kastelruth,76,,25,26,51
019 Kastelruth,77,,21,24,45
019 Kastelruth,78,,23,21,44
019 Kastelruth,79,,23,16,39
019 Kastelruth,80,,22,25,47
019 Kastelruth,81,,16,19,35
019 Kastelruth,82,,26,27,53
019 Kastelruth,83,,13,32,45
019 Kastelruth,84,,26,17,43
019 Kastelruth,85,,7,22,29
019 Kastelruth,86,,12,18,30
019 Kastelruth,87,,6,9,15
019 Kastelruth,88,,11,21,32
019 Kastelruth,89,,7,9,16
019 Kastelruth,90,,7,10,17
019 Kastelruth,91,,5,11,16
019 Kastelruth,92,,3,9,12
019 Kastelruth,93,,2,5,7
019 Kastelruth,94,,2,6,8
019 Kastelruth,95,,-,1,1
019 Kastelruth,96,,-,2,2
019 Kastelruth,101,,-,1,1
019 Kastelruth,Insgesamt,,3.429,3.396,6.825
020 Tscherms,0,,13,7,20
020 Tscherms,1,,7,12,19
020 Tscherms,2,,7,6,13
020 Tscherms,3,,11,10,21
020 Tscherms,4,,19,6,25
020 Tscherms,5,,9,6,15
020 Tscherms,6,,8,7,15
020 Tscherms,7,,9,11,20
020 Tscherms,8,,8,10,18
020 Tscherms,9,,9,6,15
020 Tscherms,10,,1,9,10
020 Tscherms,11,,9,7,16
020 Tscherms,12,,9,9,18
020 Tscherms,13,,7,7,14
020 Tscherms,14,,3,9,12
020 Tscherms,15,,11,6,17
020 Tscherms,16,,8,8,16
020 Tscherms,17,,4,8,12
020 Tscherms,18,,11,9,20
020 Tscherms,19,,7,6,13
020 Tscherms,20,,11,10,21
020 Tscherms,21,,10,17,27
020 Tscherms,22,,7,9,16
020 Tscherms,23,,8,6,14
020 Tscherms,24,,7,10,17
020 Tscherms,25,,10,9,19
020 Tscherms,26,,5,5,10
020 Tscherms,27,,6,12,18
020 Tscherms,28,,11,10,21
020 Tscherms,29,,8,6,14
020 Tscherms,30,,13,13,26
020 Tscherms,31,,12,9,21
020 Tscherms,32,,13,14,27
020 Tscherms,33,,7,10,17
020 Tscherms,34,,11,10,21
020 Tscherms,35,,11,17,28
020 Tscherms,36,,8,12,20
020 Tscherms,37,,6,11,17
020 Tscherms,38,,9,8,17
020 Tscherms,39,,8,11,19
020 Tscherms,40,,15,7,22
020 Tscherms,41,,13,9,22
020 Tscherms,42,,12,14,26
020 Tscherms,43,,9,14,23
020 Tscherms,44,,9,15,24
020 Tscherms,45,,13,5,18
020 Tscherms,46,,7,17,24
020 Tscherms,47,,13,8,21
020 Tscherms,48,,14,10,24
020 Tscherms,49,,15,7,22
020 Tscherms,50,,17,19,36
020 Tscherms,51,,15,18,33
020 Tscherms,52,,16,12,28
020 Tscherms,53,,20,14,34
020 Tscherms,54,,14,12,26
020 Tscherms,55,,11,14,25
020 Tscherms,56,,6,18,24
020 Tscherms,57,,9,8,17
020 Tscherms,58,,8,11,19
020 Tscherms,59,,9,6,15
020 Tscherms,60,,9,7,16
020 Tscherms,61,,6,9,15
020 Tscherms,62,,10,8,18
020 Tscherms,63,,11,6,17
020 Tscherms,64,,5,9,14
020 Tscherms,65,,10,6,16
020 Tscherms,66,,4,3,7
020 Tscherms,67,,6,6,12
020 Tscherms,68,,7,8,15
020 Tscherms,69,,4,8,12
020 Tscherms,70,,4,6,10
020 Tscherms,71,,5,8,13
020 Tscherms,72,,5,4,9
020 Tscherms,73,,7,3,10
020 Tscherms,74,,10,9,19
020 Tscherms,75,,4,4,8
020 Tscherms,76,,5,6,11
020 Tscherms,77,,6,3,9
020 Tscherms,78,,5,8,13
020 Tscherms,79,,6,7,13
020 Tscherms,80,,3,3,6
020 Tscherms,81,,1,9,10
020 Tscherms,82,,4,3,7
020 Tscherms,83,,4,5,9
020 Tscherms,84,,2,2,4
020 Tscherms,85,,3,4,7
020 Tscherms,86,,-,2,2
020 Tscherms,87,,4,3,7
020 Tscherms,88,,3,2,5
020 Tscherms,89,,1,1,2
020 Tscherms,90,,3,5,8
020 Tscherms,91,,3,3,6
020 Tscherms,92,,-,2,2
020 Tscherms,93,,-,1,1
020 Tscherms,97,,-,1,1
020 Tscherms,Insgesamt,,756,780,1.536
021 Kiens,0,,15,15,30
021 Kiens,1,,15,17,32
021 Kiens,2,,22,5,27
021 Kiens,3,,16,23,39
021 Kiens,4,,11,8,19
021 Kiens,5,,17,14,31
021 Kiens,6,,9,20,29
021 Kiens,7,,12,9,21
021 Kiens,8,,13,14,27
021 Kiens,9,,16,7,23
021 Kiens,10,,18,20,38
021 Kiens,11,,17,11,28
021 Kiens,12,,13,20,33
021 Kiens,13,,10,15,25
021 Kiens,14,,19,21,40
021 Kiens,15,,9,23,32
021 Kiens,16,,16,19,35
021 Kiens,17,,21,10,31
021 Kiens,18,,19,15,34
021 Kiens,19,,14,17,31
021 Kiens,20,,14,22,36
021 Kiens,21,,21,16,37
021 Kiens,22,,18,19,37
021 Kiens,23,,27,17,44
021 Kiens,24,,14,21,35
021 Kiens,25,,17,21,38
021 Kiens,26,,12,20,32
021 Kiens,27,,14,13,27
021 Kiens,28,,11,15,26
021 Kiens,29,,16,14,30
021 Kiens,30,,20,10,30
021 Kiens,31,,16,13,29
021 Kiens,32,,17,17,34
021 Kiens,33,,24,18,42
021 Kiens,34,,17,17,34
021 Kiens,35,,16,16,32
021 Kiens,36,,11,15,26
021 Kiens,37,,27,17,44
021 Kiens,38,,20,13,33
021 Kiens,39,,18,26,44
021 Kiens,40,,16,21,37
021 Kiens,41,,17,20,37
021 Kiens,42,,33,22,55
021 Kiens,43,,25,16,41
021 Kiens,44,,30,22,52
021 Kiens,45,,24,30,54
021 Kiens,46,,31,25,56
021 Kiens,47,,38,23,61
021 Kiens,48,,25,24,49
021 Kiens,49,,28,24,52
021 Kiens,50,,21,23,44
021 Kiens,51,,33,24,57
021 Kiens,52,,18,23,41
021 Kiens,53,,30,19,49
021 Kiens,54,,19,24,43
021 Kiens,55,,20,18,38
021 Kiens,56,,24,16,40
021 Kiens,57,,16,13,29
021 Kiens,58,,13,14,27
021 Kiens,59,,16,15,31
021 Kiens,60,,15,8,23
021 Kiens,61,,12,15,27
021 Kiens,62,,15,22,37
021 Kiens,63,,12,10,22
021 Kiens,64,,15,12,27
021 Kiens,65,,14,9,23
021 Kiens,66,,10,13,23
021 Kiens,67,,15,16,31
021 Kiens,68,,12,15,27
021 Kiens,69,,20,14,34
021 Kiens,70,,8,11,19
021 Kiens,71,,7,12,19
021 Kiens,72,,16,9,25
021 Kiens,73,,15,10,25
021 Kiens,74,,13,11,24
021 Kiens,75,,9,16,25
021 Kiens,76,,11,8,19
021 Kiens,77,,9,10,19
021 Kiens,78,,10,8,18
021 Kiens,79,,9,7,16
021 Kiens,80,,3,14,17
021 Kiens,81,,6,6,12
021 Kiens,82,,8,7,15
021 Kiens,83,,10,7,17
021 Kiens,84,,10,5,15
021 Kiens,85,,2,9,11
021 Kiens,86,,2,6,8
021 Kiens,87,,1,3,4
021 Kiens,88,,2,4,6
021 Kiens,89,,-,1,1
021 Kiens,90,,1,2,3
021 Kiens,91,,-,4,4
021 Kiens,92,,1,2,3
021 Kiens,93,,1,1,2
021 Kiens,95,,1,-,1
021 Kiens,Insgesamt,,1.424,1.366,2.790
022 Klausen,0,,32,37,69
022 Klausen,1,,25,32,57
022 Klausen,2,,31,23,54
022 Klausen,3,,39,25,64
022 Klausen,4,,31,33,64
022 Klausen,5,,20,35,55
022 Klausen,6,,27,20,47
022 Klausen,7,,23,25,48
022 Klausen,8,,25,29,54
022 Klausen,9,,43,38,81
022 Klausen,10,,38,33,71
022 Klausen,11,,37,36,73
022 Klausen,12,,30,29,59
022 Klausen,13,,41,33,74
022 Klausen,14,,30,28,58
022 Klausen,15,,29,34,63
022 Klausen,16,,26,31,57
022 Klausen,17,,23,30,53
022 Klausen,18,,37,33,70
022 Klausen,19,,32,27,59
022 Klausen,20,,30,27,57
022 Klausen,21,,17,35,52
022 Klausen,22,,35,27,62
022 Klausen,23,,37,23,60
022 Klausen,24,,40,36,76
022 Klausen,25,,45,29,74
022 Klausen,26,,31,28,59
022 Klausen,27,,26,39,65
022 Klausen,28,,26,31,57
022 Klausen,29,,34,27,61
022 Klausen,30,,36,34,70
022 Klausen,31,,29,25,54
022 Klausen,32,,31,36,67
022 Klausen,33,,36,43,79
022 Klausen,34,,35,32,67
022 Klausen,35,,31,41,72
022 Klausen,36,,31,28,59
022 Klausen,37,,41,35,76
022 Klausen,38,,32,29,61
022 Klausen,39,,38,28,66
022 Klausen,40,,38,42,80
022 Klausen,41,,36,32,68
022 Klausen,42,,44,30,74
022 Klausen,43,,37,37,74
022 Klausen,44,,38,41,79
022 Klausen,45,,44,41,85
022 Klausen,46,,44,46,90
022 Klausen,47,,45,45,90
022 Klausen,48,,51,42,93
022 Klausen,49,,61,43,104
022 Klausen,50,,41,48,89
022 Klausen,51,,44,46,90
022 Klausen,52,,39,38,77
022 Klausen,53,,34,40,74
022 Klausen,54,,50,43,93
022 Klausen,55,,38,26,64
022 Klausen,56,,32,39,71
022 Klausen,57,,29,28,57
022 Klausen,58,,31,29,60
022 Klausen,59,,30,26,56
022 Klausen,60,,26,31,57
022 Klausen,61,,27,39,66
022 Klausen,62,,20,29,49
022 Klausen,63,,29,16,45
022 Klausen,64,,33,25,58
022 Klausen,65,,27,21,48
022 Klausen,66,,31,27,58
022 Klausen,67,,27,27,54
022 Klausen,68,,24,20,44
022 Klausen,69,,27,22,49
022 Klausen,70,,13,17,30
022 Klausen,71,,19,17,36
022 Klausen,72,,13,28,41
022 Klausen,73,,19,24,43
022 Klausen,74,,25,19,44
022 Klausen,75,,17,22,39
022 Klausen,76,,20,20,40
022 Klausen,77,,11,20,31
022 Klausen,78,,13,17,30
022 Klausen,79,,16,20,36
022 Klausen,80,,10,15,25
022 Klausen,81,,13,9,22
022 Klausen,82,,16,14,30
022 Klausen,83,,9,14,23
022 Klausen,84,,10,10,20
022 Klausen,85,,8,14,22
022 Klausen,86,,11,11,22
022 Klausen,87,,1,13,14
022 Klausen,88,,2,11,13
022 Klausen,89,,1,4,5
022 Klausen,90,,4,5,9
022 Klausen,91,,1,4,5
022 Klausen,92,,1,5,6
022 Klausen,93,,1,3,4
022 Klausen,94,,-,3,3
022 Klausen,95,,-,2,2
022 Klausen,96,,-,2,2
022 Klausen,97,,1,1,2
022 Klausen,102,,-,1,1
022 Klausen,Insgesamt,,2.612,2.608,5.220
023 Karneid,0,,18,18,36
023 Karneid,1,,18,24,42
023 Karneid,2,,10,15,25
023 Karneid,3,,21,18,39
023 Karneid,4,,30,18,48
023 Karneid,5,,15,16,31
023 Karneid,6,,16,18,34
023 Karneid,7,,29,16,45
023 Karneid,8,,25,22,47
023 Karneid,9,,23,14,37
023 Karneid,10,,26,22,48
023 Karneid,11,,20,25,45
023 Karneid,12,,28,20,48
023 Karneid,13,,15,14,29
023 Karneid,14,,22,22,44
023 Karneid,15,,17,16,33
023 Karneid,16,,26,25,51
023 Karneid,17,,17,21,38
023 Karneid,18,,28,19,47
023 Karneid,19,,19,24,43
023 Karneid,20,,29,20,49
023 Karneid,21,,22,22,44
023 Karneid,22,,23,21,44
023 Karneid,23,,23,19,42
023 Karneid,24,,18,16,34
023 Karneid,25,,21,16,37
023 Karneid,26,,20,16,36
023 Karneid,27,,16,20,36
023 Karneid,28,,14,14,28
023 Karneid,29,,22,20,42
023 Karneid,30,,22,12,34
023 Karneid,31,,29,16,45
023 Karneid,32,,16,16,32
023 Karneid,33,,16,17,33
023 Karneid,34,,29,28,57
023 Karneid,35,,25,16,41
023 Karneid,36,,22,27,49
023 Karneid,37,,20,15,35
023 Karneid,38,,16,22,38
023 Karneid,39,,30,29,59
023 Karneid,40,,18,15,33
023 Karneid,41,,23,27,50
023 Karneid,42,,28,32,60
023 Karneid,43,,29,26,55
023 Karneid,44,,32,39,71
023 Karneid,45,,35,23,58
023 Karneid,46,,24,27,51
023 Karneid,47,,35,34,69
023 Karneid,48,,32,30,62
023 Karneid,49,,34,30,64
023 Karneid,50,,33,25,58
023 Karneid,51,,33,24,57
023 Karneid,52,,38,25,63
023 Karneid,53,,28,41,69
023 Karneid,54,,30,23,53
023 Karneid,55,,27,26,53
023 Karneid,56,,29,16,45
023 Karneid,57,,23,17,40
023 Karneid,58,,16,15,31
023 Karneid,59,,20,16,36
023 Karneid,60,,13,9,22
023 Karneid,61,,15,13,28
023 Karneid,62,,15,13,28
023 Karneid,63,,10,20,30
023 Karneid,64,,16,12,28
023 Karneid,65,,20,12,32
023 Karneid,66,,9,14,23
023 Karneid,67,,10,27,37
023 Karneid,68,,6,16,22
023 Karneid,69,,13,21,34
023 Karneid,70,,11,14,25
023 Karneid,71,,10,14,24
023 Karneid,72,,18,13,31
023 Karneid,73,,15,24,39
023 Karneid,74,,16,12,28
023 Karneid,75,,9,14,23
023 Karneid,76,,13,14,27
023 Karneid,77,,13,11,24
023 Karneid,78,,8,8,16
023 Karneid,79,,11,10,21
023 Karneid,80,,9,8,17
023 Karneid,81,,6,11,17
023 Karneid,82,,5,13,18
023 Karneid,83,,11,5,16
023 Karneid,84,,9,9,18
023 Karneid,85,,4,6,10
023 Karneid,86,,6,4,10
023 Karneid,87,,5,3,8
023 Karneid,88,,-,4,4
023 Karneid,89,,4,5,9
023 Karneid,90,,1,2,3
023 Karneid,91,,3,2,5
023 Karneid,92,,-,1,1
023 Karneid,93,,-,3,3
023 Karneid,94,,1,-,1
023 Karneid,95,,1,3,4
023 Karneid,Insgesamt,,1.739,1.650,3.389
024 Kurtatsch a.d.Weinstr.,0,,8,16,24
024 Kurtatsch a.d.Weinstr.,1,,8,4,12
024 Kurtatsch a.d.Weinstr.,2,,19,7,26
024 Kurtatsch a.d.Weinstr.,3,,16,8,24
024 Kurtatsch a.d.Weinstr.,4,,11,10,21
024 Kurtatsch a.d.Weinstr.,5,,6,9,15
024 Kurtatsch a.d.Weinstr.,6,,10,12,22
024 Kurtatsch a.d.Weinstr.,7,,15,8,23
024 Kurtatsch a.d.Weinstr.,8,,6,4,10
024 Kurtatsch a.d.Weinstr.,9,,8,18,26
024 Kurtatsch a.d.Weinstr.,10,,13,14,27
024 Kurtatsch a.d.Weinstr.,11,,11,11,22
024 Kurtatsch a.d.Weinstr.,12,,10,12,22
024 Kurtatsch a.d.Weinstr.,13,,13,17,30
024 Kurtatsch a.d.Weinstr.,14,,16,10,26
024 Kurtatsch a.d.Weinstr.,15,,18,16,34
024 Kurtatsch a.d.Weinstr.,16,,18,11,29
024 Kurtatsch a.d.Weinstr.,17,,18,14,32
024 Kurtatsch a.d.Weinstr.,18,,14,14,28
024 Kurtatsch a.d.Weinstr.,19,,22,20,42
024 Kurtatsch a.d.Weinstr.,20,,17,10,27
024 Kurtatsch a.d.Weinstr.,21,,13,7,20
024 Kurtatsch a.d.Weinstr.,22,,22,15,37
024 Kurtatsch a.d.Weinstr.,23,,19,11,30
024 Kurtatsch a.d.Weinstr.,24,,17,12,29
024 Kurtatsch a.d.Weinstr.,25,,14,8,22
024 Kurtatsch a.d.Weinstr.,26,,9,18,27
024 Kurtatsch a.d.Weinstr.,27,,8,14,22
024 Kurtatsch a.d.Weinstr.,28,,12,14,26
024 Kurtatsch a.d.Weinstr.,29,,9,13,22
024 Kurtatsch a.d.Weinstr.,30,,16,11,27
024 Kurtatsch a.d.Weinstr.,31,,14,4,18
024 Kurtatsch a.d.Weinstr.,32,,14,9,23
024 Kurtatsch a.d.Weinstr.,33,,13,20,33
024 Kurtatsch a.d.Weinstr.,34,,15,16,31
024 Kurtatsch a.d.Weinstr.,35,,10,11,21
024 Kurtatsch a.d.Weinstr.,36,,11,14,25
024 Kurtatsch a.d.Weinstr.,37,,9,14,23
024 Kurtatsch a.d.Weinstr.,38,,9,16,25
024 Kurtatsch a.d.Weinstr.,39,,10,13,23
024 Kurtatsch a.d.Weinstr.,40,,11,11,22
024 Kurtatsch a.d.Weinstr.,41,,13,18,31
024 Kurtatsch a.d.Weinstr.,42,,14,21,35
024 Kurtatsch a.d.Weinstr.,43,,11,14,25
024 Kurtatsch a.d.Weinstr.,44,,15,19,34
024 Kurtatsch a.d.Weinstr.,45,,13,23,36
024 Kurtatsch a.d.Weinstr.,46,,25,22,47
024 Kurtatsch a.d.Weinstr.,47,,27,13,40
024 Kurtatsch a.d.Weinstr.,48,,17,22,39
024 Kurtatsch a.d.Weinstr.,49,,27,19,46
024 Kurtatsch a.d.Weinstr.,50,,25,26,51
024 Kurtatsch a.d.Weinstr.,51,,18,26,44
024 Kurtatsch a.d.Weinstr.,52,,21,19,40
024 Kurtatsch a.d.Weinstr.,53,,24,14,38
024 Kurtatsch a.d.Weinstr.,54,,18,18,36
024 Kurtatsch a.d.Weinstr.,55,,17,22,39
024 Kurtatsch a.d.Weinstr.,56,,20,9,29
024 Kurtatsch a.d.Weinstr.,57,,14,13,27
024 Kurtatsch a.d.Weinstr.,58,,14,11,25
024 Kurtatsch a.d.Weinstr.,59,,13,8,21
024 Kurtatsch a.d.Weinstr.,60,,12,20,32
024 Kurtatsch a.d.Weinstr.,61,,14,7,21
024 Kurtatsch a.d.Weinstr.,62,,16,19,35
024 Kurtatsch a.d.Weinstr.,63,,10,8,18
024 Kurtatsch a.d.Weinstr.,64,,9,13,22
024 Kurtatsch a.d.Weinstr.,65,,13,4,17
024 Kurtatsch a.d.Weinstr.,66,,11,9,20
024 Kurtatsch a.d.Weinstr.,67,,9,10,19
024 Kurtatsch a.d.Weinstr.,68,,9,10,19
024 Kurtatsch a.d.Weinstr.,69,,11,9,20
024 Kurtatsch a.d.Weinstr.,70,,6,8,14
024 Kurtatsch a.d.Weinstr.,71,,5,7,12
024 Kurtatsch a.d.Weinstr.,72,,10,6,16
024 Kurtatsch a.d.Weinstr.,73,,8,11,19
024 Kurtatsch a.d.Weinstr.,74,,7,11,18
024 Kurtatsch a.d.Weinstr.,75,,10,11,21
024 Kurtatsch a.d.Weinstr.,76,,3,14,17
024 Kurtatsch a.d.Weinstr.,77,,8,12,20
024 Kurtatsch a.d.Weinstr.,78,,4,9,13
024 Kurtatsch a.d.Weinstr.,79,,5,7,12
024 Kurtatsch a.d.Weinstr.,80,,4,7,11
024 Kurtatsch a.d.Weinstr.,81,,-,6,6
024 Kurtatsch a.d.Weinstr.,82,,8,6,14
024 Kurtatsch a.d.Weinstr.,83,,7,10,17
024 Kurtatsch a.d.Weinstr.,84,,4,7,11
024 Kurtatsch a.d.Weinstr.,85,,4,11,15
024 Kurtatsch a.d.Weinstr.,86,,5,6,11
024 Kurtatsch a.d.Weinstr.,87,,4,4,8
024 Kurtatsch a.d.Weinstr.,88,,3,4,7
024 Kurtatsch a.d.Weinstr.,89,,1,2,3
024 Kurtatsch a.d.Weinstr.,90,,2,4,6
024 Kurtatsch a.d.Weinstr.,91,,1,3,4
024 Kurtatsch a.d.Weinstr.,92,,2,4,6
024 Kurtatsch a.d.Weinstr.,94,,-,3,3
024 Kurtatsch a.d.Weinstr.,95,,3,1,4
024 Kurtatsch a.d.Weinstr.,98,,-,1,1
024 Kurtatsch a.d.Weinstr.,Insgesamt,,1.106,1.117,2.223
025 Kurtinig a.d. Weinstr.,0,,6,2,8
025 Kurtinig a.d. Weinstr.,1,,2,7,9
025 Kurtinig a.d. Weinstr.,2,,3,2,5
025 Kurtinig a.d. Weinstr.,3,,3,5,8
025 Kurtinig a.d. Weinstr.,4,,3,4,7
025 Kurtinig a.d. Weinstr.,5,,3,4,7
025 Kurtinig a.d. Weinstr.,6,,6,2,8
025 Kurtinig a.d. Weinstr.,7,,4,-,4
025 Kurtinig a.d. Weinstr.,8,,5,2,7
025 Kurtinig a.d. Weinstr.,9,,3,1,4
025 Kurtinig a.d. Weinstr.,10,,-,4,4
025 Kurtinig a.d. Weinstr.,11,,1,2,3
025 Kurtinig a.d. Weinstr.,12,,5,2,7
025 Kurtinig a.d. Weinstr.,13,,3,3,6
025 Kurtinig a.d. Weinstr.,14,,1,8,9
025 Kurtinig a.d. Weinstr.,15,,2,5,7
025 Kurtinig a.d. Weinstr.,16,,3,2,5
025 Kurtinig a.d. Weinstr.,17,,3,5,8
025 Kurtinig a.d. Weinstr.,18,,4,4,8
025 Kurtinig a.d. Weinstr.,19,,2,2,4
025 Kurtinig a.d. Weinstr.,20,,6,2,8
025 Kurtinig a.d. Weinstr.,21,,2,2,4
025 Kurtinig a.d. Weinstr.,22,,5,5,10
025 Kurtinig a.d. Weinstr.,23,,2,4,6
025 Kurtinig a.d. Weinstr.,24,,5,3,8
025 Kurtinig a.d. Weinstr.,25,,3,4,7
025 Kurtinig a.d. Weinstr.,26,,7,4,11
025 Kurtinig a.d. Weinstr.,27,,5,5,10
025 Kurtinig a.d. Weinstr.,28,,7,6,13
025 Kurtinig a.d. Weinstr.,29,,7,6,13
025 Kurtinig a.d. Weinstr.,30,,5,2,7
025 Kurtinig a.d. Weinstr.,31,,5,6,11
025 Kurtinig a.d. Weinstr.,32,,4,1,5
025 Kurtinig a.d. Weinstr.,33,,4,6,10
025 Kurtinig a.d. Weinstr.,34,,7,3,10
025 Kurtinig a.d. Weinstr.,35,,3,5,8
025 Kurtinig a.d. Weinstr.,36,,5,8,13
025 Kurtinig a.d. Weinstr.,37,,5,2,7
025 Kurtinig a.d. Weinstr.,38,,2,1,3
025 Kurtinig a.d. Weinstr.,39,,1,-,1
025 Kurtinig a.d. Weinstr.,40,,2,6,8
025 Kurtinig a.d. Weinstr.,41,,3,2,5
025 Kurtinig a.d. Weinstr.,42,,6,5,11
025 Kurtinig a.d. Weinstr.,43,,3,7,10
025 Kurtinig a.d. Weinstr.,44,,3,3,6
025 Kurtinig a.d. Weinstr.,45,,5,4,9
025 Kurtinig a.d. Weinstr.,46,,6,5,11
025 Kurtinig a.d. Weinstr.,47,,3,2,5
025 Kurtinig a.d. Weinstr.,48,,5,4,9
025 Kurtinig a.d. Weinstr.,49,,1,5,6
025 Kurtinig a.d. Weinstr.,50,,3,5,8
025 Kurtinig a.d. Weinstr.,51,,6,5,11
025 Kurtinig a.d. Weinstr.,52,,10,5,15
025 Kurtinig a.d. Weinstr.,53,,4,5,9
025 Kurtinig a.d. Weinstr.,54,,7,9,16
025 Kurtinig a.d. Weinstr.,55,,7,4,11
025 Kurtinig a.d. Weinstr.,56,,11,6,17
025 Kurtinig a.d. Weinstr.,57,,4,8,12
025 Kurtinig a.d. Weinstr.,58,,7,9,16
025 Kurtinig a.d. Weinstr.,59,,4,1,5
025 Kurtinig a.d. Weinstr.,60,,3,1,4
025 Kurtinig a.d. Weinstr.,61,,6,3,9
025 Kurtinig a.d. Weinstr.,62,,4,7,11
025 Kurtinig a.d. Weinstr.,63,,2,4,6
025 Kurtinig a.d. Weinstr.,64,,3,4,7
025 Kurtinig a.d. Weinstr.,65,,1,3,4
025 Kurtinig a.d. Weinstr.,66,,3,3,6
025 Kurtinig a.d. Weinstr.,67,,4,3,7
025 Kurtinig a.d. Weinstr.,68,,5,1,6
025 Kurtinig a.d. Weinstr.,69,,-,5,5
025 Kurtinig a.d. Weinstr.,70,,2,2,4
025 Kurtinig a.d. Weinstr.,71,,2,1,3
025 Kurtinig a.d. Weinstr.,72,,4,2,6
025 Kurtinig a.d. Weinstr.,73,,2,2,4
025 Kurtinig a.d. Weinstr.,74,,4,2,6
025 Kurtinig a.d. Weinstr.,75,,2,3,5
025 Kurtinig a.d. Weinstr.,76,,4,3,7
025 Kurtinig a.d. Weinstr.,77,,1,2,3
025 Kurtinig a.d. Weinstr.,78,,1,3,4
025 Kurtinig a.d. Weinstr.,79,,3,3,6
025 Kurtinig a.d. Weinstr.,80,,-,4,4
025 Kurtinig a.d. Weinstr.,81,,2,4,6
025 Kurtinig a.d. Weinstr.,82,,-,2,2
025 Kurtinig a.d. Weinstr.,83,,3,3,6
025 Kurtinig a.d. Weinstr.,84,,1,2,3
025 Kurtinig a.d. Weinstr.,85,,2,2,4
025 Kurtinig a.d. Weinstr.,86,,1,1,2
025 Kurtinig a.d. Weinstr.,87,,-,2,2
025 Kurtinig a.d. Weinstr.,88,,2,1,3
025 Kurtinig a.d. Weinstr.,90,,-,2,2
025 Kurtinig a.d. Weinstr.,91,,-,1,1
025 Kurtinig a.d. Weinstr.,94,,-,1,1
025 Kurtinig a.d. Weinstr.,97,,-,1,1
025 Kurtinig a.d. Weinstr.,Insgesamt,,319,324,643
026 Corvara,0,,7,6,13
026 Corvara,1,,8,11,19
026 Corvara,2,,4,10,14
026 Corvara,3,,9,7,16
026 Corvara,4,,6,2,8
026 Corvara,5,,12,8,20
026 Corvara,6,,9,7,16
026 Corvara,7,,6,6,12
026 Corvara,8,,5,10,15
026 Corvara,9,,8,3,11
026 Corvara,10,,8,7,15
026 Corvara,11,,6,3,9
026 Corvara,12,,12,5,17
026 Corvara,13,,5,3,8
026 Corvara,14,,5,6,11
026 Corvara,15,,8,4,12
026 Corvara,16,,8,7,15
026 Corvara,17,,10,8,18
026 Corvara,18,,3,5,8
026 Corvara,19,,9,4,13
026 Corvara,20,,8,7,15
026 Corvara,21,,8,4,12
026 Corvara,22,,5,3,8
026 Corvara,23,,6,10,16
026 Corvara,24,,4,8,12
026 Corvara,25,,11,7,18
026 Corvara,26,,7,4,11
026 Corvara,27,,5,5,10
026 Corvara,28,,9,7,16
026 Corvara,29,,5,1,6
026 Corvara,30,,6,12,18
026 Corvara,31,,5,3,8
026 Corvara,32,,6,5,11
026 Corvara,33,,11,14,25
026 Corvara,34,,13,4,17
026 Corvara,35,,9,9,18
026 Corvara,36,,9,9,18
026 Corvara,37,,12,4,16
026 Corvara,38,,15,11,26
026 Corvara,39,,13,6,19
026 Corvara,40,,8,22,30
026 Corvara,41,,6,14,20
026 Corvara,42,,10,13,23
026 Corvara,43,,10,8,18
026 Corvara,44,,12,6,18
026 Corvara,45,,10,14,24
026 Corvara,46,,16,14,30
026 Corvara,47,,8,15,23
026 Corvara,48,,15,20,35
026 Corvara,49,,13,17,30
026 Corvara,50,,16,18,34
026 Corvara,51,,7,9,16
026 Corvara,52,,15,7,22
026 Corvara,53,,14,12,26
026 Corvara,54,,8,8,16
026 Corvara,55,,14,13,27
026 Corvara,56,,8,7,15
026 Corvara,57,,11,9,20
026 Corvara,58,,8,4,12
026 Corvara,59,,5,5,10
026 Corvara,60,,11,7,18
026 Corvara,61,,8,9,17
026 Corvara,62,,5,12,17
026 Corvara,63,,4,8,12
026 Corvara,64,,4,9,13
026 Corvara,65,,6,8,14
026 Corvara,66,,2,9,11
026 Corvara,67,,5,5,10
026 Corvara,68,,3,9,12
026 Corvara,69,,10,9,19
026 Corvara,70,,5,3,8
026 Corvara,71,,5,9,14
026 Corvara,72,,4,10,14
026 Corvara,73,,6,8,14
026 Corvara,74,,9,9,18
026 Corvara,75,,8,6,14
026 Corvara,76,,5,5,10
026 Corvara,77,,3,7,10
026 Corvara,78,,6,8,14
026 Corvara,79,,3,6,9
026 Corvara,80,,5,3,8
026 Corvara,81,,2,8,10
026 Corvara,82,,3,3,6
026 Corvara,83,,4,4,8
026 Corvara,84,,3,6,9
026 Corvara,85,,2,3,5
026 Corvara,86,,3,4,7
026 Corvara,87,,1,1,2
026 Corvara,88,,3,1,4
026 Corvara,89,,1,-,1
026 Corvara,90,,1,2,3
026 Corvara,91,,1,-,1
026 Corvara,92,,3,1,4
026 Corvara,93,,1,1,2
026 Corvara,94,,1,-,1
026 Corvara,96,,1,-,1
026 Corvara,Insgesamt,,676,683,1.359
027 Graun im Vinschgau,0,,7,9,16
027 Graun im Vinschgau,1,,14,10,24
027 Graun im Vinschgau,2,,16,9,25
027 Graun im Vinschgau,3,,16,20,36
027 Graun im Vinschgau,4,,19,14,33
027 Graun im Vinschgau,5,,10,11,21
027 Graun im Vinschgau,6,,19,19,38
027 Graun im Vinschgau,7,,15,8,23
027 Graun im Vinschgau,8,,18,13,31
027 Graun im Vinschgau,9,,15,20,35
027 Graun im Vinschgau,10,,13,14,27
027 Graun im Vinschgau,11,,13,13,26
027 Graun im Vinschgau,12,,9,11,20
027 Graun im Vinschgau,13,,10,11,21
027 Graun im Vinschgau,14,,15,11,26
027 Graun im Vinschgau,15,,13,16,29
027 Graun im Vinschgau,16,,14,8,22
027 Graun im Vinschgau,17,,10,14,24
027 Graun im Vinschgau,18,,19,17,36
027 Graun im Vinschgau,19,,20,15,35
027 Graun im Vinschgau,20,,18,15,33
027 Graun im Vinschgau,21,,17,11,28
027 Graun im Vinschgau,22,,19,14,33
027 Graun im Vinschgau,23,,16,15,31
027 Graun im Vinschgau,24,,8,11,19
027 Graun im Vinschgau,25,,18,18,36
027 Graun im Vinschgau,26,,25,20,45
027 Graun im Vinschgau,27,,20,9,29
027 Graun im Vinschgau,28,,18,11,29
027 Graun im Vinschgau,29,,6,3,9
027 Graun im Vinschgau,30,,19,6,25
027 Graun im Vinschgau,31,,15,9,24
027 Graun im Vinschgau,32,,7,14,21
027 Graun im Vinschgau,33,,15,11,26
027 Graun im Vinschgau,34,,23,17,40
027 Graun im Vinschgau,35,,19,17,36
027 Graun im Vinschgau,36,,13,16,29
027 Graun im Vinschgau,37,,14,14,28
027 Graun im Vinschgau,38,,15,21,36
027 Graun im Vinschgau,39,,13,20,33
027 Graun im Vinschgau,40,,20,15,35
027 Graun im Vinschgau,41,,19,15,34
027 Graun im Vinschgau,42,,17,19,36
027 Graun im Vinschgau,43,,20,18,38
027 Graun im Vinschgau,44,,21,11,32
027 Graun im Vinschgau,45,,20,15,35
027 Graun im Vinschgau,46,,23,18,41
027 Graun im Vinschgau,47,,15,21,36
027 Graun im Vinschgau,48,,22,19,41
027 Graun im Vinschgau,49,,18,23,41
027 Graun im Vinschgau,50,,15,19,34
027 Graun im Vinschgau,51,,22,22,44
027 Graun im Vinschgau,52,,21,17,38
027 Graun im Vinschgau,53,,21,23,44
027 Graun im Vinschgau,54,,19,12,31
027 Graun im Vinschgau,55,,19,19,38
027 Graun im Vinschgau,56,,18,11,29
027 Graun im Vinschgau,57,,17,15,32
027 Graun im Vinschgau,58,,11,13,24
027 Graun im Vinschgau,59,,13,9,22
027 Graun im Vinschgau,60,,13,8,21
027 Graun im Vinschgau,61,,15,13,28
027 Graun im Vinschgau,62,,12,7,19
027 Graun im Vinschgau,63,,15,10,25
027 Graun im Vinschgau,64,,11,16,27
027 Graun im Vinschgau,65,,9,12,21
027 Graun im Vinschgau,66,,7,20,27
027 Graun im Vinschgau,67,,14,11,25
027 Graun im Vinschgau,68,,5,10,15
027 Graun im Vinschgau,69,,10,7,17
027 Graun im Vinschgau,70,,6,6,12
027 Graun im Vinschgau,71,,9,9,18
027 Graun im Vinschgau,72,,8,11,19
027 Graun im Vinschgau,73,,8,10,18
027 Graun im Vinschgau,74,,14,10,24
027 Graun im Vinschgau,75,,11,10,21
027 Graun im Vinschgau,76,,8,10,18
027 Graun im Vinschgau,77,,8,12,20
027 Graun im Vinschgau,78,,10,3,13
027 Graun im Vinschgau,79,,10,12,22
027 Graun im Vinschgau,80,,5,7,12
027 Graun im Vinschgau,81,,10,7,17
027 Graun im Vinschgau,82,,4,7,11
027 Graun im Vinschgau,83,,7,3,10
027 Graun im Vinschgau,84,,4,6,10
027 Graun im Vinschgau,85,,2,5,7
027 Graun im Vinschgau,86,,3,10,13
027 Graun im Vinschgau,87,,4,6,10
027 Graun im Vinschgau,88,,3,6,9
027 Graun im Vinschgau,89,,2,9,11
027 Graun im Vinschgau,90,,-,3,3
027 Graun im Vinschgau,91,,1,2,3
027 Graun im Vinschgau,92,,2,5,7
027 Graun im Vinschgau,93,,-,2,2
027 Graun im Vinschgau,94,,-,1,1
027 Graun im Vinschgau,95,,1,-,1
027 Graun im Vinschgau,Insgesamt,,1.225,1.155,2.380
028 Toblach,0,,20,16,36
028 Toblach,1,,18,11,29
028 Toblach,2,,23,15,38
028 Toblach,3,,18,25,43
028 Toblach,4,,16,24,40
028 Toblach,5,,18,23,41
028 Toblach,6,,18,17,35
028 Toblach,7,,22,22,44
028 Toblach,8,,23,16,39
028 Toblach,9,,23,9,32
028 Toblach,10,,15,20,35
028 Toblach,11,,20,23,43
028 Toblach,12,,20,26,46
028 Toblach,13,,13,18,31
028 Toblach,14,,25,18,43
028 Toblach,15,,23,18,41
028 Toblach,16,,16,22,38
028 Toblach,17,,17,14,31
028 Toblach,18,,24,16,40
028 Toblach,19,,25,19,44
028 Toblach,20,,18,10,28
028 Toblach,21,,20,14,34
028 Toblach,22,,19,19,38
028 Toblach,23,,13,17,30
028 Toblach,24,,20,23,43
028 Toblach,25,,15,25,40
028 Toblach,26,,12,15,27
028 Toblach,27,,16,23,39
028 Toblach,28,,33,16,49
028 Toblach,29,,13,20,33
028 Toblach,30,,23,19,42
028 Toblach,31,,23,22,45
028 Toblach,32,,20,26,46
028 Toblach,33,,23,27,50
028 Toblach,34,,23,20,43
028 Toblach,35,,20,27,47
028 Toblach,36,,23,24,47
028 Toblach,37,,18,17,35
028 Toblach,38,,13,21,34
028 Toblach,39,,28,34,62
028 Toblach,40,,21,21,42
028 Toblach,41,,28,22,50
028 Toblach,42,,31,25,56
028 Toblach,43,,25,31,56
028 Toblach,44,,27,22,49
028 Toblach,45,,23,23,46
028 Toblach,46,,41,23,64
028 Toblach,47,,29,26,55
028 Toblach,48,,26,20,46
028 Toblach,49,,33,30,63
028 Toblach,50,,30,31,61
028 Toblach,51,,39,29,68
028 Toblach,52,,25,26,51
028 Toblach,53,,35,25,60
028 Toblach,54,,22,34,56
028 Toblach,55,,22,18,40
028 Toblach,56,,33,25,58
028 Toblach,57,,19,16,35
028 Toblach,58,,28,24,52
028 Toblach,59,,16,24,40
028 Toblach,60,,15,25,40
028 Toblach,61,,20,18,38
028 Toblach,62,,20,24,44
028 Toblach,63,,19,15,34
028 Toblach,64,,23,10,33
028 Toblach,65,,13,15,28
028 Toblach,66,,19,12,31
028 Toblach,67,,16,24,40
028 Toblach,68,,16,16,32
028 Toblach,69,,12,14,26
028 Toblach,70,,8,17,25
028 Toblach,71,,14,10,24
028 Toblach,72,,13,17,30
028 Toblach,73,,12,17,29
028 Toblach,74,,16,13,29
028 Toblach,75,,10,12,22
028 Toblach,76,,13,10,23
028 Toblach,77,,13,6,19
028 Toblach,78,,2,10,12
028 Toblach,79,,4,13,17
028 Toblach,80,,5,14,19
028 Toblach,81,,10,14,24
028 Toblach,82,,6,8,14
028 Toblach,83,,7,12,19
028 Toblach,84,,7,10,17
028 Toblach,85,,6,6,12
028 Toblach,86,,4,8,12
028 Toblach,87,,5,6,11
028 Toblach,88,,3,3,6
028 Toblach,89,,2,4,6
028 Toblach,90,,3,2,5
028 Toblach,91,,2,3,5
028 Toblach,92,,3,1,4
028 Toblach,93,,2,2,4
028 Toblach,94,,-,2,2
028 Toblach,95,,2,1,3
028 Toblach,Insgesamt,,1.688,1.680,3.368
029 Neumarkt,0,,19,25,44
029 Neumarkt,1,,30,27,57
029 Neumarkt,2,,23,24,47
029 Neumarkt,3,,37,35,72
029 Neumarkt,4,,28,19,47
029 Neumarkt,5,,28,30,58
029 Neumarkt,6,,33,28,61
029 Neumarkt,7,,31,27,58
029 Neumarkt,8,,29,24,53
029 Neumarkt,9,,28,27,55
029 Neumarkt,10,,37,34,71
029 Neumarkt,11,,26,19,45
029 Neumarkt,12,,35,30,65
029 Neumarkt,13,,28,23,51
029 Neumarkt,14,,33,33,66
029 Neumarkt,15,,30,25,55
029 Neumarkt,16,,26,26,52
029 Neumarkt,17,,23,43,66
029 Neumarkt,18,,23,19,42
029 Neumarkt,19,,21,25,46
029 Neumarkt,20,,27,24,51
029 Neumarkt,21,,28,27,55
029 Neumarkt,22,,24,35,59
029 Neumarkt,23,,29,33,62
029 Neumarkt,24,,28,26,54
029 Neumarkt,25,,29,31,60
029 Neumarkt,26,,26,33,59
029 Neumarkt,27,,27,29,56
029 Neumarkt,28,,23,30,53
029 Neumarkt,29,,27,26,53
029 Neumarkt,30,,23,16,39
029 Neumarkt,31,,31,31,62
029 Neumarkt,32,,31,29,60
029 Neumarkt,33,,32,27,59
029 Neumarkt,34,,33,29,62
029 Neumarkt,35,,33,51,84
029 Neumarkt,36,,37,34,71
029 Neumarkt,37,,39,41,80
029 Neumarkt,38,,28,34,62
029 Neumarkt,39,,38,35,73
029 Neumarkt,40,,40,44,84
029 Neumarkt,41,,39,43,82
029 Neumarkt,42,,33,36,69
029 Neumarkt,43,,40,33,73
029 Neumarkt,44,,33,47,80
029 Neumarkt,45,,39,39,78
029 Neumarkt,46,,41,36,77
029 Neumarkt,47,,32,54,86
029 Neumarkt,48,,49,50,99
029 Neumarkt,49,,54,56,110
029 Neumarkt,50,,55,42,97
029 Neumarkt,51,,49,50,99
029 Neumarkt,52,,49,48,97
029 Neumarkt,53,,44,37,81
029 Neumarkt,54,,36,47,83
029 Neumarkt,55,,52,38,90
029 Neumarkt,56,,47,30,77
029 Neumarkt,57,,29,38,67
029 Neumarkt,58,,42,33,75
029 Neumarkt,59,,28,33,61
029 Neumarkt,60,,41,43,84
029 Neumarkt,61,,34,28,62
029 Neumarkt,62,,17,17,34
029 Neumarkt,63,,29,22,51
029 Neumarkt,64,,25,24,49
029 Neumarkt,65,,20,26,46
029 Neumarkt,66,,16,24,40
029 Neumarkt,67,,21,25,46
029 Neumarkt,68,,24,30,54
029 Neumarkt,69,,30,36,66
029 Neumarkt,70,,19,23,42
029 Neumarkt,71,,17,18,35
029 Neumarkt,72,,19,22,41
029 Neumarkt,73,,24,22,46
029 Neumarkt,74,,33,23,56
029 Neumarkt,75,,21,30,51
029 Neumarkt,76,,15,25,40
029 Neumarkt,77,,21,13,34
029 Neumarkt,78,,19,13,32
029 Neumarkt,79,,15,17,32
029 Neumarkt,80,,12,20,32
029 Neumarkt,81,,11,16,27
029 Neumarkt,82,,14,13,27
029 Neumarkt,83,,12,24,36
029 Neumarkt,84,,16,27,43
029 Neumarkt,85,,6,21,27
029 Neumarkt,86,,8,15,23
029 Neumarkt,87,,2,13,15
029 Neumarkt,88,,6,8,14
029 Neumarkt,89,,6,13,19
029 Neumarkt,90,,5,12,17
029 Neumarkt,91,,-,9,9
029 Neumarkt,92,,5,2,7
029 Neumarkt,93,,1,2,3
029 Neumarkt,94,,1,4,5
029 Neumarkt,95,,1,4,5
029 Neumarkt,96,,2,1,3
029 Neumarkt,98,,-,1,1
029 Neumarkt,Insgesamt,,2.560,2.684,5.244
030 Pfalzen,0,,14,16,30
030 Pfalzen,1,,15,6,21
030 Pfalzen,2,,14,25,39
030 Pfalzen,3,,20,12,32
030 Pfalzen,4,,18,24,42
030 Pfalzen,5,,19,14,33
030 Pfalzen,6,,16,18,34
030 Pfalzen,7,,17,21,38
030 Pfalzen,8,,13,9,22
030 Pfalzen,9,,21,22,43
030 Pfalzen,10,,19,17,36
030 Pfalzen,11,,13,21,34
030 Pfalzen,12,,21,13,34
030 Pfalzen,13,,13,18,31
030 Pfalzen,14,,18,13,31
030 Pfalzen,15,,16,18,34
030 Pfalzen,16,,21,20,41
030 Pfalzen,17,,16,16,32
030 Pfalzen,18,,14,16,30
030 Pfalzen,19,,16,16,32
030 Pfalzen,20,,23,19,42
030 Pfalzen,21,,12,18,30
030 Pfalzen,22,,12,16,28
030 Pfalzen,23,,12,20,32
030 Pfalzen,24,,13,19,32
030 Pfalzen,25,,19,13,32
030 Pfalzen,26,,18,27,45
030 Pfalzen,27,,17,9,26
030 Pfalzen,28,,12,22,34
030 Pfalzen,29,,17,17,34
030 Pfalzen,30,,23,14,37
030 Pfalzen,31,,21,12,33
030 Pfalzen,32,,12,11,23
030 Pfalzen,33,,19,19,38
030 Pfalzen,34,,20,19,39
030 Pfalzen,35,,25,22,47
030 Pfalzen,36,,23,23,46
030 Pfalzen,37,,18,25,43
030 Pfalzen,38,,21,25,46
030 Pfalzen,39,,15,12,27
030 Pfalzen,40,,16,15,31
030 Pfalzen,41,,25,16,41
030 Pfalzen,42,,18,26,44
030 Pfalzen,43,,24,25,49
030 Pfalzen,44,,30,24,54
030 Pfalzen,45,,20,24,44
030 Pfalzen,46,,29,14,43
030 Pfalzen,47,,27,35,62
030 Pfalzen,48,,21,22,43
030 Pfalzen,49,,24,21,45
030 Pfalzen,50,,24,27,51
030 Pfalzen,51,,19,22,41
030 Pfalzen,52,,30,20,50
030 Pfalzen,53,,24,31,55
030 Pfalzen,54,,26,23,49
030 Pfalzen,55,,22,15,37
030 Pfalzen,56,,15,18,33
030 Pfalzen,57,,16,21,37
030 Pfalzen,58,,25,19,44
030 Pfalzen,59,,17,15,32
030 Pfalzen,60,,17,14,31
030 Pfalzen,61,,17,11,28
030 Pfalzen,62,,14,12,26
030 Pfalzen,63,,10,10,20
030 Pfalzen,64,,16,16,32
030 Pfalzen,65,,11,13,24
030 Pfalzen,66,,16,7,23
030 Pfalzen,67,,11,11,22
030 Pfalzen,68,,12,2,14
030 Pfalzen,69,,7,10,17
030 Pfalzen,70,,6,8,14
030 Pfalzen,71,,11,5,16
030 Pfalzen,72,,8,10,18
030 Pfalzen,73,,7,11,18
030 Pfalzen,74,,10,7,17
030 Pfalzen,75,,12,9,21
030 Pfalzen,76,,8,5,13
030 Pfalzen,77,,11,10,21
030 Pfalzen,78,,5,5,10
030 Pfalzen,79,,2,7,9
030 Pfalzen,80,,5,7,12
030 Pfalzen,81,,7,6,13
030 Pfalzen,82,,4,6,10
030 Pfalzen,83,,5,3,8
030 Pfalzen,84,,8,7,15
030 Pfalzen,85,,4,6,10
030 Pfalzen,86,,5,3,8
030 Pfalzen,87,,-,2,2
030 Pfalzen,88,,3,3,6
030 Pfalzen,89,,-,2,2
030 Pfalzen,90,,2,2,4
030 Pfalzen,91,,1,2,3
030 Pfalzen,92,,2,2,4
030 Pfalzen,93,,1,-,1
030 Pfalzen,94,,-,1,1
030 Pfalzen,Insgesamt,,1.396,1.365,2.761
031 Völs am Schlern,0,,17,16,33
031 Völs am Schlern,1,,23,18,41
031 Völs am Schlern,2,,21,16,37
031 Völs am Schlern,3,,17,26,43
031 Völs am Schlern,4,,14,20,34
031 Völs am Schlern,5,,27,17,44
031 Völs am Schlern,6,,24,19,43
031 Völs am Schlern,7,,23,33,56
031 Völs am Schlern,8,,20,24,44
031 Völs am Schlern,9,,20,25,45
031 Völs am Schlern,10,,34,15,49
031 Völs am Schlern,11,,19,12,31
031 Völs am Schlern,12,,16,22,38
031 Völs am Schlern,13,,16,31,47
031 Völs am Schlern,14,,18,29,47
031 Völs am Schlern,15,,23,26,49
031 Völs am Schlern,16,,19,18,37
031 Völs am Schlern,17,,26,30,56
031 Völs am Schlern,18,,20,25,45
031 Völs am Schlern,19,,15,20,35
031 Völs am Schlern,20,,25,24,49
031 Völs am Schlern,21,,20,15,35
031 Völs am Schlern,22,,16,13,29
031 Völs am Schlern,23,,22,17,39
031 Völs am Schlern,24,,13,22,35
031 Völs am Schlern,25,,20,18,38
031 Völs am Schlern,26,,29,19,48
031 Völs am Schlern,27,,14,15,29
031 Völs am Schlern,28,,22,19,41
031 Völs am Schlern,29,,25,18,43
031 Völs am Schlern,30,,15,18,33
031 Völs am Schlern,31,,18,9,27
031 Völs am Schlern,32,,15,31,46
031 Völs am Schlern,33,,26,27,53
031 Völs am Schlern,34,,38,21,59
031 Völs am Schlern,35,,34,17,51
031 Völs am Schlern,36,,33,32,65
031 Völs am Schlern,37,,26,23,49
031 Völs am Schlern,38,,22,24,46
031 Völs am Schlern,39,,29,25,54
031 Völs am Schlern,40,,20,18,38
031 Völs am Schlern,41,,29,25,54
031 Völs am Schlern,42,,29,31,60
031 Völs am Schlern,43,,42,28,70
031 Völs am Schlern,44,,41,41,82
031 Völs am Schlern,45,,32,39,71
031 Völs am Schlern,46,,37,34,71
031 Völs am Schlern,47,,37,37,74
031 Völs am Schlern,48,,28,25,53
031 Völs am Schlern,49,,34,31,65
031 Völs am Schlern,50,,26,30,56
031 Völs am Schlern,51,,29,25,54
031 Völs am Schlern,52,,26,22,48
031 Völs am Schlern,53,,26,22,48
031 Völs am Schlern,54,,24,24,48
031 Völs am Schlern,55,,20,19,39
031 Völs am Schlern,56,,22,13,35
031 Völs am Schlern,57,,18,14,32
031 Völs am Schlern,58,,17,18,35
031 Völs am Schlern,59,,17,17,34
031 Völs am Schlern,60,,16,14,30
031 Völs am Schlern,61,,18,26,44
031 Völs am Schlern,62,,16,25,41
031 Völs am Schlern,63,,18,18,36
031 Völs am Schlern,64,,18,22,40
031 Völs am Schlern,65,,19,16,35
031 Völs am Schlern,66,,14,9,23
031 Völs am Schlern,67,,16,15,31
031 Völs am Schlern,68,,13,18,31
031 Völs am Schlern,69,,15,11,26
031 Völs am Schlern,70,,6,10,16
031 Völs am Schlern,71,,12,8,20
031 Völs am Schlern,72,,15,19,34
031 Völs am Schlern,73,,15,18,33
031 Völs am Schlern,74,,16,16,32
031 Völs am Schlern,75,,8,22,30
031 Völs am Schlern,76,,12,10,22
031 Völs am Schlern,77,,10,14,24
031 Völs am Schlern,78,,9,9,18
031 Völs am Schlern,79,,5,17,22
031 Völs am Schlern,80,,12,11,23
031 Völs am Schlern,81,,11,6,17
031 Völs am Schlern,82,,4,12,16
031 Völs am Schlern,83,,11,6,17
031 Völs am Schlern,84,,7,10,17
031 Völs am Schlern,85,,2,9,11
031 Völs am Schlern,86,,2,6,8
031 Völs am Schlern,87,,2,9,11
031 Völs am Schlern,88,,2,5,7
031 Völs am Schlern,89,,5,2,7
031 Völs am Schlern,90,,3,5,8
031 Völs am Schlern,91,,3,6,9
031 Völs am Schlern,92,,1,1,2
031 Völs am Schlern,93,,-,3,3
031 Völs am Schlern,94,,-,4,4
031 Völs am Schlern,95,,-,2,2
031 Völs am Schlern,96,,-,1,1
031 Völs am Schlern,97,,-,1,1
031 Völs am Schlern,98,,1,-,1
031 Völs am Schlern,Insgesamt,,1.765,1.778,3.543
032 Franzensfeste,0,,8,5,13
032 Franzensfeste,1,,6,14,20
032 Franzensfeste,2,,4,4,8
032 Franzensfeste,3,,5,8,13
032 Franzensfeste,4,,6,8,14
032 Franzensfeste,5,,11,8,19
032 Franzensfeste,6,,4,5,9
032 Franzensfeste,7,,7,6,13
032 Franzensfeste,8,,9,6,15
032 Franzensfeste,9,,4,5,9
032 Franzensfeste,10,,4,5,9
032 Franzensfeste,11,,6,5,11
032 Franzensfeste,12,,10,3,13
032 Franzensfeste,13,,8,1,9
032 Franzensfeste,14,,3,5,8
032 Franzensfeste,15,,3,5,8
032 Franzensfeste,16,,4,4,8
032 Franzensfeste,17,,6,6,12
032 Franzensfeste,18,,4,6,10
032 Franzensfeste,19,,6,4,10
032 Franzensfeste,20,,5,3,8
032 Franzensfeste,21,,7,7,14
032 Franzensfeste,22,,9,6,15
032 Franzensfeste,23,,9,7,16
032 Franzensfeste,24,,4,6,10
032 Franzensfeste,25,,2,8,10
032 Franzensfeste,26,,6,3,9
032 Franzensfeste,27,,1,5,6
032 Franzensfeste,28,,11,5,16
032 Franzensfeste,29,,5,4,9
032 Franzensfeste,30,,7,8,15
032 Franzensfeste,31,,6,6,12
032 Franzensfeste,32,,5,9,14
032 Franzensfeste,33,,4,10,14
032 Franzensfeste,34,,7,5,12
032 Franzensfeste,35,,11,10,21
032 Franzensfeste,36,,11,4,15
032 Franzensfeste,37,,9,12,21
032 Franzensfeste,38,,4,6,10
032 Franzensfeste,39,,5,3,8
032 Franzensfeste,40,,9,11,20
032 Franzensfeste,41,,13,5,18
032 Franzensfeste,42,,1,5,6
032 Franzensfeste,43,,8,7,15
032 Franzensfeste,44,,5,6,11
032 Franzensfeste,45,,7,6,13
032 Franzensfeste,46,,8,7,15
032 Franzensfeste,47,,7,12,19
032 Franzensfeste,48,,10,4,14
032 Franzensfeste,49,,9,5,14
032 Franzensfeste,50,,9,9,18
032 Franzensfeste,51,,15,8,23
032 Franzensfeste,52,,9,10,19
032 Franzensfeste,53,,12,5,17
032 Franzensfeste,54,,5,4,9
032 Franzensfeste,55,,1,8,9
032 Franzensfeste,56,,6,7,13
032 Franzensfeste,57,,10,3,13
032 Franzensfeste,58,,4,6,10
032 Franzensfeste,59,,5,6,11
032 Franzensfeste,60,,8,7,15
032 Franzensfeste,61,,8,8,16
032 Franzensfeste,62,,3,8,11
032 Franzensfeste,63,,3,3,6
032 Franzensfeste,64,,6,1,7
032 Franzensfeste,65,,12,3,15
032 Franzensfeste,66,,3,4,7
032 Franzensfeste,67,,4,3,7
032 Franzensfeste,68,,2,3,5
032 Franzensfeste,69,,8,5,13
032 Franzensfeste,70,,3,6,9
032 Franzensfeste,71,,3,7,10
032 Franzensfeste,72,,3,1,4
032 Franzensfeste,73,,4,-,4
032 Franzensfeste,74,,4,3,7
032 Franzensfeste,75,,2,3,5
032 Franzensfeste,76,,3,2,5
032 Franzensfeste,77,,1,3,4
032 Franzensfeste,78,,6,5,11
032 Franzensfeste,79,,-,1,1
032 Franzensfeste,80,,-,2,2
032 Franzensfeste,81,,2,3,5
032 Franzensfeste,82,,-,4,4
032 Franzensfeste,83,,3,4,7
032 Franzensfeste,84,,1,3,4
032 Franzensfeste,85,,5,3,8
032 Franzensfeste,86,,-,2,2
032 Franzensfeste,87,,-,3,3
032 Franzensfeste,88,,2,1,3
032 Franzensfeste,89,,-,4,4
032 Franzensfeste,90,,1,1,2
032 Franzensfeste,91,,1,2,3
032 Franzensfeste,92,,-,5,5
032 Franzensfeste,93,,2,2,4
032 Franzensfeste,94,,-,1,1
032 Franzensfeste,Insgesamt,,502,490,992
033 Villnöss,0,,15,20,35
033 Villnöss,1,,17,13,30
033 Villnöss,2,,12,11,23
033 Villnöss,3,,20,16,36
033 Villnöss,4,,10,20,30
033 Villnöss,5,,17,19,36
033 Villnöss,6,,18,13,31
033 Villnöss,7,,18,10,28
033 Villnöss,8,,15,14,29
033 Villnöss,9,,15,24,39
033 Villnöss,10,,19,22,41
033 Villnöss,11,,10,16,26
033 Villnöss,12,,17,14,31
033 Villnöss,13,,21,14,35
033 Villnöss,14,,15,24,39
033 Villnöss,15,,17,16,33
033 Villnöss,16,,16,30,46
033 Villnöss,17,,24,19,43
033 Villnöss,18,,20,23,43
033 Villnöss,19,,20,17,37
033 Villnöss,20,,18,13,31
033 Villnöss,21,,15,11,26
033 Villnöss,22,,17,12,29
033 Villnöss,23,,13,13,26
033 Villnöss,24,,21,13,34
033 Villnöss,25,,13,9,22
033 Villnöss,26,,13,11,24
033 Villnöss,27,,15,18,33
033 Villnöss,28,,16,17,33
033 Villnöss,29,,12,13,25
033 Villnöss,30,,12,16,28
033 Villnöss,31,,17,17,34
033 Villnöss,32,,16,14,30
033 Villnöss,33,,10,11,21
033 Villnöss,34,,11,17,28
033 Villnöss,35,,23,10,33
033 Villnöss,36,,8,12,20
033 Villnöss,37,,16,15,31
033 Villnöss,38,,13,12,25
033 Villnöss,39,,17,13,30
033 Villnöss,40,,20,14,34
033 Villnöss,41,,19,15,34
033 Villnöss,42,,13,17,30
033 Villnöss,43,,17,28,45
033 Villnöss,44,,22,24,46
033 Villnöss,45,,17,28,45
033 Villnöss,46,,28,21,49
033 Villnöss,47,,28,19,47
033 Villnöss,48,,17,21,38
033 Villnöss,49,,25,20,45
033 Villnöss,50,,30,22,52
033 Villnöss,51,,30,24,54
033 Villnöss,52,,31,21,52
033 Villnöss,53,,28,21,49
033 Villnöss,54,,20,14,34
033 Villnöss,55,,21,11,32
033 Villnöss,56,,11,10,21
033 Villnöss,57,,10,14,24
033 Villnöss,58,,14,14,28
033 Villnöss,59,,14,17,31
033 Villnöss,60,,12,3,15
033 Villnöss,61,,16,13,29
033 Villnöss,62,,12,15,27
033 Villnöss,63,,10,13,23
033 Villnöss,64,,11,10,21
033 Villnöss,65,,6,8,14
033 Villnöss,66,,7,13,20
033 Villnöss,67,,8,10,18
033 Villnöss,68,,13,11,24
033 Villnöss,69,,9,5,14
033 Villnöss,70,,8,5,13
033 Villnöss,71,,6,12,18
033 Villnöss,72,,12,8,20
033 Villnöss,73,,12,19,31
033 Villnöss,74,,10,9,19
033 Villnöss,75,,6,17,23
033 Villnöss,76,,8,14,22
033 Villnöss,77,,10,8,18
033 Villnöss,78,,6,14,20
033 Villnöss,79,,4,15,19
033 Villnöss,80,,2,8,10
033 Villnöss,81,,6,8,14
033 Villnöss,82,,8,8,16
033 Villnöss,83,,10,11,21
033 Villnöss,84,,7,9,16
033 Villnöss,85,,5,10,15
033 Villnöss,86,,5,7,12
033 Villnöss,87,,7,6,13
033 Villnöss,88,,4,5,9
033 Villnöss,89,,2,5,7
033 Villnöss,90,,1,4,5
033 Villnöss,91,,2,3,5
033 Villnöss,92,,1,6,7
033 Villnöss,93,,1,4,5
033 Villnöss,94,,-,1,1
033 Villnöss,95,,-,3,3
033 Villnöss,96,,-,1,1
033 Villnöss,Insgesamt,,1.294,1.318,2.612
034 Gais,0,,17,14,31
034 Gais,1,,18,12,30
034 Gais,2,,19,13,32
034 Gais,3,,16,15,31
034 Gais,4,,20,20,40
034 Gais,5,,29,16,45
034 Gais,6,,27,12,39
034 Gais,7,,13,18,31
034 Gais,8,,17,19,36
034 Gais,9,,22,14,36
034 Gais,10,,27,17,44
034 Gais,11,,15,25,40
034 Gais,12,,16,17,33
034 Gais,13,,21,23,44
034 Gais,14,,20,17,37
034 Gais,15,,22,17,39
034 Gais,16,,21,23,44
034 Gais,17,,25,19,44
034 Gais,18,,29,14,43
034 Gais,19,,9,17,26
034 Gais,20,,25,18,43
034 Gais,21,,25,26,51
034 Gais,22,,15,16,31
034 Gais,23,,20,28,48
034 Gais,24,,23,25,48
034 Gais,25,,14,17,31
034 Gais,26,,18,15,33
034 Gais,27,,21,17,38
034 Gais,28,,14,15,29
034 Gais,29,,14,21,35
034 Gais,30,,17,13,30
034 Gais,31,,28,20,48
034 Gais,32,,18,22,40
034 Gais,33,,23,19,42
034 Gais,34,,20,22,42
034 Gais,35,,27,28,55
034 Gais,36,,19,17,36
034 Gais,37,,20,22,42
034 Gais,38,,17,23,40
034 Gais,39,,23,22,45
034 Gais,40,,23,25,48
034 Gais,41,,34,29,63
034 Gais,42,,26,23,49
034 Gais,43,,31,40,71
034 Gais,44,,34,27,61
034 Gais,45,,27,26,53
034 Gais,46,,38,32,70
034 Gais,47,,26,21,47
034 Gais,48,,29,32,61
034 Gais,49,,30,23,53
034 Gais,50,,24,25,49
034 Gais,51,,29,30,59
034 Gais,52,,20,18,38
034 Gais,53,,28,22,50
034 Gais,54,,20,25,45
034 Gais,55,,18,12,30
034 Gais,56,,17,22,39
034 Gais,57,,23,18,41
034 Gais,58,,10,16,26
034 Gais,59,,23,19,42
034 Gais,60,,18,10,28
034 Gais,61,,16,14,30
034 Gais,62,,12,12,24
034 Gais,63,,14,18,32
034 Gais,64,,15,20,35
034 Gais,65,,20,23,43
034 Gais,66,,14,11,25
034 Gais,67,,21,13,34
034 Gais,68,,20,11,31
034 Gais,69,,17,15,32
034 Gais,70,,12,8,20
034 Gais,71,,12,14,26
034 Gais,72,,10,15,25
034 Gais,73,,10,13,23
034 Gais,74,,17,12,29
034 Gais,75,,15,12,27
034 Gais,76,,11,14,25
034 Gais,77,,14,13,27
034 Gais,78,,13,13,26
034 Gais,79,,7,12,19
034 Gais,80,,9,11,20
034 Gais,81,,4,5,9
034 Gais,82,,4,9,13
034 Gais,83,,3,6,9
034 Gais,84,,6,3,9
034 Gais,85,,4,8,12
034 Gais,86,,-,1,1
034 Gais,87,,2,5,7
034 Gais,88,,4,6,10
034 Gais,89,,4,4,8
034 Gais,90,,1,1,2
034 Gais,91,,1,2,3
034 Gais,92,,-,3,3
034 Gais,93,,-,1,1
034 Gais,94,,-,1,1
034 Gais,95,,1,-,1
034 Gais,97,,1,1,2
034 Gais,Insgesamt,,1.646,1.573,3.219
035 Gargazon,0,,9,11,20
035 Gargazon,1,,11,6,17
035 Gargazon,2,,11,7,18
035 Gargazon,3,,7,10,17
035 Gargazon,4,,8,8,16
035 Gargazon,5,,7,13,20
035 Gargazon,6,,7,11,18
035 Gargazon,7,,13,7,20
035 Gargazon,8,,8,6,14
035 Gargazon,9,,10,13,23
035 Gargazon,10,,7,7,14
035 Gargazon,11,,8,7,15
035 Gargazon,12,,5,13,18
035 Gargazon,13,,6,11,17
035 Gargazon,14,,4,7,11
035 Gargazon,15,,11,5,16
035 Gargazon,16,,15,8,23
035 Gargazon,17,,14,9,23
035 Gargazon,18,,5,14,19
035 Gargazon,19,,9,6,15
035 Gargazon,20,,11,3,14
035 Gargazon,21,,5,9,14
035 Gargazon,22,,10,8,18
035 Gargazon,23,,14,9,23
035 Gargazon,24,,16,10,26
035 Gargazon,25,,6,14,20
035 Gargazon,26,,10,4,14
035 Gargazon,27,,12,8,20
035 Gargazon,28,,10,10,20
035 Gargazon,29,,7,11,18
035 Gargazon,30,,17,8,25
035 Gargazon,31,,7,10,17
035 Gargazon,32,,7,13,20
035 Gargazon,33,,9,5,14
035 Gargazon,34,,11,10,21
035 Gargazon,35,,12,12,24
035 Gargazon,36,,5,6,11
035 Gargazon,37,,6,17,23
035 Gargazon,38,,11,12,23
035 Gargazon,39,,4,13,17
035 Gargazon,40,,10,10,20
035 Gargazon,41,,13,15,28
035 Gargazon,42,,11,9,20
035 Gargazon,43,,13,19,32
035 Gargazon,44,,16,15,31
035 Gargazon,45,,16,12,28
035 Gargazon,46,,21,15,36
035 Gargazon,47,,19,19,38
035 Gargazon,48,,11,14,25
035 Gargazon,49,,13,16,29
035 Gargazon,50,,13,9,22
035 Gargazon,51,,18,17,35
035 Gargazon,52,,18,19,37
035 Gargazon,53,,18,14,32
035 Gargazon,54,,8,15,23
035 Gargazon,55,,10,12,22
035 Gargazon,56,,18,15,33
035 Gargazon,57,,6,12,18
035 Gargazon,58,,14,13,27
035 Gargazon,59,,12,7,19
035 Gargazon,60,,9,5,14
035 Gargazon,61,,10,10,20
035 Gargazon,62,,18,11,29
035 Gargazon,63,,4,9,13
035 Gargazon,64,,9,8,17
035 Gargazon,65,,8,8,16
035 Gargazon,66,,6,9,15
035 Gargazon,67,,7,8,15
035 Gargazon,68,,5,7,12
035 Gargazon,69,,11,14,25
035 Gargazon,70,,10,6,16
035 Gargazon,71,,2,4,6
035 Gargazon,72,,6,10,16
035 Gargazon,73,,4,8,12
035 Gargazon,74,,9,9,18
035 Gargazon,75,,4,16,20
035 Gargazon,76,,8,6,14
035 Gargazon,77,,8,7,15
035 Gargazon,78,,6,11,17
035 Gargazon,79,,3,2,5
035 Gargazon,80,,11,2,13
035 Gargazon,81,,5,6,11
035 Gargazon,82,,1,7,8
035 Gargazon,83,,5,2,7
035 Gargazon,84,,2,5,7
035 Gargazon,85,,3,4,7
035 Gargazon,86,,1,3,4
035 Gargazon,87,,-,1,1
035 Gargazon,88,,2,4,6
035 Gargazon,89,,3,-,3
035 Gargazon,90,,1,1,2
035 Gargazon,91,,-,1,1
035 Gargazon,92,,3,3,6
035 Gargazon,93,,-,2,2
035 Gargazon,94,,-,2,2
035 Gargazon,102,,-,1,1
035 Gargazon,Insgesamt,,827,860,1.687
036 Glurns,0,,7,2,9
036 Glurns,1,,3,1,4
036 Glurns,2,,8,6,14
036 Glurns,3,,6,3,9
036 Glurns,4,,3,5,8
036 Glurns,5,,5,4,9
036 Glurns,6,,3,5,8
036 Glurns,7,,9,2,11
036 Glurns,8,,5,2,7
036 Glurns,9,,5,8,13
036 Glurns,10,,6,6,12
036 Glurns,11,,3,6,9
036 Glurns,12,,6,6,12
036 Glurns,13,,4,4,8
036 Glurns,14,,5,-,5
036 Glurns,15,,5,3,8
036 Glurns,16,,3,2,5
036 Glurns,17,,10,3,13
036 Glurns,18,,4,7,11
036 Glurns,19,,7,5,12
036 Glurns,20,,6,4,10
036 Glurns,21,,2,3,5
036 Glurns,22,,8,6,14
036 Glurns,23,,5,7,12
036 Glurns,24,,7,3,10
036 Glurns,25,,8,3,11
036 Glurns,26,,4,3,7
036 Glurns,27,,4,6,10
036 Glurns,28,,3,5,8
036 Glurns,29,,4,8,12
036 Glurns,30,,3,4,7
036 Glurns,31,,8,6,14
036 Glurns,32,,9,6,15
036 Glurns,33,,11,7,18
036 Glurns,34,,8,5,13
036 Glurns,35,,13,4,17
036 Glurns,36,,4,8,12
036 Glurns,37,,7,6,13
036 Glurns,38,,3,2,5
036 Glurns,39,,12,3,15
036 Glurns,40,,5,7,12
036 Glurns,41,,8,11,19
036 Glurns,42,,3,2,5
036 Glurns,43,,5,7,12
036 Glurns,44,,7,5,12
036 Glurns,45,,4,2,6
036 Glurns,46,,2,6,8
036 Glurns,47,,7,3,10
036 Glurns,48,,4,9,13
036 Glurns,49,,6,7,13
036 Glurns,50,,1,7,8
036 Glurns,51,,10,6,16
036 Glurns,52,,5,8,13
036 Glurns,53,,6,5,11
036 Glurns,54,,6,6,12
036 Glurns,55,,5,9,14
036 Glurns,56,,12,6,18
036 Glurns,57,,3,9,12
036 Glurns,58,,6,12,18
036 Glurns,59,,5,6,11
036 Glurns,60,,8,7,15
036 Glurns,61,,12,3,15
036 Glurns,62,,8,10,18
036 Glurns,63,,4,8,12
036 Glurns,64,,8,9,17
036 Glurns,65,,6,5,11
036 Glurns,66,,5,2,7
036 Glurns,67,,7,5,12
036 Glurns,68,,10,7,17
036 Glurns,69,,8,2,10
036 Glurns,70,,6,1,7
036 Glurns,71,,5,4,9
036 Glurns,72,,1,4,5
036 Glurns,73,,4,6,10
036 Glurns,74,,3,2,5
036 Glurns,75,,5,1,6
036 Glurns,76,,2,3,5
036 Glurns,77,,4,4,8
036 Glurns,78,,4,4,8
036 Glurns,79,,-,2,2
036 Glurns,80,,2,4,6
036 Glurns,81,,1,4,5
036 Glurns,82,,-,1,1
036 Glurns,83,,4,2,6
036 Glurns,84,,4,-,4
036 Glurns,85,,-,2,2
036 Glurns,86,,2,5,7
036 Glurns,87,,-,1,1
036 Glurns,88,,-,2,2
036 Glurns,90,,-,1,1
036 Glurns,91,,-,1,1
036 Glurns,94,,2,-,2
036 Glurns,100,,-,1,1
036 Glurns,Insgesamt,,471,425,896
037 Latsch,0,,33,21,54
037 Latsch,1,,31,24,55
037 Latsch,2,,31,32,63
037 Latsch,3,,30,30,60
037 Latsch,4,,25,18,43
037 Latsch,5,,23,17,40
037 Latsch,6,,21,32,53
037 Latsch,7,,19,23,42
037 Latsch,8,,28,28,56
037 Latsch,9,,26,25,51
037 Latsch,10,,21,28,49
037 Latsch,11,,31,26,57
037 Latsch,12,,24,24,48
037 Latsch,13,,27,26,53
037 Latsch,14,,36,19,55
037 Latsch,15,,33,32,65
037 Latsch,16,,33,18,51
037 Latsch,17,,27,20,47
037 Latsch,18,,34,39,73
037 Latsch,19,,38,35,73
037 Latsch,20,,49,35,84
037 Latsch,21,,43,24,67
037 Latsch,22,,31,33,64
037 Latsch,23,,35,38,73
037 Latsch,24,,30,45,75
037 Latsch,25,,37,46,83
037 Latsch,26,,36,28,64
037 Latsch,27,,46,36,82
037 Latsch,28,,25,26,51
037 Latsch,29,,38,31,69
037 Latsch,30,,33,34,67
037 Latsch,31,,47,34,81
037 Latsch,32,,25,30,55
037 Latsch,33,,35,46,81
037 Latsch,34,,26,42,68
037 Latsch,35,,35,35,70
037 Latsch,36,,37,29,66
037 Latsch,37,,34,26,60
037 Latsch,38,,33,31,64
037 Latsch,39,,26,24,50
037 Latsch,40,,31,34,65
037 Latsch,41,,30,27,57
037 Latsch,42,,30,35,65
037 Latsch,43,,36,41,77
037 Latsch,44,,46,40,86
037 Latsch,45,,37,38,75
037 Latsch,46,,43,40,83
037 Latsch,47,,44,55,99
037 Latsch,48,,51,50,101
037 Latsch,49,,30,48,78
037 Latsch,50,,51,46,97
037 Latsch,51,,56,46,102
037 Latsch,52,,50,48,98
037 Latsch,53,,41,48,89
037 Latsch,54,,43,43,86
037 Latsch,55,,37,47,84
037 Latsch,56,,43,43,86
037 Latsch,57,,39,30,69
037 Latsch,58,,28,35,63
037 Latsch,59,,27,32,59
037 Latsch,60,,34,29,63
037 Latsch,61,,23,17,40
037 Latsch,62,,23,23,46
037 Latsch,63,,36,21,57
037 Latsch,64,,21,30,51
037 Latsch,65,,32,15,47
037 Latsch,66,,15,19,34
037 Latsch,67,,13,20,33
037 Latsch,68,,19,15,34
037 Latsch,69,,17,19,36
037 Latsch,70,,15,21,36
037 Latsch,71,,20,12,32
037 Latsch,72,,21,23,44
037 Latsch,73,,24,25,49
037 Latsch,74,,15,22,37
037 Latsch,75,,17,22,39
037 Latsch,76,,15,18,33
037 Latsch,77,,12,25,37
037 Latsch,78,,10,23,33
037 Latsch,79,,13,12,25
037 Latsch,80,,21,12,33
037 Latsch,81,,13,22,35
037 Latsch,82,,12,18,30
037 Latsch,83,,18,14,32
037 Latsch,84,,9,18,27
037 Latsch,85,,11,13,24
037 Latsch,86,,12,11,23
037 Latsch,87,,15,15,30
037 Latsch,88,,5,12,17
037 Latsch,89,,6,7,13
037 Latsch,90,,5,9,14
037 Latsch,91,,1,6,7
037 Latsch,92,,1,2,3
037 Latsch,93,,2,4,6
037 Latsch,94,,1,2,3
037 Latsch,95,,2,1,3
037 Latsch,106,,-,1,1
037 Latsch,Insgesamt,,2.594,2.594,5.188
038 Algund,0,,21,33,54
038 Algund,1,,23,31,54
038 Algund,2,,30,28,58
038 Algund,3,,24,34,58
038 Algund,4,,21,18,39
038 Algund,5,,28,20,48
038 Algund,6,,18,37,55
038 Algund,7,,21,18,39
038 Algund,8,,21,20,41
038 Algund,9,,29,23,52
038 Algund,10,,21,28,49
038 Algund,11,,28,24,52
038 Algund,12,,31,26,57
038 Algund,13,,24,25,49
038 Algund,14,,36,24,60
038 Algund,15,,22,32,54
038 Algund,16,,42,26,68
038 Algund,17,,26,23,49
038 Algund,18,,31,22,53
038 Algund,19,,20,21,41
038 Algund,20,,34,23,57
038 Algund,21,,31,22,53
038 Algund,22,,29,21,50
038 Algund,23,,35,22,57
038 Algund,24,,30,27,57
038 Algund,25,,33,23,56
038 Algund,26,,22,33,55
038 Algund,27,,22,35,57
038 Algund,28,,30,28,58
038 Algund,29,,27,30,57
038 Algund,30,,27,22,49
038 Algund,31,,26,37,63
038 Algund,32,,22,35,57
038 Algund,33,,33,32,65
038 Algund,34,,38,33,71
038 Algund,35,,35,35,70
038 Algund,36,,29,37,66
038 Algund,37,,31,35,66
038 Algund,38,,33,39,72
038 Algund,39,,32,34,66
038 Algund,40,,35,44,79
038 Algund,41,,34,39,73
038 Algund,42,,33,37,70
038 Algund,43,,49,38,87
038 Algund,44,,42,44,86
038 Algund,45,,48,46,94
038 Algund,46,,43,53,96
038 Algund,47,,44,36,80
038 Algund,48,,38,46,84
038 Algund,49,,42,46,88
038 Algund,50,,45,51,96
038 Algund,51,,48,27,75
038 Algund,52,,42,39,81
038 Algund,53,,33,44,77
038 Algund,54,,31,52,83
038 Algund,55,,37,43,80
038 Algund,56,,37,38,75
038 Algund,57,,42,30,72
038 Algund,58,,27,34,61
038 Algund,59,,35,32,67
038 Algund,60,,22,28,50
038 Algund,61,,34,25,59
038 Algund,62,,21,31,52
038 Algund,63,,25,28,53
038 Algund,64,,28,28,56
038 Algund,65,,23,25,48
038 Algund,66,,20,26,46
038 Algund,67,,26,22,48
038 Algund,68,,15,20,35
038 Algund,69,,29,29,58
038 Algund,70,,25,25,50
038 Algund,71,,21,27,48
038 Algund,72,,20,19,39
038 Algund,73,,15,32,47
038 Algund,74,,15,18,33
038 Algund,75,,17,20,37
038 Algund,76,,18,26,44
038 Algund,77,,17,19,36
038 Algund,78,,16,14,30
038 Algund,79,,12,25,37
038 Algund,80,,9,17,26
038 Algund,81,,20,24,44
038 Algund,82,,15,18,33
038 Algund,83,,9,18,27
038 Algund,84,,8,20,28
038 Algund,85,,8,18,26
038 Algund,86,,5,14,19
038 Algund,87,,5,14,19
038 Algund,88,,7,9,16
038 Algund,89,,5,8,13
038 Algund,90,,4,11,15
038 Algund,91,,-,6,6
038 Algund,92,,-,3,3
038 Algund,93,,1,5,6
038 Algund,94,,1,4,5
038 Algund,95,,3,2,5
038 Algund,96,,-,5,5
038 Algund,97,,-,1,1
038 Algund,98,,-,1,1
038 Algund,103,,-,1,1
038 Algund,Insgesamt,,2.420,2.621,5.041
039 Lajen,0,,12,12,24
039 Lajen,1,,12,24,36
039 Lajen,2,,21,18,39
039 Lajen,3,,17,16,33
039 Lajen,4,,17,12,29
039 Lajen,5,,15,18,33
039 Lajen,6,,19,7,26
039 Lajen,7,,16,15,31
039 Lajen,8,,17,22,39
039 Lajen,9,,12,19,31
039 Lajen,10,,19,14,33
039 Lajen,11,,16,25,41
039 Lajen,12,,20,22,42
039 Lajen,13,,21,8,29
039 Lajen,14,,21,20,41
039 Lajen,15,,28,16,44
039 Lajen,16,,17,16,33
039 Lajen,17,,18,17,35
039 Lajen,18,,16,23,39
039 Lajen,19,,16,11,27
039 Lajen,20,,10,13,23
039 Lajen,21,,14,13,27
039 Lajen,22,,11,13,24
039 Lajen,23,,15,10,25
039 Lajen,24,,20,17,37
039 Lajen,25,,9,10,19
039 Lajen,26,,18,13,31
039 Lajen,27,,11,14,25
039 Lajen,28,,14,9,23
039 Lajen,29,,18,13,31
039 Lajen,30,,17,13,30
039 Lajen,31,,16,11,27
039 Lajen,32,,9,23,32
039 Lajen,33,,13,18,31
039 Lajen,34,,11,21,32
039 Lajen,35,,17,15,32
039 Lajen,36,,24,20,44
039 Lajen,37,,21,24,45
039 Lajen,38,,19,14,33
039 Lajen,39,,27,19,46
039 Lajen,40,,21,26,47
039 Lajen,41,,30,17,47
039 Lajen,42,,24,21,45
039 Lajen,43,,20,27,47
039 Lajen,44,,18,23,41
039 Lajen,45,,16,30,46
039 Lajen,46,,33,27,60
039 Lajen,47,,22,23,45
039 Lajen,48,,22,23,45
039 Lajen,49,,22,15,37
039 Lajen,50,,28,19,47
039 Lajen,51,,23,21,44
039 Lajen,52,,18,11,29
039 Lajen,53,,30,19,49
039 Lajen,54,,9,18,27
039 Lajen,55,,13,10,23
039 Lajen,56,,17,25,42
039 Lajen,57,,22,13,35
039 Lajen,58,,12,13,25
039 Lajen,59,,12,13,25
039 Lajen,60,,13,13,26
039 Lajen,61,,9,14,23
039 Lajen,62,,10,6,16
039 Lajen,63,,8,11,19
039 Lajen,64,,9,13,22
039 Lajen,65,,11,12,23
039 Lajen,66,,4,14,18
039 Lajen,67,,7,15,22
039 Lajen,68,,15,7,22
039 Lajen,69,,12,14,26
039 Lajen,70,,9,12,21
039 Lajen,71,,15,9,24
039 Lajen,72,,11,12,23
039 Lajen,73,,12,13,25
039 Lajen,74,,14,14,28
039 Lajen,75,,14,7,21
039 Lajen,76,,8,8,16
039 Lajen,77,,6,15,21
039 Lajen,78,,7,11,18
039 Lajen,79,,4,8,12
039 Lajen,80,,4,6,10
039 Lajen,81,,4,6,10
039 Lajen,82,,5,10,15
039 Lajen,83,,8,3,11
039 Lajen,84,,-,6,6
039 Lajen,85,,6,3,9
039 Lajen,86,,1,7,8
039 Lajen,87,,5,5,10
039 Lajen,88,,5,8,13
039 Lajen,89,,1,4,5
039 Lajen,90,,1,2,3
039 Lajen,91,,-,4,4
039 Lajen,92,,-,2,2
039 Lajen,93,,1,4,5
039 Lajen,94,,-,2,2
039 Lajen,Insgesamt,,1.315,1.332,2.647
040 Leifers,0,,91,79,170
040 Leifers,1,,77,79,156
040 Leifers,2,,86,78,164
040 Leifers,3,,117,92,209
040 Leifers,4,,114,90,204
040 Leifers,5,,99,104,203
040 Leifers,6,,99,85,184
040 Leifers,7,,102,102,204
040 Leifers,8,,97,91,188
040 Leifers,9,,91,87,178
040 Leifers,10,,98,70,168
040 Leifers,11,,87,79,166
040 Leifers,12,,103,89,192
040 Leifers,13,,93,93,186
040 Leifers,14,,93,81,174
040 Leifers,15,,96,97,193
040 Leifers,16,,93,92,185
040 Leifers,17,,78,107,185
040 Leifers,18,,110,74,184
040 Leifers,19,,103,88,191
040 Leifers,20,,97,95,192
040 Leifers,21,,100,99,199
040 Leifers,22,,89,87,176
040 Leifers,23,,93,88,181
040 Leifers,24,,103,95,198
040 Leifers,25,,93,103,196
040 Leifers,26,,94,112,206
040 Leifers,27,,92,103,195
040 Leifers,28,,97,87,184
040 Leifers,29,,113,100,213
040 Leifers,30,,106,92,198
040 Leifers,31,,122,91,213
040 Leifers,32,,144,118,262
040 Leifers,33,,118,98,216
040 Leifers,34,,105,102,207
040 Leifers,35,,99,107,206
040 Leifers,36,,108,125,233
040 Leifers,37,,112,102,214
040 Leifers,38,,106,131,237
040 Leifers,39,,123,122,245
040 Leifers,40,,143,141,284
040 Leifers,41,,157,163,320
040 Leifers,42,,156,152,308
040 Leifers,43,,149,146,295
040 Leifers,44,,140,140,280
040 Leifers,45,,168,144,312
040 Leifers,46,,169,134,303
040 Leifers,47,,148,176,324
040 Leifers,48,,143,126,269
040 Leifers,49,,148,142,290
040 Leifers,50,,152,131,283
040 Leifers,51,,157,164,321
040 Leifers,52,,147,131,278
040 Leifers,53,,139,124,263
040 Leifers,54,,136,140,276
040 Leifers,55,,130,125,255
040 Leifers,56,,114,114,228
040 Leifers,57,,98,112,210
040 Leifers,58,,100,119,219
040 Leifers,59,,139,123,262
040 Leifers,60,,102,128,230
040 Leifers,61,,85,105,190
040 Leifers,62,,96,114,210
040 Leifers,63,,101,97,198
040 Leifers,64,,92,90,182
040 Leifers,65,,95,92,187
040 Leifers,66,,79,92,171
040 Leifers,67,,100,102,202
040 Leifers,68,,87,95,182
040 Leifers,69,,101,143,244
040 Leifers,70,,69,79,148
040 Leifers,71,,79,90,169
040 Leifers,72,,83,88,171
040 Leifers,73,,76,90,166
040 Leifers,74,,76,75,151
040 Leifers,75,,84,81,165
040 Leifers,76,,74,87,161
040 Leifers,77,,66,69,135
040 Leifers,78,,42,67,109
040 Leifers,79,,36,59,95
040 Leifers,80,,39,58,97
040 Leifers,81,,41,54,95
040 Leifers,82,,31,50,81
040 Leifers,83,,46,66,112
040 Leifers,84,,28,50,78
040 Leifers,85,,27,43,70
040 Leifers,86,,23,36,59
040 Leifers,87,,19,25,44
040 Leifers,88,,14,29,43
040 Leifers,89,,3,29,32
040 Leifers,90,,8,23,31
040 Leifers,91,,6,21,27
040 Leifers,92,,4,19,23
040 Leifers,93,,6,14,20
040 Leifers,94,,3,8,11
040 Leifers,95,,2,1,3
040 Leifers,96,,1,6,7
040 Leifers,97,,1,2,3
040 Leifers,98,,-,1,1
040 Leifers,99,,-,2,2
040 Leifers,100,,-,3,3
040 Leifers,102,,-,1,1
040 Leifers,Insgesamt,,8.799,8.945,17.744
041 Lana,0,,82,72,154
041 Lana,1,,70,79,149
041 Lana,2,,57,72,129
041 Lana,3,,71,60,131
041 Lana,4,,67,66,133
041 Lana,5,,62,65,127
041 Lana,6,,66,51,117
041 Lana,7,,64,66,130
041 Lana,8,,72,58,130
041 Lana,9,,70,59,129
041 Lana,10,,72,68,140
041 Lana,11,,75,55,130
041 Lana,12,,62,62,124
041 Lana,13,,61,55,116
041 Lana,14,,74,58,132
041 Lana,15,,72,72,144
041 Lana,16,,71,65,136
041 Lana,17,,63,65,128
041 Lana,18,,62,70,132
041 Lana,19,,75,81,156
041 Lana,20,,71,69,140
041 Lana,21,,69,80,149
041 Lana,22,,62,69,131
041 Lana,23,,68,64,132
041 Lana,24,,72,64,136
041 Lana,25,,52,72,124
041 Lana,26,,49,79,128
041 Lana,27,,69,72,141
041 Lana,28,,76,66,142
041 Lana,29,,71,64,135
041 Lana,30,,62,89,151
041 Lana,31,,70,73,143
041 Lana,32,,96,84,180
041 Lana,33,,87,89,176
041 Lana,34,,65,85,150
041 Lana,35,,71,77,148
041 Lana,36,,80,99,179
041 Lana,37,,94,86,180
041 Lana,38,,74,69,143
041 Lana,39,,86,96,182
041 Lana,40,,70,91,161
041 Lana,41,,95,92,187
041 Lana,42,,85,98,183
041 Lana,43,,112,92,204
041 Lana,44,,102,110,212
041 Lana,45,,102,105,207
041 Lana,46,,128,84,212
041 Lana,47,,82,103,185
041 Lana,48,,94,93,187
041 Lana,49,,103,112,215
041 Lana,50,,98,96,194
041 Lana,51,,104,113,217
041 Lana,52,,103,82,185
041 Lana,53,,89,81,170
041 Lana,54,,88,91,179
041 Lana,55,,76,81,157
041 Lana,56,,83,81,164
041 Lana,57,,75,89,164
041 Lana,58,,73,81,154
041 Lana,59,,55,63,118
041 Lana,60,,61,74,135
041 Lana,61,,55,64,119
041 Lana,62,,57,61,118
041 Lana,63,,48,60,108
041 Lana,64,,49,67,116
041 Lana,65,,49,54,103
041 Lana,66,,51,58,109
041 Lana,67,,48,64,112
041 Lana,68,,52,47,99
041 Lana,69,,60,64,124
041 Lana,70,,41,53,94
041 Lana,71,,41,64,105
041 Lana,72,,56,56,112
041 Lana,73,,50,69,119
041 Lana,74,,50,42,92
041 Lana,75,,39,48,87
041 Lana,76,,46,49,95
041 Lana,77,,36,55,91
041 Lana,78,,31,30,61
041 Lana,79,,34,45,79
041 Lana,80,,25,30,55
041 Lana,81,,29,40,69
041 Lana,82,,22,40,62
041 Lana,83,,16,28,44
041 Lana,84,,15,29,44
041 Lana,85,,15,26,41
041 Lana,86,,12,28,40
041 Lana,87,,15,20,35
041 Lana,88,,14,21,35
041 Lana,89,,9,18,27
041 Lana,90,,9,25,34
041 Lana,91,,4,11,15
041 Lana,92,,4,15,19
041 Lana,93,,5,11,16
041 Lana,94,,4,9,13
041 Lana,95,,2,3,5
041 Lana,96,,1,1,2
041 Lana,97,,-,1,1
041 Lana,98,,1,2,3
041 Lana,100,,-,1,1
041 Lana,101,,-,1,1
041 Lana,102,,-,2,2
041 Lana,Insgesamt,,5.785,6.169,11.954
042 Laas,0,,18,17,35
042 Laas,1,,24,22,46
042 Laas,2,,26,29,55
042 Laas,3,,23,26,49
042 Laas,4,,21,27,48
042 Laas,5,,36,26,62
042 Laas,6,,22,27,49
042 Laas,7,,23,24,47
042 Laas,8,,29,17,46
042 Laas,9,,18,30,48
042 Laas,10,,35,14,49
042 Laas,11,,24,20,44
042 Laas,12,,22,20,42
042 Laas,13,,30,16,46
042 Laas,14,,17,20,37
042 Laas,15,,26,23,49
042 Laas,16,,18,15,33
042 Laas,17,,27,32,59
042 Laas,18,,25,24,49
042 Laas,19,,30,32,62
042 Laas,20,,30,25,55
042 Laas,21,,25,24,49
042 Laas,22,,22,18,40
042 Laas,23,,17,26,43
042 Laas,24,,21,22,43
042 Laas,25,,18,21,39
042 Laas,26,,21,22,43
042 Laas,27,,21,18,39
042 Laas,28,,29,17,46
042 Laas,29,,30,21,51
042 Laas,30,,24,28,52
042 Laas,31,,21,36,57
042 Laas,32,,17,41,58
042 Laas,33,,28,29,57
042 Laas,34,,26,30,56
042 Laas,35,,20,24,44
042 Laas,36,,33,27,60
042 Laas,37,,21,34,55
042 Laas,38,,25,21,46
042 Laas,39,,27,28,55
042 Laas,40,,29,18,47
042 Laas,41,,42,30,72
042 Laas,42,,37,29,66
042 Laas,43,,28,24,52
042 Laas,44,,25,25,50
042 Laas,45,,39,26,65
042 Laas,46,,30,36,66
042 Laas,47,,39,30,69
042 Laas,48,,29,25,54
042 Laas,49,,31,27,58
042 Laas,50,,37,35,72
042 Laas,51,,27,28,55
042 Laas,52,,26,27,53
042 Laas,53,,36,29,65
042 Laas,54,,25,29,54
042 Laas,55,,41,27,68
042 Laas,56,,31,28,59
042 Laas,57,,26,23,49
042 Laas,58,,16,25,41
042 Laas,59,,21,16,37
042 Laas,60,,17,15,32
042 Laas,61,,16,25,41
042 Laas,62,,19,13,32
042 Laas,63,,29,24,53
042 Laas,64,,12,15,27
042 Laas,65,,19,23,42
042 Laas,66,,19,18,37
042 Laas,67,,16,20,36
042 Laas,68,,24,11,35
042 Laas,69,,13,14,27
042 Laas,70,,14,11,25
042 Laas,71,,10,14,24
042 Laas,72,,10,15,25
042 Laas,73,,16,18,34
042 Laas,74,,12,21,33
042 Laas,75,,17,21,38
042 Laas,76,,12,23,35
042 Laas,77,,15,11,26
042 Laas,78,,9,14,23
042 Laas,79,,17,11,28
042 Laas,80,,17,20,37
042 Laas,81,,6,15,21
042 Laas,82,,13,13,26
042 Laas,83,,9,12,21
042 Laas,84,,10,20,30
042 Laas,85,,8,9,17
042 Laas,86,,8,7,15
042 Laas,87,,8,9,17
042 Laas,88,,3,8,11
042 Laas,89,,8,5,13
042 Laas,90,,3,3,6
042 Laas,91,,1,9,10
042 Laas,92,,2,3,5
042 Laas,93,,1,6,7
042 Laas,94,,-,1,1
042 Laas,95,,2,2,4
042 Laas,96,,1,-,1
042 Laas,99,,1,1,2
042 Laas,104,,-,1,1
042 Laas,Insgesamt,,2.002,1.991,3.993
043 Laurein,0,,2,1,3
043 Laurein,1,,2,1,3
043 Laurein,2,,1,1,2
043 Laurein,3,,1,1,2
043 Laurein,4,,3,-,3
043 Laurein,5,,2,1,3
043 Laurein,6,,2,3,5
043 Laurein,7,,2,1,3
043 Laurein,8,,1,-,1
043 Laurein,9,,8,-,8
043 Laurein,10,,3,4,7
043 Laurein,11,,3,1,4
043 Laurein,12,,3,3,6
043 Laurein,13,,2,3,5
043 Laurein,14,,7,1,8
043 Laurein,15,,3,7,10
043 Laurein,16,,2,2,4
043 Laurein,17,,4,3,7
043 Laurein,18,,3,6,9
043 Laurein,19,,1,2,3
043 Laurein,20,,2,2,4
043 Laurein,21,,2,3,5
043 Laurein,22,,1,6,7
043 Laurein,23,,1,1,2
043 Laurein,24,,1,1,2
043 Laurein,25,,4,-,4
043 Laurein,26,,3,3,6
043 Laurein,27,,1,1,2
043 Laurein,28,,1,2,3
043 Laurein,29,,4,1,5
043 Laurein,30,,2,2,4
043 Laurein,31,,1,2,3
043 Laurein,33,,1,1,2
043 Laurein,34,,3,-,3
043 Laurein,35,,2,-,2
043 Laurein,36,,2,-,2
043 Laurein,37,,2,3,5
043 Laurein,38,,1,2,3
043 Laurein,39,,5,1,6
043 Laurein,40,,-,4,4
043 Laurein,41,,-,1,1
043 Laurein,42,,5,3,8
043 Laurein,43,,1,2,3
043 Laurein,44,,4,5,9
043 Laurein,45,,4,3,7
043 Laurein,46,,5,4,9
043 Laurein,47,,-,2,2
043 Laurein,48,,4,6,10
043 Laurein,49,,5,3,8
043 Laurein,50,,4,1,5
043 Laurein,51,,4,3,7
043 Laurein,52,,-,2,2
043 Laurein,53,,2,2,4
043 Laurein,54,,5,3,8
043 Laurein,55,,1,-,1
043 Laurein,56,,4,4,8
043 Laurein,57,,2,2,4
043 Laurein,58,,7,-,7
043 Laurein,60,,2,-,2
043 Laurein,61,,3,1,4
043 Laurein,62,,2,1,3
043 Laurein,63,,2,-,2
043 Laurein,65,,1,1,2
043 Laurein,66,,2,2,4
043 Laurein,67,,2,-,2
043 Laurein,68,,2,2,4
043 Laurein,69,,-,1,1
043 Laurein,70,,-,1,1
043 Laurein,71,,-,1,1
043 Laurein,72,,1,-,1
043 Laurein,73,,1,-,1
043 Laurein,75,,2,2,4
043 Laurein,76,,1,2,3
043 Laurein,77,,1,1,2
043 Laurein,78,,2,1,3
043 Laurein,79,,1,2,3
043 Laurein,80,,-,3,3
043 Laurein,81,,1,4,5
043 Laurein,83,,1,2,3
043 Laurein,84,,-,1,1
043 Laurein,85,,-,4,4
043 Laurein,86,,1,-,1
043 Laurein,87,,3,-,3
043 Laurein,88,,2,1,3
043 Laurein,90,,-,1,1
043 Laurein,91,,-,1,1
043 Laurein,95,,1,-,1
043 Laurein,Insgesamt,,185,157,342
044 Lüsen,0,,4,7,11
044 Lüsen,1,,12,14,26
044 Lüsen,2,,1,11,12
044 Lüsen,3,,9,7,16
044 Lüsen,4,,11,6,17
044 Lüsen,5,,12,10,22
044 Lüsen,6,,11,9,20
044 Lüsen,7,,8,9,17
044 Lüsen,8,,11,10,21
044 Lüsen,9,,10,14,24
044 Lüsen,10,,9,8,17
044 Lüsen,11,,9,10,19
044 Lüsen,12,,14,9,23
044 Lüsen,13,,9,8,17
044 Lüsen,14,,10,10,20
044 Lüsen,15,,13,11,24
044 Lüsen,16,,5,9,14
044 Lüsen,17,,11,11,22
044 Lüsen,18,,16,6,22
044 Lüsen,19,,7,11,18
044 Lüsen,20,,10,12,22
044 Lüsen,21,,14,13,27
044 Lüsen,22,,8,9,17
044 Lüsen,23,,11,7,18
044 Lüsen,24,,9,8,17
044 Lüsen,25,,6,10,16
044 Lüsen,26,,15,10,25
044 Lüsen,27,,10,9,19
044 Lüsen,28,,7,7,14
044 Lüsen,29,,13,7,20
044 Lüsen,30,,6,4,10
044 Lüsen,31,,8,14,22
044 Lüsen,32,,7,8,15
044 Lüsen,33,,7,9,16
044 Lüsen,34,,9,10,19
044 Lüsen,35,,12,9,21
044 Lüsen,36,,9,8,17
044 Lüsen,37,,16,14,30
044 Lüsen,38,,7,13,20
044 Lüsen,39,,11,9,20
044 Lüsen,40,,11,12,23
044 Lüsen,41,,13,13,26
044 Lüsen,42,,8,8,16
044 Lüsen,43,,9,9,18
044 Lüsen,44,,14,9,23
044 Lüsen,45,,18,12,30
044 Lüsen,46,,10,11,21
044 Lüsen,47,,13,16,29
044 Lüsen,48,,11,19,30
044 Lüsen,49,,15,10,25
044 Lüsen,50,,16,11,27
044 Lüsen,51,,11,8,19
044 Lüsen,52,,12,12,24
044 Lüsen,53,,7,11,18
044 Lüsen,54,,12,9,21
044 Lüsen,55,,8,13,21
044 Lüsen,56,,10,6,16
044 Lüsen,57,,11,12,23
044 Lüsen,58,,10,9,19
044 Lüsen,59,,7,8,15
044 Lüsen,60,,6,8,14
044 Lüsen,61,,11,7,18
044 Lüsen,62,,7,10,17
044 Lüsen,63,,9,5,14
044 Lüsen,64,,5,6,11
044 Lüsen,65,,4,8,12
044 Lüsen,66,,7,10,17
044 Lüsen,67,,7,1,8
044 Lüsen,68,,5,5,10
044 Lüsen,69,,9,6,15
044 Lüsen,70,,3,9,12
044 Lüsen,71,,4,2,6
044 Lüsen,72,,7,7,14
044 Lüsen,73,,2,6,8
044 Lüsen,74,,5,2,7
044 Lüsen,75,,3,9,12
044 Lüsen,76,,8,7,15
044 Lüsen,77,,6,4,10
044 Lüsen,78,,7,4,11
044 Lüsen,79,,4,8,12
044 Lüsen,80,,2,4,6
044 Lüsen,81,,3,3,6
044 Lüsen,82,,6,1,7
044 Lüsen,83,,2,7,9
044 Lüsen,84,,4,2,6
044 Lüsen,85,,-,4,4
044 Lüsen,86,,1,3,4
044 Lüsen,87,,1,3,4
044 Lüsen,88,,2,2,4
044 Lüsen,89,,2,1,3
044 Lüsen,90,,1,-,1
044 Lüsen,91,,1,-,1
044 Lüsen,92,,1,3,4
044 Lüsen,93,,1,-,1
044 Lüsen,94,,-,2,2
044 Lüsen,102,,-,1,1
044 Lüsen,Insgesamt,,759,758,1.517
045 Margreid a.d. Weinstr.,0,,8,4,12
045 Margreid a.d. Weinstr.,1,,9,13,22
045 Margreid a.d. Weinstr.,2,,7,5,12
045 Margreid a.d. Weinstr.,3,,4,7,11
045 Margreid a.d. Weinstr.,4,,2,7,9
045 Margreid a.d. Weinstr.,5,,4,8,12
045 Margreid a.d. Weinstr.,6,,7,6,13
045 Margreid a.d. Weinstr.,7,,10,9,19
045 Margreid a.d. Weinstr.,8,,6,5,11
045 Margreid a.d. Weinstr.,9,,8,4,12
045 Margreid a.d. Weinstr.,10,,8,10,18
045 Margreid a.d. Weinstr.,11,,9,10,19
045 Margreid a.d. Weinstr.,12,,7,3,10
045 Margreid a.d. Weinstr.,13,,10,8,18
045 Margreid a.d. Weinstr.,14,,10,10,20
045 Margreid a.d. Weinstr.,15,,8,6,14
045 Margreid a.d. Weinstr.,16,,6,11,17
045 Margreid a.d. Weinstr.,17,,2,13,15
045 Margreid a.d. Weinstr.,18,,10,14,24
045 Margreid a.d. Weinstr.,19,,6,2,8
045 Margreid a.d. Weinstr.,20,,1,7,8
045 Margreid a.d. Weinstr.,21,,7,6,13
045 Margreid a.d. Weinstr.,22,,5,15,20
045 Margreid a.d. Weinstr.,23,,3,3,6
045 Margreid a.d. Weinstr.,24,,5,8,13
045 Margreid a.d. Weinstr.,25,,8,8,16
045 Margreid a.d. Weinstr.,26,,7,6,13
045 Margreid a.d. Weinstr.,27,,8,9,17
045 Margreid a.d. Weinstr.,28,,7,9,16
045 Margreid a.d. Weinstr.,29,,6,9,15
045 Margreid a.d. Weinstr.,30,,12,2,14
045 Margreid a.d. Weinstr.,31,,6,10,16
045 Margreid a.d. Weinstr.,32,,8,9,17
045 Margreid a.d. Weinstr.,33,,12,8,20
045 Margreid a.d. Weinstr.,34,,12,8,20
045 Margreid a.d. Weinstr.,35,,4,7,11
045 Margreid a.d. Weinstr.,36,,10,1,11
045 Margreid a.d. Weinstr.,37,,8,8,16
045 Margreid a.d. Weinstr.,38,,6,9,15
045 Margreid a.d. Weinstr.,39,,12,16,28
045 Margreid a.d. Weinstr.,40,,9,8,17
045 Margreid a.d. Weinstr.,41,,10,7,17
045 Margreid a.d. Weinstr.,42,,9,10,19
045 Margreid a.d. Weinstr.,43,,6,7,13
045 Margreid a.d. Weinstr.,44,,8,11,19
045 Margreid a.d. Weinstr.,45,,10,11,21
045 Margreid a.d. Weinstr.,46,,8,10,18
045 Margreid a.d. Weinstr.,47,,21,17,38
045 Margreid a.d. Weinstr.,48,,13,18,31
045 Margreid a.d. Weinstr.,49,,18,8,26
045 Margreid a.d. Weinstr.,50,,11,3,14
045 Margreid a.d. Weinstr.,51,,5,3,8
045 Margreid a.d. Weinstr.,52,,9,10,19
045 Margreid a.d. Weinstr.,53,,7,14,21
045 Margreid a.d. Weinstr.,54,,14,14,28
045 Margreid a.d. Weinstr.,55,,13,10,23
045 Margreid a.d. Weinstr.,56,,9,11,20
045 Margreid a.d. Weinstr.,57,,8,6,14
045 Margreid a.d. Weinstr.,58,,9,7,16
045 Margreid a.d. Weinstr.,59,,14,7,21
045 Margreid a.d. Weinstr.,60,,8,8,16
045 Margreid a.d. Weinstr.,61,,4,5,9
045 Margreid a.d. Weinstr.,62,,7,9,16
045 Margreid a.d. Weinstr.,63,,6,8,14
045 Margreid a.d. Weinstr.,64,,4,7,11
045 Margreid a.d. Weinstr.,65,,7,6,13
045 Margreid a.d. Weinstr.,66,,7,3,10
045 Margreid a.d. Weinstr.,67,,5,9,14
045 Margreid a.d. Weinstr.,68,,6,6,12
045 Margreid a.d. Weinstr.,69,,2,3,5
045 Margreid a.d. Weinstr.,70,,6,7,13
045 Margreid a.d. Weinstr.,71,,3,5,8
045 Margreid a.d. Weinstr.,72,,6,3,9
045 Margreid a.d. Weinstr.,73,,7,5,12
045 Margreid a.d. Weinstr.,74,,7,5,12
045 Margreid a.d. Weinstr.,75,,6,4,10
045 Margreid a.d. Weinstr.,76,,3,6,9
045 Margreid a.d. Weinstr.,77,,3,9,12
045 Margreid a.d. Weinstr.,78,,4,3,7
045 Margreid a.d. Weinstr.,79,,3,5,8
045 Margreid a.d. Weinstr.,80,,2,6,8
045 Margreid a.d. Weinstr.,81,,2,4,6
045 Margreid a.d. Weinstr.,82,,2,3,5
045 Margreid a.d. Weinstr.,83,,3,3,6
045 Margreid a.d. Weinstr.,84,,1,4,5
045 Margreid a.d. Weinstr.,85,,2,1,3
045 Margreid a.d. Weinstr.,86,,-,2,2
045 Margreid a.d. Weinstr.,87,,1,1,2
045 Margreid a.d. Weinstr.,88,,-,3,3
045 Margreid a.d. Weinstr.,89,,-,5,5
045 Margreid a.d. Weinstr.,90,,-,1,1
045 Margreid a.d. Weinstr.,91,,1,3,4
045 Margreid a.d. Weinstr.,92,,-,3,3
045 Margreid a.d. Weinstr.,94,,-,1,1
045 Margreid a.d. Weinstr.,96,,-,2,2
045 Margreid a.d. Weinstr.,Insgesamt,,617,663,1.280
046 Mals,0,,29,21,50
046 Mals,1,,31,25,56
046 Mals,2,,28,27,55
046 Mals,3,,26,22,48
046 Mals,4,,32,21,53
046 Mals,5,,32,29,61
046 Mals,6,,31,18,49
046 Mals,7,,26,24,50
046 Mals,8,,23,34,57
046 Mals,9,,35,35,70
046 Mals,10,,25,30,55
046 Mals,11,,30,24,54
046 Mals,12,,31,21,52
046 Mals,13,,23,27,50
046 Mals,14,,33,30,63
046 Mals,15,,30,36,66
046 Mals,16,,43,29,72
046 Mals,17,,34,32,66
046 Mals,18,,32,33,65
046 Mals,19,,38,29,67
046 Mals,20,,38,39,77
046 Mals,21,,39,35,74
046 Mals,22,,33,35,68
046 Mals,23,,32,35,67
046 Mals,24,,35,34,69
046 Mals,25,,38,35,73
046 Mals,26,,40,34,74
046 Mals,27,,37,29,66
046 Mals,28,,29,31,60
046 Mals,29,,28,39,67
046 Mals,30,,36,31,67
046 Mals,31,,35,30,65
046 Mals,32,,31,32,63
046 Mals,33,,33,31,64
046 Mals,34,,36,38,74
046 Mals,35,,44,33,77
046 Mals,36,,30,30,60
046 Mals,37,,44,33,77
046 Mals,38,,32,23,55
046 Mals,39,,25,29,54
046 Mals,40,,36,35,71
046 Mals,41,,48,25,73
046 Mals,42,,31,36,67
046 Mals,43,,29,48,77
046 Mals,44,,34,46,80
046 Mals,45,,44,45,89
046 Mals,46,,48,43,91
046 Mals,47,,57,38,95
046 Mals,48,,47,32,79
046 Mals,49,,51,53,104
046 Mals,50,,49,38,87
046 Mals,51,,44,42,86
046 Mals,52,,48,53,101
046 Mals,53,,38,30,68
046 Mals,54,,51,35,86
046 Mals,55,,33,39,72
046 Mals,56,,33,34,67
046 Mals,57,,31,23,54
046 Mals,58,,35,33,68
046 Mals,59,,32,26,58
046 Mals,60,,28,24,52
046 Mals,61,,19,20,39
046 Mals,62,,31,30,61
046 Mals,63,,27,24,51
046 Mals,64,,29,21,50
046 Mals,65,,33,23,56
046 Mals,66,,20,25,45
046 Mals,67,,25,14,39
046 Mals,68,,20,20,40
046 Mals,69,,18,27,45
046 Mals,70,,9,19,28
046 Mals,71,,27,14,41
046 Mals,72,,23,19,42
046 Mals,73,,16,23,39
046 Mals,74,,13,13,26
046 Mals,75,,17,26,43
046 Mals,76,,21,26,47
046 Mals,77,,16,20,36
046 Mals,78,,11,26,37
046 Mals,79,,14,15,29
046 Mals,80,,12,16,28
046 Mals,81,,9,11,20
046 Mals,82,,9,17,26
046 Mals,83,,13,9,22
046 Mals,84,,6,14,20
046 Mals,85,,14,12,26
046 Mals,86,,6,9,15
046 Mals,87,,5,9,14
046 Mals,88,,5,6,11
046 Mals,89,,3,9,12
046 Mals,90,,3,8,11
046 Mals,91,,2,7,9
046 Mals,92,,-,4,4
046 Mals,93,,3,4,7
046 Mals,94,,-,4,4
046 Mals,95,,-,2,2
046 Mals,96,,-,1,1
046 Mals,97,,1,1,2
046 Mals,98,,1,1,2
046 Mals,Insgesamt,,2.635,2.530,5.165
047 Enneberg,0,,22,23,45
047 Enneberg,1,,18,24,42
047 Enneberg,2,,14,18,32
047 Enneberg,3,,19,17,36
047 Enneberg,4,,21,16,37
047 Enneberg,5,,19,11,30
047 Enneberg,6,,14,12,26
047 Enneberg,7,,16,20,36
047 Enneberg,8,,15,15,30
047 Enneberg,9,,23,20,43
047 Enneberg,10,,19,16,35
047 Enneberg,11,,13,19,32
047 Enneberg,12,,21,27,48
047 Enneberg,13,,17,14,31
047 Enneberg,14,,29,16,45
047 Enneberg,15,,19,21,40
047 Enneberg,16,,26,19,45
047 Enneberg,17,,17,9,26
047 Enneberg,18,,23,14,37
047 Enneberg,19,,16,14,30
047 Enneberg,20,,22,9,31
047 Enneberg,21,,21,16,37
047 Enneberg,22,,22,21,43
047 Enneberg,23,,13,15,28
047 Enneberg,24,,16,19,35
047 Enneberg,25,,15,22,37
047 Enneberg,26,,24,14,38
047 Enneberg,27,,18,13,31
047 Enneberg,28,,16,17,33
047 Enneberg,29,,18,14,32
047 Enneberg,30,,23,19,42
047 Enneberg,31,,19,14,33
047 Enneberg,32,,16,17,33
047 Enneberg,33,,22,20,42
047 Enneberg,34,,20,25,45
047 Enneberg,35,,20,20,40
047 Enneberg,36,,12,18,30
047 Enneberg,37,,18,24,42
047 Enneberg,38,,22,19,41
047 Enneberg,39,,14,17,31
047 Enneberg,40,,13,27,40
047 Enneberg,41,,25,31,56
047 Enneberg,42,,26,22,48
047 Enneberg,43,,24,27,51
047 Enneberg,44,,28,38,66
047 Enneberg,45,,26,20,46
047 Enneberg,46,,32,19,51
047 Enneberg,47,,25,25,50
047 Enneberg,48,,25,22,47
047 Enneberg,49,,22,20,42
047 Enneberg,50,,26,22,48
047 Enneberg,51,,22,21,43
047 Enneberg,52,,22,19,41
047 Enneberg,53,,18,15,33
047 Enneberg,54,,18,16,34
047 Enneberg,55,,15,16,31
047 Enneberg,56,,23,15,38
047 Enneberg,57,,21,13,34
047 Enneberg,58,,15,17,32
047 Enneberg,59,,14,18,32
047 Enneberg,60,,14,16,30
047 Enneberg,61,,15,13,28
047 Enneberg,62,,17,22,39
047 Enneberg,63,,14,17,31
047 Enneberg,64,,18,10,28
047 Enneberg,65,,11,15,26
047 Enneberg,66,,17,8,25
047 Enneberg,67,,15,14,29
047 Enneberg,68,,8,11,19
047 Enneberg,69,,11,17,28
047 Enneberg,70,,3,12,15
047 Enneberg,71,,18,18,36
047 Enneberg,72,,16,9,25
047 Enneberg,73,,10,18,28
047 Enneberg,74,,13,12,25
047 Enneberg,75,,9,7,16
047 Enneberg,76,,14,9,23
047 Enneberg,77,,11,14,25
047 Enneberg,78,,13,12,25
047 Enneberg,79,,9,11,20
047 Enneberg,80,,11,13,24
047 Enneberg,81,,6,10,16
047 Enneberg,82,,8,7,15
047 Enneberg,83,,5,17,22
047 Enneberg,84,,7,10,17
047 Enneberg,85,,7,11,18
047 Enneberg,86,,3,7,10
047 Enneberg,87,,3,7,10
047 Enneberg,88,,4,4,8
047 Enneberg,89,,3,1,4
047 Enneberg,90,,4,5,9
047 Enneberg,91,,-,3,3
047 Enneberg,92,,-,6,6
047 Enneberg,93,,1,5,6
047 Enneberg,94,,1,2,3
047 Enneberg,95,,-,1,1
047 Enneberg,96,,-,2,2
047 Enneberg,97,,-,2,2
047 Enneberg,98,,-,1,1
047 Enneberg,99,,-,1,1
047 Enneberg,100,,-,1,1
047 Enneberg,101,,-,1,1
047 Enneberg,Insgesamt,,1.511,1.503,3.014
048 Marling,0,,17,11,28
048 Marling,1,,12,12,24
048 Marling,2,,11,9,20
048 Marling,3,,12,11,23
048 Marling,4,,20,7,27
048 Marling,5,,19,7,26
048 Marling,6,,21,7,28
048 Marling,7,,14,12,26
048 Marling,8,,20,11,31
048 Marling,9,,9,19,28
048 Marling,10,,26,16,42
048 Marling,11,,14,14,28
048 Marling,12,,12,14,26
048 Marling,13,,13,20,33
048 Marling,14,,13,16,29
048 Marling,15,,14,18,32
048 Marling,16,,14,9,23
048 Marling,17,,11,13,24
048 Marling,18,,16,9,25
048 Marling,19,,13,13,26
048 Marling,20,,20,14,34
048 Marling,21,,15,8,23
048 Marling,22,,16,11,27
048 Marling,23,,19,17,36
048 Marling,24,,14,17,31
048 Marling,25,,14,24,38
048 Marling,26,,16,23,39
048 Marling,27,,14,13,27
048 Marling,28,,15,19,34
048 Marling,29,,8,12,20
048 Marling,30,,11,19,30
048 Marling,31,,17,8,25
048 Marling,32,,17,18,35
048 Marling,33,,19,11,30
048 Marling,34,,17,15,32
048 Marling,35,,17,14,31
048 Marling,36,,16,24,40
048 Marling,37,,19,21,40
048 Marling,38,,22,17,39
048 Marling,39,,20,27,47
048 Marling,40,,26,16,42
048 Marling,41,,15,11,26
048 Marling,42,,18,19,37
048 Marling,43,,17,20,37
048 Marling,44,,24,18,42
048 Marling,45,,20,23,43
048 Marling,46,,24,18,42
048 Marling,47,,27,21,48
048 Marling,48,,19,20,39
048 Marling,49,,25,31,56
048 Marling,50,,27,19,46
048 Marling,51,,27,21,48
048 Marling,52,,31,29,60
048 Marling,53,,15,18,33
048 Marling,54,,26,14,40
048 Marling,55,,15,21,36
048 Marling,56,,19,15,34
048 Marling,57,,15,12,27
048 Marling,58,,13,12,25
048 Marling,59,,9,12,21
048 Marling,60,,13,8,21
048 Marling,61,,17,12,29
048 Marling,62,,10,15,25
048 Marling,63,,10,15,25
048 Marling,64,,6,16,22
048 Marling,65,,12,14,26
048 Marling,66,,18,18,36
048 Marling,67,,5,14,19
048 Marling,68,,15,12,27
048 Marling,69,,11,14,25
048 Marling,70,,17,11,28
048 Marling,71,,15,15,30
048 Marling,72,,9,17,26
048 Marling,73,,8,11,19
048 Marling,74,,18,16,34
048 Marling,75,,10,11,21
048 Marling,76,,13,14,27
048 Marling,77,,8,11,19
048 Marling,78,,9,14,23
048 Marling,79,,14,7,21
048 Marling,80,,3,16,19
048 Marling,81,,8,8,16
048 Marling,82,,6,12,18
048 Marling,83,,7,8,15
048 Marling,84,,7,7,14
048 Marling,85,,2,7,9
048 Marling,86,,5,5,10
048 Marling,87,,4,1,5
048 Marling,88,,5,5,10
048 Marling,89,,1,7,8
048 Marling,90,,1,6,7
048 Marling,91,,-,5,5
048 Marling,92,,1,3,4
048 Marling,93,,-,2,2
048 Marling,94,,1,1,2
048 Marling,95,,-,1,1
048 Marling,99,,-,1,1
048 Marling,Insgesamt,,1.328,1.310,2.638
049 Martell,0,,3,3,6
049 Martell,1,,3,4,7
049 Martell,2,,8,3,11
049 Martell,3,,5,4,9
049 Martell,4,,8,5,13
049 Martell,5,,9,4,13
049 Martell,6,,3,1,4
049 Martell,7,,7,1,8
049 Martell,8,,7,1,8
049 Martell,9,,4,5,9
049 Martell,10,,8,3,11
049 Martell,11,,6,1,7
049 Martell,12,,5,5,10
049 Martell,13,,3,6,9
049 Martell,14,,4,7,11
049 Martell,15,,7,2,9
049 Martell,16,,1,6,7
049 Martell,17,,6,6,12
049 Martell,18,,6,7,13
049 Martell,19,,4,7,11
049 Martell,20,,7,7,14
049 Martell,21,,6,8,14
049 Martell,22,,6,5,11
049 Martell,23,,4,3,7
049 Martell,24,,9,5,14
049 Martell,25,,6,5,11
049 Martell,26,,8,5,13
049 Martell,27,,4,-,4
049 Martell,28,,8,5,13
049 Martell,29,,-,3,3
049 Martell,30,,4,4,8
049 Martell,31,,4,1,5
049 Martell,32,,7,5,12
049 Martell,33,,5,10,15
049 Martell,34,,5,6,11
049 Martell,35,,8,3,11
049 Martell,36,,7,1,8
049 Martell,37,,4,5,9
049 Martell,38,,7,3,10
049 Martell,39,,5,5,10
049 Martell,40,,2,6,8
049 Martell,41,,7,11,18
049 Martell,42,,9,4,13
049 Martell,43,,6,8,14
049 Martell,44,,9,4,13
049 Martell,45,,7,4,11
049 Martell,46,,6,11,17
049 Martell,47,,8,6,14
049 Martell,48,,7,7,14
049 Martell,49,,15,5,20
049 Martell,50,,16,11,27
049 Martell,51,,7,9,16
049 Martell,52,,14,1,15
049 Martell,53,,10,6,16
049 Martell,54,,8,5,13
049 Martell,55,,9,3,12
049 Martell,56,,6,6,12
049 Martell,57,,7,6,13
049 Martell,58,,7,3,10
049 Martell,59,,5,4,9
049 Martell,60,,7,3,10
049 Martell,61,,5,6,11
049 Martell,62,,3,4,7
049 Martell,63,,3,3,6
049 Martell,64,,5,8,13
049 Martell,65,,2,5,7
049 Martell,66,,3,1,4
049 Martell,67,,4,4,8
049 Martell,68,,3,3,6
049 Martell,69,,3,-,3
049 Martell,70,,4,1,5
049 Martell,71,,1,3,4
049 Martell,72,,3,3,6
049 Martell,73,,5,5,10
049 Martell,74,,3,4,7
049 Martell,75,,6,2,8
049 Martell,76,,1,4,5
049 Martell,77,,2,5,7
049 Martell,78,,1,4,5
049 Martell,79,,2,4,6
049 Martell,80,,4,7,11
049 Martell,81,,6,1,7
049 Martell,82,,4,5,9
049 Martell,83,,2,1,3
049 Martell,84,,2,-,2
049 Martell,85,,2,2,4
049 Martell,86,,1,2,3
049 Martell,87,,1,1,2
049 Martell,88,,2,2,4
049 Martell,89,,-,2,2
049 Martell,90,,1,1,2
049 Martell,91,,1,3,4
049 Martell,92,,-,1,1
049 Martell,93,,-,1,1
049 Martell,Insgesamt,,478,391,869
050 Mölten,0,,12,8,20
050 Mölten,1,,9,7,16
050 Mölten,2,,15,14,29
050 Mölten,3,,9,7,16
050 Mölten,4,,13,10,23
050 Mölten,5,,4,14,18
050 Mölten,6,,14,13,27
050 Mölten,7,,11,14,25
050 Mölten,8,,12,8,20
050 Mölten,9,,8,8,16
050 Mölten,10,,10,14,24
050 Mölten,11,,12,9,21
050 Mölten,12,,11,8,19
050 Mölten,13,,16,11,27
050 Mölten,14,,16,17,33
050 Mölten,15,,13,14,27
050 Mölten,16,,12,16,28
050 Mölten,17,,7,15,22
050 Mölten,18,,9,7,16
050 Mölten,19,,15,12,27
050 Mölten,20,,12,9,21
050 Mölten,21,,13,5,18
050 Mölten,22,,11,11,22
050 Mölten,23,,6,14,20
050 Mölten,24,,7,7,14
050 Mölten,25,,9,5,14
050 Mölten,26,,12,3,15
050 Mölten,27,,8,10,18
050 Mölten,28,,9,7,16
050 Mölten,29,,10,6,16
050 Mölten,30,,8,8,16
050 Mölten,31,,8,7,15
050 Mölten,32,,8,7,15
050 Mölten,33,,12,13,25
050 Mölten,34,,13,12,25
050 Mölten,35,,15,6,21
050 Mölten,36,,12,15,27
050 Mölten,37,,11,8,19
050 Mölten,38,,6,15,21
050 Mölten,39,,11,20,31
050 Mölten,40,,25,11,36
050 Mölten,41,,10,12,22
050 Mölten,42,,18,18,36
050 Mölten,43,,9,11,20
050 Mölten,44,,13,15,28
050 Mölten,45,,17,11,28
050 Mölten,46,,14,13,27
050 Mölten,47,,17,17,34
050 Mölten,48,,18,15,33
050 Mölten,49,,16,13,29
050 Mölten,50,,12,13,25
050 Mölten,51,,21,16,37
050 Mölten,52,,18,7,25
050 Mölten,53,,16,10,26
050 Mölten,54,,15,11,26
050 Mölten,55,,10,8,18
050 Mölten,56,,14,5,19
050 Mölten,57,,3,7,10
050 Mölten,58,,8,3,11
050 Mölten,59,,7,8,15
050 Mölten,60,,12,8,20
050 Mölten,61,,6,7,13
050 Mölten,62,,5,7,12
050 Mölten,63,,6,6,12
050 Mölten,64,,5,4,9
050 Mölten,65,,9,9,18
050 Mölten,66,,8,4,12
050 Mölten,67,,8,4,12
050 Mölten,68,,3,8,11
050 Mölten,69,,8,3,11
050 Mölten,70,,5,5,10
050 Mölten,71,,1,7,8
050 Mölten,72,,10,9,19
050 Mölten,73,,5,9,14
050 Mölten,74,,8,4,12
050 Mölten,75,,3,6,9
050 Mölten,76,,5,6,11
050 Mölten,77,,3,2,5
050 Mölten,78,,4,6,10
050 Mölten,79,,2,3,5
050 Mölten,80,,6,6,12
050 Mölten,81,,7,4,11
050 Mölten,82,,5,8,13
050 Mölten,83,,2,6,8
050 Mölten,84,,6,1,7
050 Mölten,85,,3,2,5
050 Mölten,86,,1,4,5
050 Mölten,87,,1,2,3
050 Mölten,88,,-,1,1
050 Mölten,89,,1,3,4
050 Mölten,90,,-,3,3
050 Mölten,92,,-,2,2
050 Mölten,93,,1,1,2
050 Mölten,94,,-,2,2
050 Mölten,95,,-,2,2
050 Mölten,96,,-,1,1
050 Mölten,Insgesamt,,859,803,1.662
051 Meran,0,,193,197,390
051 Meran,1,,204,185,389
051 Meran,2,,189,179,368
051 Meran,3,,189,169,358
051 Meran,4,,197,205,402
051 Meran,5,,209,196,405
051 Meran,6,,199,182,381
051 Meran,7,,204,182,386
051 Meran,8,,226,203,429
051 Meran,9,,202,213,415
051 Meran,10,,194,179,373
051 Meran,11,,238,178,416
051 Meran,12,,196,170,366
051 Meran,13,,191,170,361
051 Meran,14,,211,192,403
051 Meran,15,,212,172,384
051 Meran,16,,191,192,383
051 Meran,17,,170,179,349
051 Meran,18,,209,175,384
051 Meran,19,,218,177,395
051 Meran,20,,203,171,374
051 Meran,21,,195,212,407
051 Meran,22,,168,184,352
051 Meran,23,,194,177,371
051 Meran,24,,192,223,415
051 Meran,25,,190,196,386
051 Meran,26,,239,229,468
051 Meran,27,,229,200,429
051 Meran,28,,211,221,432
051 Meran,29,,225,204,429
051 Meran,30,,200,245,445
051 Meran,31,,219,223,442
051 Meran,32,,216,236,452
051 Meran,33,,231,236,467
051 Meran,34,,243,254,497
051 Meran,35,,246,232,478
051 Meran,36,,230,244,474
051 Meran,37,,259,238,497
051 Meran,38,,244,274,518
051 Meran,39,,225,289,514
051 Meran,40,,256,289,545
051 Meran,41,,277,325,602
051 Meran,42,,276,312,588
051 Meran,43,,290,306,596
051 Meran,44,,325,291,616
051 Meran,45,,310,330,640
051 Meran,46,,340,342,682
051 Meran,47,,350,357,707
051 Meran,48,,357,348,705
051 Meran,49,,318,304,622
051 Meran,50,,325,336,661
051 Meran,51,,337,317,654
051 Meran,52,,336,309,645
051 Meran,53,,270,297,567
051 Meran,54,,283,308,591
051 Meran,55,,290,280,570
051 Meran,56,,264,253,517
051 Meran,57,,253,259,512
051 Meran,58,,217,260,477
051 Meran,59,,215,230,445
051 Meran,60,,201,226,427
051 Meran,61,,182,235,417
051 Meran,62,,177,236,413
051 Meran,63,,209,221,430
051 Meran,64,,187,221,408
051 Meran,65,,186,232,418
051 Meran,66,,228,252,480
051 Meran,67,,194,261,455
051 Meran,68,,221,276,497
051 Meran,69,,226,288,514
051 Meran,70,,178,204,382
051 Meran,71,,181,219,400
051 Meran,72,,244,233,477
051 Meran,73,,215,282,497
051 Meran,74,,193,270,463
051 Meran,75,,154,216,370
051 Meran,76,,167,233,400
051 Meran,77,,147,213,360
051 Meran,78,,152,207,359
051 Meran,79,,127,185,312
051 Meran,80,,119,175,294
051 Meran,81,,114,156,270
051 Meran,82,,119,141,260
051 Meran,83,,92,149,241
051 Meran,84,,69,134,203
051 Meran,85,,77,137,214
051 Meran,86,,61,105,166
051 Meran,87,,50,115,165
051 Meran,88,,51,85,136
051 Meran,89,,33,94,127
051 Meran,90,,27,79,106
051 Meran,91,,33,77,110
051 Meran,92,,19,60,79
051 Meran,93,,20,56,76
051 Meran,94,,7,47,54
051 Meran,95,,7,39,46
051 Meran,96,,6,15,21
051 Meran,97,,1,7,8
051 Meran,98,,2,13,15
051 Meran,99,,1,5,6
051 Meran,100,,2,5,7
051 Meran,101,,1,3,4
051 Meran,102,,1,1,2
051 Meran,103,,1,-,1
051 Meran,Insgesamt,,18.972,20.644,39.616
052 Welsberg-Taisten,0,,18,18,36
052 Welsberg-Taisten,1,,21,12,33
052 Welsberg-Taisten,2,,17,11,28
052 Welsberg-Taisten,3,,12,14,26
052 Welsberg-Taisten,4,,14,19,33
052 Welsberg-Taisten,5,,9,17,26
052 Welsberg-Taisten,6,,13,16,29
052 Welsberg-Taisten,7,,24,20,44
052 Welsberg-Taisten,8,,22,23,45
052 Welsberg-Taisten,9,,11,27,38
052 Welsberg-Taisten,10,,20,29,49
052 Welsberg-Taisten,11,,14,19,33
052 Welsberg-Taisten,12,,20,18,38
052 Welsberg-Taisten,13,,22,23,45
052 Welsberg-Taisten,14,,32,20,52
052 Welsberg-Taisten,15,,19,13,32
052 Welsberg-Taisten,16,,20,22,42
052 Welsberg-Taisten,17,,24,12,36
052 Welsberg-Taisten,18,,20,20,40
052 Welsberg-Taisten,19,,17,16,33
052 Welsberg-Taisten,20,,20,17,37
052 Welsberg-Taisten,21,,14,16,30
052 Welsberg-Taisten,22,,20,22,42
052 Welsberg-Taisten,23,,12,12,24
052 Welsberg-Taisten,24,,22,18,40
052 Welsberg-Taisten,25,,9,14,23
052 Welsberg-Taisten,26,,7,16,23
052 Welsberg-Taisten,27,,11,19,30
052 Welsberg-Taisten,28,,9,9,18
052 Welsberg-Taisten,29,,20,12,32
052 Welsberg-Taisten,30,,7,26,33
052 Welsberg-Taisten,31,,29,16,45
052 Welsberg-Taisten,32,,23,20,43
052 Welsberg-Taisten,33,,18,20,38
052 Welsberg-Taisten,34,,12,16,28
052 Welsberg-Taisten,35,,20,14,34
052 Welsberg-Taisten,36,,21,20,41
052 Welsberg-Taisten,37,,17,19,36
052 Welsberg-Taisten,38,,14,29,43
052 Welsberg-Taisten,39,,14,10,24
052 Welsberg-Taisten,40,,15,24,39
052 Welsberg-Taisten,41,,27,25,52
052 Welsberg-Taisten,42,,24,12,36
052 Welsberg-Taisten,43,,18,27,45
052 Welsberg-Taisten,44,,31,22,53
052 Welsberg-Taisten,45,,29,25,54
052 Welsberg-Taisten,46,,19,23,42
052 Welsberg-Taisten,47,,26,23,49
052 Welsberg-Taisten,48,,34,23,57
052 Welsberg-Taisten,49,,32,22,54
052 Welsberg-Taisten,50,,22,16,38
052 Welsberg-Taisten,51,,31,20,51
052 Welsberg-Taisten,52,,26,24,50
052 Welsberg-Taisten,53,,23,22,45
052 Welsberg-Taisten,54,,18,13,31
052 Welsberg-Taisten,55,,10,17,27
052 Welsberg-Taisten,56,,20,21,41
052 Welsberg-Taisten,57,,24,16,40
052 Welsberg-Taisten,58,,14,19,33
052 Welsberg-Taisten,59,,17,19,36
052 Welsberg-Taisten,60,,15,7,22
052 Welsberg-Taisten,61,,15,14,29
052 Welsberg-Taisten,62,,18,13,31
052 Welsberg-Taisten,63,,16,12,28
052 Welsberg-Taisten,64,,15,8,23
052 Welsberg-Taisten,65,,15,13,28
052 Welsberg-Taisten,66,,14,10,24
052 Welsberg-Taisten,67,,17,16,33
052 Welsberg-Taisten,68,,9,12,21
052 Welsberg-Taisten,69,,12,12,24
052 Welsberg-Taisten,70,,9,11,20
052 Welsberg-Taisten,71,,13,11,24
052 Welsberg-Taisten,72,,8,14,22
052 Welsberg-Taisten,73,,10,12,22
052 Welsberg-Taisten,74,,13,17,30
052 Welsberg-Taisten,75,,6,11,17
052 Welsberg-Taisten,76,,12,8,20
052 Welsberg-Taisten,77,,7,11,18
052 Welsberg-Taisten,78,,8,8,16
052 Welsberg-Taisten,79,,6,8,14
052 Welsberg-Taisten,80,,3,14,17
052 Welsberg-Taisten,81,,14,12,26
052 Welsberg-Taisten,82,,7,10,17
052 Welsberg-Taisten,83,,7,8,15
052 Welsberg-Taisten,84,,4,9,13
052 Welsberg-Taisten,85,,5,6,11
052 Welsberg-Taisten,86,,4,7,11
052 Welsberg-Taisten,87,,4,11,15
052 Welsberg-Taisten,88,,1,5,6
052 Welsberg-Taisten,89,,2,4,6
052 Welsberg-Taisten,90,,-,3,3
052 Welsberg-Taisten,91,,1,4,5
052 Welsberg-Taisten,92,,3,2,5
052 Welsberg-Taisten,93,,1,2,3
052 Welsberg-Taisten,94,,1,3,4
052 Welsberg-Taisten,95,,-,1,1
052 Welsberg-Taisten,96,,-,1,1
052 Welsberg-Taisten,Insgesamt,,1.443,1.457,2.900
053 Montan,0,,3,11,14
053 Montan,1,,11,5,16
053 Montan,2,,8,4,12
053 Montan,3,,10,7,17
053 Montan,4,,10,2,12
053 Montan,5,,14,9,23
053 Montan,6,,6,7,13
053 Montan,7,,12,8,20
053 Montan,8,,8,4,12
053 Montan,9,,8,7,15
053 Montan,10,,8,9,17
053 Montan,11,,6,10,16
053 Montan,12,,9,12,21
053 Montan,13,,6,4,10
053 Montan,14,,13,4,17
053 Montan,15,,9,6,15
053 Montan,16,,8,11,19
053 Montan,17,,9,15,24
053 Montan,18,,7,9,16
053 Montan,19,,14,12,26
053 Montan,20,,16,15,31
053 Montan,21,,12,4,16
053 Montan,22,,6,7,13
053 Montan,23,,5,8,13
053 Montan,24,,13,11,24
053 Montan,25,,10,7,17
053 Montan,26,,9,10,19
053 Montan,27,,11,19,30
053 Montan,28,,14,18,32
053 Montan,29,,15,9,24
053 Montan,30,,9,7,16
053 Montan,31,,9,6,15
053 Montan,32,,14,12,26
053 Montan,33,,10,8,18
053 Montan,34,,14,13,27
053 Montan,35,,8,6,14
053 Montan,36,,13,8,21
053 Montan,37,,14,5,19
053 Montan,38,,9,6,15
053 Montan,39,,8,6,14
053 Montan,40,,10,16,26
053 Montan,41,,9,17,26
053 Montan,42,,11,6,17
053 Montan,43,,11,9,20
053 Montan,44,,11,10,21
053 Montan,45,,13,13,26
053 Montan,46,,14,18,32
053 Montan,47,,12,19,31
053 Montan,48,,13,11,24
053 Montan,49,,13,16,29
053 Montan,50,,27,16,43
053 Montan,51,,14,10,24
053 Montan,52,,13,21,34
053 Montan,53,,16,17,33
053 Montan,54,,19,11,30
053 Montan,55,,13,10,23
053 Montan,56,,15,10,25
053 Montan,57,,9,10,19
053 Montan,58,,11,12,23
053 Montan,59,,8,14,22
053 Montan,60,,7,14,21
053 Montan,61,,10,12,22
053 Montan,62,,11,6,17
053 Montan,63,,12,3,15
053 Montan,64,,6,7,13
053 Montan,65,,4,4,8
053 Montan,66,,8,4,12
053 Montan,67,,5,5,10
053 Montan,68,,6,10,16
053 Montan,69,,5,3,8
053 Montan,70,,5,3,8
053 Montan,71,,3,4,7
053 Montan,72,,5,7,12
053 Montan,73,,5,6,11
053 Montan,74,,6,7,13
053 Montan,75,,8,7,15
053 Montan,76,,4,9,13
053 Montan,77,,5,9,14
053 Montan,78,,1,6,7
053 Montan,79,,6,9,15
053 Montan,80,,1,7,8
053 Montan,81,,2,6,8
053 Montan,82,,12,3,15
053 Montan,83,,5,6,11
053 Montan,84,,4,9,13
053 Montan,85,,6,10,16
053 Montan,86,,3,7,10
053 Montan,87,,2,2,4
053 Montan,88,,1,4,5
053 Montan,89,,3,5,8
053 Montan,90,,-,5,5
053 Montan,91,,-,4,4
053 Montan,92,,-,4,4
053 Montan,93,,1,1,2
053 Montan,94,,-,1,1
053 Montan,95,,-,1,1
053 Montan,96,,-,2,2
053 Montan,97,,-,1,1
053 Montan,Insgesamt,,822,820,1.642
054 Moos in Passeier,0,,13,9,22
054 Moos in Passeier,1,,15,17,32
054 Moos in Passeier,2,,13,11,24
054 Moos in Passeier,3,,11,13,24
054 Moos in Passeier,4,,21,10,31
054 Moos in Passeier,5,,8,9,17
054 Moos in Passeier,6,,9,14,23
054 Moos in Passeier,7,,17,11,28
054 Moos in Passeier,8,,18,7,25
054 Moos in Passeier,9,,17,10,27
054 Moos in Passeier,10,,17,14,31
054 Moos in Passeier,11,,17,21,38
054 Moos in Passeier,12,,16,10,26
054 Moos in Passeier,13,,20,18,38
054 Moos in Passeier,14,,12,12,24
054 Moos in Passeier,15,,11,17,28
054 Moos in Passeier,16,,24,9,33
054 Moos in Passeier,17,,16,13,29
054 Moos in Passeier,18,,11,17,28
054 Moos in Passeier,19,,18,18,36
054 Moos in Passeier,20,,8,10,18
054 Moos in Passeier,21,,17,17,34
054 Moos in Passeier,22,,15,12,27
054 Moos in Passeier,23,,18,15,33
054 Moos in Passeier,24,,12,14,26
054 Moos in Passeier,25,,11,14,25
054 Moos in Passeier,26,,13,12,25
054 Moos in Passeier,27,,17,14,31
054 Moos in Passeier,28,,15,12,27
054 Moos in Passeier,29,,13,12,25
054 Moos in Passeier,30,,19,11,30
054 Moos in Passeier,31,,16,17,33
054 Moos in Passeier,32,,10,11,21
054 Moos in Passeier,33,,13,13,26
054 Moos in Passeier,34,,11,14,25
054 Moos in Passeier,35,,10,14,24
054 Moos in Passeier,36,,16,9,25
054 Moos in Passeier,37,,17,13,30
054 Moos in Passeier,38,,17,13,30
054 Moos in Passeier,39,,15,8,23
054 Moos in Passeier,40,,14,11,25
054 Moos in Passeier,41,,23,13,36
054 Moos in Passeier,42,,6,19,25
054 Moos in Passeier,43,,17,14,31
054 Moos in Passeier,44,,18,15,33
054 Moos in Passeier,45,,19,9,28
054 Moos in Passeier,46,,15,17,32
054 Moos in Passeier,47,,16,17,33
054 Moos in Passeier,48,,21,15,36
054 Moos in Passeier,49,,21,16,37
054 Moos in Passeier,50,,19,8,27
054 Moos in Passeier,51,,20,10,30
054 Moos in Passeier,52,,14,17,31
054 Moos in Passeier,53,,10,18,28
054 Moos in Passeier,54,,10,8,18
054 Moos in Passeier,55,,13,14,27
054 Moos in Passeier,56,,14,11,25
054 Moos in Passeier,57,,13,13,26
054 Moos in Passeier,58,,19,5,24
054 Moos in Passeier,59,,8,8,16
054 Moos in Passeier,60,,8,6,14
054 Moos in Passeier,61,,13,9,22
054 Moos in Passeier,62,,7,7,14
054 Moos in Passeier,63,,8,3,11
054 Moos in Passeier,64,,9,10,19
054 Moos in Passeier,65,,5,9,14
054 Moos in Passeier,66,,12,9,21
054 Moos in Passeier,67,,5,6,11
054 Moos in Passeier,68,,16,10,26
054 Moos in Passeier,69,,8,8,16
054 Moos in Passeier,70,,9,5,14
054 Moos in Passeier,71,,8,7,15
054 Moos in Passeier,72,,12,11,23
054 Moos in Passeier,73,,4,11,15
054 Moos in Passeier,74,,8,13,21
054 Moos in Passeier,75,,7,6,13
054 Moos in Passeier,76,,5,4,9
054 Moos in Passeier,77,,9,5,14
054 Moos in Passeier,78,,4,6,10
054 Moos in Passeier,79,,7,6,13
054 Moos in Passeier,80,,7,5,12
054 Moos in Passeier,81,,10,13,23
054 Moos in Passeier,82,,5,9,14
054 Moos in Passeier,83,,7,1,8
054 Moos in Passeier,84,,3,4,7
054 Moos in Passeier,85,,4,4,8
054 Moos in Passeier,86,,5,8,13
054 Moos in Passeier,87,,2,6,8
054 Moos in Passeier,88,,2,2,4
054 Moos in Passeier,89,,3,2,5
054 Moos in Passeier,90,,-,4,4
054 Moos in Passeier,91,,1,2,3
054 Moos in Passeier,92,,2,1,3
054 Moos in Passeier,95,,-,1,1
054 Moos in Passeier,96,,-,1,1
054 Moos in Passeier,Insgesamt,,1.112,987,2.099
055 Nals,0,,18,12,30
055 Nals,1,,12,9,21
055 Nals,2,,16,14,30
055 Nals,3,,10,7,17
055 Nals,4,,13,14,27
055 Nals,5,,8,14,22
055 Nals,6,,9,11,20
055 Nals,7,,12,5,17
055 Nals,8,,11,10,21
055 Nals,9,,11,3,14
055 Nals,10,,7,12,19
055 Nals,11,,7,10,17
055 Nals,12,,11,5,16
055 Nals,13,,12,14,26
055 Nals,14,,8,9,17
055 Nals,15,,8,14,22
055 Nals,16,,13,9,22
055 Nals,17,,15,8,23
055 Nals,18,,11,10,21
055 Nals,19,,13,12,25
055 Nals,20,,7,6,13
055 Nals,21,,9,11,20
055 Nals,22,,7,13,20
055 Nals,23,,11,10,21
055 Nals,24,,11,11,22
055 Nals,25,,8,10,18
055 Nals,26,,17,14,31
055 Nals,27,,15,14,29
055 Nals,28,,11,10,21
055 Nals,29,,8,7,15
055 Nals,30,,13,18,31
055 Nals,31,,9,10,19
055 Nals,32,,7,10,17
055 Nals,33,,9,14,23
055 Nals,34,,12,13,25
055 Nals,35,,16,11,27
055 Nals,36,,16,14,30
055 Nals,37,,13,15,28
055 Nals,38,,9,17,26
055 Nals,39,,15,15,30
055 Nals,40,,8,13,21
055 Nals,41,,23,16,39
055 Nals,42,,18,10,28
055 Nals,43,,12,18,30
055 Nals,44,,16,17,33
055 Nals,45,,21,12,33
055 Nals,46,,23,19,42
055 Nals,47,,28,17,45
055 Nals,48,,19,16,35
055 Nals,49,,14,16,30
055 Nals,50,,18,18,36
055 Nals,51,,16,24,40
055 Nals,52,,12,21,33
055 Nals,53,,13,13,26
055 Nals,54,,18,15,33
055 Nals,55,,16,13,29
055 Nals,56,,14,18,32
055 Nals,57,,16,13,29
055 Nals,58,,9,7,16
055 Nals,59,,7,9,16
055 Nals,60,,21,13,34
055 Nals,61,,7,5,12
055 Nals,62,,8,8,16
055 Nals,63,,4,6,10
055 Nals,64,,5,9,14
055 Nals,65,,8,11,19
055 Nals,66,,10,8,18
055 Nals,67,,9,12,21
055 Nals,68,,12,6,18
055 Nals,69,,7,13,20
055 Nals,70,,7,11,18
055 Nals,71,,6,11,17
055 Nals,72,,7,6,13
055 Nals,73,,5,9,14
055 Nals,74,,11,5,16
055 Nals,75,,6,11,17
055 Nals,76,,7,11,18
055 Nals,77,,4,8,12
055 Nals,78,,3,12,15
055 Nals,79,,5,4,9
055 Nals,80,,5,5,10
055 Nals,81,,3,6,9
055 Nals,82,,6,9,15
055 Nals,83,,5,4,9
055 Nals,84,,2,5,7
055 Nals,85,,1,4,5
055 Nals,86,,5,5,10
055 Nals,87,,4,5,9
055 Nals,88,,1,4,5
055 Nals,89,,4,1,5
055 Nals,90,,1,-,1
055 Nals,91,,1,-,1
055 Nals,92,,-,2,2
055 Nals,93,,-,2,2
055 Nals,94,,-,1,1
055 Nals,96,,-,1,1
055 Nals,Insgesamt,,959,983,1.942
056 Naturns,0,,25,31,56
056 Naturns,1,,33,17,50
056 Naturns,2,,33,32,65
056 Naturns,3,,36,32,68
056 Naturns,4,,36,30,66
056 Naturns,5,,33,22,55
056 Naturns,6,,22,27,49
056 Naturns,7,,36,21,57
056 Naturns,8,,34,35,69
056 Naturns,9,,39,31,70
056 Naturns,10,,32,25,57
056 Naturns,11,,35,31,66
056 Naturns,12,,37,22,59
056 Naturns,13,,28,28,56
056 Naturns,14,,33,29,62
056 Naturns,15,,32,26,58
056 Naturns,16,,28,30,58
056 Naturns,17,,29,37,66
056 Naturns,18,,22,17,39
056 Naturns,19,,33,37,70
056 Naturns,20,,46,36,82
056 Naturns,21,,34,38,72
056 Naturns,22,,35,42,77
056 Naturns,23,,30,46,76
056 Naturns,24,,49,40,89
056 Naturns,25,,41,31,72
056 Naturns,26,,41,31,72
056 Naturns,27,,46,30,76
056 Naturns,28,,30,24,54
056 Naturns,29,,27,34,61
056 Naturns,30,,40,29,69
056 Naturns,31,,38,21,59
056 Naturns,32,,33,37,70
056 Naturns,33,,44,43,87
056 Naturns,34,,40,48,88
056 Naturns,35,,38,42,80
056 Naturns,36,,48,38,86
056 Naturns,37,,43,44,87
056 Naturns,38,,39,44,83
056 Naturns,39,,44,35,79
056 Naturns,40,,48,40,88
056 Naturns,41,,42,43,85
056 Naturns,42,,48,47,95
056 Naturns,43,,52,52,104
056 Naturns,44,,45,45,90
056 Naturns,45,,54,42,96
056 Naturns,46,,44,47,91
056 Naturns,47,,50,40,90
056 Naturns,48,,46,48,94
056 Naturns,49,,54,47,101
056 Naturns,50,,38,57,95
056 Naturns,51,,51,36,87
056 Naturns,52,,42,47,89
056 Naturns,53,,38,44,82
056 Naturns,54,,43,51,94
056 Naturns,55,,56,39,95
056 Naturns,56,,41,40,81
056 Naturns,57,,32,35,67
056 Naturns,58,,36,34,70
056 Naturns,59,,45,44,89
056 Naturns,60,,31,31,62
056 Naturns,61,,39,33,72
056 Naturns,62,,31,22,53
056 Naturns,63,,29,36,65
056 Naturns,64,,32,32,64
056 Naturns,65,,28,31,59
056 Naturns,66,,23,20,43
056 Naturns,67,,26,22,48
056 Naturns,68,,8,24,32
056 Naturns,69,,22,27,49
056 Naturns,70,,25,18,43
056 Naturns,71,,17,19,36
056 Naturns,72,,24,32,56
056 Naturns,73,,29,32,61
056 Naturns,74,,32,28,60
056 Naturns,75,,23,20,43
056 Naturns,76,,17,22,39
056 Naturns,77,,19,17,36
056 Naturns,78,,20,17,37
056 Naturns,79,,15,21,36
056 Naturns,80,,13,11,24
056 Naturns,81,,14,18,32
056 Naturns,82,,13,13,26
056 Naturns,83,,8,13,21
056 Naturns,84,,7,15,22
056 Naturns,85,,10,17,27
056 Naturns,86,,7,13,20
056 Naturns,87,,7,7,14
056 Naturns,88,,1,10,11
056 Naturns,89,,6,7,13
056 Naturns,90,,7,7,14
056 Naturns,91,,4,5,9
056 Naturns,92,,-,5,5
056 Naturns,93,,-,2,2
056 Naturns,94,,-,4,4
056 Naturns,96,,-,3,3
056 Naturns,Insgesamt,,2.914,2.825,5.739
057 Natz-Schabs,0,,20,30,50
057 Natz-Schabs,1,,30,19,49
057 Natz-Schabs,2,,21,25,46
057 Natz-Schabs,3,,15,28,43
057 Natz-Schabs,4,,30,16,46
057 Natz-Schabs,5,,15,13,28
057 Natz-Schabs,6,,10,23,33
057 Natz-Schabs,7,,16,24,40
057 Natz-Schabs,8,,14,14,28
057 Natz-Schabs,9,,14,18,32
057 Natz-Schabs,10,,13,15,28
057 Natz-Schabs,11,,15,18,33
057 Natz-Schabs,12,,18,18,36
057 Natz-Schabs,13,,23,21,44
057 Natz-Schabs,14,,17,14,31
057 Natz-Schabs,15,,22,18,40
057 Natz-Schabs,16,,14,18,32
057 Natz-Schabs,17,,23,19,42
057 Natz-Schabs,18,,20,18,38
057 Natz-Schabs,19,,22,19,41
057 Natz-Schabs,20,,13,14,27
057 Natz-Schabs,21,,22,15,37
057 Natz-Schabs,22,,17,18,35
057 Natz-Schabs,23,,15,17,32
057 Natz-Schabs,24,,22,24,46
057 Natz-Schabs,25,,15,22,37
057 Natz-Schabs,26,,17,31,48
057 Natz-Schabs,27,,25,15,40
057 Natz-Schabs,28,,25,27,52
057 Natz-Schabs,29,,22,21,43
057 Natz-Schabs,30,,19,23,42
057 Natz-Schabs,31,,24,17,41
057 Natz-Schabs,32,,17,34,51
057 Natz-Schabs,33,,17,33,50
057 Natz-Schabs,34,,25,22,47
057 Natz-Schabs,35,,28,22,50
057 Natz-Schabs,36,,21,20,41
057 Natz-Schabs,37,,19,30,49
057 Natz-Schabs,38,,21,21,42
057 Natz-Schabs,39,,17,21,38
057 Natz-Schabs,40,,24,27,51
057 Natz-Schabs,41,,30,30,60
057 Natz-Schabs,42,,31,19,50
057 Natz-Schabs,43,,24,25,49
057 Natz-Schabs,44,,25,24,49
057 Natz-Schabs,45,,36,24,60
057 Natz-Schabs,46,,29,25,54
057 Natz-Schabs,47,,29,23,52
057 Natz-Schabs,48,,27,22,49
057 Natz-Schabs,49,,30,22,52
057 Natz-Schabs,50,,35,34,69
057 Natz-Schabs,51,,32,29,61
057 Natz-Schabs,52,,24,29,53
057 Natz-Schabs,53,,17,23,40
057 Natz-Schabs,54,,17,20,37
057 Natz-Schabs,55,,30,23,53
057 Natz-Schabs,56,,21,20,41
057 Natz-Schabs,57,,23,19,42
057 Natz-Schabs,58,,20,21,41
057 Natz-Schabs,59,,17,22,39
057 Natz-Schabs,60,,19,17,36
057 Natz-Schabs,61,,11,15,26
057 Natz-Schabs,62,,20,15,35
057 Natz-Schabs,63,,13,10,23
057 Natz-Schabs,64,,15,13,28
057 Natz-Schabs,65,,14,13,27
057 Natz-Schabs,66,,18,15,33
057 Natz-Schabs,67,,15,12,27
057 Natz-Schabs,68,,11,15,26
057 Natz-Schabs,69,,14,12,26
057 Natz-Schabs,70,,8,7,15
057 Natz-Schabs,71,,13,10,23
057 Natz-Schabs,72,,14,6,20
057 Natz-Schabs,73,,12,8,20
057 Natz-Schabs,74,,12,8,20
057 Natz-Schabs,75,,3,7,10
057 Natz-Schabs,76,,1,5,6
057 Natz-Schabs,77,,5,5,10
057 Natz-Schabs,78,,6,6,12
057 Natz-Schabs,79,,5,4,9
057 Natz-Schabs,80,,5,5,10
057 Natz-Schabs,81,,2,3,5
057 Natz-Schabs,82,,6,8,14
057 Natz-Schabs,83,,2,5,7
057 Natz-Schabs,84,,3,4,7
057 Natz-Schabs,85,,3,8,11
057 Natz-Schabs,86,,6,2,8
057 Natz-Schabs,87,,1,2,3
057 Natz-Schabs,88,,-,2,2
057 Natz-Schabs,89,,1,1,2
057 Natz-Schabs,90,,1,1,2
057 Natz-Schabs,91,,-,2,2
057 Natz-Schabs,92,,-,1,1
057 Natz-Schabs,93,,2,1,3
057 Natz-Schabs,94,,1,1,2
057 Natz-Schabs,Insgesamt,,1.556,1.565,3.121
058 Welschnofen,0,,6,11,17
058 Welschnofen,1,,12,9,21
058 Welschnofen,2,,6,5,11
058 Welschnofen,3,,10,12,22
058 Welschnofen,4,,13,4,17
058 Welschnofen,5,,4,8,12
058 Welschnofen,6,,9,3,12
058 Welschnofen,7,,9,8,17
058 Welschnofen,8,,9,7,16
058 Welschnofen,9,,7,8,15
058 Welschnofen,10,,7,10,17
058 Welschnofen,11,,15,8,23
058 Welschnofen,12,,10,7,17
058 Welschnofen,13,,16,8,24
058 Welschnofen,14,,6,9,15
058 Welschnofen,15,,8,8,16
058 Welschnofen,16,,8,13,21
058 Welschnofen,17,,12,9,21
058 Welschnofen,18,,12,11,23
058 Welschnofen,19,,9,9,18
058 Welschnofen,20,,14,15,29
058 Welschnofen,21,,12,9,21
058 Welschnofen,22,,14,10,24
058 Welschnofen,23,,18,15,33
058 Welschnofen,24,,15,12,27
058 Welschnofen,25,,12,13,25
058 Welschnofen,26,,14,9,23
058 Welschnofen,27,,13,15,28
058 Welschnofen,28,,10,16,26
058 Welschnofen,29,,7,10,17
058 Welschnofen,30,,13,14,27
058 Welschnofen,31,,7,7,14
058 Welschnofen,32,,12,14,26
058 Welschnofen,33,,14,12,26
058 Welschnofen,34,,13,15,28
058 Welschnofen,35,,14,12,26
058 Welschnofen,36,,9,10,19
058 Welschnofen,37,,12,17,29
058 Welschnofen,38,,13,13,26
058 Welschnofen,39,,17,8,25
058 Welschnofen,40,,20,13,33
058 Welschnofen,41,,12,16,28
058 Welschnofen,42,,16,16,32
058 Welschnofen,43,,12,10,22
058 Welschnofen,44,,17,21,38
058 Welschnofen,45,,19,16,35
058 Welschnofen,46,,12,15,27
058 Welschnofen,47,,22,17,39
058 Welschnofen,48,,15,15,30
058 Welschnofen,49,,13,13,26
058 Welschnofen,50,,25,15,40
058 Welschnofen,51,,17,9,26
058 Welschnofen,52,,18,15,33
058 Welschnofen,53,,15,13,28
058 Welschnofen,54,,14,16,30
058 Welschnofen,55,,18,11,29
058 Welschnofen,56,,13,13,26
058 Welschnofen,57,,17,10,27
058 Welschnofen,58,,10,13,23
058 Welschnofen,59,,12,11,23
058 Welschnofen,60,,15,14,29
058 Welschnofen,61,,13,11,24
058 Welschnofen,62,,11,12,23
058 Welschnofen,63,,11,11,22
058 Welschnofen,64,,13,7,20
058 Welschnofen,65,,8,9,17
058 Welschnofen,66,,9,13,22
058 Welschnofen,67,,9,10,19
058 Welschnofen,68,,8,7,15
058 Welschnofen,69,,12,10,22
058 Welschnofen,70,,12,4,16
058 Welschnofen,71,,6,9,15
058 Welschnofen,72,,13,9,22
058 Welschnofen,73,,10,12,22
058 Welschnofen,74,,9,6,15
058 Welschnofen,75,,4,7,11
058 Welschnofen,76,,9,6,15
058 Welschnofen,77,,6,8,14
058 Welschnofen,78,,7,3,10
058 Welschnofen,79,,3,12,15
058 Welschnofen,80,,6,6,12
058 Welschnofen,81,,8,9,17
058 Welschnofen,82,,5,11,16
058 Welschnofen,83,,6,6,12
058 Welschnofen,84,,2,6,8
058 Welschnofen,85,,2,7,9
058 Welschnofen,86,,1,10,11
058 Welschnofen,87,,5,1,6
058 Welschnofen,88,,-,3,3
058 Welschnofen,89,,1,4,5
058 Welschnofen,90,,2,2,4
058 Welschnofen,91,,-,4,4
058 Welschnofen,92,,1,4,5
058 Welschnofen,93,,3,3,6
058 Welschnofen,94,,-,5,5
058 Welschnofen,95,,-,2,2
058 Welschnofen,96,,1,-,1
058 Welschnofen,Insgesamt,,989,954,1.943
059 Deutschnofen,0,,18,15,33
059 Deutschnofen,1,,17,10,27
059 Deutschnofen,2,,29,12,41
059 Deutschnofen,3,,21,19,40
059 Deutschnofen,4,,14,18,32
059 Deutschnofen,5,,23,17,40
059 Deutschnofen,6,,28,19,47
059 Deutschnofen,7,,17,19,36
059 Deutschnofen,8,,18,17,35
059 Deutschnofen,9,,22,27,49
059 Deutschnofen,10,,28,33,61
059 Deutschnofen,11,,17,30,47
059 Deutschnofen,12,,17,34,51
059 Deutschnofen,13,,32,14,46
059 Deutschnofen,14,,24,32,56
059 Deutschnofen,15,,23,27,50
059 Deutschnofen,16,,28,24,52
059 Deutschnofen,17,,34,13,47
059 Deutschnofen,18,,23,30,53
059 Deutschnofen,19,,20,28,48
059 Deutschnofen,20,,26,24,50
059 Deutschnofen,21,,26,15,41
059 Deutschnofen,22,,23,25,48
059 Deutschnofen,23,,34,28,62
059 Deutschnofen,24,,26,16,42
059 Deutschnofen,25,,32,31,63
059 Deutschnofen,26,,23,21,44
059 Deutschnofen,27,,21,31,52
059 Deutschnofen,28,,20,25,45
059 Deutschnofen,29,,29,23,52
059 Deutschnofen,30,,25,23,48
059 Deutschnofen,31,,30,28,58
059 Deutschnofen,32,,24,24,48
059 Deutschnofen,33,,19,27,46
059 Deutschnofen,34,,22,17,39
059 Deutschnofen,35,,26,28,54
059 Deutschnofen,36,,21,23,44
059 Deutschnofen,37,,22,17,39
059 Deutschnofen,38,,30,21,51
059 Deutschnofen,39,,24,27,51
059 Deutschnofen,40,,21,21,42
059 Deutschnofen,41,,27,31,58
059 Deutschnofen,42,,24,30,54
059 Deutschnofen,43,,30,34,64
059 Deutschnofen,44,,29,24,53
059 Deutschnofen,45,,31,32,63
059 Deutschnofen,46,,38,29,67
059 Deutschnofen,47,,26,35,61
059 Deutschnofen,48,,26,29,55
059 Deutschnofen,49,,37,38,75
059 Deutschnofen,50,,34,20,54
059 Deutschnofen,51,,31,31,62
059 Deutschnofen,52,,36,26,62
059 Deutschnofen,53,,24,30,54
059 Deutschnofen,54,,33,24,57
059 Deutschnofen,55,,41,27,68
059 Deutschnofen,56,,29,18,47
059 Deutschnofen,57,,21,28,49
059 Deutschnofen,58,,20,25,45
059 Deutschnofen,59,,29,27,56
059 Deutschnofen,60,,33,21,54
059 Deutschnofen,61,,27,23,50
059 Deutschnofen,62,,22,16,38
059 Deutschnofen,63,,24,21,45
059 Deutschnofen,64,,20,16,36
059 Deutschnofen,65,,17,18,35
059 Deutschnofen,66,,17,16,33
059 Deutschnofen,67,,23,16,39
059 Deutschnofen,68,,10,12,22
059 Deutschnofen,69,,16,21,37
059 Deutschnofen,70,,14,14,28
059 Deutschnofen,71,,15,15,30
059 Deutschnofen,72,,18,22,40
059 Deutschnofen,73,,16,17,33
059 Deutschnofen,74,,16,20,36
059 Deutschnofen,75,,13,16,29
059 Deutschnofen,76,,21,13,34
059 Deutschnofen,77,,14,18,32
059 Deutschnofen,78,,10,4,14
059 Deutschnofen,79,,11,9,20
059 Deutschnofen,80,,5,8,13
059 Deutschnofen,81,,10,7,17
059 Deutschnofen,82,,5,13,18
059 Deutschnofen,83,,11,11,22
059 Deutschnofen,84,,4,8,12
059 Deutschnofen,85,,5,8,13
059 Deutschnofen,86,,4,3,7
059 Deutschnofen,87,,4,14,18
059 Deutschnofen,88,,6,9,15
059 Deutschnofen,89,,6,6,12
059 Deutschnofen,90,,1,10,11
059 Deutschnofen,91,,1,4,5
059 Deutschnofen,92,,1,5,6
059 Deutschnofen,93,,2,4,6
059 Deutschnofen,94,,-,4,4
059 Deutschnofen,95,,-,3,3
059 Deutschnofen,96,,-,1,1
059 Deutschnofen,97,,-,1,1
059 Deutschnofen,98,,-,1,1
059 Deutschnofen,Insgesamt,,1.965,1.919,3.884
060 Auer,0,,21,13,34
060 Auer,1,,20,28,48
060 Auer,2,,20,13,33
060 Auer,3,,20,11,31
060 Auer,4,,22,25,47
060 Auer,5,,22,12,34
060 Auer,6,,16,27,43
060 Auer,7,,10,22,32
060 Auer,8,,20,14,34
060 Auer,9,,17,16,33
060 Auer,10,,25,22,47
060 Auer,11,,20,21,41
060 Auer,12,,20,13,33
060 Auer,13,,33,18,51
060 Auer,14,,15,27,42
060 Auer,15,,23,19,42
060 Auer,16,,19,25,44
060 Auer,17,,23,25,48
060 Auer,18,,22,19,41
060 Auer,19,,21,21,42
060 Auer,20,,18,18,36
060 Auer,21,,26,24,50
060 Auer,22,,11,22,33
060 Auer,23,,21,20,41
060 Auer,24,,30,23,53
060 Auer,25,,15,18,33
060 Auer,26,,19,24,43
060 Auer,27,,21,31,52
060 Auer,28,,23,17,40
060 Auer,29,,20,20,40
060 Auer,30,,21,36,57
060 Auer,31,,23,18,41
060 Auer,32,,15,17,32
060 Auer,33,,25,29,54
060 Auer,34,,26,17,43
060 Auer,35,,21,17,38
060 Auer,36,,27,24,51
060 Auer,37,,18,21,39
060 Auer,38,,20,34,54
060 Auer,39,,25,30,55
060 Auer,40,,19,15,34
060 Auer,41,,29,27,56
060 Auer,42,,24,27,51
060 Auer,43,,17,25,42
060 Auer,44,,41,28,69
060 Auer,45,,30,28,58
060 Auer,46,,21,30,51
060 Auer,47,,32,38,70
060 Auer,48,,27,27,54
060 Auer,49,,37,41,78
060 Auer,50,,36,27,63
060 Auer,51,,28,25,53
060 Auer,52,,32,43,75
060 Auer,53,,28,24,52
060 Auer,54,,34,33,67
060 Auer,55,,29,31,60
060 Auer,56,,35,31,66
060 Auer,57,,35,25,60
060 Auer,58,,20,26,46
060 Auer,59,,29,31,60
060 Auer,60,,14,21,35
060 Auer,61,,20,14,34
060 Auer,62,,17,23,40
060 Auer,63,,18,23,41
060 Auer,64,,14,20,34
060 Auer,65,,15,19,34
060 Auer,66,,14,12,26
060 Auer,67,,27,14,41
060 Auer,68,,18,17,35
060 Auer,69,,13,23,36
060 Auer,70,,10,14,24
060 Auer,71,,21,14,35
060 Auer,72,,11,18,29
060 Auer,73,,14,18,32
060 Auer,74,,17,14,31
060 Auer,75,,10,8,18
060 Auer,76,,10,20,30
060 Auer,77,,14,17,31
060 Auer,78,,7,10,17
060 Auer,79,,7,8,15
060 Auer,80,,7,15,22
060 Auer,81,,13,12,25
060 Auer,82,,3,8,11
060 Auer,83,,2,10,12
060 Auer,84,,4,9,13
060 Auer,85,,3,5,8
060 Auer,86,,4,11,15
060 Auer,87,,4,4,8
060 Auer,88,,2,7,9
060 Auer,89,,-,14,14
060 Auer,90,,8,3,11
060 Auer,91,,3,5,8
060 Auer,92,,3,6,9
060 Auer,93,,1,5,6
060 Auer,94,,-,2,2
060 Auer,95,,2,1,3
060 Auer,96,,-,2,2
060 Auer,97,,-,2,2
060 Auer,100,,-,1,1
060 Auer,102,,1,-,1
060 Auer,Insgesamt,,1.768,1.882,3.650
061 St.Ulrich,0,,28,16,44
061 St.Ulrich,1,,29,28,57
061 St.Ulrich,2,,19,23,42
061 St.Ulrich,3,,19,14,33
061 St.Ulrich,4,,28,30,58
061 St.Ulrich,5,,22,23,45
061 St.Ulrich,6,,23,19,42
061 St.Ulrich,7,,35,24,59
061 St.Ulrich,8,,30,34,64
061 St.Ulrich,9,,34,27,61
061 St.Ulrich,10,,33,22,55
061 St.Ulrich,11,,22,31,53
061 St.Ulrich,12,,23,27,50
061 St.Ulrich,13,,24,39,63
061 St.Ulrich,14,,23,23,46
061 St.Ulrich,15,,30,35,65
061 St.Ulrich,16,,43,32,75
061 St.Ulrich,17,,49,36,85
061 St.Ulrich,18,,37,28,65
061 St.Ulrich,19,,30,24,54
061 St.Ulrich,20,,30,30,60
061 St.Ulrich,21,,27,30,57
061 St.Ulrich,22,,25,33,58
061 St.Ulrich,23,,36,31,67
061 St.Ulrich,24,,30,35,65
061 St.Ulrich,25,,32,25,57
061 St.Ulrich,26,,20,21,41
061 St.Ulrich,27,,21,28,49
061 St.Ulrich,28,,31,22,53
061 St.Ulrich,29,,26,23,49
061 St.Ulrich,30,,23,17,40
061 St.Ulrich,31,,23,19,42
061 St.Ulrich,32,,18,22,40
061 St.Ulrich,33,,27,33,60
061 St.Ulrich,34,,23,35,58
061 St.Ulrich,35,,24,34,58
061 St.Ulrich,36,,26,34,60
061 St.Ulrich,37,,20,32,52
061 St.Ulrich,38,,23,23,46
061 St.Ulrich,39,,34,35,69
061 St.Ulrich,40,,37,25,62
061 St.Ulrich,41,,37,34,71
061 St.Ulrich,42,,35,29,64
061 St.Ulrich,43,,44,34,78
061 St.Ulrich,44,,39,37,76
061 St.Ulrich,45,,39,36,75
061 St.Ulrich,46,,39,45,84
061 St.Ulrich,47,,40,42,82
061 St.Ulrich,48,,38,39,77
061 St.Ulrich,49,,33,39,72
061 St.Ulrich,50,,36,29,65
061 St.Ulrich,51,,36,43,79
061 St.Ulrich,52,,37,35,72
061 St.Ulrich,53,,31,35,66
061 St.Ulrich,54,,25,27,52
061 St.Ulrich,55,,31,26,57
061 St.Ulrich,56,,38,25,63
061 St.Ulrich,57,,23,18,41
061 St.Ulrich,58,,23,31,54
061 St.Ulrich,59,,17,31,48
061 St.Ulrich,60,,24,36,60
061 St.Ulrich,61,,27,32,59
061 St.Ulrich,62,,26,19,45
061 St.Ulrich,63,,13,29,42
061 St.Ulrich,64,,26,24,50
061 St.Ulrich,65,,19,26,45
061 St.Ulrich,66,,16,28,44
061 St.Ulrich,67,,29,29,58
061 St.Ulrich,68,,20,23,43
061 St.Ulrich,69,,30,23,53
061 St.Ulrich,70,,15,16,31
061 St.Ulrich,71,,20,32,52
061 St.Ulrich,72,,36,35,71
061 St.Ulrich,73,,25,33,58
061 St.Ulrich,74,,31,40,71
061 St.Ulrich,75,,26,26,52
061 St.Ulrich,76,,15,18,33
061 St.Ulrich,77,,21,22,43
061 St.Ulrich,78,,20,23,43
061 St.Ulrich,79,,20,16,36
061 St.Ulrich,80,,11,21,32
061 St.Ulrich,81,,12,8,20
061 St.Ulrich,82,,10,11,21
061 St.Ulrich,83,,12,20,32
061 St.Ulrich,84,,12,13,25
061 St.Ulrich,85,,13,6,19
061 St.Ulrich,86,,9,4,13
061 St.Ulrich,87,,9,10,19
061 St.Ulrich,88,,6,7,13
061 St.Ulrich,89,,3,9,12
061 St.Ulrich,90,,4,6,10
061 St.Ulrich,91,,2,7,9
061 St.Ulrich,92,,-,9,9
061 St.Ulrich,93,,1,5,6
061 St.Ulrich,94,,4,4,8
061 St.Ulrich,95,,2,6,8
061 St.Ulrich,96,,-,2,2
061 St.Ulrich,97,,-,2,2
061 St.Ulrich,100,,-,1,1
061 St.Ulrich,102,,-,1,1
061 St.Ulrich,Insgesamt,,2.347,2.439,4.786
062 Partschins,0,,24,16,40
062 Partschins,1,,23,15,38
062 Partschins,2,,15,21,36
062 Partschins,3,,25,17,42
062 Partschins,4,,19,15,34
062 Partschins,5,,21,20,41
062 Partschins,6,,19,19,38
062 Partschins,7,,23,12,35
062 Partschins,8,,17,20,37
062 Partschins,9,,17,17,34
062 Partschins,10,,18,25,43
062 Partschins,11,,16,24,40
062 Partschins,12,,25,17,42
062 Partschins,13,,25,19,44
062 Partschins,14,,15,14,29
062 Partschins,15,,23,17,40
062 Partschins,16,,18,19,37
062 Partschins,17,,20,10,30
062 Partschins,18,,23,24,47
062 Partschins,19,,15,19,34
062 Partschins,20,,26,16,42
062 Partschins,21,,20,20,40
062 Partschins,22,,26,22,48
062 Partschins,23,,25,19,44
062 Partschins,24,,24,31,55
062 Partschins,25,,22,25,47
062 Partschins,26,,11,27,38
062 Partschins,27,,20,29,49
062 Partschins,28,,15,20,35
062 Partschins,29,,25,19,44
062 Partschins,30,,14,16,30
062 Partschins,31,,22,24,46
062 Partschins,32,,14,24,38
062 Partschins,33,,14,21,35
062 Partschins,34,,22,32,54
062 Partschins,35,,28,29,57
062 Partschins,36,,21,26,47
062 Partschins,37,,22,13,35
062 Partschins,38,,26,21,47
062 Partschins,39,,23,18,41
062 Partschins,40,,28,19,47
062 Partschins,41,,24,27,51
062 Partschins,42,,33,28,61
062 Partschins,43,,29,26,55
062 Partschins,44,,27,36,63
062 Partschins,45,,30,34,64
062 Partschins,46,,40,25,65
062 Partschins,47,,27,34,61
062 Partschins,48,,34,26,60
062 Partschins,49,,35,37,72
062 Partschins,50,,32,28,60
062 Partschins,51,,31,41,72
062 Partschins,52,,30,26,56
062 Partschins,53,,35,23,58
062 Partschins,54,,20,24,44
062 Partschins,55,,27,41,68
062 Partschins,56,,29,24,53
062 Partschins,57,,20,21,41
062 Partschins,58,,22,26,48
062 Partschins,59,,22,17,39
062 Partschins,60,,27,23,50
062 Partschins,61,,13,31,44
062 Partschins,62,,21,17,38
062 Partschins,63,,15,15,30
062 Partschins,64,,19,18,37
062 Partschins,65,,20,21,41
062 Partschins,66,,11,10,21
062 Partschins,67,,18,18,36
062 Partschins,68,,14,18,32
062 Partschins,69,,24,27,51
062 Partschins,70,,12,15,27
062 Partschins,71,,15,14,29
062 Partschins,72,,20,23,43
062 Partschins,73,,13,16,29
062 Partschins,74,,19,29,48
062 Partschins,75,,12,14,26
062 Partschins,76,,10,13,23
062 Partschins,77,,15,11,26
062 Partschins,78,,12,13,25
062 Partschins,79,,12,16,28
062 Partschins,80,,7,8,15
062 Partschins,81,,8,14,22
062 Partschins,82,,5,13,18
062 Partschins,83,,12,10,22
062 Partschins,84,,8,14,22
062 Partschins,85,,4,5,9
062 Partschins,86,,6,6,12
062 Partschins,87,,7,5,12
062 Partschins,88,,6,9,15
062 Partschins,89,,4,7,11
062 Partschins,90,,2,6,8
062 Partschins,91,,1,7,8
062 Partschins,92,,4,4,8
062 Partschins,93,,2,3,5
062 Partschins,94,,5,2,7
062 Partschins,96,,2,2,4
062 Partschins,Insgesamt,,1.801,1.852,3.653
063 Percha,0,,11,6,17
063 Percha,1,,12,10,22
063 Percha,2,,13,15,28
063 Percha,3,,7,7,14
063 Percha,4,,5,7,12
063 Percha,5,,5,11,16
063 Percha,6,,11,8,19
063 Percha,7,,9,5,14
063 Percha,8,,10,6,16
063 Percha,9,,4,5,9
063 Percha,10,,6,9,15
063 Percha,11,,10,17,27
063 Percha,12,,9,7,16
063 Percha,13,,10,6,16
063 Percha,14,,4,5,9
063 Percha,15,,12,10,22
063 Percha,16,,6,8,14
063 Percha,17,,8,8,16
063 Percha,18,,12,15,27
063 Percha,19,,9,5,14
063 Percha,20,,7,9,16
063 Percha,21,,11,13,24
063 Percha,22,,7,8,15
063 Percha,23,,13,6,19
063 Percha,24,,11,11,22
063 Percha,25,,6,8,14
063 Percha,26,,6,8,14
063 Percha,27,,6,4,10
063 Percha,28,,12,21,33
063 Percha,29,,5,9,14
063 Percha,30,,7,10,17
063 Percha,31,,13,7,20
063 Percha,32,,17,14,31
063 Percha,33,,7,14,21
063 Percha,34,,12,11,23
063 Percha,35,,9,5,14
063 Percha,36,,5,13,18
063 Percha,37,,14,14,28
063 Percha,38,,13,3,16
063 Percha,39,,12,19,31
063 Percha,40,,7,12,19
063 Percha,41,,9,11,20
063 Percha,42,,17,12,29
063 Percha,43,,12,11,23
063 Percha,44,,20,18,38
063 Percha,45,,8,8,16
063 Percha,46,,22,13,35
063 Percha,47,,18,17,35
063 Percha,48,,13,9,22
063 Percha,49,,20,6,26
063 Percha,50,,14,18,32
063 Percha,51,,16,8,24
063 Percha,52,,11,15,26
063 Percha,53,,18,10,28
063 Percha,54,,8,12,20
063 Percha,55,,12,7,19
063 Percha,56,,7,10,17
063 Percha,57,,9,7,16
063 Percha,58,,8,5,13
063 Percha,59,,6,15,21
063 Percha,60,,9,10,19
063 Percha,61,,5,7,12
063 Percha,62,,8,7,15
063 Percha,63,,6,10,16
063 Percha,64,,7,7,14
063 Percha,65,,6,7,13
063 Percha,66,,9,5,14
063 Percha,67,,5,5,10
063 Percha,68,,6,6,12
063 Percha,69,,7,8,15
063 Percha,70,,6,5,11
063 Percha,71,,11,5,16
063 Percha,72,,7,8,15
063 Percha,73,,8,6,14
063 Percha,74,,6,7,13
063 Percha,75,,4,5,9
063 Percha,76,,6,5,11
063 Percha,77,,5,9,14
063 Percha,78,,2,5,7
063 Percha,79,,2,1,3
063 Percha,80,,3,4,7
063 Percha,81,,5,5,10
063 Percha,82,,-,5,5
063 Percha,83,,4,3,7
063 Percha,84,,4,-,4
063 Percha,85,,4,2,6
063 Percha,86,,-,3,3
063 Percha,87,,-,1,1
063 Percha,88,,2,2,4
063 Percha,89,,1,4,5
063 Percha,90,,1,1,2
063 Percha,92,,1,2,3
063 Percha,Insgesamt,,771,761,1.532
064 Plaus,0,,3,4,7
064 Plaus,1,,2,3,5
064 Plaus,2,,6,2,8
064 Plaus,3,,4,5,9
064 Plaus,4,,4,1,5
064 Plaus,5,,6,5,11
064 Plaus,6,,5,3,8
064 Plaus,7,,5,4,9
064 Plaus,8,,5,4,9
064 Plaus,9,,4,1,5
064 Plaus,10,,4,1,5
064 Plaus,11,,5,3,8
064 Plaus,12,,3,4,7
064 Plaus,13,,4,6,10
064 Plaus,14,,9,4,13
064 Plaus,15,,11,5,16
064 Plaus,16,,13,6,19
064 Plaus,17,,6,8,14
064 Plaus,18,,8,4,12
064 Plaus,19,,4,3,7
064 Plaus,20,,2,2,4
064 Plaus,21,,7,1,8
064 Plaus,22,,10,2,12
064 Plaus,23,,8,7,15
064 Plaus,24,,2,9,11
064 Plaus,25,,5,1,6
064 Plaus,26,,4,5,9
064 Plaus,27,,5,4,9
064 Plaus,28,,5,4,9
064 Plaus,29,,-,5,5
064 Plaus,30,,5,7,12
064 Plaus,31,,4,4,8
064 Plaus,32,,2,2,4
064 Plaus,33,,1,4,5
064 Plaus,34,,2,5,7
064 Plaus,35,,6,4,10
064 Plaus,36,,5,7,12
064 Plaus,37,,3,5,8
064 Plaus,38,,2,8,10
064 Plaus,39,,5,5,10
064 Plaus,40,,14,4,18
064 Plaus,41,,7,12,19
064 Plaus,42,,13,6,19
064 Plaus,43,,8,5,13
064 Plaus,44,,7,8,15
064 Plaus,45,,7,4,11
064 Plaus,46,,5,10,15
064 Plaus,47,,4,8,12
064 Plaus,48,,8,10,18
064 Plaus,49,,5,5,10
064 Plaus,50,,12,4,16
064 Plaus,51,,7,9,16
064 Plaus,52,,2,4,6
064 Plaus,53,,7,5,12
064 Plaus,54,,6,4,10
064 Plaus,55,,3,7,10
064 Plaus,56,,6,1,7
064 Plaus,57,,3,3,6
064 Plaus,58,,3,3,6
064 Plaus,59,,2,2,4
064 Plaus,60,,1,5,6
064 Plaus,61,,1,2,3
064 Plaus,62,,3,5,8
064 Plaus,63,,4,1,5
064 Plaus,64,,4,3,7
064 Plaus,65,,1,2,3
064 Plaus,66,,4,3,7
064 Plaus,67,,-,3,3
064 Plaus,68,,2,4,6
064 Plaus,69,,5,1,6
064 Plaus,70,,4,1,5
064 Plaus,71,,2,2,4
064 Plaus,72,,4,1,5
064 Plaus,73,,-,5,5
064 Plaus,74,,3,2,5
064 Plaus,75,,3,1,4
064 Plaus,76,,3,1,4
064 Plaus,78,,2,3,5
064 Plaus,80,,1,2,3
064 Plaus,81,,4,1,5
064 Plaus,82,,2,2,4
064 Plaus,83,,2,3,5
064 Plaus,86,,1,-,1
064 Plaus,87,,-,1,1
064 Plaus,88,,1,1,2
064 Plaus,89,,-,1,1
064 Plaus,91,,-,1,1
064 Plaus,96,,-,1,1
064 Plaus,100,,-,1,1
064 Plaus,Insgesamt,,380,340,720
065 Waidbruck,0,,2,1,3
065 Waidbruck,1,,1,-,1
065 Waidbruck,2,,1,1,2
065 Waidbruck,3,,1,1,2
065 Waidbruck,4,,1,1,2
065 Waidbruck,5,,-,1,1
065 Waidbruck,6,,2,2,4
065 Waidbruck,7,,2,-,2
065 Waidbruck,8,,2,-,2
065 Waidbruck,9,,3,-,3
065 Waidbruck,11,,1,1,2
065 Waidbruck,12,,-,2,2
065 Waidbruck,13,,1,1,2
065 Waidbruck,14,,1,-,1
065 Waidbruck,15,,1,1,2
065 Waidbruck,16,,2,1,3
065 Waidbruck,17,,1,-,1
065 Waidbruck,18,,4,3,7
065 Waidbruck,19,,3,2,5
065 Waidbruck,20,,2,1,3
065 Waidbruck,21,,3,1,4
065 Waidbruck,22,,-,2,2
065 Waidbruck,23,,-,4,4
065 Waidbruck,24,,1,1,2
065 Waidbruck,25,,1,1,2
065 Waidbruck,26,,2,2,4
065 Waidbruck,27,,-,1,1
065 Waidbruck,28,,1,-,1
065 Waidbruck,29,,1,2,3
065 Waidbruck,30,,2,-,2
065 Waidbruck,31,,2,-,2
065 Waidbruck,34,,3,1,4
065 Waidbruck,35,,1,1,2
065 Waidbruck,36,,1,-,1
065 Waidbruck,37,,4,-,4
065 Waidbruck,38,,-,1,1
065 Waidbruck,40,,2,2,4
065 Waidbruck,41,,2,3,5
065 Waidbruck,42,,-,1,1
065 Waidbruck,43,,1,2,3
065 Waidbruck,44,,2,-,2
065 Waidbruck,45,,2,1,3
065 Waidbruck,46,,4,2,6
065 Waidbruck,47,,2,2,4
065 Waidbruck,48,,2,4,6
065 Waidbruck,49,,4,3,7
065 Waidbruck,50,,2,2,4
065 Waidbruck,51,,2,-,2
065 Waidbruck,52,,-,1,1
065 Waidbruck,53,,2,-,2
065 Waidbruck,54,,1,2,3
065 Waidbruck,55,,3,-,3
065 Waidbruck,56,,2,1,3
065 Waidbruck,57,,-,1,1
065 Waidbruck,58,,1,1,2
065 Waidbruck,59,,2,-,2
065 Waidbruck,60,,3,-,3
065 Waidbruck,61,,1,-,1
065 Waidbruck,63,,1,-,1
065 Waidbruck,64,,-,1,1
065 Waidbruck,67,,1,-,1
065 Waidbruck,69,,-,3,3
065 Waidbruck,70,,1,1,2
065 Waidbruck,71,,2,1,3
065 Waidbruck,72,,-,1,1
065 Waidbruck,73,,1,1,2
065 Waidbruck,74,,-,1,1
065 Waidbruck,75,,-,2,2
065 Waidbruck,76,,1,-,1
065 Waidbruck,77,,-,2,2
065 Waidbruck,78,,1,-,1
065 Waidbruck,79,,1,1,2
065 Waidbruck,80,,-,2,2
065 Waidbruck,81,,-,1,1
065 Waidbruck,83,,-,2,2
065 Waidbruck,84,,1,-,1
065 Waidbruck,85,,1,-,1
065 Waidbruck,86,,-,1,1
065 Waidbruck,87,,1,-,1
065 Waidbruck,88,,1,1,2
065 Waidbruck,89,,-,1,1
065 Waidbruck,90,,1,-,1
065 Waidbruck,Insgesamt,,107,86,193
066 Burgstall,0,,10,11,21
066 Burgstall,1,,7,6,13
066 Burgstall,2,,13,16,29
066 Burgstall,3,,7,8,15
066 Burgstall,4,,11,15,26
066 Burgstall,5,,10,13,23
066 Burgstall,6,,14,7,21
066 Burgstall,7,,12,14,26
066 Burgstall,8,,9,8,17
066 Burgstall,9,,8,9,17
066 Burgstall,10,,7,7,14
066 Burgstall,11,,14,9,23
066 Burgstall,12,,10,10,20
066 Burgstall,13,,7,13,20
066 Burgstall,14,,8,9,17
066 Burgstall,15,,10,11,21
066 Burgstall,16,,11,10,21
066 Burgstall,17,,9,9,18
066 Burgstall,18,,13,8,21
066 Burgstall,19,,9,7,16
066 Burgstall,20,,11,7,18
066 Burgstall,21,,6,5,11
066 Burgstall,22,,7,11,18
066 Burgstall,23,,8,6,14
066 Burgstall,24,,11,10,21
066 Burgstall,25,,13,10,23
066 Burgstall,26,,10,9,19
066 Burgstall,27,,10,10,20
066 Burgstall,28,,9,10,19
066 Burgstall,29,,11,9,20
066 Burgstall,30,,8,15,23
066 Burgstall,31,,8,17,25
066 Burgstall,32,,12,14,26
066 Burgstall,33,,9,13,22
066 Burgstall,34,,11,6,17
066 Burgstall,35,,13,10,23
066 Burgstall,36,,17,11,28
066 Burgstall,37,,10,13,23
066 Burgstall,38,,10,20,30
066 Burgstall,39,,7,10,17
066 Burgstall,40,,21,14,35
066 Burgstall,41,,7,17,24
066 Burgstall,42,,9,19,28
066 Burgstall,43,,14,22,36
066 Burgstall,44,,14,14,28
066 Burgstall,45,,20,16,36
066 Burgstall,46,,19,12,31
066 Burgstall,47,,21,19,40
066 Burgstall,48,,14,15,29
066 Burgstall,49,,15,16,31
066 Burgstall,50,,18,18,36
066 Burgstall,51,,16,13,29
066 Burgstall,52,,19,16,35
066 Burgstall,53,,19,12,31
066 Burgstall,54,,16,21,37
066 Burgstall,55,,16,12,28
066 Burgstall,56,,11,7,18
066 Burgstall,57,,16,12,28
066 Burgstall,58,,11,11,22
066 Burgstall,59,,14,10,24
066 Burgstall,60,,10,13,23
066 Burgstall,61,,10,16,26
066 Burgstall,62,,10,11,21
066 Burgstall,63,,15,11,26
066 Burgstall,64,,13,6,19
066 Burgstall,65,,10,12,22
066 Burgstall,66,,8,10,18
066 Burgstall,67,,7,11,18
066 Burgstall,68,,6,9,15
066 Burgstall,69,,9,8,17
066 Burgstall,70,,7,7,14
066 Burgstall,71,,9,10,19
066 Burgstall,72,,11,8,19
066 Burgstall,73,,5,5,10
066 Burgstall,74,,5,6,11
066 Burgstall,75,,5,12,17
066 Burgstall,76,,5,8,13
066 Burgstall,77,,9,12,21
066 Burgstall,78,,4,7,11
066 Burgstall,79,,4,6,10
066 Burgstall,80,,6,3,9
066 Burgstall,81,,2,7,9
066 Burgstall,82,,5,3,8
066 Burgstall,83,,2,5,7
066 Burgstall,84,,4,2,6
066 Burgstall,85,,3,5,8
066 Burgstall,86,,-,3,3
066 Burgstall,87,,3,4,7
066 Burgstall,88,,1,7,8
066 Burgstall,89,,3,6,9
066 Burgstall,90,,1,2,3
066 Burgstall,91,,1,3,4
066 Burgstall,93,,-,3,3
066 Burgstall,95,,1,-,1
066 Burgstall,97,,-,1,1
066 Burgstall,Insgesamt,,904,954,1.858
067 Prad am Stilfser Joch,0,,24,25,49
067 Prad am Stilfser Joch,1,,24,29,53
067 Prad am Stilfser Joch,2,,10,15,25
067 Prad am Stilfser Joch,3,,16,14,30
067 Prad am Stilfser Joch,4,,17,14,31
067 Prad am Stilfser Joch,5,,20,12,32
067 Prad am Stilfser Joch,6,,13,12,25
067 Prad am Stilfser Joch,7,,15,19,34
067 Prad am Stilfser Joch,8,,15,9,24
067 Prad am Stilfser Joch,9,,16,17,33
067 Prad am Stilfser Joch,10,,22,14,36
067 Prad am Stilfser Joch,11,,19,22,41
067 Prad am Stilfser Joch,12,,19,13,32
067 Prad am Stilfser Joch,13,,12,17,29
067 Prad am Stilfser Joch,14,,23,19,42
067 Prad am Stilfser Joch,15,,18,19,37
067 Prad am Stilfser Joch,16,,19,21,40
067 Prad am Stilfser Joch,17,,20,23,43
067 Prad am Stilfser Joch,18,,27,19,46
067 Prad am Stilfser Joch,19,,22,20,42
067 Prad am Stilfser Joch,20,,20,15,35
067 Prad am Stilfser Joch,21,,23,26,49
067 Prad am Stilfser Joch,22,,24,32,56
067 Prad am Stilfser Joch,23,,18,24,42
067 Prad am Stilfser Joch,24,,19,14,33
067 Prad am Stilfser Joch,25,,21,21,42
067 Prad am Stilfser Joch,26,,20,20,40
067 Prad am Stilfser Joch,27,,30,17,47
067 Prad am Stilfser Joch,28,,15,24,39
067 Prad am Stilfser Joch,29,,25,34,59
067 Prad am Stilfser Joch,30,,28,17,45
067 Prad am Stilfser Joch,31,,26,31,57
067 Prad am Stilfser Joch,32,,25,21,46
067 Prad am Stilfser Joch,33,,27,20,47
067 Prad am Stilfser Joch,34,,22,22,44
067 Prad am Stilfser Joch,35,,24,20,44
067 Prad am Stilfser Joch,36,,19,22,41
067 Prad am Stilfser Joch,37,,22,22,44
067 Prad am Stilfser Joch,38,,25,27,52
067 Prad am Stilfser Joch,39,,26,21,47
067 Prad am Stilfser Joch,40,,22,21,43
067 Prad am Stilfser Joch,41,,27,17,44
067 Prad am Stilfser Joch,42,,22,41,63
067 Prad am Stilfser Joch,43,,23,23,46
067 Prad am Stilfser Joch,44,,24,27,51
067 Prad am Stilfser Joch,45,,26,25,51
067 Prad am Stilfser Joch,46,,29,34,63
067 Prad am Stilfser Joch,47,,33,36,69
067 Prad am Stilfser Joch,48,,27,25,52
067 Prad am Stilfser Joch,49,,34,27,61
067 Prad am Stilfser Joch,50,,34,27,61
067 Prad am Stilfser Joch,51,,23,26,49
067 Prad am Stilfser Joch,52,,28,12,40
067 Prad am Stilfser Joch,53,,28,33,61
067 Prad am Stilfser Joch,54,,23,25,48
067 Prad am Stilfser Joch,55,,20,27,47
067 Prad am Stilfser Joch,56,,35,18,53
067 Prad am Stilfser Joch,57,,19,28,47
067 Prad am Stilfser Joch,58,,25,26,51
067 Prad am Stilfser Joch,59,,25,24,49
067 Prad am Stilfser Joch,60,,23,19,42
067 Prad am Stilfser Joch,61,,25,17,42
067 Prad am Stilfser Joch,62,,28,19,47
067 Prad am Stilfser Joch,63,,13,19,32
067 Prad am Stilfser Joch,64,,17,22,39
067 Prad am Stilfser Joch,65,,18,17,35
067 Prad am Stilfser Joch,66,,20,21,41
067 Prad am Stilfser Joch,67,,19,11,30
067 Prad am Stilfser Joch,68,,14,12,26
067 Prad am Stilfser Joch,69,,13,14,27
067 Prad am Stilfser Joch,70,,13,11,24
067 Prad am Stilfser Joch,71,,10,15,25
067 Prad am Stilfser Joch,72,,22,19,41
067 Prad am Stilfser Joch,73,,14,16,30
067 Prad am Stilfser Joch,74,,24,7,31
067 Prad am Stilfser Joch,75,,8,16,24
067 Prad am Stilfser Joch,76,,11,15,26
067 Prad am Stilfser Joch,77,,14,12,26
067 Prad am Stilfser Joch,78,,5,9,14
067 Prad am Stilfser Joch,79,,8,7,15
067 Prad am Stilfser Joch,80,,13,11,24
067 Prad am Stilfser Joch,81,,6,20,26
067 Prad am Stilfser Joch,82,,9,9,18
067 Prad am Stilfser Joch,83,,5,16,21
067 Prad am Stilfser Joch,84,,6,8,14
067 Prad am Stilfser Joch,85,,6,7,13
067 Prad am Stilfser Joch,86,,3,11,14
067 Prad am Stilfser Joch,87,,4,5,9
067 Prad am Stilfser Joch,88,,4,7,11
067 Prad am Stilfser Joch,89,,1,3,4
067 Prad am Stilfser Joch,90,,4,-,4
067 Prad am Stilfser Joch,91,,1,3,4
067 Prad am Stilfser Joch,92,,1,7,8
067 Prad am Stilfser Joch,93,,-,3,3
067 Prad am Stilfser Joch,95,,-,1,1
067 Prad am Stilfser Joch,96,,2,1,3
067 Prad am Stilfser Joch,99,,-,1,1
067 Prad am Stilfser Joch,Insgesamt,,1.741,1.736,3.477
068 Prettau,0,,-,1,1
068 Prettau,1,,1,1,2
068 Prettau,2,,2,2,4
068 Prettau,3,,1,-,1
068 Prettau,4,,4,3,7
068 Prettau,5,,1,1,2
068 Prettau,6,,1,1,2
068 Prettau,7,,7,3,10
068 Prettau,8,,5,2,7
068 Prettau,9,,5,7,12
068 Prettau,10,,2,1,3
068 Prettau,11,,4,5,9
068 Prettau,12,,2,4,6
068 Prettau,13,,1,2,3
068 Prettau,14,,3,5,8
068 Prettau,15,,1,3,4
068 Prettau,16,,5,6,11
068 Prettau,17,,5,4,9
068 Prettau,18,,1,6,7
068 Prettau,19,,1,2,3
068 Prettau,20,,4,4,8
068 Prettau,21,,3,7,10
068 Prettau,22,,3,5,8
068 Prettau,23,,2,4,6
068 Prettau,24,,1,4,5
068 Prettau,25,,1,6,7
068 Prettau,26,,-,1,1
068 Prettau,27,,4,2,6
068 Prettau,28,,5,-,5
068 Prettau,29,,1,2,3
068 Prettau,30,,1,1,2
068 Prettau,31,,4,7,11
068 Prettau,32,,4,1,5
068 Prettau,33,,2,3,5
068 Prettau,34,,3,-,3
068 Prettau,35,,3,5,8
068 Prettau,36,,5,3,8
068 Prettau,37,,1,2,3
068 Prettau,38,,3,2,5
068 Prettau,39,,3,2,5
068 Prettau,40,,3,1,4
068 Prettau,41,,5,1,6
068 Prettau,42,,6,6,12
068 Prettau,43,,9,3,12
068 Prettau,44,,4,6,10
068 Prettau,45,,3,6,9
068 Prettau,46,,6,5,11
068 Prettau,47,,3,1,4
068 Prettau,48,,10,3,13
068 Prettau,49,,6,-,6
068 Prettau,50,,3,7,10
068 Prettau,51,,6,6,12
068 Prettau,52,,4,5,9
068 Prettau,53,,2,5,7
068 Prettau,54,,5,6,11
068 Prettau,55,,6,4,10
068 Prettau,56,,5,2,7
068 Prettau,57,,7,-,7
068 Prettau,58,,2,1,3
068 Prettau,59,,5,6,11
068 Prettau,60,,6,4,10
068 Prettau,61,,5,2,7
068 Prettau,62,,3,3,6
068 Prettau,63,,4,3,7
068 Prettau,64,,3,2,5
068 Prettau,65,,2,2,4
068 Prettau,66,,2,3,5
068 Prettau,67,,2,1,3
068 Prettau,68,,4,5,9
068 Prettau,69,,6,3,9
068 Prettau,70,,1,2,3
068 Prettau,71,,6,5,11
068 Prettau,72,,4,3,7
068 Prettau,73,,3,2,5
068 Prettau,74,,3,2,5
068 Prettau,75,,4,3,7
068 Prettau,76,,4,3,7
068 Prettau,77,,5,6,11
068 Prettau,78,,2,5,7
068 Prettau,79,,3,3,6
068 Prettau,80,,2,-,2
068 Prettau,81,,1,3,4
068 Prettau,82,,2,3,5
068 Prettau,83,,2,-,2
068 Prettau,84,,1,1,2
068 Prettau,85,,3,3,6
068 Prettau,86,,3,5,8
068 Prettau,87,,-,1,1
068 Prettau,88,,2,1,3
068 Prettau,89,,-,1,1
068 Prettau,90,,-,1,1
068 Prettau,92,,-,1,1
068 Prettau,97,,-,1,1
068 Prettau,102,,-,1,1
068 Prettau,Insgesamt,,293,278,571
069 Proveis,0,,1,-,1
069 Proveis,1,,2,2,4
069 Proveis,2,,1,1,2
069 Proveis,3,,1,2,3
069 Proveis,4,,-,2,2
069 Proveis,5,,2,1,3
069 Proveis,6,,3,1,4
069 Proveis,7,,-,1,1
069 Proveis,8,,1,1,2
069 Proveis,9,,1,-,1
069 Proveis,10,,-,4,4
069 Proveis,11,,3,2,5
069 Proveis,12,,2,1,3
069 Proveis,13,,4,-,4
069 Proveis,14,,1,1,2
069 Proveis,15,,-,1,1
069 Proveis,16,,4,-,4
069 Proveis,17,,2,2,4
069 Proveis,18,,2,2,4
069 Proveis,19,,1,1,2
069 Proveis,20,,-,4,4
069 Proveis,21,,3,1,4
069 Proveis,22,,2,1,3
069 Proveis,23,,4,2,6
069 Proveis,24,,5,2,7
069 Proveis,26,,1,1,2
069 Proveis,27,,2,1,3
069 Proveis,28,,1,4,5
069 Proveis,29,,3,-,3
069 Proveis,30,,5,-,5
069 Proveis,31,,3,2,5
069 Proveis,32,,3,-,3
069 Proveis,33,,2,-,2
069 Proveis,34,,2,3,5
069 Proveis,36,,2,-,2
069 Proveis,37,,1,3,4
069 Proveis,38,,2,1,3
069 Proveis,39,,1,1,2
069 Proveis,40,,2,-,2
069 Proveis,41,,3,2,5
069 Proveis,42,,2,-,2
069 Proveis,43,,-,1,1
069 Proveis,44,,-,1,1
069 Proveis,45,,3,3,6
069 Proveis,46,,3,3,6
069 Proveis,47,,4,1,5
069 Proveis,48,,3,1,4
069 Proveis,49,,2,2,4
069 Proveis,50,,1,2,3
069 Proveis,51,,3,1,4
069 Proveis,52,,4,2,6
069 Proveis,53,,2,2,4
069 Proveis,54,,3,1,4
069 Proveis,55,,1,4,5
069 Proveis,56,,4,-,4
069 Proveis,57,,1,3,4
069 Proveis,58,,2,2,4
069 Proveis,59,,4,2,6
069 Proveis,60,,4,4,8
069 Proveis,61,,3,2,5
069 Proveis,62,,1,1,2
069 Proveis,63,,2,3,5
069 Proveis,64,,2,-,2
069 Proveis,65,,1,1,2
069 Proveis,66,,1,-,1
069 Proveis,67,,2,-,2
069 Proveis,68,,1,2,3
069 Proveis,69,,2,-,2
069 Proveis,70,,1,-,1
069 Proveis,71,,1,-,1
069 Proveis,72,,1,1,2
069 Proveis,73,,1,1,2
069 Proveis,74,,1,1,2
069 Proveis,75,,2,-,2
069 Proveis,76,,1,3,4
069 Proveis,77,,-,2,2
069 Proveis,78,,1,1,2
069 Proveis,79,,1,1,2
069 Proveis,82,,-,1,1
069 Proveis,83,,-,1,1
069 Proveis,84,,1,1,2
069 Proveis,86,,-,1,1
069 Proveis,87,,2,-,2
069 Proveis,88,,-,1,1
069 Proveis,Insgesamt,,152,112,264
070 Ratschings,0,,21,22,43
070 Ratschings,1,,28,24,52
070 Ratschings,2,,24,28,52
070 Ratschings,3,,24,26,50
070 Ratschings,4,,17,24,41
070 Ratschings,5,,25,27,52
070 Ratschings,6,,23,21,44
070 Ratschings,7,,20,16,36
070 Ratschings,8,,27,25,52
070 Ratschings,9,,26,24,50
070 Ratschings,10,,22,26,48
070 Ratschings,11,,34,25,59
070 Ratschings,12,,34,22,56
070 Ratschings,13,,16,26,42
070 Ratschings,14,,26,34,60
070 Ratschings,15,,35,27,62
070 Ratschings,16,,29,21,50
070 Ratschings,17,,34,20,54
070 Ratschings,18,,36,35,71
070 Ratschings,19,,29,30,59
070 Ratschings,20,,29,26,55
070 Ratschings,21,,25,27,52
070 Ratschings,22,,25,20,45
070 Ratschings,23,,36,39,75
070 Ratschings,24,,23,21,44
070 Ratschings,25,,30,28,58
070 Ratschings,26,,27,19,46
070 Ratschings,27,,35,24,59
070 Ratschings,28,,26,23,49
070 Ratschings,29,,28,26,54
070 Ratschings,30,,27,40,67
070 Ratschings,31,,30,18,48
070 Ratschings,32,,35,20,55
070 Ratschings,33,,35,29,64
070 Ratschings,34,,31,28,59
070 Ratschings,35,,25,29,54
070 Ratschings,36,,32,29,61
070 Ratschings,37,,32,22,54
070 Ratschings,38,,33,27,60
070 Ratschings,39,,21,21,42
070 Ratschings,40,,41,35,76
070 Ratschings,41,,35,22,57
070 Ratschings,42,,32,34,66
070 Ratschings,43,,38,38,76
070 Ratschings,44,,39,39,78
070 Ratschings,45,,32,42,74
070 Ratschings,46,,37,44,81
070 Ratschings,47,,51,45,96
070 Ratschings,48,,31,39,70
070 Ratschings,49,,44,49,93
070 Ratschings,50,,35,42,77
070 Ratschings,51,,48,42,90
070 Ratschings,52,,45,26,71
070 Ratschings,53,,33,41,74
070 Ratschings,54,,35,27,62
070 Ratschings,55,,40,25,65
070 Ratschings,56,,44,24,68
070 Ratschings,57,,27,27,54
070 Ratschings,58,,28,19,47
070 Ratschings,59,,39,19,58
070 Ratschings,60,,14,32,46
070 Ratschings,61,,23,16,39
070 Ratschings,62,,24,24,48
070 Ratschings,63,,17,20,37
070 Ratschings,64,,19,14,33
070 Ratschings,65,,25,20,45
070 Ratschings,66,,19,24,43
070 Ratschings,67,,28,18,46
070 Ratschings,68,,15,17,32
070 Ratschings,69,,21,6,27
070 Ratschings,70,,19,19,38
070 Ratschings,71,,14,11,25
070 Ratschings,72,,15,13,28
070 Ratschings,73,,17,16,33
070 Ratschings,74,,18,14,32
070 Ratschings,75,,15,15,30
070 Ratschings,76,,9,16,25
070 Ratschings,77,,12,17,29
070 Ratschings,78,,12,8,20
070 Ratschings,79,,7,11,18
070 Ratschings,80,,7,13,20
070 Ratschings,81,,8,6,14
070 Ratschings,82,,9,16,25
070 Ratschings,83,,7,9,16
070 Ratschings,84,,5,9,14
070 Ratschings,85,,3,10,13
070 Ratschings,86,,5,13,18
070 Ratschings,87,,3,7,10
070 Ratschings,88,,2,6,8
070 Ratschings,89,,3,4,7
070 Ratschings,90,,2,2,4
070 Ratschings,91,,1,6,7
070 Ratschings,92,,1,1,2
070 Ratschings,93,,1,2,3
070 Ratschings,94,,-,2,2
070 Ratschings,95,,-,1,1
070 Ratschings,Insgesamt,,2.269,2.136,4.405
071 Rasen-Antholz,0,,15,18,33
071 Rasen-Antholz,1,,10,18,28
071 Rasen-Antholz,2,,13,10,23
071 Rasen-Antholz,3,,9,22,31
071 Rasen-Antholz,4,,17,18,35
071 Rasen-Antholz,5,,12,9,21
071 Rasen-Antholz,6,,14,16,30
071 Rasen-Antholz,7,,21,7,28
071 Rasen-Antholz,8,,18,17,35
071 Rasen-Antholz,9,,15,21,36
071 Rasen-Antholz,10,,25,16,41
071 Rasen-Antholz,11,,15,21,36
071 Rasen-Antholz,12,,11,23,34
071 Rasen-Antholz,13,,14,19,33
071 Rasen-Antholz,14,,20,22,42
071 Rasen-Antholz,15,,24,22,46
071 Rasen-Antholz,16,,13,18,31
071 Rasen-Antholz,17,,21,17,38
071 Rasen-Antholz,18,,25,25,50
071 Rasen-Antholz,19,,26,19,45
071 Rasen-Antholz,20,,8,14,22
071 Rasen-Antholz,21,,21,11,32
071 Rasen-Antholz,22,,16,15,31
071 Rasen-Antholz,23,,25,19,44
071 Rasen-Antholz,24,,15,16,31
071 Rasen-Antholz,25,,15,22,37
071 Rasen-Antholz,26,,18,17,35
071 Rasen-Antholz,27,,16,15,31
071 Rasen-Antholz,28,,23,9,32
071 Rasen-Antholz,29,,17,22,39
071 Rasen-Antholz,30,,21,8,29
071 Rasen-Antholz,31,,19,23,42
071 Rasen-Antholz,32,,11,22,33
071 Rasen-Antholz,33,,16,21,37
071 Rasen-Antholz,34,,21,12,33
071 Rasen-Antholz,35,,14,11,25
071 Rasen-Antholz,36,,17,24,41
071 Rasen-Antholz,37,,16,22,38
071 Rasen-Antholz,38,,13,14,27
071 Rasen-Antholz,39,,24,12,36
071 Rasen-Antholz,40,,17,21,38
071 Rasen-Antholz,41,,22,20,42
071 Rasen-Antholz,42,,28,23,51
071 Rasen-Antholz,43,,18,21,39
071 Rasen-Antholz,44,,27,24,51
071 Rasen-Antholz,45,,23,26,49
071 Rasen-Antholz,46,,23,25,48
071 Rasen-Antholz,47,,25,27,52
071 Rasen-Antholz,48,,25,28,53
071 Rasen-Antholz,49,,27,19,46
071 Rasen-Antholz,50,,30,24,54
071 Rasen-Antholz,51,,28,23,51
071 Rasen-Antholz,52,,17,21,38
071 Rasen-Antholz,53,,28,19,47
071 Rasen-Antholz,54,,18,24,42
071 Rasen-Antholz,55,,23,25,48
071 Rasen-Antholz,56,,27,18,45
071 Rasen-Antholz,57,,24,15,39
071 Rasen-Antholz,58,,20,9,29
071 Rasen-Antholz,59,,20,14,34
071 Rasen-Antholz,60,,18,14,32
071 Rasen-Antholz,61,,14,15,29
071 Rasen-Antholz,62,,13,9,22
071 Rasen-Antholz,63,,11,15,26
071 Rasen-Antholz,64,,11,11,22
071 Rasen-Antholz,65,,11,8,19
071 Rasen-Antholz,66,,14,10,24
071 Rasen-Antholz,67,,14,11,25
071 Rasen-Antholz,68,,10,14,24
071 Rasen-Antholz,69,,9,14,23
071 Rasen-Antholz,70,,11,8,19
071 Rasen-Antholz,71,,9,8,17
071 Rasen-Antholz,72,,13,12,25
071 Rasen-Antholz,73,,8,13,21
071 Rasen-Antholz,74,,14,12,26
071 Rasen-Antholz,75,,8,16,24
071 Rasen-Antholz,76,,14,12,26
071 Rasen-Antholz,77,,11,7,18
071 Rasen-Antholz,78,,6,10,16
071 Rasen-Antholz,79,,9,10,19
071 Rasen-Antholz,80,,6,8,14
071 Rasen-Antholz,81,,7,9,16
071 Rasen-Antholz,82,,5,11,16
071 Rasen-Antholz,83,,8,9,17
071 Rasen-Antholz,84,,6,14,20
071 Rasen-Antholz,85,,4,8,12
071 Rasen-Antholz,86,,4,3,7
071 Rasen-Antholz,87,,1,4,5
071 Rasen-Antholz,88,,3,1,4
071 Rasen-Antholz,89,,1,5,6
071 Rasen-Antholz,90,,4,4,8
071 Rasen-Antholz,91,,2,1,3
071 Rasen-Antholz,92,,-,4,4
071 Rasen-Antholz,93,,1,2,3
071 Rasen-Antholz,96,,-,1,1
071 Rasen-Antholz,98,,-,1,1
071 Rasen-Antholz,Insgesamt,,1.434,1.427,2.861
072 Ritten,0,,39,49,88
072 Ritten,1,,40,33,73
072 Ritten,2,,32,40,72
072 Ritten,3,,43,44,87
072 Ritten,4,,45,40,85
072 Ritten,5,,47,44,91
072 Ritten,6,,43,45,88
072 Ritten,7,,37,52,89
072 Ritten,8,,47,54,101
072 Ritten,9,,54,48,102
072 Ritten,10,,44,50,94
072 Ritten,11,,51,55,106
072 Ritten,12,,44,40,84
072 Ritten,13,,35,48,83
072 Ritten,14,,50,45,95
072 Ritten,15,,45,44,89
072 Ritten,16,,50,54,104
072 Ritten,17,,45,46,91
072 Ritten,18,,57,53,110
072 Ritten,19,,42,53,95
072 Ritten,20,,55,42,97
072 Ritten,21,,60,44,104
072 Ritten,22,,54,49,103
072 Ritten,23,,42,68,110
072 Ritten,24,,62,51,113
072 Ritten,25,,61,47,108
072 Ritten,26,,52,42,94
072 Ritten,27,,57,55,112
072 Ritten,28,,56,47,103
072 Ritten,29,,47,49,96
072 Ritten,30,,46,52,98
072 Ritten,31,,49,33,82
072 Ritten,32,,56,60,116
072 Ritten,33,,40,50,90
072 Ritten,34,,48,47,95
072 Ritten,35,,49,46,95
072 Ritten,36,,55,54,109
072 Ritten,37,,49,48,97
072 Ritten,38,,61,33,94
072 Ritten,39,,47,56,103
072 Ritten,40,,54,52,106
072 Ritten,41,,60,56,116
072 Ritten,42,,60,47,107
072 Ritten,43,,50,64,114
072 Ritten,44,,56,63,119
072 Ritten,45,,57,69,126
072 Ritten,46,,52,72,124
072 Ritten,47,,67,66,133
072 Ritten,48,,76,49,125
072 Ritten,49,,61,47,108
072 Ritten,50,,75,43,118
072 Ritten,51,,66,58,124
072 Ritten,52,,64,54,118
072 Ritten,53,,53,61,114
072 Ritten,54,,45,58,103
072 Ritten,55,,60,60,120
072 Ritten,56,,71,49,120
072 Ritten,57,,37,47,84
072 Ritten,58,,38,42,80
072 Ritten,59,,45,46,91
072 Ritten,60,,47,40,87
072 Ritten,61,,36,35,71
072 Ritten,62,,51,30,81
072 Ritten,63,,42,43,85
072 Ritten,64,,45,36,81
072 Ritten,65,,31,39,70
072 Ritten,66,,32,47,79
072 Ritten,67,,50,39,89
072 Ritten,68,,31,29,60
072 Ritten,69,,25,38,63
072 Ritten,70,,20,28,48
072 Ritten,71,,37,39,76
072 Ritten,72,,35,37,72
072 Ritten,73,,39,33,72
072 Ritten,74,,32,35,67
072 Ritten,75,,32,22,54
072 Ritten,76,,32,29,61
072 Ritten,77,,27,31,58
072 Ritten,78,,21,21,42
072 Ritten,79,,16,23,39
072 Ritten,80,,17,25,42
072 Ritten,81,,16,26,42
072 Ritten,82,,11,22,33
072 Ritten,83,,10,19,29
072 Ritten,84,,8,26,34
072 Ritten,85,,6,17,23
072 Ritten,86,,11,13,24
072 Ritten,87,,7,10,17
072 Ritten,88,,7,10,17
072 Ritten,89,,6,9,15
072 Ritten,90,,1,15,16
072 Ritten,91,,6,12,18
072 Ritten,92,,7,10,17
072 Ritten,93,,1,5,6
072 Ritten,94,,1,8,9
072 Ritten,95,,1,2,3
072 Ritten,96,,-,1,1
072 Ritten,97,,-,1,1
072 Ritten,Insgesamt,,3.880,3.918,7.798
073 Riffian,0,,7,4,11
073 Riffian,1,,7,3,10
073 Riffian,2,,9,5,14
073 Riffian,3,,1,7,8
073 Riffian,4,,12,12,24
073 Riffian,5,,6,6,12
073 Riffian,6,,8,8,16
073 Riffian,7,,12,5,17
073 Riffian,8,,11,8,19
073 Riffian,9,,5,10,15
073 Riffian,10,,9,9,18
073 Riffian,11,,9,3,12
073 Riffian,12,,8,7,15
073 Riffian,13,,9,7,16
073 Riffian,14,,11,8,19
073 Riffian,15,,10,9,19
073 Riffian,16,,9,9,18
073 Riffian,17,,10,7,17
073 Riffian,18,,9,7,16
073 Riffian,19,,5,10,15
073 Riffian,20,,5,9,14
073 Riffian,21,,6,10,16
073 Riffian,22,,7,6,13
073 Riffian,23,,11,8,19
073 Riffian,24,,11,12,23
073 Riffian,25,,7,6,13
073 Riffian,26,,14,3,17
073 Riffian,27,,7,9,16
073 Riffian,28,,4,9,13
073 Riffian,29,,11,7,18
073 Riffian,30,,10,4,14
073 Riffian,31,,6,7,13
073 Riffian,32,,5,7,12
073 Riffian,33,,8,11,19
073 Riffian,34,,7,7,14
073 Riffian,35,,2,6,8
073 Riffian,36,,9,7,16
073 Riffian,37,,9,5,14
073 Riffian,38,,9,13,22
073 Riffian,39,,7,4,11
073 Riffian,40,,9,14,23
073 Riffian,41,,10,13,23
073 Riffian,42,,10,9,19
073 Riffian,43,,12,24,36
073 Riffian,44,,10,15,25
073 Riffian,45,,7,10,17
073 Riffian,46,,14,12,26
073 Riffian,47,,9,12,21
073 Riffian,48,,11,14,25
073 Riffian,49,,12,6,18
073 Riffian,50,,10,6,16
073 Riffian,51,,10,8,18
073 Riffian,52,,16,10,26
073 Riffian,53,,9,12,21
073 Riffian,54,,7,8,15
073 Riffian,55,,13,5,18
073 Riffian,56,,6,13,19
073 Riffian,57,,8,6,14
073 Riffian,58,,6,11,17
073 Riffian,59,,9,6,15
073 Riffian,60,,3,7,10
073 Riffian,61,,10,6,16
073 Riffian,62,,7,5,12
073 Riffian,63,,6,3,9
073 Riffian,64,,5,10,15
073 Riffian,65,,3,3,6
073 Riffian,66,,8,6,14
073 Riffian,67,,3,4,7
073 Riffian,68,,3,4,7
073 Riffian,69,,2,8,10
073 Riffian,70,,6,3,9
073 Riffian,71,,7,8,15
073 Riffian,72,,6,7,13
073 Riffian,73,,13,8,21
073 Riffian,74,,5,3,8
073 Riffian,75,,3,3,6
073 Riffian,76,,4,9,13
073 Riffian,77,,6,4,10
073 Riffian,78,,4,5,9
073 Riffian,79,,2,3,5
073 Riffian,80,,-,3,3
073 Riffian,81,,-,3,3
073 Riffian,82,,3,5,8
073 Riffian,83,,1,6,7
073 Riffian,84,,3,5,8
073 Riffian,85,,4,3,7
073 Riffian,86,,-,6,6
073 Riffian,87,,2,4,6
073 Riffian,88,,2,2,4
073 Riffian,89,,3,2,5
073 Riffian,90,,1,1,2
073 Riffian,91,,2,1,3
073 Riffian,92,,-,2,2
073 Riffian,93,,1,-,1
073 Riffian,94,,-,1,1
073 Riffian,100,,-,1,1
073 Riffian,Insgesamt,,648,662,1.310
074 Mühlbach,0,,27,18,45
074 Mühlbach,1,,20,11,31
074 Mühlbach,2,,25,12,37
074 Mühlbach,3,,18,22,40
074 Mühlbach,4,,21,15,36
074 Mühlbach,5,,18,24,42
074 Mühlbach,6,,21,15,36
074 Mühlbach,7,,22,17,39
074 Mühlbach,8,,22,25,47
074 Mühlbach,9,,15,9,24
074 Mühlbach,10,,18,11,29
074 Mühlbach,11,,14,20,34
074 Mühlbach,12,,23,12,35
074 Mühlbach,13,,19,18,37
074 Mühlbach,14,,14,20,34
074 Mühlbach,15,,16,16,32
074 Mühlbach,16,,19,16,35
074 Mühlbach,17,,19,17,36
074 Mühlbach,18,,21,17,38
074 Mühlbach,19,,20,16,36
074 Mühlbach,20,,14,19,33
074 Mühlbach,21,,24,15,39
074 Mühlbach,22,,17,24,41
074 Mühlbach,23,,18,25,43
074 Mühlbach,24,,17,19,36
074 Mühlbach,25,,12,22,34
074 Mühlbach,26,,11,20,31
074 Mühlbach,27,,18,16,34
074 Mühlbach,28,,22,19,41
074 Mühlbach,29,,16,11,27
074 Mühlbach,30,,18,22,40
074 Mühlbach,31,,27,24,51
074 Mühlbach,32,,19,17,36
074 Mühlbach,33,,29,30,59
074 Mühlbach,34,,23,16,39
074 Mühlbach,35,,21,19,40
074 Mühlbach,36,,23,17,40
074 Mühlbach,37,,30,25,55
074 Mühlbach,38,,25,17,42
074 Mühlbach,39,,23,18,41
074 Mühlbach,40,,19,22,41
074 Mühlbach,41,,23,16,39
074 Mühlbach,42,,23,19,42
074 Mühlbach,43,,24,24,48
074 Mühlbach,44,,29,27,56
074 Mühlbach,45,,28,16,44
074 Mühlbach,46,,27,34,61
074 Mühlbach,47,,32,21,53
074 Mühlbach,48,,21,24,45
074 Mühlbach,49,,27,18,45
074 Mühlbach,50,,25,21,46
074 Mühlbach,51,,16,22,38
074 Mühlbach,52,,21,20,41
074 Mühlbach,53,,23,18,41
074 Mühlbach,54,,24,24,48
074 Mühlbach,55,,22,14,36
074 Mühlbach,56,,22,17,39
074 Mühlbach,57,,19,13,32
074 Mühlbach,58,,16,23,39
074 Mühlbach,59,,18,26,44
074 Mühlbach,60,,19,19,38
074 Mühlbach,61,,13,20,33
074 Mühlbach,62,,18,17,35
074 Mühlbach,63,,15,21,36
074 Mühlbach,64,,12,18,30
074 Mühlbach,65,,20,18,38
074 Mühlbach,66,,15,13,28
074 Mühlbach,67,,17,13,30
074 Mühlbach,68,,10,18,28
074 Mühlbach,69,,18,10,28
074 Mühlbach,70,,8,7,15
074 Mühlbach,71,,14,11,25
074 Mühlbach,72,,10,9,19
074 Mühlbach,73,,14,13,27
074 Mühlbach,74,,15,16,31
074 Mühlbach,75,,11,10,21
074 Mühlbach,76,,7,16,23
074 Mühlbach,77,,10,6,16
074 Mühlbach,78,,5,11,16
074 Mühlbach,79,,6,7,13
074 Mühlbach,80,,6,6,12
074 Mühlbach,81,,9,9,18
074 Mühlbach,82,,8,10,18
074 Mühlbach,83,,2,5,7
074 Mühlbach,84,,5,6,11
074 Mühlbach,85,,4,5,9
074 Mühlbach,86,,4,2,6
074 Mühlbach,87,,2,11,13
074 Mühlbach,88,,2,6,8
074 Mühlbach,89,,2,4,6
074 Mühlbach,90,,3,4,7
074 Mühlbach,91,,3,4,7
074 Mühlbach,92,,1,2,3
074 Mühlbach,93,,1,5,6
074 Mühlbach,94,,-,3,3
074 Mühlbach,95,,-,1,1
074 Mühlbach,96,,-,2,2
074 Mühlbach,Insgesamt,,1.567,1.503,3.070
075 Rodeneck,0,,8,5,13
075 Rodeneck,1,,6,8,14
075 Rodeneck,2,,7,5,12
075 Rodeneck,3,,6,5,11
075 Rodeneck,4,,2,7,9
075 Rodeneck,5,,7,4,11
075 Rodeneck,6,,3,6,9
075 Rodeneck,7,,8,9,17
075 Rodeneck,8,,7,6,13
075 Rodeneck,9,,5,5,10
075 Rodeneck,10,,9,8,17
075 Rodeneck,11,,7,4,11
075 Rodeneck,12,,8,7,15
075 Rodeneck,13,,9,3,12
075 Rodeneck,14,,9,3,12
075 Rodeneck,15,,6,14,20
075 Rodeneck,16,,8,11,19
075 Rodeneck,17,,12,7,19
075 Rodeneck,18,,10,7,17
075 Rodeneck,19,,13,8,21
075 Rodeneck,20,,6,9,15
075 Rodeneck,21,,6,13,19
075 Rodeneck,22,,6,8,14
075 Rodeneck,23,,9,11,20
075 Rodeneck,24,,6,8,14
075 Rodeneck,25,,11,8,19
075 Rodeneck,26,,6,4,10
075 Rodeneck,27,,13,8,21
075 Rodeneck,28,,5,7,12
075 Rodeneck,29,,5,11,16
075 Rodeneck,30,,10,7,17
075 Rodeneck,31,,10,8,18
075 Rodeneck,32,,9,10,19
075 Rodeneck,33,,7,5,12
075 Rodeneck,34,,9,5,14
075 Rodeneck,35,,7,12,19
075 Rodeneck,36,,6,4,10
075 Rodeneck,37,,5,7,12
075 Rodeneck,38,,6,5,11
075 Rodeneck,39,,9,7,16
075 Rodeneck,40,,7,6,13
075 Rodeneck,41,,6,6,12
075 Rodeneck,42,,16,11,27
075 Rodeneck,43,,7,8,15
075 Rodeneck,44,,14,5,19
075 Rodeneck,45,,7,12,19
075 Rodeneck,46,,15,10,25
075 Rodeneck,47,,11,11,22
075 Rodeneck,48,,11,9,20
075 Rodeneck,49,,16,10,26
075 Rodeneck,50,,7,7,14
075 Rodeneck,51,,11,12,23
075 Rodeneck,52,,10,10,20
075 Rodeneck,53,,10,11,21
075 Rodeneck,54,,9,10,19
075 Rodeneck,55,,5,10,15
075 Rodeneck,56,,10,7,17
075 Rodeneck,57,,8,4,12
075 Rodeneck,58,,5,8,13
075 Rodeneck,59,,8,4,12
075 Rodeneck,60,,5,6,11
075 Rodeneck,61,,10,3,13
075 Rodeneck,62,,3,1,4
075 Rodeneck,63,,8,4,12
075 Rodeneck,64,,2,2,4
075 Rodeneck,65,,2,8,10
075 Rodeneck,66,,2,4,6
075 Rodeneck,67,,4,7,11
075 Rodeneck,68,,4,5,9
075 Rodeneck,69,,9,6,15
075 Rodeneck,70,,2,5,7
075 Rodeneck,71,,3,4,7
075 Rodeneck,72,,2,2,4
075 Rodeneck,73,,1,6,7
075 Rodeneck,74,,10,3,13
075 Rodeneck,75,,5,4,9
075 Rodeneck,76,,1,9,10
075 Rodeneck,77,,2,3,5
075 Rodeneck,78,,1,4,5
075 Rodeneck,79,,1,2,3
075 Rodeneck,80,,3,2,5
075 Rodeneck,81,,1,9,10
075 Rodeneck,82,,3,-,3
075 Rodeneck,83,,4,5,9
075 Rodeneck,84,,4,2,6
075 Rodeneck,85,,4,3,7
075 Rodeneck,86,,4,1,5
075 Rodeneck,87,,3,4,7
075 Rodeneck,88,,1,3,4
075 Rodeneck,89,,1,3,4
075 Rodeneck,90,,-,3,3
075 Rodeneck,91,,2,2,4
075 Rodeneck,92,,2,-,2
075 Rodeneck,93,,-,1,1
075 Rodeneck,Insgesamt,,603,586,1.189
076 Salurn,0,,23,23,46
076 Salurn,1,,26,22,48
076 Salurn,2,,20,22,42
076 Salurn,3,,23,24,47
076 Salurn,4,,30,22,52
076 Salurn,5,,29,18,47
076 Salurn,6,,25,31,56
076 Salurn,7,,26,22,48
076 Salurn,8,,29,23,52
076 Salurn,9,,23,20,43
076 Salurn,10,,16,23,39
076 Salurn,11,,23,18,41
076 Salurn,12,,30,18,48
076 Salurn,13,,16,18,34
076 Salurn,14,,18,18,36
076 Salurn,15,,20,19,39
076 Salurn,16,,22,16,38
076 Salurn,17,,16,27,43
076 Salurn,18,,14,13,27
076 Salurn,19,,26,23,49
076 Salurn,20,,22,16,38
076 Salurn,21,,19,19,38
076 Salurn,22,,19,28,47
076 Salurn,23,,24,25,49
076 Salurn,24,,15,24,39
076 Salurn,25,,13,21,34
076 Salurn,26,,18,23,41
076 Salurn,27,,28,20,48
076 Salurn,28,,26,23,49
076 Salurn,29,,23,25,48
076 Salurn,30,,19,28,47
076 Salurn,31,,16,22,38
076 Salurn,32,,17,22,39
076 Salurn,33,,23,22,45
076 Salurn,34,,23,32,55
076 Salurn,35,,27,27,54
076 Salurn,36,,24,28,52
076 Salurn,37,,23,24,47
076 Salurn,38,,31,29,60
076 Salurn,39,,34,24,58
076 Salurn,40,,27,27,54
076 Salurn,41,,26,22,48
076 Salurn,42,,31,36,67
076 Salurn,43,,29,28,57
076 Salurn,44,,39,27,66
076 Salurn,45,,33,30,63
076 Salurn,46,,27,31,58
076 Salurn,47,,35,27,62
076 Salurn,48,,29,24,53
076 Salurn,49,,24,31,55
076 Salurn,50,,28,34,62
076 Salurn,51,,32,32,64
076 Salurn,52,,39,29,68
076 Salurn,53,,31,29,60
076 Salurn,54,,27,34,61
076 Salurn,55,,21,23,44
076 Salurn,56,,26,28,54
076 Salurn,57,,32,17,49
076 Salurn,58,,19,23,42
076 Salurn,59,,19,16,35
076 Salurn,60,,20,20,40
076 Salurn,61,,20,19,39
076 Salurn,62,,17,17,34
076 Salurn,63,,28,19,47
076 Salurn,64,,25,20,45
076 Salurn,65,,24,14,38
076 Salurn,66,,27,10,37
076 Salurn,67,,14,20,34
076 Salurn,68,,15,18,33
076 Salurn,69,,20,17,37
076 Salurn,70,,12,10,22
076 Salurn,71,,16,18,34
076 Salurn,72,,16,17,33
076 Salurn,73,,20,18,38
076 Salurn,74,,15,16,31
076 Salurn,75,,11,10,21
076 Salurn,76,,11,8,19
076 Salurn,77,,5,9,14
076 Salurn,78,,10,12,22
076 Salurn,79,,12,20,32
076 Salurn,80,,10,16,26
076 Salurn,81,,9,6,15
076 Salurn,82,,4,6,10
076 Salurn,83,,4,13,17
076 Salurn,84,,5,8,13
076 Salurn,85,,8,10,18
076 Salurn,86,,7,10,17
076 Salurn,87,,4,14,18
076 Salurn,88,,1,11,12
076 Salurn,89,,2,8,10
076 Salurn,90,,4,7,11
076 Salurn,91,,1,8,9
076 Salurn,92,,2,2,4
076 Salurn,93,,-,5,5
076 Salurn,94,,1,2,3
076 Salurn,95,,1,4,5
076 Salurn,96,,-,4,4
076 Salurn,97,,-,2,2
076 Salurn,98,,-,2,2
076 Salurn,104,,-,1,1
076 Salurn,Insgesamt,,1.874,1.901,3.775
077 Innichen,0,,9,15,24
077 Innichen,1,,20,13,33
077 Innichen,2,,16,21,37
077 Innichen,3,,11,19,30
077 Innichen,4,,25,22,47
077 Innichen,5,,20,13,33
077 Innichen,6,,10,18,28
077 Innichen,7,,22,14,36
077 Innichen,8,,16,19,35
077 Innichen,9,,9,16,25
077 Innichen,10,,13,16,29
077 Innichen,11,,12,15,27
077 Innichen,12,,18,17,35
077 Innichen,13,,15,17,32
077 Innichen,14,,23,16,39
077 Innichen,15,,14,16,30
077 Innichen,16,,11,16,27
077 Innichen,17,,21,12,33
077 Innichen,18,,21,16,37
077 Innichen,19,,19,18,37
077 Innichen,20,,19,14,33
077 Innichen,21,,20,18,38
077 Innichen,22,,29,19,48
077 Innichen,23,,23,15,38
077 Innichen,24,,19,24,43
077 Innichen,25,,22,17,39
077 Innichen,26,,28,27,55
077 Innichen,27,,26,19,45
077 Innichen,28,,24,18,42
077 Innichen,29,,25,16,41
077 Innichen,30,,27,24,51
077 Innichen,31,,17,19,36
077 Innichen,32,,24,21,45
077 Innichen,33,,29,26,55
077 Innichen,34,,14,18,32
077 Innichen,35,,23,21,44
077 Innichen,36,,29,27,56
077 Innichen,37,,16,18,34
077 Innichen,38,,18,24,42
077 Innichen,39,,17,24,41
077 Innichen,40,,20,17,37
077 Innichen,41,,22,19,41
077 Innichen,42,,22,21,43
077 Innichen,43,,24,24,48
077 Innichen,44,,25,17,42
077 Innichen,45,,24,30,54
077 Innichen,46,,19,28,47
077 Innichen,47,,23,24,47
077 Innichen,48,,27,27,54
077 Innichen,49,,28,30,58
077 Innichen,50,,39,27,66
077 Innichen,51,,30,31,61
077 Innichen,52,,28,26,54
077 Innichen,53,,30,24,54
077 Innichen,54,,21,24,45
077 Innichen,55,,28,21,49
077 Innichen,56,,25,21,46
077 Innichen,57,,20,27,47
077 Innichen,58,,18,25,43
077 Innichen,59,,25,14,39
077 Innichen,60,,25,22,47
077 Innichen,61,,23,11,34
077 Innichen,62,,23,20,43
077 Innichen,63,,11,25,36
077 Innichen,64,,12,17,29
077 Innichen,65,,15,19,34
077 Innichen,66,,17,16,33
077 Innichen,67,,15,17,32
077 Innichen,68,,10,14,24
077 Innichen,69,,13,15,28
077 Innichen,70,,10,10,20
077 Innichen,71,,10,16,26
077 Innichen,72,,17,9,26
077 Innichen,73,,17,18,35
077 Innichen,74,,13,16,29
077 Innichen,75,,8,25,33
077 Innichen,76,,11,12,23
077 Innichen,77,,8,13,21
077 Innichen,78,,8,11,19
077 Innichen,79,,8,20,28
077 Innichen,80,,4,16,20
077 Innichen,81,,7,14,21
077 Innichen,82,,8,6,14
077 Innichen,83,,10,15,25
077 Innichen,84,,10,15,25
077 Innichen,85,,9,11,20
077 Innichen,86,,7,13,20
077 Innichen,87,,8,12,20
077 Innichen,88,,2,11,13
077 Innichen,89,,4,8,12
077 Innichen,90,,2,8,10
077 Innichen,91,,2,3,5
077 Innichen,92,,2,3,5
077 Innichen,93,,-,5,5
077 Innichen,94,,-,3,3
077 Innichen,95,,1,3,4
077 Innichen,96,,-,1,1
077 Innichen,Insgesamt,,1.622,1.688,3.310
079 Jenesien,0,,14,14,28
079 Jenesien,1,,22,19,41
079 Jenesien,2,,18,16,34
079 Jenesien,3,,16,12,28
079 Jenesien,4,,14,11,25
079 Jenesien,5,,18,17,35
079 Jenesien,6,,18,18,36
079 Jenesien,7,,19,18,37
079 Jenesien,8,,23,17,40
079 Jenesien,9,,20,25,45
079 Jenesien,10,,15,17,32
079 Jenesien,11,,18,20,38
079 Jenesien,12,,17,22,39
079 Jenesien,13,,14,18,32
079 Jenesien,14,,20,22,42
079 Jenesien,15,,17,18,35
079 Jenesien,16,,27,21,48
079 Jenesien,17,,15,27,42
079 Jenesien,18,,23,18,41
079 Jenesien,19,,25,12,37
079 Jenesien,20,,23,18,41
079 Jenesien,21,,20,21,41
079 Jenesien,22,,16,18,34
079 Jenesien,23,,28,21,49
079 Jenesien,24,,20,22,42
079 Jenesien,25,,18,14,32
079 Jenesien,26,,17,17,34
079 Jenesien,27,,23,14,37
079 Jenesien,28,,17,17,34
079 Jenesien,29,,15,14,29
079 Jenesien,30,,18,12,30
079 Jenesien,31,,19,17,36
079 Jenesien,32,,16,19,35
079 Jenesien,33,,18,22,40
079 Jenesien,34,,17,18,35
079 Jenesien,35,,19,16,35
079 Jenesien,36,,21,16,37
079 Jenesien,37,,14,21,35
079 Jenesien,38,,21,13,34
079 Jenesien,39,,13,20,33
079 Jenesien,40,,11,22,33
079 Jenesien,41,,23,25,48
079 Jenesien,42,,23,29,52
079 Jenesien,43,,25,25,50
079 Jenesien,44,,30,25,55
079 Jenesien,45,,31,32,63
079 Jenesien,46,,32,19,51
079 Jenesien,47,,18,26,44
079 Jenesien,48,,18,25,43
079 Jenesien,49,,38,30,68
079 Jenesien,50,,33,28,61
079 Jenesien,51,,34,35,69
079 Jenesien,52,,28,27,55
079 Jenesien,53,,25,21,46
079 Jenesien,54,,31,22,53
079 Jenesien,55,,21,12,33
079 Jenesien,56,,21,16,37
079 Jenesien,57,,23,9,32
079 Jenesien,58,,12,17,29
079 Jenesien,59,,15,13,28
079 Jenesien,60,,10,12,22
079 Jenesien,61,,18,13,31
079 Jenesien,62,,13,9,22
079 Jenesien,63,,13,18,31
079 Jenesien,64,,11,9,20
079 Jenesien,65,,14,21,35
079 Jenesien,66,,14,13,27
079 Jenesien,67,,14,9,23
079 Jenesien,68,,13,11,24
079 Jenesien,69,,11,9,20
079 Jenesien,70,,7,14,21
079 Jenesien,71,,11,11,22
079 Jenesien,72,,15,9,24
079 Jenesien,73,,14,9,23
079 Jenesien,74,,12,19,31
079 Jenesien,75,,14,11,25
079 Jenesien,76,,11,18,29
079 Jenesien,77,,14,10,24
079 Jenesien,78,,7,15,22
079 Jenesien,79,,5,18,23
079 Jenesien,80,,5,8,13
079 Jenesien,81,,8,6,14
079 Jenesien,82,,15,8,23
079 Jenesien,83,,5,7,12
079 Jenesien,84,,6,6,12
079 Jenesien,85,,3,10,13
079 Jenesien,86,,3,9,12
079 Jenesien,87,,4,5,9
079 Jenesien,88,,1,5,6
079 Jenesien,89,,3,5,8
079 Jenesien,90,,-,3,3
079 Jenesien,91,,3,-,3
079 Jenesien,92,,1,1,2
079 Jenesien,93,,1,3,4
079 Jenesien,94,,-,2,2
079 Jenesien,95,,1,1,2
079 Jenesien,96,,-,1,1
079 Jenesien,97,,-,1,1
079 Jenesien,Insgesamt,,1.538,1.509,3.047
080 St.Leonhard in Pass.,0,,21,29,50
080 St.Leonhard in Pass.,1,,28,20,48
080 St.Leonhard in Pass.,2,,20,21,41
080 St.Leonhard in Pass.,3,,12,21,33
080 St.Leonhard in Pass.,4,,16,20,36
080 St.Leonhard in Pass.,5,,21,24,45
080 St.Leonhard in Pass.,6,,20,20,40
080 St.Leonhard in Pass.,7,,18,19,37
080 St.Leonhard in Pass.,8,,22,20,42
080 St.Leonhard in Pass.,9,,16,26,42
080 St.Leonhard in Pass.,10,,20,21,41
080 St.Leonhard in Pass.,11,,17,22,39
080 St.Leonhard in Pass.,12,,24,15,39
080 St.Leonhard in Pass.,13,,26,20,46
080 St.Leonhard in Pass.,14,,28,14,42
080 St.Leonhard in Pass.,15,,23,18,41
080 St.Leonhard in Pass.,16,,22,21,43
080 St.Leonhard in Pass.,17,,20,21,41
080 St.Leonhard in Pass.,18,,25,20,45
080 St.Leonhard in Pass.,19,,25,20,45
080 St.Leonhard in Pass.,20,,22,14,36
080 St.Leonhard in Pass.,21,,19,22,41
080 St.Leonhard in Pass.,22,,26,22,48
080 St.Leonhard in Pass.,23,,23,20,43
080 St.Leonhard in Pass.,24,,21,23,44
080 St.Leonhard in Pass.,25,,26,16,42
080 St.Leonhard in Pass.,26,,31,30,61
080 St.Leonhard in Pass.,27,,20,20,40
080 St.Leonhard in Pass.,28,,28,21,49
080 St.Leonhard in Pass.,29,,30,29,59
080 St.Leonhard in Pass.,30,,26,20,46
080 St.Leonhard in Pass.,31,,28,20,48
080 St.Leonhard in Pass.,32,,25,21,46
080 St.Leonhard in Pass.,33,,23,30,53
080 St.Leonhard in Pass.,34,,21,29,50
080 St.Leonhard in Pass.,35,,21,25,46
080 St.Leonhard in Pass.,36,,30,21,51
080 St.Leonhard in Pass.,37,,26,27,53
080 St.Leonhard in Pass.,38,,31,24,55
080 St.Leonhard in Pass.,39,,14,32,46
080 St.Leonhard in Pass.,40,,26,12,38
080 St.Leonhard in Pass.,41,,32,20,52
080 St.Leonhard in Pass.,42,,27,30,57
080 St.Leonhard in Pass.,43,,27,24,51
080 St.Leonhard in Pass.,44,,30,20,50
080 St.Leonhard in Pass.,45,,19,24,43
080 St.Leonhard in Pass.,46,,24,27,51
080 St.Leonhard in Pass.,47,,34,22,56
080 St.Leonhard in Pass.,48,,22,25,47
080 St.Leonhard in Pass.,49,,34,28,62
080 St.Leonhard in Pass.,50,,30,31,61
080 St.Leonhard in Pass.,51,,24,27,51
080 St.Leonhard in Pass.,52,,23,24,47
080 St.Leonhard in Pass.,53,,24,31,55
080 St.Leonhard in Pass.,54,,27,22,49
080 St.Leonhard in Pass.,55,,32,19,51
080 St.Leonhard in Pass.,56,,29,25,54
080 St.Leonhard in Pass.,57,,21,20,41
080 St.Leonhard in Pass.,58,,20,28,48
080 St.Leonhard in Pass.,59,,26,17,43
080 St.Leonhard in Pass.,60,,24,17,41
080 St.Leonhard in Pass.,61,,18,13,31
080 St.Leonhard in Pass.,62,,27,24,51
080 St.Leonhard in Pass.,63,,19,23,42
080 St.Leonhard in Pass.,64,,24,17,41
080 St.Leonhard in Pass.,65,,14,16,30
080 St.Leonhard in Pass.,66,,21,10,31
080 St.Leonhard in Pass.,67,,23,11,34
080 St.Leonhard in Pass.,68,,19,14,33
080 St.Leonhard in Pass.,69,,13,16,29
080 St.Leonhard in Pass.,70,,9,10,19
080 St.Leonhard in Pass.,71,,11,12,23
080 St.Leonhard in Pass.,72,,7,24,31
080 St.Leonhard in Pass.,73,,7,12,19
080 St.Leonhard in Pass.,74,,12,13,25
080 St.Leonhard in Pass.,75,,17,12,29
080 St.Leonhard in Pass.,76,,18,18,36
080 St.Leonhard in Pass.,77,,11,13,24
080 St.Leonhard in Pass.,78,,16,7,23
080 St.Leonhard in Pass.,79,,14,12,26
080 St.Leonhard in Pass.,80,,8,11,19
080 St.Leonhard in Pass.,81,,6,12,18
080 St.Leonhard in Pass.,82,,8,13,21
080 St.Leonhard in Pass.,83,,4,12,16
080 St.Leonhard in Pass.,84,,2,13,15
080 St.Leonhard in Pass.,85,,4,7,11
080 St.Leonhard in Pass.,86,,3,5,8
080 St.Leonhard in Pass.,87,,5,7,12
080 St.Leonhard in Pass.,88,,3,7,10
080 St.Leonhard in Pass.,89,,4,7,11
080 St.Leonhard in Pass.,90,,4,5,9
080 St.Leonhard in Pass.,91,,1,3,4
080 St.Leonhard in Pass.,92,,3,3,6
080 St.Leonhard in Pass.,93,,-,4,4
080 St.Leonhard in Pass.,94,,-,1,1
080 St.Leonhard in Pass.,96,,-,1,1
080 St.Leonhard in Pass.,103,,-,1,1
080 St.Leonhard in Pass.,Insgesamt,,1.825,1.760,3.585
081 St.Lorenzen,0,,13,25,38
081 St.Lorenzen,1,,19,28,47
081 St.Lorenzen,2,,25,25,50
081 St.Lorenzen,3,,16,9,25
081 St.Lorenzen,4,,21,21,42
081 St.Lorenzen,5,,28,20,48
081 St.Lorenzen,6,,19,23,42
081 St.Lorenzen,7,,23,22,45
081 St.Lorenzen,8,,25,21,46
081 St.Lorenzen,9,,18,20,38
081 St.Lorenzen,10,,26,22,48
081 St.Lorenzen,11,,27,19,46
081 St.Lorenzen,12,,28,17,45
081 St.Lorenzen,13,,21,20,41
081 St.Lorenzen,14,,30,21,51
081 St.Lorenzen,15,,21,28,49
081 St.Lorenzen,16,,27,26,53
081 St.Lorenzen,17,,34,23,57
081 St.Lorenzen,18,,18,31,49
081 St.Lorenzen,19,,27,30,57
081 St.Lorenzen,20,,26,15,41
081 St.Lorenzen,21,,30,21,51
081 St.Lorenzen,22,,25,34,59
081 St.Lorenzen,23,,26,20,46
081 St.Lorenzen,24,,22,17,39
081 St.Lorenzen,25,,23,19,42
081 St.Lorenzen,26,,20,16,36
081 St.Lorenzen,27,,17,28,45
081 St.Lorenzen,28,,22,22,44
081 St.Lorenzen,29,,20,28,48
081 St.Lorenzen,30,,26,31,57
081 St.Lorenzen,31,,25,24,49
081 St.Lorenzen,32,,27,18,45
081 St.Lorenzen,33,,38,22,60
081 St.Lorenzen,34,,24,25,49
081 St.Lorenzen,35,,17,27,44
081 St.Lorenzen,36,,24,32,56
081 St.Lorenzen,37,,26,20,46
081 St.Lorenzen,38,,30,17,47
081 St.Lorenzen,39,,25,16,41
081 St.Lorenzen,40,,27,29,56
081 St.Lorenzen,41,,27,32,59
081 St.Lorenzen,42,,34,36,70
081 St.Lorenzen,43,,38,35,73
081 St.Lorenzen,44,,35,31,66
081 St.Lorenzen,45,,30,27,57
081 St.Lorenzen,46,,20,33,53
081 St.Lorenzen,47,,45,34,79
081 St.Lorenzen,48,,31,39,70
081 St.Lorenzen,49,,36,32,68
081 St.Lorenzen,50,,30,27,57
081 St.Lorenzen,51,,36,24,60
081 St.Lorenzen,52,,33,31,64
081 St.Lorenzen,53,,30,38,68
081 St.Lorenzen,54,,24,37,61
081 St.Lorenzen,55,,32,19,51
081 St.Lorenzen,56,,31,25,56
081 St.Lorenzen,57,,29,34,63
081 St.Lorenzen,58,,23,28,51
081 St.Lorenzen,59,,24,28,52
081 St.Lorenzen,60,,16,18,34
081 St.Lorenzen,61,,13,20,33
081 St.Lorenzen,62,,24,17,41
081 St.Lorenzen,63,,18,11,29
081 St.Lorenzen,64,,15,15,30
081 St.Lorenzen,65,,16,18,34
081 St.Lorenzen,66,,10,22,32
081 St.Lorenzen,67,,15,12,27
081 St.Lorenzen,68,,19,9,28
081 St.Lorenzen,69,,17,10,27
081 St.Lorenzen,70,,10,18,28
081 St.Lorenzen,71,,17,14,31
081 St.Lorenzen,72,,11,15,26
081 St.Lorenzen,73,,17,20,37
081 St.Lorenzen,74,,15,16,31
081 St.Lorenzen,75,,12,11,23
081 St.Lorenzen,76,,11,18,29
081 St.Lorenzen,77,,12,10,22
081 St.Lorenzen,78,,17,16,33
081 St.Lorenzen,79,,10,12,22
081 St.Lorenzen,80,,9,11,20
081 St.Lorenzen,81,,14,7,21
081 St.Lorenzen,82,,11,7,18
081 St.Lorenzen,83,,7,10,17
081 St.Lorenzen,84,,5,13,18
081 St.Lorenzen,85,,3,5,8
081 St.Lorenzen,86,,9,11,20
081 St.Lorenzen,87,,3,10,13
081 St.Lorenzen,88,,3,4,7
081 St.Lorenzen,89,,5,4,9
081 St.Lorenzen,90,,1,8,9
081 St.Lorenzen,91,,1,6,7
081 St.Lorenzen,92,,-,5,5
081 St.Lorenzen,93,,-,1,1
081 St.Lorenzen,94,,-,1,1
081 St.Lorenzen,95,,-,2,2
081 St.Lorenzen,97,,-,1,1
081 St.Lorenzen,Insgesamt,,1.940,1.930,3.870
082 St.Martin in Thurn,0,,12,7,19
082 St.Martin in Thurn,1,,12,13,25
082 St.Martin in Thurn,2,,12,7,19
082 St.Martin in Thurn,3,,7,6,13
082 St.Martin in Thurn,4,,12,5,17
082 St.Martin in Thurn,5,,5,8,13
082 St.Martin in Thurn,6,,5,5,10
082 St.Martin in Thurn,7,,7,4,11
082 St.Martin in Thurn,8,,2,10,12
082 St.Martin in Thurn,9,,9,14,23
082 St.Martin in Thurn,10,,10,9,19
082 St.Martin in Thurn,11,,17,13,30
082 St.Martin in Thurn,12,,4,7,11
082 St.Martin in Thurn,13,,15,8,23
082 St.Martin in Thurn,14,,8,15,23
082 St.Martin in Thurn,15,,7,9,16
082 St.Martin in Thurn,16,,9,19,28
082 St.Martin in Thurn,17,,11,10,21
082 St.Martin in Thurn,18,,15,11,26
082 St.Martin in Thurn,19,,24,15,39
082 St.Martin in Thurn,20,,15,11,26
082 St.Martin in Thurn,21,,15,8,23
082 St.Martin in Thurn,22,,9,10,19
082 St.Martin in Thurn,23,,18,14,32
082 St.Martin in Thurn,24,,11,11,22
082 St.Martin in Thurn,25,,6,15,21
082 St.Martin in Thurn,26,,19,12,31
082 St.Martin in Thurn,27,,7,6,13
082 St.Martin in Thurn,28,,13,8,21
082 St.Martin in Thurn,29,,11,9,20
082 St.Martin in Thurn,30,,10,12,22
082 St.Martin in Thurn,31,,7,8,15
082 St.Martin in Thurn,32,,13,10,23
082 St.Martin in Thurn,33,,14,14,28
082 St.Martin in Thurn,34,,12,5,17
082 St.Martin in Thurn,35,,12,7,19
082 St.Martin in Thurn,36,,7,11,18
082 St.Martin in Thurn,37,,16,8,24
082 St.Martin in Thurn,38,,13,10,23
082 St.Martin in Thurn,39,,12,10,22
082 St.Martin in Thurn,40,,7,10,17
082 St.Martin in Thurn,41,,7,11,18
082 St.Martin in Thurn,42,,11,10,21
082 St.Martin in Thurn,43,,13,8,21
082 St.Martin in Thurn,44,,15,14,29
082 St.Martin in Thurn,45,,13,14,27
082 St.Martin in Thurn,46,,14,16,30
082 St.Martin in Thurn,47,,16,14,30
082 St.Martin in Thurn,48,,11,9,20
082 St.Martin in Thurn,49,,16,26,42
082 St.Martin in Thurn,50,,17,21,38
082 St.Martin in Thurn,51,,11,15,26
082 St.Martin in Thurn,52,,14,14,28
082 St.Martin in Thurn,53,,14,16,30
082 St.Martin in Thurn,54,,15,19,34
082 St.Martin in Thurn,55,,15,5,20
082 St.Martin in Thurn,56,,12,10,22
082 St.Martin in Thurn,57,,12,8,20
082 St.Martin in Thurn,58,,12,10,22
082 St.Martin in Thurn,59,,8,5,13
082 St.Martin in Thurn,60,,13,9,22
082 St.Martin in Thurn,61,,8,7,15
082 St.Martin in Thurn,62,,5,9,14
082 St.Martin in Thurn,63,,3,4,7
082 St.Martin in Thurn,64,,8,7,15
082 St.Martin in Thurn,65,,8,6,14
082 St.Martin in Thurn,66,,3,6,9
082 St.Martin in Thurn,67,,8,6,14
082 St.Martin in Thurn,68,,9,7,16
082 St.Martin in Thurn,69,,7,7,14
082 St.Martin in Thurn,70,,7,4,11
082 St.Martin in Thurn,71,,12,9,21
082 St.Martin in Thurn,72,,3,8,11
082 St.Martin in Thurn,73,,8,6,14
082 St.Martin in Thurn,74,,5,5,10
082 St.Martin in Thurn,75,,3,5,8
082 St.Martin in Thurn,76,,6,8,14
082 St.Martin in Thurn,77,,10,6,16
082 St.Martin in Thurn,78,,5,11,16
082 St.Martin in Thurn,79,,4,6,10
082 St.Martin in Thurn,80,,5,3,8
082 St.Martin in Thurn,81,,4,2,6
082 St.Martin in Thurn,82,,2,7,9
082 St.Martin in Thurn,83,,6,5,11
082 St.Martin in Thurn,84,,5,6,11
082 St.Martin in Thurn,85,,3,5,8
082 St.Martin in Thurn,86,,5,5,10
082 St.Martin in Thurn,87,,2,2,4
082 St.Martin in Thurn,88,,1,2,3
082 St.Martin in Thurn,89,,2,2,4
082 St.Martin in Thurn,90,,1,4,5
082 St.Martin in Thurn,91,,3,3,6
082 St.Martin in Thurn,92,,-,3,3
082 St.Martin in Thurn,93,,1,1,2
082 St.Martin in Thurn,94,,-,1,1
082 St.Martin in Thurn,95,,-,1,1
082 St.Martin in Thurn,96,,-,2,2
082 St.Martin in Thurn,97,,-,1,1
082 St.Martin in Thurn,Insgesamt,,871,840,1.711
083 St.Martin in Passeier,0,,14,24,38
083 St.Martin in Passeier,1,,20,12,32
083 St.Martin in Passeier,2,,21,13,34
083 St.Martin in Passeier,3,,21,27,48
083 St.Martin in Passeier,4,,12,22,34
083 St.Martin in Passeier,5,,26,16,42
083 St.Martin in Passeier,6,,13,21,34
083 St.Martin in Passeier,7,,20,27,47
083 St.Martin in Passeier,8,,16,21,37
083 St.Martin in Passeier,9,,24,17,41
083 St.Martin in Passeier,10,,22,18,40
083 St.Martin in Passeier,11,,19,18,37
083 St.Martin in Passeier,12,,18,16,34
083 St.Martin in Passeier,13,,16,12,28
083 St.Martin in Passeier,14,,18,16,34
083 St.Martin in Passeier,15,,13,23,36
083 St.Martin in Passeier,16,,8,21,29
083 St.Martin in Passeier,17,,22,20,42
083 St.Martin in Passeier,18,,25,28,53
083 St.Martin in Passeier,19,,20,21,41
083 St.Martin in Passeier,20,,21,19,40
083 St.Martin in Passeier,21,,22,24,46
083 St.Martin in Passeier,22,,20,22,42
083 St.Martin in Passeier,23,,22,19,41
083 St.Martin in Passeier,24,,26,23,49
083 St.Martin in Passeier,25,,21,22,43
083 St.Martin in Passeier,26,,19,20,39
083 St.Martin in Passeier,27,,14,16,30
083 St.Martin in Passeier,28,,19,26,45
083 St.Martin in Passeier,29,,27,21,48
083 St.Martin in Passeier,30,,19,29,48
083 St.Martin in Passeier,31,,24,26,50
083 St.Martin in Passeier,32,,18,11,29
083 St.Martin in Passeier,33,,26,17,43
083 St.Martin in Passeier,34,,25,24,49
083 St.Martin in Passeier,35,,19,24,43
083 St.Martin in Passeier,36,,15,18,33
083 St.Martin in Passeier,37,,33,17,50
083 St.Martin in Passeier,38,,28,22,50
083 St.Martin in Passeier,39,,19,18,37
083 St.Martin in Passeier,40,,23,20,43
083 St.Martin in Passeier,41,,21,24,45
083 St.Martin in Passeier,42,,28,22,50
083 St.Martin in Passeier,43,,22,22,44
083 St.Martin in Passeier,44,,26,24,50
083 St.Martin in Passeier,45,,30,21,51
083 St.Martin in Passeier,46,,28,26,54
083 St.Martin in Passeier,47,,26,23,49
083 St.Martin in Passeier,48,,22,25,47
083 St.Martin in Passeier,49,,26,29,55
083 St.Martin in Passeier,50,,34,24,58
083 St.Martin in Passeier,51,,18,19,37
083 St.Martin in Passeier,52,,31,19,50
083 St.Martin in Passeier,53,,23,30,53
083 St.Martin in Passeier,54,,33,22,55
083 St.Martin in Passeier,55,,24,21,45
083 St.Martin in Passeier,56,,21,25,46
083 St.Martin in Passeier,57,,25,19,44
083 St.Martin in Passeier,58,,26,11,37
083 St.Martin in Passeier,59,,19,17,36
083 St.Martin in Passeier,60,,25,16,41
083 St.Martin in Passeier,61,,11,13,24
083 St.Martin in Passeier,62,,21,15,36
083 St.Martin in Passeier,63,,5,21,26
083 St.Martin in Passeier,64,,23,11,34
083 St.Martin in Passeier,65,,12,15,27
083 St.Martin in Passeier,66,,14,12,26
083 St.Martin in Passeier,67,,9,9,18
083 St.Martin in Passeier,68,,14,14,28
083 St.Martin in Passeier,69,,12,9,21
083 St.Martin in Passeier,70,,10,10,20
083 St.Martin in Passeier,71,,16,12,28
083 St.Martin in Passeier,72,,11,11,22
083 St.Martin in Passeier,73,,13,14,27
083 St.Martin in Passeier,74,,8,14,22
083 St.Martin in Passeier,75,,4,11,15
083 St.Martin in Passeier,76,,6,13,19
083 St.Martin in Passeier,77,,10,6,16
083 St.Martin in Passeier,78,,12,19,31
083 St.Martin in Passeier,79,,11,11,22
083 St.Martin in Passeier,80,,7,12,19
083 St.Martin in Passeier,81,,13,7,20
083 St.Martin in Passeier,82,,7,9,16
083 St.Martin in Passeier,83,,3,8,11
083 St.Martin in Passeier,84,,3,8,11
083 St.Martin in Passeier,85,,2,9,11
083 St.Martin in Passeier,86,,5,8,13
083 St.Martin in Passeier,87,,2,4,6
083 St.Martin in Passeier,88,,4,2,6
083 St.Martin in Passeier,89,,-,8,8
083 St.Martin in Passeier,90,,3,4,7
083 St.Martin in Passeier,91,,2,4,6
083 St.Martin in Passeier,92,,1,3,4
083 St.Martin in Passeier,94,,-,3,3
083 St.Martin in Passeier,96,,-,1,1
083 St.Martin in Passeier,Insgesamt,,1.610,1.600,3.210
084 St.Pankraz,0,,5,4,9
084 St.Pankraz,1,,2,8,10
084 St.Pankraz,2,,7,3,10
084 St.Pankraz,3,,5,3,8
084 St.Pankraz,4,,7,4,11
084 St.Pankraz,5,,8,5,13
084 St.Pankraz,6,,11,12,23
084 St.Pankraz,7,,9,9,18
084 St.Pankraz,8,,10,11,21
084 St.Pankraz,9,,8,12,20
084 St.Pankraz,10,,12,11,23
084 St.Pankraz,11,,13,9,22
084 St.Pankraz,12,,14,8,22
084 St.Pankraz,13,,8,3,11
084 St.Pankraz,14,,14,15,29
084 St.Pankraz,15,,12,13,25
084 St.Pankraz,16,,8,4,12
084 St.Pankraz,17,,13,6,19
084 St.Pankraz,18,,8,11,19
084 St.Pankraz,19,,9,10,19
084 St.Pankraz,20,,10,7,17
084 St.Pankraz,21,,8,6,14
084 St.Pankraz,22,,4,7,11
084 St.Pankraz,23,,8,9,17
084 St.Pankraz,24,,12,13,25
084 St.Pankraz,25,,11,6,17
084 St.Pankraz,26,,14,15,29
084 St.Pankraz,27,,12,9,21
084 St.Pankraz,28,,8,4,12
084 St.Pankraz,29,,10,2,12
084 St.Pankraz,30,,7,3,10
084 St.Pankraz,31,,9,6,15
084 St.Pankraz,32,,8,5,13
084 St.Pankraz,33,,12,7,19
084 St.Pankraz,34,,5,15,20
084 St.Pankraz,35,,11,7,18
084 St.Pankraz,36,,4,5,9
084 St.Pankraz,37,,11,9,20
084 St.Pankraz,38,,11,11,22
084 St.Pankraz,39,,6,9,15
084 St.Pankraz,40,,8,14,22
084 St.Pankraz,41,,14,11,25
084 St.Pankraz,42,,13,5,18
084 St.Pankraz,43,,10,20,30
084 St.Pankraz,44,,11,11,22
084 St.Pankraz,45,,13,13,26
084 St.Pankraz,46,,17,8,25
084 St.Pankraz,47,,16,16,32
084 St.Pankraz,48,,8,16,24
084 St.Pankraz,49,,13,7,20
084 St.Pankraz,50,,22,14,36
084 St.Pankraz,51,,13,11,24
084 St.Pankraz,52,,10,8,18
084 St.Pankraz,53,,15,9,24
084 St.Pankraz,54,,11,13,24
084 St.Pankraz,55,,13,4,17
084 St.Pankraz,56,,13,13,26
084 St.Pankraz,57,,6,8,14
084 St.Pankraz,58,,9,8,17
084 St.Pankraz,59,,10,16,26
084 St.Pankraz,60,,6,4,10
084 St.Pankraz,61,,11,7,18
084 St.Pankraz,62,,10,10,20
084 St.Pankraz,63,,16,8,24
084 St.Pankraz,64,,5,2,7
084 St.Pankraz,65,,10,5,15
084 St.Pankraz,66,,8,4,12
084 St.Pankraz,67,,7,2,9
084 St.Pankraz,68,,8,6,14
084 St.Pankraz,69,,3,7,10
084 St.Pankraz,70,,3,5,8
084 St.Pankraz,71,,4,7,11
084 St.Pankraz,72,,12,14,26
084 St.Pankraz,73,,9,15,24
084 St.Pankraz,74,,8,11,19
084 St.Pankraz,75,,7,6,13
084 St.Pankraz,76,,7,7,14
084 St.Pankraz,77,,5,10,15
084 St.Pankraz,78,,9,8,17
084 St.Pankraz,79,,5,3,8
084 St.Pankraz,80,,5,2,7
084 St.Pankraz,81,,4,7,11
084 St.Pankraz,82,,6,3,9
084 St.Pankraz,83,,6,9,15
084 St.Pankraz,84,,3,4,7
084 St.Pankraz,85,,3,6,9
084 St.Pankraz,86,,5,8,13
084 St.Pankraz,87,,3,6,9
084 St.Pankraz,88,,5,3,8
084 St.Pankraz,89,,1,1,2
084 St.Pankraz,90,,3,1,4
084 St.Pankraz,91,,1,2,3
084 St.Pankraz,92,,2,3,5
084 St.Pankraz,93,,-,2,2
084 St.Pankraz,94,,1,2,3
084 St.Pankraz,95,,-,1,1
084 St.Pankraz,96,,-,1,1
084 St.Pankraz,101,,-,1,1
084 St.Pankraz,Insgesamt,,810,744,1.554
085 St.Christina in Gröden,0,,12,8,20
085 St.Christina in Gröden,1,,11,9,20
085 St.Christina in Gröden,2,,12,9,21
085 St.Christina in Gröden,3,,8,13,21
085 St.Christina in Gröden,4,,11,8,19
085 St.Christina in Gröden,5,,9,7,16
085 St.Christina in Gröden,6,,12,6,18
085 St.Christina in Gröden,7,,14,7,21
085 St.Christina in Gröden,8,,9,8,17
085 St.Christina in Gröden,9,,7,10,17
085 St.Christina in Gröden,10,,14,11,25
085 St.Christina in Gröden,11,,15,11,26
085 St.Christina in Gröden,12,,7,7,14
085 St.Christina in Gröden,13,,10,14,24
085 St.Christina in Gröden,14,,11,10,21
085 St.Christina in Gröden,15,,20,12,32
085 St.Christina in Gröden,16,,22,10,32
085 St.Christina in Gröden,17,,9,16,25
085 St.Christina in Gröden,18,,7,12,19
085 St.Christina in Gröden,19,,12,7,19
085 St.Christina in Gröden,20,,15,12,27
085 St.Christina in Gröden,21,,9,16,25
085 St.Christina in Gröden,22,,12,12,24
085 St.Christina in Gröden,23,,17,15,32
085 St.Christina in Gröden,24,,13,16,29
085 St.Christina in Gröden,25,,8,13,21
085 St.Christina in Gröden,26,,3,14,17
085 St.Christina in Gröden,27,,11,10,21
085 St.Christina in Gröden,28,,10,11,21
085 St.Christina in Gröden,29,,14,10,24
085 St.Christina in Gröden,30,,7,8,15
085 St.Christina in Gröden,31,,8,9,17
085 St.Christina in Gröden,32,,20,11,31
085 St.Christina in Gröden,33,,9,7,16
085 St.Christina in Gröden,34,,7,10,17
085 St.Christina in Gröden,35,,15,19,34
085 St.Christina in Gröden,36,,10,11,21
085 St.Christina in Gröden,37,,3,13,16
085 St.Christina in Gröden,38,,9,11,20
085 St.Christina in Gröden,39,,14,18,32
085 St.Christina in Gröden,40,,12,15,27
085 St.Christina in Gröden,41,,12,24,36
085 St.Christina in Gröden,42,,10,14,24
085 St.Christina in Gröden,43,,18,10,28
085 St.Christina in Gröden,44,,15,14,29
085 St.Christina in Gröden,45,,21,21,42
085 St.Christina in Gröden,46,,21,12,33
085 St.Christina in Gröden,47,,27,26,53
085 St.Christina in Gröden,48,,14,16,30
085 St.Christina in Gröden,49,,18,10,28
085 St.Christina in Gröden,50,,13,17,30
085 St.Christina in Gröden,51,,13,23,36
085 St.Christina in Gröden,52,,13,17,30
085 St.Christina in Gröden,53,,19,14,33
085 St.Christina in Gröden,54,,21,16,37
085 St.Christina in Gröden,55,,21,18,39
085 St.Christina in Gröden,56,,11,12,23
085 St.Christina in Gröden,57,,7,11,18
085 St.Christina in Gröden,58,,16,10,26
085 St.Christina in Gröden,59,,11,11,22
085 St.Christina in Gröden,60,,9,10,19
085 St.Christina in Gröden,61,,11,15,26
085 St.Christina in Gröden,62,,9,9,18
085 St.Christina in Gröden,63,,5,7,12
085 St.Christina in Gröden,64,,11,5,16
085 St.Christina in Gröden,65,,6,5,11
085 St.Christina in Gröden,66,,8,9,17
085 St.Christina in Gröden,67,,8,5,13
085 St.Christina in Gröden,68,,6,9,15
085 St.Christina in Gröden,69,,7,9,16
085 St.Christina in Gröden,70,,7,7,14
085 St.Christina in Gröden,71,,6,12,18
085 St.Christina in Gröden,72,,10,14,24
085 St.Christina in Gröden,73,,8,4,12
085 St.Christina in Gröden,74,,11,7,18
085 St.Christina in Gröden,75,,8,10,18
085 St.Christina in Gröden,76,,10,8,18
085 St.Christina in Gröden,77,,6,7,13
085 St.Christina in Gröden,78,,8,4,12
085 St.Christina in Gröden,79,,10,8,18
085 St.Christina in Gröden,80,,12,3,15
085 St.Christina in Gröden,81,,6,11,17
085 St.Christina in Gröden,82,,4,9,13
085 St.Christina in Gröden,83,,6,7,13
085 St.Christina in Gröden,84,,2,6,8
085 St.Christina in Gröden,85,,9,3,12
085 St.Christina in Gröden,86,,2,9,11
085 St.Christina in Gröden,87,,2,2,4
085 St.Christina in Gröden,88,,5,6,11
085 St.Christina in Gröden,89,,4,1,5
085 St.Christina in Gröden,90,,2,4,6
085 St.Christina in Gröden,92,,1,2,3
085 St.Christina in Gröden,93,,-,2,2
085 St.Christina in Gröden,94,,-,1,1
085 St.Christina in Gröden,95,,-,1,1
085 St.Christina in Gröden,96,,-,1,1
085 St.Christina in Gröden,100,,1,-,1
085 St.Christina in Gröden,102,,2,-,2
085 St.Christina in Gröden,Insgesamt,,981,984,1.965
086 Sarntal,0,,55,33,88
086 Sarntal,1,,49,37,86
086 Sarntal,2,,48,31,79
086 Sarntal,3,,40,45,85
086 Sarntal,4,,45,43,88
086 Sarntal,5,,41,39,80
086 Sarntal,6,,34,36,70
086 Sarntal,7,,41,55,96
086 Sarntal,8,,53,40,93
086 Sarntal,9,,43,51,94
086 Sarntal,10,,41,37,78
086 Sarntal,11,,41,39,80
086 Sarntal,12,,47,34,81
086 Sarntal,13,,29,42,71
086 Sarntal,14,,49,25,74
086 Sarntal,15,,37,43,80
086 Sarntal,16,,35,36,71
086 Sarntal,17,,52,42,94
086 Sarntal,18,,45,47,92
086 Sarntal,19,,43,43,86
086 Sarntal,20,,44,42,86
086 Sarntal,21,,36,42,78
086 Sarntal,22,,33,44,77
086 Sarntal,23,,43,39,82
086 Sarntal,24,,44,49,93
086 Sarntal,25,,43,29,72
086 Sarntal,26,,57,32,89
086 Sarntal,27,,47,43,90
086 Sarntal,28,,35,31,66
086 Sarntal,29,,41,44,85
086 Sarntal,30,,39,41,80
086 Sarntal,31,,38,40,78
086 Sarntal,32,,59,40,99
086 Sarntal,33,,55,38,93
086 Sarntal,34,,45,51,96
086 Sarntal,35,,54,35,89
086 Sarntal,36,,53,52,105
086 Sarntal,37,,57,55,112
086 Sarntal,38,,53,41,94
086 Sarntal,39,,44,35,79
086 Sarntal,40,,57,47,104
086 Sarntal,41,,43,58,101
086 Sarntal,42,,56,68,124
086 Sarntal,43,,69,40,109
086 Sarntal,44,,46,45,91
086 Sarntal,45,,62,59,121
086 Sarntal,46,,62,55,117
086 Sarntal,47,,49,45,94
086 Sarntal,48,,52,50,102
086 Sarntal,49,,49,47,96
086 Sarntal,50,,63,57,120
086 Sarntal,51,,58,66,124
086 Sarntal,52,,41,46,87
086 Sarntal,53,,57,36,93
086 Sarntal,54,,41,51,92
086 Sarntal,55,,65,45,110
086 Sarntal,56,,42,42,84
086 Sarntal,57,,56,44,100
086 Sarntal,58,,32,40,72
086 Sarntal,59,,37,29,66
086 Sarntal,60,,39,40,79
086 Sarntal,61,,36,29,65
086 Sarntal,62,,41,30,71
086 Sarntal,63,,34,42,76
086 Sarntal,64,,42,33,75
086 Sarntal,65,,36,32,68
086 Sarntal,66,,50,28,78
086 Sarntal,67,,30,40,70
086 Sarntal,68,,32,29,61
086 Sarntal,69,,33,37,70
086 Sarntal,70,,30,28,58
086 Sarntal,71,,30,27,57
086 Sarntal,72,,36,37,73
086 Sarntal,73,,32,35,67
086 Sarntal,74,,30,28,58
086 Sarntal,75,,25,41,66
086 Sarntal,76,,33,27,60
086 Sarntal,77,,26,28,54
086 Sarntal,78,,17,33,50
086 Sarntal,79,,12,20,32
086 Sarntal,80,,16,19,35
086 Sarntal,81,,13,16,29
086 Sarntal,82,,12,12,24
086 Sarntal,83,,16,20,36
086 Sarntal,84,,8,20,28
086 Sarntal,85,,9,13,22
086 Sarntal,86,,12,23,35
086 Sarntal,87,,9,14,23
086 Sarntal,88,,9,25,34
086 Sarntal,89,,4,6,10
086 Sarntal,90,,5,10,15
086 Sarntal,91,,-,9,9
086 Sarntal,92,,-,6,6
086 Sarntal,93,,-,11,11
086 Sarntal,94,,1,4,5
086 Sarntal,95,,-,4,4
086 Sarntal,96,,1,3,4
086 Sarntal,98,,-,1,1
086 Sarntal,102,,-,1,1
086 Sarntal,Insgesamt,,3.584,3.452,7.036
087 Schenna,0,,17,21,38
087 Schenna,1,,18,13,31
087 Schenna,2,,10,16,26
087 Schenna,3,,17,15,32
087 Schenna,4,,13,18,31
087 Schenna,5,,10,21,31
087 Schenna,6,,12,16,28
087 Schenna,7,,12,18,30
087 Schenna,8,,17,14,31
087 Schenna,9,,19,26,45
087 Schenna,10,,11,8,19
087 Schenna,11,,18,15,33
087 Schenna,12,,14,17,31
087 Schenna,13,,16,19,35
087 Schenna,14,,18,14,32
087 Schenna,15,,19,21,40
087 Schenna,16,,25,18,43
087 Schenna,17,,21,10,31
087 Schenna,18,,13,19,32
087 Schenna,19,,17,19,36
087 Schenna,20,,22,15,37
087 Schenna,21,,20,18,38
087 Schenna,22,,13,5,18
087 Schenna,23,,17,15,32
087 Schenna,24,,11,17,28
087 Schenna,25,,14,17,31
087 Schenna,26,,25,13,38
087 Schenna,27,,20,22,42
087 Schenna,28,,21,11,32
087 Schenna,29,,16,16,32
087 Schenna,30,,14,19,33
087 Schenna,31,,16,16,32
087 Schenna,32,,18,13,31
087 Schenna,33,,13,21,34
087 Schenna,34,,20,16,36
087 Schenna,35,,24,30,54
087 Schenna,36,,28,18,46
087 Schenna,37,,14,20,34
087 Schenna,38,,22,25,47
087 Schenna,39,,20,15,35
087 Schenna,40,,16,32,48
087 Schenna,41,,26,20,46
087 Schenna,42,,25,19,44
087 Schenna,43,,26,15,41
087 Schenna,44,,26,26,52
087 Schenna,45,,23,22,45
087 Schenna,46,,28,21,49
087 Schenna,47,,25,22,47
087 Schenna,48,,28,17,45
087 Schenna,49,,19,18,37
087 Schenna,50,,29,30,59
087 Schenna,51,,19,26,45
087 Schenna,52,,21,20,41
087 Schenna,53,,22,11,33
087 Schenna,54,,31,22,53
087 Schenna,55,,31,26,57
087 Schenna,56,,14,12,26
087 Schenna,57,,21,19,40
087 Schenna,58,,13,19,32
087 Schenna,59,,17,17,34
087 Schenna,60,,9,17,26
087 Schenna,61,,17,17,34
087 Schenna,62,,12,16,28
087 Schenna,63,,10,15,25
087 Schenna,64,,14,12,26
087 Schenna,65,,18,14,32
087 Schenna,66,,17,19,36
087 Schenna,67,,13,16,29
087 Schenna,68,,17,18,35
087 Schenna,69,,14,18,32
087 Schenna,70,,12,14,26
087 Schenna,71,,15,9,24
087 Schenna,72,,18,12,30
087 Schenna,73,,7,18,25
087 Schenna,74,,12,11,23
087 Schenna,75,,11,10,21
087 Schenna,76,,8,11,19
087 Schenna,77,,16,16,32
087 Schenna,78,,5,11,16
087 Schenna,79,,7,12,19
087 Schenna,80,,10,7,17
087 Schenna,81,,10,11,21
087 Schenna,82,,6,7,13
087 Schenna,83,,4,8,12
087 Schenna,84,,6,7,13
087 Schenna,85,,7,4,11
087 Schenna,86,,1,10,11
087 Schenna,87,,4,4,8
087 Schenna,88,,2,8,10
087 Schenna,89,,4,5,9
087 Schenna,90,,-,8,8
087 Schenna,91,,4,3,7
087 Schenna,92,,1,1,2
087 Schenna,93,,1,2,3
087 Schenna,94,,1,2,3
087 Schenna,96,,-,1,1
087 Schenna,102,,-,2,2
087 Schenna,Insgesamt,,1.458,1.470,2.928
088 Mühlwald,0,,9,5,14
088 Mühlwald,1,,9,3,12
088 Mühlwald,2,,8,12,20
088 Mühlwald,3,,10,5,15
088 Mühlwald,4,,4,10,14
088 Mühlwald,5,,6,7,13
088 Mühlwald,6,,4,7,11
088 Mühlwald,7,,9,7,16
088 Mühlwald,8,,8,9,17
088 Mühlwald,9,,5,13,18
088 Mühlwald,10,,8,4,12
088 Mühlwald,11,,10,8,18
088 Mühlwald,12,,14,10,24
088 Mühlwald,13,,10,11,21
088 Mühlwald,14,,11,13,24
088 Mühlwald,15,,9,10,19
088 Mühlwald,16,,14,11,25
088 Mühlwald,17,,13,15,28
088 Mühlwald,18,,10,8,18
088 Mühlwald,19,,15,13,28
088 Mühlwald,20,,12,4,16
088 Mühlwald,21,,7,5,12
088 Mühlwald,22,,14,12,26
088 Mühlwald,23,,5,6,11
088 Mühlwald,24,,10,9,19
088 Mühlwald,25,,10,6,16
088 Mühlwald,26,,13,6,19
088 Mühlwald,27,,7,5,12
088 Mühlwald,28,,9,8,17
088 Mühlwald,29,,6,3,9
088 Mühlwald,30,,9,10,19
088 Mühlwald,31,,8,13,21
088 Mühlwald,32,,9,6,15
088 Mühlwald,33,,3,9,12
088 Mühlwald,34,,13,8,21
088 Mühlwald,35,,17,5,22
088 Mühlwald,36,,7,13,20
088 Mühlwald,37,,13,5,18
088 Mühlwald,38,,7,6,13
088 Mühlwald,39,,12,10,22
088 Mühlwald,40,,11,6,17
088 Mühlwald,41,,9,6,15
088 Mühlwald,42,,14,12,26
088 Mühlwald,43,,7,9,16
088 Mühlwald,44,,19,15,34
088 Mühlwald,45,,7,10,17
088 Mühlwald,46,,13,14,27
088 Mühlwald,47,,15,9,24
088 Mühlwald,48,,17,15,32
088 Mühlwald,49,,12,7,19
088 Mühlwald,50,,16,12,28
088 Mühlwald,51,,16,11,27
088 Mühlwald,52,,9,11,20
088 Mühlwald,53,,7,11,18
088 Mühlwald,54,,6,11,17
088 Mühlwald,55,,13,9,22
088 Mühlwald,56,,13,5,18
088 Mühlwald,57,,10,5,15
088 Mühlwald,58,,13,13,26
088 Mühlwald,59,,8,7,15
088 Mühlwald,60,,7,7,14
088 Mühlwald,61,,9,4,13
088 Mühlwald,62,,8,9,17
088 Mühlwald,63,,9,7,16
088 Mühlwald,64,,10,4,14
088 Mühlwald,65,,4,9,13
088 Mühlwald,66,,7,2,9
088 Mühlwald,67,,12,4,16
088 Mühlwald,68,,9,7,16
088 Mühlwald,69,,6,3,9
088 Mühlwald,70,,4,4,8
088 Mühlwald,71,,7,4,11
088 Mühlwald,72,,7,2,9
088 Mühlwald,73,,6,7,13
088 Mühlwald,74,,4,7,11
088 Mühlwald,75,,4,9,13
088 Mühlwald,76,,4,11,15
088 Mühlwald,77,,7,4,11
088 Mühlwald,78,,6,2,8
088 Mühlwald,79,,3,3,6
088 Mühlwald,80,,3,3,6
088 Mühlwald,81,,3,5,8
088 Mühlwald,82,,2,9,11
088 Mühlwald,83,,1,2,3
088 Mühlwald,84,,1,3,4
088 Mühlwald,85,,1,3,4
088 Mühlwald,86,,3,4,7
088 Mühlwald,87,,2,3,5
088 Mühlwald,88,,2,1,3
088 Mühlwald,89,,-,3,3
088 Mühlwald,90,,1,1,2
088 Mühlwald,92,,-,2,2
088 Mühlwald,93,,-,1,1
088 Mühlwald,94,,-,1,1
088 Mühlwald,Insgesamt,,764,678,1.442
089 Wolkenstein in Gröden,0,,9,15,24
089 Wolkenstein in Gröden,1,,10,11,21
089 Wolkenstein in Gröden,2,,18,8,26
089 Wolkenstein in Gröden,3,,10,8,18
089 Wolkenstein in Gröden,4,,12,16,28
089 Wolkenstein in Gröden,5,,16,10,26
089 Wolkenstein in Gröden,6,,10,8,18
089 Wolkenstein in Gröden,7,,16,13,29
089 Wolkenstein in Gröden,8,,17,11,28
089 Wolkenstein in Gröden,9,,10,15,25
089 Wolkenstein in Gröden,10,,15,19,34
089 Wolkenstein in Gröden,11,,11,8,19
089 Wolkenstein in Gröden,12,,16,19,35
089 Wolkenstein in Gröden,13,,23,18,41
089 Wolkenstein in Gröden,14,,19,18,37
089 Wolkenstein in Gröden,15,,17,23,40
089 Wolkenstein in Gröden,16,,11,18,29
089 Wolkenstein in Gröden,17,,16,22,38
089 Wolkenstein in Gröden,18,,20,29,49
089 Wolkenstein in Gröden,19,,15,12,27
089 Wolkenstein in Gröden,20,,15,12,27
089 Wolkenstein in Gröden,21,,13,18,31
089 Wolkenstein in Gröden,22,,14,15,29
089 Wolkenstein in Gröden,23,,23,13,36
089 Wolkenstein in Gröden,24,,18,17,35
089 Wolkenstein in Gröden,25,,13,11,24
089 Wolkenstein in Gröden,26,,14,16,30
089 Wolkenstein in Gröden,27,,17,12,29
089 Wolkenstein in Gröden,28,,12,17,29
089 Wolkenstein in Gröden,29,,15,13,28
089 Wolkenstein in Gröden,30,,18,13,31
089 Wolkenstein in Gröden,31,,13,9,22
089 Wolkenstein in Gröden,32,,15,6,21
089 Wolkenstein in Gröden,33,,12,17,29
089 Wolkenstein in Gröden,34,,14,9,23
089 Wolkenstein in Gröden,35,,18,19,37
089 Wolkenstein in Gröden,36,,10,19,29
089 Wolkenstein in Gröden,37,,10,10,20
089 Wolkenstein in Gröden,38,,13,12,25
089 Wolkenstein in Gröden,39,,16,9,25
089 Wolkenstein in Gröden,40,,19,25,44
089 Wolkenstein in Gröden,41,,10,17,27
089 Wolkenstein in Gröden,42,,24,24,48
089 Wolkenstein in Gröden,43,,17,24,41
089 Wolkenstein in Gröden,44,,22,23,45
089 Wolkenstein in Gröden,45,,25,22,47
089 Wolkenstein in Gröden,46,,26,22,48
089 Wolkenstein in Gröden,47,,24,24,48
089 Wolkenstein in Gröden,48,,32,26,58
089 Wolkenstein in Gröden,49,,27,26,53
089 Wolkenstein in Gröden,50,,20,33,53
089 Wolkenstein in Gröden,51,,29,22,51
089 Wolkenstein in Gröden,52,,23,19,42
089 Wolkenstein in Gröden,53,,19,20,39
089 Wolkenstein in Gröden,54,,25,21,46
089 Wolkenstein in Gröden,55,,26,22,48
089 Wolkenstein in Gröden,56,,14,15,29
089 Wolkenstein in Gröden,57,,17,15,32
089 Wolkenstein in Gröden,58,,20,16,36
089 Wolkenstein in Gröden,59,,10,14,24
089 Wolkenstein in Gröden,60,,10,9,19
089 Wolkenstein in Gröden,61,,14,11,25
089 Wolkenstein in Gröden,62,,8,13,21
089 Wolkenstein in Gröden,63,,9,6,15
089 Wolkenstein in Gröden,64,,11,11,22
089 Wolkenstein in Gröden,65,,6,17,23
089 Wolkenstein in Gröden,66,,15,10,25
089 Wolkenstein in Gröden,67,,12,13,25
089 Wolkenstein in Gröden,68,,9,14,23
089 Wolkenstein in Gröden,69,,17,20,37
089 Wolkenstein in Gröden,70,,5,14,19
089 Wolkenstein in Gröden,71,,9,8,17
089 Wolkenstein in Gröden,72,,17,13,30
089 Wolkenstein in Gröden,73,,10,11,21
089 Wolkenstein in Gröden,74,,13,11,24
089 Wolkenstein in Gröden,75,,14,16,30
089 Wolkenstein in Gröden,76,,16,11,27
089 Wolkenstein in Gröden,77,,15,8,23
089 Wolkenstein in Gröden,78,,9,16,25
089 Wolkenstein in Gröden,79,,9,12,21
089 Wolkenstein in Gröden,80,,13,6,19
089 Wolkenstein in Gröden,81,,10,10,20
089 Wolkenstein in Gröden,82,,4,8,12
089 Wolkenstein in Gröden,83,,4,9,13
089 Wolkenstein in Gröden,84,,6,6,12
089 Wolkenstein in Gröden,85,,6,6,12
089 Wolkenstein in Gröden,86,,3,4,7
089 Wolkenstein in Gröden,87,,3,7,10
089 Wolkenstein in Gröden,88,,4,4,8
089 Wolkenstein in Gröden,89,,3,3,6
089 Wolkenstein in Gröden,90,,2,6,8
089 Wolkenstein in Gröden,91,,1,3,4
089 Wolkenstein in Gröden,92,,-,2,2
089 Wolkenstein in Gröden,93,,2,3,5
089 Wolkenstein in Gröden,94,,1,1,2
089 Wolkenstein in Gröden,95,,1,1,2
089 Wolkenstein in Gröden,Insgesamt,,1.304,1.321,2.625
091 Schnals,0,,4,5,9
091 Schnals,1,,9,7,16
091 Schnals,2,,8,2,10
091 Schnals,3,,8,3,11
091 Schnals,4,,5,4,9
091 Schnals,5,,3,6,9
091 Schnals,6,,7,8,15
091 Schnals,7,,10,5,15
091 Schnals,8,,4,4,8
091 Schnals,9,,4,4,8
091 Schnals,10,,3,5,8
091 Schnals,11,,6,5,11
091 Schnals,12,,2,8,10
091 Schnals,13,,12,2,14
091 Schnals,14,,3,4,7
091 Schnals,15,,5,5,10
091 Schnals,16,,5,8,13
091 Schnals,17,,7,14,21
091 Schnals,18,,11,11,22
091 Schnals,19,,5,10,15
091 Schnals,20,,5,7,12
091 Schnals,21,,4,8,12
091 Schnals,22,,9,6,15
091 Schnals,23,,10,9,19
091 Schnals,24,,10,7,17
091 Schnals,25,,3,5,8
091 Schnals,26,,18,8,26
091 Schnals,27,,9,4,13
091 Schnals,28,,9,8,17
091 Schnals,29,,6,6,12
091 Schnals,30,,4,6,10
091 Schnals,31,,13,11,24
091 Schnals,32,,6,5,11
091 Schnals,33,,6,6,12
091 Schnals,34,,14,10,24
091 Schnals,35,,10,8,18
091 Schnals,36,,5,9,14
091 Schnals,37,,9,8,17
091 Schnals,38,,6,10,16
091 Schnals,39,,9,1,10
091 Schnals,40,,7,6,13
091 Schnals,41,,14,7,21
091 Schnals,42,,8,9,17
091 Schnals,43,,8,9,17
091 Schnals,44,,9,7,16
091 Schnals,45,,9,7,16
091 Schnals,46,,10,7,17
091 Schnals,47,,11,8,19
091 Schnals,48,,13,11,24
091 Schnals,49,,14,13,27
091 Schnals,50,,14,7,21
091 Schnals,51,,6,10,16
091 Schnals,52,,9,16,25
091 Schnals,53,,12,10,22
091 Schnals,54,,9,13,22
091 Schnals,55,,12,6,18
091 Schnals,56,,14,12,26
091 Schnals,57,,11,11,22
091 Schnals,58,,11,5,16
091 Schnals,59,,11,4,15
091 Schnals,60,,9,6,15
091 Schnals,61,,9,10,19
091 Schnals,62,,13,8,21
091 Schnals,63,,13,7,20
091 Schnals,64,,11,8,19
091 Schnals,65,,8,7,15
091 Schnals,66,,10,9,19
091 Schnals,67,,3,2,5
091 Schnals,68,,8,7,15
091 Schnals,69,,6,5,11
091 Schnals,70,,6,3,9
091 Schnals,71,,3,7,10
091 Schnals,72,,5,8,13
091 Schnals,73,,4,4,8
091 Schnals,74,,3,4,7
091 Schnals,75,,7,7,14
091 Schnals,76,,5,7,12
091 Schnals,77,,1,11,12
091 Schnals,78,,5,4,9
091 Schnals,79,,4,3,7
091 Schnals,80,,1,4,5
091 Schnals,81,,2,3,5
091 Schnals,82,,3,2,5
091 Schnals,83,,2,7,9
091 Schnals,84,,2,4,6
091 Schnals,85,,-,3,3
091 Schnals,86,,3,6,9
091 Schnals,87,,1,3,4
091 Schnals,88,,1,1,2
091 Schnals,89,,4,2,6
091 Schnals,90,,1,2,3
091 Schnals,91,,-,2,2
091 Schnals,92,,-,1,1
091 Schnals,93,,1,2,3
091 Schnals,94,,-,2,2
091 Schnals,97,,1,1,2
091 Schnals,100,,-,1,1
091 Schnals,Insgesamt,,653,613,1.266
092 Sexten,0,,4,9,13
092 Sexten,1,,7,3,10
092 Sexten,2,,11,7,18
092 Sexten,3,,10,7,17
092 Sexten,4,,11,3,14
092 Sexten,5,,9,6,15
092 Sexten,6,,11,6,17
092 Sexten,7,,6,8,14
092 Sexten,8,,8,16,24
092 Sexten,9,,5,7,12
092 Sexten,10,,11,8,19
092 Sexten,11,,13,5,18
092 Sexten,12,,10,9,19
092 Sexten,13,,17,17,34
092 Sexten,14,,16,11,27
092 Sexten,15,,8,17,25
092 Sexten,16,,8,14,22
092 Sexten,17,,13,6,19
092 Sexten,18,,12,10,22
092 Sexten,19,,14,12,26
092 Sexten,20,,15,13,28
092 Sexten,21,,15,10,25
092 Sexten,22,,8,5,13
092 Sexten,23,,13,11,24
092 Sexten,24,,10,13,23
092 Sexten,25,,11,16,27
092 Sexten,26,,12,11,23
092 Sexten,27,,10,6,16
092 Sexten,28,,9,9,18
092 Sexten,29,,8,9,17
092 Sexten,30,,10,10,20
092 Sexten,31,,7,7,14
092 Sexten,32,,12,6,18
092 Sexten,33,,10,9,19
092 Sexten,34,,14,13,27
092 Sexten,35,,14,8,22
092 Sexten,36,,14,22,36
092 Sexten,37,,13,11,24
092 Sexten,38,,7,4,11
092 Sexten,39,,17,15,32
092 Sexten,40,,7,12,19
092 Sexten,41,,11,6,17
092 Sexten,42,,9,11,20
092 Sexten,43,,13,18,31
092 Sexten,44,,16,14,30
092 Sexten,45,,12,19,31
092 Sexten,46,,20,16,36
092 Sexten,47,,16,16,32
092 Sexten,48,,23,20,43
092 Sexten,49,,15,19,34
092 Sexten,50,,18,18,36
092 Sexten,51,,19,16,35
092 Sexten,52,,27,19,46
092 Sexten,53,,14,16,30
092 Sexten,54,,18,12,30
092 Sexten,55,,20,8,28
092 Sexten,56,,15,14,29
092 Sexten,57,,22,13,35
092 Sexten,58,,17,12,29
092 Sexten,59,,12,14,26
092 Sexten,60,,10,11,21
092 Sexten,61,,11,13,24
092 Sexten,62,,2,10,12
092 Sexten,63,,6,12,18
092 Sexten,64,,7,9,16
092 Sexten,65,,10,7,17
092 Sexten,66,,5,5,10
092 Sexten,67,,11,7,18
092 Sexten,68,,9,3,12
092 Sexten,69,,4,8,12
092 Sexten,70,,6,4,10
092 Sexten,71,,5,11,16
092 Sexten,72,,8,4,12
092 Sexten,73,,5,4,9
092 Sexten,74,,6,16,22
092 Sexten,75,,7,12,19
092 Sexten,76,,5,10,15
092 Sexten,77,,12,10,22
092 Sexten,78,,6,5,11
092 Sexten,79,,6,8,14
092 Sexten,80,,7,12,19
092 Sexten,81,,7,5,12
092 Sexten,82,,2,9,11
092 Sexten,83,,3,7,10
092 Sexten,84,,4,11,15
092 Sexten,85,,4,9,13
092 Sexten,86,,3,8,11
092 Sexten,87,,4,6,10
092 Sexten,88,,3,9,12
092 Sexten,89,,3,3,6
092 Sexten,90,,1,5,6
092 Sexten,91,,2,3,5
092 Sexten,92,,1,4,5
092 Sexten,93,,-,4,4
092 Sexten,94,,-,3,3
092 Sexten,95,,-,1,1
092 Sexten,96,,-,1,1
092 Sexten,Insgesamt,,942,951,1.893
093 Schlanders,0,,29,43,72
093 Schlanders,1,,27,34,61
093 Schlanders,2,,29,25,54
093 Schlanders,3,,34,38,72
093 Schlanders,4,,26,23,49
093 Schlanders,5,,30,31,61
093 Schlanders,6,,24,36,60
093 Schlanders,7,,34,24,58
093 Schlanders,8,,30,30,60
093 Schlanders,9,,27,25,52
093 Schlanders,10,,30,34,64
093 Schlanders,11,,27,33,60
093 Schlanders,12,,29,24,53
093 Schlanders,13,,26,35,61
093 Schlanders,14,,32,32,64
093 Schlanders,15,,39,36,75
093 Schlanders,16,,28,39,67
093 Schlanders,17,,41,38,79
093 Schlanders,18,,55,49,104
093 Schlanders,19,,42,35,77
093 Schlanders,20,,39,28,67
093 Schlanders,21,,42,42,84
093 Schlanders,22,,46,44,90
093 Schlanders,23,,33,44,77
093 Schlanders,24,,40,27,67
093 Schlanders,25,,53,42,95
093 Schlanders,26,,38,36,74
093 Schlanders,27,,33,37,70
093 Schlanders,28,,40,35,75
093 Schlanders,29,,39,37,76
093 Schlanders,30,,39,35,74
093 Schlanders,31,,40,37,77
093 Schlanders,32,,35,42,77
093 Schlanders,33,,44,41,85
093 Schlanders,34,,46,38,84
093 Schlanders,35,,35,38,73
093 Schlanders,36,,28,31,59
093 Schlanders,37,,43,32,75
093 Schlanders,38,,33,46,79
093 Schlanders,39,,36,22,58
093 Schlanders,40,,47,39,86
093 Schlanders,41,,47,39,86
093 Schlanders,42,,35,53,88
093 Schlanders,43,,52,38,90
093 Schlanders,44,,47,50,97
093 Schlanders,45,,45,47,92
093 Schlanders,46,,62,45,107
093 Schlanders,47,,47,40,87
093 Schlanders,48,,43,55,98
093 Schlanders,49,,45,58,103
093 Schlanders,50,,53,48,101
093 Schlanders,51,,38,45,83
093 Schlanders,52,,52,57,109
093 Schlanders,53,,48,46,94
093 Schlanders,54,,37,56,93
093 Schlanders,55,,42,41,83
093 Schlanders,56,,35,42,77
093 Schlanders,57,,48,52,100
093 Schlanders,58,,41,37,78
093 Schlanders,59,,27,34,61
093 Schlanders,60,,26,35,61
093 Schlanders,61,,31,31,62
093 Schlanders,62,,34,39,73
093 Schlanders,63,,31,21,52
093 Schlanders,64,,27,30,57
093 Schlanders,65,,22,34,56
093 Schlanders,66,,27,36,63
093 Schlanders,67,,36,25,61
093 Schlanders,68,,22,23,45
093 Schlanders,69,,24,21,45
093 Schlanders,70,,31,17,48
093 Schlanders,71,,24,33,57
093 Schlanders,72,,27,34,61
093 Schlanders,73,,27,33,60
093 Schlanders,74,,28,36,64
093 Schlanders,75,,23,25,48
093 Schlanders,76,,27,30,57
093 Schlanders,77,,13,16,29
093 Schlanders,78,,23,22,45
093 Schlanders,79,,13,24,37
093 Schlanders,80,,14,21,35
093 Schlanders,81,,10,20,30
093 Schlanders,82,,15,25,40
093 Schlanders,83,,12,13,25
093 Schlanders,84,,12,11,23
093 Schlanders,85,,9,18,27
093 Schlanders,86,,8,13,21
093 Schlanders,87,,7,15,22
093 Schlanders,88,,5,14,19
093 Schlanders,89,,2,15,17
093 Schlanders,90,,7,9,16
093 Schlanders,91,,2,4,6
093 Schlanders,92,,3,3,6
093 Schlanders,93,,1,3,4
093 Schlanders,94,,-,5,5
093 Schlanders,95,,-,2,2
093 Schlanders,96,,1,1,2
093 Schlanders,99,,-,1,1
093 Schlanders,105,,-,1,1
093 Schlanders,106,,-,1,1
093 Schlanders,Insgesamt,,2.936,3.080,6.016
094 Schluderns,0,,5,10,15
094 Schluderns,1,,10,12,22
094 Schluderns,2,,15,5,20
094 Schluderns,3,,8,10,18
094 Schluderns,4,,13,9,22
094 Schluderns,5,,8,5,13
094 Schluderns,6,,12,6,18
094 Schluderns,7,,7,2,9
094 Schluderns,8,,10,13,23
094 Schluderns,9,,8,8,16
094 Schluderns,10,,6,6,12
094 Schluderns,11,,6,11,17
094 Schluderns,12,,14,9,23
094 Schluderns,13,,15,8,23
094 Schluderns,14,,11,7,18
094 Schluderns,15,,18,9,27
094 Schluderns,16,,7,14,21
094 Schluderns,17,,5,11,16
094 Schluderns,18,,12,10,22
094 Schluderns,19,,11,14,25
094 Schluderns,20,,9,12,21
094 Schluderns,21,,13,21,34
094 Schluderns,22,,17,5,22
094 Schluderns,23,,8,9,17
094 Schluderns,24,,9,13,22
094 Schluderns,25,,19,9,28
094 Schluderns,26,,12,11,23
094 Schluderns,27,,10,11,21
094 Schluderns,28,,9,8,17
094 Schluderns,29,,7,14,21
094 Schluderns,30,,16,12,28
094 Schluderns,31,,10,10,20
094 Schluderns,32,,9,10,19
094 Schluderns,33,,12,14,26
094 Schluderns,34,,17,14,31
094 Schluderns,35,,10,14,24
094 Schluderns,36,,2,13,15
094 Schluderns,37,,11,11,22
094 Schluderns,38,,7,12,19
094 Schluderns,39,,13,17,30
094 Schluderns,40,,17,7,24
094 Schluderns,41,,20,14,34
094 Schluderns,42,,17,11,28
094 Schluderns,43,,15,11,26
094 Schluderns,44,,10,12,22
094 Schluderns,45,,9,11,20
094 Schluderns,46,,15,10,25
094 Schluderns,47,,17,16,33
094 Schluderns,48,,12,13,25
094 Schluderns,49,,15,15,30
094 Schluderns,50,,25,9,34
094 Schluderns,51,,26,13,39
094 Schluderns,52,,13,18,31
094 Schluderns,53,,11,18,29
094 Schluderns,54,,12,18,30
094 Schluderns,55,,7,6,13
094 Schluderns,56,,12,16,28
094 Schluderns,57,,9,16,25
094 Schluderns,58,,17,7,24
094 Schluderns,59,,10,16,26
094 Schluderns,60,,15,11,26
094 Schluderns,61,,13,8,21
094 Schluderns,62,,14,7,21
094 Schluderns,63,,6,5,11
094 Schluderns,64,,11,3,14
094 Schluderns,65,,8,13,21
094 Schluderns,66,,11,9,20
094 Schluderns,67,,8,8,16
094 Schluderns,68,,6,7,13
094 Schluderns,69,,5,9,14
094 Schluderns,70,,5,4,9
094 Schluderns,71,,5,12,17
094 Schluderns,72,,2,6,8
094 Schluderns,73,,8,7,15
094 Schluderns,74,,11,14,25
094 Schluderns,75,,5,5,10
094 Schluderns,76,,9,8,17
094 Schluderns,77,,7,7,14
094 Schluderns,78,,5,10,15
094 Schluderns,79,,2,7,9
094 Schluderns,80,,4,9,13
094 Schluderns,81,,7,10,17
094 Schluderns,82,,6,8,14
094 Schluderns,83,,5,7,12
094 Schluderns,84,,2,4,6
094 Schluderns,85,,4,6,10
094 Schluderns,86,,2,4,6
094 Schluderns,87,,1,3,4
094 Schluderns,88,,1,-,1
094 Schluderns,89,,1,8,9
094 Schluderns,90,,1,1,2
094 Schluderns,92,,-,1,1
094 Schluderns,93,,-,1,1
094 Schluderns,94,,-,3,3
094 Schluderns,95,,-,1,1
094 Schluderns,96,,-,1,1
094 Schluderns,98,,-,1,1
094 Schluderns,Insgesamt,,900,904,1.804
095 Stilfs,0,,8,6,14
095 Stilfs,1,,7,7,14
095 Stilfs,2,,6,1,7
095 Stilfs,3,,9,5,14
095 Stilfs,4,,4,3,7
095 Stilfs,5,,2,4,6
095 Stilfs,6,,4,3,7
095 Stilfs,7,,4,4,8
095 Stilfs,8,,4,6,10
095 Stilfs,9,,5,1,6
095 Stilfs,10,,6,5,11
095 Stilfs,11,,5,5,10
095 Stilfs,12,,5,6,11
095 Stilfs,13,,6,2,8
095 Stilfs,14,,4,11,15
095 Stilfs,15,,9,4,13
095 Stilfs,16,,2,6,8
095 Stilfs,17,,8,3,11
095 Stilfs,18,,10,10,20
095 Stilfs,19,,11,1,12
095 Stilfs,20,,5,5,10
095 Stilfs,21,,9,7,16
095 Stilfs,22,,5,14,19
095 Stilfs,23,,4,8,12
095 Stilfs,24,,12,4,16
095 Stilfs,25,,17,9,26
095 Stilfs,26,,7,8,15
095 Stilfs,27,,7,1,8
095 Stilfs,28,,5,5,10
095 Stilfs,29,,10,6,16
095 Stilfs,30,,11,5,16
095 Stilfs,31,,10,7,17
095 Stilfs,32,,10,2,12
095 Stilfs,33,,11,6,17
095 Stilfs,34,,10,7,17
095 Stilfs,35,,4,4,8
095 Stilfs,36,,5,6,11
095 Stilfs,37,,7,8,15
095 Stilfs,38,,6,4,10
095 Stilfs,39,,9,5,14
095 Stilfs,40,,6,7,13
095 Stilfs,41,,6,5,11
095 Stilfs,42,,10,14,24
095 Stilfs,43,,9,8,17
095 Stilfs,44,,11,10,21
095 Stilfs,45,,9,12,21
095 Stilfs,46,,8,11,19
095 Stilfs,47,,7,8,15
095 Stilfs,48,,5,7,12
095 Stilfs,49,,20,8,28
095 Stilfs,50,,12,9,21
095 Stilfs,51,,13,7,20
095 Stilfs,52,,10,6,16
095 Stilfs,53,,7,12,19
095 Stilfs,54,,7,3,10
095 Stilfs,55,,9,7,16
095 Stilfs,56,,9,9,18
095 Stilfs,57,,8,13,21
095 Stilfs,58,,11,6,17
095 Stilfs,59,,5,8,13
095 Stilfs,60,,4,4,8
095 Stilfs,61,,16,8,24
095 Stilfs,62,,8,4,12
095 Stilfs,63,,10,5,15
095 Stilfs,64,,14,8,22
095 Stilfs,65,,1,6,7
095 Stilfs,66,,5,3,8
095 Stilfs,67,,7,9,16
095 Stilfs,68,,6,4,10
095 Stilfs,69,,9,9,18
095 Stilfs,70,,2,4,6
095 Stilfs,71,,12,8,20
095 Stilfs,72,,7,6,13
095 Stilfs,73,,2,12,14
095 Stilfs,74,,6,4,10
095 Stilfs,75,,4,6,10
095 Stilfs,76,,3,6,9
095 Stilfs,77,,2,4,6
095 Stilfs,78,,5,5,10
095 Stilfs,79,,1,9,10
095 Stilfs,80,,1,5,6
095 Stilfs,81,,2,4,6
095 Stilfs,82,,3,6,9
095 Stilfs,83,,3,4,7
095 Stilfs,84,,2,2,4
095 Stilfs,85,,3,3,6
095 Stilfs,86,,2,-,2
095 Stilfs,87,,1,5,6
095 Stilfs,88,,1,2,3
095 Stilfs,89,,1,4,5
095 Stilfs,90,,2,1,3
095 Stilfs,91,,-,3,3
095 Stilfs,93,,-,2,2
095 Stilfs,94,,1,1,2
095 Stilfs,Insgesamt,,611,550,1.161
096 Terenten,0,,10,8,18
096 Terenten,1,,17,9,26
096 Terenten,2,,10,10,20
096 Terenten,3,,5,10,15
096 Terenten,4,,8,8,16
096 Terenten,5,,3,9,12
096 Terenten,6,,13,7,20
096 Terenten,7,,11,4,15
096 Terenten,8,,8,11,19
096 Terenten,9,,15,10,25
096 Terenten,10,,15,10,25
096 Terenten,11,,11,19,30
096 Terenten,12,,8,12,20
096 Terenten,13,,8,7,15
096 Terenten,14,,13,15,28
096 Terenten,15,,10,8,18
096 Terenten,16,,10,19,29
096 Terenten,17,,22,19,41
096 Terenten,18,,9,8,17
096 Terenten,19,,13,11,24
096 Terenten,20,,12,8,20
096 Terenten,21,,12,13,25
096 Terenten,22,,7,13,20
096 Terenten,23,,9,9,18
096 Terenten,24,,6,16,22
096 Terenten,25,,12,16,28
096 Terenten,26,,15,8,23
096 Terenten,27,,8,10,18
096 Terenten,28,,12,7,19
096 Terenten,29,,12,8,20
096 Terenten,30,,8,12,20
096 Terenten,31,,11,9,20
096 Terenten,32,,13,15,28
096 Terenten,33,,11,9,20
096 Terenten,34,,14,15,29
096 Terenten,35,,7,9,16
096 Terenten,36,,8,10,18
096 Terenten,37,,15,18,33
096 Terenten,38,,10,4,14
096 Terenten,39,,14,10,24
096 Terenten,40,,16,10,26
096 Terenten,41,,15,16,31
096 Terenten,42,,7,16,23
096 Terenten,43,,17,10,27
096 Terenten,44,,18,15,33
096 Terenten,45,,20,12,32
096 Terenten,46,,16,14,30
096 Terenten,47,,12,15,27
096 Terenten,48,,17,18,35
096 Terenten,49,,14,17,31
096 Terenten,50,,15,10,25
096 Terenten,51,,17,13,30
096 Terenten,52,,24,12,36
096 Terenten,53,,20,11,31
096 Terenten,54,,11,19,30
096 Terenten,55,,13,9,22
096 Terenten,56,,13,10,23
096 Terenten,57,,14,9,23
096 Terenten,58,,13,8,21
096 Terenten,59,,9,12,21
096 Terenten,60,,12,11,23
096 Terenten,61,,13,10,23
096 Terenten,62,,9,8,17
096 Terenten,63,,7,7,14
096 Terenten,64,,7,6,13
096 Terenten,65,,8,6,14
096 Terenten,66,,7,6,13
096 Terenten,67,,10,8,18
096 Terenten,68,,7,3,10
096 Terenten,69,,9,3,12
096 Terenten,70,,6,4,10
096 Terenten,71,,3,6,9
096 Terenten,72,,7,5,12
096 Terenten,73,,5,5,10
096 Terenten,74,,3,4,7
096 Terenten,75,,7,5,12
096 Terenten,76,,2,6,8
096 Terenten,77,,4,9,13
096 Terenten,78,,4,5,9
096 Terenten,79,,2,7,9
096 Terenten,80,,3,4,7
096 Terenten,81,,1,2,3
096 Terenten,82,,3,2,5
096 Terenten,83,,2,3,5
096 Terenten,84,,4,8,12
096 Terenten,85,,3,3,6
096 Terenten,86,,3,2,5
096 Terenten,87,,1,4,5
096 Terenten,88,,1,2,3
096 Terenten,89,,1,3,4
096 Terenten,90,,2,-,2
096 Terenten,91,,1,1,2
096 Terenten,94,,-,2,2
096 Terenten,Insgesamt,,893,849,1.742
097 Terlan,0,,23,18,41
097 Terlan,1,,25,19,44
097 Terlan,2,,22,28,50
097 Terlan,3,,36,19,55
097 Terlan,4,,35,34,69
097 Terlan,5,,17,16,33
097 Terlan,6,,35,28,63
097 Terlan,7,,33,24,57
097 Terlan,8,,21,23,44
097 Terlan,9,,20,29,49
097 Terlan,10,,17,26,43
097 Terlan,11,,29,22,51
097 Terlan,12,,22,24,46
097 Terlan,13,,24,17,41
097 Terlan,14,,21,27,48
097 Terlan,15,,32,25,57
097 Terlan,16,,32,18,50
097 Terlan,17,,23,22,45
097 Terlan,18,,37,30,67
097 Terlan,19,,16,28,44
097 Terlan,20,,25,27,52
097 Terlan,21,,23,18,41
097 Terlan,22,,29,20,49
097 Terlan,23,,22,30,52
097 Terlan,24,,29,16,45
097 Terlan,25,,17,25,42
097 Terlan,26,,21,29,50
097 Terlan,27,,26,20,46
097 Terlan,28,,28,24,52
097 Terlan,29,,19,27,46
097 Terlan,30,,26,25,51
097 Terlan,31,,23,12,35
097 Terlan,32,,24,16,40
097 Terlan,33,,23,30,53
097 Terlan,34,,21,20,41
097 Terlan,35,,38,36,74
097 Terlan,36,,23,28,51
097 Terlan,37,,20,35,55
097 Terlan,38,,50,26,76
097 Terlan,39,,38,36,74
097 Terlan,40,,38,40,78
097 Terlan,41,,31,48,79
097 Terlan,42,,33,38,71
097 Terlan,43,,44,31,75
097 Terlan,44,,33,29,62
097 Terlan,45,,43,48,91
097 Terlan,46,,36,37,73
097 Terlan,47,,38,33,71
097 Terlan,48,,34,39,73
097 Terlan,49,,43,33,76
097 Terlan,50,,31,29,60
097 Terlan,51,,37,28,65
097 Terlan,52,,30,29,59
097 Terlan,53,,28,37,65
097 Terlan,54,,39,28,67
097 Terlan,55,,29,36,65
097 Terlan,56,,18,26,44
097 Terlan,57,,35,24,59
097 Terlan,58,,24,29,53
097 Terlan,59,,30,32,62
097 Terlan,60,,23,24,47
097 Terlan,61,,27,20,47
097 Terlan,62,,12,23,35
097 Terlan,63,,17,24,41
097 Terlan,64,,21,17,38
097 Terlan,65,,23,21,44
097 Terlan,66,,17,15,32
097 Terlan,67,,17,24,41
097 Terlan,68,,15,20,35
097 Terlan,69,,11,24,35
097 Terlan,70,,21,21,42
097 Terlan,71,,23,21,44
097 Terlan,72,,13,26,39
097 Terlan,73,,30,21,51
097 Terlan,74,,21,23,44
097 Terlan,75,,17,16,33
097 Terlan,76,,15,16,31
097 Terlan,77,,18,15,33
097 Terlan,78,,11,14,25
097 Terlan,79,,6,11,17
097 Terlan,80,,12,20,32
097 Terlan,81,,7,18,25
097 Terlan,82,,9,12,21
097 Terlan,83,,9,10,19
097 Terlan,84,,16,9,25
097 Terlan,85,,7,11,18
097 Terlan,86,,8,10,18
097 Terlan,87,,7,8,15
097 Terlan,88,,3,9,12
097 Terlan,89,,3,9,12
097 Terlan,90,,2,5,7
097 Terlan,91,,-,9,9
097 Terlan,92,,2,12,14
097 Terlan,93,,2,4,6
097 Terlan,94,,2,5,7
097 Terlan,95,,-,2,2
097 Terlan,96,,-,2,2
097 Terlan,97,,-,2,2
097 Terlan,99,,-,2,2
097 Terlan,101,,-,1,1
097 Terlan,Insgesamt,,2.166,2.207,4.373
098 Tramin a.d. Weinstr.,0,,26,16,42
098 Tramin a.d. Weinstr.,1,,16,26,42
098 Tramin a.d. Weinstr.,2,,26,14,40
098 Tramin a.d. Weinstr.,3,,18,22,40
098 Tramin a.d. Weinstr.,4,,12,12,24
098 Tramin a.d. Weinstr.,5,,20,16,36
098 Tramin a.d. Weinstr.,6,,20,13,33
098 Tramin a.d. Weinstr.,7,,17,12,29
098 Tramin a.d. Weinstr.,8,,16,14,30
098 Tramin a.d. Weinstr.,9,,14,9,23
098 Tramin a.d. Weinstr.,10,,16,13,29
098 Tramin a.d. Weinstr.,11,,12,17,29
098 Tramin a.d. Weinstr.,12,,25,12,37
098 Tramin a.d. Weinstr.,13,,15,17,32
098 Tramin a.d. Weinstr.,14,,21,18,39
098 Tramin a.d. Weinstr.,15,,26,13,39
098 Tramin a.d. Weinstr.,16,,17,18,35
098 Tramin a.d. Weinstr.,17,,15,21,36
098 Tramin a.d. Weinstr.,18,,26,16,42
098 Tramin a.d. Weinstr.,19,,22,26,48
098 Tramin a.d. Weinstr.,20,,19,21,40
098 Tramin a.d. Weinstr.,21,,19,21,40
098 Tramin a.d. Weinstr.,22,,16,20,36
098 Tramin a.d. Weinstr.,23,,20,27,47
098 Tramin a.d. Weinstr.,24,,18,7,25
098 Tramin a.d. Weinstr.,25,,24,24,48
098 Tramin a.d. Weinstr.,26,,19,30,49
098 Tramin a.d. Weinstr.,27,,14,27,41
098 Tramin a.d. Weinstr.,28,,18,27,45
098 Tramin a.d. Weinstr.,29,,16,15,31
098 Tramin a.d. Weinstr.,30,,25,26,51
098 Tramin a.d. Weinstr.,31,,21,18,39
098 Tramin a.d. Weinstr.,32,,15,20,35
098 Tramin a.d. Weinstr.,33,,22,26,48
098 Tramin a.d. Weinstr.,34,,31,10,41
098 Tramin a.d. Weinstr.,35,,24,22,46
098 Tramin a.d. Weinstr.,36,,18,13,31
098 Tramin a.d. Weinstr.,37,,13,22,35
098 Tramin a.d. Weinstr.,38,,20,16,36
098 Tramin a.d. Weinstr.,39,,30,21,51
098 Tramin a.d. Weinstr.,40,,23,18,41
098 Tramin a.d. Weinstr.,41,,25,16,41
098 Tramin a.d. Weinstr.,42,,21,16,37
098 Tramin a.d. Weinstr.,43,,17,26,43
098 Tramin a.d. Weinstr.,44,,22,34,56
098 Tramin a.d. Weinstr.,45,,26,19,45
098 Tramin a.d. Weinstr.,46,,28,32,60
098 Tramin a.d. Weinstr.,47,,24,21,45
098 Tramin a.d. Weinstr.,48,,30,30,60
098 Tramin a.d. Weinstr.,49,,31,24,55
098 Tramin a.d. Weinstr.,50,,31,27,58
098 Tramin a.d. Weinstr.,51,,28,30,58
098 Tramin a.d. Weinstr.,52,,23,21,44
098 Tramin a.d. Weinstr.,53,,24,14,38
098 Tramin a.d. Weinstr.,54,,30,23,53
098 Tramin a.d. Weinstr.,55,,27,35,62
098 Tramin a.d. Weinstr.,56,,17,32,49
098 Tramin a.d. Weinstr.,57,,25,23,48
098 Tramin a.d. Weinstr.,58,,18,22,40
098 Tramin a.d. Weinstr.,59,,22,21,43
098 Tramin a.d. Weinstr.,60,,17,18,35
098 Tramin a.d. Weinstr.,61,,19,20,39
098 Tramin a.d. Weinstr.,62,,16,13,29
098 Tramin a.d. Weinstr.,63,,19,18,37
098 Tramin a.d. Weinstr.,64,,12,14,26
098 Tramin a.d. Weinstr.,65,,16,19,35
098 Tramin a.d. Weinstr.,66,,15,17,32
098 Tramin a.d. Weinstr.,67,,17,18,35
098 Tramin a.d. Weinstr.,68,,13,22,35
098 Tramin a.d. Weinstr.,69,,18,18,36
098 Tramin a.d. Weinstr.,70,,6,9,15
098 Tramin a.d. Weinstr.,71,,22,25,47
098 Tramin a.d. Weinstr.,72,,18,20,38
098 Tramin a.d. Weinstr.,73,,20,15,35
098 Tramin a.d. Weinstr.,74,,13,23,36
098 Tramin a.d. Weinstr.,75,,19,16,35
098 Tramin a.d. Weinstr.,76,,10,11,21
098 Tramin a.d. Weinstr.,77,,6,17,23
098 Tramin a.d. Weinstr.,78,,11,11,22
098 Tramin a.d. Weinstr.,79,,12,13,25
098 Tramin a.d. Weinstr.,80,,12,12,24
098 Tramin a.d. Weinstr.,81,,8,13,21
098 Tramin a.d. Weinstr.,82,,4,10,14
098 Tramin a.d. Weinstr.,83,,8,14,22
098 Tramin a.d. Weinstr.,84,,5,14,19
098 Tramin a.d. Weinstr.,85,,8,10,18
098 Tramin a.d. Weinstr.,86,,6,13,19
098 Tramin a.d. Weinstr.,87,,9,7,16
098 Tramin a.d. Weinstr.,88,,7,8,15
098 Tramin a.d. Weinstr.,89,,6,10,16
098 Tramin a.d. Weinstr.,90,,5,12,17
098 Tramin a.d. Weinstr.,91,,2,5,7
098 Tramin a.d. Weinstr.,92,,-,4,4
098 Tramin a.d. Weinstr.,93,,-,3,3
098 Tramin a.d. Weinstr.,94,,1,3,4
098 Tramin a.d. Weinstr.,95,,-,3,3
098 Tramin a.d. Weinstr.,96,,-,2,2
098 Tramin a.d. Weinstr.,Insgesamt,,1.654,1.702,3.356
099 Tisens,0,,6,6,12
099 Tisens,1,,9,8,17
099 Tisens,2,,5,10,15
099 Tisens,3,,7,12,19
099 Tisens,4,,6,8,14
099 Tisens,5,,7,9,16
099 Tisens,6,,5,2,7
099 Tisens,7,,14,8,22
099 Tisens,8,,12,9,21
099 Tisens,9,,9,7,16
099 Tisens,10,,11,17,28
099 Tisens,11,,12,14,26
099 Tisens,12,,8,12,20
099 Tisens,13,,13,9,22
099 Tisens,14,,10,18,28
099 Tisens,15,,11,10,21
099 Tisens,16,,10,8,18
099 Tisens,17,,14,13,27
099 Tisens,18,,7,7,14
099 Tisens,19,,13,7,20
099 Tisens,20,,15,7,22
099 Tisens,21,,14,10,24
099 Tisens,22,,8,10,18
099 Tisens,23,,6,15,21
099 Tisens,24,,17,8,25
099 Tisens,25,,17,15,32
099 Tisens,26,,12,9,21
099 Tisens,27,,13,14,27
099 Tisens,28,,14,5,19
099 Tisens,29,,14,9,23
099 Tisens,30,,6,9,15
099 Tisens,31,,10,10,20
099 Tisens,32,,18,6,24
099 Tisens,33,,16,12,28
099 Tisens,34,,12,16,28
099 Tisens,35,,10,12,22
099 Tisens,36,,12,11,23
099 Tisens,37,,11,18,29
099 Tisens,38,,14,11,25
099 Tisens,39,,10,7,17
099 Tisens,40,,14,9,23
099 Tisens,41,,14,11,25
099 Tisens,42,,9,13,22
099 Tisens,43,,11,13,24
099 Tisens,44,,16,13,29
099 Tisens,45,,16,18,34
099 Tisens,46,,16,17,33
099 Tisens,47,,19,19,38
099 Tisens,48,,23,21,44
099 Tisens,49,,23,10,33
099 Tisens,50,,17,28,45
099 Tisens,51,,17,10,27
099 Tisens,52,,19,14,33
099 Tisens,53,,21,7,28
099 Tisens,54,,14,11,25
099 Tisens,55,,16,7,23
099 Tisens,56,,13,13,26
099 Tisens,57,,12,13,25
099 Tisens,58,,15,19,34
099 Tisens,59,,10,13,23
099 Tisens,60,,17,12,29
099 Tisens,61,,6,8,14
099 Tisens,62,,12,10,22
099 Tisens,63,,6,11,17
099 Tisens,64,,13,10,23
099 Tisens,65,,9,5,14
099 Tisens,66,,5,6,11
099 Tisens,67,,14,7,21
099 Tisens,68,,9,9,18
099 Tisens,69,,7,7,14
099 Tisens,70,,3,6,9
099 Tisens,71,,9,12,21
099 Tisens,72,,12,8,20
099 Tisens,73,,8,10,18
099 Tisens,74,,6,10,16
099 Tisens,75,,3,7,10
099 Tisens,76,,8,9,17
099 Tisens,77,,5,12,17
099 Tisens,78,,4,4,8
099 Tisens,79,,7,6,13
099 Tisens,80,,4,11,15
099 Tisens,81,,5,5,10
099 Tisens,82,,2,10,12
099 Tisens,83,,4,10,14
099 Tisens,84,,4,6,10
099 Tisens,85,,2,15,17
099 Tisens,86,,3,3,6
099 Tisens,87,,1,9,10
099 Tisens,88,,3,5,8
099 Tisens,89,,2,7,9
099 Tisens,90,,2,7,9
099 Tisens,91,,1,2,3
099 Tisens,92,,1,4,5
099 Tisens,93,,2,1,3
099 Tisens,95,,1,1,2
099 Tisens,96,,1,-,1
099 Tisens,101,,-,1,1
099 Tisens,Insgesamt,,954,953,1.907
100 Tiers,0,,4,5,9
100 Tiers,1,,7,4,11
100 Tiers,2,,6,6,12
100 Tiers,3,,4,7,11
100 Tiers,4,,2,6,8
100 Tiers,5,,7,7,14
100 Tiers,6,,3,3,6
100 Tiers,7,,10,7,17
100 Tiers,8,,8,3,11
100 Tiers,9,,2,7,9
100 Tiers,10,,2,10,12
100 Tiers,11,,5,2,7
100 Tiers,12,,4,8,12
100 Tiers,13,,6,4,10
100 Tiers,14,,2,9,11
100 Tiers,15,,2,7,9
100 Tiers,16,,4,9,13
100 Tiers,17,,4,9,13
100 Tiers,18,,9,6,15
100 Tiers,19,,6,3,9
100 Tiers,20,,7,9,16
100 Tiers,21,,4,6,10
100 Tiers,22,,5,2,7
100 Tiers,23,,6,3,9
100 Tiers,24,,6,6,12
100 Tiers,25,,7,6,13
100 Tiers,26,,4,7,11
100 Tiers,27,,8,10,18
100 Tiers,28,,6,5,11
100 Tiers,29,,9,8,17
100 Tiers,30,,5,5,10
100 Tiers,31,,2,9,11
100 Tiers,32,,9,4,13
100 Tiers,33,,6,2,8
100 Tiers,34,,5,7,12
100 Tiers,35,,4,4,8
100 Tiers,36,,1,3,4
100 Tiers,37,,12,7,19
100 Tiers,38,,5,2,7
100 Tiers,39,,2,4,6
100 Tiers,40,,11,8,19
100 Tiers,41,,5,8,13
100 Tiers,42,,10,7,17
100 Tiers,43,,9,7,16
100 Tiers,44,,4,7,11
100 Tiers,45,,6,7,13
100 Tiers,46,,15,11,26
100 Tiers,47,,7,3,10
100 Tiers,48,,10,12,22
100 Tiers,49,,9,6,15
100 Tiers,50,,5,5,10
100 Tiers,51,,9,5,14
100 Tiers,52,,6,11,17
100 Tiers,53,,6,7,13
100 Tiers,54,,6,6,12
100 Tiers,55,,4,10,14
100 Tiers,56,,12,6,18
100 Tiers,57,,8,4,12
100 Tiers,58,,5,8,13
100 Tiers,59,,9,7,16
100 Tiers,60,,5,4,9
100 Tiers,61,,6,5,11
100 Tiers,62,,5,6,11
100 Tiers,63,,3,2,5
100 Tiers,64,,1,4,5
100 Tiers,65,,8,5,13
100 Tiers,66,,3,4,7
100 Tiers,67,,3,5,8
100 Tiers,68,,-,3,3
100 Tiers,69,,5,4,9
100 Tiers,70,,8,3,11
100 Tiers,71,,2,4,6
100 Tiers,72,,9,10,19
100 Tiers,73,,2,5,7
100 Tiers,74,,2,5,7
100 Tiers,75,,2,2,4
100 Tiers,76,,5,6,11
100 Tiers,77,,6,5,11
100 Tiers,78,,4,4,8
100 Tiers,79,,3,5,8
100 Tiers,80,,6,2,8
100 Tiers,81,,2,5,7
100 Tiers,82,,3,3,6
100 Tiers,83,,2,4,6
100 Tiers,84,,3,3,6
100 Tiers,85,,2,-,2
100 Tiers,86,,2,1,3
100 Tiers,87,,2,1,3
100 Tiers,88,,2,2,4
100 Tiers,89,,2,-,2
100 Tiers,90,,4,1,5
100 Tiers,91,,1,2,3
100 Tiers,92,,-,2,2
100 Tiers,93,,-,1,1
100 Tiers,94,,-,2,2
100 Tiers,97,,1,1,2
100 Tiers,98,,-,1,1
100 Tiers,100,,1,-,1
100 Tiers,Insgesamt,,481,498,979
101 Tirol,0,,14,10,24
101 Tirol,1,,8,10,18
101 Tirol,2,,12,6,18
101 Tirol,3,,15,11,26
101 Tirol,4,,9,13,22
101 Tirol,5,,17,14,31
101 Tirol,6,,12,7,19
101 Tirol,7,,11,15,26
101 Tirol,8,,13,9,22
101 Tirol,9,,12,10,22
101 Tirol,10,,14,4,18
101 Tirol,11,,12,16,28
101 Tirol,12,,10,11,21
101 Tirol,13,,17,10,27
101 Tirol,14,,18,10,28
101 Tirol,15,,19,13,32
101 Tirol,16,,14,16,30
101 Tirol,17,,16,11,27
101 Tirol,18,,21,23,44
101 Tirol,19,,20,18,38
101 Tirol,20,,12,18,30
101 Tirol,21,,15,15,30
101 Tirol,22,,21,13,34
101 Tirol,23,,15,15,30
101 Tirol,24,,6,9,15
101 Tirol,25,,18,10,28
101 Tirol,26,,14,17,31
101 Tirol,27,,14,17,31
101 Tirol,28,,15,10,25
101 Tirol,29,,12,16,28
101 Tirol,30,,13,12,25
101 Tirol,31,,17,12,29
101 Tirol,32,,14,17,31
101 Tirol,33,,16,12,28
101 Tirol,34,,15,18,33
101 Tirol,35,,18,6,24
101 Tirol,36,,13,11,24
101 Tirol,37,,8,12,20
101 Tirol,38,,13,20,33
101 Tirol,39,,13,14,27
101 Tirol,40,,20,16,36
101 Tirol,41,,15,19,34
101 Tirol,42,,22,16,38
101 Tirol,43,,25,20,45
101 Tirol,44,,25,23,48
101 Tirol,45,,17,17,34
101 Tirol,46,,22,22,44
101 Tirol,47,,26,24,50
101 Tirol,48,,24,20,44
101 Tirol,49,,25,18,43
101 Tirol,50,,22,19,41
101 Tirol,51,,28,20,48
101 Tirol,52,,18,16,34
101 Tirol,53,,18,19,37
101 Tirol,54,,18,21,39
101 Tirol,55,,24,14,38
101 Tirol,56,,15,17,32
101 Tirol,57,,9,14,23
101 Tirol,58,,15,20,35
101 Tirol,59,,8,16,24
101 Tirol,60,,14,17,31
101 Tirol,61,,14,17,31
101 Tirol,62,,16,16,32
101 Tirol,63,,12,13,25
101 Tirol,64,,14,18,32
101 Tirol,65,,14,11,25
101 Tirol,66,,15,16,31
101 Tirol,67,,20,14,34
101 Tirol,68,,9,12,21
101 Tirol,69,,13,7,20
101 Tirol,70,,10,13,23
101 Tirol,71,,13,15,28
101 Tirol,72,,11,13,24
101 Tirol,73,,12,17,29
101 Tirol,74,,10,14,24
101 Tirol,75,,9,14,23
101 Tirol,76,,7,11,18
101 Tirol,77,,7,9,16
101 Tirol,78,,6,14,20
101 Tirol,79,,4,7,11
101 Tirol,80,,6,6,12
101 Tirol,81,,13,7,20
101 Tirol,82,,5,10,15
101 Tirol,83,,5,6,11
101 Tirol,84,,3,6,9
101 Tirol,85,,3,4,7
101 Tirol,86,,5,9,14
101 Tirol,87,,2,6,8
101 Tirol,88,,5,7,12
101 Tirol,89,,1,1,2
101 Tirol,90,,3,2,5
101 Tirol,91,,1,6,7
101 Tirol,92,,-,4,4
101 Tirol,93,,2,1,3
101 Tirol,94,,1,-,1
101 Tirol,95,,1,2,3
101 Tirol,96,,1,-,1
101 Tirol,99,,1,-,1
101 Tirol,Insgesamt,,1.250,1.227,2.477
102 Truden im Naturpark,0,,4,5,9
102 Truden im Naturpark,1,,2,5,7
102 Truden im Naturpark,2,,11,5,16
102 Truden im Naturpark,3,,3,8,11
102 Truden im Naturpark,4,,3,2,5
102 Truden im Naturpark,5,,9,7,16
102 Truden im Naturpark,6,,10,7,17
102 Truden im Naturpark,7,,5,7,12
102 Truden im Naturpark,8,,8,10,18
102 Truden im Naturpark,9,,4,1,5
102 Truden im Naturpark,10,,2,5,7
102 Truden im Naturpark,11,,6,8,14
102 Truden im Naturpark,12,,5,4,9
102 Truden im Naturpark,13,,1,4,5
102 Truden im Naturpark,14,,4,2,6
102 Truden im Naturpark,15,,8,7,15
102 Truden im Naturpark,16,,-,2,2
102 Truden im Naturpark,17,,2,10,12
102 Truden im Naturpark,18,,5,6,11
102 Truden im Naturpark,19,,5,7,12
102 Truden im Naturpark,20,,7,5,12
102 Truden im Naturpark,21,,5,5,10
102 Truden im Naturpark,22,,13,6,19
102 Truden im Naturpark,23,,7,4,11
102 Truden im Naturpark,24,,7,8,15
102 Truden im Naturpark,25,,2,4,6
102 Truden im Naturpark,26,,11,9,20
102 Truden im Naturpark,27,,8,12,20
102 Truden im Naturpark,28,,6,3,9
102 Truden im Naturpark,29,,4,6,10
102 Truden im Naturpark,30,,9,6,15
102 Truden im Naturpark,31,,10,3,13
102 Truden im Naturpark,32,,4,7,11
102 Truden im Naturpark,33,,8,7,15
102 Truden im Naturpark,34,,6,11,17
102 Truden im Naturpark,35,,6,5,11
102 Truden im Naturpark,36,,7,4,11
102 Truden im Naturpark,37,,7,8,15
102 Truden im Naturpark,38,,3,7,10
102 Truden im Naturpark,39,,9,7,16
102 Truden im Naturpark,40,,9,3,12
102 Truden im Naturpark,41,,8,10,18
102 Truden im Naturpark,42,,6,9,15
102 Truden im Naturpark,43,,9,9,18
102 Truden im Naturpark,44,,3,3,6
102 Truden im Naturpark,45,,2,8,10
102 Truden im Naturpark,46,,8,9,17
102 Truden im Naturpark,47,,7,8,15
102 Truden im Naturpark,48,,11,7,18
102 Truden im Naturpark,49,,6,12,18
102 Truden im Naturpark,50,,8,7,15
102 Truden im Naturpark,51,,10,8,18
102 Truden im Naturpark,52,,13,7,20
102 Truden im Naturpark,53,,10,4,14
102 Truden im Naturpark,54,,8,5,13
102 Truden im Naturpark,55,,8,13,21
102 Truden im Naturpark,56,,5,8,13
102 Truden im Naturpark,57,,6,11,17
102 Truden im Naturpark,58,,5,7,12
102 Truden im Naturpark,59,,6,6,12
102 Truden im Naturpark,60,,7,9,16
102 Truden im Naturpark,61,,5,6,11
102 Truden im Naturpark,62,,11,6,17
102 Truden im Naturpark,63,,3,6,9
102 Truden im Naturpark,64,,9,6,15
102 Truden im Naturpark,65,,3,3,6
102 Truden im Naturpark,66,,4,3,7
102 Truden im Naturpark,67,,1,5,6
102 Truden im Naturpark,68,,6,2,8
102 Truden im Naturpark,69,,9,7,16
102 Truden im Naturpark,70,,4,3,7
102 Truden im Naturpark,71,,4,6,10
102 Truden im Naturpark,72,,4,5,9
102 Truden im Naturpark,73,,4,4,8
102 Truden im Naturpark,74,,4,6,10
102 Truden im Naturpark,75,,2,5,7
102 Truden im Naturpark,76,,7,2,9
102 Truden im Naturpark,77,,4,7,11
102 Truden im Naturpark,78,,1,4,5
102 Truden im Naturpark,79,,4,2,6
102 Truden im Naturpark,80,,3,1,4
102 Truden im Naturpark,81,,4,1,5
102 Truden im Naturpark,82,,3,7,10
102 Truden im Naturpark,83,,2,2,4
102 Truden im Naturpark,84,,1,3,4
102 Truden im Naturpark,85,,-,5,5
102 Truden im Naturpark,86,,-,4,4
102 Truden im Naturpark,87,,-,3,3
102 Truden im Naturpark,88,,-,2,2
102 Truden im Naturpark,89,,-,4,4
102 Truden im Naturpark,90,,-,4,4
102 Truden im Naturpark,91,,-,1,1
102 Truden im Naturpark,92,,-,3,3
102 Truden im Naturpark,93,,-,2,2
102 Truden im Naturpark,94,,-,1,1
102 Truden im Naturpark,Insgesamt,,493,533,1.026
103 Taufers im Münstertal,0,,4,11,15
103 Taufers im Münstertal,1,,3,7,10
103 Taufers im Münstertal,2,,4,2,6
103 Taufers im Münstertal,3,,4,6,10
103 Taufers im Münstertal,4,,6,7,13
103 Taufers im Münstertal,5,,4,-,4
103 Taufers im Münstertal,6,,7,10,17
103 Taufers im Münstertal,7,,3,5,8
103 Taufers im Münstertal,8,,6,3,9
103 Taufers im Münstertal,9,,4,10,14
103 Taufers im Münstertal,10,,2,5,7
103 Taufers im Münstertal,11,,7,4,11
103 Taufers im Münstertal,12,,3,3,6
103 Taufers im Münstertal,13,,5,5,10
103 Taufers im Münstertal,14,,6,6,12
103 Taufers im Münstertal,15,,4,3,7
103 Taufers im Münstertal,16,,3,4,7
103 Taufers im Münstertal,17,,7,8,15
103 Taufers im Münstertal,18,,4,4,8
103 Taufers im Münstertal,19,,6,4,10
103 Taufers im Münstertal,20,,8,8,16
103 Taufers im Münstertal,21,,6,9,15
103 Taufers im Münstertal,22,,6,5,11
103 Taufers im Münstertal,23,,9,7,16
103 Taufers im Münstertal,24,,6,10,16
103 Taufers im Münstertal,25,,10,8,18
103 Taufers im Münstertal,26,,9,4,13
103 Taufers im Münstertal,27,,7,7,14
103 Taufers im Münstertal,28,,4,7,11
103 Taufers im Münstertal,29,,9,3,12
103 Taufers im Münstertal,30,,5,5,10
103 Taufers im Münstertal,31,,7,6,13
103 Taufers im Münstertal,32,,5,7,12
103 Taufers im Münstertal,33,,4,9,13
103 Taufers im Münstertal,34,,7,7,14
103 Taufers im Münstertal,35,,7,4,11
103 Taufers im Münstertal,36,,6,3,9
103 Taufers im Münstertal,37,,6,3,9
103 Taufers im Münstertal,38,,5,3,8
103 Taufers im Münstertal,39,,1,6,7
103 Taufers im Münstertal,40,,11,5,16
103 Taufers im Münstertal,41,,5,5,10
103 Taufers im Münstertal,42,,2,7,9
103 Taufers im Münstertal,43,,3,8,11
103 Taufers im Münstertal,44,,7,15,22
103 Taufers im Münstertal,45,,6,8,14
103 Taufers im Münstertal,46,,9,7,16
103 Taufers im Münstertal,47,,8,12,20
103 Taufers im Münstertal,48,,5,4,9
103 Taufers im Münstertal,49,,5,10,15
103 Taufers im Münstertal,50,,11,6,17
103 Taufers im Münstertal,51,,9,11,20
103 Taufers im Münstertal,52,,9,10,19
103 Taufers im Münstertal,53,,11,8,19
103 Taufers im Münstertal,54,,8,6,14
103 Taufers im Münstertal,55,,12,6,18
103 Taufers im Münstertal,56,,6,10,16
103 Taufers im Münstertal,57,,5,6,11
103 Taufers im Münstertal,58,,8,6,14
103 Taufers im Münstertal,59,,10,9,19
103 Taufers im Münstertal,60,,4,3,7
103 Taufers im Münstertal,61,,4,6,10
103 Taufers im Münstertal,62,,6,4,10
103 Taufers im Münstertal,63,,7,2,9
103 Taufers im Münstertal,64,,4,5,9
103 Taufers im Münstertal,65,,7,3,10
103 Taufers im Münstertal,66,,5,1,6
103 Taufers im Münstertal,67,,5,1,6
103 Taufers im Münstertal,68,,3,6,9
103 Taufers im Münstertal,69,,2,3,5
103 Taufers im Münstertal,70,,2,4,6
103 Taufers im Münstertal,71,,1,-,1
103 Taufers im Münstertal,72,,6,4,10
103 Taufers im Münstertal,73,,4,4,8
103 Taufers im Münstertal,74,,3,4,7
103 Taufers im Münstertal,75,,2,3,5
103 Taufers im Münstertal,76,,4,4,8
103 Taufers im Münstertal,77,,6,8,14
103 Taufers im Münstertal,78,,3,3,6
103 Taufers im Münstertal,79,,2,8,10
103 Taufers im Münstertal,80,,2,2,4
103 Taufers im Münstertal,81,,2,7,9
103 Taufers im Münstertal,82,,3,5,8
103 Taufers im Münstertal,83,,4,1,5
103 Taufers im Münstertal,84,,6,4,10
103 Taufers im Münstertal,85,,1,3,4
103 Taufers im Münstertal,86,,2,4,6
103 Taufers im Münstertal,87,,3,1,4
103 Taufers im Münstertal,88,,2,2,4
103 Taufers im Münstertal,89,,-,3,3
103 Taufers im Münstertal,90,,1,2,3
103 Taufers im Münstertal,92,,2,2,4
103 Taufers im Münstertal,93,,-,1,1
103 Taufers im Münstertal,Insgesamt,,477,500,977
104 Ulten,0,,17,13,30
104 Ulten,1,,15,17,32
104 Ulten,2,,20,14,34
104 Ulten,3,,11,13,24
104 Ulten,4,,16,21,37
104 Ulten,5,,14,11,25
104 Ulten,6,,18,13,31
104 Ulten,7,,18,10,28
104 Ulten,8,,6,11,17
104 Ulten,9,,14,11,25
104 Ulten,10,,18,20,38
104 Ulten,11,,18,12,30
104 Ulten,12,,23,18,41
104 Ulten,13,,15,18,33
104 Ulten,14,,21,17,38
104 Ulten,15,,16,18,34
104 Ulten,16,,14,13,27
104 Ulten,17,,16,17,33
104 Ulten,18,,14,20,34
104 Ulten,19,,11,13,24
104 Ulten,20,,11,15,26
104 Ulten,21,,18,15,33
104 Ulten,22,,22,15,37
104 Ulten,23,,16,15,31
104 Ulten,24,,23,21,44
104 Ulten,25,,15,16,31
104 Ulten,26,,17,27,44
104 Ulten,27,,14,15,29
104 Ulten,28,,16,15,31
104 Ulten,29,,19,10,29
104 Ulten,30,,14,16,30
104 Ulten,31,,19,16,35
104 Ulten,32,,19,11,30
104 Ulten,33,,14,21,35
104 Ulten,34,,21,17,38
104 Ulten,35,,19,23,42
104 Ulten,36,,17,16,33
104 Ulten,37,,24,12,36
104 Ulten,38,,16,14,30
104 Ulten,39,,15,18,33
104 Ulten,40,,21,20,41
104 Ulten,41,,13,24,37
104 Ulten,42,,23,15,38
104 Ulten,43,,21,19,40
104 Ulten,44,,28,21,49
104 Ulten,45,,21,25,46
104 Ulten,46,,27,22,49
104 Ulten,47,,30,26,56
104 Ulten,48,,15,19,34
104 Ulten,49,,19,17,36
104 Ulten,50,,24,28,52
104 Ulten,51,,22,17,39
104 Ulten,52,,27,24,51
104 Ulten,53,,29,21,50
104 Ulten,54,,27,17,44
104 Ulten,55,,25,21,46
104 Ulten,56,,24,21,45
104 Ulten,57,,25,16,41
104 Ulten,58,,32,21,53
104 Ulten,59,,18,16,34
104 Ulten,60,,13,12,25
104 Ulten,61,,17,14,31
104 Ulten,62,,22,13,35
104 Ulten,63,,16,12,28
104 Ulten,64,,15,16,31
104 Ulten,65,,17,12,29
104 Ulten,66,,16,10,26
104 Ulten,67,,13,13,26
104 Ulten,68,,15,9,24
104 Ulten,69,,16,14,30
104 Ulten,70,,9,12,21
104 Ulten,71,,11,20,31
104 Ulten,72,,15,14,29
104 Ulten,73,,8,11,19
104 Ulten,74,,8,10,18
104 Ulten,75,,13,9,22
104 Ulten,76,,16,17,33
104 Ulten,77,,6,9,15
104 Ulten,78,,9,7,16
104 Ulten,79,,5,9,14
104 Ulten,80,,6,8,14
104 Ulten,81,,10,12,22
104 Ulten,82,,2,11,13
104 Ulten,83,,7,7,14
104 Ulten,84,,6,6,12
104 Ulten,85,,9,13,22
104 Ulten,86,,2,10,12
104 Ulten,87,,3,8,11
104 Ulten,88,,6,14,20
104 Ulten,89,,3,9,12
104 Ulten,90,,3,7,10
104 Ulten,91,,3,5,8
104 Ulten,92,,3,10,13
104 Ulten,93,,3,3,6
104 Ulten,94,,2,2,4
104 Ulten,95,,-,1,1
104 Ulten,96,,-,2,2
104 Ulten,97,,1,-,1
104 Ulten,Insgesamt,,1.464,1.409,2.873
105 Pfatten,0,,8,4,12
105 Pfatten,1,,9,6,15
105 Pfatten,2,,11,5,16
105 Pfatten,3,,5,6,11
105 Pfatten,4,,11,7,18
105 Pfatten,5,,5,3,8
105 Pfatten,6,,5,6,11
105 Pfatten,7,,8,6,14
105 Pfatten,8,,9,6,15
105 Pfatten,9,,10,3,13
105 Pfatten,10,,6,10,16
105 Pfatten,11,,1,6,7
105 Pfatten,12,,10,4,14
105 Pfatten,13,,4,5,9
105 Pfatten,14,,4,3,7
105 Pfatten,15,,3,5,8
105 Pfatten,16,,6,6,12
105 Pfatten,17,,7,5,12
105 Pfatten,18,,4,2,6
105 Pfatten,19,,4,8,12
105 Pfatten,20,,5,4,9
105 Pfatten,21,,8,9,17
105 Pfatten,22,,5,5,10
105 Pfatten,23,,6,6,12
105 Pfatten,24,,7,3,10
105 Pfatten,25,,9,6,15
105 Pfatten,26,,5,8,13
105 Pfatten,27,,4,4,8
105 Pfatten,28,,9,5,14
105 Pfatten,29,,3,11,14
105 Pfatten,30,,4,9,13
105 Pfatten,31,,6,6,12
105 Pfatten,32,,8,11,19
105 Pfatten,33,,8,5,13
105 Pfatten,34,,13,6,19
105 Pfatten,35,,3,4,7
105 Pfatten,36,,7,12,19
105 Pfatten,37,,6,9,15
105 Pfatten,38,,6,9,15
105 Pfatten,39,,7,9,16
105 Pfatten,40,,5,11,16
105 Pfatten,41,,13,10,23
105 Pfatten,42,,10,5,15
105 Pfatten,43,,7,9,16
105 Pfatten,44,,11,7,18
105 Pfatten,45,,10,6,16
105 Pfatten,46,,6,4,10
105 Pfatten,47,,7,8,15
105 Pfatten,48,,14,6,20
105 Pfatten,49,,10,9,19
105 Pfatten,50,,11,10,21
105 Pfatten,51,,12,5,17
105 Pfatten,52,,8,8,16
105 Pfatten,53,,9,14,23
105 Pfatten,54,,10,14,24
105 Pfatten,55,,8,9,17
105 Pfatten,56,,6,14,20
105 Pfatten,57,,8,7,15
105 Pfatten,58,,12,6,18
105 Pfatten,59,,9,8,17
105 Pfatten,60,,6,5,11
105 Pfatten,61,,11,2,13
105 Pfatten,62,,5,4,9
105 Pfatten,63,,1,5,6
105 Pfatten,64,,5,3,8
105 Pfatten,65,,5,5,10
105 Pfatten,66,,8,2,10
105 Pfatten,67,,3,2,5
105 Pfatten,68,,5,7,12
105 Pfatten,69,,3,3,6
105 Pfatten,70,,6,3,9
105 Pfatten,71,,4,1,5
105 Pfatten,72,,1,2,3
105 Pfatten,73,,1,2,3
105 Pfatten,74,,3,4,7
105 Pfatten,75,,3,3,6
105 Pfatten,76,,3,1,4
105 Pfatten,77,,2,1,3
105 Pfatten,78,,3,2,5
105 Pfatten,79,,2,3,5
105 Pfatten,80,,4,2,6
105 Pfatten,81,,-,5,5
105 Pfatten,82,,1,1,2
105 Pfatten,83,,-,5,5
105 Pfatten,84,,1,3,4
105 Pfatten,85,,-,2,2
105 Pfatten,86,,-,4,4
105 Pfatten,87,,-,1,1
105 Pfatten,89,,1,1,2
105 Pfatten,90,,-,1,1
105 Pfatten,91,,-,1,1
105 Pfatten,92,,1,-,1
105 Pfatten,94,,-,1,1
105 Pfatten,98,,-,1,1
105 Pfatten,Insgesamt,,533,505,1.038
106 Olang,0,,14,19,33
106 Olang,1,,20,15,35
106 Olang,2,,22,15,37
106 Olang,3,,15,24,39
106 Olang,4,,19,21,40
106 Olang,5,,21,20,41
106 Olang,6,,14,20,34
106 Olang,7,,24,22,46
106 Olang,8,,13,23,36
106 Olang,9,,8,18,26
106 Olang,10,,23,10,33
106 Olang,11,,14,14,28
106 Olang,12,,20,11,31
106 Olang,13,,15,11,26
106 Olang,14,,17,20,37
106 Olang,15,,23,21,44
106 Olang,16,,16,12,28
106 Olang,17,,17,23,40
106 Olang,18,,22,14,36
106 Olang,19,,25,22,47
106 Olang,20,,19,10,29
106 Olang,21,,20,11,31
106 Olang,22,,21,23,44
106 Olang,23,,15,17,32
106 Olang,24,,27,16,43
106 Olang,25,,26,25,51
106 Olang,26,,23,20,43
106 Olang,27,,16,20,36
106 Olang,28,,24,18,42
106 Olang,29,,16,19,35
106 Olang,30,,14,19,33
106 Olang,31,,23,13,36
106 Olang,32,,18,16,34
106 Olang,33,,20,18,38
106 Olang,34,,9,24,33
106 Olang,35,,25,19,44
106 Olang,36,,26,26,52
106 Olang,37,,19,20,39
106 Olang,38,,33,29,62
106 Olang,39,,20,24,44
106 Olang,40,,26,23,49
106 Olang,41,,16,26,42
106 Olang,42,,27,26,53
106 Olang,43,,26,17,43
106 Olang,44,,30,19,49
106 Olang,45,,21,20,41
106 Olang,46,,22,30,52
106 Olang,47,,32,26,58
106 Olang,48,,32,25,57
106 Olang,49,,27,23,50
106 Olang,50,,18,25,43
106 Olang,51,,21,27,48
106 Olang,52,,27,25,52
106 Olang,53,,24,14,38
106 Olang,54,,16,24,40
106 Olang,55,,20,27,47
106 Olang,56,,24,15,39
106 Olang,57,,22,11,33
106 Olang,58,,25,13,38
106 Olang,59,,12,27,39
106 Olang,60,,16,18,34
106 Olang,61,,15,19,34
106 Olang,62,,16,20,36
106 Olang,63,,16,13,29
106 Olang,64,,8,16,24
106 Olang,65,,31,15,46
106 Olang,66,,19,11,30
106 Olang,67,,19,20,39
106 Olang,68,,13,23,36
106 Olang,69,,14,13,27
106 Olang,70,,17,11,28
106 Olang,71,,15,6,21
106 Olang,72,,11,14,25
106 Olang,73,,13,16,29
106 Olang,74,,12,12,24
106 Olang,75,,15,10,25
106 Olang,76,,8,11,19
106 Olang,77,,7,12,19
106 Olang,78,,4,8,12
106 Olang,79,,5,9,14
106 Olang,80,,5,14,19
106 Olang,81,,10,9,19
106 Olang,82,,8,13,21
106 Olang,83,,8,8,16
106 Olang,84,,2,5,7
106 Olang,85,,6,7,13
106 Olang,86,,5,10,15
106 Olang,87,,3,6,9
106 Olang,88,,3,5,8
106 Olang,89,,1,8,9
106 Olang,91,,2,6,8
106 Olang,92,,1,2,3
106 Olang,93,,-,2,2
106 Olang,94,,-,2,2
106 Olang,95,,-,1,1
106 Olang,96,,1,1,2
106 Olang,97,,-,1,1
106 Olang,99,,-,1,1
106 Olang,100,,-,1,1
106 Olang,Insgesamt,,1.573,1.564,3.137
107 Pfitsch,0,,14,16,30
107 Pfitsch,1,,18,15,33
107 Pfitsch,2,,15,23,38
107 Pfitsch,3,,25,22,47
107 Pfitsch,4,,14,13,27
107 Pfitsch,5,,23,15,38
107 Pfitsch,6,,19,10,29
107 Pfitsch,7,,14,21,35
107 Pfitsch,8,,17,10,27
107 Pfitsch,9,,28,14,42
107 Pfitsch,10,,17,17,34
107 Pfitsch,11,,20,13,33
107 Pfitsch,12,,14,17,31
107 Pfitsch,13,,21,20,41
107 Pfitsch,14,,13,10,23
107 Pfitsch,15,,24,23,47
107 Pfitsch,16,,20,14,34
107 Pfitsch,17,,9,13,22
107 Pfitsch,18,,18,17,35
107 Pfitsch,19,,15,14,29
107 Pfitsch,20,,21,11,32
107 Pfitsch,21,,17,18,35
107 Pfitsch,22,,17,13,30
107 Pfitsch,23,,17,19,36
107 Pfitsch,24,,21,19,40
107 Pfitsch,25,,27,15,42
107 Pfitsch,26,,18,17,35
107 Pfitsch,27,,16,18,34
107 Pfitsch,28,,12,12,24
107 Pfitsch,29,,14,15,29
107 Pfitsch,30,,15,16,31
107 Pfitsch,31,,28,15,43
107 Pfitsch,32,,26,26,52
107 Pfitsch,33,,30,18,48
107 Pfitsch,34,,19,24,43
107 Pfitsch,35,,19,23,42
107 Pfitsch,36,,27,18,45
107 Pfitsch,37,,26,20,46
107 Pfitsch,38,,19,15,34
107 Pfitsch,39,,22,31,53
107 Pfitsch,40,,20,26,46
107 Pfitsch,41,,19,19,38
107 Pfitsch,42,,25,18,43
107 Pfitsch,43,,23,24,47
107 Pfitsch,44,,30,16,46
107 Pfitsch,45,,22,23,45
107 Pfitsch,46,,27,19,46
107 Pfitsch,47,,21,19,40
107 Pfitsch,48,,23,18,41
107 Pfitsch,49,,23,20,43
107 Pfitsch,50,,18,20,38
107 Pfitsch,51,,17,24,41
107 Pfitsch,52,,18,19,37
107 Pfitsch,53,,24,22,46
107 Pfitsch,54,,23,20,43
107 Pfitsch,55,,16,25,41
107 Pfitsch,56,,13,17,30
107 Pfitsch,57,,24,15,39
107 Pfitsch,58,,24,25,49
107 Pfitsch,59,,19,16,35
107 Pfitsch,60,,13,13,26
107 Pfitsch,61,,19,19,38
107 Pfitsch,62,,22,15,37
107 Pfitsch,63,,16,20,36
107 Pfitsch,64,,22,17,39
107 Pfitsch,65,,18,20,38
107 Pfitsch,66,,12,18,30
107 Pfitsch,67,,8,7,15
107 Pfitsch,68,,8,12,20
107 Pfitsch,69,,14,13,27
107 Pfitsch,70,,10,13,23
107 Pfitsch,71,,12,14,26
107 Pfitsch,72,,18,11,29
107 Pfitsch,73,,18,13,31
107 Pfitsch,74,,13,16,29
107 Pfitsch,75,,12,12,24
107 Pfitsch,76,,11,8,19
107 Pfitsch,77,,4,10,14
107 Pfitsch,78,,8,10,18
107 Pfitsch,79,,6,11,17
107 Pfitsch,80,,6,5,11
107 Pfitsch,81,,10,5,15
107 Pfitsch,82,,11,9,20
107 Pfitsch,83,,3,10,13
107 Pfitsch,84,,7,7,14
107 Pfitsch,85,,2,9,11
107 Pfitsch,86,,5,7,12
107 Pfitsch,87,,2,8,10
107 Pfitsch,88,,5,8,13
107 Pfitsch,89,,2,8,10
107 Pfitsch,90,,2,6,8
107 Pfitsch,91,,-,2,2
107 Pfitsch,92,,-,2,2
107 Pfitsch,93,,2,1,3
107 Pfitsch,94,,-,5,5
107 Pfitsch,96,,-,2,2
107 Pfitsch,98,,-,1,1
107 Pfitsch,Insgesamt,,1.519,1.452,2.971
108 Ahrntal,0,,35,30,65
108 Ahrntal,1,,42,19,61
108 Ahrntal,2,,33,26,59
108 Ahrntal,3,,48,29,77
108 Ahrntal,4,,37,35,72
108 Ahrntal,5,,30,29,59
108 Ahrntal,6,,43,42,85
108 Ahrntal,7,,29,48,77
108 Ahrntal,8,,41,38,79
108 Ahrntal,9,,41,34,75
108 Ahrntal,10,,31,39,70
108 Ahrntal,11,,32,40,72
108 Ahrntal,12,,37,39,76
108 Ahrntal,13,,32,37,69
108 Ahrntal,14,,34,32,66
108 Ahrntal,15,,50,42,92
108 Ahrntal,16,,36,38,74
108 Ahrntal,17,,36,37,73
108 Ahrntal,18,,41,46,87
108 Ahrntal,19,,39,49,88
108 Ahrntal,20,,36,30,66
108 Ahrntal,21,,27,27,54
108 Ahrntal,22,,37,44,81
108 Ahrntal,23,,43,32,75
108 Ahrntal,24,,28,35,63
108 Ahrntal,25,,41,32,73
108 Ahrntal,26,,41,30,71
108 Ahrntal,27,,27,30,57
108 Ahrntal,28,,38,35,73
108 Ahrntal,29,,36,42,78
108 Ahrntal,30,,35,46,81
108 Ahrntal,31,,36,27,63
108 Ahrntal,32,,45,47,92
108 Ahrntal,33,,38,41,79
108 Ahrntal,34,,47,41,88
108 Ahrntal,35,,37,40,77
108 Ahrntal,36,,36,42,78
108 Ahrntal,37,,34,39,73
108 Ahrntal,38,,48,44,92
108 Ahrntal,39,,49,42,91
108 Ahrntal,40,,45,41,86
108 Ahrntal,41,,46,38,84
108 Ahrntal,42,,43,39,82
108 Ahrntal,43,,55,52,107
108 Ahrntal,44,,65,43,108
108 Ahrntal,45,,54,44,98
108 Ahrntal,46,,51,46,97
108 Ahrntal,47,,50,42,92
108 Ahrntal,48,,40,50,90
108 Ahrntal,49,,59,43,102
108 Ahrntal,50,,59,43,102
108 Ahrntal,51,,48,40,88
108 Ahrntal,52,,49,43,92
108 Ahrntal,53,,36,47,83
108 Ahrntal,54,,33,38,71
108 Ahrntal,55,,37,29,66
108 Ahrntal,56,,41,40,81
108 Ahrntal,57,,45,30,75
108 Ahrntal,58,,27,40,67
108 Ahrntal,59,,34,21,55
108 Ahrntal,60,,35,23,58
108 Ahrntal,61,,34,18,52
108 Ahrntal,62,,26,29,55
108 Ahrntal,63,,27,34,61
108 Ahrntal,64,,29,21,50
108 Ahrntal,65,,30,19,49
108 Ahrntal,66,,28,30,58
108 Ahrntal,67,,27,26,53
108 Ahrntal,68,,22,17,39
108 Ahrntal,69,,17,22,39
108 Ahrntal,70,,20,13,33
108 Ahrntal,71,,12,18,30
108 Ahrntal,72,,20,30,50
108 Ahrntal,73,,26,25,51
108 Ahrntal,74,,24,31,55
108 Ahrntal,75,,27,24,51
108 Ahrntal,76,,20,21,41
108 Ahrntal,77,,30,28,58
108 Ahrntal,78,,20,19,39
108 Ahrntal,79,,17,12,29
108 Ahrntal,80,,14,34,48
108 Ahrntal,81,,10,20,30
108 Ahrntal,82,,16,16,32
108 Ahrntal,83,,14,26,40
108 Ahrntal,84,,18,16,34
108 Ahrntal,85,,13,14,27
108 Ahrntal,86,,7,15,22
108 Ahrntal,87,,7,20,27
108 Ahrntal,88,,4,11,15
108 Ahrntal,89,,6,8,14
108 Ahrntal,90,,3,10,13
108 Ahrntal,91,,4,2,6
108 Ahrntal,92,,2,4,6
108 Ahrntal,93,,1,5,6
108 Ahrntal,95,,-,1,1
108 Ahrntal,96,,2,-,2
108 Ahrntal,100,,-,1,1
108 Ahrntal,101,,-,1,1
108 Ahrntal,Insgesamt,,3.035,2.948,5.983
109 Gsies,0,,14,17,31
109 Gsies,1,,18,20,38
109 Gsies,2,,20,14,34
109 Gsies,3,,16,15,31
109 Gsies,4,,12,18,30
109 Gsies,5,,16,16,32
109 Gsies,6,,15,17,32
109 Gsies,7,,15,12,27
109 Gsies,8,,17,12,29
109 Gsies,9,,19,20,39
109 Gsies,10,,17,17,34
109 Gsies,11,,10,13,23
109 Gsies,12,,19,18,37
109 Gsies,13,,13,12,25
109 Gsies,14,,15,14,29
109 Gsies,15,,9,12,21
109 Gsies,16,,28,10,38
109 Gsies,17,,19,5,24
109 Gsies,18,,13,17,30
109 Gsies,19,,10,18,28
109 Gsies,20,,15,15,30
109 Gsies,21,,8,17,25
109 Gsies,22,,17,18,35
109 Gsies,23,,16,11,27
109 Gsies,24,,14,22,36
109 Gsies,25,,16,8,24
109 Gsies,26,,9,11,20
109 Gsies,27,,7,15,22
109 Gsies,28,,17,19,36
109 Gsies,29,,12,14,26
109 Gsies,30,,18,14,32
109 Gsies,31,,13,15,28
109 Gsies,32,,16,9,25
109 Gsies,33,,18,13,31
109 Gsies,34,,14,24,38
109 Gsies,35,,21,20,41
109 Gsies,36,,10,15,25
109 Gsies,37,,16,12,28
109 Gsies,38,,14,16,30
109 Gsies,39,,12,18,30
109 Gsies,40,,18,21,39
109 Gsies,41,,18,14,32
109 Gsies,42,,14,11,25
109 Gsies,43,,8,19,27
109 Gsies,44,,19,18,37
109 Gsies,45,,27,14,41
109 Gsies,46,,24,10,34
109 Gsies,47,,14,14,28
109 Gsies,48,,16,12,28
109 Gsies,49,,15,18,33
109 Gsies,50,,19,4,23
109 Gsies,51,,16,18,34
109 Gsies,52,,14,15,29
109 Gsies,53,,15,8,23
109 Gsies,54,,9,14,23
109 Gsies,55,,15,17,32
109 Gsies,56,,10,13,23
109 Gsies,57,,15,15,30
109 Gsies,58,,11,13,24
109 Gsies,59,,16,7,23
109 Gsies,60,,14,10,24
109 Gsies,61,,16,7,23
109 Gsies,62,,18,6,24
109 Gsies,63,,16,14,30
109 Gsies,64,,14,12,26
109 Gsies,65,,7,8,15
109 Gsies,66,,16,17,33
109 Gsies,67,,7,10,17
109 Gsies,68,,20,5,25
109 Gsies,69,,14,10,24
109 Gsies,70,,5,11,16
109 Gsies,71,,6,13,19
109 Gsies,72,,9,7,16
109 Gsies,73,,5,12,17
109 Gsies,74,,6,9,15
109 Gsies,75,,5,9,14
109 Gsies,76,,5,8,13
109 Gsies,77,,8,8,16
109 Gsies,78,,8,6,14
109 Gsies,79,,3,10,13
109 Gsies,80,,3,7,10
109 Gsies,81,,3,7,10
109 Gsies,82,,5,6,11
109 Gsies,83,,5,3,8
109 Gsies,84,,4,5,9
109 Gsies,85,,10,5,15
109 Gsies,86,,1,4,5
109 Gsies,87,,6,6,12
109 Gsies,88,,-,7,7
109 Gsies,89,,1,2,3
109 Gsies,90,,2,3,5
109 Gsies,91,,-,4,4
109 Gsies,92,,1,5,6
109 Gsies,93,,3,3,6
109 Gsies,94,,1,1,2
109 Gsies,95,,1,-,1
109 Gsies,96,,1,-,1
109 Gsies,Insgesamt,,1.160,1.138,2.298
110 Vintl,0,,17,19,36
110 Vintl,1,,18,27,45
110 Vintl,2,,18,20,38
110 Vintl,3,,18,22,40
110 Vintl,4,,10,19,29
110 Vintl,5,,14,16,30
110 Vintl,6,,23,20,43
110 Vintl,7,,21,19,40
110 Vintl,8,,24,16,40
110 Vintl,9,,12,14,26
110 Vintl,10,,19,22,41
110 Vintl,11,,12,14,26
110 Vintl,12,,17,17,34
110 Vintl,13,,14,23,37
110 Vintl,14,,17,21,38
110 Vintl,15,,23,15,38
110 Vintl,16,,22,22,44
110 Vintl,17,,19,29,48
110 Vintl,18,,20,14,34
110 Vintl,19,,24,21,45
110 Vintl,20,,38,26,64
110 Vintl,21,,21,17,38
110 Vintl,22,,28,23,51
110 Vintl,23,,30,26,56
110 Vintl,24,,22,31,53
110 Vintl,25,,26,18,44
110 Vintl,26,,28,12,40
110 Vintl,27,,18,20,38
110 Vintl,28,,24,23,47
110 Vintl,29,,24,22,46
110 Vintl,30,,12,15,27
110 Vintl,31,,25,13,38
110 Vintl,32,,19,13,32
110 Vintl,33,,24,29,53
110 Vintl,34,,16,21,37
110 Vintl,35,,26,17,43
110 Vintl,36,,26,22,48
110 Vintl,37,,22,36,58
110 Vintl,38,,17,20,37
110 Vintl,39,,22,18,40
110 Vintl,40,,24,19,43
110 Vintl,41,,25,26,51
110 Vintl,42,,18,21,39
110 Vintl,43,,27,17,44
110 Vintl,44,,25,26,51
110 Vintl,45,,19,18,37
110 Vintl,46,,25,23,48
110 Vintl,47,,24,22,46
110 Vintl,48,,28,35,63
110 Vintl,49,,29,29,58
110 Vintl,50,,30,30,60
110 Vintl,51,,35,22,57
110 Vintl,52,,34,28,62
110 Vintl,53,,32,22,54
110 Vintl,54,,24,29,53
110 Vintl,55,,16,22,38
110 Vintl,56,,20,23,43
110 Vintl,57,,21,16,37
110 Vintl,58,,22,29,51
110 Vintl,59,,22,19,41
110 Vintl,60,,19,13,32
110 Vintl,61,,15,18,33
110 Vintl,62,,21,9,30
110 Vintl,63,,15,18,33
110 Vintl,64,,21,17,38
110 Vintl,65,,20,20,40
110 Vintl,66,,16,19,35
110 Vintl,67,,12,13,25
110 Vintl,68,,18,13,31
110 Vintl,69,,12,12,24
110 Vintl,70,,11,17,28
110 Vintl,71,,10,5,15
110 Vintl,72,,19,12,31
110 Vintl,73,,9,10,19
110 Vintl,74,,7,13,20
110 Vintl,75,,8,17,25
110 Vintl,76,,12,13,25
110 Vintl,77,,9,5,14
110 Vintl,78,,8,7,15
110 Vintl,79,,11,10,21
110 Vintl,80,,9,10,19
110 Vintl,81,,11,5,16
110 Vintl,82,,3,17,20
110 Vintl,83,,6,10,16
110 Vintl,84,,6,11,17
110 Vintl,85,,3,10,13
110 Vintl,86,,4,10,14
110 Vintl,87,,4,6,10
110 Vintl,88,,4,8,12
110 Vintl,89,,4,1,5
110 Vintl,90,,3,3,6
110 Vintl,91,,1,1,2
110 Vintl,92,,1,2,3
110 Vintl,93,,1,2,3
110 Vintl,94,,-,2,2
110 Vintl,95,,-,2,2
110 Vintl,98,,-,1,1
110 Vintl,100,,1,-,1
110 Vintl,Insgesamt,,1.664,1.650,3.314
111 Vahrn,0,,27,31,58
111 Vahrn,1,,30,27,57
111 Vahrn,2,,38,25,63
111 Vahrn,3,,35,28,63
111 Vahrn,4,,38,29,67
111 Vahrn,5,,25,26,51
111 Vahrn,6,,25,28,53
111 Vahrn,7,,25,25,50
111 Vahrn,8,,42,22,64
111 Vahrn,9,,31,33,64
111 Vahrn,10,,30,32,62
111 Vahrn,11,,30,27,57
111 Vahrn,12,,28,13,41
111 Vahrn,13,,28,32,60
111 Vahrn,14,,28,19,47
111 Vahrn,15,,27,21,48
111 Vahrn,16,,28,32,60
111 Vahrn,17,,23,26,49
111 Vahrn,18,,23,21,44
111 Vahrn,19,,35,14,49
111 Vahrn,20,,28,21,49
111 Vahrn,21,,22,27,49
111 Vahrn,22,,18,19,37
111 Vahrn,23,,18,33,51
111 Vahrn,24,,24,24,48
111 Vahrn,25,,22,38,60
111 Vahrn,26,,26,21,47
111 Vahrn,27,,29,19,48
111 Vahrn,28,,20,23,43
111 Vahrn,29,,28,18,46
111 Vahrn,30,,22,25,47
111 Vahrn,31,,23,19,42
111 Vahrn,32,,31,24,55
111 Vahrn,33,,30,38,68
111 Vahrn,34,,34,29,63
111 Vahrn,35,,26,29,55
111 Vahrn,36,,25,34,59
111 Vahrn,37,,33,36,69
111 Vahrn,38,,19,30,49
111 Vahrn,39,,40,30,70
111 Vahrn,40,,34,32,66
111 Vahrn,41,,36,43,79
111 Vahrn,42,,40,42,82
111 Vahrn,43,,35,48,83
111 Vahrn,44,,41,28,69
111 Vahrn,45,,47,40,87
111 Vahrn,46,,41,44,85
111 Vahrn,47,,34,38,72
111 Vahrn,48,,43,34,77
111 Vahrn,49,,36,31,67
111 Vahrn,50,,38,37,75
111 Vahrn,51,,40,34,74
111 Vahrn,52,,39,35,74
111 Vahrn,53,,27,38,65
111 Vahrn,54,,25,25,50
111 Vahrn,55,,30,30,60
111 Vahrn,56,,30,27,57
111 Vahrn,57,,21,19,40
111 Vahrn,58,,28,29,57
111 Vahrn,59,,20,23,43
111 Vahrn,60,,25,31,56
111 Vahrn,61,,24,33,57
111 Vahrn,62,,24,28,52
111 Vahrn,63,,19,14,33
111 Vahrn,64,,20,11,31
111 Vahrn,65,,20,20,40
111 Vahrn,66,,24,30,54
111 Vahrn,67,,17,18,35
111 Vahrn,68,,14,26,40
111 Vahrn,69,,19,22,41
111 Vahrn,70,,12,14,26
111 Vahrn,71,,14,19,33
111 Vahrn,72,,18,22,40
111 Vahrn,73,,13,22,35
111 Vahrn,74,,14,22,36
111 Vahrn,75,,19,14,33
111 Vahrn,76,,18,18,36
111 Vahrn,77,,12,8,20
111 Vahrn,78,,12,17,29
111 Vahrn,79,,7,14,21
111 Vahrn,80,,5,13,18
111 Vahrn,81,,11,11,22
111 Vahrn,82,,7,10,17
111 Vahrn,83,,4,8,12
111 Vahrn,84,,6,10,16
111 Vahrn,85,,6,7,13
111 Vahrn,86,,4,16,20
111 Vahrn,87,,5,7,12
111 Vahrn,88,,1,11,12
111 Vahrn,89,,4,3,7
111 Vahrn,90,,-,8,8
111 Vahrn,91,,2,2,4
111 Vahrn,92,,1,4,5
111 Vahrn,93,,-,4,4
111 Vahrn,94,,-,2,2
111 Vahrn,95,,-,1,1
111 Vahrn,98,,-,1,1
111 Vahrn,101,,-,1,1
111 Vahrn,Insgesamt,,2.200,2.247,4.447
112 Vöran,0,,5,2,7
112 Vöran,1,,5,7,12
112 Vöran,2,,4,5,9
112 Vöran,3,,9,6,15
112 Vöran,4,,2,3,5
112 Vöran,5,,9,6,15
112 Vöran,6,,5,6,11
112 Vöran,7,,8,3,11
112 Vöran,8,,4,3,7
112 Vöran,9,,9,3,12
112 Vöran,10,,3,5,8
112 Vöran,11,,3,5,8
112 Vöran,12,,9,5,14
112 Vöran,13,,5,7,12
112 Vöran,14,,9,4,13
112 Vöran,15,,11,6,17
112 Vöran,16,,5,3,8
112 Vöran,17,,5,4,9
112 Vöran,18,,11,7,18
112 Vöran,19,,10,5,15
112 Vöran,20,,6,9,15
112 Vöran,21,,7,6,13
112 Vöran,22,,7,5,12
112 Vöran,23,,6,3,9
112 Vöran,24,,5,6,11
112 Vöran,25,,7,5,12
112 Vöran,26,,11,6,17
112 Vöran,27,,5,6,11
112 Vöran,28,,11,10,21
112 Vöran,29,,6,8,14
112 Vöran,30,,7,6,13
112 Vöran,31,,6,4,10
112 Vöran,32,,3,6,9
112 Vöran,33,,8,10,18
112 Vöran,34,,7,10,17
112 Vöran,35,,5,3,8
112 Vöran,36,,3,5,8
112 Vöran,37,,7,7,14
112 Vöran,38,,7,6,13
112 Vöran,39,,4,6,10
112 Vöran,40,,8,5,13
112 Vöran,41,,14,11,25
112 Vöran,42,,6,6,12
112 Vöran,43,,8,8,16
112 Vöran,44,,7,10,17
112 Vöran,45,,7,6,13
112 Vöran,46,,7,4,11
112 Vöran,47,,14,3,17
112 Vöran,48,,5,6,11
112 Vöran,49,,8,6,14
112 Vöran,50,,4,4,8
112 Vöran,51,,11,4,15
112 Vöran,52,,7,8,15
112 Vöran,53,,12,14,26
112 Vöran,54,,4,5,9
112 Vöran,55,,6,6,12
112 Vöran,56,,4,7,11
112 Vöran,57,,6,6,12
112 Vöran,58,,5,10,15
112 Vöran,59,,2,2,4
112 Vöran,60,,4,2,6
112 Vöran,61,,5,5,10
112 Vöran,62,,5,4,9
112 Vöran,63,,9,2,11
112 Vöran,64,,2,-,2
112 Vöran,65,,7,4,11
112 Vöran,66,,7,5,12
112 Vöran,67,,3,3,6
112 Vöran,68,,5,2,7
112 Vöran,69,,4,2,6
112 Vöran,70,,-,4,4
112 Vöran,71,,4,1,5
112 Vöran,72,,2,5,7
112 Vöran,73,,4,4,8
112 Vöran,74,,5,6,11
112 Vöran,75,,1,3,4
112 Vöran,76,,1,2,3
112 Vöran,77,,6,3,9
112 Vöran,78,,2,2,4
112 Vöran,79,,2,5,7
112 Vöran,80,,2,-,2
112 Vöran,81,,1,5,6
112 Vöran,82,,5,6,11
112 Vöran,83,,1,3,4
112 Vöran,84,,2,-,2
112 Vöran,85,,2,1,3
112 Vöran,86,,1,1,2
112 Vöran,87,,2,1,3
112 Vöran,90,,-,2,2
112 Vöran,92,,-,1,1
112 Vöran,95,,-,1,1
112 Vöran,Insgesamt,,498,438,936
113 Niederdorf,0,,9,6,15
113 Niederdorf,1,,10,9,19
113 Niederdorf,2,,12,9,21
113 Niederdorf,3,,9,7,16
113 Niederdorf,4,,11,4,15
113 Niederdorf,5,,10,5,15
113 Niederdorf,6,,14,11,25
113 Niederdorf,7,,10,7,17
113 Niederdorf,8,,10,11,21
113 Niederdorf,9,,10,8,18
113 Niederdorf,10,,15,8,23
113 Niederdorf,11,,11,17,28
113 Niederdorf,12,,6,15,21
113 Niederdorf,13,,8,13,21
113 Niederdorf,14,,10,9,19
113 Niederdorf,15,,14,12,26
113 Niederdorf,16,,5,6,11
113 Niederdorf,17,,7,12,19
113 Niederdorf,18,,9,8,17
113 Niederdorf,19,,6,7,13
113 Niederdorf,20,,6,12,18
113 Niederdorf,21,,13,7,20
113 Niederdorf,22,,9,8,17
113 Niederdorf,23,,7,10,17
113 Niederdorf,24,,9,14,23
113 Niederdorf,25,,14,11,25
113 Niederdorf,26,,8,5,13
113 Niederdorf,27,,9,9,18
113 Niederdorf,28,,4,11,15
113 Niederdorf,29,,7,8,15
113 Niederdorf,30,,15,6,21
113 Niederdorf,31,,9,2,11
113 Niederdorf,32,,7,9,16
113 Niederdorf,33,,4,16,20
113 Niederdorf,34,,9,9,18
113 Niederdorf,35,,9,6,15
113 Niederdorf,36,,11,11,22
113 Niederdorf,37,,6,6,12
113 Niederdorf,38,,8,8,16
113 Niederdorf,39,,12,10,22
113 Niederdorf,40,,8,11,19
113 Niederdorf,41,,9,7,16
113 Niederdorf,42,,11,13,24
113 Niederdorf,43,,18,10,28
113 Niederdorf,44,,6,15,21
113 Niederdorf,45,,10,11,21
113 Niederdorf,46,,24,17,41
113 Niederdorf,47,,16,12,28
113 Niederdorf,48,,15,18,33
113 Niederdorf,49,,22,11,33
113 Niederdorf,50,,12,14,26
113 Niederdorf,51,,15,17,32
113 Niederdorf,52,,15,9,24
113 Niederdorf,53,,25,8,33
113 Niederdorf,54,,12,10,22
113 Niederdorf,55,,8,10,18
113 Niederdorf,56,,11,11,22
113 Niederdorf,57,,7,5,12
113 Niederdorf,58,,9,10,19
113 Niederdorf,59,,7,11,18
113 Niederdorf,60,,10,8,18
113 Niederdorf,61,,10,7,17
113 Niederdorf,62,,7,5,12
113 Niederdorf,63,,9,5,14
113 Niederdorf,64,,2,2,4
113 Niederdorf,65,,5,6,11
113 Niederdorf,66,,10,4,14
113 Niederdorf,67,,5,9,14
113 Niederdorf,68,,6,7,13
113 Niederdorf,69,,7,7,14
113 Niederdorf,70,,2,7,9
113 Niederdorf,71,,4,5,9
113 Niederdorf,72,,5,8,13
113 Niederdorf,73,,6,7,13
113 Niederdorf,74,,3,4,7
113 Niederdorf,75,,4,6,10
113 Niederdorf,76,,2,4,6
113 Niederdorf,77,,6,5,11
113 Niederdorf,78,,5,7,12
113 Niederdorf,79,,4,8,12
113 Niederdorf,80,,5,7,12
113 Niederdorf,81,,2,12,14
113 Niederdorf,82,,3,6,9
113 Niederdorf,83,,6,4,10
113 Niederdorf,84,,5,4,9
113 Niederdorf,85,,3,6,9
113 Niederdorf,86,,1,8,9
113 Niederdorf,87,,-,4,4
113 Niederdorf,88,,-,6,6
113 Niederdorf,89,,-,4,4
113 Niederdorf,90,,1,3,4
113 Niederdorf,91,,1,4,5
113 Niederdorf,92,,1,-,1
113 Niederdorf,93,,1,2,3
113 Niederdorf,94,,2,2,4
113 Niederdorf,95,,-,1,1
113 Niederdorf,99,,-,1,1
113 Niederdorf,Insgesamt,,775,787,1.562
114 Villanders,0,,9,7,16
114 Villanders,1,,7,9,16
114 Villanders,2,,6,9,15
114 Villanders,3,,11,11,22
114 Villanders,4,,5,6,11
114 Villanders,5,,15,6,21
114 Villanders,6,,11,8,19
114 Villanders,7,,6,9,15
114 Villanders,8,,15,14,29
114 Villanders,9,,12,15,27
114 Villanders,10,,17,7,24
114 Villanders,11,,13,13,26
114 Villanders,12,,5,12,17
114 Villanders,13,,7,9,16
114 Villanders,14,,13,11,24
114 Villanders,15,,9,17,26
114 Villanders,16,,12,11,23
114 Villanders,17,,11,8,19
114 Villanders,18,,11,12,23
114 Villanders,19,,14,7,21
114 Villanders,20,,16,5,21
114 Villanders,21,,11,13,24
114 Villanders,22,,8,17,25
114 Villanders,23,,14,8,22
114 Villanders,24,,16,16,32
114 Villanders,25,,17,12,29
114 Villanders,26,,9,11,20
114 Villanders,27,,12,12,24
114 Villanders,28,,7,8,15
114 Villanders,29,,12,7,19
114 Villanders,30,,7,9,16
114 Villanders,31,,11,11,22
114 Villanders,32,,13,6,19
114 Villanders,33,,13,14,27
114 Villanders,34,,18,11,29
114 Villanders,35,,9,14,23
114 Villanders,36,,13,5,18
114 Villanders,37,,12,8,20
114 Villanders,38,,16,10,26
114 Villanders,39,,13,6,19
114 Villanders,40,,14,11,25
114 Villanders,41,,14,13,27
114 Villanders,42,,10,15,25
114 Villanders,43,,16,21,37
114 Villanders,44,,19,18,37
114 Villanders,45,,14,9,23
114 Villanders,46,,25,16,41
114 Villanders,47,,22,12,34
114 Villanders,48,,20,14,34
114 Villanders,49,,19,20,39
114 Villanders,50,,22,18,40
114 Villanders,51,,18,16,34
114 Villanders,52,,15,12,27
114 Villanders,53,,18,11,29
114 Villanders,54,,13,11,24
114 Villanders,55,,18,6,24
114 Villanders,56,,14,10,24
114 Villanders,57,,15,7,22
114 Villanders,58,,9,6,15
114 Villanders,59,,10,7,17
114 Villanders,60,,11,17,28
114 Villanders,61,,6,6,12
114 Villanders,62,,11,11,22
114 Villanders,63,,11,7,18
114 Villanders,64,,10,7,17
114 Villanders,65,,10,8,18
114 Villanders,66,,9,6,15
114 Villanders,67,,6,11,17
114 Villanders,68,,5,7,12
114 Villanders,69,,8,10,18
114 Villanders,70,,6,2,8
114 Villanders,71,,3,9,12
114 Villanders,72,,6,7,13
114 Villanders,73,,8,8,16
114 Villanders,74,,6,9,15
114 Villanders,75,,9,11,20
114 Villanders,76,,7,4,11
114 Villanders,77,,6,6,12
114 Villanders,78,,4,9,13
114 Villanders,79,,7,6,13
114 Villanders,80,,2,6,8
114 Villanders,81,,1,8,9
114 Villanders,82,,6,8,14
114 Villanders,83,,6,9,15
114 Villanders,84,,4,8,12
114 Villanders,85,,4,3,7
114 Villanders,86,,3,7,10
114 Villanders,87,,2,4,6
114 Villanders,88,,1,3,4
114 Villanders,89,,1,2,3
114 Villanders,90,,-,4,4
114 Villanders,91,,2,-,2
114 Villanders,92,,2,1,3
114 Villanders,93,,1,2,3
114 Villanders,94,,-,4,4
114 Villanders,95,,-,2,2
114 Villanders,Insgesamt,,965,889,1.854
115 Sterzing,0,,38,30,68
115 Sterzing,1,,43,39,82
115 Sterzing,2,,37,31,68
115 Sterzing,3,,42,40,82
115 Sterzing,4,,36,29,65
115 Sterzing,5,,38,33,71
115 Sterzing,6,,33,34,67
115 Sterzing,7,,39,42,81
115 Sterzing,8,,35,33,68
115 Sterzing,9,,36,32,68
115 Sterzing,10,,33,33,66
115 Sterzing,11,,28,32,60
115 Sterzing,12,,35,35,70
115 Sterzing,13,,35,31,66
115 Sterzing,14,,32,32,64
115 Sterzing,15,,32,38,70
115 Sterzing,16,,29,27,56
115 Sterzing,17,,28,26,54
115 Sterzing,18,,32,35,67
115 Sterzing,19,,31,41,72
115 Sterzing,20,,39,31,70
115 Sterzing,21,,34,30,64
115 Sterzing,22,,45,26,71
115 Sterzing,23,,44,40,84
115 Sterzing,24,,47,38,85
115 Sterzing,25,,48,49,97
115 Sterzing,26,,64,39,103
115 Sterzing,27,,63,37,100
115 Sterzing,28,,61,47,108
115 Sterzing,29,,65,47,112
115 Sterzing,30,,54,45,99
115 Sterzing,31,,56,51,107
115 Sterzing,32,,59,43,102
115 Sterzing,33,,65,39,104
115 Sterzing,34,,72,49,121
115 Sterzing,35,,57,59,116
115 Sterzing,36,,54,54,108
115 Sterzing,37,,61,42,103
115 Sterzing,38,,41,32,73
115 Sterzing,39,,42,38,80
115 Sterzing,40,,49,43,92
115 Sterzing,41,,48,46,94
115 Sterzing,42,,60,70,130
115 Sterzing,43,,60,43,103
115 Sterzing,44,,43,55,98
115 Sterzing,45,,58,66,124
115 Sterzing,46,,45,38,83
115 Sterzing,47,,52,51,103
115 Sterzing,48,,64,49,113
115 Sterzing,49,,63,51,114
115 Sterzing,50,,53,49,102
115 Sterzing,51,,47,44,91
115 Sterzing,52,,52,47,99
115 Sterzing,53,,44,47,91
115 Sterzing,54,,38,37,75
115 Sterzing,55,,44,47,91
115 Sterzing,56,,54,41,95
115 Sterzing,57,,37,43,80
115 Sterzing,58,,35,46,81
115 Sterzing,59,,37,27,64
115 Sterzing,60,,35,48,83
115 Sterzing,61,,36,32,68
115 Sterzing,62,,29,44,73
115 Sterzing,63,,40,41,81
115 Sterzing,64,,32,44,76
115 Sterzing,65,,38,36,74
115 Sterzing,66,,35,47,82
115 Sterzing,67,,37,45,82
115 Sterzing,68,,26,26,52
115 Sterzing,69,,41,44,85
115 Sterzing,70,,29,38,67
115 Sterzing,71,,31,25,56
115 Sterzing,72,,36,48,84
115 Sterzing,73,,29,38,67
115 Sterzing,74,,27,28,55
115 Sterzing,75,,32,30,62
115 Sterzing,76,,22,28,50
115 Sterzing,77,,29,27,56
115 Sterzing,78,,18,32,50
115 Sterzing,79,,15,36,51
115 Sterzing,80,,16,20,36
115 Sterzing,81,,9,17,26
115 Sterzing,82,,19,23,42
115 Sterzing,83,,15,11,26
115 Sterzing,84,,13,24,37
115 Sterzing,85,,5,15,20
115 Sterzing,86,,6,10,16
115 Sterzing,87,,9,15,24
115 Sterzing,88,,8,13,21
115 Sterzing,89,,6,9,15
115 Sterzing,90,,2,10,12
115 Sterzing,91,,2,7,9
115 Sterzing,92,,5,9,14
115 Sterzing,93,,-,6,6
115 Sterzing,94,,1,1,2
115 Sterzing,95,,-,3,3
115 Sterzing,96,,1,2,3
115 Sterzing,97,,-,1,1
115 Sterzing,Insgesamt,,3.480,3.382,6.862
116 Feldthurns,0,,21,15,36
116 Feldthurns,1,,17,14,31
116 Feldthurns,2,,17,17,34
116 Feldthurns,3,,18,15,33
116 Feldthurns,4,,14,13,27
116 Feldthurns,5,,26,20,46
116 Feldthurns,6,,14,13,27
116 Feldthurns,7,,15,21,36
116 Feldthurns,8,,24,17,41
116 Feldthurns,9,,27,21,48
116 Feldthurns,10,,25,14,39
116 Feldthurns,11,,22,17,39
116 Feldthurns,12,,11,13,24
116 Feldthurns,13,,24,20,44
116 Feldthurns,14,,16,21,37
116 Feldthurns,15,,23,14,37
116 Feldthurns,16,,17,23,40
116 Feldthurns,17,,21,21,42
116 Feldthurns,18,,22,17,39
116 Feldthurns,19,,16,19,35
116 Feldthurns,20,,18,20,38
116 Feldthurns,21,,16,18,34
116 Feldthurns,22,,31,19,50
116 Feldthurns,23,,21,20,41
116 Feldthurns,24,,14,12,26
116 Feldthurns,25,,13,15,28
116 Feldthurns,26,,18,12,30
116 Feldthurns,27,,16,16,32
116 Feldthurns,28,,17,12,29
116 Feldthurns,29,,16,23,39
116 Feldthurns,30,,14,16,30
116 Feldthurns,31,,18,19,37
116 Feldthurns,32,,20,13,33
116 Feldthurns,33,,14,14,28
116 Feldthurns,34,,20,21,41
116 Feldthurns,35,,12,23,35
116 Feldthurns,36,,11,19,30
116 Feldthurns,37,,32,19,51
116 Feldthurns,38,,23,14,37
116 Feldthurns,39,,21,26,47
116 Feldthurns,40,,25,15,40
116 Feldthurns,41,,27,24,51
116 Feldthurns,42,,21,19,40
116 Feldthurns,43,,29,25,54
116 Feldthurns,44,,19,24,43
116 Feldthurns,45,,19,21,40
116 Feldthurns,46,,28,25,53
116 Feldthurns,47,,20,26,46
116 Feldthurns,48,,22,22,44
116 Feldthurns,49,,20,22,42
116 Feldthurns,50,,27,26,53
116 Feldthurns,51,,22,19,41
116 Feldthurns,52,,31,20,51
116 Feldthurns,53,,14,19,33
116 Feldthurns,54,,18,17,35
116 Feldthurns,55,,16,14,30
116 Feldthurns,56,,16,16,32
116 Feldthurns,57,,13,19,32
116 Feldthurns,58,,15,13,28
116 Feldthurns,59,,11,20,31
116 Feldthurns,60,,13,15,28
116 Feldthurns,61,,14,14,28
116 Feldthurns,62,,16,12,28
116 Feldthurns,63,,22,14,36
116 Feldthurns,64,,12,11,23
116 Feldthurns,65,,14,14,28
116 Feldthurns,66,,6,14,20
116 Feldthurns,67,,13,11,24
116 Feldthurns,68,,14,9,23
116 Feldthurns,69,,11,8,19
116 Feldthurns,70,,10,12,22
116 Feldthurns,71,,17,10,27
116 Feldthurns,72,,10,11,21
116 Feldthurns,73,,8,7,15
116 Feldthurns,74,,5,4,9
116 Feldthurns,75,,9,6,15
116 Feldthurns,76,,8,10,18
116 Feldthurns,77,,11,8,19
116 Feldthurns,78,,3,8,11
116 Feldthurns,79,,5,8,13
116 Feldthurns,80,,8,9,17
116 Feldthurns,81,,2,4,6
116 Feldthurns,82,,5,4,9
116 Feldthurns,83,,5,6,11
116 Feldthurns,84,,4,6,10
116 Feldthurns,85,,3,12,15
116 Feldthurns,86,,2,8,10
116 Feldthurns,87,,5,4,9
116 Feldthurns,88,,-,2,2
116 Feldthurns,89,,-,3,3
116 Feldthurns,90,,3,6,9
116 Feldthurns,91,,-,5,5
116 Feldthurns,92,,3,2,5
116 Feldthurns,93,,-,3,3
116 Feldthurns,94,,1,1,2
116 Feldthurns,95,,-,2,2
116 Feldthurns,96,,2,-,2
116 Feldthurns,99,,-,1,1
116 Feldthurns,101,,-,1,1
116 Feldthurns,Insgesamt,,1.432,1.387,2.819
117 Wengen,0,,7,7,14
117 Wengen,1,,6,10,16
117 Wengen,2,,9,8,17
117 Wengen,3,,12,11,23
117 Wengen,4,,12,3,15
117 Wengen,5,,12,16,28
117 Wengen,6,,7,7,14
117 Wengen,7,,7,9,16
117 Wengen,8,,10,11,21
117 Wengen,9,,8,12,20
117 Wengen,10,,10,5,15
117 Wengen,11,,5,9,14
117 Wengen,12,,5,6,11
117 Wengen,13,,10,4,14
117 Wengen,14,,5,10,15
117 Wengen,15,,8,6,14
117 Wengen,16,,9,5,14
117 Wengen,17,,7,8,15
117 Wengen,18,,12,10,22
117 Wengen,19,,10,8,18
117 Wengen,20,,11,8,19
117 Wengen,21,,12,7,19
117 Wengen,22,,10,6,16
117 Wengen,23,,10,7,17
117 Wengen,24,,19,9,28
117 Wengen,25,,13,7,20
117 Wengen,26,,4,8,12
117 Wengen,27,,6,16,22
117 Wengen,28,,10,4,14
117 Wengen,29,,8,6,14
117 Wengen,30,,8,4,12
117 Wengen,31,,14,9,23
117 Wengen,32,,12,4,16
117 Wengen,33,,13,9,22
117 Wengen,34,,7,6,13
117 Wengen,35,,9,16,25
117 Wengen,36,,13,4,17
117 Wengen,37,,5,9,14
117 Wengen,38,,8,7,15
117 Wengen,39,,6,6,12
117 Wengen,40,,18,11,29
117 Wengen,41,,12,5,17
117 Wengen,42,,16,9,25
117 Wengen,43,,13,12,25
117 Wengen,44,,12,14,26
117 Wengen,45,,13,14,27
117 Wengen,46,,7,9,16
117 Wengen,47,,16,9,25
117 Wengen,48,,11,13,24
117 Wengen,49,,12,5,17
117 Wengen,50,,8,11,19
117 Wengen,51,,11,7,18
117 Wengen,52,,14,13,27
117 Wengen,53,,14,7,21
117 Wengen,54,,7,10,17
117 Wengen,55,,10,12,22
117 Wengen,56,,7,6,13
117 Wengen,57,,6,7,13
117 Wengen,58,,6,11,17
117 Wengen,59,,4,6,10
117 Wengen,60,,7,6,13
117 Wengen,61,,9,6,15
117 Wengen,62,,6,2,8
117 Wengen,63,,4,6,10
117 Wengen,64,,8,5,13
117 Wengen,65,,2,6,8
117 Wengen,66,,4,8,12
117 Wengen,67,,1,11,12
117 Wengen,68,,6,3,9
117 Wengen,69,,5,4,9
117 Wengen,70,,5,3,8
117 Wengen,71,,6,8,14
117 Wengen,72,,3,6,9
117 Wengen,73,,7,7,14
117 Wengen,74,,4,4,8
117 Wengen,75,,5,6,11
117 Wengen,76,,6,4,10
117 Wengen,77,,5,3,8
117 Wengen,78,,7,7,14
117 Wengen,80,,2,6,8
117 Wengen,81,,2,6,8
117 Wengen,82,,3,2,5
117 Wengen,83,,1,4,5
117 Wengen,84,,4,1,5
117 Wengen,85,,3,2,5
117 Wengen,86,,2,7,9
117 Wengen,87,,1,2,3
117 Wengen,88,,1,-,1
117 Wengen,89,,1,-,1
117 Wengen,90,,-,3,3
117 Wengen,91,,-,2,2
117 Wengen,92,,-,2,2
117 Wengen,93,,2,1,3
117 Wengen,94,,-,5,5
117 Wengen,Insgesamt,,708,656,1.364
118 U.L.Frau i.W.-St.Felix,0,,5,10,15
118 U.L.Frau i.W.-St.Felix,1,,4,4,8
118 U.L.Frau i.W.-St.Felix,2,,5,2,7
118 U.L.Frau i.W.-St.Felix,3,,2,7,9
118 U.L.Frau i.W.-St.Felix,4,,2,2,4
118 U.L.Frau i.W.-St.Felix,5,,3,4,7
118 U.L.Frau i.W.-St.Felix,6,,5,3,8
118 U.L.Frau i.W.-St.Felix,7,,1,9,10
118 U.L.Frau i.W.-St.Felix,8,,3,-,3
118 U.L.Frau i.W.-St.Felix,9,,3,3,6
118 U.L.Frau i.W.-St.Felix,10,,5,7,12
118 U.L.Frau i.W.-St.Felix,11,,4,3,7
118 U.L.Frau i.W.-St.Felix,12,,8,6,14
118 U.L.Frau i.W.-St.Felix,13,,7,3,10
118 U.L.Frau i.W.-St.Felix,14,,9,5,14
118 U.L.Frau i.W.-St.Felix,15,,3,2,5
118 U.L.Frau i.W.-St.Felix,16,,5,5,10
118 U.L.Frau i.W.-St.Felix,17,,6,9,15
118 U.L.Frau i.W.-St.Felix,18,,5,4,9
118 U.L.Frau i.W.-St.Felix,19,,8,4,12
118 U.L.Frau i.W.-St.Felix,20,,3,10,13
118 U.L.Frau i.W.-St.Felix,21,,7,5,12
118 U.L.Frau i.W.-St.Felix,22,,9,5,14
118 U.L.Frau i.W.-St.Felix,23,,7,3,10
118 U.L.Frau i.W.-St.Felix,24,,8,7,15
118 U.L.Frau i.W.-St.Felix,25,,5,2,7
118 U.L.Frau i.W.-St.Felix,26,,6,5,11
118 U.L.Frau i.W.-St.Felix,27,,8,3,11
118 U.L.Frau i.W.-St.Felix,28,,4,7,11
118 U.L.Frau i.W.-St.Felix,29,,7,1,8
118 U.L.Frau i.W.-St.Felix,30,,7,2,9
118 U.L.Frau i.W.-St.Felix,31,,5,5,10
118 U.L.Frau i.W.-St.Felix,32,,1,9,10
118 U.L.Frau i.W.-St.Felix,33,,4,5,9
118 U.L.Frau i.W.-St.Felix,34,,5,1,6
118 U.L.Frau i.W.-St.Felix,35,,2,4,6
118 U.L.Frau i.W.-St.Felix,36,,1,3,4
118 U.L.Frau i.W.-St.Felix,37,,-,3,3
118 U.L.Frau i.W.-St.Felix,38,,5,3,8
118 U.L.Frau i.W.-St.Felix,39,,4,8,12
118 U.L.Frau i.W.-St.Felix,40,,8,1,9
118 U.L.Frau i.W.-St.Felix,41,,5,6,11
118 U.L.Frau i.W.-St.Felix,42,,2,2,4
118 U.L.Frau i.W.-St.Felix,43,,8,5,13
118 U.L.Frau i.W.-St.Felix,44,,4,4,8
118 U.L.Frau i.W.-St.Felix,45,,6,10,16
118 U.L.Frau i.W.-St.Felix,46,,7,4,11
118 U.L.Frau i.W.-St.Felix,47,,3,9,12
118 U.L.Frau i.W.-St.Felix,48,,3,4,7
118 U.L.Frau i.W.-St.Felix,49,,9,7,16
118 U.L.Frau i.W.-St.Felix,50,,9,6,15
118 U.L.Frau i.W.-St.Felix,51,,4,8,12
118 U.L.Frau i.W.-St.Felix,52,,16,8,24
118 U.L.Frau i.W.-St.Felix,53,,7,9,16
118 U.L.Frau i.W.-St.Felix,54,,4,4,8
118 U.L.Frau i.W.-St.Felix,55,,8,8,16
118 U.L.Frau i.W.-St.Felix,56,,5,4,9
118 U.L.Frau i.W.-St.Felix,57,,4,3,7
118 U.L.Frau i.W.-St.Felix,58,,3,6,9
118 U.L.Frau i.W.-St.Felix,59,,5,5,10
118 U.L.Frau i.W.-St.Felix,60,,3,4,7
118 U.L.Frau i.W.-St.Felix,61,,6,3,9
118 U.L.Frau i.W.-St.Felix,62,,2,3,5
118 U.L.Frau i.W.-St.Felix,63,,5,3,8
118 U.L.Frau i.W.-St.Felix,64,,6,3,9
118 U.L.Frau i.W.-St.Felix,65,,3,4,7
118 U.L.Frau i.W.-St.Felix,66,,4,-,4
118 U.L.Frau i.W.-St.Felix,67,,4,-,4
118 U.L.Frau i.W.-St.Felix,68,,1,7,8
118 U.L.Frau i.W.-St.Felix,69,,1,3,4
118 U.L.Frau i.W.-St.Felix,70,,3,1,4
118 U.L.Frau i.W.-St.Felix,71,,5,-,5
118 U.L.Frau i.W.-St.Felix,72,,5,4,9
118 U.L.Frau i.W.-St.Felix,73,,2,3,5
118 U.L.Frau i.W.-St.Felix,74,,4,7,11
118 U.L.Frau i.W.-St.Felix,75,,2,-,2
118 U.L.Frau i.W.-St.Felix,76,,1,3,4
118 U.L.Frau i.W.-St.Felix,77,,2,4,6
118 U.L.Frau i.W.-St.Felix,78,,3,-,3
118 U.L.Frau i.W.-St.Felix,79,,5,2,7
118 U.L.Frau i.W.-St.Felix,80,,3,4,7
118 U.L.Frau i.W.-St.Felix,81,,3,2,5
118 U.L.Frau i.W.-St.Felix,82,,3,3,6
118 U.L.Frau i.W.-St.Felix,83,,4,1,5
118 U.L.Frau i.W.-St.Felix,84,,2,-,2
118 U.L.Frau i.W.-St.Felix,85,,3,5,8
118 U.L.Frau i.W.-St.Felix,86,,-,3,3
118 U.L.Frau i.W.-St.Felix,87,,-,2,2
118 U.L.Frau i.W.-St.Felix,88,,2,3,5
118 U.L.Frau i.W.-St.Felix,89,,2,3,5
118 U.L.Frau i.W.-St.Felix,90,,-,3,3
118 U.L.Frau i.W.-St.Felix,91,,1,1,2
118 U.L.Frau i.W.-St.Felix,92,,1,3,4
118 U.L.Frau i.W.-St.Felix,98,,-,1,1
118 U.L.Frau i.W.-St.Felix,Insgesamt,,402,384,786
Insgesamt,,,257.404,264.427,521.831
