Gemeinde,Altersklassen,Geschlecht,Männer,Frauen,Insgesamt
001 Aldein,0,,13,7,20
001 Aldein,1,,12,5,17
001 Aldein,2,,13,7,20
001 Aldein,3,,6,11,17
001 Aldein,4,,14,4,18
001 Aldein,5,,2,10,12
001 Aldein,6,,10,4,14
001 Aldein,7,,12,8,20
001 Aldein,8,,7,9,16
001 Aldein,9,,7,11,18
001 Aldein,10,,8,12,20
001 Aldein,11,,8,14,22
001 Aldein,12,,10,8,18
001 Aldein,13,,17,9,26
001 Aldein,14,,17,10,27
001 Aldein,15,,14,7,21
001 Aldein,16,,17,8,25
001 Aldein,17,,13,4,17
001 Aldein,18,,16,15,31
001 Aldein,19,,12,18,30
001 Aldein,20,,16,7,23
001 Aldein,21,,8,7,15
001 Aldein,22,,9,12,21
001 Aldein,23,,11,7,18
001 Aldein,24,,14,13,27
001 Aldein,25,,8,11,19
001 Aldein,26,,5,5,10
001 Aldein,27,,6,5,11
001 Aldein,28,,10,12,22
001 Aldein,29,,10,4,14
001 Aldein,30,,9,6,15
001 Aldein,31,,7,3,10
001 Aldein,32,,13,11,24
001 Aldein,33,,7,6,13
001 Aldein,34,,7,10,17
001 Aldein,35,,10,11,21
001 Aldein,36,,10,13,23
001 Aldein,37,,7,12,19
001 Aldein,38,,12,13,25
001 Aldein,39,,10,8,18
001 Aldein,40,,8,20,28
001 Aldein,41,,8,12,20
001 Aldein,42,,16,10,26
001 Aldein,43,,14,11,25
001 Aldein,44,,13,10,23
001 Aldein,45,,16,7,23
001 Aldein,46,,16,15,31
001 Aldein,47,,14,15,29
001 Aldein,48,,18,8,26
001 Aldein,49,,12,16,28
001 Aldein,50,,6,14,20
001 Aldein,51,,7,19,26
001 Aldein,52,,16,10,26
001 Aldein,53,,16,10,26
001 Aldein,54,,13,6,19
001 Aldein,55,,9,18,27
001 Aldein,56,,17,14,31
001 Aldein,57,,14,9,23
001 Aldein,58,,10,12,22
001 Aldein,59,,7,4,11
001 Aldein,60,,10,10,20
001 Aldein,61,,6,7,13
001 Aldein,62,,9,9,18
001 Aldein,63,,9,7,16
001 Aldein,64,,9,10,19
001 Aldein,65,,7,4,11
001 Aldein,66,,14,10,24
001 Aldein,67,,5,12,17
001 Aldein,68,,9,6,15
001 Aldein,69,,9,8,17
001 Aldein,70,,4,11,15
001 Aldein,71,,6,10,16
001 Aldein,72,,6,5,11
001 Aldein,73,,4,6,10
001 Aldein,74,,8,9,17
001 Aldein,75,,6,9,15
001 Aldein,76,,5,11,16
001 Aldein,77,,4,8,12
001 Aldein,78,,4,9,13
001 Aldein,79,,7,7,14
001 Aldein,80,,5,7,12
001 Aldein,81,,4,3,7
001 Aldein,82,,4,3,7
001 Aldein,83,,6,3,9
001 Aldein,84,,3,2,5
001 Aldein,85,,2,3,5
001 Aldein,86,,3,1,4
001 Aldein,87,,1,1,2
001 Aldein,88,,5,6,11
001 Aldein,89,,1,1,2
001 Aldein,90,,3,3,6
001 Aldein,91,,-,1,1
001 Aldein,92,,1,3,4
001 Aldein,93,,-,2,2
001 Aldein,94,,1,2,3
001 Aldein,95,,-,2,2
001 Aldein,96,,-,1,1
002 Andrian,0,,7,7,14
002 Andrian,1,,1,5,6
002 Andrian,2,,3,3,6
002 Andrian,3,,9,4,13
002 Andrian,4,,5,4,9
002 Andrian,5,,9,4,13
002 Andrian,6,,8,5,13
002 Andrian,7,,8,6,14
002 Andrian,8,,7,11,18
002 Andrian,9,,4,5,9
002 Andrian,10,,5,6,11
002 Andrian,11,,8,3,11
002 Andrian,12,,5,6,11
002 Andrian,13,,9,4,13
002 Andrian,14,,6,10,16
002 Andrian,15,,3,3,6
002 Andrian,16,,3,2,5
002 Andrian,17,,6,4,10
002 Andrian,18,,3,5,8
002 Andrian,19,,9,1,10
002 Andrian,20,,9,7,16
002 Andrian,21,,2,11,13
002 Andrian,22,,8,4,12
002 Andrian,23,,5,3,8
002 Andrian,24,,4,6,10
002 Andrian,25,,7,6,13
002 Andrian,26,,4,10,14
002 Andrian,27,,8,4,12
002 Andrian,28,,5,4,9
002 Andrian,29,,9,6,15
002 Andrian,30,,7,5,12
002 Andrian,31,,8,7,15
002 Andrian,32,,2,4,6
002 Andrian,33,,6,5,11
002 Andrian,34,,6,4,10
002 Andrian,35,,8,11,19
002 Andrian,36,,6,4,10
002 Andrian,37,,5,5,10
002 Andrian,38,,6,7,13
002 Andrian,39,,7,5,12
002 Andrian,40,,8,11,19
002 Andrian,41,,9,10,19
002 Andrian,42,,9,4,13
002 Andrian,43,,5,10,15
002 Andrian,44,,10,9,19
002 Andrian,45,,9,9,18
002 Andrian,46,,9,10,19
002 Andrian,47,,10,6,16
002 Andrian,48,,8,8,16
002 Andrian,49,,10,10,20
002 Andrian,50,,10,8,18
002 Andrian,51,,9,10,19
002 Andrian,52,,13,8,21
002 Andrian,53,,8,6,14
002 Andrian,54,,8,16,24
002 Andrian,55,,10,7,17
002 Andrian,56,,9,4,13
002 Andrian,57,,8,5,13
002 Andrian,58,,7,4,11
002 Andrian,59,,8,10,18
002 Andrian,60,,6,7,13
002 Andrian,61,,6,10,16
002 Andrian,62,,3,3,6
002 Andrian,63,,5,2,7
002 Andrian,64,,7,7,14
002 Andrian,65,,2,3,5
002 Andrian,66,,4,3,7
002 Andrian,67,,6,5,11
002 Andrian,68,,3,2,5
002 Andrian,69,,2,5,7
002 Andrian,70,,6,4,10
002 Andrian,71,,8,8,16
002 Andrian,72,,1,2,3
002 Andrian,73,,1,4,5
002 Andrian,74,,6,7,13
002 Andrian,75,,2,3,5
002 Andrian,76,,5,4,9
002 Andrian,77,,2,6,8
002 Andrian,78,,1,6,7
002 Andrian,79,,3,3,6
002 Andrian,80,,3,3,6
002 Andrian,81,,2,4,6
002 Andrian,82,,3,2,5
002 Andrian,83,,5,1,6
002 Andrian,84,,2,2,4
002 Andrian,85,,4,2,6
002 Andrian,86,,-,2,2
002 Andrian,87,,2,1,3
002 Andrian,88,,2,1,3
002 Andrian,89,,1,1,2
002 Andrian,90,,-,2,2
002 Andrian,91,,1,1,2
002 Andrian,92,,-,2,2
002 Andrian,93,,-,1,1
002 Andrian,96,,-,2,2
002 Andrian,103,,-,1,1
003 Altrei,0,,4,3,7
003 Altrei,1,,-,2,2
003 Altrei,2,,5,2,7
003 Altrei,3,,2,6,8
003 Altrei,4,,2,2,4
003 Altrei,5,,3,3,6
003 Altrei,6,,-,2,2
003 Altrei,8,,2,2,4
003 Altrei,9,,3,4,7
003 Altrei,10,,6,4,10
003 Altrei,11,,2,-,2
003 Altrei,12,,4,2,6
003 Altrei,13,,2,1,3
003 Altrei,14,,-,1,1
003 Altrei,15,,2,1,3
003 Altrei,16,,4,1,5
003 Altrei,17,,1,2,3
003 Altrei,18,,3,-,3
003 Altrei,19,,3,1,4
003 Altrei,20,,-,1,1
003 Altrei,21,,-,3,3
003 Altrei,22,,1,2,3
003 Altrei,23,,3,1,4
003 Altrei,24,,2,-,2
003 Altrei,25,,7,1,8
003 Altrei,26,,-,1,1
003 Altrei,27,,2,2,4
003 Altrei,28,,1,2,3
003 Altrei,29,,2,6,8
003 Altrei,30,,2,3,5
003 Altrei,31,,1,2,3
003 Altrei,32,,4,1,5
003 Altrei,33,,3,3,6
003 Altrei,34,,5,1,6
003 Altrei,35,,2,2,4
003 Altrei,36,,1,2,3
003 Altrei,37,,1,3,4
003 Altrei,38,,1,3,4
003 Altrei,39,,3,4,7
003 Altrei,40,,-,2,2
003 Altrei,41,,2,4,6
003 Altrei,42,,2,2,4
003 Altrei,43,,1,-,1
003 Altrei,44,,1,4,5
003 Altrei,45,,3,1,4
003 Altrei,46,,4,3,7
003 Altrei,47,,2,3,5
003 Altrei,48,,3,5,8
003 Altrei,49,,-,4,4
003 Altrei,50,,3,1,4
003 Altrei,51,,2,4,6
003 Altrei,52,,3,4,7
003 Altrei,53,,3,6,9
003 Altrei,54,,3,3,6
003 Altrei,55,,10,2,12
003 Altrei,56,,2,3,5
003 Altrei,57,,4,2,6
003 Altrei,58,,5,4,9
003 Altrei,59,,2,4,6
003 Altrei,60,,1,2,3
003 Altrei,61,,5,1,6
003 Altrei,62,,3,3,6
003 Altrei,63,,2,-,2
003 Altrei,64,,2,2,4
003 Altrei,65,,6,2,8
003 Altrei,66,,3,3,6
003 Altrei,67,,-,3,3
003 Altrei,68,,1,-,1
003 Altrei,69,,2,2,4
003 Altrei,70,,3,2,5
003 Altrei,71,,2,2,4
003 Altrei,72,,3,1,4
003 Altrei,73,,1,2,3
003 Altrei,74,,2,3,5
003 Altrei,75,,3,1,4
003 Altrei,76,,1,3,4
003 Altrei,77,,3,3,6
003 Altrei,78,,1,2,3
003 Altrei,79,,-,1,1
003 Altrei,80,,2,1,3
003 Altrei,81,,4,1,5
003 Altrei,82,,1,1,2
003 Altrei,83,,-,2,2
003 Altrei,84,,2,2,4
003 Altrei,85,,-,2,2
003 Altrei,86,,-,1,1
003 Altrei,87,,-,1,1
003 Altrei,88,,-,2,2
003 Altrei,89,,-,1,1
003 Altrei,90,,-,1,1
003 Altrei,93,,-,1,1
003 Altrei,95,,-,1,1
004 Eppan a.d. Weinstr.,0,,72,75,147
004 Eppan a.d. Weinstr.,1,,79,71,150
004 Eppan a.d. Weinstr.,2,,68,85,153
004 Eppan a.d. Weinstr.,3,,85,79,164
004 Eppan a.d. Weinstr.,4,,76,73,149
004 Eppan a.d. Weinstr.,5,,91,87,178
004 Eppan a.d. Weinstr.,6,,86,83,169
004 Eppan a.d. Weinstr.,7,,81,76,157
004 Eppan a.d. Weinstr.,8,,81,63,144
004 Eppan a.d. Weinstr.,9,,81,97,178
004 Eppan a.d. Weinstr.,10,,76,66,142
004 Eppan a.d. Weinstr.,11,,105,83,188
004 Eppan a.d. Weinstr.,12,,90,106,196
004 Eppan a.d. Weinstr.,13,,89,67,156
004 Eppan a.d. Weinstr.,14,,92,68,160
004 Eppan a.d. Weinstr.,15,,74,80,154
004 Eppan a.d. Weinstr.,16,,81,81,162
004 Eppan a.d. Weinstr.,17,,78,84,162
004 Eppan a.d. Weinstr.,18,,93,67,160
004 Eppan a.d. Weinstr.,19,,88,85,173
004 Eppan a.d. Weinstr.,20,,70,72,142
004 Eppan a.d. Weinstr.,21,,82,77,159
004 Eppan a.d. Weinstr.,22,,81,76,157
004 Eppan a.d. Weinstr.,23,,86,84,170
004 Eppan a.d. Weinstr.,24,,85,99,184
004 Eppan a.d. Weinstr.,25,,81,83,164
004 Eppan a.d. Weinstr.,26,,90,74,164
004 Eppan a.d. Weinstr.,27,,101,74,175
004 Eppan a.d. Weinstr.,28,,83,77,160
004 Eppan a.d. Weinstr.,29,,92,85,177
004 Eppan a.d. Weinstr.,30,,80,75,155
004 Eppan a.d. Weinstr.,31,,100,86,186
004 Eppan a.d. Weinstr.,32,,98,80,178
004 Eppan a.d. Weinstr.,33,,98,96,194
004 Eppan a.d. Weinstr.,34,,80,94,174
004 Eppan a.d. Weinstr.,35,,98,98,196
004 Eppan a.d. Weinstr.,36,,74,102,176
004 Eppan a.d. Weinstr.,37,,98,101,199
004 Eppan a.d. Weinstr.,38,,93,90,183
004 Eppan a.d. Weinstr.,39,,107,100,207
004 Eppan a.d. Weinstr.,40,,102,91,193
004 Eppan a.d. Weinstr.,41,,90,92,182
004 Eppan a.d. Weinstr.,42,,110,109,219
004 Eppan a.d. Weinstr.,43,,101,116,217
004 Eppan a.d. Weinstr.,44,,117,109,226
004 Eppan a.d. Weinstr.,45,,105,128,233
004 Eppan a.d. Weinstr.,46,,128,115,243
004 Eppan a.d. Weinstr.,47,,136,120,256
004 Eppan a.d. Weinstr.,48,,144,129,273
004 Eppan a.d. Weinstr.,49,,119,117,236
004 Eppan a.d. Weinstr.,50,,113,136,249
004 Eppan a.d. Weinstr.,51,,115,145,260
004 Eppan a.d. Weinstr.,52,,117,117,234
004 Eppan a.d. Weinstr.,53,,129,121,250
004 Eppan a.d. Weinstr.,54,,103,117,220
004 Eppan a.d. Weinstr.,55,,124,122,246
004 Eppan a.d. Weinstr.,56,,132,100,232
004 Eppan a.d. Weinstr.,57,,103,128,231
004 Eppan a.d. Weinstr.,58,,105,100,205
004 Eppan a.d. Weinstr.,59,,92,103,195
004 Eppan a.d. Weinstr.,60,,97,94,191
004 Eppan a.d. Weinstr.,61,,87,80,167
004 Eppan a.d. Weinstr.,62,,86,86,172
004 Eppan a.d. Weinstr.,63,,70,92,162
004 Eppan a.d. Weinstr.,64,,84,86,170
004 Eppan a.d. Weinstr.,65,,64,83,147
004 Eppan a.d. Weinstr.,66,,78,63,141
004 Eppan a.d. Weinstr.,67,,63,74,137
004 Eppan a.d. Weinstr.,68,,61,52,113
004 Eppan a.d. Weinstr.,69,,68,70,138
004 Eppan a.d. Weinstr.,70,,55,76,131
004 Eppan a.d. Weinstr.,71,,74,68,142
004 Eppan a.d. Weinstr.,72,,49,52,101
004 Eppan a.d. Weinstr.,73,,63,69,132
004 Eppan a.d. Weinstr.,74,,84,77,161
004 Eppan a.d. Weinstr.,75,,75,75,150
004 Eppan a.d. Weinstr.,76,,48,94,142
004 Eppan a.d. Weinstr.,77,,61,49,110
004 Eppan a.d. Weinstr.,78,,57,78,135
004 Eppan a.d. Weinstr.,79,,40,47,87
004 Eppan a.d. Weinstr.,80,,34,47,81
004 Eppan a.d. Weinstr.,81,,38,33,71
004 Eppan a.d. Weinstr.,82,,24,36,60
004 Eppan a.d. Weinstr.,83,,23,42,65
004 Eppan a.d. Weinstr.,84,,34,43,77
004 Eppan a.d. Weinstr.,85,,30,36,66
004 Eppan a.d. Weinstr.,86,,16,39,55
004 Eppan a.d. Weinstr.,87,,19,43,62
004 Eppan a.d. Weinstr.,88,,12,31,43
004 Eppan a.d. Weinstr.,89,,17,23,40
004 Eppan a.d. Weinstr.,90,,8,24,32
004 Eppan a.d. Weinstr.,91,,9,29,38
004 Eppan a.d. Weinstr.,92,,7,21,28
004 Eppan a.d. Weinstr.,93,,4,19,23
004 Eppan a.d. Weinstr.,94,,3,18,21
004 Eppan a.d. Weinstr.,95,,1,11,12
004 Eppan a.d. Weinstr.,96,,3,7,10
004 Eppan a.d. Weinstr.,97,,1,3,4
004 Eppan a.d. Weinstr.,98,,-,4,4
004 Eppan a.d. Weinstr.,99,,-,2,2
004 Eppan a.d. Weinstr.,100,,-,1,1
005 Hafling,0,,4,4,8
005 Hafling,1,,4,4,8
005 Hafling,2,,2,6,8
005 Hafling,3,,5,4,9
005 Hafling,4,,4,8,12
005 Hafling,5,,4,3,7
005 Hafling,6,,2,4,6
005 Hafling,7,,3,4,7
005 Hafling,8,,2,8,10
005 Hafling,9,,5,4,9
005 Hafling,10,,3,2,5
005 Hafling,11,,6,5,11
005 Hafling,12,,3,2,5
005 Hafling,13,,1,6,7
005 Hafling,14,,-,4,4
005 Hafling,15,,5,1,6
005 Hafling,16,,5,3,8
005 Hafling,17,,4,9,13
005 Hafling,18,,6,3,9
005 Hafling,19,,3,7,10
005 Hafling,20,,1,9,10
005 Hafling,21,,12,5,17
005 Hafling,22,,7,3,10
005 Hafling,23,,4,6,10
005 Hafling,24,,3,8,11
005 Hafling,25,,3,4,7
005 Hafling,26,,6,2,8
005 Hafling,27,,4,5,9
005 Hafling,28,,5,2,7
005 Hafling,29,,2,4,6
005 Hafling,30,,3,7,10
005 Hafling,31,,5,1,6
005 Hafling,32,,3,4,7
005 Hafling,33,,2,11,13
005 Hafling,34,,3,1,4
005 Hafling,35,,5,2,7
005 Hafling,36,,6,9,15
005 Hafling,37,,7,11,18
005 Hafling,38,,4,5,9
005 Hafling,39,,5,6,11
005 Hafling,40,,4,5,9
005 Hafling,41,,7,7,14
005 Hafling,42,,7,4,11
005 Hafling,43,,10,6,16
005 Hafling,44,,11,4,15
005 Hafling,45,,8,1,9
005 Hafling,46,,11,6,17
005 Hafling,47,,7,11,18
005 Hafling,48,,6,12,18
005 Hafling,49,,4,10,14
005 Hafling,50,,6,2,8
005 Hafling,51,,11,6,17
005 Hafling,52,,8,11,19
005 Hafling,53,,3,2,5
005 Hafling,54,,8,4,12
005 Hafling,55,,6,4,10
005 Hafling,56,,8,5,13
005 Hafling,57,,10,7,17
005 Hafling,58,,6,5,11
005 Hafling,59,,3,4,7
005 Hafling,60,,2,5,7
005 Hafling,61,,3,8,11
005 Hafling,62,,6,2,8
005 Hafling,63,,3,1,4
005 Hafling,64,,2,3,5
005 Hafling,65,,7,2,9
005 Hafling,66,,2,3,5
005 Hafling,67,,5,5,10
005 Hafling,68,,4,4,8
005 Hafling,69,,6,2,8
005 Hafling,70,,2,2,4
005 Hafling,71,,1,3,4
005 Hafling,72,,2,3,5
005 Hafling,73,,2,2,4
005 Hafling,74,,4,4,8
005 Hafling,75,,5,3,8
005 Hafling,76,,3,4,7
005 Hafling,77,,1,1,2
005 Hafling,78,,4,3,7
005 Hafling,79,,1,-,1
005 Hafling,80,,2,1,3
005 Hafling,81,,-,1,1
005 Hafling,82,,1,2,3
005 Hafling,83,,1,1,2
005 Hafling,84,,5,1,6
005 Hafling,85,,2,1,3
005 Hafling,86,,1,2,3
005 Hafling,87,,1,3,4
005 Hafling,88,,1,1,2
005 Hafling,89,,-,1,1
005 Hafling,90,,-,2,2
005 Hafling,91,,-,2,2
005 Hafling,93,,1,-,1
005 Hafling,95,,-,1,1
006 Abtei,0,,24,10,34
006 Abtei,1,,16,16,32
006 Abtei,2,,14,23,37
006 Abtei,3,,26,14,40
006 Abtei,4,,11,21,32
006 Abtei,5,,21,15,36
006 Abtei,6,,20,13,33
006 Abtei,7,,24,17,41
006 Abtei,8,,22,19,41
006 Abtei,9,,27,20,47
006 Abtei,10,,27,21,48
006 Abtei,11,,29,22,51
006 Abtei,12,,20,27,47
006 Abtei,13,,29,12,41
006 Abtei,14,,20,19,39
006 Abtei,15,,13,31,44
006 Abtei,16,,24,23,47
006 Abtei,17,,23,31,54
006 Abtei,18,,21,26,47
006 Abtei,19,,13,15,28
006 Abtei,20,,27,21,48
006 Abtei,21,,26,15,41
006 Abtei,22,,24,25,49
006 Abtei,23,,18,16,34
006 Abtei,24,,16,18,34
006 Abtei,25,,23,16,39
006 Abtei,26,,21,16,37
006 Abtei,27,,24,17,41
006 Abtei,28,,15,20,35
006 Abtei,29,,19,10,29
006 Abtei,30,,20,16,36
006 Abtei,31,,23,21,44
006 Abtei,32,,15,17,32
006 Abtei,33,,14,19,33
006 Abtei,34,,13,16,29
006 Abtei,35,,23,13,36
006 Abtei,36,,23,15,38
006 Abtei,37,,26,18,44
006 Abtei,38,,17,29,46
006 Abtei,39,,21,37,58
006 Abtei,40,,26,34,60
006 Abtei,41,,25,27,52
006 Abtei,42,,17,33,50
006 Abtei,43,,20,31,51
006 Abtei,44,,26,22,48
006 Abtei,45,,44,32,76
006 Abtei,46,,17,32,49
006 Abtei,47,,28,36,64
006 Abtei,48,,27,30,57
006 Abtei,49,,29,34,63
006 Abtei,50,,35,37,72
006 Abtei,51,,25,29,54
006 Abtei,52,,34,23,57
006 Abtei,53,,27,36,63
006 Abtei,54,,30,30,60
006 Abtei,55,,26,29,55
006 Abtei,56,,27,27,54
006 Abtei,57,,26,25,51
006 Abtei,58,,28,23,51
006 Abtei,59,,18,21,39
006 Abtei,60,,18,16,34
006 Abtei,61,,20,16,36
006 Abtei,62,,17,15,32
006 Abtei,63,,12,15,27
006 Abtei,64,,12,20,32
006 Abtei,65,,9,14,23
006 Abtei,66,,10,10,20
006 Abtei,67,,12,19,31
006 Abtei,68,,10,18,28
006 Abtei,69,,21,16,37
006 Abtei,70,,15,15,30
006 Abtei,71,,22,17,39
006 Abtei,72,,16,18,34
006 Abtei,73,,10,14,24
006 Abtei,74,,9,13,22
006 Abtei,75,,19,11,30
006 Abtei,76,,12,17,29
006 Abtei,77,,13,16,29
006 Abtei,78,,12,12,24
006 Abtei,79,,15,15,30
006 Abtei,80,,5,14,19
006 Abtei,81,,11,9,20
006 Abtei,82,,6,16,22
006 Abtei,83,,9,10,19
006 Abtei,84,,5,14,19
006 Abtei,85,,4,3,7
006 Abtei,86,,7,8,15
006 Abtei,87,,7,8,15
006 Abtei,88,,4,5,9
006 Abtei,89,,2,5,7
006 Abtei,90,,4,5,9
006 Abtei,91,,1,1,2
006 Abtei,92,,2,2,4
006 Abtei,93,,2,7,9
006 Abtei,94,,-,1,1
006 Abtei,95,,-,2,2
006 Abtei,97,,-,1,1
006 Abtei,101,,-,1,1
007 Barbian,0,,3,16,19
007 Barbian,1,,9,16,25
007 Barbian,2,,8,13,21
007 Barbian,3,,13,16,29
007 Barbian,4,,7,12,19
007 Barbian,5,,10,11,21
007 Barbian,6,,13,8,21
007 Barbian,7,,9,8,17
007 Barbian,8,,8,13,21
007 Barbian,9,,11,5,16
007 Barbian,10,,7,12,19
007 Barbian,11,,7,2,9
007 Barbian,12,,15,7,22
007 Barbian,13,,6,6,12
007 Barbian,14,,8,16,24
007 Barbian,15,,6,7,13
007 Barbian,16,,13,16,29
007 Barbian,17,,16,8,24
007 Barbian,18,,11,10,21
007 Barbian,19,,15,9,24
007 Barbian,20,,9,11,20
007 Barbian,21,,10,11,21
007 Barbian,22,,11,9,20
007 Barbian,23,,9,5,14
007 Barbian,24,,9,8,17
007 Barbian,25,,13,12,25
007 Barbian,26,,13,13,26
007 Barbian,27,,17,12,29
007 Barbian,28,,8,13,21
007 Barbian,29,,13,3,16
007 Barbian,30,,8,7,15
007 Barbian,31,,13,15,28
007 Barbian,32,,8,10,18
007 Barbian,33,,11,5,16
007 Barbian,34,,10,14,24
007 Barbian,35,,8,15,23
007 Barbian,36,,10,15,25
007 Barbian,37,,15,7,22
007 Barbian,38,,16,10,26
007 Barbian,39,,13,9,22
007 Barbian,40,,12,21,33
007 Barbian,41,,10,14,24
007 Barbian,42,,9,12,21
007 Barbian,43,,13,12,25
007 Barbian,44,,14,18,32
007 Barbian,45,,13,15,28
007 Barbian,46,,19,8,27
007 Barbian,47,,13,12,25
007 Barbian,48,,15,8,23
007 Barbian,49,,14,10,24
007 Barbian,50,,10,10,20
007 Barbian,51,,10,12,22
007 Barbian,52,,9,12,21
007 Barbian,53,,16,14,30
007 Barbian,54,,14,15,29
007 Barbian,55,,15,14,29
007 Barbian,56,,16,11,27
007 Barbian,57,,13,17,30
007 Barbian,58,,11,7,18
007 Barbian,59,,7,9,16
007 Barbian,60,,13,6,19
007 Barbian,61,,6,9,15
007 Barbian,62,,7,7,14
007 Barbian,63,,6,13,19
007 Barbian,64,,7,9,16
007 Barbian,65,,6,4,10
007 Barbian,66,,10,8,18
007 Barbian,67,,11,11,22
007 Barbian,68,,5,6,11
007 Barbian,69,,3,5,8
007 Barbian,70,,5,6,11
007 Barbian,71,,15,6,21
007 Barbian,72,,3,6,9
007 Barbian,73,,9,9,18
007 Barbian,74,,9,5,14
007 Barbian,75,,11,9,20
007 Barbian,76,,8,12,20
007 Barbian,77,,9,3,12
007 Barbian,78,,5,3,8
007 Barbian,79,,5,9,14
007 Barbian,80,,8,9,17
007 Barbian,81,,3,3,6
007 Barbian,82,,1,4,5
007 Barbian,83,,4,5,9
007 Barbian,84,,4,3,7
007 Barbian,85,,4,5,9
007 Barbian,86,,1,5,6
007 Barbian,87,,1,3,4
007 Barbian,88,,2,3,5
007 Barbian,89,,3,3,6
007 Barbian,90,,1,-,1
007 Barbian,91,,1,1,2
007 Barbian,92,,2,-,2
007 Barbian,95,,-,1,1
008 Bozen,0,,465,422,887
008 Bozen,1,,508,459,967
008 Bozen,2,,489,471,960
008 Bozen,3,,513,513,1.026
008 Bozen,4,,502,474,976
008 Bozen,5,,519,472,991
008 Bozen,6,,499,515,1.014
008 Bozen,7,,521,498,1.019
008 Bozen,8,,539,488,1.027
008 Bozen,9,,545,526,1.071
008 Bozen,10,,588,500,1.088
008 Bozen,11,,502,533,1.035
008 Bozen,12,,561,502,1.063
008 Bozen,13,,578,525,1.103
008 Bozen,14,,562,541,1.103
008 Bozen,15,,574,483,1.057
008 Bozen,16,,556,494,1.050
008 Bozen,17,,505,537,1.042
008 Bozen,18,,578,522,1.100
008 Bozen,19,,582,509,1.091
008 Bozen,20,,567,494,1.061
008 Bozen,21,,556,542,1.098
008 Bozen,22,,548,502,1.050
008 Bozen,23,,581,540,1.121
008 Bozen,24,,549,533,1.082
008 Bozen,25,,600,521,1.121
008 Bozen,26,,640,547,1.187
008 Bozen,27,,647,554,1.201
008 Bozen,28,,582,568,1.150
008 Bozen,29,,625,564,1.189
008 Bozen,30,,539,577,1.116
008 Bozen,31,,607,588,1.195
008 Bozen,32,,609,588,1.197
008 Bozen,33,,591,632,1.223
008 Bozen,34,,645,574,1.219
008 Bozen,35,,638,588,1.226
008 Bozen,36,,647,601,1.248
008 Bozen,37,,655,620,1.275
008 Bozen,38,,615,636,1.251
008 Bozen,39,,633,659,1.292
008 Bozen,40,,669,664,1.333
008 Bozen,41,,681,715,1.396
008 Bozen,42,,729,751,1.480
008 Bozen,43,,787,805,1.592
008 Bozen,44,,739,841,1.580
008 Bozen,45,,836,869,1.705
008 Bozen,46,,863,923,1.786
008 Bozen,47,,858,850,1.708
008 Bozen,48,,891,884,1.775
008 Bozen,49,,837,839,1.676
008 Bozen,50,,798,898,1.696
008 Bozen,51,,865,931,1.796
008 Bozen,52,,899,928,1.827
008 Bozen,53,,888,923,1.811
008 Bozen,54,,745,874,1.619
008 Bozen,55,,750,809,1.559
008 Bozen,56,,722,764,1.486
008 Bozen,57,,687,746,1.433
008 Bozen,58,,679,729,1.408
008 Bozen,59,,657,715,1.372
008 Bozen,60,,587,726,1.313
008 Bozen,61,,589,682,1.271
008 Bozen,62,,557,638,1.195
008 Bozen,63,,553,610,1.163
008 Bozen,64,,513,617,1.130
008 Bozen,65,,474,625,1.099
008 Bozen,66,,493,603,1.096
008 Bozen,67,,483,655,1.138
008 Bozen,68,,515,626,1.141
008 Bozen,69,,558,681,1.239
008 Bozen,70,,535,756,1.291
008 Bozen,71,,593,819,1.412
008 Bozen,72,,448,545,993
008 Bozen,73,,477,663,1.140
008 Bozen,74,,505,662,1.167
008 Bozen,75,,523,636,1.159
008 Bozen,76,,553,667,1.220
008 Bozen,77,,521,652,1.173
008 Bozen,78,,470,634,1.104
008 Bozen,79,,442,572,1.014
008 Bozen,80,,396,484,880
008 Bozen,81,,328,463,791
008 Bozen,82,,302,464,766
008 Bozen,83,,305,454,759
008 Bozen,84,,247,433,680
008 Bozen,85,,241,382,623
008 Bozen,86,,232,368,600
008 Bozen,87,,198,338,536
008 Bozen,88,,118,302,420
008 Bozen,89,,134,262,396
008 Bozen,90,,102,233,335
008 Bozen,91,,103,182,285
008 Bozen,92,,67,169,236
008 Bozen,93,,42,125,167
008 Bozen,94,,40,137,177
008 Bozen,95,,24,110,134
008 Bozen,96,,20,70,90
008 Bozen,97,,17,53,70
008 Bozen,98,,3,37,40
008 Bozen,99,,3,11,14
008 Bozen,100,,2,7,9
008 Bozen,101,,-,7,7
008 Bozen,102,,-,4,4
008 Bozen,103,,1,2,3
008 Bozen,104,,-,1,1
008 Bozen,105,,-,1,1
009 Prags,0,,-,3,3
009 Prags,1,,2,7,9
009 Prags,2,,4,2,6
009 Prags,3,,3,3,6
009 Prags,4,,4,1,5
009 Prags,5,,2,2,4
009 Prags,6,,5,2,7
009 Prags,7,,3,4,7
009 Prags,8,,1,2,3
009 Prags,9,,4,6,10
009 Prags,10,,3,6,9
009 Prags,11,,4,2,6
009 Prags,12,,3,1,4
009 Prags,13,,2,3,5
009 Prags,14,,2,5,7
009 Prags,15,,2,6,8
009 Prags,16,,7,5,12
009 Prags,17,,2,3,5
009 Prags,18,,5,9,14
009 Prags,19,,2,4,6
009 Prags,20,,3,5,8
009 Prags,21,,3,7,10
009 Prags,22,,3,1,4
009 Prags,23,,4,5,9
009 Prags,24,,7,3,10
009 Prags,25,,7,3,10
009 Prags,26,,6,2,8
009 Prags,27,,3,2,5
009 Prags,28,,6,5,11
009 Prags,29,,2,4,6
009 Prags,30,,3,2,5
009 Prags,31,,5,4,9
009 Prags,32,,7,2,9
009 Prags,33,,3,3,6
009 Prags,34,,4,5,9
009 Prags,35,,3,4,7
009 Prags,36,,2,6,8
009 Prags,37,,5,1,6
009 Prags,38,,2,3,5
009 Prags,39,,5,6,11
009 Prags,40,,3,2,5
009 Prags,41,,6,3,9
009 Prags,42,,4,5,9
009 Prags,43,,2,5,7
009 Prags,44,,8,4,12
009 Prags,45,,3,3,6
009 Prags,46,,4,4,8
009 Prags,47,,6,6,12
009 Prags,48,,9,4,13
009 Prags,49,,8,8,16
009 Prags,50,,7,6,13
009 Prags,51,,8,5,13
009 Prags,52,,6,6,12
009 Prags,53,,5,3,8
009 Prags,54,,7,5,12
009 Prags,55,,3,5,8
009 Prags,56,,5,12,17
009 Prags,57,,5,3,8
009 Prags,58,,10,5,15
009 Prags,59,,4,2,6
009 Prags,60,,6,4,10
009 Prags,61,,1,6,7
009 Prags,62,,4,5,9
009 Prags,63,,6,4,10
009 Prags,64,,3,-,3
009 Prags,65,,2,6,8
009 Prags,66,,3,1,4
009 Prags,67,,4,1,5
009 Prags,68,,1,1,2
009 Prags,69,,3,1,4
009 Prags,70,,1,-,1
009 Prags,71,,2,4,6
009 Prags,72,,2,2,4
009 Prags,73,,4,4,8
009 Prags,74,,1,3,4
009 Prags,75,,4,4,8
009 Prags,76,,4,3,7
009 Prags,77,,1,2,3
009 Prags,78,,3,4,7
009 Prags,79,,1,2,3
009 Prags,80,,-,2,2
009 Prags,81,,1,3,4
009 Prags,82,,1,3,4
009 Prags,83,,-,2,2
009 Prags,84,,3,1,4
009 Prags,85,,1,3,4
009 Prags,86,,-,2,2
009 Prags,89,,-,1,1
009 Prags,90,,1,3,4
009 Prags,91,,1,4,5
009 Prags,92,,-,3,3
009 Prags,93,,1,-,1
009 Prags,95,,1,1,2
010 Brenner,0,,12,11,23
010 Brenner,1,,11,11,22
010 Brenner,2,,11,10,21
010 Brenner,3,,11,12,23
010 Brenner,4,,14,11,25
010 Brenner,5,,7,5,12
010 Brenner,6,,11,20,31
010 Brenner,7,,9,16,25
010 Brenner,8,,12,7,19
010 Brenner,9,,10,17,27
010 Brenner,10,,14,12,26
010 Brenner,11,,8,12,20
010 Brenner,12,,12,9,21
010 Brenner,13,,9,16,25
010 Brenner,14,,11,9,20
010 Brenner,15,,15,13,28
010 Brenner,16,,10,6,16
010 Brenner,17,,16,12,28
010 Brenner,18,,8,16,24
010 Brenner,19,,16,7,23
010 Brenner,20,,17,7,24
010 Brenner,21,,7,12,19
010 Brenner,22,,6,13,19
010 Brenner,23,,26,15,41
010 Brenner,24,,17,6,23
010 Brenner,25,,15,11,26
010 Brenner,26,,13,18,31
010 Brenner,27,,17,17,34
010 Brenner,28,,15,6,21
010 Brenner,29,,16,11,27
010 Brenner,30,,17,14,31
010 Brenner,31,,10,13,23
010 Brenner,32,,18,11,29
010 Brenner,33,,16,14,30
010 Brenner,34,,15,13,28
010 Brenner,35,,16,10,26
010 Brenner,36,,12,16,28
010 Brenner,37,,14,12,26
010 Brenner,38,,15,17,32
010 Brenner,39,,16,11,27
010 Brenner,40,,22,13,35
010 Brenner,41,,13,7,20
010 Brenner,42,,19,20,39
010 Brenner,43,,16,7,23
010 Brenner,44,,17,10,27
010 Brenner,45,,15,24,39
010 Brenner,46,,21,15,36
010 Brenner,47,,18,13,31
010 Brenner,48,,14,19,33
010 Brenner,49,,13,17,30
010 Brenner,50,,18,15,33
010 Brenner,51,,19,17,36
010 Brenner,52,,23,16,39
010 Brenner,53,,19,15,34
010 Brenner,54,,13,19,32
010 Brenner,55,,14,14,28
010 Brenner,56,,17,12,29
010 Brenner,57,,19,17,36
010 Brenner,58,,12,14,26
010 Brenner,59,,15,10,25
010 Brenner,60,,15,18,33
010 Brenner,61,,18,14,32
010 Brenner,62,,12,9,21
010 Brenner,63,,9,11,20
010 Brenner,64,,8,13,21
010 Brenner,65,,16,7,23
010 Brenner,66,,12,11,23
010 Brenner,67,,9,14,23
010 Brenner,68,,12,13,25
010 Brenner,69,,7,7,14
010 Brenner,70,,18,10,28
010 Brenner,71,,8,15,23
010 Brenner,72,,4,7,11
010 Brenner,73,,15,11,26
010 Brenner,74,,13,12,25
010 Brenner,75,,8,10,18
010 Brenner,76,,8,12,20
010 Brenner,77,,9,11,20
010 Brenner,78,,6,9,15
010 Brenner,79,,6,13,19
010 Brenner,80,,6,12,18
010 Brenner,81,,8,6,14
010 Brenner,82,,2,5,7
010 Brenner,83,,6,4,10
010 Brenner,84,,1,4,5
010 Brenner,85,,-,3,3
010 Brenner,86,,5,6,11
010 Brenner,87,,4,6,10
010 Brenner,88,,4,5,9
010 Brenner,89,,3,4,7
010 Brenner,90,,4,2,6
010 Brenner,91,,2,1,3
010 Brenner,92,,1,1,2
010 Brenner,93,,-,2,2
010 Brenner,94,,-,2,2
010 Brenner,95,,-,1,1
010 Brenner,97,,-,1,1
011 Brixen,0,,114,112,226
011 Brixen,1,,124,101,225
011 Brixen,2,,116,140,256
011 Brixen,3,,117,118,235
011 Brixen,4,,103,130,233
011 Brixen,5,,130,112,242
011 Brixen,6,,108,108,216
011 Brixen,7,,131,124,255
011 Brixen,8,,141,129,270
011 Brixen,9,,115,116,231
011 Brixen,10,,135,111,246
011 Brixen,11,,130,104,234
011 Brixen,12,,131,121,252
011 Brixen,13,,128,123,251
011 Brixen,14,,114,120,234
011 Brixen,15,,130,121,251
011 Brixen,16,,131,124,255
011 Brixen,17,,132,112,244
011 Brixen,18,,149,131,280
011 Brixen,19,,130,136,266
011 Brixen,20,,133,119,252
011 Brixen,21,,133,122,255
011 Brixen,22,,131,135,266
011 Brixen,23,,144,135,279
011 Brixen,24,,133,127,260
011 Brixen,25,,137,129,266
011 Brixen,26,,136,123,259
011 Brixen,27,,108,114,222
011 Brixen,28,,137,111,248
011 Brixen,29,,138,122,260
011 Brixen,30,,120,129,249
011 Brixen,31,,106,139,245
011 Brixen,32,,140,111,251
011 Brixen,33,,135,124,259
011 Brixen,34,,131,154,285
011 Brixen,35,,127,126,253
011 Brixen,36,,148,134,282
011 Brixen,37,,120,142,262
011 Brixen,38,,155,135,290
011 Brixen,39,,112,143,255
011 Brixen,40,,149,149,298
011 Brixen,41,,150,170,320
011 Brixen,42,,145,145,290
011 Brixen,43,,145,175,320
011 Brixen,44,,161,168,329
011 Brixen,45,,170,182,352
011 Brixen,46,,168,177,345
011 Brixen,47,,176,166,342
011 Brixen,48,,204,199,403
011 Brixen,49,,183,203,386
011 Brixen,50,,187,171,358
011 Brixen,51,,170,194,364
011 Brixen,52,,190,178,368
011 Brixen,53,,182,194,376
011 Brixen,54,,151,177,328
011 Brixen,55,,167,168,335
011 Brixen,56,,137,174,311
011 Brixen,57,,133,151,284
011 Brixen,58,,140,148,288
011 Brixen,59,,144,123,267
011 Brixen,60,,131,143,274
011 Brixen,61,,113,148,261
011 Brixen,62,,125,100,225
011 Brixen,63,,87,116,203
011 Brixen,64,,81,110,191
011 Brixen,65,,104,109,213
011 Brixen,66,,95,106,201
011 Brixen,67,,115,109,224
011 Brixen,68,,80,130,210
011 Brixen,69,,98,124,222
011 Brixen,70,,80,114,194
011 Brixen,71,,96,100,196
011 Brixen,72,,58,93,151
011 Brixen,73,,106,114,220
011 Brixen,74,,117,103,220
011 Brixen,75,,84,97,181
011 Brixen,76,,92,115,207
011 Brixen,77,,67,106,173
011 Brixen,78,,76,92,168
011 Brixen,79,,63,81,144
011 Brixen,80,,64,88,152
011 Brixen,81,,44,79,123
011 Brixen,82,,57,74,131
011 Brixen,83,,46,74,120
011 Brixen,84,,44,57,101
011 Brixen,85,,43,62,105
011 Brixen,86,,37,55,92
011 Brixen,87,,31,58,89
011 Brixen,88,,24,46,70
011 Brixen,89,,20,40,60
011 Brixen,90,,12,48,60
011 Brixen,91,,14,29,43
011 Brixen,92,,14,30,44
011 Brixen,93,,7,27,34
011 Brixen,94,,7,18,25
011 Brixen,95,,2,15,17
011 Brixen,96,,3,8,11
011 Brixen,97,,1,7,8
011 Brixen,98,,1,2,3
011 Brixen,99,,-,3,3
011 Brixen,100,,-,3,3
011 Brixen,101,,1,1,2
011 Brixen,105,,-,1,1
012 Branzoll,0,,18,14,32
012 Branzoll,1,,18,13,31
012 Branzoll,2,,23,19,42
012 Branzoll,3,,19,10,29
012 Branzoll,4,,13,18,31
012 Branzoll,5,,15,16,31
012 Branzoll,6,,16,10,26
012 Branzoll,7,,15,24,39
012 Branzoll,8,,12,18,30
012 Branzoll,9,,15,12,27
012 Branzoll,10,,10,17,27
012 Branzoll,11,,12,10,22
012 Branzoll,12,,12,9,21
012 Branzoll,13,,16,14,30
012 Branzoll,14,,15,21,36
012 Branzoll,15,,13,11,24
012 Branzoll,16,,9,12,21
012 Branzoll,17,,21,8,29
012 Branzoll,18,,12,12,24
012 Branzoll,19,,17,6,23
012 Branzoll,20,,17,22,39
012 Branzoll,21,,16,6,22
012 Branzoll,22,,14,17,31
012 Branzoll,23,,18,8,26
012 Branzoll,24,,23,17,40
012 Branzoll,25,,15,20,35
012 Branzoll,26,,16,20,36
012 Branzoll,27,,20,17,37
012 Branzoll,28,,14,21,35
012 Branzoll,29,,20,19,39
012 Branzoll,30,,16,15,31
012 Branzoll,31,,14,14,28
012 Branzoll,32,,21,20,41
012 Branzoll,33,,17,19,36
012 Branzoll,34,,15,20,35
012 Branzoll,35,,22,14,36
012 Branzoll,36,,15,15,30
012 Branzoll,37,,10,13,23
012 Branzoll,38,,17,11,28
012 Branzoll,39,,14,20,34
012 Branzoll,40,,12,18,30
012 Branzoll,41,,24,19,43
012 Branzoll,42,,21,16,37
012 Branzoll,43,,28,27,55
012 Branzoll,44,,22,15,37
012 Branzoll,45,,25,21,46
012 Branzoll,46,,22,27,49
012 Branzoll,47,,20,16,36
012 Branzoll,48,,27,30,57
012 Branzoll,49,,25,23,48
012 Branzoll,50,,24,22,46
012 Branzoll,51,,20,20,40
012 Branzoll,52,,25,25,50
012 Branzoll,53,,26,28,54
012 Branzoll,54,,19,22,41
012 Branzoll,55,,15,17,32
012 Branzoll,56,,23,28,51
012 Branzoll,57,,23,18,41
012 Branzoll,58,,18,20,38
012 Branzoll,59,,20,15,35
012 Branzoll,60,,17,13,30
012 Branzoll,61,,13,18,31
012 Branzoll,62,,17,16,33
012 Branzoll,63,,20,19,39
012 Branzoll,64,,12,19,31
012 Branzoll,65,,14,20,34
012 Branzoll,66,,12,15,27
012 Branzoll,67,,17,15,32
012 Branzoll,68,,13,16,29
012 Branzoll,69,,14,15,29
012 Branzoll,70,,15,17,32
012 Branzoll,71,,14,18,32
012 Branzoll,72,,9,7,16
012 Branzoll,73,,10,11,21
012 Branzoll,74,,13,11,24
012 Branzoll,75,,15,12,27
012 Branzoll,76,,17,12,29
012 Branzoll,77,,7,11,18
012 Branzoll,78,,13,13,26
012 Branzoll,79,,7,8,15
012 Branzoll,80,,3,7,10
012 Branzoll,81,,6,8,14
012 Branzoll,82,,7,8,15
012 Branzoll,83,,3,7,10
012 Branzoll,84,,14,11,25
012 Branzoll,85,,7,6,13
012 Branzoll,86,,-,6,6
012 Branzoll,87,,4,10,14
012 Branzoll,88,,2,8,10
012 Branzoll,89,,3,4,7
012 Branzoll,90,,2,2,4
012 Branzoll,91,,-,3,3
012 Branzoll,92,,1,-,1
012 Branzoll,93,,1,3,4
012 Branzoll,94,,-,3,3
012 Branzoll,95,,-,1,1
012 Branzoll,97,,-,1,1
013 Bruneck,0,,100,64,164
013 Bruneck,1,,67,98,165
013 Bruneck,2,,99,68,167
013 Bruneck,3,,90,94,184
013 Bruneck,4,,86,76,162
013 Bruneck,5,,93,76,169
013 Bruneck,6,,86,66,152
013 Bruneck,7,,84,78,162
013 Bruneck,8,,106,71,177
013 Bruneck,9,,81,67,148
013 Bruneck,10,,91,75,166
013 Bruneck,11,,99,83,182
013 Bruneck,12,,99,81,180
013 Bruneck,13,,89,99,188
013 Bruneck,14,,100,84,184
013 Bruneck,15,,79,90,169
013 Bruneck,16,,103,81,184
013 Bruneck,17,,86,92,178
013 Bruneck,18,,97,100,197
013 Bruneck,19,,110,97,207
013 Bruneck,20,,129,79,208
013 Bruneck,21,,92,109,201
013 Bruneck,22,,81,88,169
013 Bruneck,23,,103,90,193
013 Bruneck,24,,101,87,188
013 Bruneck,25,,112,87,199
013 Bruneck,26,,99,89,188
013 Bruneck,27,,105,89,194
013 Bruneck,28,,86,92,178
013 Bruneck,29,,78,85,163
013 Bruneck,30,,70,81,151
013 Bruneck,31,,120,86,206
013 Bruneck,32,,92,97,189
013 Bruneck,33,,102,98,200
013 Bruneck,34,,107,101,208
013 Bruneck,35,,106,101,207
013 Bruneck,36,,107,115,222
013 Bruneck,37,,112,119,231
013 Bruneck,38,,95,106,201
013 Bruneck,39,,131,121,252
013 Bruneck,40,,125,116,241
013 Bruneck,41,,101,131,232
013 Bruneck,42,,126,133,259
013 Bruneck,43,,136,115,251
013 Bruneck,44,,144,121,265
013 Bruneck,45,,126,139,265
013 Bruneck,46,,144,114,258
013 Bruneck,47,,114,149,263
013 Bruneck,48,,138,129,267
013 Bruneck,49,,120,142,262
013 Bruneck,50,,133,137,270
013 Bruneck,51,,134,135,269
013 Bruneck,52,,159,148,307
013 Bruneck,53,,134,139,273
013 Bruneck,54,,142,112,254
013 Bruneck,55,,128,124,252
013 Bruneck,56,,127,103,230
013 Bruneck,57,,110,127,237
013 Bruneck,58,,106,108,214
013 Bruneck,59,,99,117,216
013 Bruneck,60,,81,100,181
013 Bruneck,61,,88,91,179
013 Bruneck,62,,74,83,157
013 Bruneck,63,,86,85,171
013 Bruneck,64,,74,100,174
013 Bruneck,65,,86,98,184
013 Bruneck,66,,65,102,167
013 Bruneck,67,,77,95,172
013 Bruneck,68,,78,86,164
013 Bruneck,69,,73,106,179
013 Bruneck,70,,88,70,158
013 Bruneck,71,,90,80,170
013 Bruneck,72,,61,64,125
013 Bruneck,73,,78,91,169
013 Bruneck,74,,94,81,175
013 Bruneck,75,,68,85,153
013 Bruneck,76,,64,85,149
013 Bruneck,77,,60,80,140
013 Bruneck,78,,66,88,154
013 Bruneck,79,,50,50,100
013 Bruneck,80,,44,48,92
013 Bruneck,81,,36,50,86
013 Bruneck,82,,30,46,76
013 Bruneck,83,,23,42,65
013 Bruneck,84,,36,47,83
013 Bruneck,85,,28,42,70
013 Bruneck,86,,26,32,58
013 Bruneck,87,,20,37,57
013 Bruneck,88,,12,29,41
013 Bruneck,89,,12,39,51
013 Bruneck,90,,11,22,33
013 Bruneck,91,,11,18,29
013 Bruneck,92,,7,20,27
013 Bruneck,93,,2,19,21
013 Bruneck,94,,6,13,19
013 Bruneck,95,,7,9,16
013 Bruneck,96,,1,6,7
013 Bruneck,97,,1,7,8
013 Bruneck,98,,-,1,1
013 Bruneck,99,,-,1,1
013 Bruneck,100,,1,-,1
013 Bruneck,101,,-,1,1
014 Kuens,0,,1,-,1
014 Kuens,1,,2,2,4
014 Kuens,2,,1,1,2
014 Kuens,3,,1,1,2
014 Kuens,4,,2,5,7
014 Kuens,5,,1,1,2
014 Kuens,6,,2,6,8
014 Kuens,7,,1,2,3
014 Kuens,8,,4,4,8
014 Kuens,9,,4,3,7
014 Kuens,10,,2,4,6
014 Kuens,11,,1,1,2
014 Kuens,12,,6,2,8
014 Kuens,13,,-,3,3
014 Kuens,14,,5,4,9
014 Kuens,15,,2,1,3
014 Kuens,16,,5,2,7
014 Kuens,17,,2,5,7
014 Kuens,18,,1,3,4
014 Kuens,19,,2,6,8
014 Kuens,20,,1,1,2
014 Kuens,21,,5,2,7
014 Kuens,22,,2,3,5
014 Kuens,23,,1,4,5
014 Kuens,24,,3,2,5
014 Kuens,25,,3,3,6
014 Kuens,26,,2,1,3
014 Kuens,27,,4,1,5
014 Kuens,28,,1,1,2
014 Kuens,29,,-,1,1
014 Kuens,30,,1,-,1
014 Kuens,31,,1,1,2
014 Kuens,32,,1,2,3
014 Kuens,33,,1,2,3
014 Kuens,34,,1,1,2
014 Kuens,35,,2,1,3
014 Kuens,36,,-,4,4
014 Kuens,37,,5,4,9
014 Kuens,38,,1,2,3
014 Kuens,39,,3,1,4
014 Kuens,40,,2,1,3
014 Kuens,41,,3,1,4
014 Kuens,42,,3,7,10
014 Kuens,43,,3,5,8
014 Kuens,44,,2,4,6
014 Kuens,45,,6,1,7
014 Kuens,46,,2,3,5
014 Kuens,47,,7,5,12
014 Kuens,48,,4,1,5
014 Kuens,49,,4,4,8
014 Kuens,50,,6,9,15
014 Kuens,51,,1,6,7
014 Kuens,52,,6,1,7
014 Kuens,53,,5,6,11
014 Kuens,54,,8,2,10
014 Kuens,55,,5,1,6
014 Kuens,56,,1,6,7
014 Kuens,58,,1,-,1
014 Kuens,59,,-,6,6
014 Kuens,60,,3,-,3
014 Kuens,61,,2,-,2
014 Kuens,62,,1,2,3
014 Kuens,63,,-,1,1
014 Kuens,64,,2,-,2
014 Kuens,65,,1,4,5
014 Kuens,67,,1,3,4
014 Kuens,68,,-,2,2
014 Kuens,69,,3,1,4
014 Kuens,70,,1,2,3
014 Kuens,71,,1,2,3
014 Kuens,72,,3,1,4
014 Kuens,74,,-,2,2
014 Kuens,75,,1,3,4
014 Kuens,76,,-,2,2
014 Kuens,77,,-,1,1
014 Kuens,78,,4,2,6
014 Kuens,79,,3,2,5
014 Kuens,80,,1,2,3
014 Kuens,81,,1,2,3
014 Kuens,82,,1,2,3
014 Kuens,83,,-,1,1
014 Kuens,84,,-,1,1
014 Kuens,85,,2,2,4
014 Kuens,86,,2,2,4
014 Kuens,87,,2,1,3
014 Kuens,90,,1,-,1
014 Kuens,91,,1,-,1
014 Kuens,95,,-,1,1
015 Kaltern a.d. Weinstr.,0,,46,39,85
015 Kaltern a.d. Weinstr.,1,,37,51,88
015 Kaltern a.d. Weinstr.,2,,45,35,80
015 Kaltern a.d. Weinstr.,3,,48,48,96
015 Kaltern a.d. Weinstr.,4,,45,51,96
015 Kaltern a.d. Weinstr.,5,,57,33,90
015 Kaltern a.d. Weinstr.,6,,44,51,95
015 Kaltern a.d. Weinstr.,7,,47,33,80
015 Kaltern a.d. Weinstr.,8,,44,31,75
015 Kaltern a.d. Weinstr.,9,,44,41,85
015 Kaltern a.d. Weinstr.,10,,43,41,84
015 Kaltern a.d. Weinstr.,11,,47,40,87
015 Kaltern a.d. Weinstr.,12,,44,43,87
015 Kaltern a.d. Weinstr.,13,,44,49,93
015 Kaltern a.d. Weinstr.,14,,43,38,81
015 Kaltern a.d. Weinstr.,15,,40,34,74
015 Kaltern a.d. Weinstr.,16,,31,51,82
015 Kaltern a.d. Weinstr.,17,,33,35,68
015 Kaltern a.d. Weinstr.,18,,45,41,86
015 Kaltern a.d. Weinstr.,19,,41,46,87
015 Kaltern a.d. Weinstr.,20,,45,47,92
015 Kaltern a.d. Weinstr.,21,,45,47,92
015 Kaltern a.d. Weinstr.,22,,43,39,82
015 Kaltern a.d. Weinstr.,23,,30,42,72
015 Kaltern a.d. Weinstr.,24,,35,40,75
015 Kaltern a.d. Weinstr.,25,,44,49,93
015 Kaltern a.d. Weinstr.,26,,42,39,81
015 Kaltern a.d. Weinstr.,27,,42,45,87
015 Kaltern a.d. Weinstr.,28,,66,50,116
015 Kaltern a.d. Weinstr.,29,,50,45,95
015 Kaltern a.d. Weinstr.,30,,41,36,77
015 Kaltern a.d. Weinstr.,31,,53,47,100
015 Kaltern a.d. Weinstr.,32,,63,36,99
015 Kaltern a.d. Weinstr.,33,,48,56,104
015 Kaltern a.d. Weinstr.,34,,52,62,114
015 Kaltern a.d. Weinstr.,35,,59,59,118
015 Kaltern a.d. Weinstr.,36,,56,52,108
015 Kaltern a.d. Weinstr.,37,,51,67,118
015 Kaltern a.d. Weinstr.,38,,52,46,98
015 Kaltern a.d. Weinstr.,39,,62,47,109
015 Kaltern a.d. Weinstr.,40,,44,65,109
015 Kaltern a.d. Weinstr.,41,,53,54,107
015 Kaltern a.d. Weinstr.,42,,43,67,110
015 Kaltern a.d. Weinstr.,43,,60,50,110
015 Kaltern a.d. Weinstr.,44,,42,56,98
015 Kaltern a.d. Weinstr.,45,,59,69,128
015 Kaltern a.d. Weinstr.,46,,68,65,133
015 Kaltern a.d. Weinstr.,47,,59,61,120
015 Kaltern a.d. Weinstr.,48,,51,65,116
015 Kaltern a.d. Weinstr.,49,,74,73,147
015 Kaltern a.d. Weinstr.,50,,67,67,134
015 Kaltern a.d. Weinstr.,51,,64,68,132
015 Kaltern a.d. Weinstr.,52,,58,67,125
015 Kaltern a.d. Weinstr.,53,,81,51,132
015 Kaltern a.d. Weinstr.,54,,52,61,113
015 Kaltern a.d. Weinstr.,55,,56,58,114
015 Kaltern a.d. Weinstr.,56,,67,71,138
015 Kaltern a.d. Weinstr.,57,,52,67,119
015 Kaltern a.d. Weinstr.,58,,55,59,114
015 Kaltern a.d. Weinstr.,59,,55,62,117
015 Kaltern a.d. Weinstr.,60,,51,62,113
015 Kaltern a.d. Weinstr.,61,,61,42,103
015 Kaltern a.d. Weinstr.,62,,52,43,95
015 Kaltern a.d. Weinstr.,63,,39,50,89
015 Kaltern a.d. Weinstr.,64,,36,36,72
015 Kaltern a.d. Weinstr.,65,,38,56,94
015 Kaltern a.d. Weinstr.,66,,32,39,71
015 Kaltern a.d. Weinstr.,67,,43,34,77
015 Kaltern a.d. Weinstr.,68,,31,34,65
015 Kaltern a.d. Weinstr.,69,,31,32,63
015 Kaltern a.d. Weinstr.,70,,33,51,84
015 Kaltern a.d. Weinstr.,71,,45,42,87
015 Kaltern a.d. Weinstr.,72,,33,37,70
015 Kaltern a.d. Weinstr.,73,,30,41,71
015 Kaltern a.d. Weinstr.,74,,30,37,67
015 Kaltern a.d. Weinstr.,75,,36,39,75
015 Kaltern a.d. Weinstr.,76,,42,37,79
015 Kaltern a.d. Weinstr.,77,,23,38,61
015 Kaltern a.d. Weinstr.,78,,19,29,48
015 Kaltern a.d. Weinstr.,79,,29,37,66
015 Kaltern a.d. Weinstr.,80,,23,28,51
015 Kaltern a.d. Weinstr.,81,,17,21,38
015 Kaltern a.d. Weinstr.,82,,17,22,39
015 Kaltern a.d. Weinstr.,83,,15,20,35
015 Kaltern a.d. Weinstr.,84,,14,28,42
015 Kaltern a.d. Weinstr.,85,,13,25,38
015 Kaltern a.d. Weinstr.,86,,11,22,33
015 Kaltern a.d. Weinstr.,87,,14,22,36
015 Kaltern a.d. Weinstr.,88,,10,20,30
015 Kaltern a.d. Weinstr.,89,,7,15,22
015 Kaltern a.d. Weinstr.,90,,6,18,24
015 Kaltern a.d. Weinstr.,91,,4,10,14
015 Kaltern a.d. Weinstr.,92,,3,15,18
015 Kaltern a.d. Weinstr.,93,,1,4,5
015 Kaltern a.d. Weinstr.,94,,1,8,9
015 Kaltern a.d. Weinstr.,95,,1,9,10
015 Kaltern a.d. Weinstr.,96,,1,4,5
015 Kaltern a.d. Weinstr.,97,,-,6,6
015 Kaltern a.d. Weinstr.,98,,-,1,1
015 Kaltern a.d. Weinstr.,99,,-,2,2
015 Kaltern a.d. Weinstr.,102,,-,1,1
015 Kaltern a.d. Weinstr.,104,,-,1,1
016 Freienfeld,0,,8,18,26
016 Freienfeld,1,,10,17,27
016 Freienfeld,2,,14,11,25
016 Freienfeld,3,,14,10,24
016 Freienfeld,4,,10,11,21
016 Freienfeld,5,,10,14,24
016 Freienfeld,6,,21,15,36
016 Freienfeld,7,,15,14,29
016 Freienfeld,8,,17,18,35
016 Freienfeld,9,,14,12,26
016 Freienfeld,10,,22,12,34
016 Freienfeld,11,,14,14,28
016 Freienfeld,12,,19,18,37
016 Freienfeld,13,,15,10,25
016 Freienfeld,14,,20,17,37
016 Freienfeld,15,,20,19,39
016 Freienfeld,16,,17,19,36
016 Freienfeld,17,,16,13,29
016 Freienfeld,18,,17,22,39
016 Freienfeld,19,,13,21,34
016 Freienfeld,20,,18,19,37
016 Freienfeld,21,,22,14,36
016 Freienfeld,22,,18,17,35
016 Freienfeld,23,,12,9,21
016 Freienfeld,24,,13,11,24
016 Freienfeld,25,,18,17,35
016 Freienfeld,26,,10,12,22
016 Freienfeld,27,,21,14,35
016 Freienfeld,28,,26,23,49
016 Freienfeld,29,,22,12,34
016 Freienfeld,30,,16,13,29
016 Freienfeld,31,,14,18,32
016 Freienfeld,32,,17,13,30
016 Freienfeld,33,,21,13,34
016 Freienfeld,34,,25,17,42
016 Freienfeld,35,,16,18,34
016 Freienfeld,36,,19,15,34
016 Freienfeld,37,,18,12,30
016 Freienfeld,38,,13,20,33
016 Freienfeld,39,,16,15,31
016 Freienfeld,40,,20,23,43
016 Freienfeld,41,,15,14,29
016 Freienfeld,42,,15,16,31
016 Freienfeld,43,,20,24,44
016 Freienfeld,44,,20,18,38
016 Freienfeld,45,,16,23,39
016 Freienfeld,46,,25,22,47
016 Freienfeld,47,,25,16,41
016 Freienfeld,48,,22,22,44
016 Freienfeld,49,,18,18,36
016 Freienfeld,50,,23,26,49
016 Freienfeld,51,,21,20,41
016 Freienfeld,52,,23,19,42
016 Freienfeld,53,,24,16,40
016 Freienfeld,54,,19,19,38
016 Freienfeld,55,,24,28,52
016 Freienfeld,56,,26,16,42
016 Freienfeld,57,,19,23,42
016 Freienfeld,58,,24,14,38
016 Freienfeld,59,,17,20,37
016 Freienfeld,60,,13,19,32
016 Freienfeld,61,,17,16,33
016 Freienfeld,62,,19,10,29
016 Freienfeld,63,,16,18,34
016 Freienfeld,64,,17,10,27
016 Freienfeld,65,,13,18,31
016 Freienfeld,66,,12,9,21
016 Freienfeld,67,,18,10,28
016 Freienfeld,68,,16,10,26
016 Freienfeld,69,,15,11,26
016 Freienfeld,70,,4,9,13
016 Freienfeld,71,,11,15,26
016 Freienfeld,72,,8,2,10
016 Freienfeld,73,,8,5,13
016 Freienfeld,74,,9,7,16
016 Freienfeld,75,,9,8,17
016 Freienfeld,76,,10,9,19
016 Freienfeld,77,,9,5,14
016 Freienfeld,78,,6,9,15
016 Freienfeld,79,,9,12,21
016 Freienfeld,80,,2,10,12
016 Freienfeld,81,,8,10,18
016 Freienfeld,82,,5,8,13
016 Freienfeld,83,,3,4,7
016 Freienfeld,84,,5,8,13
016 Freienfeld,85,,5,5,10
016 Freienfeld,86,,3,5,8
016 Freienfeld,87,,5,5,10
016 Freienfeld,88,,1,3,4
016 Freienfeld,89,,2,3,5
016 Freienfeld,90,,2,3,5
016 Freienfeld,91,,3,-,3
016 Freienfeld,92,,-,1,1
016 Freienfeld,94,,-,3,3
016 Freienfeld,97,,-,1,1
017 Sand in Taufers,0,,26,39,65
017 Sand in Taufers,1,,23,39,62
017 Sand in Taufers,2,,23,31,54
017 Sand in Taufers,3,,33,29,62
017 Sand in Taufers,4,,26,20,46
017 Sand in Taufers,5,,20,34,54
017 Sand in Taufers,6,,21,25,46
017 Sand in Taufers,7,,24,22,46
017 Sand in Taufers,8,,33,40,73
017 Sand in Taufers,9,,28,30,58
017 Sand in Taufers,10,,46,38,84
017 Sand in Taufers,11,,34,20,54
017 Sand in Taufers,12,,35,31,66
017 Sand in Taufers,13,,36,22,58
017 Sand in Taufers,14,,37,32,69
017 Sand in Taufers,15,,26,28,54
017 Sand in Taufers,16,,29,36,65
017 Sand in Taufers,17,,43,24,67
017 Sand in Taufers,18,,36,38,74
017 Sand in Taufers,19,,30,33,63
017 Sand in Taufers,20,,37,33,70
017 Sand in Taufers,21,,31,31,62
017 Sand in Taufers,22,,30,28,58
017 Sand in Taufers,23,,47,36,83
017 Sand in Taufers,24,,26,35,61
017 Sand in Taufers,25,,35,38,73
017 Sand in Taufers,26,,26,28,54
017 Sand in Taufers,27,,30,37,67
017 Sand in Taufers,28,,29,33,62
017 Sand in Taufers,29,,30,33,63
017 Sand in Taufers,30,,22,30,52
017 Sand in Taufers,31,,27,28,55
017 Sand in Taufers,32,,33,28,61
017 Sand in Taufers,33,,34,27,61
017 Sand in Taufers,34,,29,34,63
017 Sand in Taufers,35,,23,40,63
017 Sand in Taufers,36,,34,35,69
017 Sand in Taufers,37,,37,37,74
017 Sand in Taufers,38,,34,43,77
017 Sand in Taufers,39,,43,35,78
017 Sand in Taufers,40,,36,37,73
017 Sand in Taufers,41,,40,33,73
017 Sand in Taufers,42,,48,37,85
017 Sand in Taufers,43,,56,47,103
017 Sand in Taufers,44,,54,44,98
017 Sand in Taufers,45,,43,50,93
017 Sand in Taufers,46,,48,49,97
017 Sand in Taufers,47,,45,60,105
017 Sand in Taufers,48,,57,43,100
017 Sand in Taufers,49,,51,38,89
017 Sand in Taufers,50,,35,40,75
017 Sand in Taufers,51,,48,39,87
017 Sand in Taufers,52,,55,36,91
017 Sand in Taufers,53,,54,45,99
017 Sand in Taufers,54,,44,41,85
017 Sand in Taufers,55,,39,43,82
017 Sand in Taufers,56,,44,42,86
017 Sand in Taufers,57,,40,30,70
017 Sand in Taufers,58,,36,33,69
017 Sand in Taufers,59,,30,22,52
017 Sand in Taufers,60,,26,37,63
017 Sand in Taufers,61,,25,33,58
017 Sand in Taufers,62,,19,23,42
017 Sand in Taufers,63,,25,27,52
017 Sand in Taufers,64,,26,24,50
017 Sand in Taufers,65,,15,28,43
017 Sand in Taufers,66,,24,21,45
017 Sand in Taufers,67,,30,32,62
017 Sand in Taufers,68,,28,23,51
017 Sand in Taufers,69,,24,24,48
017 Sand in Taufers,70,,23,30,53
017 Sand in Taufers,71,,25,24,49
017 Sand in Taufers,72,,22,7,29
017 Sand in Taufers,73,,14,29,43
017 Sand in Taufers,74,,22,27,49
017 Sand in Taufers,75,,27,29,56
017 Sand in Taufers,76,,23,30,53
017 Sand in Taufers,77,,21,17,38
017 Sand in Taufers,78,,19,30,49
017 Sand in Taufers,79,,16,21,37
017 Sand in Taufers,80,,20,11,31
017 Sand in Taufers,81,,11,21,32
017 Sand in Taufers,82,,15,15,30
017 Sand in Taufers,83,,11,9,20
017 Sand in Taufers,84,,11,14,25
017 Sand in Taufers,85,,5,13,18
017 Sand in Taufers,86,,4,9,13
017 Sand in Taufers,87,,6,15,21
017 Sand in Taufers,88,,5,7,12
017 Sand in Taufers,89,,1,6,7
017 Sand in Taufers,90,,2,4,6
017 Sand in Taufers,91,,2,6,8
017 Sand in Taufers,92,,1,4,5
017 Sand in Taufers,93,,-,5,5
017 Sand in Taufers,94,,-,3,3
017 Sand in Taufers,95,,-,2,2
017 Sand in Taufers,96,,-,1,1
017 Sand in Taufers,97,,-,1,1
017 Sand in Taufers,99,,-,1,1
018 Kastelbell-Tschars,0,,15,9,24
018 Kastelbell-Tschars,1,,8,16,24
018 Kastelbell-Tschars,2,,9,10,19
018 Kastelbell-Tschars,3,,7,11,18
018 Kastelbell-Tschars,4,,16,15,31
018 Kastelbell-Tschars,5,,16,7,23
018 Kastelbell-Tschars,6,,15,10,25
018 Kastelbell-Tschars,7,,11,20,31
018 Kastelbell-Tschars,8,,10,9,19
018 Kastelbell-Tschars,9,,9,6,15
018 Kastelbell-Tschars,10,,11,10,21
018 Kastelbell-Tschars,11,,19,6,25
018 Kastelbell-Tschars,12,,9,7,16
018 Kastelbell-Tschars,13,,13,11,24
018 Kastelbell-Tschars,14,,11,9,20
018 Kastelbell-Tschars,15,,8,8,16
018 Kastelbell-Tschars,16,,14,15,29
018 Kastelbell-Tschars,17,,13,12,25
018 Kastelbell-Tschars,18,,22,12,34
018 Kastelbell-Tschars,19,,17,7,24
018 Kastelbell-Tschars,20,,12,13,25
018 Kastelbell-Tschars,21,,14,15,29
018 Kastelbell-Tschars,22,,16,11,27
018 Kastelbell-Tschars,23,,14,12,26
018 Kastelbell-Tschars,24,,14,16,30
018 Kastelbell-Tschars,25,,15,8,23
018 Kastelbell-Tschars,26,,16,10,26
018 Kastelbell-Tschars,27,,15,14,29
018 Kastelbell-Tschars,28,,12,12,24
018 Kastelbell-Tschars,29,,13,8,21
018 Kastelbell-Tschars,30,,15,12,27
018 Kastelbell-Tschars,31,,13,15,28
018 Kastelbell-Tschars,32,,21,17,38
018 Kastelbell-Tschars,33,,9,16,25
018 Kastelbell-Tschars,34,,11,14,25
018 Kastelbell-Tschars,35,,24,9,33
018 Kastelbell-Tschars,36,,11,10,21
018 Kastelbell-Tschars,37,,10,13,23
018 Kastelbell-Tschars,38,,12,14,26
018 Kastelbell-Tschars,39,,14,13,27
018 Kastelbell-Tschars,40,,14,14,28
018 Kastelbell-Tschars,41,,20,17,37
018 Kastelbell-Tschars,42,,18,14,32
018 Kastelbell-Tschars,43,,20,9,29
018 Kastelbell-Tschars,44,,14,24,38
018 Kastelbell-Tschars,45,,13,19,32
018 Kastelbell-Tschars,46,,16,16,32
018 Kastelbell-Tschars,47,,15,13,28
018 Kastelbell-Tschars,48,,24,23,47
018 Kastelbell-Tschars,49,,15,18,33
018 Kastelbell-Tschars,50,,14,23,37
018 Kastelbell-Tschars,51,,20,13,33
018 Kastelbell-Tschars,52,,19,10,29
018 Kastelbell-Tschars,53,,22,16,38
018 Kastelbell-Tschars,54,,23,21,44
018 Kastelbell-Tschars,55,,6,21,27
018 Kastelbell-Tschars,56,,18,18,36
018 Kastelbell-Tschars,57,,23,19,42
018 Kastelbell-Tschars,58,,23,20,43
018 Kastelbell-Tschars,59,,18,15,33
018 Kastelbell-Tschars,60,,12,11,23
018 Kastelbell-Tschars,61,,13,14,27
018 Kastelbell-Tschars,62,,20,16,36
018 Kastelbell-Tschars,63,,10,9,19
018 Kastelbell-Tschars,64,,9,16,25
018 Kastelbell-Tschars,65,,11,14,25
018 Kastelbell-Tschars,66,,16,13,29
018 Kastelbell-Tschars,67,,10,13,23
018 Kastelbell-Tschars,68,,13,10,23
018 Kastelbell-Tschars,69,,11,14,25
018 Kastelbell-Tschars,70,,9,8,17
018 Kastelbell-Tschars,71,,10,13,23
018 Kastelbell-Tschars,72,,11,4,15
018 Kastelbell-Tschars,73,,12,6,18
018 Kastelbell-Tschars,74,,8,7,15
018 Kastelbell-Tschars,75,,9,10,19
018 Kastelbell-Tschars,76,,7,7,14
018 Kastelbell-Tschars,77,,8,7,15
018 Kastelbell-Tschars,78,,10,11,21
018 Kastelbell-Tschars,79,,5,13,18
018 Kastelbell-Tschars,80,,11,8,19
018 Kastelbell-Tschars,81,,6,13,19
018 Kastelbell-Tschars,82,,7,7,14
018 Kastelbell-Tschars,83,,4,10,14
018 Kastelbell-Tschars,84,,11,9,20
018 Kastelbell-Tschars,85,,5,9,14
018 Kastelbell-Tschars,86,,6,6,12
018 Kastelbell-Tschars,87,,12,11,23
018 Kastelbell-Tschars,88,,7,6,13
018 Kastelbell-Tschars,89,,3,5,8
018 Kastelbell-Tschars,90,,2,3,5
018 Kastelbell-Tschars,91,,2,6,8
018 Kastelbell-Tschars,92,,7,3,10
018 Kastelbell-Tschars,93,,1,2,3
018 Kastelbell-Tschars,95,,-,2,2
019 Kastelruth,0,,34,32,66
019 Kastelruth,1,,40,40,80
019 Kastelruth,2,,34,34,68
019 Kastelruth,3,,41,35,76
019 Kastelruth,4,,37,36,73
019 Kastelruth,5,,38,41,79
019 Kastelruth,6,,42,38,80
019 Kastelruth,7,,40,33,73
019 Kastelruth,8,,28,37,65
019 Kastelruth,9,,50,35,85
019 Kastelruth,10,,44,36,80
019 Kastelruth,11,,45,37,82
019 Kastelruth,12,,46,33,79
019 Kastelruth,13,,49,40,89
019 Kastelruth,14,,50,41,91
019 Kastelruth,15,,39,35,74
019 Kastelruth,16,,44,36,80
019 Kastelruth,17,,36,26,62
019 Kastelruth,18,,36,47,83
019 Kastelruth,19,,50,44,94
019 Kastelruth,20,,45,48,93
019 Kastelruth,21,,45,40,85
019 Kastelruth,22,,60,35,95
019 Kastelruth,23,,39,37,76
019 Kastelruth,24,,40,35,75
019 Kastelruth,25,,40,47,87
019 Kastelruth,26,,40,43,83
019 Kastelruth,27,,48,38,86
019 Kastelruth,28,,55,48,103
019 Kastelruth,29,,26,34,60
019 Kastelruth,30,,38,43,81
019 Kastelruth,31,,35,31,66
019 Kastelruth,32,,34,46,80
019 Kastelruth,33,,30,39,69
019 Kastelruth,34,,45,31,76
019 Kastelruth,35,,53,42,95
019 Kastelruth,36,,43,51,94
019 Kastelruth,37,,59,47,106
019 Kastelruth,38,,41,38,79
019 Kastelruth,39,,41,43,84
019 Kastelruth,40,,40,47,87
019 Kastelruth,41,,45,62,107
019 Kastelruth,42,,55,46,101
019 Kastelruth,43,,66,48,114
019 Kastelruth,44,,42,68,110
019 Kastelruth,45,,66,41,107
019 Kastelruth,46,,55,44,99
019 Kastelruth,47,,52,53,105
019 Kastelruth,48,,56,45,101
019 Kastelruth,49,,64,59,123
019 Kastelruth,50,,64,56,120
019 Kastelruth,51,,67,48,115
019 Kastelruth,52,,44,77,121
019 Kastelruth,53,,56,36,92
019 Kastelruth,54,,50,34,84
019 Kastelruth,55,,33,54,87
019 Kastelruth,56,,53,42,95
019 Kastelruth,57,,47,39,86
019 Kastelruth,58,,44,49,93
019 Kastelruth,59,,46,46,92
019 Kastelruth,60,,38,39,77
019 Kastelruth,61,,37,33,70
019 Kastelruth,62,,39,39,78
019 Kastelruth,63,,35,33,68
019 Kastelruth,64,,29,28,57
019 Kastelruth,65,,34,25,59
019 Kastelruth,66,,28,21,49
019 Kastelruth,67,,40,26,66
019 Kastelruth,68,,17,33,50
019 Kastelruth,69,,26,41,67
019 Kastelruth,70,,28,30,58
019 Kastelruth,71,,23,36,59
019 Kastelruth,72,,22,21,43
019 Kastelruth,73,,24,40,64
019 Kastelruth,74,,37,37,74
019 Kastelruth,75,,28,23,51
019 Kastelruth,76,,24,44,68
019 Kastelruth,77,,23,34,57
019 Kastelruth,78,,23,26,49
019 Kastelruth,79,,21,24,45
019 Kastelruth,80,,23,20,43
019 Kastelruth,81,,22,13,35
019 Kastelruth,82,,23,23,46
019 Kastelruth,83,,13,18,31
019 Kastelruth,84,,23,24,47
019 Kastelruth,85,,13,27,40
019 Kastelruth,86,,22,16,38
019 Kastelruth,87,,6,21,27
019 Kastelruth,88,,12,12,24
019 Kastelruth,89,,4,6,10
019 Kastelruth,90,,8,18,26
019 Kastelruth,91,,5,9,14
019 Kastelruth,92,,6,6,12
019 Kastelruth,93,,3,7,10
019 Kastelruth,94,,2,8,10
019 Kastelruth,95,,-,5,5
019 Kastelruth,96,,-,4,4
019 Kastelruth,98,,-,2,2
020 Tscherms,0,,4,10,14
020 Tscherms,1,,20,11,31
020 Tscherms,2,,11,7,18
020 Tscherms,3,,7,13,20
020 Tscherms,4,,7,7,14
020 Tscherms,5,,11,8,19
020 Tscherms,6,,18,6,24
020 Tscherms,7,,9,6,15
020 Tscherms,8,,7,8,15
020 Tscherms,9,,9,11,20
020 Tscherms,10,,8,11,19
020 Tscherms,11,,9,6,15
020 Tscherms,12,,1,10,11
020 Tscherms,13,,9,7,16
020 Tscherms,14,,9,10,19
020 Tscherms,15,,9,6,15
020 Tscherms,16,,3,8,11
020 Tscherms,17,,10,7,17
020 Tscherms,18,,8,9,17
020 Tscherms,19,,4,8,12
020 Tscherms,20,,12,8,20
020 Tscherms,21,,7,6,13
020 Tscherms,22,,13,9,22
020 Tscherms,23,,10,17,27
020 Tscherms,24,,9,9,18
020 Tscherms,25,,10,6,16
020 Tscherms,26,,8,9,17
020 Tscherms,27,,9,4,13
020 Tscherms,28,,4,5,9
020 Tscherms,29,,7,9,16
020 Tscherms,30,,12,7,19
020 Tscherms,31,,7,3,10
020 Tscherms,32,,12,12,24
020 Tscherms,33,,11,8,19
020 Tscherms,34,,12,14,26
020 Tscherms,35,,8,10,18
020 Tscherms,36,,10,11,21
020 Tscherms,37,,10,16,26
020 Tscherms,38,,8,9,17
020 Tscherms,39,,5,11,16
020 Tscherms,40,,10,8,18
020 Tscherms,41,,8,11,19
020 Tscherms,42,,14,7,21
020 Tscherms,43,,14,9,23
020 Tscherms,44,,11,14,25
020 Tscherms,45,,9,13,22
020 Tscherms,46,,10,14,24
020 Tscherms,47,,13,6,19
020 Tscherms,48,,9,16,25
020 Tscherms,49,,13,8,21
020 Tscherms,50,,11,11,22
020 Tscherms,51,,15,8,23
020 Tscherms,52,,18,19,37
020 Tscherms,53,,15,19,34
020 Tscherms,54,,16,12,28
020 Tscherms,55,,21,14,35
020 Tscherms,56,,13,12,25
020 Tscherms,57,,11,13,24
020 Tscherms,58,,8,18,26
020 Tscherms,59,,9,8,17
020 Tscherms,60,,8,10,18
020 Tscherms,61,,7,5,12
020 Tscherms,62,,10,8,18
020 Tscherms,63,,6,9,15
020 Tscherms,64,,10,8,18
020 Tscherms,65,,11,6,17
020 Tscherms,66,,5,9,14
020 Tscherms,67,,10,6,16
020 Tscherms,68,,4,2,6
020 Tscherms,69,,6,6,12
020 Tscherms,70,,7,8,15
020 Tscherms,71,,4,8,12
020 Tscherms,72,,3,6,9
020 Tscherms,73,,5,7,12
020 Tscherms,74,,5,4,9
020 Tscherms,75,,7,3,10
020 Tscherms,76,,11,7,18
020 Tscherms,77,,4,4,8
020 Tscherms,78,,4,6,10
020 Tscherms,79,,5,2,7
020 Tscherms,80,,5,8,13
020 Tscherms,81,,6,7,13
020 Tscherms,82,,2,3,5
020 Tscherms,83,,1,8,9
020 Tscherms,84,,4,3,7
020 Tscherms,85,,4,5,9
020 Tscherms,86,,2,2,4
020 Tscherms,87,,3,4,7
020 Tscherms,88,,-,1,1
020 Tscherms,89,,4,3,7
020 Tscherms,90,,3,-,3
020 Tscherms,91,,1,1,2
020 Tscherms,92,,2,4,6
020 Tscherms,93,,2,2,4
020 Tscherms,94,,-,2,2
020 Tscherms,99,,-,1,1
021 Kiens,0,,14,12,26
021 Kiens,1,,19,15,34
021 Kiens,2,,12,18,30
021 Kiens,3,,15,18,33
021 Kiens,4,,22,5,27
021 Kiens,5,,14,24,38
021 Kiens,6,,13,9,22
021 Kiens,7,,17,14,31
021 Kiens,8,,8,21,29
021 Kiens,9,,14,9,23
021 Kiens,10,,13,14,27
021 Kiens,11,,16,6,22
021 Kiens,12,,17,22,39
021 Kiens,13,,20,12,32
021 Kiens,14,,15,21,36
021 Kiens,15,,10,14,24
021 Kiens,16,,21,21,42
021 Kiens,17,,9,22,31
021 Kiens,18,,19,18,37
021 Kiens,19,,20,10,30
021 Kiens,20,,19,16,35
021 Kiens,21,,15,16,31
021 Kiens,22,,14,22,36
021 Kiens,23,,20,14,34
021 Kiens,24,,19,21,40
021 Kiens,25,,25,17,42
021 Kiens,26,,13,20,33
021 Kiens,27,,16,19,35
021 Kiens,28,,16,20,36
021 Kiens,29,,14,15,29
021 Kiens,30,,15,21,36
021 Kiens,31,,16,13,29
021 Kiens,32,,20,12,32
021 Kiens,33,,19,16,35
021 Kiens,34,,18,16,34
021 Kiens,35,,25,21,46
021 Kiens,36,,18,16,34
021 Kiens,37,,19,16,35
021 Kiens,38,,12,14,26
021 Kiens,39,,25,17,42
021 Kiens,40,,18,14,32
021 Kiens,41,,19,28,47
021 Kiens,42,,17,21,38
021 Kiens,43,,13,20,33
021 Kiens,44,,30,23,53
021 Kiens,45,,24,17,41
021 Kiens,46,,27,20,47
021 Kiens,47,,21,29,50
021 Kiens,48,,32,28,60
021 Kiens,49,,37,23,60
021 Kiens,50,,24,24,48
021 Kiens,51,,27,24,51
021 Kiens,52,,19,24,43
021 Kiens,53,,31,24,55
021 Kiens,54,,17,23,40
021 Kiens,55,,30,19,49
021 Kiens,56,,19,23,42
021 Kiens,57,,20,18,38
021 Kiens,58,,24,15,39
021 Kiens,59,,16,14,30
021 Kiens,60,,13,14,27
021 Kiens,61,,16,14,30
021 Kiens,62,,14,8,22
021 Kiens,63,,12,16,28
021 Kiens,64,,16,23,39
021 Kiens,65,,12,10,22
021 Kiens,66,,15,12,27
021 Kiens,67,,12,9,21
021 Kiens,68,,10,13,23
021 Kiens,69,,15,16,31
021 Kiens,70,,11,15,26
021 Kiens,71,,19,14,33
021 Kiens,72,,8,11,19
021 Kiens,73,,7,12,19
021 Kiens,74,,14,9,23
021 Kiens,75,,15,10,25
021 Kiens,76,,13,10,23
021 Kiens,77,,10,16,26
021 Kiens,78,,11,7,18
021 Kiens,79,,8,10,18
021 Kiens,80,,9,7,16
021 Kiens,81,,8,7,15
021 Kiens,82,,1,11,12
021 Kiens,83,,5,6,11
021 Kiens,84,,7,7,14
021 Kiens,85,,6,6,12
021 Kiens,86,,10,5,15
021 Kiens,87,,1,7,8
021 Kiens,88,,2,5,7
021 Kiens,89,,1,3,4
021 Kiens,90,,1,4,5
021 Kiens,91,,-,1,1
021 Kiens,92,,1,2,3
021 Kiens,93,,-,2,2
021 Kiens,94,,-,2,2
021 Kiens,95,,1,1,2
022 Klausen,0,,29,27,56
022 Klausen,1,,30,23,53
022 Klausen,2,,31,32,63
022 Klausen,3,,24,33,57
022 Klausen,4,,28,21,49
022 Klausen,5,,40,26,66
022 Klausen,6,,33,33,66
022 Klausen,7,,21,34,55
022 Klausen,8,,27,22,49
022 Klausen,9,,24,26,50
022 Klausen,10,,24,29,53
022 Klausen,11,,43,40,83
022 Klausen,12,,38,32,70
022 Klausen,13,,37,35,72
022 Klausen,14,,29,31,60
022 Klausen,15,,41,32,73
022 Klausen,16,,29,27,56
022 Klausen,17,,28,34,62
022 Klausen,18,,27,32,59
022 Klausen,19,,23,31,54
022 Klausen,20,,38,33,71
022 Klausen,21,,30,22,52
022 Klausen,22,,30,28,58
022 Klausen,23,,18,36,54
022 Klausen,24,,32,25,57
022 Klausen,25,,40,26,66
022 Klausen,26,,36,41,77
022 Klausen,27,,44,28,72
022 Klausen,28,,33,32,65
022 Klausen,29,,27,35,62
022 Klausen,30,,29,28,57
022 Klausen,31,,35,19,54
022 Klausen,32,,32,31,63
022 Klausen,33,,24,23,47
022 Klausen,34,,33,34,67
022 Klausen,35,,35,43,78
022 Klausen,36,,36,34,70
022 Klausen,37,,32,41,73
022 Klausen,38,,30,28,58
022 Klausen,39,,41,33,74
022 Klausen,40,,34,30,64
022 Klausen,41,,36,28,64
022 Klausen,42,,39,39,78
022 Klausen,43,,36,35,71
022 Klausen,44,,42,30,72
022 Klausen,45,,37,38,75
022 Klausen,46,,33,41,74
022 Klausen,47,,46,44,90
022 Klausen,48,,46,46,92
022 Klausen,49,,48,45,93
022 Klausen,50,,49,42,91
022 Klausen,51,,64,42,106
022 Klausen,52,,39,48,87
022 Klausen,53,,43,45,88
022 Klausen,54,,40,37,77
022 Klausen,55,,33,41,74
022 Klausen,56,,51,42,93
022 Klausen,57,,38,26,64
022 Klausen,58,,33,37,70
022 Klausen,59,,29,29,58
022 Klausen,60,,30,29,59
022 Klausen,61,,28,24,52
022 Klausen,62,,26,33,59
022 Klausen,63,,26,38,64
022 Klausen,64,,20,31,51
022 Klausen,65,,28,15,43
022 Klausen,66,,34,25,59
022 Klausen,67,,27,21,48
022 Klausen,68,,28,28,56
022 Klausen,69,,25,26,51
022 Klausen,70,,22,20,42
022 Klausen,71,,26,23,49
022 Klausen,72,,10,17,27
022 Klausen,73,,19,17,36
022 Klausen,74,,12,28,40
022 Klausen,75,,19,24,43
022 Klausen,76,,23,20,43
022 Klausen,77,,14,21,35
022 Klausen,78,,19,19,38
022 Klausen,79,,9,20,29
022 Klausen,80,,13,15,28
022 Klausen,81,,16,17,33
022 Klausen,82,,9,15,24
022 Klausen,83,,10,8,18
022 Klausen,84,,12,14,26
022 Klausen,85,,9,13,22
022 Klausen,86,,8,10,18
022 Klausen,87,,7,15,22
022 Klausen,88,,8,7,15
022 Klausen,89,,2,10,12
022 Klausen,90,,1,8,9
022 Klausen,91,,1,3,4
022 Klausen,92,,2,5,7
022 Klausen,93,,1,3,4
022 Klausen,94,,1,3,4
022 Klausen,95,,1,2,3
022 Klausen,96,,-,1,1
022 Klausen,99,,-,1,1
023 Karneid,0,,21,14,35
023 Karneid,1,,12,21,33
023 Karneid,2,,16,20,36
023 Karneid,3,,18,25,43
023 Karneid,4,,10,18,28
023 Karneid,5,,20,18,38
023 Karneid,6,,31,16,47
023 Karneid,7,,17,16,33
023 Karneid,8,,17,19,36
023 Karneid,9,,29,21,50
023 Karneid,10,,26,22,48
023 Karneid,11,,24,16,40
023 Karneid,12,,25,21,46
023 Karneid,13,,21,25,46
023 Karneid,14,,28,20,48
023 Karneid,15,,14,14,28
023 Karneid,16,,22,22,44
023 Karneid,17,,16,15,31
023 Karneid,18,,26,25,51
023 Karneid,19,,15,22,37
023 Karneid,20,,30,15,45
023 Karneid,21,,17,22,39
023 Karneid,22,,28,19,47
023 Karneid,23,,24,20,44
023 Karneid,24,,24,19,43
023 Karneid,25,,23,18,41
023 Karneid,26,,17,11,28
023 Karneid,27,,19,18,37
023 Karneid,28,,23,15,38
023 Karneid,29,,18,17,35
023 Karneid,30,,17,16,33
023 Karneid,31,,22,18,40
023 Karneid,32,,21,13,34
023 Karneid,33,,27,16,43
023 Karneid,34,,14,12,26
023 Karneid,35,,18,16,34
023 Karneid,36,,29,28,57
023 Karneid,37,,27,17,44
023 Karneid,38,,24,28,52
023 Karneid,39,,20,14,34
023 Karneid,40,,17,21,38
023 Karneid,41,,33,30,63
023 Karneid,42,,20,14,34
023 Karneid,43,,22,30,52
023 Karneid,44,,28,33,61
023 Karneid,45,,28,26,54
023 Karneid,46,,31,38,69
023 Karneid,47,,32,22,54
023 Karneid,48,,23,27,50
023 Karneid,49,,34,27,61
023 Karneid,50,,27,32,59
023 Karneid,51,,35,29,64
023 Karneid,52,,38,25,63
023 Karneid,53,,29,24,53
023 Karneid,54,,39,25,64
023 Karneid,55,,27,40,67
023 Karneid,56,,29,23,52
023 Karneid,57,,27,28,55
023 Karneid,58,,28,18,46
023 Karneid,59,,23,17,40
023 Karneid,60,,16,14,30
023 Karneid,61,,22,16,38
023 Karneid,62,,13,8,21
023 Karneid,63,,16,12,28
023 Karneid,64,,15,12,27
023 Karneid,65,,10,21,31
023 Karneid,66,,15,11,26
023 Karneid,67,,20,12,32
023 Karneid,68,,6,14,20
023 Karneid,69,,10,26,36
023 Karneid,70,,6,16,22
023 Karneid,71,,11,20,31
023 Karneid,72,,11,13,24
023 Karneid,73,,8,14,22
023 Karneid,74,,17,13,30
023 Karneid,75,,15,24,39
023 Karneid,76,,13,11,24
023 Karneid,77,,8,13,21
023 Karneid,78,,12,13,25
023 Karneid,79,,12,10,22
023 Karneid,80,,6,8,14
023 Karneid,81,,10,9,19
023 Karneid,82,,9,8,17
023 Karneid,83,,6,11,17
023 Karneid,84,,5,10,15
023 Karneid,85,,8,5,13
023 Karneid,86,,8,8,16
023 Karneid,87,,4,6,10
023 Karneid,88,,5,3,8
023 Karneid,89,,4,2,6
023 Karneid,90,,-,3,3
023 Karneid,91,,3,4,7
023 Karneid,92,,1,1,2
023 Karneid,93,,2,1,3
023 Karneid,94,,-,1,1
023 Karneid,95,,-,2,2
023 Karneid,97,,1,1,2
024 Kurtatsch a.d.Weinstr.,0,,6,10,16
024 Kurtatsch a.d.Weinstr.,1,,12,13,25
024 Kurtatsch a.d.Weinstr.,2,,9,16,25
024 Kurtatsch a.d.Weinstr.,3,,7,5,12
024 Kurtatsch a.d.Weinstr.,4,,22,7,29
024 Kurtatsch a.d.Weinstr.,5,,16,10,26
024 Kurtatsch a.d.Weinstr.,6,,12,9,21
024 Kurtatsch a.d.Weinstr.,7,,5,8,13
024 Kurtatsch a.d.Weinstr.,8,,10,12,22
024 Kurtatsch a.d.Weinstr.,9,,17,8,25
024 Kurtatsch a.d.Weinstr.,10,,6,4,10
024 Kurtatsch a.d.Weinstr.,11,,8,17,25
024 Kurtatsch a.d.Weinstr.,12,,13,15,28
024 Kurtatsch a.d.Weinstr.,13,,11,11,22
024 Kurtatsch a.d.Weinstr.,14,,10,12,22
024 Kurtatsch a.d.Weinstr.,15,,13,14,27
024 Kurtatsch a.d.Weinstr.,16,,16,11,27
024 Kurtatsch a.d.Weinstr.,17,,19,15,34
024 Kurtatsch a.d.Weinstr.,18,,18,11,29
024 Kurtatsch a.d.Weinstr.,19,,17,14,31
024 Kurtatsch a.d.Weinstr.,20,,14,14,28
024 Kurtatsch a.d.Weinstr.,21,,23,17,40
024 Kurtatsch a.d.Weinstr.,22,,19,13,32
024 Kurtatsch a.d.Weinstr.,23,,16,7,23
024 Kurtatsch a.d.Weinstr.,24,,22,12,34
024 Kurtatsch a.d.Weinstr.,25,,17,12,29
024 Kurtatsch a.d.Weinstr.,26,,17,12,29
024 Kurtatsch a.d.Weinstr.,27,,15,8,23
024 Kurtatsch a.d.Weinstr.,28,,8,15,23
024 Kurtatsch a.d.Weinstr.,29,,7,13,20
024 Kurtatsch a.d.Weinstr.,30,,12,15,27
024 Kurtatsch a.d.Weinstr.,31,,11,16,27
024 Kurtatsch a.d.Weinstr.,32,,18,10,28
024 Kurtatsch a.d.Weinstr.,33,,14,5,19
024 Kurtatsch a.d.Weinstr.,34,,14,9,23
024 Kurtatsch a.d.Weinstr.,35,,12,22,34
024 Kurtatsch a.d.Weinstr.,36,,16,14,30
024 Kurtatsch a.d.Weinstr.,37,,9,11,20
024 Kurtatsch a.d.Weinstr.,38,,12,15,27
024 Kurtatsch a.d.Weinstr.,39,,8,16,24
024 Kurtatsch a.d.Weinstr.,40,,8,15,23
024 Kurtatsch a.d.Weinstr.,41,,10,12,22
024 Kurtatsch a.d.Weinstr.,42,,11,12,23
024 Kurtatsch a.d.Weinstr.,43,,12,20,32
024 Kurtatsch a.d.Weinstr.,44,,15,20,35
024 Kurtatsch a.d.Weinstr.,45,,11,13,24
024 Kurtatsch a.d.Weinstr.,46,,16,21,37
024 Kurtatsch a.d.Weinstr.,47,,13,22,35
024 Kurtatsch a.d.Weinstr.,48,,26,20,46
024 Kurtatsch a.d.Weinstr.,49,,25,13,38
024 Kurtatsch a.d.Weinstr.,50,,17,20,37
024 Kurtatsch a.d.Weinstr.,51,,27,16,43
024 Kurtatsch a.d.Weinstr.,52,,27,26,53
024 Kurtatsch a.d.Weinstr.,53,,18,26,44
024 Kurtatsch a.d.Weinstr.,54,,23,20,43
024 Kurtatsch a.d.Weinstr.,55,,21,13,34
024 Kurtatsch a.d.Weinstr.,56,,18,18,36
024 Kurtatsch a.d.Weinstr.,57,,18,20,38
024 Kurtatsch a.d.Weinstr.,58,,20,9,29
024 Kurtatsch a.d.Weinstr.,59,,13,12,25
024 Kurtatsch a.d.Weinstr.,60,,12,12,24
024 Kurtatsch a.d.Weinstr.,61,,13,7,20
024 Kurtatsch a.d.Weinstr.,62,,12,18,30
024 Kurtatsch a.d.Weinstr.,63,,13,8,21
024 Kurtatsch a.d.Weinstr.,64,,16,19,35
024 Kurtatsch a.d.Weinstr.,65,,8,8,16
024 Kurtatsch a.d.Weinstr.,66,,9,13,22
024 Kurtatsch a.d.Weinstr.,67,,14,4,18
024 Kurtatsch a.d.Weinstr.,68,,11,9,20
024 Kurtatsch a.d.Weinstr.,69,,9,8,17
024 Kurtatsch a.d.Weinstr.,70,,9,10,19
024 Kurtatsch a.d.Weinstr.,71,,9,11,20
024 Kurtatsch a.d.Weinstr.,72,,5,7,12
024 Kurtatsch a.d.Weinstr.,73,,5,7,12
024 Kurtatsch a.d.Weinstr.,74,,9,6,15
024 Kurtatsch a.d.Weinstr.,75,,7,11,18
024 Kurtatsch a.d.Weinstr.,76,,5,10,15
024 Kurtatsch a.d.Weinstr.,77,,10,10,20
024 Kurtatsch a.d.Weinstr.,78,,3,14,17
024 Kurtatsch a.d.Weinstr.,79,,8,12,20
024 Kurtatsch a.d.Weinstr.,80,,4,8,12
024 Kurtatsch a.d.Weinstr.,81,,4,7,11
024 Kurtatsch a.d.Weinstr.,82,,2,7,9
024 Kurtatsch a.d.Weinstr.,83,,1,6,7
024 Kurtatsch a.d.Weinstr.,84,,7,5,12
024 Kurtatsch a.d.Weinstr.,85,,7,10,17
024 Kurtatsch a.d.Weinstr.,86,,4,6,10
024 Kurtatsch a.d.Weinstr.,87,,3,9,12
024 Kurtatsch a.d.Weinstr.,88,,5,6,11
024 Kurtatsch a.d.Weinstr.,89,,2,4,6
024 Kurtatsch a.d.Weinstr.,90,,3,4,7
024 Kurtatsch a.d.Weinstr.,91,,1,3,4
024 Kurtatsch a.d.Weinstr.,92,,1,3,4
024 Kurtatsch a.d.Weinstr.,93,,1,4,5
024 Kurtatsch a.d.Weinstr.,94,,2,3,5
024 Kurtatsch a.d.Weinstr.,96,,-,3,3
024 Kurtatsch a.d.Weinstr.,97,,2,1,3
025 Kurtinig a.d. Weinstr.,0,,5,3,8
025 Kurtinig a.d. Weinstr.,1,,2,4,6
025 Kurtinig a.d. Weinstr.,2,,7,1,8
025 Kurtinig a.d. Weinstr.,3,,2,8,10
025 Kurtinig a.d. Weinstr.,4,,3,2,5
025 Kurtinig a.d. Weinstr.,5,,3,4,7
025 Kurtinig a.d. Weinstr.,6,,3,3,6
025 Kurtinig a.d. Weinstr.,7,,3,4,7
025 Kurtinig a.d. Weinstr.,8,,6,3,9
025 Kurtinig a.d. Weinstr.,9,,4,-,4
025 Kurtinig a.d. Weinstr.,10,,5,2,7
025 Kurtinig a.d. Weinstr.,11,,4,1,5
025 Kurtinig a.d. Weinstr.,12,,-,4,4
025 Kurtinig a.d. Weinstr.,13,,1,2,3
025 Kurtinig a.d. Weinstr.,14,,5,2,7
025 Kurtinig a.d. Weinstr.,15,,3,3,6
025 Kurtinig a.d. Weinstr.,16,,1,7,8
025 Kurtinig a.d. Weinstr.,17,,2,5,7
025 Kurtinig a.d. Weinstr.,18,,3,2,5
025 Kurtinig a.d. Weinstr.,19,,4,5,9
025 Kurtinig a.d. Weinstr.,20,,2,4,6
025 Kurtinig a.d. Weinstr.,21,,2,4,6
025 Kurtinig a.d. Weinstr.,22,,7,3,10
025 Kurtinig a.d. Weinstr.,23,,3,2,5
025 Kurtinig a.d. Weinstr.,24,,5,7,12
025 Kurtinig a.d. Weinstr.,25,,4,4,8
025 Kurtinig a.d. Weinstr.,26,,6,4,10
025 Kurtinig a.d. Weinstr.,27,,3,5,8
025 Kurtinig a.d. Weinstr.,28,,6,4,10
025 Kurtinig a.d. Weinstr.,29,,8,3,11
025 Kurtinig a.d. Weinstr.,30,,7,4,11
025 Kurtinig a.d. Weinstr.,31,,7,6,13
025 Kurtinig a.d. Weinstr.,32,,5,1,6
025 Kurtinig a.d. Weinstr.,33,,5,7,12
025 Kurtinig a.d. Weinstr.,34,,3,1,4
025 Kurtinig a.d. Weinstr.,35,,4,5,9
025 Kurtinig a.d. Weinstr.,36,,8,3,11
025 Kurtinig a.d. Weinstr.,37,,3,5,8
025 Kurtinig a.d. Weinstr.,38,,4,8,12
025 Kurtinig a.d. Weinstr.,39,,5,3,8
025 Kurtinig a.d. Weinstr.,40,,4,1,5
025 Kurtinig a.d. Weinstr.,41,,1,3,4
025 Kurtinig a.d. Weinstr.,42,,2,6,8
025 Kurtinig a.d. Weinstr.,43,,3,2,5
025 Kurtinig a.d. Weinstr.,44,,6,5,11
025 Kurtinig a.d. Weinstr.,45,,2,7,9
025 Kurtinig a.d. Weinstr.,46,,4,3,7
025 Kurtinig a.d. Weinstr.,47,,5,4,9
025 Kurtinig a.d. Weinstr.,48,,6,5,11
025 Kurtinig a.d. Weinstr.,49,,3,2,5
025 Kurtinig a.d. Weinstr.,50,,4,7,11
025 Kurtinig a.d. Weinstr.,51,,1,6,7
025 Kurtinig a.d. Weinstr.,52,,3,5,8
025 Kurtinig a.d. Weinstr.,53,,6,6,12
025 Kurtinig a.d. Weinstr.,54,,8,5,13
025 Kurtinig a.d. Weinstr.,55,,5,5,10
025 Kurtinig a.d. Weinstr.,56,,6,9,15
025 Kurtinig a.d. Weinstr.,57,,7,4,11
025 Kurtinig a.d. Weinstr.,58,,11,6,17
025 Kurtinig a.d. Weinstr.,59,,4,8,12
025 Kurtinig a.d. Weinstr.,60,,7,9,16
025 Kurtinig a.d. Weinstr.,61,,5,1,6
025 Kurtinig a.d. Weinstr.,62,,1,1,2
025 Kurtinig a.d. Weinstr.,63,,6,3,9
025 Kurtinig a.d. Weinstr.,64,,4,8,12
025 Kurtinig a.d. Weinstr.,65,,2,4,6
025 Kurtinig a.d. Weinstr.,66,,3,4,7
025 Kurtinig a.d. Weinstr.,67,,1,2,3
025 Kurtinig a.d. Weinstr.,68,,3,3,6
025 Kurtinig a.d. Weinstr.,69,,3,3,6
025 Kurtinig a.d. Weinstr.,70,,5,1,6
025 Kurtinig a.d. Weinstr.,71,,-,5,5
025 Kurtinig a.d. Weinstr.,72,,2,2,4
025 Kurtinig a.d. Weinstr.,73,,2,1,3
025 Kurtinig a.d. Weinstr.,74,,4,2,6
025 Kurtinig a.d. Weinstr.,75,,2,2,4
025 Kurtinig a.d. Weinstr.,76,,4,2,6
025 Kurtinig a.d. Weinstr.,77,,2,3,5
025 Kurtinig a.d. Weinstr.,78,,4,3,7
025 Kurtinig a.d. Weinstr.,79,,1,1,2
025 Kurtinig a.d. Weinstr.,80,,1,3,4
025 Kurtinig a.d. Weinstr.,81,,3,3,6
025 Kurtinig a.d. Weinstr.,82,,-,4,4
025 Kurtinig a.d. Weinstr.,83,,2,4,6
025 Kurtinig a.d. Weinstr.,84,,-,2,2
025 Kurtinig a.d. Weinstr.,85,,1,3,4
025 Kurtinig a.d. Weinstr.,86,,1,2,3
025 Kurtinig a.d. Weinstr.,87,,2,2,4
025 Kurtinig a.d. Weinstr.,88,,1,1,2
025 Kurtinig a.d. Weinstr.,89,,-,1,1
025 Kurtinig a.d. Weinstr.,90,,1,1,2
025 Kurtinig a.d. Weinstr.,92,,-,2,2
025 Kurtinig a.d. Weinstr.,93,,-,1,1
025 Kurtinig a.d. Weinstr.,99,,-,1,1
026 Corvara,0,,6,6,12
026 Corvara,1,,10,6,16
026 Corvara,2,,10,5,15
026 Corvara,3,,9,13,22
026 Corvara,4,,4,9,13
026 Corvara,5,,10,8,18
026 Corvara,6,,6,3,9
026 Corvara,7,,12,8,20
026 Corvara,8,,9,7,16
026 Corvara,9,,6,5,11
026 Corvara,10,,5,10,15
026 Corvara,11,,8,3,11
026 Corvara,12,,8,7,15
026 Corvara,13,,6,3,9
026 Corvara,14,,12,5,17
026 Corvara,15,,5,3,8
026 Corvara,16,,5,6,11
026 Corvara,17,,8,4,12
026 Corvara,18,,8,7,15
026 Corvara,19,,9,8,17
026 Corvara,20,,3,6,9
026 Corvara,21,,9,5,14
026 Corvara,22,,8,7,15
026 Corvara,23,,8,3,11
026 Corvara,24,,6,3,9
026 Corvara,25,,8,8,16
026 Corvara,26,,5,6,11
026 Corvara,27,,11,10,21
026 Corvara,28,,5,6,11
026 Corvara,29,,4,6,10
026 Corvara,30,,9,9,18
026 Corvara,31,,5,1,6
026 Corvara,32,,5,13,18
026 Corvara,33,,5,3,8
026 Corvara,34,,4,6,10
026 Corvara,35,,11,12,23
026 Corvara,36,,12,4,16
026 Corvara,37,,8,9,17
026 Corvara,38,,8,9,17
026 Corvara,39,,14,6,20
026 Corvara,40,,15,12,27
026 Corvara,41,,12,7,19
026 Corvara,42,,7,23,30
026 Corvara,43,,7,14,21
026 Corvara,44,,10,14,24
026 Corvara,45,,11,7,18
026 Corvara,46,,11,6,17
026 Corvara,47,,10,13,23
026 Corvara,48,,16,14,30
026 Corvara,49,,8,15,23
026 Corvara,50,,15,20,35
026 Corvara,51,,13,16,29
026 Corvara,52,,16,18,34
026 Corvara,53,,6,9,15
026 Corvara,54,,15,6,21
026 Corvara,55,,12,12,24
026 Corvara,56,,8,8,16
026 Corvara,57,,13,13,26
026 Corvara,58,,8,7,15
026 Corvara,59,,11,11,22
026 Corvara,60,,8,4,12
026 Corvara,61,,5,5,10
026 Corvara,62,,11,7,18
026 Corvara,63,,9,9,18
026 Corvara,64,,5,11,16
026 Corvara,65,,4,8,12
026 Corvara,66,,4,10,14
026 Corvara,67,,6,8,14
026 Corvara,68,,2,8,10
026 Corvara,69,,5,5,10
026 Corvara,70,,3,9,12
026 Corvara,71,,10,9,19
026 Corvara,72,,5,3,8
026 Corvara,73,,5,9,14
026 Corvara,74,,4,10,14
026 Corvara,75,,6,7,13
026 Corvara,76,,8,8,16
026 Corvara,77,,7,6,13
026 Corvara,78,,5,3,8
026 Corvara,79,,2,7,9
026 Corvara,80,,6,8,14
026 Corvara,81,,3,6,9
026 Corvara,82,,3,2,5
026 Corvara,83,,2,8,10
026 Corvara,84,,3,3,6
026 Corvara,85,,4,4,8
026 Corvara,86,,2,4,6
026 Corvara,87,,2,3,5
026 Corvara,88,,3,4,7
026 Corvara,89,,1,1,2
026 Corvara,90,,2,1,3
026 Corvara,91,,1,-,1
026 Corvara,92,,1,2,3
026 Corvara,93,,1,-,1
026 Corvara,94,,2,1,3
026 Corvara,95,,1,1,2
026 Corvara,96,,1,-,1
027 Graun im Vinschgau,0,,2,16,18
027 Graun im Vinschgau,1,,14,8,22
027 Graun im Vinschgau,2,,6,9,15
027 Graun im Vinschgau,3,,14,10,24
027 Graun im Vinschgau,4,,16,8,24
027 Graun im Vinschgau,5,,16,19,35
027 Graun im Vinschgau,6,,20,14,34
027 Graun im Vinschgau,7,,10,12,22
027 Graun im Vinschgau,8,,18,19,37
027 Graun im Vinschgau,9,,16,8,24
027 Graun im Vinschgau,10,,18,12,30
027 Graun im Vinschgau,11,,16,20,36
027 Graun im Vinschgau,12,,13,15,28
027 Graun im Vinschgau,13,,15,13,28
027 Graun im Vinschgau,14,,9,10,19
027 Graun im Vinschgau,15,,10,11,21
027 Graun im Vinschgau,16,,14,12,26
027 Graun im Vinschgau,17,,13,16,29
027 Graun im Vinschgau,18,,13,8,21
027 Graun im Vinschgau,19,,10,14,24
027 Graun im Vinschgau,20,,18,17,35
027 Graun im Vinschgau,21,,17,15,32
027 Graun im Vinschgau,22,,17,14,31
027 Graun im Vinschgau,23,,18,10,28
027 Graun im Vinschgau,24,,19,13,32
027 Graun im Vinschgau,25,,16,14,30
027 Graun im Vinschgau,26,,9,15,24
027 Graun im Vinschgau,27,,17,18,35
027 Graun im Vinschgau,28,,23,17,40
027 Graun im Vinschgau,29,,20,8,28
027 Graun im Vinschgau,30,,18,13,31
027 Graun im Vinschgau,31,,6,4,10
027 Graun im Vinschgau,32,,20,6,26
027 Graun im Vinschgau,33,,14,8,22
027 Graun im Vinschgau,34,,8,12,20
027 Graun im Vinschgau,35,,16,13,29
027 Graun im Vinschgau,36,,22,15,37
027 Graun im Vinschgau,37,,20,17,37
027 Graun im Vinschgau,38,,14,16,30
027 Graun im Vinschgau,39,,13,15,28
027 Graun im Vinschgau,40,,15,21,36
027 Graun im Vinschgau,41,,11,21,32
027 Graun im Vinschgau,42,,21,18,39
027 Graun im Vinschgau,43,,19,15,34
027 Graun im Vinschgau,44,,17,19,36
027 Graun im Vinschgau,45,,20,18,38
027 Graun im Vinschgau,46,,21,10,31
027 Graun im Vinschgau,47,,22,15,37
027 Graun im Vinschgau,48,,24,17,41
027 Graun im Vinschgau,49,,16,21,37
027 Graun im Vinschgau,50,,23,18,41
027 Graun im Vinschgau,51,,18,23,41
027 Graun im Vinschgau,52,,15,18,33
027 Graun im Vinschgau,53,,21,22,43
027 Graun im Vinschgau,54,,20,17,37
027 Graun im Vinschgau,55,,20,22,42
027 Graun im Vinschgau,56,,19,12,31
027 Graun im Vinschgau,57,,19,19,38
027 Graun im Vinschgau,58,,16,11,27
027 Graun im Vinschgau,59,,19,15,34
027 Graun im Vinschgau,60,,11,14,25
027 Graun im Vinschgau,61,,13,9,22
027 Graun im Vinschgau,62,,13,8,21
027 Graun im Vinschgau,63,,15,13,28
027 Graun im Vinschgau,64,,11,6,17
027 Graun im Vinschgau,65,,14,8,22
027 Graun im Vinschgau,66,,11,16,27
027 Graun im Vinschgau,67,,9,12,21
027 Graun im Vinschgau,68,,7,20,27
027 Graun im Vinschgau,69,,13,11,24
027 Graun im Vinschgau,70,,5,9,14
027 Graun im Vinschgau,71,,9,7,16
027 Graun im Vinschgau,72,,6,6,12
027 Graun im Vinschgau,73,,7,10,17
027 Graun im Vinschgau,74,,8,12,20
027 Graun im Vinschgau,75,,8,9,17
027 Graun im Vinschgau,76,,13,10,23
027 Graun im Vinschgau,77,,10,10,20
027 Graun im Vinschgau,78,,7,10,17
027 Graun im Vinschgau,79,,8,12,20
027 Graun im Vinschgau,80,,10,3,13
027 Graun im Vinschgau,81,,9,12,21
027 Graun im Vinschgau,82,,5,7,12
027 Graun im Vinschgau,83,,8,7,15
027 Graun im Vinschgau,84,,4,7,11
027 Graun im Vinschgau,85,,7,3,10
027 Graun im Vinschgau,86,,3,7,10
027 Graun im Vinschgau,87,,2,3,5
027 Graun im Vinschgau,88,,3,9,12
027 Graun im Vinschgau,89,,4,5,9
027 Graun im Vinschgau,90,,2,1,3
027 Graun im Vinschgau,91,,2,6,8
027 Graun im Vinschgau,92,,-,3,3
027 Graun im Vinschgau,93,,1,2,3
027 Graun im Vinschgau,94,,2,2,4
027 Graun im Vinschgau,95,,-,1,1
027 Graun im Vinschgau,97,,1,-,1
028 Toblach,0,,15,15,30
028 Toblach,1,,15,19,34
028 Toblach,2,,18,15,33
028 Toblach,3,,19,15,34
028 Toblach,4,,20,16,36
028 Toblach,5,,17,26,43
028 Toblach,6,,18,23,41
028 Toblach,7,,20,22,42
028 Toblach,8,,19,18,37
028 Toblach,9,,23,23,46
028 Toblach,10,,23,16,39
028 Toblach,11,,22,9,31
028 Toblach,12,,14,20,34
028 Toblach,13,,20,23,43
028 Toblach,14,,20,24,44
028 Toblach,15,,13,18,31
028 Toblach,16,,25,18,43
028 Toblach,17,,25,15,40
028 Toblach,18,,15,23,38
028 Toblach,19,,17,13,30
028 Toblach,20,,24,16,40
028 Toblach,21,,27,18,45
028 Toblach,22,,17,10,27
028 Toblach,23,,19,15,34
028 Toblach,24,,19,17,36
028 Toblach,25,,13,16,29
028 Toblach,26,,21,20,41
028 Toblach,27,,15,21,36
028 Toblach,28,,11,15,26
028 Toblach,29,,19,20,39
028 Toblach,30,,30,15,45
028 Toblach,31,,16,20,36
028 Toblach,32,,20,18,38
028 Toblach,33,,20,20,40
028 Toblach,34,,20,24,44
028 Toblach,35,,20,26,46
028 Toblach,36,,21,22,43
028 Toblach,37,,22,23,45
028 Toblach,38,,25,26,51
028 Toblach,39,,20,17,37
028 Toblach,40,,14,18,32
028 Toblach,41,,27,34,61
028 Toblach,42,,22,23,45
028 Toblach,43,,29,23,52
028 Toblach,44,,31,25,56
028 Toblach,45,,25,33,58
028 Toblach,46,,29,21,50
028 Toblach,47,,21,24,45
028 Toblach,48,,38,24,62
028 Toblach,49,,31,28,59
028 Toblach,50,,26,18,44
028 Toblach,51,,30,28,58
028 Toblach,52,,30,31,61
028 Toblach,53,,36,30,66
028 Toblach,54,,25,25,50
028 Toblach,55,,35,29,64
028 Toblach,56,,25,33,58
028 Toblach,57,,21,17,38
028 Toblach,58,,30,25,55
028 Toblach,59,,19,17,36
028 Toblach,60,,28,22,50
028 Toblach,61,,16,24,40
028 Toblach,62,,15,26,41
028 Toblach,63,,20,19,39
028 Toblach,64,,20,23,43
028 Toblach,65,,18,15,33
028 Toblach,66,,22,11,33
028 Toblach,67,,14,15,29
028 Toblach,68,,19,12,31
028 Toblach,69,,15,23,38
028 Toblach,70,,14,15,29
028 Toblach,71,,12,13,25
028 Toblach,72,,7,17,24
028 Toblach,73,,14,10,24
028 Toblach,74,,10,17,27
028 Toblach,75,,12,15,27
028 Toblach,76,,15,12,27
028 Toblach,77,,10,12,22
028 Toblach,78,,12,10,22
028 Toblach,79,,12,5,17
028 Toblach,80,,2,10,12
028 Toblach,81,,4,13,17
028 Toblach,82,,5,13,18
028 Toblach,83,,6,14,20
028 Toblach,84,,6,8,14
028 Toblach,85,,5,11,16
028 Toblach,86,,6,9,15
028 Toblach,87,,6,4,10
028 Toblach,88,,3,5,8
028 Toblach,89,,4,1,5
028 Toblach,90,,3,2,5
028 Toblach,91,,1,3,4
028 Toblach,92,,1,2,3
028 Toblach,93,,2,3,5
028 Toblach,94,,2,-,2
028 Toblach,95,,-,2,2
028 Toblach,96,,-,1,1
028 Toblach,97,,1,-,1
029 Neumarkt,0,,20,19,39
029 Neumarkt,1,,28,28,56
029 Neumarkt,2,,22,24,46
029 Neumarkt,3,,30,27,57
029 Neumarkt,4,,24,25,49
029 Neumarkt,5,,40,39,79
029 Neumarkt,6,,30,17,47
029 Neumarkt,7,,28,29,57
029 Neumarkt,8,,32,28,60
029 Neumarkt,9,,30,28,58
029 Neumarkt,10,,28,23,51
029 Neumarkt,11,,25,27,52
029 Neumarkt,12,,39,37,76
029 Neumarkt,13,,26,19,45
029 Neumarkt,14,,36,33,69
029 Neumarkt,15,,29,25,54
029 Neumarkt,16,,33,34,67
029 Neumarkt,17,,30,24,54
029 Neumarkt,18,,26,27,53
029 Neumarkt,19,,20,42,62
029 Neumarkt,20,,26,21,47
029 Neumarkt,21,,23,27,50
029 Neumarkt,22,,27,24,51
029 Neumarkt,23,,26,29,55
029 Neumarkt,24,,25,38,63
029 Neumarkt,25,,28,30,58
029 Neumarkt,26,,26,25,51
029 Neumarkt,27,,26,26,52
029 Neumarkt,28,,32,32,64
029 Neumarkt,29,,28,26,54
029 Neumarkt,30,,29,33,62
029 Neumarkt,31,,27,28,55
029 Neumarkt,32,,21,23,44
029 Neumarkt,33,,29,30,59
029 Neumarkt,34,,31,27,58
029 Neumarkt,35,,33,33,66
029 Neumarkt,36,,36,29,65
029 Neumarkt,37,,31,50,81
029 Neumarkt,38,,33,33,66
029 Neumarkt,39,,41,40,81
029 Neumarkt,40,,26,32,58
029 Neumarkt,41,,34,39,73
029 Neumarkt,42,,40,44,84
029 Neumarkt,43,,39,42,81
029 Neumarkt,44,,35,39,74
029 Neumarkt,45,,42,35,77
029 Neumarkt,46,,38,47,85
029 Neumarkt,47,,42,41,83
029 Neumarkt,48,,42,38,80
029 Neumarkt,49,,35,51,86
029 Neumarkt,50,,50,48,98
029 Neumarkt,51,,56,57,113
029 Neumarkt,52,,57,43,100
029 Neumarkt,53,,46,48,94
029 Neumarkt,54,,52,50,102
029 Neumarkt,55,,43,35,78
029 Neumarkt,56,,35,48,83
029 Neumarkt,57,,51,39,90
029 Neumarkt,58,,48,33,81
029 Neumarkt,59,,27,36,63
029 Neumarkt,60,,42,34,76
029 Neumarkt,61,,26,34,60
029 Neumarkt,62,,42,43,85
029 Neumarkt,63,,34,29,63
029 Neumarkt,64,,17,17,34
029 Neumarkt,65,,26,21,47
029 Neumarkt,66,,25,25,50
029 Neumarkt,67,,19,25,44
029 Neumarkt,68,,15,24,39
029 Neumarkt,69,,20,25,45
029 Neumarkt,70,,21,30,51
029 Neumarkt,71,,28,34,62
029 Neumarkt,72,,18,23,41
029 Neumarkt,73,,19,15,34
029 Neumarkt,74,,19,22,41
029 Neumarkt,75,,22,23,45
029 Neumarkt,76,,32,23,55
029 Neumarkt,77,,20,28,48
029 Neumarkt,78,,14,24,38
029 Neumarkt,79,,20,12,32
029 Neumarkt,80,,18,14,32
029 Neumarkt,81,,13,17,30
029 Neumarkt,82,,11,19,30
029 Neumarkt,83,,10,16,26
029 Neumarkt,84,,12,12,24
029 Neumarkt,85,,8,23,31
029 Neumarkt,86,,13,20,33
029 Neumarkt,87,,5,21,26
029 Neumarkt,88,,5,13,18
029 Neumarkt,89,,2,11,13
029 Neumarkt,90,,5,6,11
029 Neumarkt,91,,4,8,12
029 Neumarkt,92,,4,8,12
029 Neumarkt,93,,-,6,6
029 Neumarkt,94,,2,2,4
029 Neumarkt,95,,1,2,3
029 Neumarkt,96,,1,3,4
029 Neumarkt,97,,1,2,3
029 Neumarkt,98,,1,-,1
029 Neumarkt,100,,-,1,1
030 Pfalzen,0,,22,23,45
030 Pfalzen,1,,20,20,40
030 Pfalzen,2,,14,16,30
030 Pfalzen,3,,12,6,18
030 Pfalzen,4,,14,24,38
030 Pfalzen,5,,21,11,32
030 Pfalzen,6,,18,24,42
030 Pfalzen,7,,16,14,30
030 Pfalzen,8,,15,17,32
030 Pfalzen,9,,16,21,37
030 Pfalzen,10,,13,9,22
030 Pfalzen,11,,20,20,40
030 Pfalzen,12,,17,17,34
030 Pfalzen,13,,13,21,34
030 Pfalzen,14,,20,13,33
030 Pfalzen,15,,16,18,34
030 Pfalzen,16,,15,13,28
030 Pfalzen,17,,17,18,35
030 Pfalzen,18,,21,21,42
030 Pfalzen,19,,16,16,32
030 Pfalzen,20,,13,16,29
030 Pfalzen,21,,19,16,35
030 Pfalzen,22,,22,18,40
030 Pfalzen,23,,12,18,30
030 Pfalzen,24,,12,15,27
030 Pfalzen,25,,13,20,33
030 Pfalzen,26,,14,17,31
030 Pfalzen,27,,18,17,35
030 Pfalzen,28,,18,24,42
030 Pfalzen,29,,19,8,27
030 Pfalzen,30,,12,21,33
030 Pfalzen,31,,17,15,32
030 Pfalzen,32,,22,15,37
030 Pfalzen,33,,16,12,28
030 Pfalzen,34,,13,14,27
030 Pfalzen,35,,20,18,38
030 Pfalzen,36,,20,21,41
030 Pfalzen,37,,24,21,45
030 Pfalzen,38,,22,23,45
030 Pfalzen,39,,17,24,41
030 Pfalzen,40,,21,25,46
030 Pfalzen,41,,17,12,29
030 Pfalzen,42,,17,15,32
030 Pfalzen,43,,25,15,40
030 Pfalzen,44,,17,24,41
030 Pfalzen,45,,25,25,50
030 Pfalzen,46,,27,25,52
030 Pfalzen,47,,21,24,45
030 Pfalzen,48,,30,13,43
030 Pfalzen,49,,26,35,61
030 Pfalzen,50,,21,22,43
030 Pfalzen,51,,24,22,46
030 Pfalzen,52,,23,27,50
030 Pfalzen,53,,19,22,41
030 Pfalzen,54,,31,20,51
030 Pfalzen,55,,24,31,55
030 Pfalzen,56,,26,23,49
030 Pfalzen,57,,21,16,37
030 Pfalzen,58,,15,19,34
030 Pfalzen,59,,16,23,39
030 Pfalzen,60,,24,19,43
030 Pfalzen,61,,17,17,34
030 Pfalzen,62,,18,12,30
030 Pfalzen,63,,17,10,27
030 Pfalzen,64,,14,12,26
030 Pfalzen,65,,11,10,21
030 Pfalzen,66,,16,14,30
030 Pfalzen,67,,11,13,24
030 Pfalzen,68,,16,7,23
030 Pfalzen,69,,10,11,21
030 Pfalzen,70,,12,3,15
030 Pfalzen,71,,7,11,18
030 Pfalzen,72,,4,8,12
030 Pfalzen,73,,10,5,15
030 Pfalzen,74,,7,10,17
030 Pfalzen,75,,6,10,16
030 Pfalzen,76,,9,7,16
030 Pfalzen,77,,13,9,22
030 Pfalzen,78,,8,5,13
030 Pfalzen,79,,11,9,20
030 Pfalzen,80,,5,5,10
030 Pfalzen,81,,2,7,9
030 Pfalzen,82,,5,6,11
030 Pfalzen,83,,6,7,13
030 Pfalzen,84,,2,5,7
030 Pfalzen,85,,4,2,6
030 Pfalzen,86,,4,5,9
030 Pfalzen,87,,4,6,10
030 Pfalzen,88,,3,2,5
030 Pfalzen,89,,-,1,1
030 Pfalzen,90,,-,2,2
030 Pfalzen,91,,-,1,1
030 Pfalzen,92,,1,1,2
030 Pfalzen,94,,2,-,2
030 Pfalzen,95,,-,1,1
031 Völs am Schlern,0,,20,17,37
031 Völs am Schlern,1,,23,17,40
031 Völs am Schlern,2,,17,18,35
031 Völs am Schlern,3,,23,19,42
031 Völs am Schlern,4,,20,14,34
031 Völs am Schlern,5,,17,25,42
031 Völs am Schlern,6,,16,21,37
031 Völs am Schlern,7,,25,17,42
031 Völs am Schlern,8,,24,18,42
031 Völs am Schlern,9,,23,34,57
031 Völs am Schlern,10,,23,24,47
031 Völs am Schlern,11,,19,25,44
031 Völs am Schlern,12,,35,16,51
031 Völs am Schlern,13,,21,11,32
031 Völs am Schlern,14,,15,21,36
031 Völs am Schlern,15,,18,32,50
031 Völs am Schlern,16,,20,29,49
031 Völs am Schlern,17,,23,26,49
031 Völs am Schlern,18,,20,19,39
031 Völs am Schlern,19,,29,30,59
031 Völs am Schlern,20,,20,25,45
031 Völs am Schlern,21,,14,21,35
031 Völs am Schlern,22,,24,25,49
031 Völs am Schlern,23,,20,17,37
031 Völs am Schlern,24,,15,15,30
031 Völs am Schlern,25,,23,18,41
031 Völs am Schlern,26,,14,22,36
031 Völs am Schlern,27,,22,18,40
031 Völs am Schlern,28,,24,21,45
031 Völs am Schlern,29,,19,18,37
031 Völs am Schlern,30,,23,24,47
031 Völs am Schlern,31,,26,21,47
031 Völs am Schlern,32,,16,16,32
031 Völs am Schlern,33,,16,9,25
031 Völs am Schlern,34,,14,29,43
031 Völs am Schlern,35,,23,27,50
031 Völs am Schlern,36,,35,20,55
031 Völs am Schlern,37,,35,17,52
031 Völs am Schlern,38,,31,31,62
031 Völs am Schlern,39,,27,22,49
031 Völs am Schlern,40,,18,23,41
031 Völs am Schlern,41,,28,26,54
031 Völs am Schlern,42,,22,18,40
031 Völs am Schlern,43,,30,24,54
031 Völs am Schlern,44,,27,30,57
031 Völs am Schlern,45,,39,29,68
031 Völs am Schlern,46,,40,41,81
031 Völs am Schlern,47,,33,39,72
031 Völs am Schlern,48,,36,38,74
031 Völs am Schlern,49,,35,36,71
031 Völs am Schlern,50,,30,26,56
031 Völs am Schlern,51,,36,30,66
031 Völs am Schlern,52,,26,30,56
031 Völs am Schlern,53,,27,23,50
031 Völs am Schlern,54,,27,24,51
031 Völs am Schlern,55,,27,23,50
031 Völs am Schlern,56,,22,24,46
031 Völs am Schlern,57,,17,21,38
031 Völs am Schlern,58,,22,15,37
031 Völs am Schlern,59,,20,14,34
031 Völs am Schlern,60,,15,20,35
031 Völs am Schlern,61,,18,16,34
031 Völs am Schlern,62,,18,14,32
031 Völs am Schlern,63,,18,26,44
031 Völs am Schlern,64,,16,24,40
031 Völs am Schlern,65,,15,18,33
031 Völs am Schlern,66,,19,22,41
031 Völs am Schlern,67,,18,16,34
031 Völs am Schlern,68,,14,10,24
031 Völs am Schlern,69,,16,15,31
031 Völs am Schlern,70,,12,18,30
031 Völs am Schlern,71,,14,11,25
031 Völs am Schlern,72,,5,8,13
031 Völs am Schlern,73,,12,8,20
031 Völs am Schlern,74,,15,19,34
031 Völs am Schlern,75,,15,18,33
031 Völs am Schlern,76,,16,16,32
031 Völs am Schlern,77,,8,19,27
031 Völs am Schlern,78,,9,10,19
031 Völs am Schlern,79,,10,14,24
031 Völs am Schlern,80,,9,8,17
031 Völs am Schlern,81,,5,17,22
031 Völs am Schlern,82,,11,11,22
031 Völs am Schlern,83,,11,6,17
031 Völs am Schlern,84,,5,12,17
031 Völs am Schlern,85,,7,5,12
031 Völs am Schlern,86,,6,9,15
031 Völs am Schlern,87,,2,8,10
031 Völs am Schlern,88,,2,5,7
031 Völs am Schlern,89,,1,9,10
031 Völs am Schlern,90,,2,5,7
031 Völs am Schlern,91,,-,2,2
031 Völs am Schlern,92,,1,1,2
031 Völs am Schlern,93,,1,5,6
031 Völs am Schlern,94,,1,1,2
031 Völs am Schlern,95,,-,3,3
031 Völs am Schlern,96,,-,3,3
031 Völs am Schlern,99,,-,1,1
031 Völs am Schlern,100,,1,-,1
032 Franzensfeste,0,,11,5,16
032 Franzensfeste,1,,10,5,15
032 Franzensfeste,2,,8,5,13
032 Franzensfeste,3,,5,16,21
032 Franzensfeste,4,,4,4,8
032 Franzensfeste,5,,7,9,16
032 Franzensfeste,6,,7,8,15
032 Franzensfeste,7,,13,11,24
032 Franzensfeste,8,,3,7,10
032 Franzensfeste,9,,8,8,16
032 Franzensfeste,10,,8,5,13
032 Franzensfeste,11,,4,5,9
032 Franzensfeste,12,,4,5,9
032 Franzensfeste,13,,3,3,6
032 Franzensfeste,14,,10,2,12
032 Franzensfeste,15,,9,1,10
032 Franzensfeste,16,,3,4,7
032 Franzensfeste,17,,3,7,10
032 Franzensfeste,18,,3,4,7
032 Franzensfeste,19,,7,6,13
032 Franzensfeste,20,,3,5,8
032 Franzensfeste,21,,6,2,8
032 Franzensfeste,22,,5,3,8
032 Franzensfeste,23,,8,5,13
032 Franzensfeste,24,,6,5,11
032 Franzensfeste,25,,7,8,15
032 Franzensfeste,26,,3,6,9
032 Franzensfeste,27,,3,10,13
032 Franzensfeste,28,,5,3,8
032 Franzensfeste,29,,4,5,9
032 Franzensfeste,30,,11,7,18
032 Franzensfeste,31,,5,3,8
032 Franzensfeste,32,,7,7,14
032 Franzensfeste,33,,5,5,10
032 Franzensfeste,34,,3,8,11
032 Franzensfeste,35,,4,11,15
032 Franzensfeste,36,,10,5,15
032 Franzensfeste,37,,10,10,20
032 Franzensfeste,38,,12,4,16
032 Franzensfeste,39,,9,11,20
032 Franzensfeste,40,,4,7,11
032 Franzensfeste,41,,4,4,8
032 Franzensfeste,42,,9,11,20
032 Franzensfeste,43,,13,5,18
032 Franzensfeste,44,,1,5,6
032 Franzensfeste,45,,10,6,16
032 Franzensfeste,46,,5,5,10
032 Franzensfeste,47,,7,6,13
032 Franzensfeste,48,,7,9,16
032 Franzensfeste,49,,7,13,20
032 Franzensfeste,50,,10,4,14
032 Franzensfeste,51,,10,5,15
032 Franzensfeste,52,,9,7,16
032 Franzensfeste,53,,14,7,21
032 Franzensfeste,54,,10,8,18
032 Franzensfeste,55,,11,5,16
032 Franzensfeste,56,,4,4,8
032 Franzensfeste,57,,1,9,10
032 Franzensfeste,58,,6,7,13
032 Franzensfeste,59,,10,3,13
032 Franzensfeste,60,,4,7,11
032 Franzensfeste,61,,5,6,11
032 Franzensfeste,62,,7,8,15
032 Franzensfeste,63,,7,7,14
032 Franzensfeste,64,,3,7,10
032 Franzensfeste,65,,3,4,7
032 Franzensfeste,66,,6,1,7
032 Franzensfeste,67,,11,3,14
032 Franzensfeste,68,,3,4,7
032 Franzensfeste,69,,5,3,8
032 Franzensfeste,70,,2,3,5
032 Franzensfeste,71,,7,5,12
032 Franzensfeste,72,,3,6,9
032 Franzensfeste,73,,3,7,10
032 Franzensfeste,74,,3,1,4
032 Franzensfeste,75,,4,-,4
032 Franzensfeste,76,,2,3,5
032 Franzensfeste,77,,2,3,5
032 Franzensfeste,78,,3,2,5
032 Franzensfeste,79,,1,3,4
032 Franzensfeste,80,,4,5,9
032 Franzensfeste,81,,-,1,1
032 Franzensfeste,82,,-,2,2
032 Franzensfeste,83,,1,3,4
032 Franzensfeste,84,,-,3,3
032 Franzensfeste,85,,3,3,6
032 Franzensfeste,86,,-,3,3
032 Franzensfeste,87,,3,3,6
032 Franzensfeste,88,,-,2,2
032 Franzensfeste,89,,-,3,3
032 Franzensfeste,90,,1,-,1
032 Franzensfeste,91,,-,4,4
032 Franzensfeste,93,,1,-,1
032 Franzensfeste,94,,-,4,4
032 Franzensfeste,95,,-,1,1
032 Franzensfeste,96,,-,1,1
033 Villnöss,0,,12,16,28
033 Villnöss,1,,16,15,31
033 Villnöss,2,,15,19,34
033 Villnöss,3,,18,14,32
033 Villnöss,4,,14,9,23
033 Villnöss,5,,19,17,36
033 Villnöss,6,,8,22,30
033 Villnöss,7,,17,19,36
033 Villnöss,8,,17,13,30
033 Villnöss,9,,19,9,28
033 Villnöss,10,,16,14,30
033 Villnöss,11,,14,24,38
033 Villnöss,12,,19,22,41
033 Villnöss,13,,10,16,26
033 Villnöss,14,,16,14,30
033 Villnöss,15,,21,14,35
033 Villnöss,16,,15,24,39
033 Villnöss,17,,17,15,32
033 Villnöss,18,,17,30,47
033 Villnöss,19,,24,19,43
033 Villnöss,20,,20,23,43
033 Villnöss,21,,22,17,39
033 Villnöss,22,,19,14,33
033 Villnöss,23,,14,12,26
033 Villnöss,24,,16,9,25
033 Villnöss,25,,15,13,28
033 Villnöss,26,,22,10,32
033 Villnöss,27,,17,9,26
033 Villnöss,28,,11,12,23
033 Villnöss,29,,12,18,30
033 Villnöss,30,,16,15,31
033 Villnöss,31,,10,19,29
033 Villnöss,32,,10,17,27
033 Villnöss,33,,18,18,36
033 Villnöss,34,,15,15,30
033 Villnöss,35,,13,10,23
033 Villnöss,36,,11,17,28
033 Villnöss,37,,21,9,30
033 Villnöss,38,,8,12,20
033 Villnöss,39,,15,16,31
033 Villnöss,40,,12,11,23
033 Villnöss,41,,18,12,30
033 Villnöss,42,,21,13,34
033 Villnöss,43,,19,15,34
033 Villnöss,44,,14,17,31
033 Villnöss,45,,17,27,44
033 Villnöss,46,,22,23,45
033 Villnöss,47,,17,28,45
033 Villnöss,48,,27,21,48
033 Villnöss,49,,29,17,46
033 Villnöss,50,,17,19,36
033 Villnöss,51,,24,19,43
033 Villnöss,52,,29,21,50
033 Villnöss,53,,31,22,53
033 Villnöss,54,,29,20,49
033 Villnöss,55,,28,21,49
033 Villnöss,56,,19,14,33
033 Villnöss,57,,20,12,32
033 Villnöss,58,,10,10,20
033 Villnöss,59,,11,12,23
033 Villnöss,60,,12,15,27
033 Villnöss,61,,14,17,31
033 Villnöss,62,,12,2,14
033 Villnöss,63,,15,12,27
033 Villnöss,64,,11,15,26
033 Villnöss,65,,9,12,21
033 Villnöss,66,,11,10,21
033 Villnöss,67,,6,7,13
033 Villnöss,68,,7,14,21
033 Villnöss,69,,8,10,18
033 Villnöss,70,,13,10,23
033 Villnöss,71,,8,5,13
033 Villnöss,72,,7,5,12
033 Villnöss,73,,5,12,17
033 Villnöss,74,,10,8,18
033 Villnöss,75,,11,18,29
033 Villnöss,76,,10,9,19
033 Villnöss,77,,6,16,22
033 Villnöss,78,,8,12,20
033 Villnöss,79,,9,8,17
033 Villnöss,80,,6,14,20
033 Villnöss,81,,3,14,17
033 Villnöss,82,,3,9,12
033 Villnöss,83,,4,8,12
033 Villnöss,84,,6,6,12
033 Villnöss,85,,10,11,21
033 Villnöss,86,,6,9,15
033 Villnöss,87,,4,8,12
033 Villnöss,88,,4,6,10
033 Villnöss,89,,5,5,10
033 Villnöss,90,,2,5,7
033 Villnöss,91,,-,5,5
033 Villnöss,92,,1,2,3
033 Villnöss,93,,1,1,2
033 Villnöss,94,,1,3,4
033 Villnöss,95,,1,3,4
033 Villnöss,97,,-,1,1
034 Gais,0,,16,11,27
034 Gais,1,,18,15,33
034 Gais,2,,16,12,28
034 Gais,3,,18,12,30
034 Gais,4,,20,14,34
034 Gais,5,,16,16,32
034 Gais,6,,20,20,40
034 Gais,7,,30,16,46
034 Gais,8,,26,13,39
034 Gais,9,,14,19,33
034 Gais,10,,18,17,35
034 Gais,11,,22,15,37
034 Gais,12,,28,18,46
034 Gais,13,,16,25,41
034 Gais,14,,16,16,32
034 Gais,15,,21,25,46
034 Gais,16,,20,17,37
034 Gais,17,,22,19,41
034 Gais,18,,21,22,43
034 Gais,19,,27,19,46
034 Gais,20,,29,14,43
034 Gais,21,,9,17,26
034 Gais,22,,28,18,46
034 Gais,23,,26,23,49
034 Gais,24,,15,20,35
034 Gais,25,,18,26,44
034 Gais,26,,25,25,50
034 Gais,27,,13,17,30
034 Gais,28,,19,15,34
034 Gais,29,,19,18,37
034 Gais,30,,14,16,30
034 Gais,31,,15,19,34
034 Gais,32,,17,17,34
034 Gais,33,,29,24,53
034 Gais,34,,19,20,39
034 Gais,35,,22,18,40
034 Gais,36,,21,26,47
034 Gais,37,,24,27,51
034 Gais,38,,20,17,37
034 Gais,39,,21,22,43
034 Gais,40,,17,24,41
034 Gais,41,,24,24,48
034 Gais,42,,23,26,49
034 Gais,43,,33,29,62
034 Gais,44,,27,23,50
034 Gais,45,,32,41,73
034 Gais,46,,34,27,61
034 Gais,47,,28,24,52
034 Gais,48,,37,32,69
034 Gais,49,,28,22,50
034 Gais,50,,31,31,62
034 Gais,51,,28,24,52
034 Gais,52,,24,27,51
034 Gais,53,,28,30,58
034 Gais,54,,21,19,40
034 Gais,55,,29,21,50
034 Gais,56,,18,25,43
034 Gais,57,,18,12,30
034 Gais,58,,17,22,39
034 Gais,59,,23,18,41
034 Gais,60,,10,17,27
034 Gais,61,,23,21,44
034 Gais,62,,16,10,26
034 Gais,63,,16,13,29
034 Gais,64,,13,12,25
034 Gais,65,,14,18,32
034 Gais,66,,14,20,34
034 Gais,67,,20,24,44
034 Gais,68,,13,11,24
034 Gais,69,,21,13,34
034 Gais,70,,19,11,30
034 Gais,71,,17,15,32
034 Gais,72,,12,8,20
034 Gais,73,,13,14,27
034 Gais,74,,9,15,24
034 Gais,75,,8,13,21
034 Gais,76,,18,12,30
034 Gais,77,,15,12,27
034 Gais,78,,11,14,25
034 Gais,79,,13,12,25
034 Gais,80,,14,12,26
034 Gais,81,,7,11,18
034 Gais,82,,7,11,18
034 Gais,83,,4,4,8
034 Gais,84,,3,7,10
034 Gais,85,,2,5,7
034 Gais,86,,5,3,8
034 Gais,87,,4,5,9
034 Gais,88,,-,2,2
034 Gais,89,,1,2,3
034 Gais,90,,1,5,6
034 Gais,91,,2,2,4
034 Gais,92,,1,1,2
034 Gais,93,,1,1,2
034 Gais,94,,-,3,3
034 Gais,95,,-,1,1
034 Gais,99,,1,1,2
035 Gargazon,0,,12,5,17
035 Gargazon,1,,10,5,15
035 Gargazon,2,,11,11,22
035 Gargazon,3,,11,5,16
035 Gargazon,4,,12,9,21
035 Gargazon,5,,7,10,17
035 Gargazon,6,,7,7,14
035 Gargazon,7,,7,11,18
035 Gargazon,8,,8,11,19
035 Gargazon,9,,13,8,21
035 Gargazon,10,,8,6,14
035 Gargazon,11,,10,13,23
035 Gargazon,12,,9,6,15
035 Gargazon,13,,7,6,13
035 Gargazon,14,,5,11,16
035 Gargazon,15,,6,12,18
035 Gargazon,16,,4,8,12
035 Gargazon,17,,11,5,16
035 Gargazon,18,,14,7,21
035 Gargazon,19,,13,10,23
035 Gargazon,20,,4,13,17
035 Gargazon,21,,9,8,17
035 Gargazon,22,,10,3,13
035 Gargazon,23,,3,6,9
035 Gargazon,24,,8,7,15
035 Gargazon,25,,13,11,24
035 Gargazon,26,,18,10,28
035 Gargazon,27,,7,9,16
035 Gargazon,28,,11,4,15
035 Gargazon,29,,9,7,16
035 Gargazon,30,,8,11,19
035 Gargazon,31,,7,10,17
035 Gargazon,32,,16,8,24
035 Gargazon,33,,9,11,20
035 Gargazon,34,,8,13,21
035 Gargazon,35,,10,6,16
035 Gargazon,36,,13,11,24
035 Gargazon,37,,11,11,22
035 Gargazon,38,,6,6,12
035 Gargazon,39,,7,21,28
035 Gargazon,40,,10,11,21
035 Gargazon,41,,4,13,17
035 Gargazon,42,,9,9,18
035 Gargazon,43,,11,13,24
035 Gargazon,44,,12,7,19
035 Gargazon,45,,16,22,38
035 Gargazon,46,,16,15,31
035 Gargazon,47,,16,13,29
035 Gargazon,48,,23,14,37
035 Gargazon,49,,18,21,39
035 Gargazon,50,,12,14,26
035 Gargazon,51,,13,16,29
035 Gargazon,52,,14,10,24
035 Gargazon,53,,18,17,35
035 Gargazon,54,,17,20,37
035 Gargazon,55,,17,14,31
035 Gargazon,56,,9,13,22
035 Gargazon,57,,11,13,24
035 Gargazon,58,,17,15,32
035 Gargazon,59,,6,12,18
035 Gargazon,60,,14,13,27
035 Gargazon,61,,12,7,19
035 Gargazon,62,,10,6,16
035 Gargazon,63,,9,11,20
035 Gargazon,64,,18,10,28
035 Gargazon,65,,4,8,12
035 Gargazon,66,,9,8,17
035 Gargazon,67,,8,7,15
035 Gargazon,68,,5,8,13
035 Gargazon,69,,7,8,15
035 Gargazon,70,,5,7,12
035 Gargazon,71,,11,14,25
035 Gargazon,72,,10,4,14
035 Gargazon,73,,1,3,4
035 Gargazon,74,,5,10,15
035 Gargazon,75,,3,8,11
035 Gargazon,76,,10,9,19
035 Gargazon,77,,4,16,20
035 Gargazon,78,,7,5,12
035 Gargazon,79,,8,7,15
035 Gargazon,80,,5,11,16
035 Gargazon,81,,3,2,5
035 Gargazon,82,,10,2,12
035 Gargazon,83,,5,6,11
035 Gargazon,84,,1,7,8
035 Gargazon,85,,3,2,5
035 Gargazon,86,,2,5,7
035 Gargazon,87,,2,3,5
035 Gargazon,88,,-,3,3
035 Gargazon,90,,1,2,3
035 Gargazon,91,,2,-,2
035 Gargazon,92,,1,1,2
035 Gargazon,93,,-,1,1
035 Gargazon,94,,2,1,3
035 Gargazon,95,,-,1,1
035 Gargazon,96,,-,1,1
036 Glurns,0,,3,5,8
036 Glurns,1,,2,7,9
036 Glurns,2,,8,2,10
036 Glurns,3,,3,-,3
036 Glurns,4,,7,5,12
036 Glurns,5,,6,3,9
036 Glurns,6,,3,5,8
036 Glurns,7,,5,4,9
036 Glurns,8,,2,5,7
036 Glurns,9,,9,2,11
036 Glurns,10,,5,2,7
036 Glurns,11,,5,8,13
036 Glurns,12,,6,6,12
036 Glurns,13,,3,6,9
036 Glurns,14,,6,6,12
036 Glurns,15,,3,4,7
036 Glurns,16,,5,-,5
036 Glurns,17,,5,3,8
036 Glurns,18,,3,2,5
036 Glurns,19,,12,3,15
036 Glurns,20,,4,7,11
036 Glurns,21,,7,5,12
036 Glurns,22,,6,4,10
036 Glurns,23,,4,3,7
036 Glurns,24,,7,6,13
036 Glurns,25,,4,6,10
036 Glurns,26,,7,3,10
036 Glurns,27,,7,2,9
036 Glurns,28,,4,3,7
036 Glurns,29,,3,6,9
036 Glurns,30,,4,5,9
036 Glurns,31,,4,6,10
036 Glurns,32,,4,3,7
036 Glurns,33,,7,6,13
036 Glurns,34,,9,6,15
036 Glurns,35,,6,7,13
036 Glurns,36,,8,5,13
036 Glurns,37,,11,2,13
036 Glurns,38,,4,8,12
036 Glurns,39,,8,5,13
036 Glurns,40,,3,1,4
036 Glurns,41,,12,3,15
036 Glurns,42,,5,7,12
036 Glurns,43,,8,11,19
036 Glurns,44,,3,2,5
036 Glurns,45,,5,8,13
036 Glurns,46,,5,6,11
036 Glurns,47,,4,2,6
036 Glurns,48,,2,7,9
036 Glurns,49,,7,3,10
036 Glurns,50,,4,9,13
036 Glurns,51,,7,7,14
036 Glurns,52,,1,7,8
036 Glurns,53,,10,5,15
036 Glurns,54,,5,8,13
036 Glurns,55,,6,5,11
036 Glurns,56,,7,6,13
036 Glurns,57,,5,9,14
036 Glurns,58,,12,6,18
036 Glurns,59,,4,9,13
036 Glurns,60,,6,12,18
036 Glurns,61,,5,6,11
036 Glurns,62,,8,8,16
036 Glurns,63,,10,3,13
036 Glurns,64,,8,9,17
036 Glurns,65,,4,8,12
036 Glurns,66,,8,9,17
036 Glurns,67,,7,4,11
036 Glurns,68,,5,2,7
036 Glurns,69,,8,5,13
036 Glurns,70,,10,7,17
036 Glurns,71,,8,2,10
036 Glurns,72,,6,1,7
036 Glurns,73,,5,4,9
036 Glurns,74,,1,4,5
036 Glurns,75,,3,6,9
036 Glurns,76,,3,2,5
036 Glurns,77,,5,1,6
036 Glurns,78,,2,3,5
036 Glurns,79,,4,4,8
036 Glurns,80,,4,4,8
036 Glurns,81,,-,2,2
036 Glurns,82,,2,4,6
036 Glurns,83,,1,4,5
036 Glurns,84,,-,1,1
036 Glurns,85,,4,2,6
036 Glurns,86,,2,-,2
036 Glurns,87,,-,2,2
036 Glurns,88,,1,4,5
036 Glurns,89,,-,1,1
036 Glurns,90,,-,1,1
036 Glurns,92,,-,1,1
036 Glurns,93,,-,1,1
037 Latsch,0,,29,23,52
037 Latsch,1,,24,36,60
037 Latsch,2,,34,23,57
037 Latsch,3,,32,26,58
037 Latsch,4,,33,31,64
037 Latsch,5,,28,29,57
037 Latsch,6,,23,19,42
037 Latsch,7,,26,19,45
037 Latsch,8,,20,30,50
037 Latsch,9,,23,24,47
037 Latsch,10,,29,29,58
037 Latsch,11,,23,23,46
037 Latsch,12,,24,30,54
037 Latsch,13,,30,27,57
037 Latsch,14,,23,25,48
037 Latsch,15,,26,25,51
037 Latsch,16,,33,20,53
037 Latsch,17,,34,29,63
037 Latsch,18,,34,17,51
037 Latsch,19,,27,21,48
037 Latsch,20,,36,39,75
037 Latsch,21,,40,37,77
037 Latsch,22,,45,33,78
037 Latsch,23,,39,27,66
037 Latsch,24,,31,32,63
037 Latsch,25,,32,43,75
037 Latsch,26,,32,43,75
037 Latsch,27,,31,42,73
037 Latsch,28,,37,26,63
037 Latsch,29,,39,33,72
037 Latsch,30,,29,24,53
037 Latsch,31,,36,33,69
037 Latsch,32,,36,38,74
037 Latsch,33,,46,31,77
037 Latsch,34,,23,27,50
037 Latsch,35,,34,46,80
037 Latsch,36,,26,41,67
037 Latsch,37,,37,32,69
037 Latsch,38,,38,28,66
037 Latsch,39,,36,28,64
037 Latsch,40,,36,29,65
037 Latsch,41,,29,22,51
037 Latsch,42,,33,36,69
037 Latsch,43,,31,27,58
037 Latsch,44,,33,35,68
037 Latsch,45,,37,42,79
037 Latsch,46,,45,40,85
037 Latsch,47,,36,38,74
037 Latsch,48,,43,39,82
037 Latsch,49,,44,54,98
037 Latsch,50,,55,49,104
037 Latsch,51,,30,49,79
037 Latsch,52,,49,45,94
037 Latsch,53,,54,45,99
037 Latsch,54,,49,48,97
037 Latsch,55,,43,46,89
037 Latsch,56,,43,42,85
037 Latsch,57,,37,48,85
037 Latsch,58,,42,44,86
037 Latsch,59,,38,30,68
037 Latsch,60,,29,37,66
037 Latsch,61,,26,31,57
037 Latsch,62,,36,28,64
037 Latsch,63,,23,16,39
037 Latsch,64,,22,22,44
037 Latsch,65,,36,21,57
037 Latsch,66,,20,28,48
037 Latsch,67,,34,15,49
037 Latsch,68,,15,19,34
037 Latsch,69,,15,21,36
037 Latsch,70,,18,16,34
037 Latsch,71,,17,17,34
037 Latsch,72,,14,21,35
037 Latsch,73,,17,12,29
037 Latsch,74,,19,23,42
037 Latsch,75,,22,24,46
037 Latsch,76,,12,22,34
037 Latsch,77,,17,20,37
037 Latsch,78,,13,16,29
037 Latsch,79,,9,23,32
037 Latsch,80,,8,23,31
037 Latsch,81,,11,12,23
037 Latsch,82,,19,12,31
037 Latsch,83,,12,19,31
037 Latsch,84,,12,17,29
037 Latsch,85,,14,14,28
037 Latsch,86,,8,17,25
037 Latsch,87,,9,10,19
037 Latsch,88,,9,10,19
037 Latsch,89,,12,11,23
037 Latsch,90,,4,9,13
037 Latsch,91,,4,6,10
037 Latsch,92,,2,7,9
037 Latsch,93,,1,4,5
037 Latsch,94,,1,1,2
037 Latsch,95,,1,2,3
037 Latsch,96,,-,2,2
037 Latsch,97,,1,1,2
037 Latsch,108,,-,1,1
038 Algund,0,,27,24,51
038 Algund,1,,26,30,56
038 Algund,2,,18,38,56
038 Algund,3,,24,30,54
038 Algund,4,,32,28,60
038 Algund,5,,23,31,54
038 Algund,6,,22,19,41
038 Algund,7,,28,20,48
038 Algund,8,,18,36,54
038 Algund,9,,20,21,41
038 Algund,10,,23,19,42
038 Algund,11,,31,22,53
038 Algund,12,,22,28,50
038 Algund,13,,26,26,52
038 Algund,14,,31,27,58
038 Algund,15,,23,25,48
038 Algund,16,,35,26,61
038 Algund,17,,23,30,53
038 Algund,18,,45,27,72
038 Algund,19,,25,24,49
038 Algund,20,,30,24,54
038 Algund,21,,21,23,44
038 Algund,22,,35,28,63
038 Algund,23,,33,20,53
038 Algund,24,,29,20,49
038 Algund,25,,29,27,56
038 Algund,26,,31,28,59
038 Algund,27,,30,22,52
038 Algund,28,,22,29,51
038 Algund,29,,20,33,53
038 Algund,30,,32,25,57
038 Algund,31,,29,30,59
038 Algund,32,,30,25,55
038 Algund,33,,24,38,62
038 Algund,34,,22,32,54
038 Algund,35,,26,24,50
038 Algund,36,,35,34,69
038 Algund,37,,35,36,71
038 Algund,38,,28,36,64
038 Algund,39,,33,33,66
038 Algund,40,,40,41,81
038 Algund,41,,33,34,67
038 Algund,42,,34,42,76
038 Algund,43,,33,36,69
038 Algund,44,,31,40,71
038 Algund,45,,46,42,88
038 Algund,46,,38,43,81
038 Algund,47,,46,40,86
038 Algund,48,,45,54,99
038 Algund,49,,49,34,83
038 Algund,50,,38,47,85
038 Algund,51,,40,44,84
038 Algund,52,,42,52,94
038 Algund,53,,49,26,75
038 Algund,54,,42,40,82
038 Algund,55,,35,45,80
038 Algund,56,,28,49,77
038 Algund,57,,37,40,77
038 Algund,58,,38,38,76
038 Algund,59,,42,30,72
038 Algund,60,,24,34,58
038 Algund,61,,36,30,66
038 Algund,62,,22,28,50
038 Algund,63,,35,28,63
038 Algund,64,,20,29,49
038 Algund,65,,24,28,52
038 Algund,66,,26,28,54
038 Algund,67,,21,25,46
038 Algund,68,,19,27,46
038 Algund,69,,24,22,46
038 Algund,70,,16,18,34
038 Algund,71,,29,29,58
038 Algund,72,,24,23,47
038 Algund,73,,21,27,48
038 Algund,74,,21,18,39
038 Algund,75,,15,31,46
038 Algund,76,,14,18,32
038 Algund,77,,14,20,34
038 Algund,78,,17,25,42
038 Algund,79,,18,18,36
038 Algund,80,,16,14,30
038 Algund,81,,10,25,35
038 Algund,82,,8,18,26
038 Algund,83,,19,23,42
038 Algund,84,,13,16,29
038 Algund,85,,8,17,25
038 Algund,86,,7,16,23
038 Algund,87,,6,17,23
038 Algund,88,,5,12,17
038 Algund,89,,4,11,15
038 Algund,90,,5,8,13
038 Algund,91,,4,4,8
038 Algund,92,,2,10,12
038 Algund,93,,-,2,2
038 Algund,94,,-,1,1
038 Algund,95,,-,3,3
038 Algund,96,,-,1,1
038 Algund,97,,3,-,3
038 Algund,98,,-,2,2
039 Lajen,0,,15,11,26
039 Lajen,1,,15,17,32
039 Lajen,2,,12,13,25
039 Lajen,3,,12,22,34
039 Lajen,4,,22,19,41
039 Lajen,5,,15,14,29
039 Lajen,6,,17,13,30
039 Lajen,7,,14,21,35
039 Lajen,8,,20,6,26
039 Lajen,9,,16,16,32
039 Lajen,10,,18,23,41
039 Lajen,11,,11,19,30
039 Lajen,12,,20,15,35
039 Lajen,13,,17,24,41
039 Lajen,14,,21,22,43
039 Lajen,15,,20,9,29
039 Lajen,16,,20,19,39
039 Lajen,17,,27,14,41
039 Lajen,18,,17,15,32
039 Lajen,19,,18,19,37
039 Lajen,20,,15,23,38
039 Lajen,21,,16,11,27
039 Lajen,22,,11,12,23
039 Lajen,23,,14,12,26
039 Lajen,24,,10,14,24
039 Lajen,25,,14,11,25
039 Lajen,26,,22,19,41
039 Lajen,27,,11,12,23
039 Lajen,28,,16,10,26
039 Lajen,29,,12,15,27
039 Lajen,30,,16,9,25
039 Lajen,31,,16,18,34
039 Lajen,32,,17,13,30
039 Lajen,33,,15,13,28
039 Lajen,34,,8,25,33
039 Lajen,35,,13,18,31
039 Lajen,36,,12,20,32
039 Lajen,37,,17,14,31
039 Lajen,38,,23,20,43
039 Lajen,39,,22,23,45
039 Lajen,40,,20,14,34
039 Lajen,41,,25,18,43
039 Lajen,42,,20,25,45
039 Lajen,43,,28,17,45
039 Lajen,44,,24,20,44
039 Lajen,45,,20,26,46
039 Lajen,46,,20,24,44
039 Lajen,47,,18,30,48
039 Lajen,48,,32,23,55
039 Lajen,49,,24,24,48
039 Lajen,50,,20,24,44
039 Lajen,51,,23,16,39
039 Lajen,52,,29,22,51
039 Lajen,53,,21,21,42
039 Lajen,54,,18,13,31
039 Lajen,55,,30,19,49
039 Lajen,56,,9,19,28
039 Lajen,57,,15,10,25
039 Lajen,58,,16,25,41
039 Lajen,59,,22,13,35
039 Lajen,60,,11,10,21
039 Lajen,61,,12,13,25
039 Lajen,62,,12,13,25
039 Lajen,63,,8,15,23
039 Lajen,64,,10,6,16
039 Lajen,65,,8,11,19
039 Lajen,66,,8,13,21
039 Lajen,67,,9,11,20
039 Lajen,68,,4,14,18
039 Lajen,69,,7,15,22
039 Lajen,70,,15,7,22
039 Lajen,71,,13,13,26
039 Lajen,72,,9,11,20
039 Lajen,73,,14,9,23
039 Lajen,74,,10,12,22
039 Lajen,75,,12,12,24
039 Lajen,76,,14,14,28
039 Lajen,77,,14,8,22
039 Lajen,78,,8,8,16
039 Lajen,79,,6,14,20
039 Lajen,80,,7,10,17
039 Lajen,81,,3,7,10
039 Lajen,82,,3,5,8
039 Lajen,83,,3,5,8
039 Lajen,84,,5,9,14
039 Lajen,85,,4,3,7
039 Lajen,86,,-,3,3
039 Lajen,87,,6,4,10
039 Lajen,88,,-,6,6
039 Lajen,89,,3,3,6
039 Lajen,90,,4,7,11
039 Lajen,91,,1,3,4
039 Lajen,92,,1,1,2
039 Lajen,93,,-,3,3
039 Lajen,94,,-,1,1
039 Lajen,95,,2,2,4
039 Lajen,96,,-,2,2
040 Leifers,0,,97,81,178
040 Leifers,1,,86,86,172
040 Leifers,2,,104,75,179
040 Leifers,3,,77,87,164
040 Leifers,4,,91,82,173
040 Leifers,5,,114,99,213
040 Leifers,6,,114,87,201
040 Leifers,7,,99,105,204
040 Leifers,8,,94,79,173
040 Leifers,9,,97,105,202
040 Leifers,10,,94,85,179
040 Leifers,11,,95,83,178
040 Leifers,12,,98,68,166
040 Leifers,13,,85,77,162
040 Leifers,14,,99,89,188
040 Leifers,15,,92,94,186
040 Leifers,16,,98,81,179
040 Leifers,17,,94,91,185
040 Leifers,18,,92,92,184
040 Leifers,19,,89,115,204
040 Leifers,20,,108,79,187
040 Leifers,21,,115,99,214
040 Leifers,22,,103,91,194
040 Leifers,23,,115,107,222
040 Leifers,24,,95,79,174
040 Leifers,25,,110,103,213
040 Leifers,26,,107,102,209
040 Leifers,27,,108,108,216
040 Leifers,28,,106,118,224
040 Leifers,29,,112,108,220
040 Leifers,30,,110,92,202
040 Leifers,31,,123,101,224
040 Leifers,32,,105,93,198
040 Leifers,33,,120,95,215
040 Leifers,34,,134,113,247
040 Leifers,35,,114,103,217
040 Leifers,36,,105,108,213
040 Leifers,37,,109,109,218
040 Leifers,38,,108,120,228
040 Leifers,39,,113,97,210
040 Leifers,40,,105,134,239
040 Leifers,41,,126,127,253
040 Leifers,42,,143,141,284
040 Leifers,43,,153,161,314
040 Leifers,44,,157,152,309
040 Leifers,45,,156,148,304
040 Leifers,46,,134,142,276
040 Leifers,47,,165,145,310
040 Leifers,48,,168,135,303
040 Leifers,49,,147,168,315
040 Leifers,50,,144,129,273
040 Leifers,51,,143,144,287
040 Leifers,52,,150,131,281
040 Leifers,53,,158,164,322
040 Leifers,54,,142,136,278
040 Leifers,55,,138,127,265
040 Leifers,56,,137,141,278
040 Leifers,57,,131,124,255
040 Leifers,58,,111,111,222
040 Leifers,59,,96,112,208
040 Leifers,60,,101,117,218
040 Leifers,61,,140,126,266
040 Leifers,62,,103,124,227
040 Leifers,63,,81,103,184
040 Leifers,64,,95,115,210
040 Leifers,65,,106,96,202
040 Leifers,66,,89,86,175
040 Leifers,67,,87,91,178
040 Leifers,68,,79,93,172
040 Leifers,69,,99,105,204
040 Leifers,70,,83,95,178
040 Leifers,71,,99,143,242
040 Leifers,72,,69,78,147
040 Leifers,73,,81,91,172
040 Leifers,74,,77,87,164
040 Leifers,75,,72,88,160
040 Leifers,76,,74,76,150
040 Leifers,77,,82,76,158
040 Leifers,78,,68,83,151
040 Leifers,79,,60,63,123
040 Leifers,80,,42,61,103
040 Leifers,81,,29,57,86
040 Leifers,82,,36,56,92
040 Leifers,83,,42,52,94
040 Leifers,84,,29,45,74
040 Leifers,85,,37,53,90
040 Leifers,86,,24,42,66
040 Leifers,87,,20,38,58
040 Leifers,88,,21,31,52
040 Leifers,89,,13,19,32
040 Leifers,90,,9,26,35
040 Leifers,91,,3,20,23
040 Leifers,92,,6,16,22
040 Leifers,93,,3,19,22
040 Leifers,94,,3,14,17
040 Leifers,95,,3,11,14
040 Leifers,96,,3,5,8
040 Leifers,97,,-,1,1
040 Leifers,98,,-,1,1
040 Leifers,99,,-,1,1
040 Leifers,100,,-,1,1
040 Leifers,101,,-,1,1
040 Leifers,102,,-,1,1
041 Lana,0,,60,68,128
041 Lana,1,,71,75,146
041 Lana,2,,84,71,155
041 Lana,3,,64,74,138
041 Lana,4,,61,80,141
041 Lana,5,,69,63,132
041 Lana,6,,70,67,137
041 Lana,7,,64,65,129
041 Lana,8,,66,48,114
041 Lana,9,,66,64,130
041 Lana,10,,72,58,130
041 Lana,11,,72,62,134
041 Lana,12,,70,67,137
041 Lana,13,,74,53,127
041 Lana,14,,62,65,127
041 Lana,15,,59,55,114
041 Lana,16,,73,56,129
041 Lana,17,,74,68,142
041 Lana,18,,73,66,139
041 Lana,19,,65,67,132
041 Lana,20,,63,69,132
041 Lana,21,,82,83,165
041 Lana,22,,75,70,145
041 Lana,23,,75,80,155
041 Lana,24,,68,66,134
041 Lana,25,,74,62,136
041 Lana,26,,70,78,148
041 Lana,27,,65,87,152
041 Lana,28,,56,94,150
041 Lana,29,,83,75,158
041 Lana,30,,84,73,157
041 Lana,31,,79,69,148
041 Lana,32,,62,80,142
041 Lana,33,,79,81,160
041 Lana,34,,93,84,177
041 Lana,35,,88,94,182
041 Lana,36,,59,92,151
041 Lana,37,,79,72,151
041 Lana,38,,78,101,179
041 Lana,39,,94,87,181
041 Lana,40,,74,72,146
041 Lana,41,,89,95,184
041 Lana,42,,81,96,177
041 Lana,43,,95,93,188
041 Lana,44,,82,91,173
041 Lana,45,,111,92,203
041 Lana,46,,96,111,207
041 Lana,47,,100,104,204
041 Lana,48,,130,87,217
041 Lana,49,,87,104,191
041 Lana,50,,91,95,186
041 Lana,51,,100,107,207
041 Lana,52,,99,93,192
041 Lana,53,,105,115,220
041 Lana,54,,108,81,189
041 Lana,55,,90,81,171
041 Lana,56,,91,94,185
041 Lana,57,,76,82,158
041 Lana,58,,84,84,168
041 Lana,59,,73,91,164
041 Lana,60,,73,81,154
041 Lana,61,,58,63,121
041 Lana,62,,58,72,130
041 Lana,63,,53,62,115
041 Lana,64,,55,60,115
041 Lana,65,,47,58,105
041 Lana,66,,48,67,115
041 Lana,67,,50,58,108
041 Lana,68,,50,57,107
041 Lana,69,,49,64,113
041 Lana,70,,53,48,101
041 Lana,71,,57,64,121
041 Lana,72,,40,53,93
041 Lana,73,,43,63,106
041 Lana,74,,50,56,106
041 Lana,75,,47,64,111
041 Lana,76,,48,46,94
041 Lana,77,,39,48,87
041 Lana,78,,45,50,95
041 Lana,79,,34,50,84
041 Lana,80,,31,31,62
041 Lana,81,,32,41,73
041 Lana,82,,22,30,52
041 Lana,83,,28,40,68
041 Lana,84,,14,39,53
041 Lana,85,,17,28,45
041 Lana,86,,13,26,39
041 Lana,87,,14,25,39
041 Lana,88,,10,23,33
041 Lana,89,,13,18,31
041 Lana,90,,11,17,28
041 Lana,91,,7,14,21
041 Lana,92,,10,22,32
041 Lana,93,,3,8,11
041 Lana,94,,4,11,15
041 Lana,95,,3,9,12
041 Lana,96,,4,5,9
041 Lana,97,,-,3,3
041 Lana,98,,-,1,1
041 Lana,99,,-,1,1
041 Lana,100,,-,1,1
041 Lana,102,,-,1,1
042 Laas,0,,21,29,50
042 Laas,1,,26,15,41
042 Laas,2,,18,17,35
042 Laas,3,,25,22,47
042 Laas,4,,26,30,56
042 Laas,5,,21,24,45
042 Laas,6,,22,27,49
042 Laas,7,,35,26,61
042 Laas,8,,23,28,51
042 Laas,9,,24,27,51
042 Laas,10,,29,18,47
042 Laas,11,,18,30,48
042 Laas,12,,35,15,50
042 Laas,13,,25,19,44
042 Laas,14,,23,21,44
042 Laas,15,,30,16,46
042 Laas,16,,19,21,40
042 Laas,17,,26,24,50
042 Laas,18,,18,15,33
042 Laas,19,,31,34,65
042 Laas,20,,28,23,51
042 Laas,21,,31,30,61
042 Laas,22,,33,28,61
042 Laas,23,,27,26,53
042 Laas,24,,25,20,45
042 Laas,25,,17,20,37
042 Laas,26,,21,18,39
042 Laas,27,,17,20,37
042 Laas,28,,22,17,39
042 Laas,29,,19,20,39
042 Laas,30,,25,18,43
042 Laas,31,,29,21,50
042 Laas,32,,23,23,46
042 Laas,33,,22,33,55
042 Laas,34,,16,41,57
042 Laas,35,,28,30,58
042 Laas,36,,26,33,59
042 Laas,37,,22,24,46
042 Laas,38,,33,26,59
042 Laas,39,,24,35,59
042 Laas,40,,24,21,45
042 Laas,41,,27,28,55
042 Laas,42,,32,19,51
042 Laas,43,,42,30,72
042 Laas,44,,37,29,66
042 Laas,45,,29,24,53
042 Laas,46,,25,26,51
042 Laas,47,,38,28,66
042 Laas,48,,29,37,66
042 Laas,49,,37,32,69
042 Laas,50,,29,28,57
042 Laas,51,,31,27,58
042 Laas,52,,35,33,68
042 Laas,53,,28,28,56
042 Laas,54,,26,27,53
042 Laas,55,,35,28,63
042 Laas,56,,25,29,54
042 Laas,57,,38,26,64
042 Laas,58,,30,28,58
042 Laas,59,,24,23,47
042 Laas,60,,16,25,41
042 Laas,61,,21,15,36
042 Laas,62,,16,15,31
042 Laas,63,,16,23,39
042 Laas,64,,18,12,30
042 Laas,65,,29,25,54
042 Laas,66,,11,15,26
042 Laas,67,,18,23,41
042 Laas,68,,19,18,37
042 Laas,69,,16,20,36
042 Laas,70,,22,11,33
042 Laas,71,,13,14,27
042 Laas,72,,13,12,25
042 Laas,73,,10,14,24
042 Laas,74,,10,15,25
042 Laas,75,,15,17,32
042 Laas,76,,12,21,33
042 Laas,77,,17,21,38
042 Laas,78,,12,23,35
042 Laas,79,,15,10,25
042 Laas,80,,8,14,22
042 Laas,81,,16,11,27
042 Laas,82,,16,16,32
042 Laas,83,,6,13,19
042 Laas,84,,10,12,22
042 Laas,85,,8,10,18
042 Laas,86,,8,18,26
042 Laas,87,,6,8,14
042 Laas,88,,6,6,12
042 Laas,89,,4,6,10
042 Laas,90,,2,5,7
042 Laas,91,,7,4,11
042 Laas,92,,-,2,2
042 Laas,93,,-,6,6
042 Laas,94,,2,3,5
042 Laas,95,,1,4,5
042 Laas,96,,-,1,1
042 Laas,97,,1,1,2
043 Laurein,0,,1,-,1
043 Laurein,1,,1,-,1
043 Laurein,2,,2,1,3
043 Laurein,3,,2,1,3
043 Laurein,4,,2,1,3
043 Laurein,5,,-,1,1
043 Laurein,6,,3,-,3
043 Laurein,7,,2,1,3
043 Laurein,8,,2,3,5
043 Laurein,9,,2,1,3
043 Laurein,10,,1,-,1
043 Laurein,11,,8,-,8
043 Laurein,12,,3,4,7
043 Laurein,13,,3,1,4
043 Laurein,14,,3,3,6
043 Laurein,15,,2,3,5
043 Laurein,16,,7,1,8
043 Laurein,17,,3,7,10
043 Laurein,18,,2,2,4
043 Laurein,19,,4,3,7
043 Laurein,20,,3,6,9
043 Laurein,21,,1,2,3
043 Laurein,22,,2,2,4
043 Laurein,23,,2,3,5
043 Laurein,24,,2,5,7
043 Laurein,25,,1,1,2
043 Laurein,26,,1,1,2
043 Laurein,27,,4,-,4
043 Laurein,28,,3,3,6
043 Laurein,29,,1,1,2
043 Laurein,30,,1,1,2
043 Laurein,31,,3,1,4
043 Laurein,32,,-,2,2
043 Laurein,33,,1,2,3
043 Laurein,34,,-,1,1
043 Laurein,35,,1,1,2
043 Laurein,36,,3,-,3
043 Laurein,37,,2,-,2
043 Laurein,38,,2,-,2
043 Laurein,39,,3,3,6
043 Laurein,40,,-,3,3
043 Laurein,41,,5,1,6
043 Laurein,42,,-,4,4
043 Laurein,43,,-,1,1
043 Laurein,44,,5,3,8
043 Laurein,45,,1,2,3
043 Laurein,46,,4,5,9
043 Laurein,47,,4,3,7
043 Laurein,48,,5,4,9
043 Laurein,49,,-,2,2
043 Laurein,50,,4,6,10
043 Laurein,51,,6,3,9
043 Laurein,52,,4,1,5
043 Laurein,53,,4,3,7
043 Laurein,54,,-,2,2
043 Laurein,55,,2,2,4
043 Laurein,56,,5,4,9
043 Laurein,57,,1,-,1
043 Laurein,58,,4,4,8
043 Laurein,59,,2,2,4
043 Laurein,60,,6,-,6
043 Laurein,62,,2,-,2
043 Laurein,63,,3,1,4
043 Laurein,64,,2,1,3
043 Laurein,65,,2,-,2
043 Laurein,67,,1,1,2
043 Laurein,68,,2,2,4
043 Laurein,69,,2,-,2
043 Laurein,70,,2,2,4
043 Laurein,71,,-,1,1
043 Laurein,72,,-,1,1
043 Laurein,73,,-,1,1
043 Laurein,74,,1,-,1
043 Laurein,75,,1,-,1
043 Laurein,77,,2,2,4
043 Laurein,78,,1,1,2
043 Laurein,79,,1,1,2
043 Laurein,80,,2,1,3
043 Laurein,81,,1,2,3
043 Laurein,82,,-,3,3
043 Laurein,83,,1,4,5
043 Laurein,85,,-,2,2
043 Laurein,86,,-,1,1
043 Laurein,87,,-,4,4
043 Laurein,88,,1,-,1
043 Laurein,89,,2,-,2
043 Laurein,90,,2,-,2
043 Laurein,92,,-,1,1
043 Laurein,93,,-,1,1
044 Lüsen,0,,11,9,20
044 Lüsen,1,,11,7,18
044 Lüsen,2,,6,6,12
044 Lüsen,3,,11,13,24
044 Lüsen,4,,1,10,11
044 Lüsen,5,,9,7,16
044 Lüsen,6,,11,6,17
044 Lüsen,7,,13,10,23
044 Lüsen,8,,12,8,20
044 Lüsen,9,,8,9,17
044 Lüsen,10,,12,10,22
044 Lüsen,11,,10,15,25
044 Lüsen,12,,9,9,18
044 Lüsen,13,,11,10,21
044 Lüsen,14,,14,10,24
044 Lüsen,15,,9,8,17
044 Lüsen,16,,10,10,20
044 Lüsen,17,,12,10,22
044 Lüsen,18,,5,9,14
044 Lüsen,19,,12,12,24
044 Lüsen,20,,16,6,22
044 Lüsen,21,,6,11,17
044 Lüsen,22,,10,13,23
044 Lüsen,23,,12,14,26
044 Lüsen,24,,8,9,17
044 Lüsen,25,,10,8,18
044 Lüsen,26,,7,8,15
044 Lüsen,27,,7,9,16
044 Lüsen,28,,14,11,25
044 Lüsen,29,,9,9,18
044 Lüsen,30,,8,6,14
044 Lüsen,31,,10,7,17
044 Lüsen,32,,7,4,11
044 Lüsen,33,,8,16,24
044 Lüsen,34,,6,9,15
044 Lüsen,35,,8,8,16
044 Lüsen,36,,11,11,22
044 Lüsen,37,,12,9,21
044 Lüsen,38,,9,7,16
044 Lüsen,39,,15,14,29
044 Lüsen,40,,7,13,20
044 Lüsen,41,,14,10,24
044 Lüsen,42,,11,12,23
044 Lüsen,43,,13,14,27
044 Lüsen,44,,8,7,15
044 Lüsen,45,,9,9,18
044 Lüsen,46,,13,9,22
044 Lüsen,47,,18,14,32
044 Lüsen,48,,10,11,21
044 Lüsen,49,,13,17,30
044 Lüsen,50,,11,19,30
044 Lüsen,51,,16,11,27
044 Lüsen,52,,13,10,23
044 Lüsen,53,,12,8,20
044 Lüsen,54,,13,11,24
044 Lüsen,55,,7,11,18
044 Lüsen,56,,11,10,21
044 Lüsen,57,,8,13,21
044 Lüsen,58,,11,6,17
044 Lüsen,59,,11,13,24
044 Lüsen,60,,10,9,19
044 Lüsen,61,,7,8,15
044 Lüsen,62,,6,6,12
044 Lüsen,63,,10,7,17
044 Lüsen,64,,7,10,17
044 Lüsen,65,,8,4,12
044 Lüsen,66,,5,5,10
044 Lüsen,67,,5,8,13
044 Lüsen,68,,7,10,17
044 Lüsen,69,,6,1,7
044 Lüsen,70,,4,5,9
044 Lüsen,71,,9,6,15
044 Lüsen,72,,3,7,10
044 Lüsen,73,,4,2,6
044 Lüsen,74,,7,7,14
044 Lüsen,75,,3,6,9
044 Lüsen,76,,5,2,7
044 Lüsen,77,,3,9,12
044 Lüsen,78,,8,6,14
044 Lüsen,79,,6,4,10
044 Lüsen,80,,5,4,9
044 Lüsen,81,,3,8,11
044 Lüsen,82,,2,4,6
044 Lüsen,83,,2,4,6
044 Lüsen,84,,6,1,7
044 Lüsen,85,,1,7,8
044 Lüsen,86,,3,2,5
044 Lüsen,87,,-,4,4
044 Lüsen,88,,1,3,4
044 Lüsen,89,,1,3,4
044 Lüsen,90,,1,2,3
044 Lüsen,91,,2,1,3
044 Lüsen,93,,1,-,1
044 Lüsen,94,,1,2,3
044 Lüsen,96,,-,1,1
045 Margreid a.d. Weinstr.,0,,11,10,21
045 Margreid a.d. Weinstr.,1,,7,4,11
045 Margreid a.d. Weinstr.,2,,7,5,12
045 Margreid a.d. Weinstr.,3,,7,13,20
045 Margreid a.d. Weinstr.,4,,7,7,14
045 Margreid a.d. Weinstr.,5,,5,8,13
045 Margreid a.d. Weinstr.,6,,3,8,11
045 Margreid a.d. Weinstr.,7,,5,8,13
045 Margreid a.d. Weinstr.,8,,5,7,12
045 Margreid a.d. Weinstr.,9,,8,9,17
045 Margreid a.d. Weinstr.,10,,7,6,13
045 Margreid a.d. Weinstr.,11,,10,4,14
045 Margreid a.d. Weinstr.,12,,8,10,18
045 Margreid a.d. Weinstr.,13,,8,10,18
045 Margreid a.d. Weinstr.,14,,8,3,11
045 Margreid a.d. Weinstr.,15,,10,9,19
045 Margreid a.d. Weinstr.,16,,10,10,20
045 Margreid a.d. Weinstr.,17,,8,7,15
045 Margreid a.d. Weinstr.,18,,6,11,17
045 Margreid a.d. Weinstr.,19,,2,12,14
045 Margreid a.d. Weinstr.,20,,11,13,24
045 Margreid a.d. Weinstr.,21,,4,2,6
045 Margreid a.d. Weinstr.,22,,1,5,6
045 Margreid a.d. Weinstr.,23,,7,6,13
045 Margreid a.d. Weinstr.,24,,3,13,16
045 Margreid a.d. Weinstr.,25,,3,3,6
045 Margreid a.d. Weinstr.,26,,6,6,12
045 Margreid a.d. Weinstr.,27,,5,7,12
045 Margreid a.d. Weinstr.,28,,5,6,11
045 Margreid a.d. Weinstr.,29,,8,8,16
045 Margreid a.d. Weinstr.,30,,9,10,19
045 Margreid a.d. Weinstr.,31,,6,8,14
045 Margreid a.d. Weinstr.,32,,15,1,16
045 Margreid a.d. Weinstr.,33,,7,12,19
045 Margreid a.d. Weinstr.,34,,7,9,16
045 Margreid a.d. Weinstr.,35,,12,9,21
045 Margreid a.d. Weinstr.,36,,10,8,18
045 Margreid a.d. Weinstr.,37,,6,9,15
045 Margreid a.d. Weinstr.,38,,9,1,10
045 Margreid a.d. Weinstr.,39,,7,6,13
045 Margreid a.d. Weinstr.,40,,7,9,16
045 Margreid a.d. Weinstr.,41,,11,19,30
045 Margreid a.d. Weinstr.,42,,10,8,18
045 Margreid a.d. Weinstr.,43,,10,6,16
045 Margreid a.d. Weinstr.,44,,8,12,20
045 Margreid a.d. Weinstr.,45,,8,6,14
045 Margreid a.d. Weinstr.,46,,9,9,18
045 Margreid a.d. Weinstr.,47,,10,11,21
045 Margreid a.d. Weinstr.,48,,7,11,18
045 Margreid a.d. Weinstr.,49,,18,16,34
045 Margreid a.d. Weinstr.,50,,12,17,29
045 Margreid a.d. Weinstr.,51,,17,9,26
045 Margreid a.d. Weinstr.,52,,11,4,15
045 Margreid a.d. Weinstr.,53,,7,3,10
045 Margreid a.d. Weinstr.,54,,9,11,20
045 Margreid a.d. Weinstr.,55,,7,15,22
045 Margreid a.d. Weinstr.,56,,14,13,27
045 Margreid a.d. Weinstr.,57,,13,10,23
045 Margreid a.d. Weinstr.,58,,9,11,20
045 Margreid a.d. Weinstr.,59,,8,5,13
045 Margreid a.d. Weinstr.,60,,9,8,17
045 Margreid a.d. Weinstr.,61,,14,6,20
045 Margreid a.d. Weinstr.,62,,8,8,16
045 Margreid a.d. Weinstr.,63,,4,6,10
045 Margreid a.d. Weinstr.,64,,7,8,15
045 Margreid a.d. Weinstr.,65,,6,7,13
045 Margreid a.d. Weinstr.,66,,4,7,11
045 Margreid a.d. Weinstr.,67,,7,6,13
045 Margreid a.d. Weinstr.,68,,8,2,10
045 Margreid a.d. Weinstr.,69,,6,9,15
045 Margreid a.d. Weinstr.,70,,4,6,10
045 Margreid a.d. Weinstr.,71,,2,3,5
045 Margreid a.d. Weinstr.,72,,6,7,13
045 Margreid a.d. Weinstr.,73,,3,5,8
045 Margreid a.d. Weinstr.,74,,6,3,9
045 Margreid a.d. Weinstr.,75,,6,5,11
045 Margreid a.d. Weinstr.,76,,7,5,12
045 Margreid a.d. Weinstr.,77,,6,4,10
045 Margreid a.d. Weinstr.,78,,3,6,9
045 Margreid a.d. Weinstr.,79,,4,9,13
045 Margreid a.d. Weinstr.,80,,3,3,6
045 Margreid a.d. Weinstr.,81,,3,4,7
045 Margreid a.d. Weinstr.,82,,2,5,7
045 Margreid a.d. Weinstr.,83,,1,4,5
045 Margreid a.d. Weinstr.,84,,1,3,4
045 Margreid a.d. Weinstr.,85,,3,3,6
045 Margreid a.d. Weinstr.,86,,-,4,4
045 Margreid a.d. Weinstr.,87,,2,1,3
045 Margreid a.d. Weinstr.,88,,-,1,1
045 Margreid a.d. Weinstr.,89,,1,1,2
045 Margreid a.d. Weinstr.,90,,-,3,3
045 Margreid a.d. Weinstr.,91,,-,4,4
045 Margreid a.d. Weinstr.,92,,-,1,1
045 Margreid a.d. Weinstr.,93,,-,2,2
045 Margreid a.d. Weinstr.,94,,-,2,2
045 Margreid a.d. Weinstr.,98,,-,2,2
046 Mals,0,,33,35,68
046 Mals,1,,43,25,68
046 Mals,2,,27,20,47
046 Mals,3,,33,27,60
046 Mals,4,,31,30,61
046 Mals,5,,28,24,52
046 Mals,6,,33,21,54
046 Mals,7,,31,27,58
046 Mals,8,,33,17,50
046 Mals,9,,26,23,49
046 Mals,10,,22,34,56
046 Mals,11,,36,34,70
046 Mals,12,,24,29,53
046 Mals,13,,28,24,52
046 Mals,14,,30,21,51
046 Mals,15,,25,27,52
046 Mals,16,,32,28,60
046 Mals,17,,32,38,70
046 Mals,18,,42,30,72
046 Mals,19,,38,35,73
046 Mals,20,,34,34,68
046 Mals,21,,42,31,73
046 Mals,22,,39,43,82
046 Mals,23,,38,35,73
046 Mals,24,,35,33,68
046 Mals,25,,36,40,76
046 Mals,26,,41,37,78
046 Mals,27,,40,34,74
046 Mals,28,,43,34,77
046 Mals,29,,43,31,74
046 Mals,30,,28,27,55
046 Mals,31,,27,34,61
046 Mals,32,,37,33,70
046 Mals,33,,37,31,68
046 Mals,34,,34,34,68
046 Mals,35,,34,32,66
046 Mals,36,,32,39,71
046 Mals,37,,38,30,68
046 Mals,38,,29,30,59
046 Mals,39,,42,31,73
046 Mals,40,,30,25,55
046 Mals,41,,26,29,55
046 Mals,42,,37,32,69
046 Mals,43,,47,28,75
046 Mals,44,,30,36,66
046 Mals,45,,29,45,74
046 Mals,46,,33,47,80
046 Mals,47,,42,48,90
046 Mals,48,,48,43,91
046 Mals,49,,53,39,92
046 Mals,50,,46,34,80
046 Mals,51,,49,50,99
046 Mals,52,,50,39,89
046 Mals,53,,43,42,85
046 Mals,54,,47,53,100
046 Mals,55,,37,30,67
046 Mals,56,,50,36,86
046 Mals,57,,33,39,72
046 Mals,58,,35,33,68
046 Mals,59,,29,23,52
046 Mals,60,,35,32,67
046 Mals,61,,32,26,58
046 Mals,62,,27,24,51
046 Mals,63,,19,20,39
046 Mals,64,,31,31,62
046 Mals,65,,26,23,49
046 Mals,66,,28,20,48
046 Mals,67,,33,23,56
046 Mals,68,,20,25,45
046 Mals,69,,24,14,38
046 Mals,70,,19,20,39
046 Mals,71,,17,26,43
046 Mals,72,,9,18,27
046 Mals,73,,28,14,42
046 Mals,74,,23,19,42
046 Mals,75,,16,22,38
046 Mals,76,,13,14,27
046 Mals,77,,14,25,39
046 Mals,78,,19,25,44
046 Mals,79,,13,19,32
046 Mals,80,,10,24,34
046 Mals,81,,14,14,28
046 Mals,82,,9,14,23
046 Mals,83,,7,11,18
046 Mals,84,,9,16,25
046 Mals,85,,13,7,20
046 Mals,86,,6,11,17
046 Mals,87,,12,11,23
046 Mals,88,,4,8,12
046 Mals,89,,4,8,12
046 Mals,90,,4,4,8
046 Mals,91,,2,9,11
046 Mals,92,,2,6,8
046 Mals,93,,1,6,7
046 Mals,94,,-,2,2
046 Mals,95,,1,4,5
046 Mals,96,,-,1,1
046 Mals,97,,-,1,1
046 Mals,100,,-,1,1
047 Enneberg,0,,28,15,43
047 Enneberg,1,,25,22,47
047 Enneberg,2,,21,20,41
047 Enneberg,3,,17,24,41
047 Enneberg,4,,15,18,33
047 Enneberg,5,,18,15,33
047 Enneberg,6,,24,17,41
047 Enneberg,7,,18,11,29
047 Enneberg,8,,15,13,28
047 Enneberg,9,,16,20,36
047 Enneberg,10,,15,15,30
047 Enneberg,11,,23,21,44
047 Enneberg,12,,19,16,35
047 Enneberg,13,,14,18,32
047 Enneberg,14,,21,27,48
047 Enneberg,15,,17,14,31
047 Enneberg,16,,29,16,45
047 Enneberg,17,,20,20,40
047 Enneberg,18,,25,18,43
047 Enneberg,19,,17,11,28
047 Enneberg,20,,23,13,36
047 Enneberg,21,,16,16,32
047 Enneberg,22,,22,9,31
047 Enneberg,23,,21,14,35
047 Enneberg,24,,21,23,44
047 Enneberg,25,,13,17,30
047 Enneberg,26,,17,22,39
047 Enneberg,27,,16,23,39
047 Enneberg,28,,21,14,35
047 Enneberg,29,,18,12,30
047 Enneberg,30,,15,16,31
047 Enneberg,31,,16,10,26
047 Enneberg,32,,22,18,40
047 Enneberg,33,,18,15,33
047 Enneberg,34,,16,14,30
047 Enneberg,35,,24,22,46
047 Enneberg,36,,18,22,40
047 Enneberg,37,,20,19,39
047 Enneberg,38,,12,20,32
047 Enneberg,39,,18,24,42
047 Enneberg,40,,22,20,42
047 Enneberg,41,,15,18,33
047 Enneberg,42,,16,26,42
047 Enneberg,43,,25,33,58
047 Enneberg,44,,27,22,49
047 Enneberg,45,,23,27,50
047 Enneberg,46,,28,38,66
047 Enneberg,47,,25,17,42
047 Enneberg,48,,32,18,50
047 Enneberg,49,,25,24,49
047 Enneberg,50,,25,22,47
047 Enneberg,51,,21,18,39
047 Enneberg,52,,25,22,47
047 Enneberg,53,,22,20,42
047 Enneberg,54,,21,20,41
047 Enneberg,55,,18,16,34
047 Enneberg,56,,18,16,34
047 Enneberg,57,,15,16,31
047 Enneberg,58,,23,15,38
047 Enneberg,59,,21,13,34
047 Enneberg,60,,14,17,31
047 Enneberg,61,,14,18,32
047 Enneberg,62,,14,15,29
047 Enneberg,63,,14,13,27
047 Enneberg,64,,17,21,38
047 Enneberg,65,,15,18,33
047 Enneberg,66,,18,10,28
047 Enneberg,67,,10,15,25
047 Enneberg,68,,17,7,24
047 Enneberg,69,,15,14,29
047 Enneberg,70,,7,11,18
047 Enneberg,71,,10,17,27
047 Enneberg,72,,3,12,15
047 Enneberg,73,,18,18,36
047 Enneberg,74,,15,9,24
047 Enneberg,75,,10,16,26
047 Enneberg,76,,13,12,25
047 Enneberg,77,,9,6,15
047 Enneberg,78,,14,8,22
047 Enneberg,79,,10,12,22
047 Enneberg,80,,12,10,22
047 Enneberg,81,,8,10,18
047 Enneberg,82,,9,13,22
047 Enneberg,83,,5,9,14
047 Enneberg,84,,6,7,13
047 Enneberg,85,,4,17,21
047 Enneberg,86,,7,7,14
047 Enneberg,87,,6,11,17
047 Enneberg,88,,3,6,9
047 Enneberg,89,,3,6,9
047 Enneberg,90,,1,4,5
047 Enneberg,91,,3,1,4
047 Enneberg,92,,2,4,6
047 Enneberg,93,,-,3,3
047 Enneberg,94,,-,4,4
047 Enneberg,95,,1,4,5
047 Enneberg,96,,1,1,2
047 Enneberg,98,,-,2,2
047 Enneberg,103,,-,1,1
048 Marling,0,,17,16,33
048 Marling,1,,11,18,29
048 Marling,2,,16,8,24
048 Marling,3,,11,15,26
048 Marling,4,,12,8,20
048 Marling,5,,13,11,24
048 Marling,6,,17,6,23
048 Marling,7,,20,7,27
048 Marling,8,,21,7,28
048 Marling,9,,12,12,24
048 Marling,10,,19,11,30
048 Marling,11,,9,17,26
048 Marling,12,,25,14,39
048 Marling,13,,13,14,27
048 Marling,14,,11,13,24
048 Marling,15,,13,19,32
048 Marling,16,,15,16,31
048 Marling,17,,16,18,34
048 Marling,18,,15,9,24
048 Marling,19,,15,13,28
048 Marling,20,,18,10,28
048 Marling,21,,13,15,28
048 Marling,22,,21,12,33
048 Marling,23,,14,9,23
048 Marling,24,,16,17,33
048 Marling,25,,21,17,38
048 Marling,26,,15,20,35
048 Marling,27,,16,24,40
048 Marling,28,,17,20,37
048 Marling,29,,13,15,28
048 Marling,30,,18,17,35
048 Marling,31,,10,18,28
048 Marling,32,,10,24,34
048 Marling,33,,19,11,30
048 Marling,34,,18,19,37
048 Marling,35,,22,13,35
048 Marling,36,,24,14,38
048 Marling,37,,17,15,32
048 Marling,38,,14,23,37
048 Marling,39,,19,24,43
048 Marling,40,,21,16,37
048 Marling,41,,19,23,42
048 Marling,42,,27,17,44
048 Marling,43,,17,10,27
048 Marling,44,,21,20,41
048 Marling,45,,19,23,42
048 Marling,46,,27,17,44
048 Marling,47,,20,21,41
048 Marling,48,,21,17,38
048 Marling,49,,25,21,46
048 Marling,50,,19,19,38
048 Marling,51,,26,33,59
048 Marling,52,,27,18,45
048 Marling,53,,28,20,48
048 Marling,54,,29,29,58
048 Marling,55,,17,20,37
048 Marling,56,,26,13,39
048 Marling,57,,14,23,37
048 Marling,58,,18,15,33
048 Marling,59,,17,12,29
048 Marling,60,,12,12,24
048 Marling,61,,12,12,24
048 Marling,62,,13,6,19
048 Marling,63,,18,12,30
048 Marling,64,,9,15,24
048 Marling,65,,11,16,27
048 Marling,66,,7,15,22
048 Marling,67,,10,15,25
048 Marling,68,,17,16,33
048 Marling,69,,5,14,19
048 Marling,70,,15,13,28
048 Marling,71,,12,14,26
048 Marling,72,,16,11,27
048 Marling,73,,17,14,31
048 Marling,74,,9,17,26
048 Marling,75,,7,12,19
048 Marling,76,,17,15,32
048 Marling,77,,10,11,21
048 Marling,78,,13,14,27
048 Marling,79,,8,11,19
048 Marling,80,,8,13,21
048 Marling,81,,12,7,19
048 Marling,82,,3,15,18
048 Marling,83,,7,7,14
048 Marling,84,,6,12,18
048 Marling,85,,6,8,14
048 Marling,86,,7,7,14
048 Marling,87,,2,7,9
048 Marling,88,,4,4,8
048 Marling,89,,3,1,4
048 Marling,90,,3,4,7
048 Marling,91,,1,5,6
048 Marling,92,,-,5,5
048 Marling,93,,-,5,5
048 Marling,94,,-,3,3
048 Marling,95,,-,1,1
048 Marling,96,,1,1,2
049 Martell,0,,6,2,8
049 Martell,1,,3,4,7
049 Martell,2,,3,3,6
049 Martell,3,,3,4,7
049 Martell,4,,8,3,11
049 Martell,5,,3,4,7
049 Martell,6,,9,5,14
049 Martell,7,,8,4,12
049 Martell,8,,3,1,4
049 Martell,9,,7,1,8
049 Martell,10,,7,1,8
049 Martell,11,,4,5,9
049 Martell,12,,8,4,12
049 Martell,13,,6,1,7
049 Martell,14,,5,5,10
049 Martell,15,,3,6,9
049 Martell,16,,4,7,11
049 Martell,17,,7,2,9
049 Martell,18,,1,7,8
049 Martell,19,,6,6,12
049 Martell,20,,6,7,13
049 Martell,21,,4,6,10
049 Martell,22,,6,7,13
049 Martell,23,,6,8,14
049 Martell,24,,7,4,11
049 Martell,25,,3,4,7
049 Martell,26,,8,3,11
049 Martell,27,,4,5,9
049 Martell,28,,7,5,12
049 Martell,29,,4,1,5
049 Martell,30,,8,6,14
049 Martell,31,,-,3,3
049 Martell,32,,3,4,7
049 Martell,33,,3,-,3
049 Martell,34,,7,6,13
049 Martell,35,,6,8,14
049 Martell,36,,5,5,10
049 Martell,37,,8,4,12
049 Martell,38,,7,1,8
049 Martell,39,,4,5,9
049 Martell,40,,7,3,10
049 Martell,41,,5,6,11
049 Martell,42,,2,6,8
049 Martell,43,,7,11,18
049 Martell,44,,10,4,14
049 Martell,45,,6,8,14
049 Martell,46,,9,4,13
049 Martell,47,,6,4,10
049 Martell,48,,6,12,18
049 Martell,49,,8,6,14
049 Martell,50,,6,7,13
049 Martell,51,,15,5,20
049 Martell,52,,17,11,28
049 Martell,53,,7,9,16
049 Martell,54,,14,1,15
049 Martell,55,,10,6,16
049 Martell,56,,7,5,12
049 Martell,57,,9,3,12
049 Martell,58,,6,6,12
049 Martell,59,,6,6,12
049 Martell,60,,7,3,10
049 Martell,61,,5,4,9
049 Martell,62,,7,3,10
049 Martell,63,,5,6,11
049 Martell,64,,3,4,7
049 Martell,65,,3,3,6
049 Martell,66,,4,8,12
049 Martell,67,,2,5,7
049 Martell,68,,3,1,4
049 Martell,69,,4,4,8
049 Martell,70,,3,3,6
049 Martell,71,,3,-,3
049 Martell,72,,4,1,5
049 Martell,73,,1,3,4
049 Martell,74,,4,3,7
049 Martell,75,,5,4,9
049 Martell,76,,2,3,5
049 Martell,77,,6,2,8
049 Martell,78,,1,4,5
049 Martell,79,,1,4,5
049 Martell,80,,1,3,4
049 Martell,81,,1,4,5
049 Martell,82,,2,7,9
049 Martell,83,,3,1,4
049 Martell,84,,4,4,8
049 Martell,85,,2,1,3
049 Martell,86,,2,-,2
049 Martell,87,,2,1,3
049 Martell,88,,-,1,1
049 Martell,89,,-,1,1
049 Martell,90,,1,2,3
049 Martell,91,,-,2,2
049 Martell,92,,-,1,1
049 Martell,93,,1,1,2
049 Martell,94,,-,1,1
050 Mölten,0,,4,5,9
050 Mölten,1,,8,10,18
050 Mölten,2,,12,8,20
050 Mölten,3,,10,7,17
050 Mölten,4,,15,14,29
050 Mölten,5,,9,8,17
050 Mölten,6,,13,9,22
050 Mölten,7,,5,14,19
050 Mölten,8,,14,12,26
050 Mölten,9,,10,16,26
050 Mölten,10,,14,9,23
050 Mölten,11,,8,8,16
050 Mölten,12,,10,13,23
050 Mölten,13,,12,11,23
050 Mölten,14,,11,9,20
050 Mölten,15,,16,10,26
050 Mölten,16,,17,17,34
050 Mölten,17,,13,13,26
050 Mölten,18,,12,15,27
050 Mölten,19,,8,14,22
050 Mölten,20,,10,6,16
050 Mölten,21,,15,13,28
050 Mölten,22,,13,9,22
050 Mölten,23,,12,6,18
050 Mölten,24,,13,9,22
050 Mölten,25,,4,12,16
050 Mölten,26,,10,7,17
050 Mölten,27,,9,4,13
050 Mölten,28,,11,5,16
050 Mölten,29,,10,10,20
050 Mölten,30,,9,6,15
050 Mölten,31,,9,6,15
050 Mölten,32,,7,7,14
050 Mölten,33,,6,7,13
050 Mölten,34,,7,6,13
050 Mölten,35,,11,10,21
050 Mölten,36,,14,12,26
050 Mölten,37,,16,7,23
050 Mölten,38,,12,16,28
050 Mölten,39,,11,7,18
050 Mölten,40,,6,17,23
050 Mölten,41,,11,20,31
050 Mölten,42,,24,12,36
050 Mölten,43,,11,14,25
050 Mölten,44,,18,18,36
050 Mölten,45,,9,11,20
050 Mölten,46,,12,16,28
050 Mölten,47,,15,11,26
050 Mölten,48,,16,13,29
050 Mölten,49,,18,16,34
050 Mölten,50,,18,13,31
050 Mölten,51,,17,13,30
050 Mölten,52,,14,13,27
050 Mölten,53,,20,16,36
050 Mölten,54,,19,7,26
050 Mölten,55,,15,10,25
050 Mölten,56,,16,10,26
050 Mölten,57,,9,9,18
050 Mölten,58,,14,5,19
050 Mölten,59,,4,8,12
050 Mölten,60,,8,3,11
050 Mölten,61,,6,8,14
050 Mölten,62,,12,8,20
050 Mölten,63,,7,6,13
050 Mölten,64,,6,7,13
050 Mölten,65,,7,6,13
050 Mölten,66,,5,4,9
050 Mölten,67,,9,10,19
050 Mölten,68,,8,4,12
050 Mölten,69,,8,5,13
050 Mölten,70,,3,8,11
050 Mölten,71,,8,1,9
050 Mölten,72,,6,4,10
050 Mölten,73,,1,7,8
050 Mölten,74,,11,9,20
050 Mölten,75,,4,9,13
050 Mölten,76,,8,5,13
050 Mölten,77,,4,7,11
050 Mölten,78,,4,5,9
050 Mölten,79,,4,2,6
050 Mölten,80,,3,6,9
050 Mölten,81,,2,3,5
050 Mölten,82,,6,5,11
050 Mölten,83,,7,4,11
050 Mölten,84,,4,7,11
050 Mölten,85,,3,4,7
050 Mölten,86,,4,-,4
050 Mölten,87,,2,2,4
050 Mölten,88,,1,3,4
050 Mölten,89,,1,1,2
050 Mölten,90,,-,1,1
050 Mölten,91,,-,1,1
050 Mölten,92,,-,3,3
050 Mölten,94,,-,1,1
050 Mölten,95,,1,1,2
050 Mölten,96,,-,1,1
050 Mölten,98,,-,1,1
051 Meran,0,,203,169,372
051 Meran,1,,191,183,374
051 Meran,2,,193,191,384
051 Meran,3,,208,194,402
051 Meran,4,,192,180,372
051 Meran,5,,199,182,381
051 Meran,6,,189,215,404
051 Meran,7,,219,204,423
051 Meran,8,,215,194,409
051 Meran,9,,213,179,392
051 Meran,10,,237,206,443
051 Meran,11,,205,221,426
051 Meran,12,,201,195,396
051 Meran,13,,248,191,439
051 Meran,14,,204,172,376
051 Meran,15,,195,182,377
051 Meran,16,,217,191,408
051 Meran,17,,224,179,403
051 Meran,18,,196,197,393
051 Meran,19,,182,186,368
051 Meran,20,,228,188,416
051 Meran,21,,228,187,415
051 Meran,22,,211,183,394
051 Meran,23,,209,221,430
051 Meran,24,,186,198,384
051 Meran,25,,228,189,417
051 Meran,26,,214,220,434
051 Meran,27,,197,200,397
051 Meran,28,,248,213,461
051 Meran,29,,230,199,429
051 Meran,30,,213,224,437
051 Meran,31,,234,205,439
051 Meran,32,,212,258,470
051 Meran,33,,227,224,451
051 Meran,34,,239,243,482
051 Meran,35,,232,253,485
051 Meran,36,,253,259,512
051 Meran,37,,265,244,509
051 Meran,38,,238,254,492
051 Meran,39,,258,252,510
051 Meran,40,,248,277,525
051 Meran,41,,244,299,543
051 Meran,42,,270,294,564
051 Meran,43,,288,338,626
051 Meran,44,,275,326,601
051 Meran,45,,296,308,604
051 Meran,46,,331,298,629
051 Meran,47,,324,354,678
051 Meran,48,,347,343,690
051 Meran,49,,352,350,702
051 Meran,50,,368,354,722
051 Meran,51,,328,322,650
051 Meran,52,,325,345,670
051 Meran,53,,340,328,668
051 Meran,54,,343,308,651
051 Meran,55,,274,293,567
051 Meran,56,,290,315,605
051 Meran,57,,291,278,569
051 Meran,58,,259,256,515
051 Meran,59,,257,262,519
051 Meran,60,,213,263,476
051 Meran,61,,218,235,453
051 Meran,62,,200,229,429
051 Meran,63,,182,239,421
051 Meran,64,,170,242,412
051 Meran,65,,203,222,425
051 Meran,66,,183,225,408
051 Meran,67,,184,229,413
051 Meran,68,,224,249,473
051 Meran,69,,194,261,455
051 Meran,70,,213,271,484
051 Meran,71,,209,288,497
051 Meran,72,,172,200,372
051 Meran,73,,174,213,387
051 Meran,74,,234,235,469
051 Meran,75,,204,277,481
051 Meran,76,,185,267,452
051 Meran,77,,150,209,359
051 Meran,78,,154,223,377
051 Meran,79,,140,207,347
051 Meran,80,,144,194,338
051 Meran,81,,121,175,296
051 Meran,82,,110,168,278
051 Meran,83,,104,145,249
051 Meran,84,,103,127,230
051 Meran,85,,78,134,212
051 Meran,86,,56,125,181
051 Meran,87,,68,110,178
051 Meran,88,,51,86,137
051 Meran,89,,42,99,141
051 Meran,90,,43,69,112
051 Meran,91,,25,71,96
051 Meran,92,,18,59,77
051 Meran,93,,25,68,93
051 Meran,94,,7,42,49
051 Meran,95,,12,32,44
051 Meran,96,,4,30,34
051 Meran,97,,4,22,26
051 Meran,98,,4,9,13
051 Meran,99,,-,3,3
051 Meran,100,,1,5,6
051 Meran,101,,1,1,2
051 Meran,102,,1,2,3
051 Meran,103,,-,2,2
052 Welsberg-Taisten,0,,10,9,19
052 Welsberg-Taisten,1,,12,6,18
052 Welsberg-Taisten,2,,13,16,29
052 Welsberg-Taisten,3,,22,12,34
052 Welsberg-Taisten,4,,16,10,26
052 Welsberg-Taisten,5,,10,12,22
052 Welsberg-Taisten,6,,15,19,34
052 Welsberg-Taisten,7,,8,17,25
052 Welsberg-Taisten,8,,13,15,28
052 Welsberg-Taisten,9,,21,20,41
052 Welsberg-Taisten,10,,21,23,44
052 Welsberg-Taisten,11,,11,25,36
052 Welsberg-Taisten,12,,19,27,46
052 Welsberg-Taisten,13,,15,19,34
052 Welsberg-Taisten,14,,20,21,41
052 Welsberg-Taisten,15,,23,24,47
052 Welsberg-Taisten,16,,31,20,51
052 Welsberg-Taisten,17,,19,14,33
052 Welsberg-Taisten,18,,20,23,43
052 Welsberg-Taisten,19,,25,12,37
052 Welsberg-Taisten,20,,21,22,43
052 Welsberg-Taisten,21,,16,17,33
052 Welsberg-Taisten,22,,19,17,36
052 Welsberg-Taisten,23,,12,15,27
052 Welsberg-Taisten,24,,19,19,38
052 Welsberg-Taisten,25,,12,15,27
052 Welsberg-Taisten,26,,22,15,37
052 Welsberg-Taisten,27,,8,16,24
052 Welsberg-Taisten,28,,7,20,27
052 Welsberg-Taisten,29,,14,18,32
052 Welsberg-Taisten,30,,11,9,20
052 Welsberg-Taisten,31,,18,11,29
052 Welsberg-Taisten,32,,6,26,32
052 Welsberg-Taisten,33,,26,16,42
052 Welsberg-Taisten,34,,21,17,38
052 Welsberg-Taisten,35,,16,19,35
052 Welsberg-Taisten,36,,12,17,29
052 Welsberg-Taisten,37,,19,13,32
052 Welsberg-Taisten,38,,23,22,45
052 Welsberg-Taisten,39,,17,19,36
052 Welsberg-Taisten,40,,14,26,40
052 Welsberg-Taisten,41,,14,11,25
052 Welsberg-Taisten,42,,14,24,38
052 Welsberg-Taisten,43,,26,25,51
052 Welsberg-Taisten,44,,24,13,37
052 Welsberg-Taisten,45,,18,29,47
052 Welsberg-Taisten,46,,31,23,54
052 Welsberg-Taisten,47,,28,25,53
052 Welsberg-Taisten,48,,18,23,41
052 Welsberg-Taisten,49,,26,23,49
052 Welsberg-Taisten,50,,32,23,55
052 Welsberg-Taisten,51,,31,21,52
052 Welsberg-Taisten,52,,21,15,36
052 Welsberg-Taisten,53,,32,19,51
052 Welsberg-Taisten,54,,26,24,50
052 Welsberg-Taisten,55,,21,23,44
052 Welsberg-Taisten,56,,17,14,31
052 Welsberg-Taisten,57,,10,17,27
052 Welsberg-Taisten,58,,21,20,41
052 Welsberg-Taisten,59,,25,16,41
052 Welsberg-Taisten,60,,15,19,34
052 Welsberg-Taisten,61,,16,19,35
052 Welsberg-Taisten,62,,15,7,22
052 Welsberg-Taisten,63,,15,15,30
052 Welsberg-Taisten,64,,16,14,30
052 Welsberg-Taisten,65,,16,13,29
052 Welsberg-Taisten,66,,15,8,23
052 Welsberg-Taisten,67,,15,12,27
052 Welsberg-Taisten,68,,13,9,22
052 Welsberg-Taisten,69,,16,16,32
052 Welsberg-Taisten,70,,9,12,21
052 Welsberg-Taisten,71,,12,12,24
052 Welsberg-Taisten,72,,9,11,20
052 Welsberg-Taisten,73,,12,11,23
052 Welsberg-Taisten,74,,8,12,20
052 Welsberg-Taisten,75,,9,13,22
052 Welsberg-Taisten,76,,13,16,29
052 Welsberg-Taisten,77,,6,11,17
052 Welsberg-Taisten,78,,12,7,19
052 Welsberg-Taisten,79,,6,9,15
052 Welsberg-Taisten,80,,7,8,15
052 Welsberg-Taisten,81,,3,8,11
052 Welsberg-Taisten,82,,3,12,15
052 Welsberg-Taisten,83,,10,10,20
052 Welsberg-Taisten,84,,7,10,17
052 Welsberg-Taisten,85,,6,9,15
052 Welsberg-Taisten,86,,3,8,11
052 Welsberg-Taisten,87,,3,6,9
052 Welsberg-Taisten,88,,4,7,11
052 Welsberg-Taisten,89,,4,11,15
052 Welsberg-Taisten,90,,1,2,3
052 Welsberg-Taisten,91,,1,4,5
052 Welsberg-Taisten,92,,-,2,2
052 Welsberg-Taisten,93,,-,4,4
052 Welsberg-Taisten,94,,2,2,4
052 Welsberg-Taisten,95,,-,1,1
052 Welsberg-Taisten,96,,1,2,3
052 Welsberg-Taisten,97,,-,1,1
053 Montan,0,,15,12,27
053 Montan,1,,7,12,19
053 Montan,2,,5,12,17
053 Montan,3,,15,5,20
053 Montan,4,,8,4,12
053 Montan,5,,10,7,17
053 Montan,6,,10,2,12
053 Montan,7,,15,8,23
053 Montan,8,,8,7,15
053 Montan,9,,12,9,21
053 Montan,10,,8,7,15
053 Montan,11,,8,7,15
053 Montan,12,,8,10,18
053 Montan,13,,7,10,17
053 Montan,14,,8,12,20
053 Montan,15,,6,4,10
053 Montan,16,,13,4,17
053 Montan,17,,10,6,16
053 Montan,18,,8,10,18
053 Montan,19,,9,14,23
053 Montan,20,,7,14,21
053 Montan,21,,15,11,26
053 Montan,22,,16,15,31
053 Montan,23,,12,5,17
053 Montan,24,,4,7,11
053 Montan,25,,6,8,14
053 Montan,26,,12,10,22
053 Montan,27,,9,9,18
053 Montan,28,,11,13,24
053 Montan,29,,9,18,27
053 Montan,30,,15,19,34
053 Montan,31,,16,8,24
053 Montan,32,,8,9,17
053 Montan,33,,6,8,14
053 Montan,34,,15,13,28
053 Montan,35,,9,7,16
053 Montan,36,,14,15,29
053 Montan,37,,7,6,13
053 Montan,38,,11,9,20
053 Montan,39,,14,6,20
053 Montan,40,,8,6,14
053 Montan,41,,8,5,13
053 Montan,42,,11,17,28
053 Montan,43,,10,17,27
053 Montan,44,,11,8,19
053 Montan,45,,10,9,19
053 Montan,46,,11,10,21
053 Montan,47,,14,12,26
053 Montan,48,,12,19,31
053 Montan,49,,12,19,31
053 Montan,50,,12,12,24
053 Montan,51,,13,16,29
053 Montan,52,,28,16,44
053 Montan,53,,14,10,24
053 Montan,54,,11,20,31
053 Montan,55,,15,17,32
053 Montan,56,,17,11,28
053 Montan,57,,14,10,24
053 Montan,58,,15,11,26
053 Montan,59,,10,11,21
053 Montan,60,,9,12,21
053 Montan,61,,9,15,24
053 Montan,62,,6,14,20
053 Montan,63,,10,12,22
053 Montan,64,,11,6,17
053 Montan,65,,11,3,14
053 Montan,66,,6,7,13
053 Montan,67,,4,4,8
053 Montan,68,,8,4,12
053 Montan,69,,5,5,10
053 Montan,70,,7,11,18
053 Montan,71,,5,3,8
053 Montan,72,,5,3,8
053 Montan,73,,2,6,8
053 Montan,74,,5,6,11
053 Montan,75,,5,7,12
053 Montan,76,,5,5,10
053 Montan,77,,7,7,14
053 Montan,78,,3,8,11
053 Montan,79,,5,10,15
053 Montan,80,,1,6,7
053 Montan,81,,5,8,13
053 Montan,82,,1,7,8
053 Montan,83,,2,5,7
053 Montan,84,,11,3,14
053 Montan,85,,4,4,8
053 Montan,86,,4,9,13
053 Montan,87,,6,11,17
053 Montan,88,,3,7,10
053 Montan,89,,1,2,3
053 Montan,90,,1,3,4
053 Montan,91,,2,6,8
053 Montan,92,,-,4,4
053 Montan,93,,-,2,2
053 Montan,94,,-,2,2
053 Montan,98,,-,1,1
054 Moos in Passeier,0,,16,11,27
054 Moos in Passeier,1,,16,15,31
054 Moos in Passeier,2,,12,7,19
054 Moos in Passeier,3,,17,17,34
054 Moos in Passeier,4,,15,11,26
054 Moos in Passeier,5,,12,14,26
054 Moos in Passeier,6,,21,8,29
054 Moos in Passeier,7,,8,10,18
054 Moos in Passeier,8,,9,14,23
054 Moos in Passeier,9,,17,11,28
054 Moos in Passeier,10,,17,7,24
054 Moos in Passeier,11,,17,10,27
054 Moos in Passeier,12,,18,14,32
054 Moos in Passeier,13,,17,21,38
054 Moos in Passeier,14,,16,10,26
054 Moos in Passeier,15,,20,19,39
054 Moos in Passeier,16,,12,12,24
054 Moos in Passeier,17,,11,17,28
054 Moos in Passeier,18,,24,9,33
054 Moos in Passeier,19,,16,12,28
054 Moos in Passeier,20,,11,16,27
054 Moos in Passeier,21,,18,14,32
054 Moos in Passeier,22,,7,9,16
054 Moos in Passeier,23,,16,16,32
054 Moos in Passeier,24,,15,13,28
054 Moos in Passeier,25,,17,10,27
054 Moos in Passeier,26,,13,11,24
054 Moos in Passeier,27,,9,14,23
054 Moos in Passeier,28,,12,11,23
054 Moos in Passeier,29,,14,13,27
054 Moos in Passeier,30,,15,11,26
054 Moos in Passeier,31,,12,10,22
054 Moos in Passeier,32,,20,11,31
054 Moos in Passeier,33,,18,16,34
054 Moos in Passeier,34,,9,14,23
054 Moos in Passeier,35,,13,14,27
054 Moos in Passeier,36,,8,13,21
054 Moos in Passeier,37,,9,15,24
054 Moos in Passeier,38,,15,8,23
054 Moos in Passeier,39,,16,13,29
054 Moos in Passeier,40,,17,15,32
054 Moos in Passeier,41,,15,7,22
054 Moos in Passeier,42,,13,12,25
054 Moos in Passeier,43,,23,14,37
054 Moos in Passeier,44,,5,19,24
054 Moos in Passeier,45,,17,14,31
054 Moos in Passeier,46,,18,15,33
054 Moos in Passeier,47,,19,8,27
054 Moos in Passeier,48,,15,17,32
054 Moos in Passeier,49,,16,17,33
054 Moos in Passeier,50,,21,15,36
054 Moos in Passeier,51,,20,16,36
054 Moos in Passeier,52,,18,8,26
054 Moos in Passeier,53,,21,11,32
054 Moos in Passeier,54,,14,19,33
054 Moos in Passeier,55,,9,16,25
054 Moos in Passeier,56,,9,7,16
054 Moos in Passeier,57,,13,14,27
054 Moos in Passeier,58,,14,11,25
054 Moos in Passeier,59,,13,12,25
054 Moos in Passeier,60,,19,5,24
054 Moos in Passeier,61,,8,8,16
054 Moos in Passeier,62,,8,6,14
054 Moos in Passeier,63,,13,9,22
054 Moos in Passeier,64,,5,8,13
054 Moos in Passeier,65,,8,3,11
054 Moos in Passeier,66,,9,10,19
054 Moos in Passeier,67,,5,9,14
054 Moos in Passeier,68,,9,9,18
054 Moos in Passeier,69,,5,6,11
054 Moos in Passeier,70,,15,10,25
054 Moos in Passeier,71,,8,8,16
054 Moos in Passeier,72,,9,5,14
054 Moos in Passeier,73,,8,7,15
054 Moos in Passeier,74,,12,11,23
054 Moos in Passeier,75,,3,11,14
054 Moos in Passeier,76,,8,13,21
054 Moos in Passeier,77,,7,6,13
054 Moos in Passeier,78,,5,4,9
054 Moos in Passeier,79,,8,5,13
054 Moos in Passeier,80,,2,6,8
054 Moos in Passeier,81,,7,6,13
054 Moos in Passeier,82,,7,4,11
054 Moos in Passeier,83,,9,12,21
054 Moos in Passeier,84,,3,8,11
054 Moos in Passeier,85,,5,1,6
054 Moos in Passeier,86,,2,4,6
054 Moos in Passeier,87,,4,3,7
054 Moos in Passeier,88,,4,7,11
054 Moos in Passeier,89,,2,4,6
054 Moos in Passeier,90,,1,2,3
054 Moos in Passeier,91,,2,1,3
054 Moos in Passeier,92,,-,4,4
054 Moos in Passeier,93,,-,2,2
054 Moos in Passeier,94,,1,1,2
054 Moos in Passeier,97,,-,1,1
054 Moos in Passeier,98,,-,1,1
055 Nals,0,,21,8,29
055 Nals,1,,5,10,15
055 Nals,2,,20,14,34
055 Nals,3,,13,9,22
055 Nals,4,,20,12,32
055 Nals,5,,9,8,17
055 Nals,6,,13,14,27
055 Nals,7,,8,15,23
055 Nals,8,,9,12,21
055 Nals,9,,11,5,16
055 Nals,10,,10,10,20
055 Nals,11,,11,3,14
055 Nals,12,,9,12,21
055 Nals,13,,9,9,18
055 Nals,14,,11,6,17
055 Nals,15,,14,14,28
055 Nals,16,,10,9,19
055 Nals,17,,9,16,25
055 Nals,18,,13,11,24
055 Nals,19,,17,12,29
055 Nals,20,,10,9,19
055 Nals,21,,13,13,26
055 Nals,22,,7,9,16
055 Nals,23,,9,10,19
055 Nals,24,,7,13,20
055 Nals,25,,11,9,20
055 Nals,26,,13,8,21
055 Nals,27,,12,12,24
055 Nals,28,,13,14,27
055 Nals,29,,17,14,31
055 Nals,30,,9,11,20
055 Nals,31,,8,9,17
055 Nals,32,,17,15,32
055 Nals,33,,9,8,17
055 Nals,34,,9,10,19
055 Nals,35,,9,15,24
055 Nals,36,,10,15,25
055 Nals,37,,16,12,28
055 Nals,38,,14,13,27
055 Nals,39,,13,14,27
055 Nals,40,,11,16,27
055 Nals,41,,15,16,31
055 Nals,42,,11,15,26
055 Nals,43,,23,20,43
055 Nals,44,,18,11,29
055 Nals,45,,13,18,31
055 Nals,46,,18,19,37
055 Nals,47,,22,13,35
055 Nals,48,,20,18,38
055 Nals,49,,25,18,43
055 Nals,50,,19,16,35
055 Nals,51,,16,16,32
055 Nals,52,,18,20,38
055 Nals,53,,20,23,43
055 Nals,54,,14,21,35
055 Nals,55,,14,14,28
055 Nals,56,,17,14,31
055 Nals,57,,16,13,29
055 Nals,58,,15,19,34
055 Nals,59,,15,13,28
055 Nals,60,,9,6,15
055 Nals,61,,7,9,16
055 Nals,62,,21,13,34
055 Nals,63,,8,6,14
055 Nals,64,,8,8,16
055 Nals,65,,4,6,10
055 Nals,66,,5,8,13
055 Nals,67,,7,10,17
055 Nals,68,,10,8,18
055 Nals,69,,9,12,21
055 Nals,70,,12,6,18
055 Nals,71,,7,13,20
055 Nals,72,,7,11,18
055 Nals,73,,6,11,17
055 Nals,74,,7,6,13
055 Nals,75,,4,9,13
055 Nals,76,,10,5,15
055 Nals,77,,6,12,18
055 Nals,78,,7,10,17
055 Nals,79,,4,8,12
055 Nals,80,,3,12,15
055 Nals,81,,5,4,9
055 Nals,82,,5,5,10
055 Nals,83,,1,6,7
055 Nals,84,,5,9,14
055 Nals,85,,4,2,6
055 Nals,86,,2,5,7
055 Nals,87,,1,4,5
055 Nals,88,,5,4,9
055 Nals,89,,2,4,6
055 Nals,90,,1,4,5
055 Nals,91,,4,1,5
055 Nals,93,,1,-,1
055 Nals,95,,-,1,1
055 Nals,96,,-,1,1
055 Nals,98,,-,1,1
056 Naturns,0,,35,30,65
056 Naturns,1,,24,38,62
056 Naturns,2,,29,31,60
056 Naturns,3,,33,18,51
056 Naturns,4,,36,33,69
056 Naturns,5,,38,34,72
056 Naturns,6,,36,29,65
056 Naturns,7,,31,22,53
056 Naturns,8,,23,26,49
056 Naturns,9,,36,20,56
056 Naturns,10,,32,36,68
056 Naturns,11,,38,30,68
056 Naturns,12,,31,25,56
056 Naturns,13,,36,30,66
056 Naturns,14,,38,22,60
056 Naturns,15,,31,32,63
056 Naturns,16,,33,28,61
056 Naturns,17,,33,28,61
056 Naturns,18,,28,29,57
056 Naturns,19,,30,37,67
056 Naturns,20,,22,15,37
056 Naturns,21,,34,36,70
056 Naturns,22,,45,38,83
056 Naturns,23,,38,40,78
056 Naturns,24,,38,38,76
056 Naturns,25,,28,42,70
056 Naturns,26,,46,42,88
056 Naturns,27,,39,32,71
056 Naturns,28,,40,30,70
056 Naturns,29,,44,30,74
056 Naturns,30,,34,27,61
056 Naturns,31,,28,39,67
056 Naturns,32,,40,31,71
056 Naturns,33,,36,28,64
056 Naturns,34,,36,39,75
056 Naturns,35,,47,38,85
056 Naturns,36,,39,48,87
056 Naturns,37,,36,48,84
056 Naturns,38,,43,35,78
056 Naturns,39,,40,44,84
056 Naturns,40,,37,45,82
056 Naturns,41,,45,34,79
056 Naturns,42,,46,38,84
056 Naturns,43,,42,46,88
056 Naturns,44,,46,51,97
056 Naturns,45,,51,52,103
056 Naturns,46,,42,49,91
056 Naturns,47,,54,42,96
056 Naturns,48,,48,49,97
056 Naturns,49,,47,41,88
056 Naturns,50,,48,47,95
056 Naturns,51,,53,45,98
056 Naturns,52,,37,57,94
056 Naturns,53,,50,35,85
056 Naturns,54,,40,46,86
056 Naturns,55,,42,44,86
056 Naturns,56,,40,51,91
056 Naturns,57,,56,41,97
056 Naturns,58,,41,40,81
056 Naturns,59,,31,33,64
056 Naturns,60,,36,36,72
056 Naturns,61,,43,45,88
056 Naturns,62,,30,31,61
056 Naturns,63,,38,33,71
056 Naturns,64,,31,24,55
056 Naturns,65,,28,36,64
056 Naturns,66,,32,31,63
056 Naturns,67,,27,31,58
056 Naturns,68,,22,19,41
056 Naturns,69,,25,22,47
056 Naturns,70,,8,24,32
056 Naturns,71,,21,27,48
056 Naturns,72,,23,17,40
056 Naturns,73,,14,19,33
056 Naturns,74,,24,31,55
056 Naturns,75,,27,31,58
056 Naturns,76,,31,28,59
056 Naturns,77,,22,19,41
056 Naturns,78,,16,22,38
056 Naturns,79,,17,14,31
056 Naturns,80,,18,16,34
056 Naturns,81,,15,19,34
056 Naturns,82,,12,8,20
056 Naturns,83,,12,18,30
056 Naturns,84,,12,13,25
056 Naturns,85,,6,11,17
056 Naturns,86,,7,12,19
056 Naturns,87,,10,16,26
056 Naturns,88,,5,12,17
056 Naturns,89,,6,3,9
056 Naturns,90,,1,6,7
056 Naturns,91,,5,4,9
056 Naturns,92,,6,3,9
056 Naturns,93,,4,3,7
056 Naturns,94,,-,4,4
056 Naturns,95,,-,1,1
056 Naturns,96,,-,2,2
057 Natz-Schabs,0,,23,20,43
057 Natz-Schabs,1,,27,27,54
057 Natz-Schabs,2,,19,24,43
057 Natz-Schabs,3,,31,21,52
057 Natz-Schabs,4,,20,24,44
057 Natz-Schabs,5,,14,25,39
057 Natz-Schabs,6,,28,14,42
057 Natz-Schabs,7,,15,10,25
057 Natz-Schabs,8,,11,21,32
057 Natz-Schabs,9,,17,24,41
057 Natz-Schabs,10,,15,14,29
057 Natz-Schabs,11,,15,18,33
057 Natz-Schabs,12,,14,15,29
057 Natz-Schabs,13,,15,17,32
057 Natz-Schabs,14,,16,17,33
057 Natz-Schabs,15,,23,19,42
057 Natz-Schabs,16,,17,15,32
057 Natz-Schabs,17,,23,18,41
057 Natz-Schabs,18,,15,19,34
057 Natz-Schabs,19,,22,19,41
057 Natz-Schabs,20,,21,18,39
057 Natz-Schabs,21,,21,20,41
057 Natz-Schabs,22,,15,15,30
057 Natz-Schabs,23,,21,17,38
057 Natz-Schabs,24,,17,19,36
057 Natz-Schabs,25,,15,19,34
057 Natz-Schabs,26,,26,21,47
057 Natz-Schabs,27,,15,20,35
057 Natz-Schabs,28,,17,30,47
057 Natz-Schabs,29,,29,17,46
057 Natz-Schabs,30,,23,21,44
057 Natz-Schabs,31,,22,22,44
057 Natz-Schabs,32,,19,23,42
057 Natz-Schabs,33,,27,16,43
057 Natz-Schabs,34,,14,34,48
057 Natz-Schabs,35,,15,29,44
057 Natz-Schabs,36,,22,19,41
057 Natz-Schabs,37,,24,21,45
057 Natz-Schabs,38,,20,18,38
057 Natz-Schabs,39,,19,31,50
057 Natz-Schabs,40,,24,20,44
057 Natz-Schabs,41,,17,21,38
057 Natz-Schabs,42,,25,29,54
057 Natz-Schabs,43,,30,30,60
057 Natz-Schabs,44,,30,18,48
057 Natz-Schabs,45,,22,30,52
057 Natz-Schabs,46,,23,23,46
057 Natz-Schabs,47,,33,25,58
057 Natz-Schabs,48,,29,24,53
057 Natz-Schabs,49,,27,23,50
057 Natz-Schabs,50,,28,21,49
057 Natz-Schabs,51,,33,22,55
057 Natz-Schabs,52,,36,34,70
057 Natz-Schabs,53,,32,27,59
057 Natz-Schabs,54,,24,32,56
057 Natz-Schabs,55,,18,24,42
057 Natz-Schabs,56,,15,20,35
057 Natz-Schabs,57,,29,23,52
057 Natz-Schabs,58,,22,20,42
057 Natz-Schabs,59,,25,19,44
057 Natz-Schabs,60,,22,22,44
057 Natz-Schabs,61,,17,22,39
057 Natz-Schabs,62,,21,17,38
057 Natz-Schabs,63,,11,17,28
057 Natz-Schabs,64,,20,14,34
057 Natz-Schabs,65,,12,11,23
057 Natz-Schabs,66,,16,13,29
057 Natz-Schabs,67,,14,13,27
057 Natz-Schabs,68,,19,15,34
057 Natz-Schabs,69,,15,12,27
057 Natz-Schabs,70,,11,17,28
057 Natz-Schabs,71,,14,13,27
057 Natz-Schabs,72,,9,7,16
057 Natz-Schabs,73,,13,10,23
057 Natz-Schabs,74,,14,6,20
057 Natz-Schabs,75,,12,7,19
057 Natz-Schabs,76,,12,8,20
057 Natz-Schabs,77,,3,6,9
057 Natz-Schabs,78,,1,5,6
057 Natz-Schabs,79,,3,5,8
057 Natz-Schabs,80,,6,6,12
057 Natz-Schabs,81,,5,4,9
057 Natz-Schabs,82,,3,5,8
057 Natz-Schabs,83,,2,4,6
057 Natz-Schabs,84,,5,7,12
057 Natz-Schabs,85,,1,5,6
057 Natz-Schabs,86,,3,4,7
057 Natz-Schabs,87,,3,6,9
057 Natz-Schabs,88,,5,2,7
057 Natz-Schabs,89,,1,2,3
057 Natz-Schabs,90,,-,2,2
057 Natz-Schabs,91,,-,1,1
057 Natz-Schabs,92,,1,1,2
057 Natz-Schabs,93,,-,2,2
057 Natz-Schabs,94,,-,1,1
057 Natz-Schabs,95,,1,1,2
057 Natz-Schabs,96,,-,1,1
058 Welschnofen,0,,9,17,26
058 Welschnofen,1,,7,16,23
058 Welschnofen,2,,8,11,19
058 Welschnofen,3,,12,8,20
058 Welschnofen,4,,7,5,12
058 Welschnofen,5,,11,10,21
058 Welschnofen,6,,12,7,19
058 Welschnofen,7,,3,9,12
058 Welschnofen,8,,9,3,12
058 Welschnofen,9,,9,8,17
058 Welschnofen,10,,9,7,16
058 Welschnofen,11,,8,8,16
058 Welschnofen,12,,8,10,18
058 Welschnofen,13,,14,8,22
058 Welschnofen,14,,10,8,18
058 Welschnofen,15,,17,6,23
058 Welschnofen,16,,6,9,15
058 Welschnofen,17,,9,8,17
058 Welschnofen,18,,8,12,20
058 Welschnofen,19,,14,10,24
058 Welschnofen,20,,14,12,26
058 Welschnofen,21,,11,9,20
058 Welschnofen,22,,15,14,29
058 Welschnofen,23,,14,10,24
058 Welschnofen,24,,14,12,26
058 Welschnofen,25,,18,12,30
058 Welschnofen,26,,16,13,29
058 Welschnofen,27,,12,11,23
058 Welschnofen,28,,15,8,23
058 Welschnofen,29,,12,13,25
058 Welschnofen,30,,10,19,29
058 Welschnofen,31,,9,11,20
058 Welschnofen,32,,14,13,27
058 Welschnofen,33,,7,6,13
058 Welschnofen,34,,14,13,27
058 Welschnofen,35,,14,12,26
058 Welschnofen,36,,14,15,29
058 Welschnofen,37,,14,12,26
058 Welschnofen,38,,8,9,17
058 Welschnofen,39,,12,15,27
058 Welschnofen,40,,12,14,26
058 Welschnofen,41,,16,7,23
058 Welschnofen,42,,18,14,32
058 Welschnofen,43,,12,15,27
058 Welschnofen,44,,16,18,34
058 Welschnofen,45,,11,11,22
058 Welschnofen,46,,18,22,40
058 Welschnofen,47,,20,17,37
058 Welschnofen,48,,12,16,28
058 Welschnofen,49,,22,18,40
058 Welschnofen,50,,15,16,31
058 Welschnofen,51,,13,15,28
058 Welschnofen,52,,24,13,37
058 Welschnofen,53,,16,10,26
058 Welschnofen,54,,18,15,33
058 Welschnofen,55,,15,12,27
058 Welschnofen,56,,14,15,29
058 Welschnofen,57,,19,11,30
058 Welschnofen,58,,14,14,28
058 Welschnofen,59,,17,10,27
058 Welschnofen,60,,10,13,23
058 Welschnofen,61,,12,13,25
058 Welschnofen,62,,14,15,29
058 Welschnofen,63,,13,11,24
058 Welschnofen,64,,12,12,24
058 Welschnofen,65,,11,11,22
058 Welschnofen,66,,12,7,19
058 Welschnofen,67,,8,8,16
058 Welschnofen,68,,9,12,21
058 Welschnofen,69,,8,10,18
058 Welschnofen,70,,8,7,15
058 Welschnofen,71,,12,10,22
058 Welschnofen,72,,12,4,16
058 Welschnofen,73,,5,9,14
058 Welschnofen,74,,13,9,22
058 Welschnofen,75,,10,12,22
058 Welschnofen,76,,8,6,14
058 Welschnofen,77,,4,7,11
058 Welschnofen,78,,9,6,15
058 Welschnofen,79,,6,8,14
058 Welschnofen,80,,7,3,10
058 Welschnofen,81,,3,10,13
058 Welschnofen,82,,5,6,11
058 Welschnofen,83,,8,9,17
058 Welschnofen,84,,5,10,15
058 Welschnofen,85,,6,6,12
058 Welschnofen,86,,2,5,7
058 Welschnofen,87,,2,6,8
058 Welschnofen,88,,1,7,8
058 Welschnofen,89,,5,1,6
058 Welschnofen,90,,-,2,2
058 Welschnofen,91,,1,2,3
058 Welschnofen,92,,1,1,2
058 Welschnofen,93,,-,2,2
058 Welschnofen,94,,1,1,2
058 Welschnofen,95,,2,2,4
058 Welschnofen,96,,-,3,3
058 Welschnofen,97,,-,2,2
058 Welschnofen,98,,1,-,1
059 Deutschnofen,0,,30,23,53
059 Deutschnofen,1,,27,19,46
059 Deutschnofen,2,,18,17,35
059 Deutschnofen,3,,20,11,31
059 Deutschnofen,4,,28,10,38
059 Deutschnofen,5,,21,19,40
059 Deutschnofen,6,,15,17,32
059 Deutschnofen,7,,24,18,42
059 Deutschnofen,8,,27,18,45
059 Deutschnofen,9,,20,19,39
059 Deutschnofen,10,,18,16,34
059 Deutschnofen,11,,22,27,49
059 Deutschnofen,12,,27,33,60
059 Deutschnofen,13,,18,30,48
059 Deutschnofen,14,,18,33,51
059 Deutschnofen,15,,32,14,46
059 Deutschnofen,16,,24,31,55
059 Deutschnofen,17,,22,27,49
059 Deutschnofen,18,,28,25,53
059 Deutschnofen,19,,34,13,47
059 Deutschnofen,20,,22,31,53
059 Deutschnofen,21,,20,28,48
059 Deutschnofen,22,,27,23,50
059 Deutschnofen,23,,27,15,42
059 Deutschnofen,24,,24,28,52
059 Deutschnofen,25,,35,29,64
059 Deutschnofen,26,,26,22,48
059 Deutschnofen,27,,28,29,57
059 Deutschnofen,28,,26,23,49
059 Deutschnofen,29,,20,28,48
059 Deutschnofen,30,,18,22,40
059 Deutschnofen,31,,26,22,48
059 Deutschnofen,32,,26,26,52
059 Deutschnofen,33,,31,26,57
059 Deutschnofen,34,,23,23,46
059 Deutschnofen,35,,19,29,48
059 Deutschnofen,36,,21,16,37
059 Deutschnofen,37,,22,30,52
059 Deutschnofen,38,,22,23,45
059 Deutschnofen,39,,22,16,38
059 Deutschnofen,40,,30,22,52
059 Deutschnofen,41,,24,28,52
059 Deutschnofen,42,,22,21,43
059 Deutschnofen,43,,27,32,59
059 Deutschnofen,44,,24,27,51
059 Deutschnofen,45,,29,34,63
059 Deutschnofen,46,,31,24,55
059 Deutschnofen,47,,32,34,66
059 Deutschnofen,48,,39,29,68
059 Deutschnofen,49,,28,31,59
059 Deutschnofen,50,,24,29,53
059 Deutschnofen,51,,37,38,75
059 Deutschnofen,52,,33,22,55
059 Deutschnofen,53,,29,32,61
059 Deutschnofen,54,,36,26,62
059 Deutschnofen,55,,25,31,56
059 Deutschnofen,56,,33,23,56
059 Deutschnofen,57,,41,29,70
059 Deutschnofen,58,,27,18,45
059 Deutschnofen,59,,21,27,48
059 Deutschnofen,60,,21,25,46
059 Deutschnofen,61,,29,26,55
059 Deutschnofen,62,,33,22,55
059 Deutschnofen,63,,27,23,50
059 Deutschnofen,64,,23,16,39
059 Deutschnofen,65,,21,22,43
059 Deutschnofen,66,,20,15,35
059 Deutschnofen,67,,17,18,35
059 Deutschnofen,68,,16,17,33
059 Deutschnofen,69,,23,15,38
059 Deutschnofen,70,,10,12,22
059 Deutschnofen,71,,16,21,37
059 Deutschnofen,72,,13,14,27
059 Deutschnofen,73,,16,15,31
059 Deutschnofen,74,,17,22,39
059 Deutschnofen,75,,15,17,32
059 Deutschnofen,76,,16,19,35
059 Deutschnofen,77,,12,16,28
059 Deutschnofen,78,,16,13,29
059 Deutschnofen,79,,14,18,32
059 Deutschnofen,80,,9,4,13
059 Deutschnofen,81,,9,8,17
059 Deutschnofen,82,,3,8,11
059 Deutschnofen,83,,9,5,14
059 Deutschnofen,84,,4,11,15
059 Deutschnofen,85,,8,11,19
059 Deutschnofen,86,,4,5,9
059 Deutschnofen,87,,4,8,12
059 Deutschnofen,88,,3,1,4
059 Deutschnofen,89,,4,10,14
059 Deutschnofen,90,,4,8,12
059 Deutschnofen,91,,2,4,6
059 Deutschnofen,92,,1,9,10
059 Deutschnofen,93,,-,5,5
059 Deutschnofen,94,,-,3,3
059 Deutschnofen,95,,-,3,3
059 Deutschnofen,96,,-,1,1
059 Deutschnofen,97,,-,2,2
060 Auer,0,,17,18,35
060 Auer,1,,20,16,36
060 Auer,2,,22,18,40
060 Auer,3,,20,31,51
060 Auer,4,,24,13,37
060 Auer,5,,20,12,32
060 Auer,6,,21,25,46
060 Auer,7,,27,15,42
060 Auer,8,,16,30,46
060 Auer,9,,11,24,35
060 Auer,10,,23,15,38
060 Auer,11,,18,17,35
060 Auer,12,,24,24,48
060 Auer,13,,20,22,42
060 Auer,14,,23,14,37
060 Auer,15,,32,18,50
060 Auer,16,,14,27,41
060 Auer,17,,22,18,40
060 Auer,18,,18,25,43
060 Auer,19,,25,23,48
060 Auer,20,,27,18,45
060 Auer,21,,21,20,41
060 Auer,22,,25,19,44
060 Auer,23,,25,26,51
060 Auer,24,,14,27,41
060 Auer,25,,23,27,50
060 Auer,26,,29,22,51
060 Auer,27,,21,19,40
060 Auer,28,,18,23,41
060 Auer,29,,24,34,58
060 Auer,30,,28,18,46
060 Auer,31,,24,19,43
060 Auer,32,,23,33,56
060 Auer,33,,24,22,46
060 Auer,34,,16,18,34
060 Auer,35,,29,25,54
060 Auer,36,,28,18,46
060 Auer,37,,20,19,39
060 Auer,38,,28,28,56
060 Auer,39,,21,23,44
060 Auer,40,,23,34,57
060 Auer,41,,22,30,52
060 Auer,42,,18,18,36
060 Auer,43,,33,30,63
060 Auer,44,,26,30,56
060 Auer,45,,14,30,44
060 Auer,46,,43,28,71
060 Auer,47,,29,28,57
060 Auer,48,,24,30,54
060 Auer,49,,34,41,75
060 Auer,50,,28,24,52
060 Auer,51,,35,41,76
060 Auer,52,,34,28,62
060 Auer,53,,28,24,52
060 Auer,54,,29,42,71
060 Auer,55,,27,23,50
060 Auer,56,,34,32,66
060 Auer,57,,27,30,57
060 Auer,58,,34,30,64
060 Auer,59,,37,24,61
060 Auer,60,,21,23,44
060 Auer,61,,29,28,57
060 Auer,62,,15,20,35
060 Auer,63,,20,15,35
060 Auer,64,,16,22,38
060 Auer,65,,18,23,41
060 Auer,66,,14,19,33
060 Auer,67,,14,19,33
060 Auer,68,,15,13,28
060 Auer,69,,25,15,40
060 Auer,70,,16,15,31
060 Auer,71,,14,24,38
060 Auer,72,,9,13,22
060 Auer,73,,22,14,36
060 Auer,74,,10,17,27
060 Auer,75,,15,19,34
060 Auer,76,,17,15,32
060 Auer,77,,10,8,18
060 Auer,78,,9,19,28
060 Auer,79,,13,16,29
060 Auer,80,,7,10,17
060 Auer,81,,8,8,16
060 Auer,82,,7,16,23
060 Auer,83,,10,12,22
060 Auer,84,,2,10,12
060 Auer,85,,1,9,10
060 Auer,86,,2,7,9
060 Auer,87,,3,5,8
060 Auer,88,,3,10,13
060 Auer,89,,3,5,8
060 Auer,90,,-,6,6
060 Auer,91,,-,12,12
060 Auer,92,,6,3,9
060 Auer,93,,3,5,8
060 Auer,94,,2,5,7
060 Auer,95,,1,4,5
060 Auer,96,,-,1,1
060 Auer,97,,1,1,2
060 Auer,104,,1,-,1
061 St.Ulrich,0,,28,26,54
061 St.Ulrich,1,,26,22,48
061 St.Ulrich,2,,26,18,44
061 St.Ulrich,3,,31,27,58
061 St.Ulrich,4,,18,23,41
061 St.Ulrich,5,,19,14,33
061 St.Ulrich,6,,35,31,66
061 St.Ulrich,7,,23,23,46
061 St.Ulrich,8,,23,25,48
061 St.Ulrich,9,,36,25,61
061 St.Ulrich,10,,30,35,65
061 St.Ulrich,11,,35,27,62
061 St.Ulrich,12,,34,23,57
061 St.Ulrich,13,,22,31,53
061 St.Ulrich,14,,23,26,49
061 St.Ulrich,15,,25,40,65
061 St.Ulrich,16,,21,22,43
061 St.Ulrich,17,,30,36,66
061 St.Ulrich,18,,44,31,75
061 St.Ulrich,19,,49,37,86
061 St.Ulrich,20,,40,29,69
061 St.Ulrich,21,,30,23,53
061 St.Ulrich,22,,30,30,60
061 St.Ulrich,23,,33,33,66
061 St.Ulrich,24,,27,35,62
061 St.Ulrich,25,,39,30,69
061 St.Ulrich,26,,33,35,68
061 St.Ulrich,27,,30,32,62
061 St.Ulrich,28,,20,20,40
061 St.Ulrich,29,,20,31,51
061 St.Ulrich,30,,32,19,51
061 St.Ulrich,31,,27,25,52
061 St.Ulrich,32,,22,20,42
061 St.Ulrich,33,,22,21,43
061 St.Ulrich,34,,24,26,50
061 St.Ulrich,35,,30,30,60
061 St.Ulrich,36,,28,36,64
061 St.Ulrich,37,,21,36,57
061 St.Ulrich,38,,26,36,62
061 St.Ulrich,39,,22,31,53
061 St.Ulrich,40,,25,22,47
061 St.Ulrich,41,,35,34,69
061 St.Ulrich,42,,35,25,60
061 St.Ulrich,43,,38,34,72
061 St.Ulrich,44,,39,34,73
061 St.Ulrich,45,,42,34,76
061 St.Ulrich,46,,40,40,80
061 St.Ulrich,47,,40,37,77
061 St.Ulrich,48,,40,45,85
061 St.Ulrich,49,,39,43,82
061 St.Ulrich,50,,41,39,80
061 St.Ulrich,51,,33,41,74
061 St.Ulrich,52,,38,31,69
061 St.Ulrich,53,,33,42,75
061 St.Ulrich,54,,37,35,72
061 St.Ulrich,55,,33,35,68
061 St.Ulrich,56,,25,28,53
061 St.Ulrich,57,,32,26,58
061 St.Ulrich,58,,37,23,60
061 St.Ulrich,59,,21,17,38
061 St.Ulrich,60,,23,32,55
061 St.Ulrich,61,,17,29,46
061 St.Ulrich,62,,23,36,59
061 St.Ulrich,63,,28,35,63
061 St.Ulrich,64,,27,19,46
061 St.Ulrich,65,,13,27,40
061 St.Ulrich,66,,26,25,51
061 St.Ulrich,67,,17,24,41
061 St.Ulrich,68,,16,27,43
061 St.Ulrich,69,,29,28,57
061 St.Ulrich,70,,17,23,40
061 St.Ulrich,71,,29,23,52
061 St.Ulrich,72,,15,16,31
061 St.Ulrich,73,,20,32,52
061 St.Ulrich,74,,36,35,71
061 St.Ulrich,75,,23,31,54
061 St.Ulrich,76,,29,40,69
061 St.Ulrich,77,,25,26,51
061 St.Ulrich,78,,16,17,33
061 St.Ulrich,79,,21,22,43
061 St.Ulrich,80,,20,21,41
061 St.Ulrich,81,,16,14,30
061 St.Ulrich,82,,9,19,28
061 St.Ulrich,83,,10,8,18
061 St.Ulrich,84,,8,11,19
061 St.Ulrich,85,,9,18,27
061 St.Ulrich,86,,11,12,23
061 St.Ulrich,87,,9,5,14
061 St.Ulrich,88,,7,3,10
061 St.Ulrich,89,,6,8,14
061 St.Ulrich,90,,5,5,10
061 St.Ulrich,91,,1,5,6
061 St.Ulrich,92,,2,1,3
061 St.Ulrich,93,,1,2,3
061 St.Ulrich,94,,-,5,5
061 St.Ulrich,95,,1,2,3
061 St.Ulrich,96,,2,2,4
061 St.Ulrich,97,,1,3,4
061 St.Ulrich,98,,-,1,1
061 St.Ulrich,99,,-,1,1
061 St.Ulrich,102,,-,1,1
062 Partschins,0,,17,13,30
062 Partschins,1,,14,31,45
062 Partschins,2,,23,16,39
062 Partschins,3,,24,17,41
062 Partschins,4,,16,21,37
062 Partschins,5,,29,16,45
062 Partschins,6,,18,16,34
062 Partschins,7,,24,21,45
062 Partschins,8,,18,15,33
062 Partschins,9,,23,13,36
062 Partschins,10,,16,19,35
062 Partschins,11,,19,19,38
062 Partschins,12,,17,25,42
062 Partschins,13,,16,24,40
062 Partschins,14,,27,16,43
062 Partschins,15,,24,16,40
062 Partschins,16,,16,14,30
062 Partschins,17,,22,18,40
062 Partschins,18,,19,21,40
062 Partschins,19,,22,11,33
062 Partschins,20,,25,23,48
062 Partschins,21,,14,20,34
062 Partschins,22,,24,14,38
062 Partschins,23,,22,23,45
062 Partschins,24,,27,23,50
062 Partschins,25,,23,16,39
062 Partschins,26,,26,35,61
062 Partschins,27,,24,24,48
062 Partschins,28,,11,29,40
062 Partschins,29,,22,30,52
062 Partschins,30,,15,19,34
062 Partschins,31,,24,21,45
062 Partschins,32,,14,16,30
062 Partschins,33,,20,25,45
062 Partschins,34,,14,22,36
062 Partschins,35,,14,24,38
062 Partschins,36,,23,33,56
062 Partschins,37,,31,28,59
062 Partschins,38,,25,25,50
062 Partschins,39,,23,13,36
062 Partschins,40,,27,25,52
062 Partschins,41,,22,19,41
062 Partschins,42,,31,21,52
062 Partschins,43,,23,23,46
062 Partschins,44,,34,28,62
062 Partschins,45,,29,25,54
062 Partschins,46,,31,36,67
062 Partschins,47,,27,38,65
062 Partschins,48,,38,24,62
062 Partschins,49,,26,32,58
062 Partschins,50,,35,25,60
062 Partschins,51,,37,43,80
062 Partschins,52,,34,28,62
062 Partschins,53,,29,41,70
062 Partschins,54,,32,23,55
062 Partschins,55,,33,25,58
062 Partschins,56,,22,25,47
062 Partschins,57,,26,42,68
062 Partschins,58,,29,25,54
062 Partschins,59,,20,19,39
062 Partschins,60,,23,25,48
062 Partschins,61,,22,17,39
062 Partschins,62,,26,22,48
062 Partschins,63,,12,30,42
062 Partschins,64,,19,16,35
062 Partschins,65,,17,15,32
062 Partschins,66,,19,17,36
062 Partschins,67,,18,20,38
062 Partschins,68,,11,10,21
062 Partschins,69,,18,18,36
062 Partschins,70,,13,18,31
062 Partschins,71,,24,26,50
062 Partschins,72,,13,15,28
062 Partschins,73,,15,14,29
062 Partschins,74,,19,23,42
062 Partschins,75,,14,16,30
062 Partschins,76,,18,28,46
062 Partschins,77,,12,14,26
062 Partschins,78,,8,13,21
062 Partschins,79,,14,10,24
062 Partschins,80,,11,13,24
062 Partschins,81,,11,17,28
062 Partschins,82,,6,7,13
062 Partschins,83,,6,15,21
062 Partschins,84,,5,13,18
062 Partschins,85,,11,10,21
062 Partschins,86,,7,13,20
062 Partschins,87,,4,5,9
062 Partschins,88,,5,5,10
062 Partschins,89,,5,5,10
062 Partschins,90,,5,7,12
062 Partschins,91,,2,5,7
062 Partschins,92,,2,6,8
062 Partschins,93,,1,6,7
062 Partschins,94,,2,2,4
062 Partschins,95,,2,2,4
062 Partschins,96,,1,2,3
062 Partschins,98,,-,1,1
063 Percha,0,,7,13,20
063 Percha,1,,12,7,19
063 Percha,2,,11,5,16
063 Percha,3,,13,9,22
063 Percha,4,,13,15,28
063 Percha,5,,8,6,14
063 Percha,6,,7,7,14
063 Percha,7,,5,10,15
063 Percha,8,,12,9,21
063 Percha,9,,9,5,14
063 Percha,10,,10,5,15
063 Percha,11,,6,4,10
063 Percha,12,,5,10,15
063 Percha,13,,9,17,26
063 Percha,14,,9,8,17
063 Percha,15,,10,7,17
063 Percha,16,,4,5,9
063 Percha,17,,14,10,24
063 Percha,18,,6,8,14
063 Percha,19,,8,10,18
063 Percha,20,,12,15,27
063 Percha,21,,9,6,15
063 Percha,22,,9,8,17
063 Percha,23,,11,12,23
063 Percha,24,,8,10,18
063 Percha,25,,12,9,21
063 Percha,26,,10,10,20
063 Percha,27,,5,10,15
063 Percha,28,,7,9,16
063 Percha,29,,5,4,9
063 Percha,30,,13,17,30
063 Percha,31,,5,6,11
063 Percha,32,,6,11,17
063 Percha,33,,10,7,17
063 Percha,34,,13,10,23
063 Percha,35,,9,16,25
063 Percha,36,,13,13,26
063 Percha,37,,10,4,14
063 Percha,38,,6,11,17
063 Percha,39,,12,14,26
063 Percha,40,,11,5,16
063 Percha,41,,13,19,32
063 Percha,42,,8,13,21
063 Percha,43,,9,12,21
063 Percha,44,,15,12,27
063 Percha,45,,15,9,24
063 Percha,46,,20,17,37
063 Percha,47,,8,9,17
063 Percha,48,,22,14,36
063 Percha,49,,19,16,35
063 Percha,50,,9,11,20
063 Percha,51,,20,6,26
063 Percha,52,,14,18,32
063 Percha,53,,16,8,24
063 Percha,54,,11,14,25
063 Percha,55,,18,10,28
063 Percha,56,,8,12,20
063 Percha,57,,12,7,19
063 Percha,58,,7,11,18
063 Percha,59,,9,8,17
063 Percha,60,,8,6,14
063 Percha,61,,6,13,19
063 Percha,62,,9,9,18
063 Percha,63,,5,6,11
063 Percha,64,,7,7,14
063 Percha,65,,5,10,15
063 Percha,66,,6,7,13
063 Percha,67,,6,7,13
063 Percha,68,,10,5,15
063 Percha,69,,5,5,10
063 Percha,70,,6,5,11
063 Percha,71,,7,8,15
063 Percha,72,,5,5,10
063 Percha,73,,12,5,17
063 Percha,74,,5,8,13
063 Percha,75,,7,6,13
063 Percha,76,,6,7,13
063 Percha,77,,4,6,10
063 Percha,78,,6,4,10
063 Percha,79,,5,7,12
063 Percha,80,,2,4,6
063 Percha,81,,2,1,3
063 Percha,82,,4,5,9
063 Percha,83,,4,3,7
063 Percha,84,,-,4,4
063 Percha,85,,2,3,5
063 Percha,86,,2,-,2
063 Percha,87,,2,2,4
063 Percha,88,,-,3,3
063 Percha,89,,-,1,1
063 Percha,90,,1,1,2
063 Percha,91,,1,4,5
063 Percha,92,,1,1,2
063 Percha,94,,-,1,1
064 Plaus,0,,-,6,6
064 Plaus,1,,4,5,9
064 Plaus,2,,3,3,6
064 Plaus,3,,1,3,4
064 Plaus,4,,4,3,7
064 Plaus,5,,2,4,6
064 Plaus,6,,4,1,5
064 Plaus,7,,5,6,11
064 Plaus,8,,4,2,6
064 Plaus,9,,4,4,8
064 Plaus,10,,5,2,7
064 Plaus,11,,4,2,6
064 Plaus,12,,4,1,5
064 Plaus,13,,6,4,10
064 Plaus,14,,3,4,7
064 Plaus,15,,3,5,8
064 Plaus,16,,8,3,11
064 Plaus,17,,11,5,16
064 Plaus,18,,13,5,18
064 Plaus,19,,6,8,14
064 Plaus,20,,8,4,12
064 Plaus,21,,3,3,6
064 Plaus,22,,3,2,5
064 Plaus,23,,5,2,7
064 Plaus,24,,9,4,13
064 Plaus,25,,7,7,14
064 Plaus,26,,5,9,14
064 Plaus,27,,6,1,7
064 Plaus,28,,7,6,13
064 Plaus,29,,3,3,6
064 Plaus,30,,7,4,11
064 Plaus,31,,1,4,5
064 Plaus,32,,5,5,10
064 Plaus,33,,4,3,7
064 Plaus,34,,3,2,5
064 Plaus,35,,-,5,5
064 Plaus,36,,4,6,10
064 Plaus,37,,4,3,7
064 Plaus,38,,4,9,13
064 Plaus,39,,4,3,7
064 Plaus,40,,3,8,11
064 Plaus,41,,5,4,9
064 Plaus,42,,12,4,16
064 Plaus,43,,8,11,19
064 Plaus,44,,11,5,16
064 Plaus,45,,9,5,14
064 Plaus,46,,6,8,14
064 Plaus,47,,7,4,11
064 Plaus,48,,5,10,15
064 Plaus,49,,4,7,11
064 Plaus,50,,7,9,16
064 Plaus,51,,4,5,9
064 Plaus,52,,10,4,14
064 Plaus,53,,7,9,16
064 Plaus,54,,2,4,6
064 Plaus,55,,7,5,12
064 Plaus,56,,6,6,12
064 Plaus,57,,3,7,10
064 Plaus,58,,6,-,6
064 Plaus,59,,4,3,7
064 Plaus,60,,4,1,5
064 Plaus,61,,2,2,4
064 Plaus,62,,1,5,6
064 Plaus,63,,1,3,4
064 Plaus,64,,2,5,7
064 Plaus,65,,4,2,6
064 Plaus,66,,4,3,7
064 Plaus,67,,2,1,3
064 Plaus,68,,4,3,7
064 Plaus,69,,-,3,3
064 Plaus,70,,2,3,5
064 Plaus,71,,5,1,6
064 Plaus,72,,3,1,4
064 Plaus,73,,1,2,3
064 Plaus,74,,5,1,6
064 Plaus,75,,-,5,5
064 Plaus,76,,3,2,5
064 Plaus,77,,3,1,4
064 Plaus,78,,3,2,5
064 Plaus,80,,1,3,4
064 Plaus,82,,1,3,4
064 Plaus,83,,4,1,5
064 Plaus,84,,2,2,4
064 Plaus,85,,3,3,6
064 Plaus,89,,-,1,1
064 Plaus,90,,1,1,2
064 Plaus,98,,-,1,1
065 Waidbruck,0,,1,1,2
065 Waidbruck,1,,1,-,1
065 Waidbruck,2,,1,1,2
065 Waidbruck,3,,1,-,1
065 Waidbruck,4,,1,-,1
065 Waidbruck,5,,1,1,2
065 Waidbruck,6,,1,-,1
065 Waidbruck,7,,-,1,1
065 Waidbruck,8,,2,2,4
065 Waidbruck,9,,2,-,2
065 Waidbruck,10,,2,-,2
065 Waidbruck,11,,2,-,2
065 Waidbruck,13,,1,1,2
065 Waidbruck,14,,-,2,2
065 Waidbruck,15,,1,1,2
065 Waidbruck,16,,1,2,3
065 Waidbruck,17,,1,1,2
065 Waidbruck,18,,2,1,3
065 Waidbruck,19,,1,-,1
065 Waidbruck,20,,4,3,7
065 Waidbruck,21,,4,1,5
065 Waidbruck,22,,2,2,4
065 Waidbruck,23,,4,1,5
065 Waidbruck,24,,-,3,3
065 Waidbruck,25,,-,2,2
065 Waidbruck,26,,1,1,2
065 Waidbruck,27,,1,1,2
065 Waidbruck,28,,3,1,4
065 Waidbruck,29,,2,1,3
065 Waidbruck,31,,1,1,2
065 Waidbruck,32,,2,-,2
065 Waidbruck,33,,2,-,2
065 Waidbruck,36,,2,-,2
065 Waidbruck,37,,2,1,3
065 Waidbruck,38,,1,-,1
065 Waidbruck,39,,5,-,5
065 Waidbruck,40,,-,1,1
065 Waidbruck,41,,-,1,1
065 Waidbruck,42,,2,2,4
065 Waidbruck,43,,3,2,5
065 Waidbruck,44,,2,1,3
065 Waidbruck,45,,1,2,3
065 Waidbruck,46,,2,-,2
065 Waidbruck,47,,2,1,3
065 Waidbruck,48,,3,3,6
065 Waidbruck,49,,2,2,4
065 Waidbruck,50,,2,4,6
065 Waidbruck,51,,3,2,5
065 Waidbruck,52,,2,2,4
065 Waidbruck,53,,2,-,2
065 Waidbruck,54,,-,1,1
065 Waidbruck,55,,2,-,2
065 Waidbruck,56,,1,2,3
065 Waidbruck,57,,3,-,3
065 Waidbruck,58,,2,1,3
065 Waidbruck,59,,-,1,1
065 Waidbruck,60,,1,1,2
065 Waidbruck,61,,2,-,2
065 Waidbruck,62,,3,-,3
065 Waidbruck,65,,1,-,1
065 Waidbruck,66,,-,1,1
065 Waidbruck,69,,1,-,1
065 Waidbruck,71,,-,3,3
065 Waidbruck,72,,1,1,2
065 Waidbruck,73,,2,1,3
065 Waidbruck,74,,-,1,1
065 Waidbruck,75,,1,1,2
065 Waidbruck,76,,-,1,1
065 Waidbruck,77,,1,2,3
065 Waidbruck,78,,1,-,1
065 Waidbruck,79,,-,2,2
065 Waidbruck,80,,1,-,1
065 Waidbruck,81,,1,1,2
065 Waidbruck,82,,-,2,2
065 Waidbruck,83,,-,1,1
065 Waidbruck,85,,-,2,2
065 Waidbruck,86,,1,-,1
065 Waidbruck,88,,-,1,1
065 Waidbruck,89,,1,-,1
065 Waidbruck,90,,1,1,2
065 Waidbruck,91,,-,1,1
065 Waidbruck,92,,1,-,1
066 Burgstall,0,,10,6,16
066 Burgstall,1,,14,6,20
066 Burgstall,2,,10,13,23
066 Burgstall,3,,7,7,14
066 Burgstall,4,,13,16,29
066 Burgstall,5,,7,7,14
066 Burgstall,6,,10,15,25
066 Burgstall,7,,10,14,24
066 Burgstall,8,,14,7,21
066 Burgstall,9,,11,14,25
066 Burgstall,10,,9,8,17
066 Burgstall,11,,10,9,19
066 Burgstall,12,,6,7,13
066 Burgstall,13,,14,9,23
066 Burgstall,14,,9,9,18
066 Burgstall,15,,6,12,18
066 Burgstall,16,,10,9,19
066 Burgstall,17,,11,11,22
066 Burgstall,18,,11,10,21
066 Burgstall,19,,9,10,19
066 Burgstall,20,,15,6,21
066 Burgstall,21,,9,7,16
066 Burgstall,22,,11,7,18
066 Burgstall,23,,7,6,13
066 Burgstall,24,,8,9,17
066 Burgstall,25,,9,6,15
066 Burgstall,26,,8,12,20
066 Burgstall,27,,11,12,23
066 Burgstall,28,,10,9,19
066 Burgstall,29,,10,16,26
066 Burgstall,30,,11,10,21
066 Burgstall,31,,7,7,14
066 Burgstall,32,,11,16,27
066 Burgstall,33,,8,16,24
066 Burgstall,34,,11,15,26
066 Burgstall,35,,9,15,24
066 Burgstall,36,,13,7,20
066 Burgstall,37,,14,9,23
066 Burgstall,38,,15,10,25
066 Burgstall,39,,11,14,25
066 Burgstall,40,,9,20,29
066 Burgstall,41,,8,11,19
066 Burgstall,42,,20,15,35
066 Burgstall,43,,7,17,24
066 Burgstall,44,,12,20,32
066 Burgstall,45,,14,22,36
066 Burgstall,46,,14,12,26
066 Burgstall,47,,20,17,37
066 Burgstall,48,,18,13,31
066 Burgstall,49,,19,19,38
066 Burgstall,50,,15,16,31
066 Burgstall,51,,15,18,33
066 Burgstall,52,,19,18,37
066 Burgstall,53,,17,13,30
066 Burgstall,54,,18,15,33
066 Burgstall,55,,19,12,31
066 Burgstall,56,,16,22,38
066 Burgstall,57,,16,13,29
066 Burgstall,58,,11,7,18
066 Burgstall,59,,16,11,27
066 Burgstall,60,,11,11,22
066 Burgstall,61,,13,11,24
066 Burgstall,62,,7,13,20
066 Burgstall,63,,10,15,25
066 Burgstall,64,,9,11,20
066 Burgstall,65,,14,11,25
066 Burgstall,66,,13,6,19
066 Burgstall,67,,9,10,19
066 Burgstall,68,,9,8,17
066 Burgstall,69,,6,11,17
066 Burgstall,70,,7,9,16
066 Burgstall,71,,8,9,17
066 Burgstall,72,,7,7,14
066 Burgstall,73,,8,9,17
066 Burgstall,74,,9,8,17
066 Burgstall,75,,5,5,10
066 Burgstall,76,,5,6,11
066 Burgstall,77,,4,12,16
066 Burgstall,78,,5,8,13
066 Burgstall,79,,9,12,21
066 Burgstall,80,,4,7,11
066 Burgstall,81,,4,6,10
066 Burgstall,82,,6,3,9
066 Burgstall,83,,2,7,9
066 Burgstall,84,,4,3,7
066 Burgstall,85,,2,4,6
066 Burgstall,86,,4,2,6
066 Burgstall,87,,2,4,6
066 Burgstall,88,,-,2,2
066 Burgstall,89,,3,3,6
066 Burgstall,90,,1,6,7
066 Burgstall,91,,3,5,8
066 Burgstall,92,,1,1,2
066 Burgstall,93,,-,2,2
066 Burgstall,95,,-,2,2
066 Burgstall,97,,1,-,1
066 Burgstall,99,,-,1,1
067 Prad am Stilfser Joch,0,,19,24,43
067 Prad am Stilfser Joch,1,,29,20,49
067 Prad am Stilfser Joch,2,,27,25,52
067 Prad am Stilfser Joch,3,,26,33,59
067 Prad am Stilfser Joch,4,,8,15,23
067 Prad am Stilfser Joch,5,,16,18,34
067 Prad am Stilfser Joch,6,,18,14,32
067 Prad am Stilfser Joch,7,,21,10,31
067 Prad am Stilfser Joch,8,,17,11,28
067 Prad am Stilfser Joch,9,,14,18,32
067 Prad am Stilfser Joch,10,,15,11,26
067 Prad am Stilfser Joch,11,,16,20,36
067 Prad am Stilfser Joch,12,,23,14,37
067 Prad am Stilfser Joch,13,,20,21,41
067 Prad am Stilfser Joch,14,,19,14,33
067 Prad am Stilfser Joch,15,,14,17,31
067 Prad am Stilfser Joch,16,,26,19,45
067 Prad am Stilfser Joch,17,,18,18,36
067 Prad am Stilfser Joch,18,,19,21,40
067 Prad am Stilfser Joch,19,,19,23,42
067 Prad am Stilfser Joch,20,,29,18,47
067 Prad am Stilfser Joch,21,,24,20,44
067 Prad am Stilfser Joch,22,,22,16,38
067 Prad am Stilfser Joch,23,,22,28,50
067 Prad am Stilfser Joch,24,,26,30,56
067 Prad am Stilfser Joch,25,,22,26,48
067 Prad am Stilfser Joch,26,,21,18,39
067 Prad am Stilfser Joch,27,,22,24,46
067 Prad am Stilfser Joch,28,,20,22,42
067 Prad am Stilfser Joch,29,,27,15,42
067 Prad am Stilfser Joch,30,,21,23,44
067 Prad am Stilfser Joch,31,,25,34,59
067 Prad am Stilfser Joch,32,,29,20,49
067 Prad am Stilfser Joch,33,,26,33,59
067 Prad am Stilfser Joch,34,,26,26,52
067 Prad am Stilfser Joch,35,,29,18,47
067 Prad am Stilfser Joch,36,,25,22,47
067 Prad am Stilfser Joch,37,,26,22,48
067 Prad am Stilfser Joch,38,,21,22,43
067 Prad am Stilfser Joch,39,,22,23,45
067 Prad am Stilfser Joch,40,,25,26,51
067 Prad am Stilfser Joch,41,,27,23,50
067 Prad am Stilfser Joch,42,,21,23,44
067 Prad am Stilfser Joch,43,,28,17,45
067 Prad am Stilfser Joch,44,,25,42,67
067 Prad am Stilfser Joch,45,,22,25,47
067 Prad am Stilfser Joch,46,,24,26,50
067 Prad am Stilfser Joch,47,,23,23,46
067 Prad am Stilfser Joch,48,,31,34,65
067 Prad am Stilfser Joch,49,,37,36,73
067 Prad am Stilfser Joch,50,,30,23,53
067 Prad am Stilfser Joch,51,,33,27,60
067 Prad am Stilfser Joch,52,,35,28,63
067 Prad am Stilfser Joch,53,,25,29,54
067 Prad am Stilfser Joch,54,,27,12,39
067 Prad am Stilfser Joch,55,,29,34,63
067 Prad am Stilfser Joch,56,,22,25,47
067 Prad am Stilfser Joch,57,,21,26,47
067 Prad am Stilfser Joch,58,,35,18,53
067 Prad am Stilfser Joch,59,,20,27,47
067 Prad am Stilfser Joch,60,,24,23,47
067 Prad am Stilfser Joch,61,,25,23,48
067 Prad am Stilfser Joch,62,,23,18,41
067 Prad am Stilfser Joch,63,,25,18,43
067 Prad am Stilfser Joch,64,,28,17,45
067 Prad am Stilfser Joch,65,,13,19,32
067 Prad am Stilfser Joch,66,,16,23,39
067 Prad am Stilfser Joch,67,,16,17,33
067 Prad am Stilfser Joch,68,,17,21,38
067 Prad am Stilfser Joch,69,,17,12,29
067 Prad am Stilfser Joch,70,,14,11,25
067 Prad am Stilfser Joch,71,,10,14,24
067 Prad am Stilfser Joch,72,,13,9,22
067 Prad am Stilfser Joch,73,,9,14,23
067 Prad am Stilfser Joch,74,,21,19,40
067 Prad am Stilfser Joch,75,,11,16,27
067 Prad am Stilfser Joch,76,,24,8,32
067 Prad am Stilfser Joch,77,,7,15,22
067 Prad am Stilfser Joch,78,,11,16,27
067 Prad am Stilfser Joch,79,,14,11,25
067 Prad am Stilfser Joch,80,,5,8,13
067 Prad am Stilfser Joch,81,,7,8,15
067 Prad am Stilfser Joch,82,,11,12,23
067 Prad am Stilfser Joch,83,,6,20,26
067 Prad am Stilfser Joch,84,,8,9,17
067 Prad am Stilfser Joch,85,,4,15,19
067 Prad am Stilfser Joch,86,,5,8,13
067 Prad am Stilfser Joch,87,,5,7,12
067 Prad am Stilfser Joch,88,,2,10,12
067 Prad am Stilfser Joch,89,,2,5,7
067 Prad am Stilfser Joch,90,,3,6,9
067 Prad am Stilfser Joch,91,,1,-,1
067 Prad am Stilfser Joch,92,,4,-,4
067 Prad am Stilfser Joch,93,,1,3,4
067 Prad am Stilfser Joch,94,,1,5,6
067 Prad am Stilfser Joch,95,,-,3,3
067 Prad am Stilfser Joch,97,,-,1,1
067 Prad am Stilfser Joch,98,,-,1,1
067 Prad am Stilfser Joch,101,,-,1,1
068 Prettau,0,,2,1,3
068 Prettau,1,,2,-,2
068 Prettau,2,,-,2,2
068 Prettau,3,,1,1,2
068 Prettau,4,,1,2,3
068 Prettau,5,,1,-,1
068 Prettau,6,,4,3,7
068 Prettau,7,,1,1,2
068 Prettau,8,,1,1,2
068 Prettau,9,,7,3,10
068 Prettau,10,,5,2,7
068 Prettau,11,,5,7,12
068 Prettau,12,,2,1,3
068 Prettau,13,,4,5,9
068 Prettau,14,,2,4,6
068 Prettau,15,,1,2,3
068 Prettau,16,,3,5,8
068 Prettau,17,,1,3,4
068 Prettau,18,,5,6,11
068 Prettau,19,,5,3,8
068 Prettau,20,,2,4,6
068 Prettau,21,,1,2,3
068 Prettau,22,,4,4,8
068 Prettau,23,,3,7,10
068 Prettau,24,,2,5,7
068 Prettau,25,,2,3,5
068 Prettau,26,,1,3,4
068 Prettau,27,,1,5,6
068 Prettau,28,,1,1,2
068 Prettau,29,,4,2,6
068 Prettau,30,,5,1,6
068 Prettau,31,,1,3,4
068 Prettau,32,,-,1,1
068 Prettau,33,,3,5,8
068 Prettau,34,,3,1,4
068 Prettau,35,,2,4,6
068 Prettau,36,,3,-,3
068 Prettau,37,,2,5,7
068 Prettau,38,,5,3,8
068 Prettau,39,,1,2,3
068 Prettau,40,,3,2,5
068 Prettau,41,,3,2,5
068 Prettau,42,,3,1,4
068 Prettau,43,,4,1,5
068 Prettau,44,,5,5,10
068 Prettau,45,,9,3,12
068 Prettau,46,,4,6,10
068 Prettau,47,,3,6,9
068 Prettau,48,,5,5,10
068 Prettau,49,,3,1,4
068 Prettau,50,,10,2,12
068 Prettau,51,,5,-,5
068 Prettau,52,,3,7,10
068 Prettau,53,,5,6,11
068 Prettau,54,,4,5,9
068 Prettau,55,,2,5,7
068 Prettau,56,,5,6,11
068 Prettau,57,,6,4,10
068 Prettau,58,,5,2,7
068 Prettau,59,,7,-,7
068 Prettau,60,,2,1,3
068 Prettau,61,,5,5,10
068 Prettau,62,,6,4,10
068 Prettau,63,,4,2,6
068 Prettau,64,,3,3,6
068 Prettau,65,,4,3,7
068 Prettau,66,,2,2,4
068 Prettau,67,,2,2,4
068 Prettau,68,,2,3,5
068 Prettau,69,,2,1,3
068 Prettau,70,,4,5,9
068 Prettau,71,,6,2,8
068 Prettau,72,,1,2,3
068 Prettau,73,,6,5,11
068 Prettau,74,,3,3,6
068 Prettau,75,,3,2,5
068 Prettau,76,,3,2,5
068 Prettau,77,,4,3,7
068 Prettau,78,,4,3,7
068 Prettau,79,,5,5,10
068 Prettau,80,,2,5,7
068 Prettau,81,,3,3,6
068 Prettau,82,,2,-,2
068 Prettau,83,,-,3,3
068 Prettau,84,,2,3,5
068 Prettau,85,,1,-,1
068 Prettau,86,,1,1,2
068 Prettau,87,,3,2,5
068 Prettau,88,,2,5,7
068 Prettau,89,,-,1,1
068 Prettau,90,,1,-,1
068 Prettau,92,,-,1,1
068 Prettau,94,,-,1,1
068 Prettau,99,,-,1,1
069 Proveis,0,,-,3,3
069 Proveis,1,,2,1,3
069 Proveis,2,,1,-,1
069 Proveis,3,,2,2,4
069 Proveis,4,,2,1,3
069 Proveis,5,,1,2,3
069 Proveis,6,,-,2,2
069 Proveis,7,,2,1,3
069 Proveis,8,,3,1,4
069 Proveis,9,,-,1,1
069 Proveis,10,,1,1,2
069 Proveis,11,,1,-,1
069 Proveis,12,,-,4,4
069 Proveis,13,,3,2,5
069 Proveis,14,,2,1,3
069 Proveis,15,,4,-,4
069 Proveis,16,,1,1,2
069 Proveis,17,,-,1,1
069 Proveis,18,,4,-,4
069 Proveis,19,,2,2,4
069 Proveis,20,,2,2,4
069 Proveis,21,,2,1,3
069 Proveis,22,,-,4,4
069 Proveis,23,,3,1,4
069 Proveis,24,,3,1,4
069 Proveis,25,,4,2,6
069 Proveis,26,,5,2,7
069 Proveis,27,,1,1,2
069 Proveis,28,,1,1,2
069 Proveis,29,,2,1,3
069 Proveis,30,,1,4,5
069 Proveis,31,,2,-,2
069 Proveis,32,,5,-,5
069 Proveis,33,,3,2,5
069 Proveis,34,,2,-,2
069 Proveis,35,,2,-,2
069 Proveis,36,,2,3,5
069 Proveis,38,,2,-,2
069 Proveis,39,,2,3,5
069 Proveis,40,,2,1,3
069 Proveis,41,,1,1,2
069 Proveis,42,,2,-,2
069 Proveis,43,,3,2,5
069 Proveis,44,,2,-,2
069 Proveis,45,,-,1,1
069 Proveis,46,,-,1,1
069 Proveis,47,,3,3,6
069 Proveis,48,,3,3,6
069 Proveis,49,,4,1,5
069 Proveis,50,,3,1,4
069 Proveis,51,,2,3,5
069 Proveis,52,,1,2,3
069 Proveis,53,,3,1,4
069 Proveis,54,,4,2,6
069 Proveis,55,,2,2,4
069 Proveis,56,,3,1,4
069 Proveis,57,,1,4,5
069 Proveis,58,,4,-,4
069 Proveis,59,,1,3,4
069 Proveis,60,,2,2,4
069 Proveis,61,,4,2,6
069 Proveis,62,,4,4,8
069 Proveis,63,,2,2,4
069 Proveis,64,,1,1,2
069 Proveis,65,,1,3,4
069 Proveis,66,,2,-,2
069 Proveis,67,,1,1,2
069 Proveis,68,,1,-,1
069 Proveis,69,,2,-,2
069 Proveis,70,,1,2,3
069 Proveis,71,,2,-,2
069 Proveis,72,,1,-,1
069 Proveis,73,,1,-,1
069 Proveis,74,,1,1,2
069 Proveis,75,,1,1,2
069 Proveis,76,,1,1,2
069 Proveis,77,,2,-,2
069 Proveis,78,,-,3,3
069 Proveis,79,,-,2,2
069 Proveis,80,,1,1,2
069 Proveis,81,,-,1,1
069 Proveis,86,,1,-,1
069 Proveis,89,,2,-,2
069 Proveis,90,,-,1,1
070 Ratschings,0,,28,21,49
070 Ratschings,1,,23,35,58
070 Ratschings,2,,24,23,47
070 Ratschings,3,,28,25,53
070 Ratschings,4,,22,28,50
070 Ratschings,5,,28,28,56
070 Ratschings,6,,15,23,38
070 Ratschings,7,,27,27,54
070 Ratschings,8,,22,21,43
070 Ratschings,9,,21,16,37
070 Ratschings,10,,28,25,53
070 Ratschings,11,,25,23,48
070 Ratschings,12,,22,26,48
070 Ratschings,13,,34,27,61
070 Ratschings,14,,34,22,56
070 Ratschings,15,,17,27,44
070 Ratschings,16,,26,33,59
070 Ratschings,17,,34,25,59
070 Ratschings,18,,30,22,52
070 Ratschings,19,,34,21,55
070 Ratschings,20,,34,37,71
070 Ratschings,21,,29,30,59
070 Ratschings,22,,28,26,54
070 Ratschings,23,,24,24,48
070 Ratschings,24,,25,20,45
070 Ratschings,25,,35,36,71
070 Ratschings,26,,24,24,48
070 Ratschings,27,,31,27,58
070 Ratschings,28,,30,20,50
070 Ratschings,29,,36,23,59
070 Ratschings,30,,25,21,46
070 Ratschings,31,,29,28,57
070 Ratschings,32,,30,42,72
070 Ratschings,33,,32,20,52
070 Ratschings,34,,35,24,59
070 Ratschings,35,,36,29,65
070 Ratschings,36,,31,32,63
070 Ratschings,37,,27,30,57
070 Ratschings,38,,30,28,58
070 Ratschings,39,,31,22,53
070 Ratschings,40,,31,28,59
070 Ratschings,41,,21,23,44
070 Ratschings,42,,37,35,72
070 Ratschings,43,,34,24,58
070 Ratschings,44,,35,34,69
070 Ratschings,45,,37,37,74
070 Ratschings,46,,40,36,76
070 Ratschings,47,,31,42,73
070 Ratschings,48,,36,45,81
070 Ratschings,49,,51,46,97
070 Ratschings,50,,33,36,69
070 Ratschings,51,,43,48,91
070 Ratschings,52,,34,44,78
070 Ratschings,53,,48,42,90
070 Ratschings,54,,46,26,72
070 Ratschings,55,,34,40,74
070 Ratschings,56,,35,27,62
070 Ratschings,57,,39,25,64
070 Ratschings,58,,43,23,66
070 Ratschings,59,,25,27,52
070 Ratschings,60,,27,19,46
070 Ratschings,61,,40,19,59
070 Ratschings,62,,14,32,46
070 Ratschings,63,,24,16,40
070 Ratschings,64,,22,24,46
070 Ratschings,65,,17,20,37
070 Ratschings,66,,19,15,34
070 Ratschings,67,,22,20,42
070 Ratschings,68,,18,24,42
070 Ratschings,69,,28,18,46
070 Ratschings,70,,14,16,30
070 Ratschings,71,,21,5,26
070 Ratschings,72,,17,18,35
070 Ratschings,73,,13,10,23
070 Ratschings,74,,14,13,27
070 Ratschings,75,,14,15,29
070 Ratschings,76,,17,14,31
070 Ratschings,77,,14,15,29
070 Ratschings,78,,9,15,24
070 Ratschings,79,,12,14,26
070 Ratschings,80,,11,8,19
070 Ratschings,81,,5,10,15
070 Ratschings,82,,7,12,19
070 Ratschings,83,,7,6,13
070 Ratschings,84,,9,14,23
070 Ratschings,85,,5,8,13
070 Ratschings,86,,2,8,10
070 Ratschings,87,,3,7,10
070 Ratschings,88,,4,10,14
070 Ratschings,89,,3,4,7
070 Ratschings,90,,2,6,8
070 Ratschings,91,,3,3,6
070 Ratschings,92,,2,2,4
070 Ratschings,93,,1,1,2
070 Ratschings,94,,-,1,1
070 Ratschings,95,,1,1,2
070 Ratschings,96,,-,1,1
071 Rasen-Antholz,0,,18,16,34
071 Rasen-Antholz,1,,15,11,26
071 Rasen-Antholz,2,,16,19,35
071 Rasen-Antholz,3,,10,17,27
071 Rasen-Antholz,4,,14,9,23
071 Rasen-Antholz,5,,10,21,31
071 Rasen-Antholz,6,,18,19,37
071 Rasen-Antholz,7,,11,8,19
071 Rasen-Antholz,8,,15,16,31
071 Rasen-Antholz,9,,21,8,29
071 Rasen-Antholz,10,,19,17,36
071 Rasen-Antholz,11,,15,21,36
071 Rasen-Antholz,12,,25,17,42
071 Rasen-Antholz,13,,15,21,36
071 Rasen-Antholz,14,,11,23,34
071 Rasen-Antholz,15,,13,19,32
071 Rasen-Antholz,16,,20,22,42
071 Rasen-Antholz,17,,24,23,47
071 Rasen-Antholz,18,,13,18,31
071 Rasen-Antholz,19,,20,17,37
071 Rasen-Antholz,20,,25,24,49
071 Rasen-Antholz,21,,26,19,45
071 Rasen-Antholz,22,,8,16,24
071 Rasen-Antholz,23,,22,10,32
071 Rasen-Antholz,24,,18,14,32
071 Rasen-Antholz,25,,22,19,41
071 Rasen-Antholz,26,,15,18,33
071 Rasen-Antholz,27,,13,20,33
071 Rasen-Antholz,28,,16,16,32
071 Rasen-Antholz,29,,19,14,33
071 Rasen-Antholz,30,,28,12,40
071 Rasen-Antholz,31,,13,20,33
071 Rasen-Antholz,32,,21,11,32
071 Rasen-Antholz,33,,20,23,43
071 Rasen-Antholz,34,,12,22,34
071 Rasen-Antholz,35,,18,19,37
071 Rasen-Antholz,36,,21,13,34
071 Rasen-Antholz,37,,15,11,26
071 Rasen-Antholz,38,,17,24,41
071 Rasen-Antholz,39,,18,22,40
071 Rasen-Antholz,40,,9,13,22
071 Rasen-Antholz,41,,25,13,38
071 Rasen-Antholz,42,,19,21,40
071 Rasen-Antholz,43,,24,20,44
071 Rasen-Antholz,44,,27,24,51
071 Rasen-Antholz,45,,19,21,40
071 Rasen-Antholz,46,,28,23,51
071 Rasen-Antholz,47,,23,26,49
071 Rasen-Antholz,48,,23,25,48
071 Rasen-Antholz,49,,26,28,54
071 Rasen-Antholz,50,,25,30,55
071 Rasen-Antholz,51,,28,20,48
071 Rasen-Antholz,52,,29,25,54
071 Rasen-Antholz,53,,28,23,51
071 Rasen-Antholz,54,,17,22,39
071 Rasen-Antholz,55,,27,20,47
071 Rasen-Antholz,56,,18,24,42
071 Rasen-Antholz,57,,23,25,48
071 Rasen-Antholz,58,,27,17,44
071 Rasen-Antholz,59,,24,16,40
071 Rasen-Antholz,60,,20,9,29
071 Rasen-Antholz,61,,20,14,34
071 Rasen-Antholz,62,,18,15,33
071 Rasen-Antholz,63,,15,15,30
071 Rasen-Antholz,64,,14,9,23
071 Rasen-Antholz,65,,9,14,23
071 Rasen-Antholz,66,,11,11,22
071 Rasen-Antholz,67,,11,9,20
071 Rasen-Antholz,68,,14,10,24
071 Rasen-Antholz,69,,14,10,24
071 Rasen-Antholz,70,,12,14,26
071 Rasen-Antholz,71,,9,14,23
071 Rasen-Antholz,72,,10,8,18
071 Rasen-Antholz,73,,8,8,16
071 Rasen-Antholz,74,,13,11,24
071 Rasen-Antholz,75,,8,12,20
071 Rasen-Antholz,76,,14,12,26
071 Rasen-Antholz,77,,8,16,24
071 Rasen-Antholz,78,,14,12,26
071 Rasen-Antholz,79,,9,7,16
071 Rasen-Antholz,80,,6,9,15
071 Rasen-Antholz,81,,8,10,18
071 Rasen-Antholz,82,,5,7,12
071 Rasen-Antholz,83,,7,7,14
071 Rasen-Antholz,84,,4,11,15
071 Rasen-Antholz,85,,5,8,13
071 Rasen-Antholz,86,,5,11,16
071 Rasen-Antholz,87,,4,5,9
071 Rasen-Antholz,88,,5,3,8
071 Rasen-Antholz,89,,-,4,4
071 Rasen-Antholz,90,,3,1,4
071 Rasen-Antholz,91,,1,3,4
071 Rasen-Antholz,92,,2,2,4
071 Rasen-Antholz,93,,2,1,3
071 Rasen-Antholz,94,,-,4,4
071 Rasen-Antholz,95,,1,-,1
072 Ritten,0,,46,42,88
072 Ritten,1,,42,48,90
072 Ritten,2,,43,46,89
072 Ritten,3,,40,32,72
072 Ritten,4,,38,42,80
072 Ritten,5,,43,45,88
072 Ritten,6,,43,41,84
072 Ritten,7,,48,42,90
072 Ritten,8,,43,44,87
072 Ritten,9,,37,52,89
072 Ritten,10,,46,52,98
072 Ritten,11,,53,48,101
072 Ritten,12,,44,50,94
072 Ritten,13,,52,55,107
072 Ritten,14,,43,41,84
072 Ritten,15,,34,48,82
072 Ritten,16,,50,46,96
072 Ritten,17,,44,45,89
072 Ritten,18,,50,54,104
072 Ritten,19,,45,49,94
072 Ritten,20,,57,51,108
072 Ritten,21,,42,56,98
072 Ritten,22,,58,46,104
072 Ritten,23,,61,41,102
072 Ritten,24,,51,49,100
072 Ritten,25,,41,71,112
072 Ritten,26,,57,48,105
072 Ritten,27,,62,46,108
072 Ritten,28,,52,37,89
072 Ritten,29,,56,59,115
072 Ritten,30,,57,47,104
072 Ritten,31,,52,43,95
072 Ritten,32,,48,54,102
072 Ritten,33,,52,33,85
072 Ritten,34,,54,62,116
072 Ritten,35,,38,52,90
072 Ritten,36,,51,51,102
072 Ritten,37,,56,48,104
072 Ritten,38,,59,52,111
072 Ritten,39,,50,47,97
072 Ritten,40,,60,34,94
072 Ritten,41,,44,55,99
072 Ritten,42,,52,51,103
072 Ritten,43,,64,58,122
072 Ritten,44,,60,45,105
072 Ritten,45,,51,65,116
072 Ritten,46,,57,65,122
072 Ritten,47,,54,69,123
072 Ritten,48,,50,74,124
072 Ritten,49,,68,65,133
072 Ritten,50,,75,49,124
072 Ritten,51,,58,49,107
072 Ritten,52,,72,43,115
072 Ritten,53,,65,60,125
072 Ritten,54,,66,51,117
072 Ritten,55,,53,60,113
072 Ritten,56,,50,57,107
072 Ritten,57,,59,59,118
072 Ritten,58,,71,50,121
072 Ritten,59,,38,48,86
072 Ritten,60,,38,43,81
072 Ritten,61,,44,45,89
072 Ritten,62,,48,40,88
072 Ritten,63,,35,34,69
072 Ritten,64,,47,29,76
072 Ritten,65,,41,43,84
072 Ritten,66,,45,37,82
072 Ritten,67,,30,38,68
072 Ritten,68,,32,47,79
072 Ritten,69,,49,39,88
072 Ritten,70,,30,28,58
072 Ritten,71,,20,38,58
072 Ritten,72,,19,26,45
072 Ritten,73,,34,39,73
072 Ritten,74,,33,37,70
072 Ritten,75,,38,34,72
072 Ritten,76,,29,35,64
072 Ritten,77,,29,21,50
072 Ritten,78,,33,28,61
072 Ritten,79,,26,30,56
072 Ritten,80,,21,21,42
072 Ritten,81,,14,24,38
072 Ritten,82,,16,24,40
072 Ritten,83,,11,24,35
072 Ritten,84,,9,21,30
072 Ritten,85,,10,17,27
072 Ritten,86,,7,24,31
072 Ritten,87,,7,14,21
072 Ritten,88,,7,12,19
072 Ritten,89,,6,7,13
072 Ritten,90,,7,7,14
072 Ritten,91,,5,8,13
072 Ritten,92,,-,13,13
072 Ritten,93,,4,9,13
072 Ritten,94,,2,8,10
072 Ritten,96,,-,5,5
072 Ritten,97,,-,1,1
072 Ritten,98,,-,1,1
073 Riffian,0,,9,6,15
073 Riffian,1,,9,8,17
073 Riffian,2,,6,4,10
073 Riffian,3,,6,2,8
073 Riffian,4,,8,5,13
073 Riffian,5,,2,6,8
073 Riffian,6,,12,11,23
073 Riffian,7,,7,6,13
073 Riffian,8,,8,7,15
073 Riffian,9,,12,5,17
073 Riffian,10,,11,8,19
073 Riffian,11,,5,11,16
073 Riffian,12,,9,9,18
073 Riffian,13,,9,3,12
073 Riffian,14,,8,7,15
073 Riffian,15,,10,7,17
073 Riffian,16,,11,8,19
073 Riffian,17,,10,11,21
073 Riffian,18,,10,9,19
073 Riffian,19,,13,6,19
073 Riffian,20,,10,7,17
073 Riffian,21,,8,10,18
073 Riffian,22,,8,9,17
073 Riffian,23,,10,10,20
073 Riffian,24,,7,6,13
073 Riffian,25,,14,7,21
073 Riffian,26,,9,14,23
073 Riffian,27,,9,6,15
073 Riffian,28,,12,4,16
073 Riffian,29,,7,9,16
073 Riffian,30,,8,9,17
073 Riffian,31,,12,8,20
073 Riffian,32,,10,5,15
073 Riffian,33,,8,7,15
073 Riffian,34,,8,6,14
073 Riffian,35,,10,11,21
073 Riffian,36,,8,7,15
073 Riffian,37,,1,5,6
073 Riffian,38,,10,9,19
073 Riffian,39,,13,6,19
073 Riffian,40,,11,14,25
073 Riffian,41,,8,4,12
073 Riffian,42,,10,13,23
073 Riffian,43,,11,12,23
073 Riffian,44,,9,9,18
073 Riffian,45,,11,22,33
073 Riffian,46,,10,15,25
073 Riffian,47,,6,7,13
073 Riffian,48,,14,12,26
073 Riffian,49,,10,12,22
073 Riffian,50,,12,15,27
073 Riffian,51,,12,6,18
073 Riffian,52,,11,7,18
073 Riffian,53,,11,8,19
073 Riffian,54,,15,9,24
073 Riffian,55,,9,12,21
073 Riffian,56,,6,8,14
073 Riffian,57,,14,6,20
073 Riffian,58,,7,13,20
073 Riffian,59,,8,5,13
073 Riffian,60,,5,11,16
073 Riffian,61,,9,6,15
073 Riffian,62,,3,7,10
073 Riffian,63,,9,6,15
073 Riffian,64,,7,4,11
073 Riffian,65,,6,3,9
073 Riffian,66,,5,9,14
073 Riffian,67,,4,3,7
073 Riffian,68,,8,6,14
073 Riffian,69,,3,2,5
073 Riffian,70,,3,4,7
073 Riffian,71,,3,8,11
073 Riffian,72,,6,3,9
073 Riffian,73,,6,8,14
073 Riffian,74,,5,7,12
073 Riffian,75,,12,6,18
073 Riffian,76,,5,3,8
073 Riffian,77,,3,3,6
073 Riffian,78,,4,9,13
073 Riffian,79,,6,4,10
073 Riffian,80,,5,5,10
073 Riffian,81,,1,3,4
073 Riffian,82,,1,3,4
073 Riffian,83,,-,2,2
073 Riffian,84,,2,5,7
073 Riffian,85,,1,5,6
073 Riffian,86,,3,4,7
073 Riffian,87,,3,2,5
073 Riffian,88,,-,4,4
073 Riffian,89,,1,3,4
073 Riffian,90,,2,2,4
073 Riffian,91,,3,1,4
073 Riffian,92,,-,2,2
073 Riffian,93,,1,1,2
073 Riffian,94,,-,2,2
073 Riffian,97,,-,1,1
074 Mühlbach,0,,14,21,35
074 Mühlbach,1,,21,19,40
074 Mühlbach,2,,29,19,48
074 Mühlbach,3,,21,12,33
074 Mühlbach,4,,24,10,34
074 Mühlbach,5,,19,24,43
074 Mühlbach,6,,22,16,38
074 Mühlbach,7,,18,25,43
074 Mühlbach,8,,21,15,36
074 Mühlbach,9,,22,17,39
074 Mühlbach,10,,22,26,48
074 Mühlbach,11,,15,9,24
074 Mühlbach,12,,18,11,29
074 Mühlbach,13,,14,20,34
074 Mühlbach,14,,23,12,35
074 Mühlbach,15,,19,19,38
074 Mühlbach,16,,14,19,33
074 Mühlbach,17,,16,17,33
074 Mühlbach,18,,19,16,35
074 Mühlbach,19,,18,17,35
074 Mühlbach,20,,21,16,37
074 Mühlbach,21,,21,13,34
074 Mühlbach,22,,14,21,35
074 Mühlbach,23,,24,15,39
074 Mühlbach,24,,20,26,46
074 Mühlbach,25,,15,20,35
074 Mühlbach,26,,16,19,35
074 Mühlbach,27,,17,19,36
074 Mühlbach,28,,12,16,28
074 Mühlbach,29,,16,19,35
074 Mühlbach,30,,22,19,41
074 Mühlbach,31,,14,10,24
074 Mühlbach,32,,19,24,43
074 Mühlbach,33,,21,25,46
074 Mühlbach,34,,21,20,41
074 Mühlbach,35,,28,30,58
074 Mühlbach,36,,24,14,38
074 Mühlbach,37,,22,20,42
074 Mühlbach,38,,24,18,42
074 Mühlbach,39,,27,27,54
074 Mühlbach,40,,24,16,40
074 Mühlbach,41,,24,16,40
074 Mühlbach,42,,19,22,41
074 Mühlbach,43,,23,20,43
074 Mühlbach,44,,23,20,43
074 Mühlbach,45,,25,23,48
074 Mühlbach,46,,31,29,60
074 Mühlbach,47,,27,18,45
074 Mühlbach,48,,24,34,58
074 Mühlbach,49,,32,21,53
074 Mühlbach,50,,21,23,44
074 Mühlbach,51,,29,20,49
074 Mühlbach,52,,26,21,47
074 Mühlbach,53,,15,21,36
074 Mühlbach,54,,20,20,40
074 Mühlbach,55,,23,17,40
074 Mühlbach,56,,24,25,49
074 Mühlbach,57,,22,14,36
074 Mühlbach,58,,21,17,38
074 Mühlbach,59,,18,14,32
074 Mühlbach,60,,15,23,38
074 Mühlbach,61,,18,25,43
074 Mühlbach,62,,19,21,40
074 Mühlbach,63,,13,20,33
074 Mühlbach,64,,18,18,36
074 Mühlbach,65,,15,21,36
074 Mühlbach,66,,13,18,31
074 Mühlbach,67,,20,17,37
074 Mühlbach,68,,13,13,26
074 Mühlbach,69,,19,12,31
074 Mühlbach,70,,10,17,27
074 Mühlbach,71,,17,10,27
074 Mühlbach,72,,6,6,12
074 Mühlbach,73,,13,11,24
074 Mühlbach,74,,8,9,17
074 Mühlbach,75,,12,13,25
074 Mühlbach,76,,14,16,30
074 Mühlbach,77,,11,9,20
074 Mühlbach,78,,7,13,20
074 Mühlbach,79,,10,6,16
074 Mühlbach,80,,5,10,15
074 Mühlbach,81,,3,7,10
074 Mühlbach,82,,5,5,10
074 Mühlbach,83,,6,7,13
074 Mühlbach,84,,8,9,17
074 Mühlbach,85,,1,5,6
074 Mühlbach,86,,2,6,8
074 Mühlbach,87,,2,4,6
074 Mühlbach,88,,3,1,4
074 Mühlbach,89,,1,8,9
074 Mühlbach,90,,-,6,6
074 Mühlbach,91,,2,4,6
074 Mühlbach,92,,-,2,2
074 Mühlbach,93,,3,2,5
074 Mühlbach,94,,-,2,2
074 Mühlbach,95,,-,4,4
074 Mühlbach,96,,-,2,2
075 Rodeneck,0,,6,8,14
075 Rodeneck,1,,6,7,13
075 Rodeneck,2,,8,5,13
075 Rodeneck,3,,6,8,14
075 Rodeneck,4,,7,6,13
075 Rodeneck,5,,7,5,12
075 Rodeneck,6,,2,7,9
075 Rodeneck,7,,7,4,11
075 Rodeneck,8,,3,6,9
075 Rodeneck,9,,7,9,16
075 Rodeneck,10,,7,6,13
075 Rodeneck,11,,6,5,11
075 Rodeneck,12,,9,8,17
075 Rodeneck,13,,8,5,13
075 Rodeneck,14,,8,7,15
075 Rodeneck,15,,10,3,13
075 Rodeneck,16,,9,5,14
075 Rodeneck,17,,6,14,20
075 Rodeneck,18,,10,11,21
075 Rodeneck,19,,11,8,19
075 Rodeneck,20,,10,7,17
075 Rodeneck,21,,13,10,23
075 Rodeneck,22,,7,7,14
075 Rodeneck,23,,7,11,18
075 Rodeneck,24,,6,7,13
075 Rodeneck,25,,9,10,19
075 Rodeneck,26,,8,7,15
075 Rodeneck,27,,10,9,19
075 Rodeneck,28,,6,8,14
075 Rodeneck,29,,13,10,23
075 Rodeneck,30,,7,6,13
075 Rodeneck,31,,7,14,21
075 Rodeneck,32,,11,6,17
075 Rodeneck,33,,11,8,19
075 Rodeneck,34,,9,10,19
075 Rodeneck,35,,8,6,14
075 Rodeneck,36,,9,3,12
075 Rodeneck,37,,7,13,20
075 Rodeneck,38,,5,4,9
075 Rodeneck,39,,6,7,13
075 Rodeneck,40,,8,5,13
075 Rodeneck,41,,9,7,16
075 Rodeneck,42,,8,6,14
075 Rodeneck,43,,6,6,12
075 Rodeneck,44,,15,11,26
075 Rodeneck,45,,8,8,16
075 Rodeneck,46,,15,5,20
075 Rodeneck,47,,7,11,18
075 Rodeneck,48,,14,10,24
075 Rodeneck,49,,12,11,23
075 Rodeneck,50,,11,9,20
075 Rodeneck,51,,16,11,27
075 Rodeneck,52,,7,7,14
075 Rodeneck,53,,14,14,28
075 Rodeneck,54,,10,10,20
075 Rodeneck,55,,10,12,22
075 Rodeneck,56,,9,10,19
075 Rodeneck,57,,5,10,15
075 Rodeneck,58,,11,6,17
075 Rodeneck,59,,8,4,12
075 Rodeneck,60,,5,7,12
075 Rodeneck,61,,8,4,12
075 Rodeneck,62,,5,5,10
075 Rodeneck,63,,9,3,12
075 Rodeneck,64,,4,1,5
075 Rodeneck,65,,9,4,13
075 Rodeneck,66,,2,2,4
075 Rodeneck,67,,2,8,10
075 Rodeneck,68,,3,4,7
075 Rodeneck,69,,4,7,11
075 Rodeneck,70,,4,5,9
075 Rodeneck,71,,8,6,14
075 Rodeneck,72,,2,5,7
075 Rodeneck,73,,3,4,7
075 Rodeneck,74,,2,2,4
075 Rodeneck,75,,1,6,7
075 Rodeneck,76,,9,3,12
075 Rodeneck,77,,4,3,7
075 Rodeneck,78,,1,8,9
075 Rodeneck,79,,2,3,5
075 Rodeneck,80,,-,3,3
075 Rodeneck,81,,1,2,3
075 Rodeneck,82,,3,2,5
075 Rodeneck,83,,1,9,10
075 Rodeneck,84,,2,-,2
075 Rodeneck,85,,4,5,9
075 Rodeneck,86,,4,2,6
075 Rodeneck,87,,4,3,7
075 Rodeneck,88,,1,1,2
075 Rodeneck,89,,3,4,7
075 Rodeneck,90,,1,2,3
075 Rodeneck,91,,1,2,3
075 Rodeneck,92,,-,2,2
075 Rodeneck,93,,-,2,2
075 Rodeneck,94,,1,-,1
076 Salurn,0,,19,21,40
076 Salurn,1,,25,20,45
076 Salurn,2,,22,25,47
076 Salurn,3,,28,23,51
076 Salurn,4,,21,24,45
076 Salurn,5,,24,23,47
076 Salurn,6,,31,25,56
076 Salurn,7,,30,19,49
076 Salurn,8,,26,29,55
076 Salurn,9,,30,23,53
076 Salurn,10,,30,21,51
076 Salurn,11,,20,21,41
076 Salurn,12,,16,25,41
076 Salurn,13,,24,17,41
076 Salurn,14,,29,17,46
076 Salurn,15,,20,19,39
076 Salurn,16,,18,17,35
076 Salurn,17,,20,19,39
076 Salurn,18,,22,17,39
076 Salurn,19,,20,27,47
076 Salurn,20,,13,14,27
076 Salurn,21,,25,22,47
076 Salurn,22,,22,17,39
076 Salurn,23,,19,22,41
076 Salurn,24,,19,29,48
076 Salurn,25,,26,21,47
076 Salurn,26,,15,25,40
076 Salurn,27,,12,27,39
076 Salurn,28,,16,23,39
076 Salurn,29,,22,29,51
076 Salurn,30,,24,16,40
076 Salurn,31,,24,27,51
076 Salurn,32,,20,27,47
076 Salurn,33,,16,24,40
076 Salurn,34,,15,25,40
076 Salurn,35,,22,22,44
076 Salurn,36,,24,33,57
076 Salurn,37,,33,28,61
076 Salurn,38,,29,30,59
076 Salurn,39,,23,24,47
076 Salurn,40,,31,28,59
076 Salurn,41,,29,25,54
076 Salurn,42,,30,30,60
076 Salurn,43,,28,22,50
076 Salurn,44,,29,34,63
076 Salurn,45,,31,28,59
076 Salurn,46,,40,28,68
076 Salurn,47,,30,31,61
076 Salurn,48,,30,31,61
076 Salurn,49,,35,26,61
076 Salurn,50,,29,25,54
076 Salurn,51,,27,28,55
076 Salurn,52,,31,32,63
076 Salurn,53,,33,32,65
076 Salurn,54,,39,28,67
076 Salurn,55,,31,30,61
076 Salurn,56,,26,32,58
076 Salurn,57,,19,25,44
076 Salurn,58,,25,27,52
076 Salurn,59,,31,18,49
076 Salurn,60,,19,25,44
076 Salurn,61,,20,16,36
076 Salurn,62,,21,22,43
076 Salurn,63,,18,18,36
076 Salurn,64,,17,18,35
076 Salurn,65,,27,22,49
076 Salurn,66,,24,19,43
076 Salurn,67,,24,16,40
076 Salurn,68,,27,10,37
076 Salurn,69,,15,21,36
076 Salurn,70,,14,18,32
076 Salurn,71,,19,17,36
076 Salurn,72,,11,11,22
076 Salurn,73,,16,17,33
076 Salurn,74,,17,17,34
076 Salurn,75,,19,18,37
076 Salurn,76,,14,15,29
076 Salurn,77,,12,12,24
076 Salurn,78,,11,7,18
076 Salurn,79,,5,9,14
076 Salurn,80,,10,10,20
076 Salurn,81,,12,18,30
076 Salurn,82,,8,14,22
076 Salurn,83,,6,5,11
076 Salurn,84,,3,5,8
076 Salurn,85,,3,13,16
076 Salurn,86,,5,5,10
076 Salurn,87,,7,7,14
076 Salurn,88,,7,9,16
076 Salurn,89,,2,14,16
076 Salurn,90,,1,8,9
076 Salurn,91,,1,6,7
076 Salurn,92,,2,3,5
076 Salurn,93,,-,8,8
076 Salurn,94,,2,2,4
076 Salurn,95,,-,4,4
076 Salurn,96,,1,1,2
076 Salurn,97,,-,2,2
076 Salurn,100,,-,1,1
076 Salurn,106,,-,1,1
077 Innichen,0,,17,19,36
077 Innichen,1,,19,17,36
077 Innichen,2,,9,17,26
077 Innichen,3,,20,14,34
077 Innichen,4,,18,21,39
077 Innichen,5,,14,21,35
077 Innichen,6,,24,22,46
077 Innichen,7,,19,13,32
077 Innichen,8,,10,19,29
077 Innichen,9,,21,14,35
077 Innichen,10,,15,17,32
077 Innichen,11,,8,17,25
077 Innichen,12,,14,15,29
077 Innichen,13,,13,16,29
077 Innichen,14,,18,17,35
077 Innichen,15,,14,17,31
077 Innichen,16,,22,16,38
077 Innichen,17,,14,14,28
077 Innichen,18,,11,16,27
077 Innichen,19,,25,12,37
077 Innichen,20,,23,14,37
077 Innichen,21,,21,17,38
077 Innichen,22,,24,13,37
077 Innichen,23,,23,20,43
077 Innichen,24,,30,19,49
077 Innichen,25,,23,14,37
077 Innichen,26,,19,23,42
077 Innichen,27,,21,16,37
077 Innichen,28,,26,21,47
077 Innichen,29,,26,18,44
077 Innichen,30,,24,13,37
077 Innichen,31,,22,17,39
077 Innichen,32,,25,31,56
077 Innichen,33,,18,19,37
077 Innichen,34,,26,19,45
077 Innichen,35,,26,26,52
077 Innichen,36,,15,19,34
077 Innichen,37,,24,22,46
077 Innichen,38,,28,28,56
077 Innichen,39,,15,17,32
077 Innichen,40,,18,26,44
077 Innichen,41,,18,26,44
077 Innichen,42,,18,19,37
077 Innichen,43,,23,17,40
077 Innichen,44,,22,22,44
077 Innichen,45,,24,23,47
077 Innichen,46,,25,16,41
077 Innichen,47,,25,28,53
077 Innichen,48,,19,27,46
077 Innichen,49,,25,24,49
077 Innichen,50,,27,27,54
077 Innichen,51,,27,31,58
077 Innichen,52,,40,27,67
077 Innichen,53,,31,32,63
077 Innichen,54,,29,26,55
077 Innichen,55,,27,23,50
077 Innichen,56,,21,24,45
077 Innichen,57,,27,23,50
077 Innichen,58,,25,22,47
077 Innichen,59,,21,26,47
077 Innichen,60,,17,25,42
077 Innichen,61,,24,15,39
077 Innichen,62,,25,21,46
077 Innichen,63,,26,11,37
077 Innichen,64,,23,20,43
077 Innichen,65,,12,26,38
077 Innichen,66,,12,17,29
077 Innichen,67,,15,18,33
077 Innichen,68,,17,16,33
077 Innichen,69,,15,16,31
077 Innichen,70,,12,14,26
077 Innichen,71,,12,16,28
077 Innichen,72,,11,10,21
077 Innichen,73,,9,15,24
077 Innichen,74,,18,9,27
077 Innichen,75,,16,18,34
077 Innichen,76,,12,16,28
077 Innichen,77,,9,24,33
077 Innichen,78,,11,11,22
077 Innichen,79,,8,12,20
077 Innichen,80,,8,9,17
077 Innichen,81,,7,20,27
077 Innichen,82,,4,15,19
077 Innichen,83,,9,12,21
077 Innichen,84,,8,6,14
077 Innichen,85,,7,13,20
077 Innichen,86,,8,13,21
077 Innichen,87,,8,8,16
077 Innichen,88,,5,12,17
077 Innichen,89,,5,13,18
077 Innichen,90,,3,7,10
077 Innichen,91,,3,7,10
077 Innichen,92,,2,6,8
077 Innichen,93,,2,1,3
077 Innichen,94,,1,3,4
077 Innichen,95,,1,5,6
077 Innichen,96,,-,2,2
077 Innichen,97,,1,2,3
079 Jenesien,0,,21,10,31
079 Jenesien,1,,22,12,34
079 Jenesien,2,,14,13,27
079 Jenesien,3,,21,18,39
079 Jenesien,4,,18,16,34
079 Jenesien,5,,16,10,26
079 Jenesien,6,,13,12,25
079 Jenesien,7,,18,16,34
079 Jenesien,8,,18,15,33
079 Jenesien,9,,19,19,38
079 Jenesien,10,,22,17,39
079 Jenesien,11,,20,22,42
079 Jenesien,12,,15,16,31
079 Jenesien,13,,18,20,38
079 Jenesien,14,,18,21,39
079 Jenesien,15,,12,17,29
079 Jenesien,16,,20,22,42
079 Jenesien,17,,17,18,35
079 Jenesien,18,,27,20,47
079 Jenesien,19,,15,27,42
079 Jenesien,20,,22,20,42
079 Jenesien,21,,26,14,40
079 Jenesien,22,,22,19,41
079 Jenesien,23,,21,21,42
079 Jenesien,24,,15,17,32
079 Jenesien,25,,26,19,45
079 Jenesien,26,,20,23,43
079 Jenesien,27,,17,12,29
079 Jenesien,28,,16,14,30
079 Jenesien,29,,19,13,32
079 Jenesien,30,,18,15,33
079 Jenesien,31,,20,15,35
079 Jenesien,32,,19,13,32
079 Jenesien,33,,16,15,31
079 Jenesien,34,,16,20,36
079 Jenesien,35,,19,22,41
079 Jenesien,36,,18,19,37
079 Jenesien,37,,17,15,32
079 Jenesien,38,,21,17,38
079 Jenesien,39,,17,21,38
079 Jenesien,40,,19,13,32
079 Jenesien,41,,12,22,34
079 Jenesien,42,,12,21,33
079 Jenesien,43,,22,25,47
079 Jenesien,44,,23,28,51
079 Jenesien,45,,25,27,52
079 Jenesien,46,,29,26,55
079 Jenesien,47,,31,33,64
079 Jenesien,48,,31,22,53
079 Jenesien,49,,18,26,44
079 Jenesien,50,,18,25,43
079 Jenesien,51,,39,30,69
079 Jenesien,52,,32,29,61
079 Jenesien,53,,35,35,70
079 Jenesien,54,,26,26,52
079 Jenesien,55,,25,20,45
079 Jenesien,56,,29,21,50
079 Jenesien,57,,22,12,34
079 Jenesien,58,,22,16,38
079 Jenesien,59,,23,9,32
079 Jenesien,60,,12,17,29
079 Jenesien,61,,16,14,30
079 Jenesien,62,,10,12,22
079 Jenesien,63,,18,12,30
079 Jenesien,64,,12,9,21
079 Jenesien,65,,14,19,33
079 Jenesien,66,,11,9,20
079 Jenesien,67,,12,21,33
079 Jenesien,68,,14,14,28
079 Jenesien,69,,13,8,21
079 Jenesien,70,,13,11,24
079 Jenesien,71,,11,9,20
079 Jenesien,72,,7,14,21
079 Jenesien,73,,11,11,22
079 Jenesien,74,,14,9,23
079 Jenesien,75,,14,9,23
079 Jenesien,76,,11,18,29
079 Jenesien,77,,13,11,24
079 Jenesien,78,,11,18,29
079 Jenesien,79,,9,10,19
079 Jenesien,80,,7,15,22
079 Jenesien,81,,3,17,20
079 Jenesien,82,,5,7,12
079 Jenesien,83,,7,6,13
079 Jenesien,84,,10,8,18
079 Jenesien,85,,3,7,10
079 Jenesien,86,,5,3,8
079 Jenesien,87,,3,10,13
079 Jenesien,88,,2,7,9
079 Jenesien,89,,3,5,8
079 Jenesien,90,,1,4,5
079 Jenesien,91,,2,3,5
079 Jenesien,92,,-,2,2
079 Jenesien,93,,2,-,2
079 Jenesien,94,,-,1,1
079 Jenesien,95,,-,3,3
080 St.Leonhard in Pass.,0,,19,20,39
080 St.Leonhard in Pass.,1,,23,16,39
080 St.Leonhard in Pass.,2,,21,28,49
080 St.Leonhard in Pass.,3,,26,20,46
080 St.Leonhard in Pass.,4,,19,22,41
080 St.Leonhard in Pass.,5,,9,20,29
080 St.Leonhard in Pass.,6,,15,19,34
080 St.Leonhard in Pass.,7,,22,21,43
080 St.Leonhard in Pass.,8,,20,19,39
080 St.Leonhard in Pass.,9,,20,20,40
080 St.Leonhard in Pass.,10,,23,20,43
080 St.Leonhard in Pass.,11,,16,26,42
080 St.Leonhard in Pass.,12,,20,20,40
080 St.Leonhard in Pass.,13,,18,22,40
080 St.Leonhard in Pass.,14,,23,14,37
080 St.Leonhard in Pass.,15,,25,19,44
080 St.Leonhard in Pass.,16,,27,13,40
080 St.Leonhard in Pass.,17,,24,18,42
080 St.Leonhard in Pass.,18,,20,21,41
080 St.Leonhard in Pass.,19,,21,22,43
080 St.Leonhard in Pass.,20,,25,20,45
080 St.Leonhard in Pass.,21,,24,18,42
080 St.Leonhard in Pass.,22,,21,13,34
080 St.Leonhard in Pass.,23,,20,21,41
080 St.Leonhard in Pass.,24,,28,20,48
080 St.Leonhard in Pass.,25,,20,18,38
080 St.Leonhard in Pass.,26,,22,26,48
080 St.Leonhard in Pass.,27,,24,14,38
080 St.Leonhard in Pass.,28,,34,28,62
080 St.Leonhard in Pass.,29,,20,20,40
080 St.Leonhard in Pass.,30,,23,22,45
080 St.Leonhard in Pass.,31,,27,29,56
080 St.Leonhard in Pass.,32,,22,20,42
080 St.Leonhard in Pass.,33,,26,24,50
080 St.Leonhard in Pass.,34,,28,20,48
080 St.Leonhard in Pass.,35,,22,28,50
080 St.Leonhard in Pass.,36,,23,29,52
080 St.Leonhard in Pass.,37,,20,23,43
080 St.Leonhard in Pass.,38,,28,22,50
080 St.Leonhard in Pass.,39,,25,27,52
080 St.Leonhard in Pass.,40,,27,23,50
080 St.Leonhard in Pass.,41,,15,30,45
080 St.Leonhard in Pass.,42,,30,11,41
080 St.Leonhard in Pass.,43,,32,20,52
080 St.Leonhard in Pass.,44,,27,27,54
080 St.Leonhard in Pass.,45,,26,25,51
080 St.Leonhard in Pass.,46,,29,20,49
080 St.Leonhard in Pass.,47,,18,23,41
080 St.Leonhard in Pass.,48,,23,27,50
080 St.Leonhard in Pass.,49,,32,23,55
080 St.Leonhard in Pass.,50,,20,25,45
080 St.Leonhard in Pass.,51,,33,29,62
080 St.Leonhard in Pass.,52,,29,29,58
080 St.Leonhard in Pass.,53,,23,26,49
080 St.Leonhard in Pass.,54,,21,24,45
080 St.Leonhard in Pass.,55,,22,32,54
080 St.Leonhard in Pass.,56,,26,20,46
080 St.Leonhard in Pass.,57,,31,19,50
080 St.Leonhard in Pass.,58,,29,25,54
080 St.Leonhard in Pass.,59,,22,19,41
080 St.Leonhard in Pass.,60,,19,28,47
080 St.Leonhard in Pass.,61,,26,18,44
080 St.Leonhard in Pass.,62,,23,17,40
080 St.Leonhard in Pass.,63,,18,13,31
080 St.Leonhard in Pass.,64,,28,25,53
080 St.Leonhard in Pass.,65,,18,21,39
080 St.Leonhard in Pass.,66,,24,16,40
080 St.Leonhard in Pass.,67,,14,16,30
080 St.Leonhard in Pass.,68,,21,10,31
080 St.Leonhard in Pass.,69,,21,10,31
080 St.Leonhard in Pass.,70,,17,14,31
080 St.Leonhard in Pass.,71,,13,16,29
080 St.Leonhard in Pass.,72,,10,10,20
080 St.Leonhard in Pass.,73,,11,12,23
080 St.Leonhard in Pass.,74,,6,23,29
080 St.Leonhard in Pass.,75,,7,12,19
080 St.Leonhard in Pass.,76,,12,13,25
080 St.Leonhard in Pass.,77,,16,12,28
080 St.Leonhard in Pass.,78,,17,17,34
080 St.Leonhard in Pass.,79,,9,13,22
080 St.Leonhard in Pass.,80,,16,7,23
080 St.Leonhard in Pass.,81,,13,12,25
080 St.Leonhard in Pass.,82,,8,11,19
080 St.Leonhard in Pass.,83,,6,8,14
080 St.Leonhard in Pass.,84,,8,13,21
080 St.Leonhard in Pass.,85,,3,11,14
080 St.Leonhard in Pass.,86,,2,12,14
080 St.Leonhard in Pass.,87,,4,5,9
080 St.Leonhard in Pass.,88,,3,4,7
080 St.Leonhard in Pass.,89,,2,6,8
080 St.Leonhard in Pass.,90,,2,4,6
080 St.Leonhard in Pass.,91,,3,4,7
080 St.Leonhard in Pass.,92,,3,4,7
080 St.Leonhard in Pass.,93,,-,1,1
080 St.Leonhard in Pass.,94,,3,2,5
080 St.Leonhard in Pass.,95,,-,1,1
080 St.Leonhard in Pass.,98,,-,1,1
081 St.Lorenzen,0,,17,18,35
081 St.Lorenzen,1,,20,20,40
081 St.Lorenzen,2,,15,25,40
081 St.Lorenzen,3,,22,26,48
081 St.Lorenzen,4,,26,24,50
081 St.Lorenzen,5,,18,9,27
081 St.Lorenzen,6,,21,20,41
081 St.Lorenzen,7,,27,18,45
081 St.Lorenzen,8,,21,23,44
081 St.Lorenzen,9,,24,21,45
081 St.Lorenzen,10,,26,22,48
081 St.Lorenzen,11,,18,19,37
081 St.Lorenzen,12,,26,22,48
081 St.Lorenzen,13,,27,20,47
081 St.Lorenzen,14,,27,19,46
081 St.Lorenzen,15,,24,20,44
081 St.Lorenzen,16,,29,19,48
081 St.Lorenzen,17,,22,28,50
081 St.Lorenzen,18,,27,26,53
081 St.Lorenzen,19,,36,23,59
081 St.Lorenzen,20,,17,32,49
081 St.Lorenzen,21,,26,31,57
081 St.Lorenzen,22,,23,15,38
081 St.Lorenzen,23,,30,21,51
081 St.Lorenzen,24,,26,34,60
081 St.Lorenzen,25,,28,22,50
081 St.Lorenzen,26,,26,21,47
081 St.Lorenzen,27,,20,16,36
081 St.Lorenzen,28,,20,21,41
081 St.Lorenzen,29,,17,27,44
081 St.Lorenzen,30,,21,23,44
081 St.Lorenzen,31,,14,27,41
081 St.Lorenzen,32,,26,24,50
081 St.Lorenzen,33,,25,21,46
081 St.Lorenzen,34,,28,15,43
081 St.Lorenzen,35,,33,23,56
081 St.Lorenzen,36,,21,25,46
081 St.Lorenzen,37,,17,27,44
081 St.Lorenzen,38,,26,32,58
081 St.Lorenzen,39,,26,20,46
081 St.Lorenzen,40,,28,14,42
081 St.Lorenzen,41,,25,18,43
081 St.Lorenzen,42,,23,30,53
081 St.Lorenzen,43,,28,32,60
081 St.Lorenzen,44,,35,39,74
081 St.Lorenzen,45,,40,34,74
081 St.Lorenzen,46,,36,29,65
081 St.Lorenzen,47,,31,30,61
081 St.Lorenzen,48,,20,33,53
081 St.Lorenzen,49,,45,35,80
081 St.Lorenzen,50,,29,41,70
081 St.Lorenzen,51,,36,32,68
081 St.Lorenzen,52,,32,27,59
081 St.Lorenzen,53,,38,24,62
081 St.Lorenzen,54,,32,31,63
081 St.Lorenzen,55,,30,36,66
081 St.Lorenzen,56,,24,38,62
081 St.Lorenzen,57,,30,20,50
081 St.Lorenzen,58,,32,26,58
081 St.Lorenzen,59,,29,33,62
081 St.Lorenzen,60,,22,27,49
081 St.Lorenzen,61,,23,28,51
081 St.Lorenzen,62,,16,16,32
081 St.Lorenzen,63,,12,19,31
081 St.Lorenzen,64,,23,16,39
081 St.Lorenzen,65,,16,11,27
081 St.Lorenzen,66,,14,15,29
081 St.Lorenzen,67,,17,18,35
081 St.Lorenzen,68,,10,22,32
081 St.Lorenzen,69,,14,11,25
081 St.Lorenzen,70,,17,8,25
081 St.Lorenzen,71,,16,9,25
081 St.Lorenzen,72,,9,19,28
081 St.Lorenzen,73,,16,14,30
081 St.Lorenzen,74,,11,15,26
081 St.Lorenzen,75,,17,19,36
081 St.Lorenzen,76,,15,16,31
081 St.Lorenzen,77,,11,11,22
081 St.Lorenzen,78,,10,17,27
081 St.Lorenzen,79,,11,10,21
081 St.Lorenzen,80,,17,16,33
081 St.Lorenzen,81,,7,12,19
081 St.Lorenzen,82,,8,10,18
081 St.Lorenzen,83,,13,7,20
081 St.Lorenzen,84,,6,7,13
081 St.Lorenzen,85,,5,9,14
081 St.Lorenzen,86,,5,12,17
081 St.Lorenzen,87,,2,4,6
081 St.Lorenzen,88,,8,8,16
081 St.Lorenzen,89,,3,10,13
081 St.Lorenzen,90,,3,1,4
081 St.Lorenzen,91,,5,3,8
081 St.Lorenzen,92,,1,7,8
081 St.Lorenzen,93,,-,4,4
081 St.Lorenzen,94,,-,4,4
081 St.Lorenzen,95,,-,1,1
081 St.Lorenzen,97,,-,2,2
081 St.Lorenzen,99,,-,1,1
082 St.Martin in Thurn,0,,8,14,22
082 St.Martin in Thurn,1,,8,7,15
082 St.Martin in Thurn,2,,11,6,17
082 St.Martin in Thurn,3,,12,16,28
082 St.Martin in Thurn,4,,12,7,19
082 St.Martin in Thurn,5,,7,7,14
082 St.Martin in Thurn,6,,13,5,18
082 St.Martin in Thurn,7,,5,7,12
082 St.Martin in Thurn,8,,5,6,11
082 St.Martin in Thurn,9,,7,5,12
082 St.Martin in Thurn,10,,2,10,12
082 St.Martin in Thurn,11,,9,14,23
082 St.Martin in Thurn,12,,10,9,19
082 St.Martin in Thurn,13,,17,13,30
082 St.Martin in Thurn,14,,4,6,10
082 St.Martin in Thurn,15,,15,9,24
082 St.Martin in Thurn,16,,8,15,23
082 St.Martin in Thurn,17,,7,9,16
082 St.Martin in Thurn,18,,9,20,29
082 St.Martin in Thurn,19,,11,11,22
082 St.Martin in Thurn,20,,16,10,26
082 St.Martin in Thurn,21,,22,14,36
082 St.Martin in Thurn,22,,16,12,28
082 St.Martin in Thurn,23,,15,10,25
082 St.Martin in Thurn,24,,8,11,19
082 St.Martin in Thurn,25,,18,13,31
082 St.Martin in Thurn,26,,12,11,23
082 St.Martin in Thurn,27,,5,14,19
082 St.Martin in Thurn,28,,18,11,29
082 St.Martin in Thurn,29,,7,7,14
082 St.Martin in Thurn,30,,14,10,24
082 St.Martin in Thurn,31,,10,12,22
082 St.Martin in Thurn,32,,8,10,18
082 St.Martin in Thurn,33,,9,6,15
082 St.Martin in Thurn,34,,11,11,22
082 St.Martin in Thurn,35,,13,14,27
082 St.Martin in Thurn,36,,15,6,21
082 St.Martin in Thurn,37,,11,7,18
082 St.Martin in Thurn,38,,8,10,18
082 St.Martin in Thurn,39,,19,8,27
082 St.Martin in Thurn,40,,13,10,23
082 St.Martin in Thurn,41,,12,10,22
082 St.Martin in Thurn,42,,8,11,19
082 St.Martin in Thurn,43,,7,11,18
082 St.Martin in Thurn,44,,11,12,23
082 St.Martin in Thurn,45,,14,9,23
082 St.Martin in Thurn,46,,15,14,29
082 St.Martin in Thurn,47,,13,16,29
082 St.Martin in Thurn,48,,16,15,31
082 St.Martin in Thurn,49,,16,14,30
082 St.Martin in Thurn,50,,11,10,21
082 St.Martin in Thurn,51,,15,25,40
082 St.Martin in Thurn,52,,16,23,39
082 St.Martin in Thurn,53,,11,15,26
082 St.Martin in Thurn,54,,14,14,28
082 St.Martin in Thurn,55,,14,15,29
082 St.Martin in Thurn,56,,15,19,34
082 St.Martin in Thurn,57,,14,7,21
082 St.Martin in Thurn,58,,12,9,21
082 St.Martin in Thurn,59,,12,8,20
082 St.Martin in Thurn,60,,12,10,22
082 St.Martin in Thurn,61,,7,5,12
082 St.Martin in Thurn,62,,13,9,22
082 St.Martin in Thurn,63,,8,8,16
082 St.Martin in Thurn,64,,5,9,14
082 St.Martin in Thurn,65,,1,3,4
082 St.Martin in Thurn,66,,7,7,14
082 St.Martin in Thurn,67,,9,6,15
082 St.Martin in Thurn,68,,3,6,9
082 St.Martin in Thurn,69,,7,7,14
082 St.Martin in Thurn,70,,9,7,16
082 St.Martin in Thurn,71,,7,7,14
082 St.Martin in Thurn,72,,7,4,11
082 St.Martin in Thurn,73,,11,8,19
082 St.Martin in Thurn,74,,3,8,11
082 St.Martin in Thurn,75,,7,6,13
082 St.Martin in Thurn,76,,3,5,8
082 St.Martin in Thurn,77,,2,4,6
082 St.Martin in Thurn,78,,6,7,13
082 St.Martin in Thurn,79,,8,6,14
082 St.Martin in Thurn,80,,5,11,16
082 St.Martin in Thurn,81,,4,6,10
082 St.Martin in Thurn,82,,5,3,8
082 St.Martin in Thurn,83,,3,3,6
082 St.Martin in Thurn,84,,3,6,9
082 St.Martin in Thurn,85,,7,5,12
082 St.Martin in Thurn,86,,5,5,10
082 St.Martin in Thurn,87,,2,6,8
082 St.Martin in Thurn,88,,5,5,10
082 St.Martin in Thurn,89,,1,2,3
082 St.Martin in Thurn,90,,1,2,3
082 St.Martin in Thurn,91,,2,2,4
082 St.Martin in Thurn,92,,1,3,4
082 St.Martin in Thurn,93,,2,3,5
082 St.Martin in Thurn,94,,-,3,3
082 St.Martin in Thurn,95,,-,1,1
082 St.Martin in Thurn,98,,-,1,1
083 St.Martin in Passeier,0,,17,21,38
083 St.Martin in Passeier,1,,15,20,35
083 St.Martin in Passeier,2,,16,24,40
083 St.Martin in Passeier,3,,20,11,31
083 St.Martin in Passeier,4,,20,13,33
083 St.Martin in Passeier,5,,21,26,47
083 St.Martin in Passeier,6,,13,21,34
083 St.Martin in Passeier,7,,24,18,42
083 St.Martin in Passeier,8,,13,22,35
083 St.Martin in Passeier,9,,19,27,46
083 St.Martin in Passeier,10,,16,21,37
083 St.Martin in Passeier,11,,24,17,41
083 St.Martin in Passeier,12,,21,19,40
083 St.Martin in Passeier,13,,19,18,37
083 St.Martin in Passeier,14,,19,17,36
083 St.Martin in Passeier,15,,16,12,28
083 St.Martin in Passeier,16,,18,18,36
083 St.Martin in Passeier,17,,13,23,36
083 St.Martin in Passeier,18,,9,21,30
083 St.Martin in Passeier,19,,22,20,42
083 St.Martin in Passeier,20,,25,27,52
083 St.Martin in Passeier,21,,20,21,41
083 St.Martin in Passeier,22,,22,18,40
083 St.Martin in Passeier,23,,22,23,45
083 St.Martin in Passeier,24,,17,20,37
083 St.Martin in Passeier,25,,23,18,41
083 St.Martin in Passeier,26,,23,21,44
083 St.Martin in Passeier,27,,20,21,41
083 St.Martin in Passeier,28,,14,19,33
083 St.Martin in Passeier,29,,14,18,32
083 St.Martin in Passeier,30,,18,25,43
083 St.Martin in Passeier,31,,30,21,51
083 St.Martin in Passeier,32,,22,29,51
083 St.Martin in Passeier,33,,23,27,50
083 St.Martin in Passeier,34,,19,12,31
083 St.Martin in Passeier,35,,26,16,42
083 St.Martin in Passeier,36,,24,23,47
083 St.Martin in Passeier,37,,20,24,44
083 St.Martin in Passeier,38,,13,19,32
083 St.Martin in Passeier,39,,31,17,48
083 St.Martin in Passeier,40,,29,22,51
083 St.Martin in Passeier,41,,17,19,36
083 St.Martin in Passeier,42,,20,21,41
083 St.Martin in Passeier,43,,23,24,47
083 St.Martin in Passeier,44,,27,25,52
083 St.Martin in Passeier,45,,23,22,45
083 St.Martin in Passeier,46,,24,24,48
083 St.Martin in Passeier,47,,31,23,54
083 St.Martin in Passeier,48,,29,27,56
083 St.Martin in Passeier,49,,26,22,48
083 St.Martin in Passeier,50,,22,26,48
083 St.Martin in Passeier,51,,27,30,57
083 St.Martin in Passeier,52,,35,25,60
083 St.Martin in Passeier,53,,20,19,39
083 St.Martin in Passeier,54,,31,19,50
083 St.Martin in Passeier,55,,23,30,53
083 St.Martin in Passeier,56,,33,22,55
083 St.Martin in Passeier,57,,26,20,46
083 St.Martin in Passeier,58,,20,24,44
083 St.Martin in Passeier,59,,24,19,43
083 St.Martin in Passeier,60,,26,11,37
083 St.Martin in Passeier,61,,18,17,35
083 St.Martin in Passeier,62,,26,16,42
083 St.Martin in Passeier,63,,11,13,24
083 St.Martin in Passeier,64,,21,15,36
083 St.Martin in Passeier,65,,6,20,26
083 St.Martin in Passeier,66,,22,11,33
083 St.Martin in Passeier,67,,12,15,27
083 St.Martin in Passeier,68,,14,11,25
083 St.Martin in Passeier,69,,6,9,15
083 St.Martin in Passeier,70,,14,14,28
083 St.Martin in Passeier,71,,10,9,19
083 St.Martin in Passeier,72,,10,10,20
083 St.Martin in Passeier,73,,16,11,27
083 St.Martin in Passeier,74,,11,11,22
083 St.Martin in Passeier,75,,11,14,25
083 St.Martin in Passeier,76,,8,14,22
083 St.Martin in Passeier,77,,4,11,15
083 St.Martin in Passeier,78,,6,13,19
083 St.Martin in Passeier,79,,7,5,12
083 St.Martin in Passeier,80,,10,18,28
083 St.Martin in Passeier,81,,11,9,20
083 St.Martin in Passeier,82,,6,11,17
083 St.Martin in Passeier,83,,13,7,20
083 St.Martin in Passeier,84,,5,8,13
083 St.Martin in Passeier,85,,3,8,11
083 St.Martin in Passeier,86,,3,6,9
083 St.Martin in Passeier,87,,2,7,9
083 St.Martin in Passeier,88,,2,6,8
083 St.Martin in Passeier,89,,1,5,6
083 St.Martin in Passeier,90,,2,1,3
083 St.Martin in Passeier,91,,-,7,7
083 St.Martin in Passeier,92,,1,1,2
083 St.Martin in Passeier,93,,-,3,3
083 St.Martin in Passeier,94,,1,1,2
083 St.Martin in Passeier,96,,-,3,3
083 St.Martin in Passeier,98,,-,1,1
084 St.Pankraz,0,,8,6,14
084 St.Pankraz,1,,10,6,16
084 St.Pankraz,2,,4,4,8
084 St.Pankraz,3,,2,9,11
084 St.Pankraz,4,,6,3,9
084 St.Pankraz,5,,4,4,8
084 St.Pankraz,6,,8,5,13
084 St.Pankraz,7,,8,5,13
084 St.Pankraz,8,,9,12,21
084 St.Pankraz,9,,9,12,21
084 St.Pankraz,10,,9,11,20
084 St.Pankraz,11,,8,12,20
084 St.Pankraz,12,,11,11,22
084 St.Pankraz,13,,13,9,22
084 St.Pankraz,14,,14,8,22
084 St.Pankraz,15,,7,4,11
084 St.Pankraz,16,,14,15,29
084 St.Pankraz,17,,12,14,26
084 St.Pankraz,18,,8,4,12
084 St.Pankraz,19,,13,6,19
084 St.Pankraz,20,,7,10,17
084 St.Pankraz,21,,9,10,19
084 St.Pankraz,22,,10,7,17
084 St.Pankraz,23,,8,5,13
084 St.Pankraz,24,,5,10,15
084 St.Pankraz,25,,9,8,17
084 St.Pankraz,26,,8,13,21
084 St.Pankraz,27,,8,5,13
084 St.Pankraz,28,,12,16,28
084 St.Pankraz,29,,8,8,16
084 St.Pankraz,30,,8,4,12
084 St.Pankraz,31,,9,1,10
084 St.Pankraz,32,,7,4,11
084 St.Pankraz,33,,8,5,13
084 St.Pankraz,34,,8,4,12
084 St.Pankraz,35,,14,6,20
084 St.Pankraz,36,,5,15,20
084 St.Pankraz,37,,11,7,18
084 St.Pankraz,38,,4,7,11
084 St.Pankraz,39,,11,9,20
084 St.Pankraz,40,,11,11,22
084 St.Pankraz,41,,6,10,16
084 St.Pankraz,42,,8,15,23
084 St.Pankraz,43,,14,12,26
084 St.Pankraz,44,,13,5,18
084 St.Pankraz,45,,10,20,30
084 St.Pankraz,46,,11,12,23
084 St.Pankraz,47,,14,11,25
084 St.Pankraz,48,,20,9,29
084 St.Pankraz,49,,16,16,32
084 St.Pankraz,50,,7,16,23
084 St.Pankraz,51,,13,7,20
084 St.Pankraz,52,,20,13,33
084 St.Pankraz,53,,13,12,25
084 St.Pankraz,54,,11,8,19
084 St.Pankraz,55,,14,8,22
084 St.Pankraz,56,,11,13,24
084 St.Pankraz,57,,12,4,16
084 St.Pankraz,58,,12,13,25
084 St.Pankraz,59,,6,9,15
084 St.Pankraz,60,,9,8,17
084 St.Pankraz,61,,10,16,26
084 St.Pankraz,62,,6,5,11
084 St.Pankraz,63,,11,7,18
084 St.Pankraz,64,,10,11,21
084 St.Pankraz,65,,16,8,24
084 St.Pankraz,66,,5,3,8
084 St.Pankraz,67,,10,5,15
084 St.Pankraz,68,,8,5,13
084 St.Pankraz,69,,6,2,8
084 St.Pankraz,70,,8,6,14
084 St.Pankraz,71,,2,7,9
084 St.Pankraz,72,,3,5,8
084 St.Pankraz,73,,4,7,11
084 St.Pankraz,74,,11,14,25
084 St.Pankraz,75,,9,14,23
084 St.Pankraz,76,,6,11,17
084 St.Pankraz,77,,6,6,12
084 St.Pankraz,78,,8,7,15
084 St.Pankraz,79,,5,10,15
084 St.Pankraz,80,,9,8,17
084 St.Pankraz,81,,5,2,7
084 St.Pankraz,82,,5,2,7
084 St.Pankraz,83,,3,5,8
084 St.Pankraz,84,,6,2,8
084 St.Pankraz,85,,6,8,14
084 St.Pankraz,86,,3,4,7
084 St.Pankraz,87,,2,5,7
084 St.Pankraz,88,,4,8,12
084 St.Pankraz,89,,2,6,8
084 St.Pankraz,90,,4,3,7
084 St.Pankraz,91,,-,1,1
084 St.Pankraz,92,,2,-,2
084 St.Pankraz,93,,-,1,1
084 St.Pankraz,94,,1,2,3
084 St.Pankraz,95,,-,2,2
084 St.Pankraz,97,,-,1,1
084 St.Pankraz,98,,-,1,1
085 St.Christina in Gröden,0,,15,7,22
085 St.Christina in Gröden,1,,11,13,24
085 St.Christina in Gröden,2,,12,7,19
085 St.Christina in Gröden,3,,11,10,21
085 St.Christina in Gröden,4,,13,7,20
085 St.Christina in Gröden,5,,9,11,20
085 St.Christina in Gröden,6,,11,8,19
085 St.Christina in Gröden,7,,10,6,16
085 St.Christina in Gröden,8,,9,5,14
085 St.Christina in Gröden,9,,13,7,20
085 St.Christina in Gröden,10,,9,7,16
085 St.Christina in Gröden,11,,7,10,17
085 St.Christina in Gröden,12,,13,10,23
085 St.Christina in Gröden,13,,13,10,23
085 St.Christina in Gröden,14,,9,8,17
085 St.Christina in Gröden,15,,10,14,24
085 St.Christina in Gröden,16,,12,10,22
085 St.Christina in Gröden,17,,20,12,32
085 St.Christina in Gröden,18,,21,9,30
085 St.Christina in Gröden,19,,9,15,24
085 St.Christina in Gröden,20,,7,12,19
085 St.Christina in Gröden,21,,12,8,20
085 St.Christina in Gröden,22,,15,11,26
085 St.Christina in Gröden,23,,8,16,24
085 St.Christina in Gröden,24,,11,11,22
085 St.Christina in Gröden,25,,16,18,34
085 St.Christina in Gröden,26,,14,15,29
085 St.Christina in Gröden,27,,11,15,26
085 St.Christina in Gröden,28,,5,11,16
085 St.Christina in Gröden,29,,9,11,20
085 St.Christina in Gröden,30,,13,7,20
085 St.Christina in Gröden,31,,15,11,26
085 St.Christina in Gröden,32,,7,10,17
085 St.Christina in Gröden,33,,10,10,20
085 St.Christina in Gröden,34,,20,11,31
085 St.Christina in Gröden,35,,9,8,17
085 St.Christina in Gröden,36,,7,12,19
085 St.Christina in Gröden,37,,14,18,32
085 St.Christina in Gröden,38,,11,12,23
085 St.Christina in Gröden,39,,3,11,14
085 St.Christina in Gröden,40,,10,11,21
085 St.Christina in Gröden,41,,14,17,31
085 St.Christina in Gröden,42,,11,13,24
085 St.Christina in Gröden,43,,12,25,37
085 St.Christina in Gröden,44,,10,13,23
085 St.Christina in Gröden,45,,18,10,28
085 St.Christina in Gröden,46,,15,13,28
085 St.Christina in Gröden,47,,21,19,40
085 St.Christina in Gröden,48,,20,12,32
085 St.Christina in Gröden,49,,25,26,51
085 St.Christina in Gröden,50,,13,15,28
085 St.Christina in Gröden,51,,18,10,28
085 St.Christina in Gröden,52,,12,18,30
085 St.Christina in Gröden,53,,12,21,33
085 St.Christina in Gröden,54,,12,17,29
085 St.Christina in Gröden,55,,17,15,32
085 St.Christina in Gröden,56,,20,15,35
085 St.Christina in Gröden,57,,22,17,39
085 St.Christina in Gröden,58,,11,9,20
085 St.Christina in Gröden,59,,7,12,19
085 St.Christina in Gröden,60,,16,11,27
085 St.Christina in Gröden,61,,11,12,23
085 St.Christina in Gröden,62,,9,9,18
085 St.Christina in Gröden,63,,11,15,26
085 St.Christina in Gröden,64,,9,9,18
085 St.Christina in Gröden,65,,5,6,11
085 St.Christina in Gröden,66,,10,5,15
085 St.Christina in Gröden,67,,6,5,11
085 St.Christina in Gröden,68,,8,9,17
085 St.Christina in Gröden,69,,8,5,13
085 St.Christina in Gröden,70,,6,9,15
085 St.Christina in Gröden,71,,7,9,16
085 St.Christina in Gröden,72,,6,7,13
085 St.Christina in Gröden,73,,5,12,17
085 St.Christina in Gröden,74,,9,14,23
085 St.Christina in Gröden,75,,9,4,13
085 St.Christina in Gröden,76,,11,6,17
085 St.Christina in Gröden,77,,7,9,16
085 St.Christina in Gröden,78,,6,8,14
085 St.Christina in Gröden,79,,6,7,13
085 St.Christina in Gröden,80,,8,4,12
085 St.Christina in Gröden,81,,10,8,18
085 St.Christina in Gröden,82,,11,3,14
085 St.Christina in Gröden,83,,7,11,18
085 St.Christina in Gröden,84,,4,8,12
085 St.Christina in Gröden,85,,5,6,11
085 St.Christina in Gröden,86,,2,4,6
085 St.Christina in Gröden,87,,7,3,10
085 St.Christina in Gröden,88,,1,9,10
085 St.Christina in Gröden,89,,1,2,3
085 St.Christina in Gröden,90,,4,6,10
085 St.Christina in Gröden,91,,2,1,3
085 St.Christina in Gröden,92,,1,2,3
085 St.Christina in Gröden,94,,1,2,3
085 St.Christina in Gröden,95,,-,2,2
085 St.Christina in Gröden,98,,-,1,1
085 St.Christina in Gröden,104,,1,-,1
086 Sarntal,0,,38,41,79
086 Sarntal,1,,37,37,74
086 Sarntal,2,,54,35,89
086 Sarntal,3,,51,39,90
086 Sarntal,4,,48,32,80
086 Sarntal,5,,41,47,88
086 Sarntal,6,,47,44,91
086 Sarntal,7,,41,39,80
086 Sarntal,8,,36,36,72
086 Sarntal,9,,40,55,95
086 Sarntal,10,,53,41,94
086 Sarntal,11,,42,50,92
086 Sarntal,12,,39,37,76
086 Sarntal,13,,40,40,80
086 Sarntal,14,,47,33,80
086 Sarntal,15,,28,42,70
086 Sarntal,16,,49,25,74
086 Sarntal,17,,37,42,79
086 Sarntal,18,,33,36,69
086 Sarntal,19,,52,44,96
086 Sarntal,20,,44,48,92
086 Sarntal,21,,43,44,87
086 Sarntal,22,,44,42,86
086 Sarntal,23,,35,42,77
086 Sarntal,24,,35,41,76
086 Sarntal,25,,43,36,79
086 Sarntal,26,,46,50,96
086 Sarntal,27,,46,27,73
086 Sarntal,28,,55,33,88
086 Sarntal,29,,49,45,94
086 Sarntal,30,,36,38,74
086 Sarntal,31,,38,41,79
086 Sarntal,32,,40,40,80
086 Sarntal,33,,39,42,81
086 Sarntal,34,,57,42,99
086 Sarntal,35,,53,34,87
086 Sarntal,36,,49,51,100
086 Sarntal,37,,55,38,93
086 Sarntal,38,,57,52,109
086 Sarntal,39,,55,57,112
086 Sarntal,40,,53,42,95
086 Sarntal,41,,44,36,80
086 Sarntal,42,,56,50,106
086 Sarntal,43,,44,58,102
086 Sarntal,44,,57,67,124
086 Sarntal,45,,66,40,106
086 Sarntal,46,,45,45,90
086 Sarntal,47,,63,59,122
086 Sarntal,48,,63,54,117
086 Sarntal,49,,50,44,94
086 Sarntal,50,,55,50,105
086 Sarntal,51,,49,47,96
086 Sarntal,52,,63,57,120
086 Sarntal,53,,59,65,124
086 Sarntal,54,,41,48,89
086 Sarntal,55,,58,35,93
086 Sarntal,56,,40,50,90
086 Sarntal,57,,65,45,110
086 Sarntal,58,,39,42,81
086 Sarntal,59,,53,44,97
086 Sarntal,60,,31,40,71
086 Sarntal,61,,36,29,65
086 Sarntal,62,,37,39,76
086 Sarntal,63,,36,28,64
086 Sarntal,64,,41,30,71
086 Sarntal,65,,33,41,74
086 Sarntal,66,,42,32,74
086 Sarntal,67,,37,32,69
086 Sarntal,68,,48,28,76
086 Sarntal,69,,30,39,69
086 Sarntal,70,,32,29,61
086 Sarntal,71,,33,36,69
086 Sarntal,72,,27,29,56
086 Sarntal,73,,27,27,54
086 Sarntal,74,,36,36,72
086 Sarntal,75,,30,34,64
086 Sarntal,76,,29,28,57
086 Sarntal,77,,25,41,66
086 Sarntal,78,,31,27,58
086 Sarntal,79,,25,28,53
086 Sarntal,80,,15,30,45
086 Sarntal,81,,11,19,30
086 Sarntal,82,,12,18,30
086 Sarntal,83,,11,15,26
086 Sarntal,84,,11,12,23
086 Sarntal,85,,11,19,30
086 Sarntal,86,,7,17,24
086 Sarntal,87,,6,10,16
086 Sarntal,88,,10,19,29
086 Sarntal,89,,6,9,15
086 Sarntal,90,,5,19,24
086 Sarntal,91,,3,6,9
086 Sarntal,92,,3,5,8
086 Sarntal,93,,-,7,7
086 Sarntal,94,,-,5,5
086 Sarntal,95,,-,6,6
086 Sarntal,96,,-,2,2
086 Sarntal,98,,-,1,1
087 Schenna,0,,19,14,33
087 Schenna,1,,17,14,31
087 Schenna,2,,17,20,37
087 Schenna,3,,18,14,32
087 Schenna,4,,11,13,24
087 Schenna,5,,16,15,31
087 Schenna,6,,14,15,29
087 Schenna,7,,10,21,31
087 Schenna,8,,11,16,27
087 Schenna,9,,11,19,30
087 Schenna,10,,18,13,31
087 Schenna,11,,20,26,46
087 Schenna,12,,11,9,20
087 Schenna,13,,18,15,33
087 Schenna,14,,14,16,30
087 Schenna,15,,15,19,34
087 Schenna,16,,19,14,33
087 Schenna,17,,19,21,40
087 Schenna,18,,25,18,43
087 Schenna,19,,18,9,27
087 Schenna,20,,12,21,33
087 Schenna,21,,18,18,36
087 Schenna,22,,21,16,37
087 Schenna,23,,20,18,38
087 Schenna,24,,12,9,21
087 Schenna,25,,19,16,35
087 Schenna,26,,12,18,30
087 Schenna,27,,14,18,32
087 Schenna,28,,25,10,35
087 Schenna,29,,18,18,36
087 Schenna,30,,17,11,28
087 Schenna,31,,19,14,33
087 Schenna,32,,12,15,27
087 Schenna,33,,16,18,34
087 Schenna,34,,19,15,34
087 Schenna,35,,12,22,34
087 Schenna,36,,20,17,37
087 Schenna,37,,19,30,49
087 Schenna,38,,28,17,45
087 Schenna,39,,15,17,32
087 Schenna,40,,23,26,49
087 Schenna,41,,20,12,32
087 Schenna,42,,16,32,48
087 Schenna,43,,24,19,43
087 Schenna,44,,28,19,47
087 Schenna,45,,26,16,42
087 Schenna,46,,27,26,53
087 Schenna,47,,23,22,45
087 Schenna,48,,27,21,48
087 Schenna,49,,25,22,47
087 Schenna,50,,27,17,44
087 Schenna,51,,19,18,37
087 Schenna,52,,28,30,58
087 Schenna,53,,18,26,44
087 Schenna,54,,21,20,41
087 Schenna,55,,20,11,31
087 Schenna,56,,30,23,53
087 Schenna,57,,28,24,52
087 Schenna,58,,14,13,27
087 Schenna,59,,20,20,40
087 Schenna,60,,13,18,31
087 Schenna,61,,15,17,32
087 Schenna,62,,9,18,27
087 Schenna,63,,15,16,31
087 Schenna,64,,11,16,27
087 Schenna,65,,10,15,25
087 Schenna,66,,14,12,26
087 Schenna,67,,17,14,31
087 Schenna,68,,18,19,37
087 Schenna,69,,12,17,29
087 Schenna,70,,16,18,34
087 Schenna,71,,14,18,32
087 Schenna,72,,11,13,24
087 Schenna,73,,15,8,23
087 Schenna,74,,18,12,30
087 Schenna,75,,7,18,25
087 Schenna,76,,12,10,22
087 Schenna,77,,10,9,19
087 Schenna,78,,7,11,18
087 Schenna,79,,13,15,28
087 Schenna,80,,6,9,15
087 Schenna,81,,6,10,16
087 Schenna,82,,9,6,15
087 Schenna,83,,10,10,20
087 Schenna,84,,5,4,9
087 Schenna,85,,4,8,12
087 Schenna,86,,4,5,9
087 Schenna,87,,6,4,10
087 Schenna,88,,1,6,7
087 Schenna,89,,3,4,7
087 Schenna,90,,2,4,6
087 Schenna,91,,3,3,6
087 Schenna,92,,-,6,6
087 Schenna,93,,-,2,2
087 Schenna,94,,-,1,1
087 Schenna,95,,1,2,3
087 Schenna,96,,-,2,2
087 Schenna,98,,-,1,1
088 Mühlwald,0,,7,6,13
088 Mühlwald,1,,11,10,21
088 Mühlwald,2,,8,4,12
088 Mühlwald,3,,10,4,14
088 Mühlwald,4,,9,11,20
088 Mühlwald,5,,9,5,14
088 Mühlwald,6,,4,10,14
088 Mühlwald,7,,6,7,13
088 Mühlwald,8,,4,6,10
088 Mühlwald,9,,10,7,17
088 Mühlwald,10,,9,8,17
088 Mühlwald,11,,5,13,18
088 Mühlwald,12,,8,4,12
088 Mühlwald,13,,11,8,19
088 Mühlwald,14,,13,10,23
088 Mühlwald,15,,10,11,21
088 Mühlwald,16,,11,14,25
088 Mühlwald,17,,8,10,18
088 Mühlwald,18,,14,11,25
088 Mühlwald,19,,14,16,30
088 Mühlwald,20,,10,8,18
088 Mühlwald,21,,15,13,28
088 Mühlwald,22,,12,5,17
088 Mühlwald,23,,8,4,12
088 Mühlwald,24,,13,12,25
088 Mühlwald,25,,5,5,10
088 Mühlwald,26,,9,9,18
088 Mühlwald,27,,6,7,13
088 Mühlwald,28,,11,8,19
088 Mühlwald,29,,7,5,12
088 Mühlwald,30,,9,6,15
088 Mühlwald,31,,7,2,9
088 Mühlwald,32,,7,9,16
088 Mühlwald,33,,7,15,22
088 Mühlwald,34,,10,5,15
088 Mühlwald,35,,3,8,11
088 Mühlwald,36,,12,9,21
088 Mühlwald,37,,17,4,21
088 Mühlwald,38,,5,13,18
088 Mühlwald,39,,11,5,16
088 Mühlwald,40,,6,7,13
088 Mühlwald,41,,12,11,23
088 Mühlwald,42,,11,6,17
088 Mühlwald,43,,10,7,17
088 Mühlwald,44,,13,12,25
088 Mühlwald,45,,7,9,16
088 Mühlwald,46,,19,14,33
088 Mühlwald,47,,6,10,16
088 Mühlwald,48,,13,14,27
088 Mühlwald,49,,15,9,24
088 Mühlwald,50,,15,16,31
088 Mühlwald,51,,12,7,19
088 Mühlwald,52,,15,12,27
088 Mühlwald,53,,15,12,27
088 Mühlwald,54,,9,11,20
088 Mühlwald,55,,7,11,18
088 Mühlwald,56,,6,11,17
088 Mühlwald,57,,13,9,22
088 Mühlwald,58,,13,5,18
088 Mühlwald,59,,9,5,14
088 Mühlwald,60,,13,12,25
088 Mühlwald,61,,7,7,14
088 Mühlwald,62,,8,7,15
088 Mühlwald,63,,8,4,12
088 Mühlwald,64,,8,9,17
088 Mühlwald,65,,8,7,15
088 Mühlwald,66,,10,4,14
088 Mühlwald,67,,3,9,12
088 Mühlwald,68,,7,2,9
088 Mühlwald,69,,12,4,16
088 Mühlwald,70,,9,7,16
088 Mühlwald,71,,6,3,9
088 Mühlwald,72,,3,3,6
088 Mühlwald,73,,7,4,11
088 Mühlwald,74,,7,2,9
088 Mühlwald,75,,6,7,13
088 Mühlwald,76,,3,7,10
088 Mühlwald,77,,3,9,12
088 Mühlwald,78,,3,11,14
088 Mühlwald,79,,6,4,10
088 Mühlwald,80,,6,2,8
088 Mühlwald,81,,3,3,6
088 Mühlwald,82,,3,2,5
088 Mühlwald,83,,3,5,8
088 Mühlwald,84,,2,7,9
088 Mühlwald,85,,-,2,2
088 Mühlwald,86,,-,2,2
088 Mühlwald,87,,-,3,3
088 Mühlwald,88,,3,3,6
088 Mühlwald,89,,2,2,4
088 Mühlwald,90,,2,-,2
088 Mühlwald,91,,-,3,3
088 Mühlwald,92,,1,1,2
088 Mühlwald,94,,-,1,1
088 Mühlwald,95,,-,1,1
089 Wolkenstein in Gröden,0,,14,19,33
089 Wolkenstein in Gröden,1,,15,11,26
089 Wolkenstein in Gröden,2,,11,15,26
089 Wolkenstein in Gröden,3,,11,11,22
089 Wolkenstein in Gröden,4,,16,8,24
089 Wolkenstein in Gröden,5,,11,9,20
089 Wolkenstein in Gröden,6,,11,16,27
089 Wolkenstein in Gröden,7,,15,11,26
089 Wolkenstein in Gröden,8,,9,9,18
089 Wolkenstein in Gröden,9,,18,13,31
089 Wolkenstein in Gröden,10,,17,11,28
089 Wolkenstein in Gröden,11,,10,16,26
089 Wolkenstein in Gröden,12,,16,19,35
089 Wolkenstein in Gröden,13,,12,8,20
089 Wolkenstein in Gröden,14,,15,19,34
089 Wolkenstein in Gröden,15,,24,18,42
089 Wolkenstein in Gröden,16,,19,19,38
089 Wolkenstein in Gröden,17,,18,24,42
089 Wolkenstein in Gröden,18,,11,17,28
089 Wolkenstein in Gröden,19,,17,23,40
089 Wolkenstein in Gröden,20,,20,25,45
089 Wolkenstein in Gröden,21,,15,10,25
089 Wolkenstein in Gröden,22,,16,11,27
089 Wolkenstein in Gröden,23,,14,17,31
089 Wolkenstein in Gröden,24,,14,16,30
089 Wolkenstein in Gröden,25,,23,11,34
089 Wolkenstein in Gröden,26,,14,19,33
089 Wolkenstein in Gröden,27,,15,9,24
089 Wolkenstein in Gröden,28,,14,16,30
089 Wolkenstein in Gröden,29,,19,10,29
089 Wolkenstein in Gröden,30,,12,18,30
089 Wolkenstein in Gröden,31,,16,13,29
089 Wolkenstein in Gröden,32,,19,13,32
089 Wolkenstein in Gröden,33,,14,8,22
089 Wolkenstein in Gröden,34,,13,9,22
089 Wolkenstein in Gröden,35,,12,18,30
089 Wolkenstein in Gröden,36,,16,10,26
089 Wolkenstein in Gröden,37,,15,18,33
089 Wolkenstein in Gröden,38,,10,18,28
089 Wolkenstein in Gröden,39,,11,12,23
089 Wolkenstein in Gröden,40,,12,11,23
089 Wolkenstein in Gröden,41,,13,9,22
089 Wolkenstein in Gröden,42,,20,25,45
089 Wolkenstein in Gröden,43,,10,15,25
089 Wolkenstein in Gröden,44,,24,26,50
089 Wolkenstein in Gröden,45,,19,25,44
089 Wolkenstein in Gröden,46,,19,22,41
089 Wolkenstein in Gröden,47,,24,22,46
089 Wolkenstein in Gröden,48,,27,22,49
089 Wolkenstein in Gröden,49,,25,22,47
089 Wolkenstein in Gröden,50,,30,27,57
089 Wolkenstein in Gröden,51,,27,25,52
089 Wolkenstein in Gröden,52,,19,32,51
089 Wolkenstein in Gröden,53,,30,21,51
089 Wolkenstein in Gröden,54,,23,19,42
089 Wolkenstein in Gröden,55,,19,20,39
089 Wolkenstein in Gröden,56,,25,20,45
089 Wolkenstein in Gröden,57,,25,20,45
089 Wolkenstein in Gröden,58,,14,16,30
089 Wolkenstein in Gröden,59,,16,14,30
089 Wolkenstein in Gröden,60,,20,16,36
089 Wolkenstein in Gröden,61,,10,14,24
089 Wolkenstein in Gröden,62,,10,9,19
089 Wolkenstein in Gröden,63,,12,10,22
089 Wolkenstein in Gröden,64,,9,13,22
089 Wolkenstein in Gröden,65,,9,6,15
089 Wolkenstein in Gröden,66,,11,10,21
089 Wolkenstein in Gröden,67,,6,17,23
089 Wolkenstein in Gröden,68,,13,10,23
089 Wolkenstein in Gröden,69,,11,12,23
089 Wolkenstein in Gröden,70,,11,13,24
089 Wolkenstein in Gröden,71,,17,17,34
089 Wolkenstein in Gröden,72,,5,14,19
089 Wolkenstein in Gröden,73,,9,8,17
089 Wolkenstein in Gröden,74,,14,11,25
089 Wolkenstein in Gröden,75,,10,11,21
089 Wolkenstein in Gröden,76,,11,11,22
089 Wolkenstein in Gröden,77,,14,16,30
089 Wolkenstein in Gröden,78,,14,11,25
089 Wolkenstein in Gröden,79,,14,8,22
089 Wolkenstein in Gröden,80,,9,16,25
089 Wolkenstein in Gröden,81,,9,11,20
089 Wolkenstein in Gröden,82,,12,4,16
089 Wolkenstein in Gröden,83,,8,9,17
089 Wolkenstein in Gröden,84,,2,7,9
089 Wolkenstein in Gröden,85,,2,9,11
089 Wolkenstein in Gröden,86,,4,6,10
089 Wolkenstein in Gröden,87,,5,5,10
089 Wolkenstein in Gröden,88,,1,2,3
089 Wolkenstein in Gröden,89,,1,4,5
089 Wolkenstein in Gröden,90,,4,3,7
089 Wolkenstein in Gröden,91,,2,2,4
089 Wolkenstein in Gröden,92,,1,5,6
089 Wolkenstein in Gröden,93,,1,1,2
089 Wolkenstein in Gröden,94,,-,1,1
089 Wolkenstein in Gröden,95,,2,3,5
089 Wolkenstein in Gröden,96,,1,1,2
091 Schnals,0,,8,9,17
091 Schnals,1,,5,5,10
091 Schnals,2,,4,5,9
091 Schnals,3,,10,7,17
091 Schnals,4,,7,2,9
091 Schnals,5,,8,3,11
091 Schnals,6,,6,5,11
091 Schnals,7,,3,5,8
091 Schnals,8,,7,8,15
091 Schnals,9,,9,4,13
091 Schnals,10,,4,4,8
091 Schnals,11,,2,4,6
091 Schnals,12,,4,5,9
091 Schnals,13,,5,6,11
091 Schnals,14,,2,7,9
091 Schnals,15,,12,2,14
091 Schnals,16,,3,4,7
091 Schnals,17,,4,5,9
091 Schnals,18,,5,7,12
091 Schnals,19,,7,14,21
091 Schnals,20,,11,11,22
091 Schnals,21,,5,13,18
091 Schnals,22,,5,8,13
091 Schnals,23,,3,10,13
091 Schnals,24,,8,5,13
091 Schnals,25,,9,4,13
091 Schnals,26,,14,8,22
091 Schnals,27,,5,6,11
091 Schnals,28,,16,8,24
091 Schnals,29,,8,3,11
091 Schnals,30,,10,9,19
091 Schnals,31,,8,5,13
091 Schnals,32,,3,5,8
091 Schnals,33,,10,10,20
091 Schnals,34,,5,5,10
091 Schnals,35,,6,4,10
091 Schnals,36,,13,8,21
091 Schnals,37,,8,8,16
091 Schnals,38,,5,8,13
091 Schnals,39,,8,8,16
091 Schnals,40,,6,10,16
091 Schnals,41,,9,1,10
091 Schnals,42,,7,5,12
091 Schnals,43,,13,7,20
091 Schnals,44,,8,8,16
091 Schnals,45,,9,9,18
091 Schnals,46,,9,6,15
091 Schnals,47,,8,7,15
091 Schnals,48,,11,7,18
091 Schnals,49,,10,7,17
091 Schnals,50,,14,11,25
091 Schnals,51,,13,13,26
091 Schnals,52,,14,7,21
091 Schnals,53,,6,10,16
091 Schnals,54,,9,16,25
091 Schnals,55,,12,9,21
091 Schnals,56,,9,11,20
091 Schnals,57,,11,6,17
091 Schnals,58,,13,12,25
091 Schnals,59,,11,11,22
091 Schnals,60,,11,5,16
091 Schnals,61,,11,4,15
091 Schnals,62,,9,7,16
091 Schnals,63,,8,10,18
091 Schnals,64,,11,7,18
091 Schnals,65,,13,6,19
091 Schnals,66,,11,8,19
091 Schnals,67,,8,7,15
091 Schnals,68,,9,9,18
091 Schnals,69,,3,2,5
091 Schnals,70,,8,7,15
091 Schnals,71,,5,4,9
091 Schnals,72,,6,2,8
091 Schnals,73,,2,7,9
091 Schnals,74,,5,8,13
091 Schnals,75,,3,4,7
091 Schnals,76,,2,4,6
091 Schnals,77,,6,7,13
091 Schnals,78,,2,7,9
091 Schnals,79,,1,10,11
091 Schnals,80,,4,4,8
091 Schnals,81,,4,2,6
091 Schnals,82,,1,4,5
091 Schnals,83,,2,3,5
091 Schnals,84,,3,2,5
091 Schnals,85,,2,7,9
091 Schnals,86,,1,4,5
091 Schnals,87,,-,3,3
091 Schnals,88,,3,4,7
091 Schnals,89,,1,2,3
091 Schnals,90,,1,-,1
091 Schnals,91,,1,2,3
091 Schnals,92,,1,1,2
091 Schnals,93,,-,1,1
091 Schnals,95,,1,2,3
091 Schnals,99,,1,1,2
092 Sexten,0,,9,10,19
092 Sexten,1,,12,7,19
092 Sexten,2,,4,9,13
092 Sexten,3,,7,3,10
092 Sexten,4,,12,7,19
092 Sexten,5,,10,8,18
092 Sexten,6,,10,2,12
092 Sexten,7,,9,6,15
092 Sexten,8,,12,5,17
092 Sexten,9,,7,9,16
092 Sexten,10,,8,16,24
092 Sexten,11,,5,7,12
092 Sexten,12,,11,8,19
092 Sexten,13,,14,5,19
092 Sexten,14,,10,11,21
092 Sexten,15,,18,18,36
092 Sexten,16,,16,12,28
092 Sexten,17,,9,19,28
092 Sexten,18,,9,13,22
092 Sexten,19,,14,6,20
092 Sexten,20,,14,11,25
092 Sexten,21,,15,10,25
092 Sexten,22,,15,14,29
092 Sexten,23,,14,10,24
092 Sexten,24,,9,6,15
092 Sexten,25,,14,10,24
092 Sexten,26,,11,12,23
092 Sexten,27,,12,14,26
092 Sexten,28,,13,9,22
092 Sexten,29,,12,4,16
092 Sexten,30,,10,11,21
092 Sexten,31,,7,8,15
092 Sexten,32,,12,9,21
092 Sexten,33,,9,6,15
092 Sexten,34,,9,6,15
092 Sexten,35,,10,9,19
092 Sexten,36,,14,9,23
092 Sexten,37,,12,10,22
092 Sexten,38,,14,23,37
092 Sexten,39,,13,11,24
092 Sexten,40,,7,6,13
092 Sexten,41,,18,14,32
092 Sexten,42,,9,13,22
092 Sexten,43,,11,5,16
092 Sexten,44,,8,9,17
092 Sexten,45,,11,18,29
092 Sexten,46,,15,16,31
092 Sexten,47,,12,19,31
092 Sexten,48,,18,17,35
092 Sexten,49,,15,18,33
092 Sexten,50,,23,21,44
092 Sexten,51,,14,19,33
092 Sexten,52,,17,20,37
092 Sexten,53,,21,15,36
092 Sexten,54,,27,20,47
092 Sexten,55,,15,17,32
092 Sexten,56,,18,12,30
092 Sexten,57,,19,8,27
092 Sexten,58,,15,14,29
092 Sexten,59,,20,14,34
092 Sexten,60,,17,12,29
092 Sexten,61,,12,14,26
092 Sexten,62,,10,11,21
092 Sexten,63,,11,12,23
092 Sexten,64,,2,10,12
092 Sexten,65,,4,12,16
092 Sexten,66,,7,9,16
092 Sexten,67,,11,7,18
092 Sexten,68,,5,5,10
092 Sexten,69,,9,7,16
092 Sexten,70,,9,3,12
092 Sexten,71,,5,8,13
092 Sexten,72,,6,4,10
092 Sexten,73,,5,11,16
092 Sexten,74,,8,4,12
092 Sexten,75,,5,4,9
092 Sexten,76,,6,16,22
092 Sexten,77,,6,12,18
092 Sexten,78,,2,10,12
092 Sexten,79,,11,10,21
092 Sexten,80,,6,4,10
092 Sexten,81,,6,8,14
092 Sexten,82,,6,11,17
092 Sexten,83,,5,4,9
092 Sexten,84,,2,8,10
092 Sexten,85,,3,7,10
092 Sexten,86,,2,9,11
092 Sexten,87,,3,7,10
092 Sexten,88,,1,6,7
092 Sexten,89,,4,6,10
092 Sexten,90,,1,8,9
092 Sexten,91,,3,3,6
092 Sexten,92,,-,5,5
092 Sexten,93,,1,2,3
092 Sexten,94,,1,3,4
092 Sexten,95,,-,3,3
093 Schlanders,0,,34,34,68
093 Schlanders,1,,23,38,61
093 Schlanders,2,,33,44,77
093 Schlanders,3,,33,33,66
093 Schlanders,4,,30,25,55
093 Schlanders,5,,37,41,78
093 Schlanders,6,,30,23,53
093 Schlanders,7,,31,27,58
093 Schlanders,8,,24,36,60
093 Schlanders,9,,37,25,62
093 Schlanders,10,,33,30,63
093 Schlanders,11,,30,24,54
093 Schlanders,12,,29,36,65
093 Schlanders,13,,27,33,60
093 Schlanders,14,,30,22,52
093 Schlanders,15,,27,34,61
093 Schlanders,16,,34,33,67
093 Schlanders,17,,40,37,77
093 Schlanders,18,,28,39,67
093 Schlanders,19,,40,40,80
093 Schlanders,20,,56,49,105
093 Schlanders,21,,42,37,79
093 Schlanders,22,,36,27,63
093 Schlanders,23,,44,43,87
093 Schlanders,24,,51,42,93
093 Schlanders,25,,39,45,84
093 Schlanders,26,,38,31,69
093 Schlanders,27,,55,45,100
093 Schlanders,28,,40,38,78
093 Schlanders,29,,35,38,73
093 Schlanders,30,,36,34,70
093 Schlanders,31,,41,36,77
093 Schlanders,32,,39,34,73
093 Schlanders,33,,45,39,84
093 Schlanders,34,,34,42,76
093 Schlanders,35,,46,43,89
093 Schlanders,36,,48,44,92
093 Schlanders,37,,35,43,78
093 Schlanders,38,,29,33,62
093 Schlanders,39,,44,32,76
093 Schlanders,40,,34,46,80
093 Schlanders,41,,40,26,66
093 Schlanders,42,,47,39,86
093 Schlanders,43,,46,38,84
093 Schlanders,44,,39,51,90
093 Schlanders,45,,52,40,92
093 Schlanders,46,,44,51,95
093 Schlanders,47,,45,46,91
093 Schlanders,48,,61,45,106
093 Schlanders,49,,48,42,90
093 Schlanders,50,,44,54,98
093 Schlanders,51,,44,59,103
093 Schlanders,52,,57,50,107
093 Schlanders,53,,37,46,83
093 Schlanders,54,,54,56,110
093 Schlanders,55,,47,48,95
093 Schlanders,56,,38,54,92
093 Schlanders,57,,39,37,76
093 Schlanders,58,,36,43,79
093 Schlanders,59,,47,52,99
093 Schlanders,60,,42,36,78
093 Schlanders,61,,27,33,60
093 Schlanders,62,,27,35,62
093 Schlanders,63,,29,31,60
093 Schlanders,64,,35,38,73
093 Schlanders,65,,31,21,52
093 Schlanders,66,,28,30,58
093 Schlanders,67,,22,34,56
093 Schlanders,68,,26,37,63
093 Schlanders,69,,36,25,61
093 Schlanders,70,,23,25,48
093 Schlanders,71,,23,20,43
093 Schlanders,72,,30,17,47
093 Schlanders,73,,23,34,57
093 Schlanders,74,,25,32,57
093 Schlanders,75,,28,31,59
093 Schlanders,76,,28,35,63
093 Schlanders,77,,23,25,48
093 Schlanders,78,,28,30,58
093 Schlanders,79,,13,16,29
093 Schlanders,80,,19,21,40
093 Schlanders,81,,13,21,34
093 Schlanders,82,,10,20,30
093 Schlanders,83,,10,19,29
093 Schlanders,84,,14,24,38
093 Schlanders,85,,10,11,21
093 Schlanders,86,,8,11,19
093 Schlanders,87,,9,15,24
093 Schlanders,88,,7,10,17
093 Schlanders,89,,8,12,20
093 Schlanders,90,,4,11,15
093 Schlanders,91,,2,14,16
093 Schlanders,92,,5,7,12
093 Schlanders,93,,1,3,4
093 Schlanders,94,,3,3,6
093 Schlanders,95,,1,2,3
093 Schlanders,96,,-,4,4
093 Schlanders,97,,-,1,1
093 Schlanders,98,,-,1,1
093 Schlanders,101,,-,1,1
094 Schluderns,0,,10,9,19
094 Schluderns,1,,18,7,25
094 Schluderns,2,,4,13,17
094 Schluderns,3,,11,13,24
094 Schluderns,4,,14,5,19
094 Schluderns,5,,9,11,20
094 Schluderns,6,,12,10,22
094 Schluderns,7,,8,5,13
094 Schluderns,8,,12,9,21
094 Schluderns,9,,7,2,9
094 Schluderns,10,,12,13,25
094 Schluderns,11,,8,8,16
094 Schluderns,12,,7,5,12
094 Schluderns,13,,6,10,16
094 Schluderns,14,,14,9,23
094 Schluderns,15,,15,8,23
094 Schluderns,16,,11,7,18
094 Schluderns,17,,18,9,27
094 Schluderns,18,,7,15,22
094 Schluderns,19,,5,11,16
094 Schluderns,20,,12,10,22
094 Schluderns,21,,12,14,26
094 Schluderns,22,,10,12,22
094 Schluderns,23,,10,15,25
094 Schluderns,24,,18,5,23
094 Schluderns,25,,7,12,19
094 Schluderns,26,,9,10,19
094 Schluderns,27,,18,12,30
094 Schluderns,28,,12,11,23
094 Schluderns,29,,13,10,23
094 Schluderns,30,,8,7,15
094 Schluderns,31,,8,11,19
094 Schluderns,32,,15,14,29
094 Schluderns,33,,8,10,18
094 Schluderns,34,,9,12,21
094 Schluderns,35,,11,12,23
094 Schluderns,36,,19,14,33
094 Schluderns,37,,11,14,25
094 Schluderns,38,,2,14,16
094 Schluderns,39,,12,12,24
094 Schluderns,40,,7,12,19
094 Schluderns,41,,14,15,29
094 Schluderns,42,,17,7,24
094 Schluderns,43,,20,14,34
094 Schluderns,44,,17,11,28
094 Schluderns,45,,15,12,27
094 Schluderns,46,,11,13,24
094 Schluderns,47,,8,10,18
094 Schluderns,48,,15,10,25
094 Schluderns,49,,17,15,32
094 Schluderns,50,,13,14,27
094 Schluderns,51,,19,16,35
094 Schluderns,52,,25,8,33
094 Schluderns,53,,26,12,38
094 Schluderns,54,,13,18,31
094 Schluderns,55,,12,20,32
094 Schluderns,56,,12,18,30
094 Schluderns,57,,7,5,12
094 Schluderns,58,,11,16,27
094 Schluderns,59,,9,15,24
094 Schluderns,60,,17,8,25
094 Schluderns,61,,10,16,26
094 Schluderns,62,,15,11,26
094 Schluderns,63,,13,7,20
094 Schluderns,64,,14,7,21
094 Schluderns,65,,5,5,10
094 Schluderns,66,,11,3,14
094 Schluderns,67,,7,13,20
094 Schluderns,68,,11,9,20
094 Schluderns,69,,8,8,16
094 Schluderns,70,,6,6,12
094 Schluderns,71,,5,10,15
094 Schluderns,72,,5,2,7
094 Schluderns,73,,5,10,15
094 Schluderns,74,,2,7,9
094 Schluderns,75,,5,7,12
094 Schluderns,76,,10,12,22
094 Schluderns,77,,4,5,9
094 Schluderns,78,,7,8,15
094 Schluderns,79,,7,7,14
094 Schluderns,80,,5,9,14
094 Schluderns,81,,1,6,7
094 Schluderns,82,,4,8,12
094 Schluderns,83,,6,10,16
094 Schluderns,84,,5,5,10
094 Schluderns,85,,4,7,11
094 Schluderns,86,,2,3,5
094 Schluderns,87,,2,3,5
094 Schluderns,88,,2,3,5
094 Schluderns,89,,1,3,4
094 Schluderns,90,,1,-,1
094 Schluderns,91,,1,5,6
094 Schluderns,95,,-,1,1
094 Schluderns,96,,-,3,3
094 Schluderns,97,,-,1,1
095 Stilfs,0,,5,6,11
095 Stilfs,1,,5,2,7
095 Stilfs,2,,7,5,12
095 Stilfs,3,,7,7,14
095 Stilfs,4,,6,5,11
095 Stilfs,5,,9,5,14
095 Stilfs,6,,4,2,6
095 Stilfs,7,,2,4,6
095 Stilfs,8,,4,2,6
095 Stilfs,9,,3,4,7
095 Stilfs,10,,4,5,9
095 Stilfs,11,,4,1,5
095 Stilfs,12,,7,5,12
095 Stilfs,13,,6,5,11
095 Stilfs,14,,5,6,11
095 Stilfs,15,,6,2,8
095 Stilfs,16,,4,11,15
095 Stilfs,17,,9,5,14
095 Stilfs,18,,3,6,9
095 Stilfs,19,,8,3,11
095 Stilfs,20,,10,11,21
095 Stilfs,21,,12,1,13
095 Stilfs,22,,5,6,11
095 Stilfs,23,,9,8,17
095 Stilfs,24,,5,12,17
095 Stilfs,25,,3,7,10
095 Stilfs,26,,11,3,14
095 Stilfs,27,,18,9,27
095 Stilfs,28,,7,5,12
095 Stilfs,29,,7,-,7
095 Stilfs,30,,4,5,9
095 Stilfs,31,,10,6,16
095 Stilfs,32,,6,4,10
095 Stilfs,33,,9,10,19
095 Stilfs,34,,8,3,11
095 Stilfs,35,,9,6,15
095 Stilfs,36,,7,8,15
095 Stilfs,37,,4,5,9
095 Stilfs,38,,5,7,12
095 Stilfs,39,,6,8,14
095 Stilfs,40,,5,4,9
095 Stilfs,41,,8,5,13
095 Stilfs,42,,6,8,14
095 Stilfs,43,,6,4,10
095 Stilfs,44,,10,16,26
095 Stilfs,45,,9,7,16
095 Stilfs,46,,10,11,21
095 Stilfs,47,,10,12,22
095 Stilfs,48,,9,11,20
095 Stilfs,49,,7,8,15
095 Stilfs,50,,5,8,13
095 Stilfs,51,,20,8,28
095 Stilfs,52,,13,10,23
095 Stilfs,53,,13,7,20
095 Stilfs,54,,11,6,17
095 Stilfs,55,,7,11,18
095 Stilfs,56,,8,3,11
095 Stilfs,57,,8,7,15
095 Stilfs,58,,9,9,18
095 Stilfs,59,,8,12,20
095 Stilfs,60,,11,6,17
095 Stilfs,61,,5,8,13
095 Stilfs,62,,4,4,8
095 Stilfs,63,,14,7,21
095 Stilfs,64,,7,4,11
095 Stilfs,65,,9,5,14
095 Stilfs,66,,14,8,22
095 Stilfs,67,,1,6,7
095 Stilfs,68,,5,3,8
095 Stilfs,69,,7,9,16
095 Stilfs,70,,6,4,10
095 Stilfs,71,,9,9,18
095 Stilfs,72,,2,4,6
095 Stilfs,73,,12,9,21
095 Stilfs,74,,7,6,13
095 Stilfs,75,,2,12,14
095 Stilfs,76,,6,4,10
095 Stilfs,77,,4,6,10
095 Stilfs,78,,3,5,8
095 Stilfs,79,,1,4,5
095 Stilfs,80,,4,5,9
095 Stilfs,81,,1,9,10
095 Stilfs,82,,-,5,5
095 Stilfs,83,,2,4,6
095 Stilfs,84,,2,6,8
095 Stilfs,85,,2,3,5
095 Stilfs,86,,2,1,3
095 Stilfs,87,,1,2,3
095 Stilfs,88,,1,-,1
095 Stilfs,89,,1,4,5
095 Stilfs,90,,1,2,3
095 Stilfs,91,,-,2,2
095 Stilfs,92,,1,-,1
095 Stilfs,93,,-,1,1
095 Stilfs,95,,-,2,2
095 Stilfs,96,,-,1,1
096 Terenten,0,,5,11,16
096 Terenten,1,,13,12,25
096 Terenten,2,,11,8,19
096 Terenten,3,,17,8,25
096 Terenten,4,,11,10,21
096 Terenten,5,,5,10,15
096 Terenten,6,,8,8,16
096 Terenten,7,,4,8,12
096 Terenten,8,,13,7,20
096 Terenten,9,,10,4,14
096 Terenten,10,,8,11,19
096 Terenten,11,,15,10,25
096 Terenten,12,,17,9,26
096 Terenten,13,,10,19,29
096 Terenten,14,,9,12,21
096 Terenten,15,,8,7,15
096 Terenten,16,,14,15,29
096 Terenten,17,,10,8,18
096 Terenten,18,,10,18,28
096 Terenten,19,,22,19,41
096 Terenten,20,,9,8,17
096 Terenten,21,,14,10,24
096 Terenten,22,,12,9,21
096 Terenten,23,,12,13,25
096 Terenten,24,,7,13,20
096 Terenten,25,,11,10,21
096 Terenten,26,,6,18,24
096 Terenten,27,,13,14,27
096 Terenten,28,,14,8,22
096 Terenten,29,,8,10,18
096 Terenten,30,,12,8,20
096 Terenten,31,,12,5,17
096 Terenten,32,,7,11,18
096 Terenten,33,,9,9,18
096 Terenten,34,,13,11,24
096 Terenten,35,,12,10,22
096 Terenten,36,,14,14,28
096 Terenten,37,,7,7,14
096 Terenten,38,,8,10,18
096 Terenten,39,,14,19,33
096 Terenten,40,,9,4,13
096 Terenten,41,,14,10,24
096 Terenten,42,,15,10,25
096 Terenten,43,,14,17,31
096 Terenten,44,,8,15,23
096 Terenten,45,,17,11,28
096 Terenten,46,,17,15,32
096 Terenten,47,,20,12,32
096 Terenten,48,,16,13,29
096 Terenten,49,,12,14,26
096 Terenten,50,,17,18,35
096 Terenten,51,,14,17,31
096 Terenten,52,,15,9,24
096 Terenten,53,,17,12,29
096 Terenten,54,,23,12,35
096 Terenten,55,,20,12,32
096 Terenten,56,,11,19,30
096 Terenten,57,,12,9,21
096 Terenten,58,,13,10,23
096 Terenten,59,,14,8,22
096 Terenten,60,,12,8,20
096 Terenten,61,,9,12,21
096 Terenten,62,,12,11,23
096 Terenten,63,,13,10,23
096 Terenten,64,,10,8,18
096 Terenten,65,,6,7,13
096 Terenten,66,,6,5,11
096 Terenten,67,,8,6,14
096 Terenten,68,,7,5,12
096 Terenten,69,,10,8,18
096 Terenten,70,,7,3,10
096 Terenten,71,,8,4,12
096 Terenten,72,,6,4,10
096 Terenten,73,,3,6,9
096 Terenten,74,,7,5,12
096 Terenten,75,,5,5,10
096 Terenten,76,,3,4,7
096 Terenten,77,,7,5,12
096 Terenten,78,,2,6,8
096 Terenten,79,,4,8,12
096 Terenten,80,,4,5,9
096 Terenten,81,,2,6,8
096 Terenten,82,,3,4,7
096 Terenten,83,,1,1,2
096 Terenten,84,,3,2,5
096 Terenten,85,,2,1,3
096 Terenten,86,,4,8,12
096 Terenten,87,,2,2,4
096 Terenten,88,,3,2,5
096 Terenten,89,,1,4,5
096 Terenten,90,,-,2,2
096 Terenten,91,,1,3,4
096 Terenten,92,,1,-,1
096 Terenten,93,,-,1,1
096 Terenten,96,,-,1,1
097 Terlan,0,,23,24,47
097 Terlan,1,,21,17,38
097 Terlan,2,,21,19,40
097 Terlan,3,,29,17,46
097 Terlan,4,,23,29,52
097 Terlan,5,,35,21,56
097 Terlan,6,,37,36,73
097 Terlan,7,,21,16,37
097 Terlan,8,,34,30,64
097 Terlan,9,,30,25,55
097 Terlan,10,,21,21,42
097 Terlan,11,,21,27,48
097 Terlan,12,,19,25,44
097 Terlan,13,,30,24,54
097 Terlan,14,,22,25,47
097 Terlan,15,,23,21,44
097 Terlan,16,,21,27,48
097 Terlan,17,,33,27,60
097 Terlan,18,,30,18,48
097 Terlan,19,,24,21,45
097 Terlan,20,,39,30,69
097 Terlan,21,,18,29,47
097 Terlan,22,,27,26,53
097 Terlan,23,,23,20,43
097 Terlan,24,,29,19,48
097 Terlan,25,,23,27,50
097 Terlan,26,,27,18,45
097 Terlan,27,,19,23,42
097 Terlan,28,,19,23,42
097 Terlan,29,,24,22,46
097 Terlan,30,,28,29,57
097 Terlan,31,,20,24,44
097 Terlan,32,,26,25,51
097 Terlan,33,,23,13,36
097 Terlan,34,,25,19,44
097 Terlan,35,,19,30,49
097 Terlan,36,,26,19,45
097 Terlan,37,,36,39,75
097 Terlan,38,,21,27,48
097 Terlan,39,,23,35,58
097 Terlan,40,,42,30,72
097 Terlan,41,,37,41,78
097 Terlan,42,,39,39,78
097 Terlan,43,,34,48,82
097 Terlan,44,,30,37,67
097 Terlan,45,,42,31,73
097 Terlan,46,,32,26,58
097 Terlan,47,,42,46,88
097 Terlan,48,,33,36,69
097 Terlan,49,,35,35,70
097 Terlan,50,,32,39,71
097 Terlan,51,,40,30,70
097 Terlan,52,,32,29,61
097 Terlan,53,,39,28,67
097 Terlan,54,,31,31,62
097 Terlan,55,,28,38,66
097 Terlan,56,,40,30,70
097 Terlan,57,,28,36,64
097 Terlan,58,,19,25,44
097 Terlan,59,,32,26,58
097 Terlan,60,,23,29,52
097 Terlan,61,,30,32,62
097 Terlan,62,,26,27,53
097 Terlan,63,,27,20,47
097 Terlan,64,,14,23,37
097 Terlan,65,,18,24,42
097 Terlan,66,,20,15,35
097 Terlan,67,,21,22,43
097 Terlan,68,,17,13,30
097 Terlan,69,,17,24,41
097 Terlan,70,,14,20,34
097 Terlan,71,,9,23,32
097 Terlan,72,,20,21,41
097 Terlan,73,,23,21,44
097 Terlan,74,,12,25,37
097 Terlan,75,,29,21,50
097 Terlan,76,,21,23,44
097 Terlan,77,,17,15,32
097 Terlan,78,,15,15,30
097 Terlan,79,,14,15,29
097 Terlan,80,,10,14,24
097 Terlan,81,,5,10,15
097 Terlan,82,,12,15,27
097 Terlan,83,,5,18,23
097 Terlan,84,,8,13,21
097 Terlan,85,,8,8,16
097 Terlan,86,,15,8,23
097 Terlan,87,,6,9,15
097 Terlan,88,,6,10,16
097 Terlan,89,,5,7,12
097 Terlan,90,,3,6,9
097 Terlan,91,,3,6,9
097 Terlan,92,,1,4,5
097 Terlan,93,,-,8,8
097 Terlan,94,,1,7,8
097 Terlan,95,,2,3,5
097 Terlan,96,,-,3,3
097 Terlan,97,,-,2,2
097 Terlan,98,,-,1,1
097 Terlan,99,,-,1,1
097 Terlan,101,,-,2,2
098 Tramin a.d. Weinstr.,0,,20,20,40
098 Tramin a.d. Weinstr.,1,,25,19,44
098 Tramin a.d. Weinstr.,2,,21,14,35
098 Tramin a.d. Weinstr.,3,,22,25,47
098 Tramin a.d. Weinstr.,4,,25,16,41
098 Tramin a.d. Weinstr.,5,,17,22,39
098 Tramin a.d. Weinstr.,6,,13,12,25
098 Tramin a.d. Weinstr.,7,,20,17,37
098 Tramin a.d. Weinstr.,8,,20,13,33
098 Tramin a.d. Weinstr.,9,,18,12,30
098 Tramin a.d. Weinstr.,10,,17,14,31
098 Tramin a.d. Weinstr.,11,,14,10,24
098 Tramin a.d. Weinstr.,12,,16,13,29
098 Tramin a.d. Weinstr.,13,,13,18,31
098 Tramin a.d. Weinstr.,14,,27,13,40
098 Tramin a.d. Weinstr.,15,,18,18,36
098 Tramin a.d. Weinstr.,16,,21,19,40
098 Tramin a.d. Weinstr.,17,,26,16,42
098 Tramin a.d. Weinstr.,18,,18,17,35
098 Tramin a.d. Weinstr.,19,,16,22,38
098 Tramin a.d. Weinstr.,20,,25,16,41
098 Tramin a.d. Weinstr.,21,,21,30,51
098 Tramin a.d. Weinstr.,22,,21,22,43
098 Tramin a.d. Weinstr.,23,,21,18,39
098 Tramin a.d. Weinstr.,24,,16,18,34
098 Tramin a.d. Weinstr.,25,,21,23,44
098 Tramin a.d. Weinstr.,26,,17,13,30
098 Tramin a.d. Weinstr.,27,,23,24,47
098 Tramin a.d. Weinstr.,28,,21,29,50
098 Tramin a.d. Weinstr.,29,,14,31,45
098 Tramin a.d. Weinstr.,30,,19,22,41
098 Tramin a.d. Weinstr.,31,,17,14,31
098 Tramin a.d. Weinstr.,32,,23,24,47
098 Tramin a.d. Weinstr.,33,,19,15,34
098 Tramin a.d. Weinstr.,34,,15,19,34
098 Tramin a.d. Weinstr.,35,,22,29,51
098 Tramin a.d. Weinstr.,36,,30,13,43
098 Tramin a.d. Weinstr.,37,,26,23,49
098 Tramin a.d. Weinstr.,38,,17,15,32
098 Tramin a.d. Weinstr.,39,,14,23,37
098 Tramin a.d. Weinstr.,40,,24,18,42
098 Tramin a.d. Weinstr.,41,,27,22,49
098 Tramin a.d. Weinstr.,42,,21,15,36
098 Tramin a.d. Weinstr.,43,,28,16,44
098 Tramin a.d. Weinstr.,44,,20,20,40
098 Tramin a.d. Weinstr.,45,,18,27,45
098 Tramin a.d. Weinstr.,46,,20,33,53
098 Tramin a.d. Weinstr.,47,,27,21,48
098 Tramin a.d. Weinstr.,48,,28,33,61
098 Tramin a.d. Weinstr.,49,,27,21,48
098 Tramin a.d. Weinstr.,50,,27,31,58
098 Tramin a.d. Weinstr.,51,,33,24,57
098 Tramin a.d. Weinstr.,52,,32,26,58
098 Tramin a.d. Weinstr.,53,,27,32,59
098 Tramin a.d. Weinstr.,54,,24,20,44
098 Tramin a.d. Weinstr.,55,,25,15,40
098 Tramin a.d. Weinstr.,56,,31,23,54
098 Tramin a.d. Weinstr.,57,,26,34,60
098 Tramin a.d. Weinstr.,58,,16,31,47
098 Tramin a.d. Weinstr.,59,,28,21,49
098 Tramin a.d. Weinstr.,60,,17,22,39
098 Tramin a.d. Weinstr.,61,,21,21,42
098 Tramin a.d. Weinstr.,62,,16,18,34
098 Tramin a.d. Weinstr.,63,,18,19,37
098 Tramin a.d. Weinstr.,64,,15,13,28
098 Tramin a.d. Weinstr.,65,,19,18,37
098 Tramin a.d. Weinstr.,66,,12,14,26
098 Tramin a.d. Weinstr.,67,,16,19,35
098 Tramin a.d. Weinstr.,68,,15,17,32
098 Tramin a.d. Weinstr.,69,,16,18,34
098 Tramin a.d. Weinstr.,70,,13,21,34
098 Tramin a.d. Weinstr.,71,,18,18,36
098 Tramin a.d. Weinstr.,72,,6,9,15
098 Tramin a.d. Weinstr.,73,,22,24,46
098 Tramin a.d. Weinstr.,74,,16,20,36
098 Tramin a.d. Weinstr.,75,,20,15,35
098 Tramin a.d. Weinstr.,76,,12,24,36
098 Tramin a.d. Weinstr.,77,,19,13,32
098 Tramin a.d. Weinstr.,78,,9,11,20
098 Tramin a.d. Weinstr.,79,,4,17,21
098 Tramin a.d. Weinstr.,80,,11,11,22
098 Tramin a.d. Weinstr.,81,,12,14,26
098 Tramin a.d. Weinstr.,82,,10,11,21
098 Tramin a.d. Weinstr.,83,,8,12,20
098 Tramin a.d. Weinstr.,84,,4,9,13
098 Tramin a.d. Weinstr.,85,,6,14,20
098 Tramin a.d. Weinstr.,86,,4,11,15
098 Tramin a.d. Weinstr.,87,,7,10,17
098 Tramin a.d. Weinstr.,88,,4,11,15
098 Tramin a.d. Weinstr.,89,,7,3,10
098 Tramin a.d. Weinstr.,90,,4,5,9
098 Tramin a.d. Weinstr.,91,,3,8,11
098 Tramin a.d. Weinstr.,92,,3,10,13
098 Tramin a.d. Weinstr.,93,,-,3,3
098 Tramin a.d. Weinstr.,94,,-,2,2
098 Tramin a.d. Weinstr.,95,,-,4,4
098 Tramin a.d. Weinstr.,96,,1,1,2
098 Tramin a.d. Weinstr.,97,,-,3,3
099 Tisens,0,,13,7,20
099 Tisens,1,,16,9,25
099 Tisens,2,,6,7,13
099 Tisens,3,,10,8,18
099 Tisens,4,,6,8,14
099 Tisens,5,,7,14,21
099 Tisens,6,,6,9,15
099 Tisens,7,,8,8,16
099 Tisens,8,,5,2,7
099 Tisens,9,,15,10,25
099 Tisens,10,,11,9,20
099 Tisens,11,,9,8,17
099 Tisens,12,,12,18,30
099 Tisens,13,,12,14,26
099 Tisens,14,,9,12,21
099 Tisens,15,,13,9,22
099 Tisens,16,,10,19,29
099 Tisens,17,,11,11,22
099 Tisens,18,,10,7,17
099 Tisens,19,,15,14,29
099 Tisens,20,,9,6,15
099 Tisens,21,,16,8,24
099 Tisens,22,,12,7,19
099 Tisens,23,,15,13,28
099 Tisens,24,,5,11,16
099 Tisens,25,,6,17,23
099 Tisens,26,,16,8,24
099 Tisens,27,,16,13,29
099 Tisens,28,,14,13,27
099 Tisens,29,,16,20,36
099 Tisens,30,,14,7,21
099 Tisens,31,,16,9,25
099 Tisens,32,,9,11,20
099 Tisens,33,,13,12,25
099 Tisens,34,,18,6,24
099 Tisens,35,,20,15,35
099 Tisens,36,,11,16,27
099 Tisens,37,,9,13,22
099 Tisens,38,,11,11,22
099 Tisens,39,,13,22,35
099 Tisens,40,,13,11,24
099 Tisens,41,,9,6,15
099 Tisens,42,,16,12,28
099 Tisens,43,,14,10,24
099 Tisens,44,,11,13,24
099 Tisens,45,,10,13,23
099 Tisens,46,,17,13,30
099 Tisens,47,,15,18,33
099 Tisens,48,,17,18,35
099 Tisens,49,,20,18,38
099 Tisens,50,,22,21,43
099 Tisens,51,,20,10,30
099 Tisens,52,,18,30,48
099 Tisens,53,,16,9,25
099 Tisens,54,,18,13,31
099 Tisens,55,,19,7,26
099 Tisens,56,,13,10,23
099 Tisens,57,,15,7,22
099 Tisens,58,,13,12,25
099 Tisens,59,,11,14,25
099 Tisens,60,,15,18,33
099 Tisens,61,,10,13,23
099 Tisens,62,,17,11,28
099 Tisens,63,,6,8,14
099 Tisens,64,,11,10,21
099 Tisens,65,,6,13,19
099 Tisens,66,,14,11,25
099 Tisens,67,,9,4,13
099 Tisens,68,,5,6,11
099 Tisens,69,,14,7,21
099 Tisens,70,,9,9,18
099 Tisens,71,,7,7,14
099 Tisens,72,,3,6,9
099 Tisens,73,,7,12,19
099 Tisens,74,,12,7,19
099 Tisens,75,,9,11,20
099 Tisens,76,,6,10,16
099 Tisens,77,,3,7,10
099 Tisens,78,,9,9,18
099 Tisens,79,,5,12,17
099 Tisens,80,,4,4,8
099 Tisens,81,,6,6,12
099 Tisens,82,,4,10,14
099 Tisens,83,,5,5,10
099 Tisens,84,,3,8,11
099 Tisens,85,,5,7,12
099 Tisens,86,,3,6,9
099 Tisens,87,,2,13,15
099 Tisens,88,,2,3,5
099 Tisens,89,,1,5,6
099 Tisens,90,,2,3,5
099 Tisens,91,,2,7,9
099 Tisens,92,,1,6,7
099 Tisens,93,,1,3,4
099 Tisens,94,,-,2,2
099 Tisens,95,,1,1,2
099 Tisens,97,,1,1,2
099 Tisens,98,,1,-,1
100 Tiers,0,,3,5,8
100 Tiers,1,,4,6,10
100 Tiers,2,,4,5,9
100 Tiers,3,,8,4,12
100 Tiers,4,,6,6,12
100 Tiers,5,,4,7,11
100 Tiers,6,,2,6,8
100 Tiers,7,,8,6,14
100 Tiers,8,,3,4,7
100 Tiers,9,,9,7,16
100 Tiers,10,,8,3,11
100 Tiers,11,,2,6,8
100 Tiers,12,,2,10,12
100 Tiers,13,,5,2,7
100 Tiers,14,,4,8,12
100 Tiers,15,,6,4,10
100 Tiers,16,,2,9,11
100 Tiers,17,,2,7,9
100 Tiers,18,,4,9,13
100 Tiers,19,,4,9,13
100 Tiers,20,,9,6,15
100 Tiers,21,,6,2,8
100 Tiers,22,,7,10,17
100 Tiers,23,,4,7,11
100 Tiers,24,,5,2,7
100 Tiers,25,,5,3,8
100 Tiers,26,,6,7,13
100 Tiers,27,,7,8,15
100 Tiers,28,,4,5,9
100 Tiers,29,,8,9,17
100 Tiers,30,,4,7,11
100 Tiers,31,,10,8,18
100 Tiers,32,,5,4,9
100 Tiers,33,,3,9,12
100 Tiers,34,,8,5,13
100 Tiers,35,,6,3,9
100 Tiers,36,,5,8,13
100 Tiers,37,,5,5,10
100 Tiers,38,,1,3,4
100 Tiers,39,,12,7,19
100 Tiers,40,,5,2,7
100 Tiers,41,,2,4,6
100 Tiers,42,,10,8,18
100 Tiers,43,,4,8,12
100 Tiers,44,,9,6,15
100 Tiers,45,,10,7,17
100 Tiers,46,,4,7,11
100 Tiers,47,,6,8,14
100 Tiers,48,,15,11,26
100 Tiers,49,,7,3,10
100 Tiers,50,,10,12,22
100 Tiers,51,,9,6,15
100 Tiers,52,,5,5,10
100 Tiers,53,,9,6,15
100 Tiers,54,,6,11,17
100 Tiers,55,,6,6,12
100 Tiers,56,,6,5,11
100 Tiers,57,,4,9,13
100 Tiers,58,,12,6,18
100 Tiers,59,,8,4,12
100 Tiers,60,,5,8,13
100 Tiers,61,,9,7,16
100 Tiers,62,,7,4,11
100 Tiers,63,,6,5,11
100 Tiers,64,,5,6,11
100 Tiers,65,,4,2,6
100 Tiers,66,,1,4,5
100 Tiers,67,,9,5,14
100 Tiers,68,,3,4,7
100 Tiers,69,,3,5,8
100 Tiers,70,,-,4,4
100 Tiers,71,,5,4,9
100 Tiers,72,,8,3,11
100 Tiers,73,,2,4,6
100 Tiers,74,,10,10,20
100 Tiers,75,,2,5,7
100 Tiers,76,,2,4,6
100 Tiers,77,,2,2,4
100 Tiers,78,,5,6,11
100 Tiers,79,,6,5,11
100 Tiers,80,,4,4,8
100 Tiers,81,,3,5,8
100 Tiers,82,,6,3,9
100 Tiers,83,,2,5,7
100 Tiers,84,,2,2,4
100 Tiers,85,,2,4,6
100 Tiers,86,,2,3,5
100 Tiers,87,,2,-,2
100 Tiers,88,,1,1,2
100 Tiers,89,,2,1,3
100 Tiers,90,,1,1,2
100 Tiers,92,,3,-,3
100 Tiers,93,,1,2,3
100 Tiers,94,,-,1,1
100 Tiers,96,,-,1,1
100 Tiers,99,,1,1,2
100 Tiers,100,,-,1,1
101 Tirol,0,,8,13,21
101 Tirol,1,,13,13,26
101 Tirol,2,,17,10,27
101 Tirol,3,,9,10,19
101 Tirol,4,,12,7,19
101 Tirol,5,,17,12,29
101 Tirol,6,,7,16,23
101 Tirol,7,,17,14,31
101 Tirol,8,,11,8,19
101 Tirol,9,,11,16,27
101 Tirol,10,,13,10,23
101 Tirol,11,,12,11,23
101 Tirol,12,,14,5,19
101 Tirol,13,,13,15,28
101 Tirol,14,,11,12,23
101 Tirol,15,,16,11,27
101 Tirol,16,,17,11,28
101 Tirol,17,,20,12,32
101 Tirol,18,,14,17,31
101 Tirol,19,,17,13,30
101 Tirol,20,,21,24,45
101 Tirol,21,,22,18,40
101 Tirol,22,,13,18,31
101 Tirol,23,,13,15,28
101 Tirol,24,,19,12,31
101 Tirol,25,,13,14,27
101 Tirol,26,,5,8,13
101 Tirol,27,,15,11,26
101 Tirol,28,,10,18,28
101 Tirol,29,,13,19,32
101 Tirol,30,,14,11,25
101 Tirol,31,,11,15,26
101 Tirol,32,,13,16,29
101 Tirol,33,,14,15,29
101 Tirol,34,,13,15,28
101 Tirol,35,,17,12,29
101 Tirol,36,,15,16,31
101 Tirol,37,,18,6,24
101 Tirol,38,,12,11,23
101 Tirol,39,,8,11,19
101 Tirol,40,,13,19,32
101 Tirol,41,,13,16,29
101 Tirol,42,,20,16,36
101 Tirol,43,,17,19,36
101 Tirol,44,,23,15,38
101 Tirol,45,,25,21,46
101 Tirol,46,,22,22,44
101 Tirol,47,,16,16,32
101 Tirol,48,,20,22,42
101 Tirol,49,,26,25,51
101 Tirol,50,,23,19,42
101 Tirol,51,,23,18,41
101 Tirol,52,,23,19,42
101 Tirol,53,,27,21,48
101 Tirol,54,,18,16,34
101 Tirol,55,,17,19,36
101 Tirol,56,,17,21,38
101 Tirol,57,,24,15,39
101 Tirol,58,,14,16,30
101 Tirol,59,,9,14,23
101 Tirol,60,,15,20,35
101 Tirol,61,,6,14,20
101 Tirol,62,,14,15,29
101 Tirol,63,,14,17,31
101 Tirol,64,,17,16,33
101 Tirol,65,,11,14,25
101 Tirol,66,,14,16,30
101 Tirol,67,,14,10,24
101 Tirol,68,,14,17,31
101 Tirol,69,,18,14,32
101 Tirol,70,,9,12,21
101 Tirol,71,,12,6,18
101 Tirol,72,,10,12,22
101 Tirol,73,,12,15,27
101 Tirol,74,,11,13,24
101 Tirol,75,,11,17,28
101 Tirol,76,,9,12,21
101 Tirol,77,,8,14,22
101 Tirol,78,,6,10,16
101 Tirol,79,,6,8,14
101 Tirol,80,,5,14,19
101 Tirol,81,,4,6,10
101 Tirol,82,,5,5,10
101 Tirol,83,,12,7,19
101 Tirol,84,,4,10,14
101 Tirol,85,,4,5,9
101 Tirol,86,,2,5,7
101 Tirol,87,,3,3,6
101 Tirol,88,,4,8,12
101 Tirol,89,,-,5,5
101 Tirol,90,,3,7,10
101 Tirol,91,,-,1,1
101 Tirol,92,,2,2,4
101 Tirol,93,,1,3,4
101 Tirol,94,,-,1,1
101 Tirol,95,,1,1,2
101 Tirol,97,,-,2,2
101 Tirol,101,,1,-,1
102 Truden im Naturpark,0,,5,6,11
102 Truden im Naturpark,1,,5,4,9
102 Truden im Naturpark,2,,4,4,8
102 Truden im Naturpark,3,,3,4,7
102 Truden im Naturpark,4,,11,6,17
102 Truden im Naturpark,5,,4,9,13
102 Truden im Naturpark,6,,2,2,4
102 Truden im Naturpark,7,,11,8,19
102 Truden im Naturpark,8,,10,7,17
102 Truden im Naturpark,9,,4,7,11
102 Truden im Naturpark,10,,9,10,19
102 Truden im Naturpark,11,,4,1,5
102 Truden im Naturpark,12,,3,5,8
102 Truden im Naturpark,13,,5,8,13
102 Truden im Naturpark,14,,5,4,9
102 Truden im Naturpark,15,,1,5,6
102 Truden im Naturpark,16,,4,2,6
102 Truden im Naturpark,17,,8,6,14
102 Truden im Naturpark,18,,-,1,1
102 Truden im Naturpark,19,,2,8,10
102 Truden im Naturpark,20,,5,6,11
102 Truden im Naturpark,21,,5,5,10
102 Truden im Naturpark,22,,6,5,11
102 Truden im Naturpark,23,,5,5,10
102 Truden im Naturpark,24,,11,5,16
102 Truden im Naturpark,25,,7,5,12
102 Truden im Naturpark,26,,6,4,10
102 Truden im Naturpark,27,,2,4,6
102 Truden im Naturpark,28,,10,9,19
102 Truden im Naturpark,29,,8,13,21
102 Truden im Naturpark,30,,8,7,15
102 Truden im Naturpark,31,,4,7,11
102 Truden im Naturpark,32,,9,8,17
102 Truden im Naturpark,33,,9,2,11
102 Truden im Naturpark,34,,5,8,13
102 Truden im Naturpark,35,,9,5,14
102 Truden im Naturpark,36,,6,11,17
102 Truden im Naturpark,37,,7,6,13
102 Truden im Naturpark,38,,8,4,12
102 Truden im Naturpark,39,,7,6,13
102 Truden im Naturpark,40,,3,7,10
102 Truden im Naturpark,41,,11,7,18
102 Truden im Naturpark,42,,9,3,12
102 Truden im Naturpark,43,,6,10,16
102 Truden im Naturpark,44,,6,9,15
102 Truden im Naturpark,45,,9,8,17
102 Truden im Naturpark,46,,3,3,6
102 Truden im Naturpark,47,,2,8,10
102 Truden im Naturpark,48,,9,9,18
102 Truden im Naturpark,49,,8,7,15
102 Truden im Naturpark,50,,11,7,18
102 Truden im Naturpark,51,,6,12,18
102 Truden im Naturpark,52,,7,7,14
102 Truden im Naturpark,53,,10,8,18
102 Truden im Naturpark,54,,12,7,19
102 Truden im Naturpark,55,,10,4,14
102 Truden im Naturpark,56,,9,5,14
102 Truden im Naturpark,57,,6,12,18
102 Truden im Naturpark,58,,6,8,14
102 Truden im Naturpark,59,,6,11,17
102 Truden im Naturpark,60,,5,7,12
102 Truden im Naturpark,61,,5,6,11
102 Truden im Naturpark,62,,8,9,17
102 Truden im Naturpark,63,,5,7,12
102 Truden im Naturpark,64,,10,6,16
102 Truden im Naturpark,65,,2,6,8
102 Truden im Naturpark,66,,9,7,16
102 Truden im Naturpark,67,,3,3,6
102 Truden im Naturpark,68,,4,4,8
102 Truden im Naturpark,69,,1,5,6
102 Truden im Naturpark,70,,6,2,8
102 Truden im Naturpark,71,,9,6,15
102 Truden im Naturpark,72,,5,3,8
102 Truden im Naturpark,73,,3,6,9
102 Truden im Naturpark,74,,5,4,9
102 Truden im Naturpark,75,,3,5,8
102 Truden im Naturpark,76,,4,6,10
102 Truden im Naturpark,77,,2,4,6
102 Truden im Naturpark,78,,7,2,9
102 Truden im Naturpark,79,,3,5,8
102 Truden im Naturpark,80,,1,4,5
102 Truden im Naturpark,81,,3,2,5
102 Truden im Naturpark,82,,3,1,4
102 Truden im Naturpark,83,,4,1,5
102 Truden im Naturpark,84,,2,6,8
102 Truden im Naturpark,85,,1,2,3
102 Truden im Naturpark,86,,1,2,3
102 Truden im Naturpark,87,,-,4,4
102 Truden im Naturpark,88,,-,4,4
102 Truden im Naturpark,89,,-,3,3
102 Truden im Naturpark,90,,-,1,1
102 Truden im Naturpark,91,,-,2,2
102 Truden im Naturpark,92,,-,3,3
102 Truden im Naturpark,93,,-,1,1
102 Truden im Naturpark,94,,-,2,2
102 Truden im Naturpark,95,,-,2,2
102 Truden im Naturpark,96,,-,1,1
103 Taufers im Münstertal,0,,9,8,17
103 Taufers im Münstertal,1,,2,4,6
103 Taufers im Münstertal,2,,5,11,16
103 Taufers im Münstertal,3,,1,7,8
103 Taufers im Münstertal,4,,5,4,9
103 Taufers im Münstertal,5,,4,5,9
103 Taufers im Münstertal,6,,5,8,13
103 Taufers im Münstertal,7,,4,-,4
103 Taufers im Münstertal,8,,7,9,16
103 Taufers im Münstertal,9,,3,5,8
103 Taufers im Münstertal,10,,6,3,9
103 Taufers im Münstertal,11,,4,10,14
103 Taufers im Münstertal,12,,3,5,8
103 Taufers im Münstertal,13,,7,4,11
103 Taufers im Münstertal,14,,3,3,6
103 Taufers im Münstertal,15,,4,5,9
103 Taufers im Münstertal,16,,6,6,12
103 Taufers im Münstertal,17,,4,3,7
103 Taufers im Münstertal,18,,3,4,7
103 Taufers im Münstertal,19,,7,9,16
103 Taufers im Münstertal,20,,4,4,8
103 Taufers im Münstertal,21,,7,4,11
103 Taufers im Münstertal,22,,8,6,14
103 Taufers im Münstertal,23,,6,9,15
103 Taufers im Münstertal,24,,5,6,11
103 Taufers im Münstertal,25,,8,7,15
103 Taufers im Münstertal,26,,7,8,15
103 Taufers im Münstertal,27,,8,8,16
103 Taufers im Münstertal,28,,10,4,14
103 Taufers im Münstertal,29,,8,6,14
103 Taufers im Münstertal,30,,3,7,10
103 Taufers im Münstertal,31,,8,3,11
103 Taufers im Münstertal,32,,7,4,11
103 Taufers im Münstertal,33,,7,5,12
103 Taufers im Münstertal,34,,4,7,11
103 Taufers im Münstertal,35,,6,10,16
103 Taufers im Münstertal,36,,8,6,14
103 Taufers im Münstertal,37,,6,4,10
103 Taufers im Münstertal,38,,6,3,9
103 Taufers im Münstertal,39,,5,4,9
103 Taufers im Münstertal,40,,5,3,8
103 Taufers im Münstertal,41,,1,7,8
103 Taufers im Münstertal,42,,11,5,16
103 Taufers im Münstertal,43,,5,4,9
103 Taufers im Münstertal,44,,1,8,9
103 Taufers im Münstertal,45,,3,8,11
103 Taufers im Münstertal,46,,7,15,22
103 Taufers im Münstertal,47,,7,7,14
103 Taufers im Münstertal,48,,9,8,17
103 Taufers im Münstertal,49,,8,12,20
103 Taufers im Münstertal,50,,4,5,9
103 Taufers im Münstertal,51,,5,10,15
103 Taufers im Münstertal,52,,12,6,18
103 Taufers im Münstertal,53,,9,13,22
103 Taufers im Münstertal,54,,9,10,19
103 Taufers im Münstertal,55,,10,8,18
103 Taufers im Münstertal,56,,8,6,14
103 Taufers im Münstertal,57,,13,6,19
103 Taufers im Münstertal,58,,6,10,16
103 Taufers im Münstertal,59,,5,6,11
103 Taufers im Münstertal,60,,7,6,13
103 Taufers im Münstertal,61,,10,9,19
103 Taufers im Münstertal,62,,5,3,8
103 Taufers im Münstertal,63,,4,6,10
103 Taufers im Münstertal,64,,6,4,10
103 Taufers im Münstertal,65,,8,2,10
103 Taufers im Münstertal,66,,4,5,9
103 Taufers im Münstertal,67,,7,3,10
103 Taufers im Münstertal,68,,5,1,6
103 Taufers im Münstertal,69,,4,1,5
103 Taufers im Münstertal,70,,3,6,9
103 Taufers im Münstertal,71,,2,3,5
103 Taufers im Münstertal,72,,2,4,6
103 Taufers im Münstertal,74,,6,4,10
103 Taufers im Münstertal,75,,4,4,8
103 Taufers im Münstertal,76,,3,4,7
103 Taufers im Münstertal,77,,2,3,5
103 Taufers im Münstertal,78,,4,4,8
103 Taufers im Münstertal,79,,6,8,14
103 Taufers im Münstertal,80,,2,3,5
103 Taufers im Münstertal,81,,2,8,10
103 Taufers im Münstertal,82,,2,2,4
103 Taufers im Münstertal,83,,2,7,9
103 Taufers im Münstertal,84,,3,5,8
103 Taufers im Münstertal,85,,4,1,5
103 Taufers im Münstertal,86,,5,3,8
103 Taufers im Münstertal,87,,-,2,2
103 Taufers im Münstertal,88,,1,4,5
103 Taufers im Münstertal,89,,3,1,4
103 Taufers im Münstertal,90,,-,2,2
103 Taufers im Münstertal,91,,-,3,3
103 Taufers im Münstertal,92,,-,2,2
103 Taufers im Münstertal,94,,-,2,2
103 Taufers im Münstertal,95,,-,1,1
104 Ulten,0,,21,16,37
104 Ulten,1,,21,19,40
104 Ulten,2,,17,15,32
104 Ulten,3,,16,17,33
104 Ulten,4,,20,14,34
104 Ulten,5,,10,14,24
104 Ulten,6,,16,21,37
104 Ulten,7,,14,11,25
104 Ulten,8,,17,13,30
104 Ulten,9,,18,11,29
104 Ulten,10,,6,11,17
104 Ulten,11,,14,11,25
104 Ulten,12,,17,20,37
104 Ulten,13,,17,12,29
104 Ulten,14,,21,18,39
104 Ulten,15,,14,18,32
104 Ulten,16,,22,17,39
104 Ulten,17,,16,18,34
104 Ulten,18,,14,13,27
104 Ulten,19,,16,16,32
104 Ulten,20,,13,21,34
104 Ulten,21,,11,13,24
104 Ulten,22,,11,14,25
104 Ulten,23,,18,15,33
104 Ulten,24,,22,14,36
104 Ulten,25,,17,13,30
104 Ulten,26,,20,21,41
104 Ulten,27,,18,16,34
104 Ulten,28,,15,24,39
104 Ulten,29,,13,13,26
104 Ulten,30,,15,14,29
104 Ulten,31,,19,10,29
104 Ulten,32,,14,18,32
104 Ulten,33,,20,15,35
104 Ulten,34,,19,12,31
104 Ulten,35,,12,20,32
104 Ulten,36,,22,16,38
104 Ulten,37,,18,25,43
104 Ulten,38,,18,16,34
104 Ulten,39,,22,8,30
104 Ulten,40,,16,12,28
104 Ulten,41,,15,18,33
104 Ulten,42,,20,20,40
104 Ulten,43,,13,23,36
104 Ulten,44,,24,15,39
104 Ulten,45,,21,18,39
104 Ulten,46,,29,20,49
104 Ulten,47,,20,24,44
104 Ulten,48,,26,20,46
104 Ulten,49,,29,25,54
104 Ulten,50,,14,19,33
104 Ulten,51,,19,17,36
104 Ulten,52,,25,29,54
104 Ulten,53,,22,16,38
104 Ulten,54,,26,24,50
104 Ulten,55,,31,21,52
104 Ulten,56,,27,17,44
104 Ulten,57,,24,21,45
104 Ulten,58,,23,21,44
104 Ulten,59,,25,16,41
104 Ulten,60,,32,21,53
104 Ulten,61,,17,16,33
104 Ulten,62,,13,12,25
104 Ulten,63,,17,14,31
104 Ulten,64,,22,13,35
104 Ulten,65,,17,12,29
104 Ulten,66,,16,15,31
104 Ulten,67,,16,12,28
104 Ulten,68,,15,10,25
104 Ulten,69,,13,13,26
104 Ulten,70,,14,9,23
104 Ulten,71,,15,14,29
104 Ulten,72,,7,12,19
104 Ulten,73,,11,18,29
104 Ulten,74,,15,14,29
104 Ulten,75,,8,11,19
104 Ulten,76,,8,10,18
104 Ulten,77,,12,8,20
104 Ulten,78,,15,17,32
104 Ulten,79,,5,9,14
104 Ulten,80,,7,7,14
104 Ulten,81,,5,9,14
104 Ulten,82,,5,6,11
104 Ulten,83,,10,10,20
104 Ulten,84,,2,11,13
104 Ulten,85,,6,6,12
104 Ulten,86,,4,6,10
104 Ulten,87,,6,13,19
104 Ulten,88,,2,9,11
104 Ulten,89,,2,8,10
104 Ulten,90,,6,12,18
104 Ulten,91,,3,8,11
104 Ulten,92,,-,5,5
104 Ulten,93,,2,5,7
104 Ulten,94,,2,6,8
104 Ulten,95,,2,2,4
104 Ulten,96,,2,1,3
104 Ulten,98,,-,1,1
105 Pfatten,0,,9,7,16
105 Pfatten,1,,6,1,7
105 Pfatten,2,,8,3,11
105 Pfatten,3,,8,4,12
105 Pfatten,4,,11,4,15
105 Pfatten,5,,3,8,11
105 Pfatten,6,,11,6,17
105 Pfatten,7,,5,3,8
105 Pfatten,8,,7,6,13
105 Pfatten,9,,7,6,13
105 Pfatten,10,,9,7,16
105 Pfatten,11,,8,3,11
105 Pfatten,12,,6,11,17
105 Pfatten,13,,1,7,8
105 Pfatten,14,,10,5,15
105 Pfatten,15,,4,4,8
105 Pfatten,16,,5,2,7
105 Pfatten,17,,3,6,9
105 Pfatten,18,,6,6,12
105 Pfatten,19,,8,6,14
105 Pfatten,20,,4,2,6
105 Pfatten,21,,5,6,11
105 Pfatten,22,,7,4,11
105 Pfatten,23,,9,10,19
105 Pfatten,24,,7,5,12
105 Pfatten,25,,6,6,12
105 Pfatten,26,,7,4,11
105 Pfatten,27,,7,9,16
105 Pfatten,28,,5,11,16
105 Pfatten,29,,10,9,19
105 Pfatten,30,,8,5,13
105 Pfatten,31,,3,10,13
105 Pfatten,32,,6,7,13
105 Pfatten,33,,5,6,11
105 Pfatten,34,,10,12,22
105 Pfatten,35,,7,5,12
105 Pfatten,36,,12,4,16
105 Pfatten,37,,6,5,11
105 Pfatten,38,,4,12,16
105 Pfatten,39,,7,7,14
105 Pfatten,40,,6,6,12
105 Pfatten,41,,5,9,14
105 Pfatten,42,,5,10,15
105 Pfatten,43,,12,7,19
105 Pfatten,44,,13,6,19
105 Pfatten,45,,6,9,15
105 Pfatten,46,,11,5,16
105 Pfatten,47,,10,6,16
105 Pfatten,48,,7,4,11
105 Pfatten,49,,6,9,15
105 Pfatten,50,,15,6,21
105 Pfatten,51,,9,9,18
105 Pfatten,52,,10,10,20
105 Pfatten,53,,13,5,18
105 Pfatten,54,,7,9,16
105 Pfatten,55,,9,12,21
105 Pfatten,56,,11,16,27
105 Pfatten,57,,8,10,18
105 Pfatten,58,,6,14,20
105 Pfatten,59,,9,7,16
105 Pfatten,60,,11,5,16
105 Pfatten,61,,7,9,16
105 Pfatten,62,,6,5,11
105 Pfatten,63,,11,2,13
105 Pfatten,64,,5,5,10
105 Pfatten,65,,2,5,7
105 Pfatten,66,,4,3,7
105 Pfatten,67,,5,5,10
105 Pfatten,68,,8,2,10
105 Pfatten,69,,3,-,3
105 Pfatten,70,,6,7,13
105 Pfatten,71,,2,3,5
105 Pfatten,72,,6,3,9
105 Pfatten,73,,3,1,4
105 Pfatten,74,,1,2,3
105 Pfatten,75,,1,2,3
105 Pfatten,76,,3,4,7
105 Pfatten,77,,3,3,6
105 Pfatten,78,,3,1,4
105 Pfatten,79,,2,1,3
105 Pfatten,80,,3,2,5
105 Pfatten,81,,1,3,4
105 Pfatten,82,,4,2,6
105 Pfatten,83,,-,4,4
105 Pfatten,84,,1,1,2
105 Pfatten,85,,-,3,3
105 Pfatten,86,,1,3,4
105 Pfatten,87,,-,1,1
105 Pfatten,88,,-,3,3
105 Pfatten,89,,-,1,1
105 Pfatten,91,,1,1,2
105 Pfatten,92,,-,1,1
106 Olang,0,,21,21,42
106 Olang,1,,24,13,37
106 Olang,2,,16,18,34
106 Olang,3,,20,16,36
106 Olang,4,,19,17,36
106 Olang,5,,15,26,41
106 Olang,6,,19,20,39
106 Olang,7,,22,21,43
106 Olang,8,,13,20,33
106 Olang,9,,25,20,45
106 Olang,10,,12,25,37
106 Olang,11,,8,16,24
106 Olang,12,,24,11,35
106 Olang,13,,14,13,27
106 Olang,14,,20,11,31
106 Olang,15,,16,10,26
106 Olang,16,,17,20,37
106 Olang,17,,24,21,45
106 Olang,18,,15,13,28
106 Olang,19,,17,23,40
106 Olang,20,,22,17,39
106 Olang,21,,25,22,47
106 Olang,22,,21,9,30
106 Olang,23,,20,14,34
106 Olang,24,,20,22,42
106 Olang,25,,14,15,29
106 Olang,26,,22,16,38
106 Olang,27,,29,24,53
106 Olang,28,,21,19,40
106 Olang,29,,16,20,36
106 Olang,30,,24,18,42
106 Olang,31,,16,23,39
106 Olang,32,,15,19,34
106 Olang,33,,22,14,36
106 Olang,34,,15,12,27
106 Olang,35,,22,18,40
106 Olang,36,,9,27,36
106 Olang,37,,27,20,47
106 Olang,38,,24,26,50
106 Olang,39,,20,22,42
106 Olang,40,,33,29,62
106 Olang,41,,21,26,47
106 Olang,42,,28,23,51
106 Olang,43,,17,26,43
106 Olang,44,,27,27,54
106 Olang,45,,26,18,44
106 Olang,46,,34,19,53
106 Olang,47,,20,20,40
106 Olang,48,,23,28,51
106 Olang,49,,31,26,57
106 Olang,50,,32,26,58
106 Olang,51,,28,23,51
106 Olang,52,,19,25,44
106 Olang,53,,21,29,50
106 Olang,54,,26,23,49
106 Olang,55,,23,13,36
106 Olang,56,,16,23,39
106 Olang,57,,20,26,46
106 Olang,58,,24,15,39
106 Olang,59,,22,12,34
106 Olang,60,,22,13,35
106 Olang,61,,12,27,39
106 Olang,62,,15,17,32
106 Olang,63,,15,17,32
106 Olang,64,,15,19,34
106 Olang,65,,15,12,27
106 Olang,66,,9,15,24
106 Olang,67,,29,15,44
106 Olang,68,,17,11,28
106 Olang,69,,18,19,37
106 Olang,70,,11,22,33
106 Olang,71,,14,12,26
106 Olang,72,,17,12,29
106 Olang,73,,14,6,20
106 Olang,74,,11,14,25
106 Olang,75,,13,16,29
106 Olang,76,,13,11,24
106 Olang,77,,14,9,23
106 Olang,78,,8,11,19
106 Olang,79,,6,12,18
106 Olang,80,,4,7,11
106 Olang,81,,6,8,14
106 Olang,82,,4,10,14
106 Olang,83,,9,10,19
106 Olang,84,,8,11,19
106 Olang,85,,8,8,16
106 Olang,86,,2,5,7
106 Olang,87,,4,8,12
106 Olang,88,,4,9,13
106 Olang,89,,3,4,7
106 Olang,90,,1,2,3
106 Olang,91,,1,8,9
106 Olang,93,,1,5,6
106 Olang,94,,1,1,2
106 Olang,95,,-,2,2
106 Olang,97,,-,1,1
106 Olang,98,,1,-,1
107 Pfitsch,0,,18,20,38
107 Pfitsch,1,,20,16,36
107 Pfitsch,2,,16,20,36
107 Pfitsch,3,,18,14,32
107 Pfitsch,4,,18,23,41
107 Pfitsch,5,,26,23,49
107 Pfitsch,6,,14,17,31
107 Pfitsch,7,,24,17,41
107 Pfitsch,8,,18,12,30
107 Pfitsch,9,,13,22,35
107 Pfitsch,10,,17,9,26
107 Pfitsch,11,,28,15,43
107 Pfitsch,12,,18,20,38
107 Pfitsch,13,,22,14,36
107 Pfitsch,14,,13,17,30
107 Pfitsch,15,,22,20,42
107 Pfitsch,16,,14,11,25
107 Pfitsch,17,,21,22,43
107 Pfitsch,18,,19,14,33
107 Pfitsch,19,,14,14,28
107 Pfitsch,20,,19,20,39
107 Pfitsch,21,,16,16,32
107 Pfitsch,22,,24,9,33
107 Pfitsch,23,,18,18,36
107 Pfitsch,24,,16,17,33
107 Pfitsch,25,,20,24,44
107 Pfitsch,26,,24,18,42
107 Pfitsch,27,,24,14,38
107 Pfitsch,28,,23,14,37
107 Pfitsch,29,,20,23,43
107 Pfitsch,30,,15,14,29
107 Pfitsch,31,,16,20,36
107 Pfitsch,32,,21,15,36
107 Pfitsch,33,,30,17,47
107 Pfitsch,34,,24,29,53
107 Pfitsch,35,,32,19,51
107 Pfitsch,36,,20,26,46
107 Pfitsch,37,,19,22,41
107 Pfitsch,38,,26,19,45
107 Pfitsch,39,,24,24,48
107 Pfitsch,40,,22,16,38
107 Pfitsch,41,,23,29,52
107 Pfitsch,42,,20,23,43
107 Pfitsch,43,,18,21,39
107 Pfitsch,44,,24,18,42
107 Pfitsch,45,,20,20,40
107 Pfitsch,46,,31,17,48
107 Pfitsch,47,,21,23,44
107 Pfitsch,48,,26,18,44
107 Pfitsch,49,,20,19,39
107 Pfitsch,50,,22,19,41
107 Pfitsch,51,,24,19,43
107 Pfitsch,52,,18,20,38
107 Pfitsch,53,,17,23,40
107 Pfitsch,54,,18,17,35
107 Pfitsch,55,,21,21,42
107 Pfitsch,56,,25,20,45
107 Pfitsch,57,,15,27,42
107 Pfitsch,58,,12,17,29
107 Pfitsch,59,,20,13,33
107 Pfitsch,60,,26,24,50
107 Pfitsch,61,,20,17,37
107 Pfitsch,62,,15,13,28
107 Pfitsch,63,,19,23,42
107 Pfitsch,64,,20,17,37
107 Pfitsch,65,,13,21,34
107 Pfitsch,66,,22,19,41
107 Pfitsch,67,,20,19,39
107 Pfitsch,68,,12,17,29
107 Pfitsch,69,,8,7,15
107 Pfitsch,70,,8,12,20
107 Pfitsch,71,,13,13,26
107 Pfitsch,72,,10,12,22
107 Pfitsch,73,,11,13,24
107 Pfitsch,74,,18,10,28
107 Pfitsch,75,,19,12,31
107 Pfitsch,76,,13,15,28
107 Pfitsch,77,,11,10,21
107 Pfitsch,78,,9,7,16
107 Pfitsch,79,,4,10,14
107 Pfitsch,80,,7,10,17
107 Pfitsch,81,,6,9,15
107 Pfitsch,82,,5,5,10
107 Pfitsch,83,,8,3,11
107 Pfitsch,84,,9,8,17
107 Pfitsch,85,,1,9,10
107 Pfitsch,86,,6,7,13
107 Pfitsch,87,,2,8,10
107 Pfitsch,88,,4,6,10
107 Pfitsch,89,,2,6,8
107 Pfitsch,90,,2,7,9
107 Pfitsch,91,,1,5,6
107 Pfitsch,92,,2,5,7
107 Pfitsch,93,,-,1,1
107 Pfitsch,94,,-,1,1
107 Pfitsch,95,,2,2,4
107 Pfitsch,96,,-,2,2
107 Pfitsch,97,,-,1,1
107 Pfitsch,98,,-,1,1
108 Ahrntal,0,,32,36,68
108 Ahrntal,1,,39,37,76
108 Ahrntal,2,,34,27,61
108 Ahrntal,3,,41,21,62
108 Ahrntal,4,,31,27,58
108 Ahrntal,5,,50,29,79
108 Ahrntal,6,,37,34,71
108 Ahrntal,7,,31,28,59
108 Ahrntal,8,,45,44,89
108 Ahrntal,9,,29,46,75
108 Ahrntal,10,,41,36,77
108 Ahrntal,11,,44,34,78
108 Ahrntal,12,,33,38,71
108 Ahrntal,13,,32,39,71
108 Ahrntal,14,,37,38,75
108 Ahrntal,15,,33,36,69
108 Ahrntal,16,,33,32,65
108 Ahrntal,17,,48,42,90
108 Ahrntal,18,,37,38,75
108 Ahrntal,19,,35,36,71
108 Ahrntal,20,,41,46,87
108 Ahrntal,21,,38,48,86
108 Ahrntal,22,,33,30,63
108 Ahrntal,23,,26,28,54
108 Ahrntal,24,,40,42,82
108 Ahrntal,25,,46,32,78
108 Ahrntal,26,,27,38,65
108 Ahrntal,27,,38,34,72
108 Ahrntal,28,,41,28,69
108 Ahrntal,29,,26,26,52
108 Ahrntal,30,,39,35,74
108 Ahrntal,31,,36,41,77
108 Ahrntal,32,,37,45,82
108 Ahrntal,33,,35,25,60
108 Ahrntal,34,,47,46,93
108 Ahrntal,35,,39,37,76
108 Ahrntal,36,,44,43,87
108 Ahrntal,37,,38,36,74
108 Ahrntal,38,,38,37,75
108 Ahrntal,39,,32,40,72
108 Ahrntal,40,,49,47,96
108 Ahrntal,41,,48,42,90
108 Ahrntal,42,,48,40,88
108 Ahrntal,43,,43,37,80
108 Ahrntal,44,,42,41,83
108 Ahrntal,45,,53,50,103
108 Ahrntal,46,,65,42,107
108 Ahrntal,47,,55,44,99
108 Ahrntal,48,,52,45,97
108 Ahrntal,49,,49,42,91
108 Ahrntal,50,,40,50,90
108 Ahrntal,51,,59,43,102
108 Ahrntal,52,,57,40,97
108 Ahrntal,53,,48,40,88
108 Ahrntal,54,,49,41,90
108 Ahrntal,55,,35,47,82
108 Ahrntal,56,,34,38,72
108 Ahrntal,57,,36,30,66
108 Ahrntal,58,,39,39,78
108 Ahrntal,59,,45,30,75
108 Ahrntal,60,,27,38,65
108 Ahrntal,61,,33,21,54
108 Ahrntal,62,,34,22,56
108 Ahrntal,63,,34,18,52
108 Ahrntal,64,,25,28,53
108 Ahrntal,65,,26,34,60
108 Ahrntal,66,,29,21,50
108 Ahrntal,67,,29,19,48
108 Ahrntal,68,,28,30,58
108 Ahrntal,69,,27,26,53
108 Ahrntal,70,,21,15,36
108 Ahrntal,71,,16,22,38
108 Ahrntal,72,,18,12,30
108 Ahrntal,73,,12,18,30
108 Ahrntal,74,,20,29,49
108 Ahrntal,75,,25,23,48
108 Ahrntal,76,,23,31,54
108 Ahrntal,77,,25,23,48
108 Ahrntal,78,,18,19,37
108 Ahrntal,79,,25,25,50
108 Ahrntal,80,,19,19,38
108 Ahrntal,81,,16,11,27
108 Ahrntal,82,,11,34,45
108 Ahrntal,83,,9,18,27
108 Ahrntal,84,,15,15,30
108 Ahrntal,85,,13,22,35
108 Ahrntal,86,,16,15,31
108 Ahrntal,87,,13,11,24
108 Ahrntal,88,,5,12,17
108 Ahrntal,89,,6,16,22
108 Ahrntal,90,,2,9,11
108 Ahrntal,91,,5,8,13
108 Ahrntal,92,,-,8,8
108 Ahrntal,93,,4,1,5
108 Ahrntal,94,,1,3,4
108 Ahrntal,95,,1,4,5
108 Ahrntal,98,,1,-,1
108 Ahrntal,103,,-,1,1
109 Gsies,0,,11,20,31
109 Gsies,1,,13,15,28
109 Gsies,2,,17,17,34
109 Gsies,3,,18,20,38
109 Gsies,4,,18,14,32
109 Gsies,5,,15,14,29
109 Gsies,6,,11,20,31
109 Gsies,7,,19,15,34
109 Gsies,8,,15,18,33
109 Gsies,9,,15,13,28
109 Gsies,10,,17,12,29
109 Gsies,11,,22,20,42
109 Gsies,12,,18,18,36
109 Gsies,13,,10,14,24
109 Gsies,14,,19,18,37
109 Gsies,15,,13,12,25
109 Gsies,16,,15,14,29
109 Gsies,17,,10,12,22
109 Gsies,18,,28,10,38
109 Gsies,19,,19,6,25
109 Gsies,20,,13,17,30
109 Gsies,21,,10,19,29
109 Gsies,22,,15,16,31
109 Gsies,23,,8,17,25
109 Gsies,24,,15,18,33
109 Gsies,25,,14,9,23
109 Gsies,26,,15,23,38
109 Gsies,27,,15,8,23
109 Gsies,28,,8,11,19
109 Gsies,29,,7,15,22
109 Gsies,30,,17,18,35
109 Gsies,31,,12,14,26
109 Gsies,32,,15,13,28
109 Gsies,33,,15,15,30
109 Gsies,34,,16,9,25
109 Gsies,35,,18,12,30
109 Gsies,36,,15,23,38
109 Gsies,37,,20,20,40
109 Gsies,38,,10,16,26
109 Gsies,39,,16,11,27
109 Gsies,40,,14,16,30
109 Gsies,41,,12,18,30
109 Gsies,42,,19,20,39
109 Gsies,43,,18,16,34
109 Gsies,44,,14,11,25
109 Gsies,45,,11,18,29
109 Gsies,46,,18,20,38
109 Gsies,47,,26,14,40
109 Gsies,48,,24,9,33
109 Gsies,49,,14,14,28
109 Gsies,50,,17,13,30
109 Gsies,51,,14,18,32
109 Gsies,52,,17,5,22
109 Gsies,53,,16,18,34
109 Gsies,54,,13,15,28
109 Gsies,55,,16,8,24
109 Gsies,56,,9,13,22
109 Gsies,57,,15,17,32
109 Gsies,58,,9,13,22
109 Gsies,59,,15,15,30
109 Gsies,60,,11,13,24
109 Gsies,61,,16,7,23
109 Gsies,62,,14,10,24
109 Gsies,63,,15,7,22
109 Gsies,64,,17,5,22
109 Gsies,65,,17,14,31
109 Gsies,66,,14,12,26
109 Gsies,67,,7,8,15
109 Gsies,68,,15,17,32
109 Gsies,69,,7,9,16
109 Gsies,70,,19,6,25
109 Gsies,71,,14,10,24
109 Gsies,72,,5,11,16
109 Gsies,73,,6,12,18
109 Gsies,74,,9,8,17
109 Gsies,75,,4,12,16
109 Gsies,76,,5,8,13
109 Gsies,77,,4,9,13
109 Gsies,78,,4,8,12
109 Gsies,79,,6,7,13
109 Gsies,80,,7,6,13
109 Gsies,81,,1,10,11
109 Gsies,82,,3,7,10
109 Gsies,83,,3,6,9
109 Gsies,84,,5,5,10
109 Gsies,85,,5,3,8
109 Gsies,86,,3,5,8
109 Gsies,87,,9,5,14
109 Gsies,88,,1,3,4
109 Gsies,89,,4,4,8
109 Gsies,90,,-,7,7
109 Gsies,91,,1,2,3
109 Gsies,92,,1,3,4
109 Gsies,93,,-,3,3
109 Gsies,94,,-,4,4
109 Gsies,95,,1,2,3
109 Gsies,96,,1,1,2
109 Gsies,97,,1,-,1
109 Gsies,98,,1,-,1
110 Vintl,0,,21,15,36
110 Vintl,1,,16,19,35
110 Vintl,2,,17,20,37
110 Vintl,3,,17,27,44
110 Vintl,4,,19,20,39
110 Vintl,5,,20,23,43
110 Vintl,6,,10,20,30
110 Vintl,7,,14,18,32
110 Vintl,8,,23,20,43
110 Vintl,9,,20,19,39
110 Vintl,10,,23,17,40
110 Vintl,11,,14,13,27
110 Vintl,12,,18,22,40
110 Vintl,13,,13,13,26
110 Vintl,14,,19,17,36
110 Vintl,15,,16,23,39
110 Vintl,16,,17,21,38
110 Vintl,17,,22,15,37
110 Vintl,18,,23,20,43
110 Vintl,19,,21,28,49
110 Vintl,20,,20,15,35
110 Vintl,21,,22,22,44
110 Vintl,22,,39,26,65
110 Vintl,23,,22,16,38
110 Vintl,24,,26,20,46
110 Vintl,25,,29,25,54
110 Vintl,26,,22,27,49
110 Vintl,27,,23,22,45
110 Vintl,28,,27,13,40
110 Vintl,29,,17,13,30
110 Vintl,30,,21,20,41
110 Vintl,31,,24,19,43
110 Vintl,32,,10,15,25
110 Vintl,33,,24,11,35
110 Vintl,34,,18,12,30
110 Vintl,35,,23,29,52
110 Vintl,36,,16,19,35
110 Vintl,37,,29,19,48
110 Vintl,38,,24,24,48
110 Vintl,39,,22,35,57
110 Vintl,40,,17,20,37
110 Vintl,41,,23,17,40
110 Vintl,42,,26,19,45
110 Vintl,43,,23,22,45
110 Vintl,44,,19,21,40
110 Vintl,45,,29,17,46
110 Vintl,46,,27,26,53
110 Vintl,47,,19,19,38
110 Vintl,48,,22,22,44
110 Vintl,49,,25,23,48
110 Vintl,50,,30,35,65
110 Vintl,51,,31,30,61
110 Vintl,52,,30,31,61
110 Vintl,53,,37,22,59
110 Vintl,54,,37,29,66
110 Vintl,55,,33,22,55
110 Vintl,56,,25,31,56
110 Vintl,57,,18,22,40
110 Vintl,58,,20,23,43
110 Vintl,59,,19,16,35
110 Vintl,60,,21,30,51
110 Vintl,61,,22,19,41
110 Vintl,62,,19,13,32
110 Vintl,63,,15,19,34
110 Vintl,64,,21,9,30
110 Vintl,65,,15,18,33
110 Vintl,66,,21,18,39
110 Vintl,67,,21,19,40
110 Vintl,68,,16,18,34
110 Vintl,69,,12,13,25
110 Vintl,70,,18,13,31
110 Vintl,71,,12,12,24
110 Vintl,72,,11,16,27
110 Vintl,73,,10,5,15
110 Vintl,74,,17,12,29
110 Vintl,75,,7,9,16
110 Vintl,76,,7,12,19
110 Vintl,77,,8,17,25
110 Vintl,78,,9,13,22
110 Vintl,79,,8,5,13
110 Vintl,80,,7,7,14
110 Vintl,81,,7,9,16
110 Vintl,82,,8,10,18
110 Vintl,83,,9,5,14
110 Vintl,84,,2,16,18
110 Vintl,85,,5,10,15
110 Vintl,86,,6,10,16
110 Vintl,87,,3,8,11
110 Vintl,88,,3,9,12
110 Vintl,89,,3,4,7
110 Vintl,90,,4,6,10
110 Vintl,91,,2,1,3
110 Vintl,92,,1,2,3
110 Vintl,93,,1,-,1
110 Vintl,94,,1,1,2
110 Vintl,95,,-,2,2
110 Vintl,96,,-,2,2
110 Vintl,97,,-,2,2
110 Vintl,102,,1,-,1
111 Vahrn,0,,24,31,55
111 Vahrn,1,,27,26,53
111 Vahrn,2,,35,30,65
111 Vahrn,3,,29,25,54
111 Vahrn,4,,35,21,56
111 Vahrn,5,,33,26,59
111 Vahrn,6,,36,27,63
111 Vahrn,7,,26,29,55
111 Vahrn,8,,28,27,55
111 Vahrn,9,,25,24,49
111 Vahrn,10,,40,22,62
111 Vahrn,11,,32,32,64
111 Vahrn,12,,32,30,62
111 Vahrn,13,,29,28,57
111 Vahrn,14,,28,13,41
111 Vahrn,15,,27,31,58
111 Vahrn,16,,29,20,49
111 Vahrn,17,,28,23,51
111 Vahrn,18,,32,32,64
111 Vahrn,19,,24,25,49
111 Vahrn,20,,23,23,46
111 Vahrn,21,,35,15,50
111 Vahrn,22,,25,24,49
111 Vahrn,23,,20,25,45
111 Vahrn,24,,18,19,37
111 Vahrn,25,,21,31,52
111 Vahrn,26,,22,24,46
111 Vahrn,27,,22,36,58
111 Vahrn,28,,32,23,55
111 Vahrn,29,,31,21,52
111 Vahrn,30,,24,25,49
111 Vahrn,31,,33,21,54
111 Vahrn,32,,24,28,52
111 Vahrn,33,,22,19,41
111 Vahrn,34,,30,29,59
111 Vahrn,35,,32,39,71
111 Vahrn,36,,32,28,60
111 Vahrn,37,,28,27,55
111 Vahrn,38,,24,29,53
111 Vahrn,39,,41,38,79
111 Vahrn,40,,22,32,54
111 Vahrn,41,,38,28,66
111 Vahrn,42,,32,32,64
111 Vahrn,43,,36,43,79
111 Vahrn,44,,44,46,90
111 Vahrn,45,,34,48,82
111 Vahrn,46,,40,27,67
111 Vahrn,47,,49,43,92
111 Vahrn,48,,41,43,84
111 Vahrn,49,,38,37,75
111 Vahrn,50,,43,33,76
111 Vahrn,51,,36,31,67
111 Vahrn,52,,41,36,77
111 Vahrn,53,,39,37,76
111 Vahrn,54,,37,37,74
111 Vahrn,55,,25,37,62
111 Vahrn,56,,28,25,53
111 Vahrn,57,,32,29,61
111 Vahrn,58,,29,27,56
111 Vahrn,59,,20,18,38
111 Vahrn,60,,28,28,56
111 Vahrn,61,,20,23,43
111 Vahrn,62,,25,31,56
111 Vahrn,63,,22,33,55
111 Vahrn,64,,23,24,47
111 Vahrn,65,,20,13,33
111 Vahrn,66,,20,12,32
111 Vahrn,67,,20,21,41
111 Vahrn,68,,24,31,55
111 Vahrn,69,,17,16,33
111 Vahrn,70,,13,24,37
111 Vahrn,71,,19,20,39
111 Vahrn,72,,12,13,25
111 Vahrn,73,,14,20,34
111 Vahrn,74,,18,22,40
111 Vahrn,75,,12,22,34
111 Vahrn,76,,13,20,33
111 Vahrn,77,,18,14,32
111 Vahrn,78,,16,19,35
111 Vahrn,79,,12,9,21
111 Vahrn,80,,11,16,27
111 Vahrn,81,,7,14,21
111 Vahrn,82,,6,13,19
111 Vahrn,83,,10,11,21
111 Vahrn,84,,7,9,16
111 Vahrn,85,,4,6,10
111 Vahrn,86,,3,11,14
111 Vahrn,87,,5,4,9
111 Vahrn,88,,3,14,17
111 Vahrn,89,,4,5,9
111 Vahrn,90,,2,9,11
111 Vahrn,91,,1,3,4
111 Vahrn,92,,-,5,5
111 Vahrn,93,,3,1,4
111 Vahrn,94,,1,2,3
111 Vahrn,95,,-,2,2
111 Vahrn,96,,-,1,1
112 Vöran,0,,7,8,15
112 Vöran,1,,7,7,14
112 Vöran,2,,5,3,8
112 Vöran,3,,6,8,14
112 Vöran,4,,4,5,9
112 Vöran,5,,9,6,15
112 Vöran,6,,2,3,5
112 Vöran,7,,9,6,15
112 Vöran,8,,5,6,11
112 Vöran,9,,8,3,11
112 Vöran,10,,4,3,7
112 Vöran,11,,9,3,12
112 Vöran,12,,3,5,8
112 Vöran,13,,3,5,8
112 Vöran,14,,9,5,14
112 Vöran,15,,5,7,12
112 Vöran,16,,9,4,13
112 Vöran,17,,11,5,16
112 Vöran,18,,5,3,8
112 Vöran,19,,5,4,9
112 Vöran,20,,11,7,18
112 Vöran,21,,10,5,15
112 Vöran,22,,4,9,13
112 Vöran,23,,7,6,13
112 Vöran,24,,6,5,11
112 Vöran,25,,6,3,9
112 Vöran,26,,5,6,11
112 Vöran,27,,6,6,12
112 Vöran,28,,9,8,17
112 Vöran,29,,6,6,12
112 Vöran,30,,11,8,19
112 Vöran,31,,5,8,13
112 Vöran,32,,8,7,15
112 Vöran,33,,6,3,9
112 Vöran,34,,2,5,7
112 Vöran,35,,7,11,18
112 Vöran,36,,7,8,15
112 Vöran,37,,5,3,8
112 Vöran,38,,3,5,8
112 Vöran,39,,7,7,14
112 Vöran,40,,7,6,13
112 Vöran,41,,4,6,10
112 Vöran,42,,9,5,14
112 Vöran,43,,14,11,25
112 Vöran,44,,6,6,12
112 Vöran,45,,8,8,16
112 Vöran,46,,7,10,17
112 Vöran,47,,7,6,13
112 Vöran,48,,7,4,11
112 Vöran,49,,13,3,16
112 Vöran,50,,5,7,12
112 Vöran,51,,8,6,14
112 Vöran,52,,4,4,8
112 Vöran,53,,11,4,15
112 Vöran,54,,7,9,16
112 Vöran,55,,13,14,27
112 Vöran,56,,3,5,8
112 Vöran,57,,6,6,12
112 Vöran,58,,4,7,11
112 Vöran,59,,6,5,11
112 Vöran,60,,6,10,16
112 Vöran,61,,2,2,4
112 Vöran,62,,4,3,7
112 Vöran,63,,5,5,10
112 Vöran,64,,5,4,9
112 Vöran,65,,9,2,11
112 Vöran,66,,2,-,2
112 Vöran,67,,7,4,11
112 Vöran,68,,7,5,12
112 Vöran,69,,4,3,7
112 Vöran,70,,5,2,7
112 Vöran,71,,4,2,6
112 Vöran,72,,-,4,4
112 Vöran,73,,4,1,5
112 Vöran,74,,2,5,7
112 Vöran,75,,4,3,7
112 Vöran,76,,5,5,10
112 Vöran,77,,1,3,4
112 Vöran,78,,1,2,3
112 Vöran,79,,6,3,9
112 Vöran,80,,2,2,4
112 Vöran,81,,2,5,7
112 Vöran,82,,2,-,2
112 Vöran,83,,1,5,6
112 Vöran,84,,4,4,8
112 Vöran,85,,1,2,3
112 Vöran,86,,1,-,1
112 Vöran,87,,1,1,2
112 Vöran,88,,1,1,2
112 Vöran,89,,1,-,1
112 Vöran,92,,-,1,1
112 Vöran,94,,-,1,1
112 Vöran,97,,-,1,1
113 Niederdorf,0,,14,11,25
113 Niederdorf,1,,5,10,15
113 Niederdorf,2,,8,7,15
113 Niederdorf,3,,10,9,19
113 Niederdorf,4,,13,10,23
113 Niederdorf,5,,10,7,17
113 Niederdorf,6,,11,6,17
113 Niederdorf,7,,10,5,15
113 Niederdorf,8,,14,10,24
113 Niederdorf,9,,9,8,17
113 Niederdorf,10,,10,11,21
113 Niederdorf,11,,10,8,18
113 Niederdorf,12,,16,8,24
113 Niederdorf,13,,11,17,28
113 Niederdorf,14,,7,16,23
113 Niederdorf,15,,8,13,21
113 Niederdorf,16,,11,10,21
113 Niederdorf,17,,15,12,27
113 Niederdorf,18,,8,6,14
113 Niederdorf,19,,7,12,19
113 Niederdorf,20,,10,8,18
113 Niederdorf,21,,5,10,15
113 Niederdorf,22,,7,10,17
113 Niederdorf,23,,14,8,22
113 Niederdorf,24,,9,9,18
113 Niederdorf,25,,7,11,18
113 Niederdorf,26,,8,12,20
113 Niederdorf,27,,17,11,28
113 Niederdorf,28,,7,5,12
113 Niederdorf,29,,9,11,20
113 Niederdorf,30,,5,11,16
113 Niederdorf,31,,7,7,14
113 Niederdorf,32,,15,6,21
113 Niederdorf,33,,10,2,12
113 Niederdorf,34,,6,9,15
113 Niederdorf,35,,7,16,23
113 Niederdorf,36,,10,7,17
113 Niederdorf,37,,9,4,13
113 Niederdorf,38,,14,10,24
113 Niederdorf,39,,5,6,11
113 Niederdorf,40,,7,10,17
113 Niederdorf,41,,10,9,19
113 Niederdorf,42,,7,11,18
113 Niederdorf,43,,7,5,12
113 Niederdorf,44,,12,13,25
113 Niederdorf,45,,19,10,29
113 Niederdorf,46,,8,15,23
113 Niederdorf,47,,10,13,23
113 Niederdorf,48,,24,17,41
113 Niederdorf,49,,13,11,24
113 Niederdorf,50,,18,18,36
113 Niederdorf,51,,23,12,35
113 Niederdorf,52,,17,14,31
113 Niederdorf,53,,15,17,32
113 Niederdorf,54,,15,10,25
113 Niederdorf,55,,25,8,33
113 Niederdorf,56,,11,11,22
113 Niederdorf,57,,8,10,18
113 Niederdorf,58,,13,12,25
113 Niederdorf,59,,7,5,12
113 Niederdorf,60,,9,10,19
113 Niederdorf,61,,7,11,18
113 Niederdorf,62,,10,6,16
113 Niederdorf,63,,10,8,18
113 Niederdorf,64,,8,4,12
113 Niederdorf,65,,9,5,14
113 Niederdorf,66,,2,1,3
113 Niederdorf,67,,5,6,11
113 Niederdorf,68,,9,4,13
113 Niederdorf,69,,5,9,14
113 Niederdorf,70,,6,6,12
113 Niederdorf,71,,8,7,15
113 Niederdorf,72,,3,7,10
113 Niederdorf,73,,6,5,11
113 Niederdorf,74,,4,8,12
113 Niederdorf,75,,5,5,10
113 Niederdorf,76,,3,5,8
113 Niederdorf,77,,3,7,10
113 Niederdorf,78,,1,4,5
113 Niederdorf,79,,7,4,11
113 Niederdorf,80,,5,7,12
113 Niederdorf,81,,3,8,11
113 Niederdorf,82,,4,5,9
113 Niederdorf,83,,3,12,15
113 Niederdorf,84,,3,6,9
113 Niederdorf,85,,6,4,10
113 Niederdorf,86,,4,5,9
113 Niederdorf,87,,3,4,7
113 Niederdorf,88,,1,7,8
113 Niederdorf,89,,-,4,4
113 Niederdorf,90,,-,3,3
113 Niederdorf,91,,-,3,3
113 Niederdorf,92,,1,1,2
113 Niederdorf,93,,1,2,3
113 Niederdorf,95,,1,2,3
113 Niederdorf,96,,-,1,1
113 Niederdorf,97,,-,1,1
113 Niederdorf,101,,-,1,1
114 Villanders,0,,8,13,21
114 Villanders,1,,6,6,12
114 Villanders,2,,10,7,17
114 Villanders,3,,7,10,17
114 Villanders,4,,6,9,15
114 Villanders,5,,11,11,22
114 Villanders,6,,6,5,11
114 Villanders,7,,15,6,21
114 Villanders,8,,12,8,20
114 Villanders,9,,6,9,15
114 Villanders,10,,14,14,28
114 Villanders,11,,13,14,27
114 Villanders,12,,17,7,24
114 Villanders,13,,13,14,27
114 Villanders,14,,5,12,17
114 Villanders,15,,8,10,18
114 Villanders,16,,13,12,25
114 Villanders,17,,10,17,27
114 Villanders,18,,12,12,24
114 Villanders,19,,11,8,19
114 Villanders,20,,10,12,22
114 Villanders,21,,16,6,22
114 Villanders,22,,17,4,21
114 Villanders,23,,12,13,25
114 Villanders,24,,8,15,23
114 Villanders,25,,13,8,21
114 Villanders,26,,15,17,32
114 Villanders,27,,16,14,30
114 Villanders,28,,9,10,19
114 Villanders,29,,10,12,22
114 Villanders,30,,6,8,14
114 Villanders,31,,9,8,17
114 Villanders,32,,9,8,17
114 Villanders,33,,13,13,26
114 Villanders,34,,16,6,22
114 Villanders,35,,15,15,30
114 Villanders,36,,17,11,28
114 Villanders,37,,10,13,23
114 Villanders,38,,11,5,16
114 Villanders,39,,12,8,20
114 Villanders,40,,17,10,27
114 Villanders,41,,11,5,16
114 Villanders,42,,13,10,23
114 Villanders,43,,14,11,25
114 Villanders,44,,10,15,25
114 Villanders,45,,14,22,36
114 Villanders,46,,16,19,35
114 Villanders,47,,14,10,24
114 Villanders,48,,26,16,42
114 Villanders,49,,21,15,36
114 Villanders,50,,20,13,33
114 Villanders,51,,19,17,36
114 Villanders,52,,21,18,39
114 Villanders,53,,19,17,36
114 Villanders,54,,14,12,26
114 Villanders,55,,18,12,30
114 Villanders,56,,12,11,23
114 Villanders,57,,17,6,23
114 Villanders,58,,14,10,24
114 Villanders,59,,15,8,23
114 Villanders,60,,9,6,15
114 Villanders,61,,10,6,16
114 Villanders,62,,10,17,27
114 Villanders,63,,6,7,13
114 Villanders,64,,10,11,21
114 Villanders,65,,11,7,18
114 Villanders,66,,10,7,17
114 Villanders,67,,10,8,18
114 Villanders,68,,8,5,13
114 Villanders,69,,5,11,16
114 Villanders,70,,6,7,13
114 Villanders,71,,7,10,17
114 Villanders,72,,6,2,8
114 Villanders,73,,3,9,12
114 Villanders,74,,6,7,13
114 Villanders,75,,6,8,14
114 Villanders,76,,6,9,15
114 Villanders,77,,8,10,18
114 Villanders,78,,5,4,9
114 Villanders,79,,4,5,9
114 Villanders,80,,3,7,10
114 Villanders,81,,5,6,11
114 Villanders,82,,2,5,7
114 Villanders,83,,1,7,8
114 Villanders,84,,6,7,13
114 Villanders,85,,5,8,13
114 Villanders,86,,4,8,12
114 Villanders,87,,4,2,6
114 Villanders,88,,3,6,9
114 Villanders,89,,1,3,4
114 Villanders,90,,1,3,4
114 Villanders,91,,1,2,3
114 Villanders,92,,-,3,3
114 Villanders,93,,2,-,2
114 Villanders,94,,-,1,1
114 Villanders,95,,-,1,1
114 Villanders,96,,-,3,3
114 Villanders,97,,-,1,1
115 Sterzing,0,,39,37,76
115 Sterzing,1,,44,36,80
115 Sterzing,2,,37,33,70
115 Sterzing,3,,40,39,79
115 Sterzing,4,,32,34,66
115 Sterzing,5,,38,43,81
115 Sterzing,6,,35,31,66
115 Sterzing,7,,34,34,68
115 Sterzing,8,,36,30,66
115 Sterzing,9,,37,43,80
115 Sterzing,10,,34,36,70
115 Sterzing,11,,37,34,71
115 Sterzing,12,,32,31,63
115 Sterzing,13,,27,29,56
115 Sterzing,14,,36,35,71
115 Sterzing,15,,30,29,59
115 Sterzing,16,,31,33,64
115 Sterzing,17,,35,38,73
115 Sterzing,18,,30,22,52
115 Sterzing,19,,31,26,57
115 Sterzing,20,,36,39,75
115 Sterzing,21,,30,41,71
115 Sterzing,22,,44,33,77
115 Sterzing,23,,34,35,69
115 Sterzing,24,,55,35,90
115 Sterzing,25,,47,46,93
115 Sterzing,26,,53,35,88
115 Sterzing,27,,47,48,95
115 Sterzing,28,,60,43,103
115 Sterzing,29,,54,46,100
115 Sterzing,30,,53,50,103
115 Sterzing,31,,61,41,102
115 Sterzing,32,,45,44,89
115 Sterzing,33,,52,46,98
115 Sterzing,34,,58,48,106
115 Sterzing,35,,65,41,106
115 Sterzing,36,,68,42,110
115 Sterzing,37,,59,59,118
115 Sterzing,38,,53,52,105
115 Sterzing,39,,59,41,100
115 Sterzing,40,,42,30,72
115 Sterzing,41,,39,40,79
115 Sterzing,42,,52,47,99
115 Sterzing,43,,51,46,97
115 Sterzing,44,,61,71,132
115 Sterzing,45,,66,48,114
115 Sterzing,46,,45,54,99
115 Sterzing,47,,56,67,123
115 Sterzing,48,,45,39,84
115 Sterzing,49,,54,52,106
115 Sterzing,50,,62,49,111
115 Sterzing,51,,65,52,117
115 Sterzing,52,,55,50,105
115 Sterzing,53,,48,46,94
115 Sterzing,54,,55,49,104
115 Sterzing,55,,49,48,97
115 Sterzing,56,,38,36,74
115 Sterzing,57,,45,45,90
115 Sterzing,58,,53,43,96
115 Sterzing,59,,39,42,81
115 Sterzing,60,,33,47,80
115 Sterzing,61,,33,25,58
115 Sterzing,62,,35,47,82
115 Sterzing,63,,35,32,67
115 Sterzing,64,,28,44,72
115 Sterzing,65,,40,43,83
115 Sterzing,66,,32,43,75
115 Sterzing,67,,36,35,71
115 Sterzing,68,,34,45,79
115 Sterzing,69,,31,44,75
115 Sterzing,70,,26,28,54
115 Sterzing,71,,38,42,80
115 Sterzing,72,,28,38,66
115 Sterzing,73,,30,25,55
115 Sterzing,74,,35,48,83
115 Sterzing,75,,27,35,62
115 Sterzing,76,,28,28,56
115 Sterzing,77,,31,29,60
115 Sterzing,78,,23,30,53
115 Sterzing,79,,28,26,54
115 Sterzing,80,,18,31,49
115 Sterzing,81,,14,36,50
115 Sterzing,82,,15,20,35
115 Sterzing,83,,9,15,24
115 Sterzing,84,,17,21,38
115 Sterzing,85,,9,9,18
115 Sterzing,86,,12,21,33
115 Sterzing,87,,4,11,15
115 Sterzing,88,,4,8,12
115 Sterzing,89,,6,14,20
115 Sterzing,90,,7,9,16
115 Sterzing,91,,3,7,10
115 Sterzing,92,,1,7,8
115 Sterzing,93,,-,6,6
115 Sterzing,94,,3,5,8
115 Sterzing,95,,1,3,4
115 Sterzing,96,,1,3,4
115 Sterzing,97,,-,3,3
115 Sterzing,98,,-,2,2
116 Feldthurns,0,,23,23,46
116 Feldthurns,1,,22,22,44
116 Feldthurns,2,,23,21,44
116 Feldthurns,3,,18,14,32
116 Feldthurns,4,,22,18,40
116 Feldthurns,5,,19,14,33
116 Feldthurns,6,,15,14,29
116 Feldthurns,7,,26,19,45
116 Feldthurns,8,,15,13,28
116 Feldthurns,9,,15,20,35
116 Feldthurns,10,,24,18,42
116 Feldthurns,11,,27,20,47
116 Feldthurns,12,,27,15,42
116 Feldthurns,13,,23,17,40
116 Feldthurns,14,,11,12,23
116 Feldthurns,15,,23,21,44
116 Feldthurns,16,,15,20,35
116 Feldthurns,17,,23,14,37
116 Feldthurns,18,,18,23,41
116 Feldthurns,19,,21,19,40
116 Feldthurns,20,,22,18,40
116 Feldthurns,21,,16,21,37
116 Feldthurns,22,,18,19,37
116 Feldthurns,23,,17,17,34
116 Feldthurns,24,,33,17,50
116 Feldthurns,25,,19,21,40
116 Feldthurns,26,,11,12,23
116 Feldthurns,27,,12,17,29
116 Feldthurns,28,,18,18,36
116 Feldthurns,29,,15,18,33
116 Feldthurns,30,,23,13,36
116 Feldthurns,31,,18,21,39
116 Feldthurns,32,,14,19,33
116 Feldthurns,33,,16,18,34
116 Feldthurns,34,,23,14,37
116 Feldthurns,35,,13,17,30
116 Feldthurns,36,,25,23,48
116 Feldthurns,37,,13,25,38
116 Feldthurns,38,,10,21,31
116 Feldthurns,39,,32,21,53
116 Feldthurns,40,,23,15,38
116 Feldthurns,41,,23,25,48
116 Feldthurns,42,,25,16,41
116 Feldthurns,43,,28,26,54
116 Feldthurns,44,,19,20,39
116 Feldthurns,45,,28,24,52
116 Feldthurns,46,,19,24,43
116 Feldthurns,47,,19,22,41
116 Feldthurns,48,,27,27,54
116 Feldthurns,49,,21,26,47
116 Feldthurns,50,,21,22,43
116 Feldthurns,51,,19,21,40
116 Feldthurns,52,,27,26,53
116 Feldthurns,53,,20,19,39
116 Feldthurns,54,,30,19,49
116 Feldthurns,55,,14,18,32
116 Feldthurns,56,,17,18,35
116 Feldthurns,57,,17,13,30
116 Feldthurns,58,,14,16,30
116 Feldthurns,59,,10,18,28
116 Feldthurns,60,,14,11,25
116 Feldthurns,61,,11,21,32
116 Feldthurns,62,,13,15,28
116 Feldthurns,63,,14,14,28
116 Feldthurns,64,,15,12,27
116 Feldthurns,65,,22,15,37
116 Feldthurns,66,,12,11,23
116 Feldthurns,67,,14,14,28
116 Feldthurns,68,,5,13,18
116 Feldthurns,69,,13,11,24
116 Feldthurns,70,,14,8,22
116 Feldthurns,71,,11,8,19
116 Feldthurns,72,,8,11,19
116 Feldthurns,73,,16,10,26
116 Feldthurns,74,,9,11,20
116 Feldthurns,75,,8,7,15
116 Feldthurns,76,,4,4,8
116 Feldthurns,77,,8,6,14
116 Feldthurns,78,,6,10,16
116 Feldthurns,79,,11,6,17
116 Feldthurns,80,,3,7,10
116 Feldthurns,81,,5,8,13
116 Feldthurns,82,,8,9,17
116 Feldthurns,83,,2,4,6
116 Feldthurns,84,,5,4,9
116 Feldthurns,85,,4,6,10
116 Feldthurns,86,,4,5,9
116 Feldthurns,87,,3,11,14
116 Feldthurns,88,,1,8,9
116 Feldthurns,89,,5,4,9
116 Feldthurns,90,,-,2,2
116 Feldthurns,91,,-,1,1
116 Feldthurns,92,,-,3,3
116 Feldthurns,93,,-,5,5
116 Feldthurns,94,,2,1,3
116 Feldthurns,95,,-,2,2
116 Feldthurns,96,,1,-,1
116 Feldthurns,97,,-,1,1
117 Wengen,0,,7,11,18
117 Wengen,1,,9,9,18
117 Wengen,2,,7,6,13
117 Wengen,3,,7,9,16
117 Wengen,4,,10,8,18
117 Wengen,5,,12,11,23
117 Wengen,6,,12,3,15
117 Wengen,7,,12,16,28
117 Wengen,8,,7,8,15
117 Wengen,9,,7,10,17
117 Wengen,10,,10,12,22
117 Wengen,11,,8,11,19
117 Wengen,12,,10,5,15
117 Wengen,13,,5,9,14
117 Wengen,14,,5,6,11
117 Wengen,15,,10,4,14
117 Wengen,16,,5,10,15
117 Wengen,17,,8,6,14
117 Wengen,18,,9,5,14
117 Wengen,19,,8,7,15
117 Wengen,20,,12,10,22
117 Wengen,21,,9,9,18
117 Wengen,22,,12,9,21
117 Wengen,23,,11,7,18
117 Wengen,24,,10,6,16
117 Wengen,25,,10,9,19
117 Wengen,26,,19,9,28
117 Wengen,27,,12,7,19
117 Wengen,28,,4,7,11
117 Wengen,29,,5,15,20
117 Wengen,30,,10,4,14
117 Wengen,31,,9,8,17
117 Wengen,32,,8,4,12
117 Wengen,33,,12,9,21
117 Wengen,34,,14,4,18
117 Wengen,35,,15,9,24
117 Wengen,36,,6,7,13
117 Wengen,37,,9,15,24
117 Wengen,38,,13,5,18
117 Wengen,39,,4,8,12
117 Wengen,40,,8,7,15
117 Wengen,41,,6,5,11
117 Wengen,42,,18,11,29
117 Wengen,43,,12,5,17
117 Wengen,44,,15,9,24
117 Wengen,45,,13,11,24
117 Wengen,46,,12,14,26
117 Wengen,47,,13,13,26
117 Wengen,48,,7,9,16
117 Wengen,49,,16,9,25
117 Wengen,50,,11,13,24
117 Wengen,51,,11,5,16
117 Wengen,52,,8,10,18
117 Wengen,53,,12,7,19
117 Wengen,54,,14,13,27
117 Wengen,55,,14,8,22
117 Wengen,56,,7,10,17
117 Wengen,57,,10,12,22
117 Wengen,58,,7,6,13
117 Wengen,59,,6,7,13
117 Wengen,60,,6,11,17
117 Wengen,61,,5,6,11
117 Wengen,62,,7,6,13
117 Wengen,63,,9,5,14
117 Wengen,64,,6,2,8
117 Wengen,65,,4,5,9
117 Wengen,66,,7,5,12
117 Wengen,67,,2,6,8
117 Wengen,68,,4,8,12
117 Wengen,69,,1,12,13
117 Wengen,70,,6,3,9
117 Wengen,71,,5,4,9
117 Wengen,72,,5,3,8
117 Wengen,73,,6,8,14
117 Wengen,74,,3,6,9
117 Wengen,75,,7,7,14
117 Wengen,76,,4,4,8
117 Wengen,77,,5,6,11
117 Wengen,78,,6,4,10
117 Wengen,79,,5,3,8
117 Wengen,80,,7,7,14
117 Wengen,82,,2,6,8
117 Wengen,83,,2,6,8
117 Wengen,84,,3,2,5
117 Wengen,85,,-,4,4
117 Wengen,86,,4,1,5
117 Wengen,87,,3,2,5
117 Wengen,88,,2,5,7
117 Wengen,89,,1,2,3
117 Wengen,91,,1,1,2
117 Wengen,92,,-,2,2
117 Wengen,93,,-,1,1
117 Wengen,94,,-,2,2
117 Wengen,95,,2,1,3
117 Wengen,96,,-,3,3
118 U.L.Frau i.W.-St.Felix,0,,5,3,8
118 U.L.Frau i.W.-St.Felix,1,,4,1,5
118 U.L.Frau i.W.-St.Felix,2,,6,9,15
118 U.L.Frau i.W.-St.Felix,3,,5,5,10
118 U.L.Frau i.W.-St.Felix,4,,4,2,6
118 U.L.Frau i.W.-St.Felix,5,,3,7,10
118 U.L.Frau i.W.-St.Felix,6,,3,2,5
118 U.L.Frau i.W.-St.Felix,7,,3,4,7
118 U.L.Frau i.W.-St.Felix,8,,6,3,9
118 U.L.Frau i.W.-St.Felix,9,,1,9,10
118 U.L.Frau i.W.-St.Felix,10,,3,-,3
118 U.L.Frau i.W.-St.Felix,11,,3,3,6
118 U.L.Frau i.W.-St.Felix,12,,5,7,12
118 U.L.Frau i.W.-St.Felix,13,,4,3,7
118 U.L.Frau i.W.-St.Felix,14,,8,6,14
118 U.L.Frau i.W.-St.Felix,15,,7,3,10
118 U.L.Frau i.W.-St.Felix,16,,9,4,13
118 U.L.Frau i.W.-St.Felix,17,,3,2,5
118 U.L.Frau i.W.-St.Felix,18,,5,5,10
118 U.L.Frau i.W.-St.Felix,19,,6,10,16
118 U.L.Frau i.W.-St.Felix,20,,5,4,9
118 U.L.Frau i.W.-St.Felix,21,,8,4,12
118 U.L.Frau i.W.-St.Felix,22,,3,10,13
118 U.L.Frau i.W.-St.Felix,23,,7,5,12
118 U.L.Frau i.W.-St.Felix,24,,8,3,11
118 U.L.Frau i.W.-St.Felix,25,,5,3,8
118 U.L.Frau i.W.-St.Felix,26,,7,7,14
118 U.L.Frau i.W.-St.Felix,27,,5,2,7
118 U.L.Frau i.W.-St.Felix,28,,5,4,9
118 U.L.Frau i.W.-St.Felix,29,,8,4,12
118 U.L.Frau i.W.-St.Felix,30,,4,5,9
118 U.L.Frau i.W.-St.Felix,31,,6,2,8
118 U.L.Frau i.W.-St.Felix,32,,7,1,8
118 U.L.Frau i.W.-St.Felix,33,,5,4,9
118 U.L.Frau i.W.-St.Felix,34,,1,10,11
118 U.L.Frau i.W.-St.Felix,35,,3,5,8
118 U.L.Frau i.W.-St.Felix,36,,5,1,6
118 U.L.Frau i.W.-St.Felix,37,,2,4,6
118 U.L.Frau i.W.-St.Felix,38,,1,3,4
118 U.L.Frau i.W.-St.Felix,39,,-,3,3
118 U.L.Frau i.W.-St.Felix,40,,4,3,7
118 U.L.Frau i.W.-St.Felix,41,,4,8,12
118 U.L.Frau i.W.-St.Felix,42,,7,1,8
118 U.L.Frau i.W.-St.Felix,43,,5,6,11
118 U.L.Frau i.W.-St.Felix,44,,2,2,4
118 U.L.Frau i.W.-St.Felix,45,,8,5,13
118 U.L.Frau i.W.-St.Felix,46,,4,5,9
118 U.L.Frau i.W.-St.Felix,47,,6,9,15
118 U.L.Frau i.W.-St.Felix,48,,6,4,10
118 U.L.Frau i.W.-St.Felix,49,,3,8,11
118 U.L.Frau i.W.-St.Felix,50,,3,4,7
118 U.L.Frau i.W.-St.Felix,51,,9,7,16
118 U.L.Frau i.W.-St.Felix,52,,9,5,14
118 U.L.Frau i.W.-St.Felix,53,,4,8,12
118 U.L.Frau i.W.-St.Felix,54,,16,8,24
118 U.L.Frau i.W.-St.Felix,55,,8,9,17
118 U.L.Frau i.W.-St.Felix,56,,4,4,8
118 U.L.Frau i.W.-St.Felix,57,,8,8,16
118 U.L.Frau i.W.-St.Felix,58,,5,4,9
118 U.L.Frau i.W.-St.Felix,59,,4,3,7
118 U.L.Frau i.W.-St.Felix,60,,3,6,9
118 U.L.Frau i.W.-St.Felix,61,,5,5,10
118 U.L.Frau i.W.-St.Felix,62,,3,4,7
118 U.L.Frau i.W.-St.Felix,63,,6,3,9
118 U.L.Frau i.W.-St.Felix,64,,2,3,5
118 U.L.Frau i.W.-St.Felix,65,,5,3,8
118 U.L.Frau i.W.-St.Felix,66,,6,3,9
118 U.L.Frau i.W.-St.Felix,67,,3,4,7
118 U.L.Frau i.W.-St.Felix,68,,4,-,4
118 U.L.Frau i.W.-St.Felix,69,,4,-,4
118 U.L.Frau i.W.-St.Felix,70,,1,7,8
118 U.L.Frau i.W.-St.Felix,71,,1,3,4
118 U.L.Frau i.W.-St.Felix,72,,2,1,3
118 U.L.Frau i.W.-St.Felix,73,,5,-,5
118 U.L.Frau i.W.-St.Felix,74,,5,4,9
118 U.L.Frau i.W.-St.Felix,75,,2,3,5
118 U.L.Frau i.W.-St.Felix,76,,4,7,11
118 U.L.Frau i.W.-St.Felix,77,,2,-,2
118 U.L.Frau i.W.-St.Felix,78,,1,3,4
118 U.L.Frau i.W.-St.Felix,79,,2,4,6
118 U.L.Frau i.W.-St.Felix,80,,3,-,3
118 U.L.Frau i.W.-St.Felix,81,,3,2,5
118 U.L.Frau i.W.-St.Felix,82,,2,3,5
118 U.L.Frau i.W.-St.Felix,83,,2,2,4
118 U.L.Frau i.W.-St.Felix,84,,3,3,6
118 U.L.Frau i.W.-St.Felix,85,,3,-,3
118 U.L.Frau i.W.-St.Felix,86,,2,-,2
118 U.L.Frau i.W.-St.Felix,87,,3,5,8
118 U.L.Frau i.W.-St.Felix,88,,-,2,2
118 U.L.Frau i.W.-St.Felix,89,,-,2,2
118 U.L.Frau i.W.-St.Felix,90,,-,2,2
118 U.L.Frau i.W.-St.Felix,91,,1,1,2
118 U.L.Frau i.W.-St.Felix,92,,-,1,1
118 U.L.Frau i.W.-St.Felix,93,,-,1,1
118 U.L.Frau i.W.-St.Felix,94,,1,2,3
118 U.L.Frau i.W.-St.Felix,100,,-,1,1
