Gemeinde,Altersklassen,Geschlecht,Männer,Frauen,Insgesamt
001 Aldein,0,,8,5,13
001 Aldein,1,,14,8,22
001 Aldein,2,,12,6,18
001 Aldein,3,,13,8,21
001 Aldein,4,,6,11,17
001 Aldein,5,,14,4,18
001 Aldein,6,,2,9,11
001 Aldein,7,,10,4,14
001 Aldein,8,,12,7,19
001 Aldein,9,,7,9,16
001 Aldein,10,,8,11,19
001 Aldein,11,,8,11,19
001 Aldein,12,,8,14,22
001 Aldein,13,,10,8,18
001 Aldein,14,,17,10,27
001 Aldein,15,,16,10,26
001 Aldein,16,,14,8,22
001 Aldein,17,,17,8,25
001 Aldein,18,,13,5,18
001 Aldein,19,,16,14,30
001 Aldein,20,,12,19,31
001 Aldein,21,,15,7,22
001 Aldein,22,,8,7,15
001 Aldein,23,,8,12,20
001 Aldein,24,,10,6,16
001 Aldein,25,,14,13,27
001 Aldein,26,,9,10,19
001 Aldein,27,,5,4,9
001 Aldein,28,,7,6,13
001 Aldein,29,,11,13,24
001 Aldein,30,,11,4,15
001 Aldein,31,,10,6,16
001 Aldein,32,,6,4,10
001 Aldein,33,,13,10,23
001 Aldein,34,,6,6,12
001 Aldein,35,,7,10,17
001 Aldein,36,,10,10,20
001 Aldein,37,,10,13,23
001 Aldein,38,,7,10,17
001 Aldein,39,,12,13,25
001 Aldein,40,,10,8,18
001 Aldein,41,,8,20,28
001 Aldein,42,,8,12,20
001 Aldein,43,,15,10,25
001 Aldein,44,,14,11,25
001 Aldein,45,,13,10,23
001 Aldein,46,,16,7,23
001 Aldein,47,,16,16,32
001 Aldein,48,,14,17,31
001 Aldein,49,,18,9,27
001 Aldein,50,,12,16,28
001 Aldein,51,,6,13,19
001 Aldein,52,,7,19,26
001 Aldein,53,,16,9,25
001 Aldein,54,,16,10,26
001 Aldein,55,,13,6,19
001 Aldein,56,,9,18,27
001 Aldein,57,,16,14,30
001 Aldein,58,,14,9,23
001 Aldein,59,,10,12,22
001 Aldein,60,,6,4,10
001 Aldein,61,,10,9,19
001 Aldein,62,,7,7,14
001 Aldein,63,,9,9,18
001 Aldein,64,,9,6,15
001 Aldein,65,,9,9,18
001 Aldein,66,,7,4,11
001 Aldein,67,,14,10,24
001 Aldein,68,,5,12,17
001 Aldein,69,,9,6,15
001 Aldein,70,,9,9,18
001 Aldein,71,,4,9,13
001 Aldein,72,,6,8,14
001 Aldein,73,,5,5,10
001 Aldein,74,,4,6,10
001 Aldein,75,,8,9,17
001 Aldein,76,,6,9,15
001 Aldein,77,,5,11,16
001 Aldein,78,,4,8,12
001 Aldein,79,,4,9,13
001 Aldein,80,,7,7,14
001 Aldein,81,,3,8,11
001 Aldein,82,,4,3,7
001 Aldein,83,,3,3,6
001 Aldein,84,,6,3,9
001 Aldein,85,,3,2,5
001 Aldein,86,,1,3,4
001 Aldein,87,,3,1,4
001 Aldein,88,,1,1,2
001 Aldein,89,,4,6,10
001 Aldein,90,,1,1,2
001 Aldein,91,,3,2,5
001 Aldein,92,,-,1,1
001 Aldein,93,,1,3,4
001 Aldein,94,,-,2,2
001 Aldein,95,,1,1,2
001 Aldein,96,,-,1,1
001 Aldein,97,,-,1,1
002 Andrian,0,,5,2,7
002 Andrian,1,,6,9,15
002 Andrian,2,,1,5,6
002 Andrian,3,,4,3,7
002 Andrian,4,,10,2,12
002 Andrian,5,,6,4,10
002 Andrian,6,,10,5,15
002 Andrian,7,,9,5,14
002 Andrian,8,,8,6,14
002 Andrian,9,,7,11,18
002 Andrian,10,,4,4,8
002 Andrian,11,,5,6,11
002 Andrian,12,,8,3,11
002 Andrian,13,,5,6,11
002 Andrian,14,,9,4,13
002 Andrian,15,,6,10,16
002 Andrian,16,,3,3,6
002 Andrian,17,,3,2,5
002 Andrian,18,,6,4,10
002 Andrian,19,,3,5,8
002 Andrian,20,,8,1,9
002 Andrian,21,,9,8,17
002 Andrian,22,,2,12,14
002 Andrian,23,,8,4,12
002 Andrian,24,,6,4,10
002 Andrian,25,,4,4,8
002 Andrian,26,,7,7,14
002 Andrian,27,,4,8,12
002 Andrian,28,,8,4,12
002 Andrian,29,,5,4,9
002 Andrian,30,,9,6,15
002 Andrian,31,,7,6,13
002 Andrian,32,,8,8,16
002 Andrian,33,,2,3,5
002 Andrian,34,,6,7,13
002 Andrian,35,,7,5,12
002 Andrian,36,,7,12,19
002 Andrian,37,,7,3,10
002 Andrian,38,,5,5,10
002 Andrian,39,,6,8,14
002 Andrian,40,,7,5,12
002 Andrian,41,,9,10,19
002 Andrian,42,,9,9,18
002 Andrian,43,,7,4,11
002 Andrian,44,,5,10,15
002 Andrian,45,,10,9,19
002 Andrian,46,,8,9,17
002 Andrian,47,,9,9,18
002 Andrian,48,,9,6,15
002 Andrian,49,,10,8,18
002 Andrian,50,,10,10,20
002 Andrian,51,,10,8,18
002 Andrian,52,,9,9,18
002 Andrian,53,,12,8,20
002 Andrian,54,,7,6,13
002 Andrian,55,,7,15,22
002 Andrian,56,,9,7,16
002 Andrian,57,,9,4,13
002 Andrian,58,,9,5,14
002 Andrian,59,,7,4,11
002 Andrian,60,,9,10,19
002 Andrian,61,,6,7,13
002 Andrian,62,,6,10,16
002 Andrian,63,,3,3,6
002 Andrian,64,,5,2,7
002 Andrian,65,,7,6,13
002 Andrian,66,,2,3,5
002 Andrian,67,,4,3,7
002 Andrian,68,,6,5,11
002 Andrian,69,,3,2,5
002 Andrian,70,,2,4,6
002 Andrian,71,,6,4,10
002 Andrian,72,,8,8,16
002 Andrian,73,,1,2,3
002 Andrian,74,,1,4,5
002 Andrian,75,,6,7,13
002 Andrian,76,,2,3,5
002 Andrian,77,,5,5,10
002 Andrian,78,,2,6,8
002 Andrian,79,,1,6,7
002 Andrian,80,,3,3,6
002 Andrian,81,,3,2,5
002 Andrian,82,,2,4,6
002 Andrian,83,,3,2,5
002 Andrian,84,,5,1,6
002 Andrian,85,,3,2,5
002 Andrian,86,,4,2,6
002 Andrian,87,,-,2,2
002 Andrian,88,,2,1,3
002 Andrian,89,,2,-,2
002 Andrian,90,,1,1,2
002 Andrian,91,,-,2,2
002 Andrian,92,,-,1,1
002 Andrian,93,,-,2,2
002 Andrian,94,,-,1,1
002 Andrian,97,,-,1,1
002 Andrian,104,,-,1,1
003 Altrei,0,,2,1,3
003 Altrei,1,,4,3,7
003 Altrei,2,,-,3,3
003 Altrei,3,,5,2,7
003 Altrei,4,,3,6,9
003 Altrei,5,,2,2,4
003 Altrei,6,,3,3,6
003 Altrei,7,,-,2,2
003 Altrei,9,,2,2,4
003 Altrei,10,,3,4,7
003 Altrei,11,,6,4,10
003 Altrei,12,,2,-,2
003 Altrei,13,,4,2,6
003 Altrei,14,,2,1,3
003 Altrei,15,,-,1,1
003 Altrei,16,,2,1,3
003 Altrei,17,,4,1,5
003 Altrei,18,,1,2,3
003 Altrei,19,,3,-,3
003 Altrei,20,,3,1,4
003 Altrei,21,,-,1,1
003 Altrei,22,,1,3,4
003 Altrei,23,,1,2,3
003 Altrei,24,,3,2,5
003 Altrei,25,,2,1,3
003 Altrei,26,,7,2,9
003 Altrei,27,,-,1,1
003 Altrei,28,,2,3,5
003 Altrei,29,,2,2,4
003 Altrei,30,,2,5,7
003 Altrei,31,,2,3,5
003 Altrei,32,,1,2,3
003 Altrei,33,,4,1,5
003 Altrei,34,,3,3,6
003 Altrei,35,,5,1,6
003 Altrei,36,,2,2,4
003 Altrei,37,,1,2,3
003 Altrei,38,,1,3,4
003 Altrei,39,,1,3,4
003 Altrei,40,,3,4,7
003 Altrei,41,,-,2,2
003 Altrei,42,,2,4,6
003 Altrei,43,,2,2,4
003 Altrei,44,,1,-,1
003 Altrei,45,,1,4,5
003 Altrei,46,,3,1,4
003 Altrei,47,,4,2,6
003 Altrei,48,,2,2,4
003 Altrei,49,,3,5,8
003 Altrei,50,,-,4,4
003 Altrei,51,,3,2,5
003 Altrei,52,,1,4,5
003 Altrei,53,,3,4,7
003 Altrei,54,,3,6,9
003 Altrei,55,,3,3,6
003 Altrei,56,,10,2,12
003 Altrei,57,,2,4,6
003 Altrei,58,,4,2,6
003 Altrei,59,,5,4,9
003 Altrei,60,,2,4,6
003 Altrei,61,,1,2,3
003 Altrei,62,,5,1,6
003 Altrei,63,,3,3,6
003 Altrei,64,,2,-,2
003 Altrei,65,,2,2,4
003 Altrei,66,,6,2,8
003 Altrei,67,,3,3,6
003 Altrei,68,,-,3,3
003 Altrei,69,,1,-,1
003 Altrei,70,,2,2,4
003 Altrei,71,,3,2,5
003 Altrei,72,,2,2,4
003 Altrei,73,,3,1,4
003 Altrei,74,,1,2,3
003 Altrei,75,,2,3,5
003 Altrei,76,,3,1,4
003 Altrei,77,,1,3,4
003 Altrei,78,,3,3,6
003 Altrei,79,,1,2,3
003 Altrei,80,,1,1,2
003 Altrei,81,,2,1,3
003 Altrei,82,,4,1,5
003 Altrei,83,,1,-,1
003 Altrei,84,,-,1,1
003 Altrei,85,,2,1,3
003 Altrei,86,,-,2,2
003 Altrei,87,,-,1,1
003 Altrei,88,,-,1,1
003 Altrei,89,,-,1,1
003 Altrei,90,,-,1,1
003 Altrei,91,,-,1,1
004 Eppan a.d. Weinstr.,0,,86,55,141
004 Eppan a.d. Weinstr.,1,,69,75,144
004 Eppan a.d. Weinstr.,2,,80,68,148
004 Eppan a.d. Weinstr.,3,,73,84,157
004 Eppan a.d. Weinstr.,4,,84,79,163
004 Eppan a.d. Weinstr.,5,,71,74,145
004 Eppan a.d. Weinstr.,6,,88,83,171
004 Eppan a.d. Weinstr.,7,,82,81,163
004 Eppan a.d. Weinstr.,8,,80,78,158
004 Eppan a.d. Weinstr.,9,,80,62,142
004 Eppan a.d. Weinstr.,10,,81,98,179
004 Eppan a.d. Weinstr.,11,,73,66,139
004 Eppan a.d. Weinstr.,12,,108,81,189
004 Eppan a.d. Weinstr.,13,,89,109,198
004 Eppan a.d. Weinstr.,14,,92,63,155
004 Eppan a.d. Weinstr.,15,,91,68,159
004 Eppan a.d. Weinstr.,16,,75,80,155
004 Eppan a.d. Weinstr.,17,,82,81,163
004 Eppan a.d. Weinstr.,18,,79,83,162
004 Eppan a.d. Weinstr.,19,,91,64,155
004 Eppan a.d. Weinstr.,20,,88,82,170
004 Eppan a.d. Weinstr.,21,,75,72,147
004 Eppan a.d. Weinstr.,22,,83,75,158
004 Eppan a.d. Weinstr.,23,,80,78,158
004 Eppan a.d. Weinstr.,24,,90,88,178
004 Eppan a.d. Weinstr.,25,,85,99,184
004 Eppan a.d. Weinstr.,26,,82,85,167
004 Eppan a.d. Weinstr.,27,,85,69,154
004 Eppan a.d. Weinstr.,28,,100,71,171
004 Eppan a.d. Weinstr.,29,,84,79,163
004 Eppan a.d. Weinstr.,30,,96,87,183
004 Eppan a.d. Weinstr.,31,,80,71,151
004 Eppan a.d. Weinstr.,32,,100,85,185
004 Eppan a.d. Weinstr.,33,,97,80,177
004 Eppan a.d. Weinstr.,34,,99,92,191
004 Eppan a.d. Weinstr.,35,,82,96,178
004 Eppan a.d. Weinstr.,36,,95,97,192
004 Eppan a.d. Weinstr.,37,,77,104,181
004 Eppan a.d. Weinstr.,38,,95,101,196
004 Eppan a.d. Weinstr.,39,,94,89,183
004 Eppan a.d. Weinstr.,40,,107,97,204
004 Eppan a.d. Weinstr.,41,,105,91,196
004 Eppan a.d. Weinstr.,42,,91,95,186
004 Eppan a.d. Weinstr.,43,,108,106,214
004 Eppan a.d. Weinstr.,44,,99,113,212
004 Eppan a.d. Weinstr.,45,,119,110,229
004 Eppan a.d. Weinstr.,46,,103,122,225
004 Eppan a.d. Weinstr.,47,,124,116,240
004 Eppan a.d. Weinstr.,48,,137,117,254
004 Eppan a.d. Weinstr.,49,,143,128,271
004 Eppan a.d. Weinstr.,50,,127,118,245
004 Eppan a.d. Weinstr.,51,,115,136,251
004 Eppan a.d. Weinstr.,52,,117,142,259
004 Eppan a.d. Weinstr.,53,,115,117,232
004 Eppan a.d. Weinstr.,54,,128,121,249
004 Eppan a.d. Weinstr.,55,,103,117,220
004 Eppan a.d. Weinstr.,56,,124,121,245
004 Eppan a.d. Weinstr.,57,,129,100,229
004 Eppan a.d. Weinstr.,58,,102,124,226
004 Eppan a.d. Weinstr.,59,,109,99,208
004 Eppan a.d. Weinstr.,60,,91,105,196
004 Eppan a.d. Weinstr.,61,,92,91,183
004 Eppan a.d. Weinstr.,62,,84,79,163
004 Eppan a.d. Weinstr.,63,,86,87,173
004 Eppan a.d. Weinstr.,64,,67,91,158
004 Eppan a.d. Weinstr.,65,,81,84,165
004 Eppan a.d. Weinstr.,66,,64,83,147
004 Eppan a.d. Weinstr.,67,,77,61,138
004 Eppan a.d. Weinstr.,68,,63,74,137
004 Eppan a.d. Weinstr.,69,,61,51,112
004 Eppan a.d. Weinstr.,70,,67,70,137
004 Eppan a.d. Weinstr.,71,,58,77,135
004 Eppan a.d. Weinstr.,72,,74,65,139
004 Eppan a.d. Weinstr.,73,,47,50,97
004 Eppan a.d. Weinstr.,74,,60,68,128
004 Eppan a.d. Weinstr.,75,,82,75,157
004 Eppan a.d. Weinstr.,76,,75,75,150
004 Eppan a.d. Weinstr.,77,,46,92,138
004 Eppan a.d. Weinstr.,78,,60,47,107
004 Eppan a.d. Weinstr.,79,,56,74,130
004 Eppan a.d. Weinstr.,80,,39,47,86
004 Eppan a.d. Weinstr.,81,,34,48,82
004 Eppan a.d. Weinstr.,82,,33,32,65
004 Eppan a.d. Weinstr.,83,,24,33,57
004 Eppan a.d. Weinstr.,84,,21,40,61
004 Eppan a.d. Weinstr.,85,,33,41,74
004 Eppan a.d. Weinstr.,86,,28,34,62
004 Eppan a.d. Weinstr.,87,,16,37,53
004 Eppan a.d. Weinstr.,88,,18,44,62
004 Eppan a.d. Weinstr.,89,,9,27,36
004 Eppan a.d. Weinstr.,90,,14,19,33
004 Eppan a.d. Weinstr.,91,,6,20,26
004 Eppan a.d. Weinstr.,92,,5,25,30
004 Eppan a.d. Weinstr.,93,,4,17,21
004 Eppan a.d. Weinstr.,94,,3,19,22
004 Eppan a.d. Weinstr.,95,,2,12,14
004 Eppan a.d. Weinstr.,96,,1,8,9
004 Eppan a.d. Weinstr.,97,,3,7,10
004 Eppan a.d. Weinstr.,98,,-,3,3
004 Eppan a.d. Weinstr.,99,,-,1,1
004 Eppan a.d. Weinstr.,100,,-,1,1
004 Eppan a.d. Weinstr.,101,,-,3,3
004 Eppan a.d. Weinstr.,102,,-,1,1
005 Hafling,0,,3,6,9
005 Hafling,1,,4,4,8
005 Hafling,2,,4,4,8
005 Hafling,3,,2,6,8
005 Hafling,4,,4,4,8
005 Hafling,5,,5,8,13
005 Hafling,6,,4,3,7
005 Hafling,7,,3,4,7
005 Hafling,8,,3,4,7
005 Hafling,9,,2,8,10
005 Hafling,10,,6,5,11
005 Hafling,11,,3,1,4
005 Hafling,12,,6,5,11
005 Hafling,13,,3,3,6
005 Hafling,14,,1,6,7
005 Hafling,15,,-,4,4
005 Hafling,16,,5,2,7
005 Hafling,17,,5,3,8
005 Hafling,18,,4,9,13
005 Hafling,19,,5,3,8
005 Hafling,20,,3,6,9
005 Hafling,21,,1,9,10
005 Hafling,22,,12,4,16
005 Hafling,23,,7,4,11
005 Hafling,24,,3,6,9
005 Hafling,25,,3,8,11
005 Hafling,26,,3,5,8
005 Hafling,27,,7,2,9
005 Hafling,28,,5,5,10
005 Hafling,29,,5,2,7
005 Hafling,30,,2,5,7
005 Hafling,31,,3,7,10
005 Hafling,32,,5,1,6
005 Hafling,33,,3,5,8
005 Hafling,34,,2,10,12
005 Hafling,35,,3,1,4
005 Hafling,36,,6,3,9
005 Hafling,37,,5,10,15
005 Hafling,38,,6,10,16
005 Hafling,39,,4,6,10
005 Hafling,40,,5,6,11
005 Hafling,41,,4,5,9
005 Hafling,42,,7,7,14
005 Hafling,43,,7,4,11
005 Hafling,44,,10,5,15
005 Hafling,45,,11,4,15
005 Hafling,46,,8,1,9
005 Hafling,47,,12,6,18
005 Hafling,48,,7,11,18
005 Hafling,49,,5,11,16
005 Hafling,50,,5,9,14
005 Hafling,51,,6,2,8
005 Hafling,52,,11,6,17
005 Hafling,53,,8,10,18
005 Hafling,54,,3,2,5
005 Hafling,55,,8,4,12
005 Hafling,56,,6,4,10
005 Hafling,57,,8,5,13
005 Hafling,58,,10,6,16
005 Hafling,59,,6,5,11
005 Hafling,60,,3,5,8
005 Hafling,61,,2,5,7
005 Hafling,62,,3,8,11
005 Hafling,63,,6,2,8
005 Hafling,64,,3,1,4
005 Hafling,65,,2,3,5
005 Hafling,66,,7,2,9
005 Hafling,67,,2,3,5
005 Hafling,68,,4,5,9
005 Hafling,69,,4,4,8
005 Hafling,70,,6,2,8
005 Hafling,71,,1,2,3
005 Hafling,72,,1,3,4
005 Hafling,73,,2,3,5
005 Hafling,74,,2,2,4
005 Hafling,75,,4,4,8
005 Hafling,76,,5,3,8
005 Hafling,77,,3,4,7
005 Hafling,78,,1,1,2
005 Hafling,79,,4,3,7
005 Hafling,80,,1,-,1
005 Hafling,81,,2,1,3
005 Hafling,82,,-,1,1
005 Hafling,83,,1,1,2
005 Hafling,84,,1,1,2
005 Hafling,85,,4,1,5
005 Hafling,86,,2,1,3
005 Hafling,87,,1,2,3
005 Hafling,88,,1,3,4
005 Hafling,91,,-,2,2
005 Hafling,92,,-,1,1
005 Hafling,94,,1,-,1
005 Hafling,96,,-,1,1
006 Abtei,0,,11,15,26
006 Abtei,1,,23,9,32
006 Abtei,2,,16,17,33
006 Abtei,3,,14,22,36
006 Abtei,4,,25,18,43
006 Abtei,5,,10,20,30
006 Abtei,6,,21,15,36
006 Abtei,7,,20,13,33
006 Abtei,8,,24,17,41
006 Abtei,9,,22,19,41
006 Abtei,10,,26,19,45
006 Abtei,11,,27,21,48
006 Abtei,12,,29,23,52
006 Abtei,13,,21,26,47
006 Abtei,14,,29,12,41
006 Abtei,15,,20,19,39
006 Abtei,16,,13,31,44
006 Abtei,17,,24,23,47
006 Abtei,18,,22,31,53
006 Abtei,19,,21,26,47
006 Abtei,20,,13,16,29
006 Abtei,21,,27,21,48
006 Abtei,22,,26,15,41
006 Abtei,23,,24,23,47
006 Abtei,24,,18,16,34
006 Abtei,25,,15,17,32
006 Abtei,26,,23,18,41
006 Abtei,27,,21,16,37
006 Abtei,28,,23,16,39
006 Abtei,29,,15,19,34
006 Abtei,30,,19,11,30
006 Abtei,31,,23,17,40
006 Abtei,32,,23,24,47
006 Abtei,33,,14,18,32
006 Abtei,34,,15,20,35
006 Abtei,35,,14,15,29
006 Abtei,36,,25,13,38
006 Abtei,37,,20,15,35
006 Abtei,38,,26,19,45
006 Abtei,39,,17,29,46
006 Abtei,40,,21,35,56
006 Abtei,41,,27,35,62
006 Abtei,42,,25,28,53
006 Abtei,43,,15,34,49
006 Abtei,44,,21,31,52
006 Abtei,45,,28,20,48
006 Abtei,46,,44,33,77
006 Abtei,47,,16,33,49
006 Abtei,48,,29,35,64
006 Abtei,49,,28,29,57
006 Abtei,50,,30,36,66
006 Abtei,51,,34,36,70
006 Abtei,52,,23,28,51
006 Abtei,53,,34,23,57
006 Abtei,54,,27,38,65
006 Abtei,55,,30,30,60
006 Abtei,56,,26,30,56
006 Abtei,57,,28,26,54
006 Abtei,58,,26,26,52
006 Abtei,59,,28,23,51
006 Abtei,60,,18,21,39
006 Abtei,61,,18,15,33
006 Abtei,62,,20,15,35
006 Abtei,63,,16,15,31
006 Abtei,64,,12,16,28
006 Abtei,65,,12,20,32
006 Abtei,66,,9,14,23
006 Abtei,67,,10,10,20
006 Abtei,68,,11,19,30
006 Abtei,69,,10,18,28
006 Abtei,70,,21,16,37
006 Abtei,71,,15,15,30
006 Abtei,72,,18,17,35
006 Abtei,73,,16,18,34
006 Abtei,74,,9,14,23
006 Abtei,75,,9,13,22
006 Abtei,76,,19,11,30
006 Abtei,77,,12,17,29
006 Abtei,78,,12,16,28
006 Abtei,79,,12,12,24
006 Abtei,80,,15,15,30
006 Abtei,81,,5,13,18
006 Abtei,82,,11,9,20
006 Abtei,83,,6,15,21
006 Abtei,84,,9,10,19
006 Abtei,85,,5,13,18
006 Abtei,86,,3,3,6
006 Abtei,87,,7,8,15
006 Abtei,88,,6,7,13
006 Abtei,89,,3,5,8
006 Abtei,90,,2,4,6
006 Abtei,91,,3,3,6
006 Abtei,92,,1,1,2
006 Abtei,93,,2,1,3
006 Abtei,94,,1,4,5
006 Abtei,96,,-,2,2
006 Abtei,102,,-,1,1
007 Barbian,0,,10,11,21
007 Barbian,1,,4,17,21
007 Barbian,2,,9,16,25
007 Barbian,3,,9,13,22
007 Barbian,4,,14,18,32
007 Barbian,5,,7,11,18
007 Barbian,6,,10,11,21
007 Barbian,7,,13,8,21
007 Barbian,8,,10,8,18
007 Barbian,9,,7,13,20
007 Barbian,10,,11,6,17
007 Barbian,11,,7,12,19
007 Barbian,12,,7,2,9
007 Barbian,13,,15,7,22
007 Barbian,14,,7,6,13
007 Barbian,15,,8,16,24
007 Barbian,16,,7,7,14
007 Barbian,17,,13,16,29
007 Barbian,18,,16,8,24
007 Barbian,19,,13,10,23
007 Barbian,20,,18,9,27
007 Barbian,21,,13,12,25
007 Barbian,22,,11,11,22
007 Barbian,23,,13,9,22
007 Barbian,24,,9,6,15
007 Barbian,25,,10,7,17
007 Barbian,26,,12,13,25
007 Barbian,27,,11,12,23
007 Barbian,28,,15,12,27
007 Barbian,29,,7,14,21
007 Barbian,30,,13,3,16
007 Barbian,31,,8,7,15
007 Barbian,32,,15,15,30
007 Barbian,33,,8,10,18
007 Barbian,34,,12,7,19
007 Barbian,35,,10,15,25
007 Barbian,36,,10,14,24
007 Barbian,37,,10,15,25
007 Barbian,38,,15,7,22
007 Barbian,39,,16,11,27
007 Barbian,40,,12,10,22
007 Barbian,41,,12,21,33
007 Barbian,42,,10,13,23
007 Barbian,43,,10,12,22
007 Barbian,44,,13,12,25
007 Barbian,45,,14,18,32
007 Barbian,46,,14,15,29
007 Barbian,47,,19,8,27
007 Barbian,48,,13,12,25
007 Barbian,49,,15,9,24
007 Barbian,50,,15,10,25
007 Barbian,51,,10,10,20
007 Barbian,52,,9,12,21
007 Barbian,53,,9,12,21
007 Barbian,54,,16,14,30
007 Barbian,55,,14,15,29
007 Barbian,56,,14,14,28
007 Barbian,57,,17,11,28
007 Barbian,58,,13,17,30
007 Barbian,59,,11,7,18
007 Barbian,60,,7,9,16
007 Barbian,61,,13,6,19
007 Barbian,62,,7,9,16
007 Barbian,63,,7,7,14
007 Barbian,64,,5,14,19
007 Barbian,65,,6,9,15
007 Barbian,66,,6,4,10
007 Barbian,67,,10,8,18
007 Barbian,68,,10,11,21
007 Barbian,69,,5,6,11
007 Barbian,70,,3,5,8
007 Barbian,71,,5,6,11
007 Barbian,72,,15,6,21
007 Barbian,73,,3,6,9
007 Barbian,74,,8,8,16
007 Barbian,75,,9,5,14
007 Barbian,76,,9,9,18
007 Barbian,77,,8,12,20
007 Barbian,78,,9,3,12
007 Barbian,79,,4,3,7
007 Barbian,80,,5,8,13
007 Barbian,81,,7,8,15
007 Barbian,82,,3,3,6
007 Barbian,83,,1,3,4
007 Barbian,84,,4,5,9
007 Barbian,85,,3,4,7
007 Barbian,86,,4,5,9
007 Barbian,87,,1,5,6
007 Barbian,88,,1,3,4
007 Barbian,89,,1,3,4
007 Barbian,90,,3,3,6
007 Barbian,92,,1,-,1
007 Barbian,93,,2,-,2
007 Barbian,96,,-,1,1
008 Bozen,0,,477,458,935
008 Bozen,1,,476,419,895
008 Bozen,2,,505,475,980
008 Bozen,3,,492,476,968
008 Bozen,4,,519,511,1.030
008 Bozen,5,,510,471,981
008 Bozen,6,,532,475,1.007
008 Bozen,7,,499,520,1.019
008 Bozen,8,,527,501,1.028
008 Bozen,9,,542,490,1.032
008 Bozen,10,,548,534,1.082
008 Bozen,11,,593,510,1.103
008 Bozen,12,,506,535,1.041
008 Bozen,13,,561,500,1.061
008 Bozen,14,,580,526,1.106
008 Bozen,15,,569,541,1.110
008 Bozen,16,,579,488,1.067
008 Bozen,17,,573,488,1.061
008 Bozen,18,,518,543,1.061
008 Bozen,19,,605,527,1.132
008 Bozen,20,,595,518,1.113
008 Bozen,21,,594,508,1.102
008 Bozen,22,,564,544,1.108
008 Bozen,23,,563,503,1.066
008 Bozen,24,,597,567,1.164
008 Bozen,25,,569,543,1.112
008 Bozen,26,,632,532,1.164
008 Bozen,27,,657,543,1.200
008 Bozen,28,,667,561,1.228
008 Bozen,29,,613,591,1.204
008 Bozen,30,,641,571,1.212
008 Bozen,31,,540,572,1.112
008 Bozen,32,,614,587,1.201
008 Bozen,33,,613,592,1.205
008 Bozen,34,,591,635,1.226
008 Bozen,35,,655,581,1.236
008 Bozen,36,,620,590,1.210
008 Bozen,37,,653,601,1.254
008 Bozen,38,,668,625,1.293
008 Bozen,39,,616,647,1.263
008 Bozen,40,,646,652,1.298
008 Bozen,41,,668,662,1.330
008 Bozen,42,,679,719,1.398
008 Bozen,43,,740,764,1.504
008 Bozen,44,,787,810,1.597
008 Bozen,45,,736,845,1.581
008 Bozen,46,,847,877,1.724
008 Bozen,47,,869,919,1.788
008 Bozen,48,,842,860,1.702
008 Bozen,49,,884,891,1.775
008 Bozen,50,,829,849,1.678
008 Bozen,51,,804,906,1.710
008 Bozen,52,,866,930,1.796
008 Bozen,53,,894,921,1.815
008 Bozen,54,,883,925,1.808
008 Bozen,55,,742,874,1.616
008 Bozen,56,,749,814,1.563
008 Bozen,57,,715,763,1.478
008 Bozen,58,,680,733,1.413
008 Bozen,59,,668,730,1.398
008 Bozen,60,,642,723,1.365
008 Bozen,61,,584,728,1.312
008 Bozen,62,,578,681,1.259
008 Bozen,63,,548,640,1.188
008 Bozen,64,,545,606,1.151
008 Bozen,65,,500,614,1.114
008 Bozen,66,,465,626,1.091
008 Bozen,67,,489,593,1.082
008 Bozen,68,,475,642,1.117
008 Bozen,69,,507,621,1.128
008 Bozen,70,,556,668,1.224
008 Bozen,71,,532,744,1.276
008 Bozen,72,,578,812,1.390
008 Bozen,73,,445,539,984
008 Bozen,74,,469,660,1.129
008 Bozen,75,,491,657,1.148
008 Bozen,76,,509,625,1.134
008 Bozen,77,,535,662,1.197
008 Bozen,78,,502,638,1.140
008 Bozen,79,,455,615,1.070
008 Bozen,80,,415,559,974
008 Bozen,81,,382,467,849
008 Bozen,82,,316,443,759
008 Bozen,83,,285,443,728
008 Bozen,84,,283,438,721
008 Bozen,85,,224,407,631
008 Bozen,86,,228,353,581
008 Bozen,87,,211,345,556
008 Bozen,88,,175,307,482
008 Bozen,89,,106,271,377
008 Bozen,90,,121,229,350
008 Bozen,91,,86,197,283
008 Bozen,92,,83,158,241
008 Bozen,93,,54,139,193
008 Bozen,94,,32,102,134
008 Bozen,95,,31,116,147
008 Bozen,96,,18,84,102
008 Bozen,97,,13,54,67
008 Bozen,98,,11,40,51
008 Bozen,99,,2,24,26
008 Bozen,100,,3,8,11
008 Bozen,101,,2,4,6
008 Bozen,102,,-,4,4
008 Bozen,103,,-,2,2
008 Bozen,104,,-,2,2
008 Bozen,106,,-,1,1
009 Prags,0,,2,6,8
009 Prags,1,,-,4,4
009 Prags,2,,2,7,9
009 Prags,3,,3,2,5
009 Prags,4,,3,3,6
009 Prags,5,,4,1,5
009 Prags,6,,2,2,4
009 Prags,7,,5,2,7
009 Prags,8,,4,4,8
009 Prags,9,,1,2,3
009 Prags,10,,4,6,10
009 Prags,11,,3,6,9
009 Prags,12,,4,2,6
009 Prags,13,,3,1,4
009 Prags,14,,2,3,5
009 Prags,15,,2,5,7
009 Prags,16,,2,6,8
009 Prags,17,,7,5,12
009 Prags,18,,2,3,5
009 Prags,19,,5,9,14
009 Prags,20,,3,4,7
009 Prags,21,,3,5,8
009 Prags,22,,3,7,10
009 Prags,23,,3,1,4
009 Prags,24,,4,5,9
009 Prags,25,,7,3,10
009 Prags,26,,7,2,9
009 Prags,27,,6,2,8
009 Prags,28,,3,3,6
009 Prags,29,,7,6,13
009 Prags,30,,3,3,6
009 Prags,31,,5,2,7
009 Prags,32,,5,3,8
009 Prags,33,,8,2,10
009 Prags,34,,3,3,6
009 Prags,35,,4,3,7
009 Prags,36,,3,4,7
009 Prags,37,,2,5,7
009 Prags,38,,6,1,7
009 Prags,39,,2,3,5
009 Prags,40,,4,6,10
009 Prags,41,,3,2,5
009 Prags,42,,5,3,8
009 Prags,43,,3,5,8
009 Prags,44,,1,5,6
009 Prags,45,,8,5,13
009 Prags,46,,3,3,6
009 Prags,47,,4,4,8
009 Prags,48,,6,6,12
009 Prags,49,,10,4,14
009 Prags,50,,8,8,16
009 Prags,51,,7,6,13
009 Prags,52,,8,5,13
009 Prags,53,,6,6,12
009 Prags,54,,5,3,8
009 Prags,55,,7,5,12
009 Prags,56,,3,5,8
009 Prags,57,,5,12,17
009 Prags,58,,5,3,8
009 Prags,59,,10,5,15
009 Prags,60,,4,2,6
009 Prags,61,,6,4,10
009 Prags,62,,1,6,7
009 Prags,63,,4,4,8
009 Prags,64,,6,4,10
009 Prags,65,,3,-,3
009 Prags,66,,2,6,8
009 Prags,67,,3,1,4
009 Prags,68,,4,1,5
009 Prags,69,,1,1,2
009 Prags,70,,3,1,4
009 Prags,71,,1,-,1
009 Prags,72,,1,4,5
009 Prags,73,,1,2,3
009 Prags,74,,4,4,8
009 Prags,75,,1,3,4
009 Prags,76,,4,4,8
009 Prags,77,,4,3,7
009 Prags,78,,1,2,3
009 Prags,79,,3,4,7
009 Prags,80,,1,2,3
009 Prags,81,,-,2,2
009 Prags,82,,1,3,4
009 Prags,83,,1,3,4
009 Prags,84,,-,2,2
009 Prags,85,,2,1,3
009 Prags,86,,1,3,4
009 Prags,87,,-,2,2
009 Prags,90,,-,1,1
009 Prags,91,,1,3,4
009 Prags,92,,-,4,4
009 Prags,93,,-,2,2
009 Prags,94,,1,-,1
009 Prags,96,,1,1,2
010 Brenner,0,,18,4,22
010 Brenner,1,,12,13,25
010 Brenner,2,,11,11,22
010 Brenner,3,,12,11,23
010 Brenner,4,,12,13,25
010 Brenner,5,,13,11,24
010 Brenner,6,,7,6,13
010 Brenner,7,,12,22,34
010 Brenner,8,,9,15,24
010 Brenner,9,,12,9,21
010 Brenner,10,,11,17,28
010 Brenner,11,,15,12,27
010 Brenner,12,,8,13,21
010 Brenner,13,,12,8,20
010 Brenner,14,,10,16,26
010 Brenner,15,,11,11,22
010 Brenner,16,,14,12,26
010 Brenner,17,,8,6,14
010 Brenner,18,,16,13,29
010 Brenner,19,,11,16,27
010 Brenner,20,,17,8,25
010 Brenner,21,,17,8,25
010 Brenner,22,,6,16,22
010 Brenner,23,,10,11,21
010 Brenner,24,,27,19,46
010 Brenner,25,,13,7,20
010 Brenner,26,,15,10,25
010 Brenner,27,,15,15,30
010 Brenner,28,,17,17,34
010 Brenner,29,,17,9,26
010 Brenner,30,,12,15,27
010 Brenner,31,,17,15,32
010 Brenner,32,,8,12,20
010 Brenner,33,,18,11,29
010 Brenner,34,,15,15,30
010 Brenner,35,,18,12,30
010 Brenner,36,,16,11,27
010 Brenner,37,,12,16,28
010 Brenner,38,,13,11,24
010 Brenner,39,,16,16,32
010 Brenner,40,,16,12,28
010 Brenner,41,,23,13,36
010 Brenner,42,,14,8,22
010 Brenner,43,,22,22,44
010 Brenner,44,,15,7,22
010 Brenner,45,,17,10,27
010 Brenner,46,,15,24,39
010 Brenner,47,,21,14,35
010 Brenner,48,,19,13,32
010 Brenner,49,,14,17,31
010 Brenner,50,,14,18,32
010 Brenner,51,,18,14,32
010 Brenner,52,,20,17,37
010 Brenner,53,,21,16,37
010 Brenner,54,,19,15,34
010 Brenner,55,,13,19,32
010 Brenner,56,,14,14,28
010 Brenner,57,,17,12,29
010 Brenner,58,,20,16,36
010 Brenner,59,,12,14,26
010 Brenner,60,,15,12,27
010 Brenner,61,,15,17,32
010 Brenner,62,,17,15,32
010 Brenner,63,,12,9,21
010 Brenner,64,,9,10,19
010 Brenner,65,,8,13,21
010 Brenner,66,,16,7,23
010 Brenner,67,,13,11,24
010 Brenner,68,,8,14,22
010 Brenner,69,,11,13,24
010 Brenner,70,,6,8,14
010 Brenner,71,,18,10,28
010 Brenner,72,,8,14,22
010 Brenner,73,,2,7,9
010 Brenner,74,,14,11,25
010 Brenner,75,,14,12,26
010 Brenner,76,,8,9,17
010 Brenner,77,,8,12,20
010 Brenner,78,,9,11,20
010 Brenner,79,,6,9,15
010 Brenner,80,,6,13,19
010 Brenner,81,,6,11,17
010 Brenner,82,,8,6,14
010 Brenner,83,,2,5,7
010 Brenner,84,,6,4,10
010 Brenner,85,,1,4,5
010 Brenner,86,,-,3,3
010 Brenner,87,,5,6,11
010 Brenner,88,,4,6,10
010 Brenner,89,,4,5,9
010 Brenner,90,,3,4,7
010 Brenner,91,,4,2,6
010 Brenner,92,,2,-,2
010 Brenner,93,,1,-,1
010 Brenner,95,,-,2,2
010 Brenner,98,,-,1,1
011 Brixen,0,,124,113,237
011 Brixen,1,,129,120,249
011 Brixen,2,,130,98,228
011 Brixen,3,,123,142,265
011 Brixen,4,,119,122,241
011 Brixen,5,,105,132,237
011 Brixen,6,,139,120,259
011 Brixen,7,,105,105,210
011 Brixen,8,,134,125,259
011 Brixen,9,,141,131,272
011 Brixen,10,,120,117,237
011 Brixen,11,,137,111,248
011 Brixen,12,,129,106,235
011 Brixen,13,,136,120,256
011 Brixen,14,,130,129,259
011 Brixen,15,,116,121,237
011 Brixen,16,,133,121,254
011 Brixen,17,,131,128,259
011 Brixen,18,,140,115,255
011 Brixen,19,,150,137,287
011 Brixen,20,,135,135,270
011 Brixen,21,,135,121,256
011 Brixen,22,,138,121,259
011 Brixen,23,,136,131,267
011 Brixen,24,,150,130,280
011 Brixen,25,,130,127,257
011 Brixen,26,,142,133,275
011 Brixen,27,,128,120,248
011 Brixen,28,,117,124,241
011 Brixen,29,,137,113,250
011 Brixen,30,,141,121,262
011 Brixen,31,,120,141,261
011 Brixen,32,,117,151,268
011 Brixen,33,,147,117,264
011 Brixen,34,,130,131,261
011 Brixen,35,,135,154,289
011 Brixen,36,,133,135,268
011 Brixen,37,,151,136,287
011 Brixen,38,,120,143,263
011 Brixen,39,,162,134,296
011 Brixen,40,,116,146,262
011 Brixen,41,,155,149,304
011 Brixen,42,,155,174,329
011 Brixen,43,,148,148,296
011 Brixen,44,,148,181,329
011 Brixen,45,,158,168,326
011 Brixen,46,,169,188,357
011 Brixen,47,,170,185,355
011 Brixen,48,,176,171,347
011 Brixen,49,,199,197,396
011 Brixen,50,,185,206,391
011 Brixen,51,,186,176,362
011 Brixen,52,,175,193,368
011 Brixen,53,,189,176,365
011 Brixen,54,,181,195,376
011 Brixen,55,,152,182,334
011 Brixen,56,,165,168,333
011 Brixen,57,,138,171,309
011 Brixen,58,,133,152,285
011 Brixen,59,,139,149,288
011 Brixen,60,,140,124,264
011 Brixen,61,,128,142,270
011 Brixen,62,,112,148,260
011 Brixen,63,,124,95,219
011 Brixen,64,,86,115,201
011 Brixen,65,,80,111,191
011 Brixen,66,,102,112,214
011 Brixen,67,,95,103,198
011 Brixen,68,,115,106,221
011 Brixen,69,,79,127,206
011 Brixen,70,,98,121,219
011 Brixen,71,,79,113,192
011 Brixen,72,,94,97,191
011 Brixen,73,,57,93,150
011 Brixen,74,,104,111,215
011 Brixen,75,,116,103,219
011 Brixen,76,,83,93,176
011 Brixen,77,,90,113,203
011 Brixen,78,,66,104,170
011 Brixen,79,,74,89,163
011 Brixen,80,,61,79,140
011 Brixen,81,,62,83,145
011 Brixen,82,,44,79,123
011 Brixen,83,,51,73,124
011 Brixen,84,,44,68,112
011 Brixen,85,,41,55,96
011 Brixen,86,,38,60,98
011 Brixen,87,,34,49,83
011 Brixen,88,,28,50,78
011 Brixen,89,,22,48,70
011 Brixen,90,,15,34,49
011 Brixen,91,,11,44,55
011 Brixen,92,,13,26,39
011 Brixen,93,,12,24,36
011 Brixen,94,,6,22,28
011 Brixen,95,,6,15,21
011 Brixen,96,,2,15,17
011 Brixen,97,,-,6,6
011 Brixen,98,,1,7,8
011 Brixen,99,,1,1,2
011 Brixen,100,,-,2,2
011 Brixen,101,,-,2,2
011 Brixen,102,,-,1,1
012 Branzoll,0,,14,15,29
012 Branzoll,1,,19,14,33
012 Branzoll,2,,16,13,29
012 Branzoll,3,,23,19,42
012 Branzoll,4,,19,11,30
012 Branzoll,5,,12,19,31
012 Branzoll,6,,17,17,34
012 Branzoll,7,,17,10,27
012 Branzoll,8,,15,27,42
012 Branzoll,9,,12,18,30
012 Branzoll,10,,15,11,26
012 Branzoll,11,,10,18,28
012 Branzoll,12,,11,10,21
012 Branzoll,13,,12,11,23
012 Branzoll,14,,15,14,29
012 Branzoll,15,,15,21,36
012 Branzoll,16,,13,11,24
012 Branzoll,17,,9,12,21
012 Branzoll,18,,22,9,31
012 Branzoll,19,,11,12,23
012 Branzoll,20,,17,6,23
012 Branzoll,21,,18,22,40
012 Branzoll,22,,17,5,22
012 Branzoll,23,,14,15,29
012 Branzoll,24,,19,8,27
012 Branzoll,25,,21,17,38
012 Branzoll,26,,14,18,32
012 Branzoll,27,,16,19,35
012 Branzoll,28,,23,20,43
012 Branzoll,29,,17,22,39
012 Branzoll,30,,18,19,37
012 Branzoll,31,,18,16,34
012 Branzoll,32,,15,15,30
012 Branzoll,33,,22,21,43
012 Branzoll,34,,16,18,34
012 Branzoll,35,,17,22,39
012 Branzoll,36,,22,14,36
012 Branzoll,37,,14,15,29
012 Branzoll,38,,11,12,23
012 Branzoll,39,,18,11,29
012 Branzoll,40,,15,21,36
012 Branzoll,41,,12,16,28
012 Branzoll,42,,25,19,44
012 Branzoll,43,,22,19,41
012 Branzoll,44,,27,29,56
012 Branzoll,45,,21,16,37
012 Branzoll,46,,24,20,44
012 Branzoll,47,,22,26,48
012 Branzoll,48,,20,15,35
012 Branzoll,49,,25,29,54
012 Branzoll,50,,23,23,46
012 Branzoll,51,,23,21,44
012 Branzoll,52,,19,19,38
012 Branzoll,53,,23,24,47
012 Branzoll,54,,27,25,52
012 Branzoll,55,,17,21,38
012 Branzoll,56,,14,18,32
012 Branzoll,57,,23,28,51
012 Branzoll,58,,21,18,39
012 Branzoll,59,,19,22,41
012 Branzoll,60,,20,15,35
012 Branzoll,61,,17,13,30
012 Branzoll,62,,14,17,31
012 Branzoll,63,,17,16,33
012 Branzoll,64,,19,19,38
012 Branzoll,65,,11,17,28
012 Branzoll,66,,14,21,35
012 Branzoll,67,,12,13,25
012 Branzoll,68,,16,15,31
012 Branzoll,69,,12,15,27
012 Branzoll,70,,14,15,29
012 Branzoll,71,,15,16,31
012 Branzoll,72,,13,18,31
012 Branzoll,73,,9,6,15
012 Branzoll,74,,10,11,21
012 Branzoll,75,,13,11,24
012 Branzoll,76,,16,12,28
012 Branzoll,77,,16,12,28
012 Branzoll,78,,7,11,18
012 Branzoll,79,,12,13,25
012 Branzoll,80,,7,7,14
012 Branzoll,81,,3,7,10
012 Branzoll,82,,6,8,14
012 Branzoll,83,,7,8,15
012 Branzoll,84,,3,6,9
012 Branzoll,85,,12,12,24
012 Branzoll,86,,7,5,12
012 Branzoll,87,,-,6,6
012 Branzoll,88,,4,10,14
012 Branzoll,89,,2,8,10
012 Branzoll,90,,3,4,7
012 Branzoll,91,,2,2,4
012 Branzoll,92,,-,2,2
012 Branzoll,94,,1,3,4
012 Branzoll,95,,-,3,3
012 Branzoll,96,,-,1,1
013 Bruneck,0,,89,76,165
013 Bruneck,1,,101,63,164
013 Bruneck,2,,70,95,165
013 Bruneck,3,,98,67,165
013 Bruneck,4,,90,98,188
013 Bruneck,5,,91,76,167
013 Bruneck,6,,88,78,166
013 Bruneck,7,,85,64,149
013 Bruneck,8,,90,81,171
013 Bruneck,9,,109,76,185
013 Bruneck,10,,82,65,147
013 Bruneck,11,,93,77,170
013 Bruneck,12,,103,86,189
013 Bruneck,13,,98,83,181
013 Bruneck,14,,91,97,188
013 Bruneck,15,,103,84,187
013 Bruneck,16,,80,91,171
013 Bruneck,17,,103,83,186
013 Bruneck,18,,91,90,181
013 Bruneck,19,,101,101,202
013 Bruneck,20,,112,100,212
013 Bruneck,21,,130,76,206
013 Bruneck,22,,94,110,204
013 Bruneck,23,,81,87,168
013 Bruneck,24,,105,94,199
013 Bruneck,25,,94,85,179
013 Bruneck,26,,119,87,206
013 Bruneck,27,,100,86,186
013 Bruneck,28,,109,88,197
013 Bruneck,29,,92,93,185
013 Bruneck,30,,75,81,156
013 Bruneck,31,,71,84,155
013 Bruneck,32,,119,84,203
013 Bruneck,33,,93,98,191
013 Bruneck,34,,96,103,199
013 Bruneck,35,,104,102,206
013 Bruneck,36,,111,104,215
013 Bruneck,37,,110,124,234
013 Bruneck,38,,113,114,227
013 Bruneck,39,,94,109,203
013 Bruneck,40,,125,126,251
013 Bruneck,41,,117,118,235
013 Bruneck,42,,105,135,240
013 Bruneck,43,,128,130,258
013 Bruneck,44,,138,119,257
013 Bruneck,45,,140,122,262
013 Bruneck,46,,125,142,267
013 Bruneck,47,,144,112,256
013 Bruneck,48,,114,149,263
013 Bruneck,49,,136,129,265
013 Bruneck,50,,122,146,268
013 Bruneck,51,,136,139,275
013 Bruneck,52,,135,134,269
013 Bruneck,53,,157,149,306
013 Bruneck,54,,139,138,277
013 Bruneck,55,,140,110,250
013 Bruneck,56,,125,124,249
013 Bruneck,57,,126,108,234
013 Bruneck,58,,111,127,238
013 Bruneck,59,,104,104,208
013 Bruneck,60,,102,122,224
013 Bruneck,61,,81,99,180
013 Bruneck,62,,85,92,177
013 Bruneck,63,,74,84,158
013 Bruneck,64,,86,84,170
013 Bruneck,65,,73,100,173
013 Bruneck,66,,85,97,182
013 Bruneck,67,,64,102,166
013 Bruneck,68,,77,95,172
013 Bruneck,69,,80,86,166
013 Bruneck,70,,72,106,178
013 Bruneck,71,,88,68,156
013 Bruneck,72,,90,81,171
013 Bruneck,73,,58,63,121
013 Bruneck,74,,78,93,171
013 Bruneck,75,,92,79,171
013 Bruneck,76,,68,82,150
013 Bruneck,77,,62,84,146
013 Bruneck,78,,56,80,136
013 Bruneck,79,,62,88,150
013 Bruneck,80,,49,48,97
013 Bruneck,81,,42,46,88
013 Bruneck,82,,32,48,80
013 Bruneck,83,,27,44,71
013 Bruneck,84,,21,42,63
013 Bruneck,85,,32,44,76
013 Bruneck,86,,24,41,65
013 Bruneck,87,,24,31,55
013 Bruneck,88,,16,32,48
013 Bruneck,89,,9,27,36
013 Bruneck,90,,13,36,49
013 Bruneck,91,,9,20,29
013 Bruneck,92,,10,14,24
013 Bruneck,93,,7,16,23
013 Bruneck,94,,-,16,16
013 Bruneck,95,,6,11,17
013 Bruneck,96,,6,8,14
013 Bruneck,97,,-,6,6
013 Bruneck,98,,1,1,2
013 Bruneck,99,,-,1,1
013 Bruneck,100,,-,1,1
013 Bruneck,101,,1,-,1
014 Kuens,0,,2,-,2
014 Kuens,1,,1,-,1
014 Kuens,2,,2,1,3
014 Kuens,3,,1,1,2
014 Kuens,4,,1,-,1
014 Kuens,5,,2,5,7
014 Kuens,6,,1,1,2
014 Kuens,7,,3,6,9
014 Kuens,8,,1,2,3
014 Kuens,9,,3,4,7
014 Kuens,10,,4,3,7
014 Kuens,11,,2,5,7
014 Kuens,12,,1,1,2
014 Kuens,13,,6,2,8
014 Kuens,14,,-,3,3
014 Kuens,15,,6,4,10
014 Kuens,16,,2,1,3
014 Kuens,17,,5,2,7
014 Kuens,18,,2,5,7
014 Kuens,19,,1,3,4
014 Kuens,20,,2,6,8
014 Kuens,21,,1,1,2
014 Kuens,22,,5,2,7
014 Kuens,23,,2,3,5
014 Kuens,24,,1,4,5
014 Kuens,25,,2,2,4
014 Kuens,26,,3,2,5
014 Kuens,27,,2,-,2
014 Kuens,28,,4,1,5
014 Kuens,29,,1,1,2
014 Kuens,31,,1,1,2
014 Kuens,32,,1,1,2
014 Kuens,33,,1,3,4
014 Kuens,34,,2,2,4
014 Kuens,35,,1,2,3
014 Kuens,36,,2,1,3
014 Kuens,37,,1,3,4
014 Kuens,38,,5,4,9
014 Kuens,39,,2,2,4
014 Kuens,40,,3,1,4
014 Kuens,41,,2,1,3
014 Kuens,42,,3,-,3
014 Kuens,43,,3,7,10
014 Kuens,44,,3,6,9
014 Kuens,45,,2,4,6
014 Kuens,46,,6,1,7
014 Kuens,47,,2,3,5
014 Kuens,48,,7,5,12
014 Kuens,49,,4,1,5
014 Kuens,50,,4,4,8
014 Kuens,51,,6,9,15
014 Kuens,52,,1,6,7
014 Kuens,53,,6,1,7
014 Kuens,54,,5,5,10
014 Kuens,55,,7,1,8
014 Kuens,56,,5,1,6
014 Kuens,57,,1,6,7
014 Kuens,59,,1,-,1
014 Kuens,60,,-,6,6
014 Kuens,61,,3,-,3
014 Kuens,62,,2,-,2
014 Kuens,63,,1,2,3
014 Kuens,64,,-,1,1
014 Kuens,65,,2,-,2
014 Kuens,66,,1,4,5
014 Kuens,68,,1,3,4
014 Kuens,69,,-,2,2
014 Kuens,70,,3,1,4
014 Kuens,71,,1,2,3
014 Kuens,72,,1,2,3
014 Kuens,73,,3,1,4
014 Kuens,75,,-,2,2
014 Kuens,76,,1,2,3
014 Kuens,77,,1,2,3
014 Kuens,78,,-,1,1
014 Kuens,79,,4,2,6
014 Kuens,80,,3,2,5
014 Kuens,81,,1,2,3
014 Kuens,82,,1,2,3
014 Kuens,83,,1,2,3
014 Kuens,84,,-,1,1
014 Kuens,85,,-,1,1
014 Kuens,86,,2,2,4
014 Kuens,87,,2,2,4
014 Kuens,88,,2,1,3
014 Kuens,91,,1,-,1
014 Kuens,96,,-,1,1
015 Kaltern a.d. Weinstr.,0,,44,45,89
015 Kaltern a.d. Weinstr.,1,,45,38,83
015 Kaltern a.d. Weinstr.,2,,37,53,90
015 Kaltern a.d. Weinstr.,3,,46,35,81
015 Kaltern a.d. Weinstr.,4,,48,48,96
015 Kaltern a.d. Weinstr.,5,,46,51,97
015 Kaltern a.d. Weinstr.,6,,57,30,87
015 Kaltern a.d. Weinstr.,7,,45,51,96
015 Kaltern a.d. Weinstr.,8,,47,33,80
015 Kaltern a.d. Weinstr.,9,,43,29,72
015 Kaltern a.d. Weinstr.,10,,44,43,87
015 Kaltern a.d. Weinstr.,11,,44,40,84
015 Kaltern a.d. Weinstr.,12,,47,41,88
015 Kaltern a.d. Weinstr.,13,,44,44,88
015 Kaltern a.d. Weinstr.,14,,46,51,97
015 Kaltern a.d. Weinstr.,15,,42,39,81
015 Kaltern a.d. Weinstr.,16,,41,36,77
015 Kaltern a.d. Weinstr.,17,,32,52,84
015 Kaltern a.d. Weinstr.,18,,32,36,68
015 Kaltern a.d. Weinstr.,19,,45,45,90
015 Kaltern a.d. Weinstr.,20,,42,48,90
015 Kaltern a.d. Weinstr.,21,,46,46,92
015 Kaltern a.d. Weinstr.,22,,46,45,91
015 Kaltern a.d. Weinstr.,23,,41,37,78
015 Kaltern a.d. Weinstr.,24,,33,43,76
015 Kaltern a.d. Weinstr.,25,,38,39,77
015 Kaltern a.d. Weinstr.,26,,41,50,91
015 Kaltern a.d. Weinstr.,27,,46,42,88
015 Kaltern a.d. Weinstr.,28,,42,43,85
015 Kaltern a.d. Weinstr.,29,,66,45,111
015 Kaltern a.d. Weinstr.,30,,50,48,98
015 Kaltern a.d. Weinstr.,31,,40,39,79
015 Kaltern a.d. Weinstr.,32,,49,42,91
015 Kaltern a.d. Weinstr.,33,,59,38,97
015 Kaltern a.d. Weinstr.,34,,48,58,106
015 Kaltern a.d. Weinstr.,35,,51,63,114
015 Kaltern a.d. Weinstr.,36,,64,59,123
015 Kaltern a.d. Weinstr.,37,,56,50,106
015 Kaltern a.d. Weinstr.,38,,53,69,122
015 Kaltern a.d. Weinstr.,39,,50,50,100
015 Kaltern a.d. Weinstr.,40,,59,48,107
015 Kaltern a.d. Weinstr.,41,,47,65,112
015 Kaltern a.d. Weinstr.,42,,55,56,111
015 Kaltern a.d. Weinstr.,43,,43,65,108
015 Kaltern a.d. Weinstr.,44,,59,46,105
015 Kaltern a.d. Weinstr.,45,,43,56,99
015 Kaltern a.d. Weinstr.,46,,61,71,132
015 Kaltern a.d. Weinstr.,47,,69,67,136
015 Kaltern a.d. Weinstr.,48,,60,60,120
015 Kaltern a.d. Weinstr.,49,,53,66,119
015 Kaltern a.d. Weinstr.,50,,75,73,148
015 Kaltern a.d. Weinstr.,51,,65,68,133
015 Kaltern a.d. Weinstr.,52,,64,70,134
015 Kaltern a.d. Weinstr.,53,,58,66,124
015 Kaltern a.d. Weinstr.,54,,83,50,133
015 Kaltern a.d. Weinstr.,55,,52,62,114
015 Kaltern a.d. Weinstr.,56,,57,57,114
015 Kaltern a.d. Weinstr.,57,,67,69,136
015 Kaltern a.d. Weinstr.,58,,51,69,120
015 Kaltern a.d. Weinstr.,59,,56,60,116
015 Kaltern a.d. Weinstr.,60,,55,62,117
015 Kaltern a.d. Weinstr.,61,,52,61,113
015 Kaltern a.d. Weinstr.,62,,61,42,103
015 Kaltern a.d. Weinstr.,63,,48,42,90
015 Kaltern a.d. Weinstr.,64,,37,50,87
015 Kaltern a.d. Weinstr.,65,,38,38,76
015 Kaltern a.d. Weinstr.,66,,36,57,93
015 Kaltern a.d. Weinstr.,67,,33,38,71
015 Kaltern a.d. Weinstr.,68,,44,34,78
015 Kaltern a.d. Weinstr.,69,,29,35,64
015 Kaltern a.d. Weinstr.,70,,32,32,64
015 Kaltern a.d. Weinstr.,71,,31,50,81
015 Kaltern a.d. Weinstr.,72,,44,43,87
015 Kaltern a.d. Weinstr.,73,,31,38,69
015 Kaltern a.d. Weinstr.,74,,30,42,72
015 Kaltern a.d. Weinstr.,75,,28,37,65
015 Kaltern a.d. Weinstr.,76,,35,37,72
015 Kaltern a.d. Weinstr.,77,,42,36,78
015 Kaltern a.d. Weinstr.,78,,23,36,59
015 Kaltern a.d. Weinstr.,79,,19,29,48
015 Kaltern a.d. Weinstr.,80,,24,37,61
015 Kaltern a.d. Weinstr.,81,,23,28,51
015 Kaltern a.d. Weinstr.,82,,17,21,38
015 Kaltern a.d. Weinstr.,83,,16,21,37
015 Kaltern a.d. Weinstr.,84,,15,20,35
015 Kaltern a.d. Weinstr.,85,,14,26,40
015 Kaltern a.d. Weinstr.,86,,11,23,34
015 Kaltern a.d. Weinstr.,87,,10,20,30
015 Kaltern a.d. Weinstr.,88,,11,20,31
015 Kaltern a.d. Weinstr.,89,,9,17,26
015 Kaltern a.d. Weinstr.,90,,6,12,18
015 Kaltern a.d. Weinstr.,91,,5,16,21
015 Kaltern a.d. Weinstr.,92,,3,7,10
015 Kaltern a.d. Weinstr.,93,,1,14,15
015 Kaltern a.d. Weinstr.,94,,1,3,4
015 Kaltern a.d. Weinstr.,95,,-,5,5
015 Kaltern a.d. Weinstr.,96,,1,7,8
015 Kaltern a.d. Weinstr.,97,,1,2,3
015 Kaltern a.d. Weinstr.,98,,-,3,3
015 Kaltern a.d. Weinstr.,99,,-,1,1
015 Kaltern a.d. Weinstr.,100,,-,1,1
015 Kaltern a.d. Weinstr.,103,,-,1,1
016 Freienfeld,0,,15,9,24
016 Freienfeld,1,,8,18,26
016 Freienfeld,2,,11,16,27
016 Freienfeld,3,,11,10,21
016 Freienfeld,4,,13,11,24
016 Freienfeld,5,,10,12,22
016 Freienfeld,6,,12,15,27
016 Freienfeld,7,,21,15,36
016 Freienfeld,8,,16,14,30
016 Freienfeld,9,,17,18,35
016 Freienfeld,10,,12,12,24
016 Freienfeld,11,,22,12,34
016 Freienfeld,12,,16,13,29
016 Freienfeld,13,,19,18,37
016 Freienfeld,14,,15,10,25
016 Freienfeld,15,,19,17,36
016 Freienfeld,16,,20,20,40
016 Freienfeld,17,,16,19,35
016 Freienfeld,18,,16,13,29
016 Freienfeld,19,,16,22,38
016 Freienfeld,20,,14,19,33
016 Freienfeld,21,,16,17,33
016 Freienfeld,22,,23,14,37
016 Freienfeld,23,,16,18,34
016 Freienfeld,24,,13,10,23
016 Freienfeld,25,,15,11,26
016 Freienfeld,26,,17,19,36
016 Freienfeld,27,,12,11,23
016 Freienfeld,28,,22,13,35
016 Freienfeld,29,,27,20,47
016 Freienfeld,30,,23,14,37
016 Freienfeld,31,,15,10,25
016 Freienfeld,32,,14,18,32
016 Freienfeld,33,,15,13,28
016 Freienfeld,34,,20,13,33
016 Freienfeld,35,,26,18,44
016 Freienfeld,36,,14,18,32
016 Freienfeld,37,,20,15,35
016 Freienfeld,38,,19,13,32
016 Freienfeld,39,,14,20,34
016 Freienfeld,40,,16,16,32
016 Freienfeld,41,,19,23,42
016 Freienfeld,42,,15,13,28
016 Freienfeld,43,,16,14,30
016 Freienfeld,44,,21,23,44
016 Freienfeld,45,,20,19,39
016 Freienfeld,46,,14,24,38
016 Freienfeld,47,,25,22,47
016 Freienfeld,48,,25,16,41
016 Freienfeld,49,,22,24,46
016 Freienfeld,50,,18,16,34
016 Freienfeld,51,,23,26,49
016 Freienfeld,52,,21,22,43
016 Freienfeld,53,,25,19,44
016 Freienfeld,54,,25,16,41
016 Freienfeld,55,,19,17,36
016 Freienfeld,56,,25,29,54
016 Freienfeld,57,,25,16,41
016 Freienfeld,58,,17,25,42
016 Freienfeld,59,,24,14,38
016 Freienfeld,60,,17,21,38
016 Freienfeld,61,,13,19,32
016 Freienfeld,62,,18,16,34
016 Freienfeld,63,,18,10,28
016 Freienfeld,64,,16,18,34
016 Freienfeld,65,,17,11,28
016 Freienfeld,66,,13,17,30
016 Freienfeld,67,,12,9,21
016 Freienfeld,68,,17,10,27
016 Freienfeld,69,,16,10,26
016 Freienfeld,70,,14,11,25
016 Freienfeld,71,,4,9,13
016 Freienfeld,72,,11,15,26
016 Freienfeld,73,,8,2,10
016 Freienfeld,74,,8,5,13
016 Freienfeld,75,,8,7,15
016 Freienfeld,76,,9,8,17
016 Freienfeld,77,,10,9,19
016 Freienfeld,78,,8,5,13
016 Freienfeld,79,,6,9,15
016 Freienfeld,80,,9,12,21
016 Freienfeld,81,,2,10,12
016 Freienfeld,82,,8,10,18
016 Freienfeld,83,,5,8,13
016 Freienfeld,84,,3,3,6
016 Freienfeld,85,,5,8,13
016 Freienfeld,86,,4,4,8
016 Freienfeld,87,,2,4,6
016 Freienfeld,88,,4,5,9
016 Freienfeld,89,,1,3,4
016 Freienfeld,90,,2,3,5
016 Freienfeld,91,,1,3,4
016 Freienfeld,92,,3,-,3
016 Freienfeld,93,,-,1,1
016 Freienfeld,95,,-,3,3
016 Freienfeld,98,,-,1,1
017 Sand in Taufers,0,,21,28,49
017 Sand in Taufers,1,,25,39,64
017 Sand in Taufers,2,,26,38,64
017 Sand in Taufers,3,,24,33,57
017 Sand in Taufers,4,,33,28,61
017 Sand in Taufers,5,,25,21,46
017 Sand in Taufers,6,,21,33,54
017 Sand in Taufers,7,,22,26,48
017 Sand in Taufers,8,,25,22,47
017 Sand in Taufers,9,,33,42,75
017 Sand in Taufers,10,,28,31,59
017 Sand in Taufers,11,,48,38,86
017 Sand in Taufers,12,,34,20,54
017 Sand in Taufers,13,,37,30,67
017 Sand in Taufers,14,,35,22,57
017 Sand in Taufers,15,,37,33,70
017 Sand in Taufers,16,,27,28,55
017 Sand in Taufers,17,,31,37,68
017 Sand in Taufers,18,,43,26,69
017 Sand in Taufers,19,,35,40,75
017 Sand in Taufers,20,,30,32,62
017 Sand in Taufers,21,,39,35,74
017 Sand in Taufers,22,,30,34,64
017 Sand in Taufers,23,,30,25,55
017 Sand in Taufers,24,,47,34,81
017 Sand in Taufers,25,,26,33,59
017 Sand in Taufers,26,,32,37,69
017 Sand in Taufers,27,,26,28,54
017 Sand in Taufers,28,,30,36,66
017 Sand in Taufers,29,,33,34,67
017 Sand in Taufers,30,,30,34,64
017 Sand in Taufers,31,,24,28,52
017 Sand in Taufers,32,,30,31,61
017 Sand in Taufers,33,,32,29,61
017 Sand in Taufers,34,,35,28,63
017 Sand in Taufers,35,,32,33,65
017 Sand in Taufers,36,,27,39,66
017 Sand in Taufers,37,,35,36,71
017 Sand in Taufers,38,,38,39,77
017 Sand in Taufers,39,,38,43,81
017 Sand in Taufers,40,,43,35,78
017 Sand in Taufers,41,,35,40,75
017 Sand in Taufers,42,,41,34,75
017 Sand in Taufers,43,,47,38,85
017 Sand in Taufers,44,,58,49,107
017 Sand in Taufers,45,,56,45,101
017 Sand in Taufers,46,,44,51,95
017 Sand in Taufers,47,,48,49,97
017 Sand in Taufers,48,,45,60,105
017 Sand in Taufers,49,,60,45,105
017 Sand in Taufers,50,,52,36,88
017 Sand in Taufers,51,,34,40,74
017 Sand in Taufers,52,,48,38,86
017 Sand in Taufers,53,,55,36,91
017 Sand in Taufers,54,,54,45,99
017 Sand in Taufers,55,,43,41,84
017 Sand in Taufers,56,,39,43,82
017 Sand in Taufers,57,,44,43,87
017 Sand in Taufers,58,,39,30,69
017 Sand in Taufers,59,,35,33,68
017 Sand in Taufers,60,,30,20,50
017 Sand in Taufers,61,,25,37,62
017 Sand in Taufers,62,,25,32,57
017 Sand in Taufers,63,,19,22,41
017 Sand in Taufers,64,,26,28,54
017 Sand in Taufers,65,,26,25,51
017 Sand in Taufers,66,,17,28,45
017 Sand in Taufers,67,,24,21,45
017 Sand in Taufers,68,,29,32,61
017 Sand in Taufers,69,,26,23,49
017 Sand in Taufers,70,,23,24,47
017 Sand in Taufers,71,,22,30,52
017 Sand in Taufers,72,,25,23,48
017 Sand in Taufers,73,,22,7,29
017 Sand in Taufers,74,,13,30,43
017 Sand in Taufers,75,,21,26,47
017 Sand in Taufers,76,,26,28,54
017 Sand in Taufers,77,,23,27,50
017 Sand in Taufers,78,,21,17,38
017 Sand in Taufers,79,,15,29,44
017 Sand in Taufers,80,,14,20,34
017 Sand in Taufers,81,,19,11,30
017 Sand in Taufers,82,,11,20,31
017 Sand in Taufers,83,,13,15,28
017 Sand in Taufers,84,,10,9,19
017 Sand in Taufers,85,,10,11,21
017 Sand in Taufers,86,,4,12,16
017 Sand in Taufers,87,,4,8,12
017 Sand in Taufers,88,,5,15,20
017 Sand in Taufers,89,,5,7,12
017 Sand in Taufers,90,,-,6,6
017 Sand in Taufers,91,,2,3,5
017 Sand in Taufers,92,,2,6,8
017 Sand in Taufers,93,,1,2,3
017 Sand in Taufers,94,,-,5,5
017 Sand in Taufers,95,,-,2,2
017 Sand in Taufers,96,,-,1,1
017 Sand in Taufers,97,,-,1,1
017 Sand in Taufers,98,,-,1,1
017 Sand in Taufers,100,,-,1,1
018 Kastelbell-Tschars,0,,15,7,22
018 Kastelbell-Tschars,1,,14,8,22
018 Kastelbell-Tschars,2,,10,16,26
018 Kastelbell-Tschars,3,,9,9,18
018 Kastelbell-Tschars,4,,8,12,20
018 Kastelbell-Tschars,5,,14,17,31
018 Kastelbell-Tschars,6,,16,7,23
018 Kastelbell-Tschars,7,,15,9,24
018 Kastelbell-Tschars,8,,11,19,30
018 Kastelbell-Tschars,9,,10,10,20
018 Kastelbell-Tschars,10,,9,6,15
018 Kastelbell-Tschars,11,,11,9,20
018 Kastelbell-Tschars,12,,19,6,25
018 Kastelbell-Tschars,13,,9,7,16
018 Kastelbell-Tschars,14,,13,11,24
018 Kastelbell-Tschars,15,,12,9,21
018 Kastelbell-Tschars,16,,8,8,16
018 Kastelbell-Tschars,17,,15,14,29
018 Kastelbell-Tschars,18,,13,11,24
018 Kastelbell-Tschars,19,,23,12,35
018 Kastelbell-Tschars,20,,18,8,26
018 Kastelbell-Tschars,21,,12,12,24
018 Kastelbell-Tschars,22,,16,14,30
018 Kastelbell-Tschars,23,,15,8,23
018 Kastelbell-Tschars,24,,13,12,25
018 Kastelbell-Tschars,25,,13,14,27
018 Kastelbell-Tschars,26,,12,10,22
018 Kastelbell-Tschars,27,,17,11,28
018 Kastelbell-Tschars,28,,14,15,29
018 Kastelbell-Tschars,29,,10,11,21
018 Kastelbell-Tschars,30,,13,8,21
018 Kastelbell-Tschars,31,,17,12,29
018 Kastelbell-Tschars,32,,13,14,27
018 Kastelbell-Tschars,33,,17,17,34
018 Kastelbell-Tschars,34,,10,16,26
018 Kastelbell-Tschars,35,,10,14,24
018 Kastelbell-Tschars,36,,26,9,35
018 Kastelbell-Tschars,37,,11,12,23
018 Kastelbell-Tschars,38,,11,14,25
018 Kastelbell-Tschars,39,,12,14,26
018 Kastelbell-Tschars,40,,16,12,28
018 Kastelbell-Tschars,41,,13,14,27
018 Kastelbell-Tschars,42,,18,18,36
018 Kastelbell-Tschars,43,,19,14,33
018 Kastelbell-Tschars,44,,20,9,29
018 Kastelbell-Tschars,45,,14,23,37
018 Kastelbell-Tschars,46,,13,18,31
018 Kastelbell-Tschars,47,,16,16,32
018 Kastelbell-Tschars,48,,15,12,27
018 Kastelbell-Tschars,49,,25,23,48
018 Kastelbell-Tschars,50,,15,18,33
018 Kastelbell-Tschars,51,,15,24,39
018 Kastelbell-Tschars,52,,19,12,31
018 Kastelbell-Tschars,53,,19,11,30
018 Kastelbell-Tschars,54,,20,18,38
018 Kastelbell-Tschars,55,,21,22,43
018 Kastelbell-Tschars,56,,6,20,26
018 Kastelbell-Tschars,57,,18,17,35
018 Kastelbell-Tschars,58,,22,20,42
018 Kastelbell-Tschars,59,,22,20,42
018 Kastelbell-Tschars,60,,17,14,31
018 Kastelbell-Tschars,61,,11,12,23
018 Kastelbell-Tschars,62,,12,14,26
018 Kastelbell-Tschars,63,,20,16,36
018 Kastelbell-Tschars,64,,10,8,18
018 Kastelbell-Tschars,65,,9,16,25
018 Kastelbell-Tschars,66,,10,14,24
018 Kastelbell-Tschars,67,,16,13,29
018 Kastelbell-Tschars,68,,11,13,24
018 Kastelbell-Tschars,69,,13,10,23
018 Kastelbell-Tschars,70,,11,14,25
018 Kastelbell-Tschars,71,,9,8,17
018 Kastelbell-Tschars,72,,10,12,22
018 Kastelbell-Tschars,73,,11,4,15
018 Kastelbell-Tschars,74,,12,5,17
018 Kastelbell-Tschars,75,,7,7,14
018 Kastelbell-Tschars,76,,9,10,19
018 Kastelbell-Tschars,77,,7,7,14
018 Kastelbell-Tschars,78,,8,7,15
018 Kastelbell-Tschars,79,,10,11,21
018 Kastelbell-Tschars,80,,5,13,18
018 Kastelbell-Tschars,81,,11,8,19
018 Kastelbell-Tschars,82,,6,13,19
018 Kastelbell-Tschars,83,,7,6,13
018 Kastelbell-Tschars,84,,5,10,15
018 Kastelbell-Tschars,85,,9,9,18
018 Kastelbell-Tschars,86,,4,9,13
018 Kastelbell-Tschars,87,,6,5,11
018 Kastelbell-Tschars,88,,9,10,19
018 Kastelbell-Tschars,89,,5,6,11
018 Kastelbell-Tschars,90,,3,4,7
018 Kastelbell-Tschars,91,,1,3,4
018 Kastelbell-Tschars,92,,1,5,6
018 Kastelbell-Tschars,93,,6,3,9
018 Kastelbell-Tschars,94,,1,2,3
018 Kastelbell-Tschars,96,,-,2,2
019 Kastelruth,0,,33,29,62
019 Kastelruth,1,,33,32,65
019 Kastelruth,2,,39,40,79
019 Kastelruth,3,,34,34,68
019 Kastelruth,4,,39,38,77
019 Kastelruth,5,,34,36,70
019 Kastelruth,6,,39,40,79
019 Kastelruth,7,,45,37,82
019 Kastelruth,8,,38,32,70
019 Kastelruth,9,,27,37,64
019 Kastelruth,10,,51,33,84
019 Kastelruth,11,,44,35,79
019 Kastelruth,12,,46,37,83
019 Kastelruth,13,,45,32,77
019 Kastelruth,14,,49,40,89
019 Kastelruth,15,,49,40,89
019 Kastelruth,16,,38,35,73
019 Kastelruth,17,,42,35,77
019 Kastelruth,18,,37,26,63
019 Kastelruth,19,,34,47,81
019 Kastelruth,20,,50,42,92
019 Kastelruth,21,,45,51,96
019 Kastelruth,22,,44,39,83
019 Kastelruth,23,,58,36,94
019 Kastelruth,24,,39,33,72
019 Kastelruth,25,,39,35,74
019 Kastelruth,26,,39,46,85
019 Kastelruth,27,,38,47,85
019 Kastelruth,28,,45,38,83
019 Kastelruth,29,,50,44,94
019 Kastelruth,30,,27,31,58
019 Kastelruth,31,,41,42,83
019 Kastelruth,32,,34,32,66
019 Kastelruth,33,,32,45,77
019 Kastelruth,34,,31,41,72
019 Kastelruth,35,,45,32,77
019 Kastelruth,36,,54,47,101
019 Kastelruth,37,,41,52,93
019 Kastelruth,38,,57,45,102
019 Kastelruth,39,,46,37,83
019 Kastelruth,40,,37,43,80
019 Kastelruth,41,,40,46,86
019 Kastelruth,42,,46,62,108
019 Kastelruth,43,,54,48,102
019 Kastelruth,44,,67,49,116
019 Kastelruth,45,,43,66,109
019 Kastelruth,46,,64,43,107
019 Kastelruth,47,,54,44,98
019 Kastelruth,48,,51,54,105
019 Kastelruth,49,,57,45,102
019 Kastelruth,50,,63,59,122
019 Kastelruth,51,,64,57,121
019 Kastelruth,52,,68,46,114
019 Kastelruth,53,,43,76,119
019 Kastelruth,54,,57,37,94
019 Kastelruth,55,,51,34,85
019 Kastelruth,56,,33,55,88
019 Kastelruth,57,,53,42,95
019 Kastelruth,58,,42,38,80
019 Kastelruth,59,,44,50,94
019 Kastelruth,60,,48,46,94
019 Kastelruth,61,,38,38,76
019 Kastelruth,62,,38,33,71
019 Kastelruth,63,,39,40,79
019 Kastelruth,64,,34,33,67
019 Kastelruth,65,,29,29,58
019 Kastelruth,66,,35,26,61
019 Kastelruth,67,,28,21,49
019 Kastelruth,68,,38,24,62
019 Kastelruth,69,,17,32,49
019 Kastelruth,70,,26,41,67
019 Kastelruth,71,,28,30,58
019 Kastelruth,72,,23,35,58
019 Kastelruth,73,,22,21,43
019 Kastelruth,74,,24,40,64
019 Kastelruth,75,,36,37,73
019 Kastelruth,76,,28,23,51
019 Kastelruth,77,,24,42,66
019 Kastelruth,78,,22,34,56
019 Kastelruth,79,,23,25,48
019 Kastelruth,80,,19,24,43
019 Kastelruth,81,,23,18,41
019 Kastelruth,82,,20,12,32
019 Kastelruth,83,,20,22,42
019 Kastelruth,84,,13,18,31
019 Kastelruth,85,,21,21,42
019 Kastelruth,86,,12,26,38
019 Kastelruth,87,,21,14,35
019 Kastelruth,88,,6,18,24
019 Kastelruth,89,,9,9,18
019 Kastelruth,90,,3,5,8
019 Kastelruth,91,,7,14,21
019 Kastelruth,92,,4,8,12
019 Kastelruth,93,,4,3,7
019 Kastelruth,94,,3,7,10
019 Kastelruth,95,,1,5,6
019 Kastelruth,96,,-,4,4
019 Kastelruth,97,,-,3,3
019 Kastelruth,99,,-,2,2
020 Tscherms,0,,8,10,18
020 Tscherms,1,,5,10,15
020 Tscherms,2,,20,8,28
020 Tscherms,3,,11,7,18
020 Tscherms,4,,7,13,20
020 Tscherms,5,,7,5,12
020 Tscherms,6,,11,9,20
020 Tscherms,7,,18,6,24
020 Tscherms,8,,9,6,15
020 Tscherms,9,,6,7,13
020 Tscherms,10,,8,11,19
020 Tscherms,11,,8,11,19
020 Tscherms,12,,7,5,12
020 Tscherms,13,,1,11,12
020 Tscherms,14,,9,7,16
020 Tscherms,15,,8,10,18
020 Tscherms,16,,9,6,15
020 Tscherms,17,,4,8,12
020 Tscherms,18,,10,7,17
020 Tscherms,19,,8,9,17
020 Tscherms,20,,4,7,11
020 Tscherms,21,,12,9,21
020 Tscherms,22,,5,5,10
020 Tscherms,23,,12,9,21
020 Tscherms,24,,10,14,24
020 Tscherms,25,,9,8,17
020 Tscherms,26,,10,5,15
020 Tscherms,27,,8,9,17
020 Tscherms,28,,9,6,15
020 Tscherms,29,,5,5,10
020 Tscherms,30,,7,10,17
020 Tscherms,31,,10,7,17
020 Tscherms,32,,9,4,13
020 Tscherms,33,,10,12,22
020 Tscherms,34,,9,8,17
020 Tscherms,35,,10,13,23
020 Tscherms,36,,5,9,14
020 Tscherms,37,,11,10,21
020 Tscherms,38,,10,14,24
020 Tscherms,39,,8,9,17
020 Tscherms,40,,5,11,16
020 Tscherms,41,,9,8,17
020 Tscherms,42,,7,10,17
020 Tscherms,43,,14,7,21
020 Tscherms,44,,15,9,24
020 Tscherms,45,,11,14,25
020 Tscherms,46,,9,13,22
020 Tscherms,47,,11,13,24
020 Tscherms,48,,14,8,22
020 Tscherms,49,,9,16,25
020 Tscherms,50,,13,8,21
020 Tscherms,51,,11,12,23
020 Tscherms,52,,15,8,23
020 Tscherms,53,,19,19,38
020 Tscherms,54,,15,19,34
020 Tscherms,55,,14,12,26
020 Tscherms,56,,21,14,35
020 Tscherms,57,,13,12,25
020 Tscherms,58,,11,13,24
020 Tscherms,59,,8,18,26
020 Tscherms,60,,9,9,18
020 Tscherms,61,,8,10,18
020 Tscherms,62,,7,5,12
020 Tscherms,63,,10,8,18
020 Tscherms,64,,6,9,15
020 Tscherms,65,,10,8,18
020 Tscherms,66,,11,6,17
020 Tscherms,67,,5,9,14
020 Tscherms,68,,10,6,16
020 Tscherms,69,,4,2,6
020 Tscherms,70,,5,6,11
020 Tscherms,71,,7,8,15
020 Tscherms,72,,4,8,12
020 Tscherms,73,,3,6,9
020 Tscherms,74,,5,7,12
020 Tscherms,75,,5,4,9
020 Tscherms,76,,7,3,10
020 Tscherms,77,,10,6,16
020 Tscherms,78,,4,4,8
020 Tscherms,79,,4,5,9
020 Tscherms,80,,5,2,7
020 Tscherms,81,,4,8,12
020 Tscherms,82,,6,7,13
020 Tscherms,83,,2,3,5
020 Tscherms,84,,1,8,9
020 Tscherms,85,,3,3,6
020 Tscherms,86,,4,6,10
020 Tscherms,87,,2,2,4
020 Tscherms,88,,3,3,6
020 Tscherms,89,,-,1,1
020 Tscherms,90,,4,3,7
020 Tscherms,91,,3,-,3
020 Tscherms,92,,1,-,1
020 Tscherms,93,,2,3,5
020 Tscherms,94,,2,2,4
020 Tscherms,95,,-,2,2
021 Kiens,0,,13,17,30
021 Kiens,1,,14,12,26
021 Kiens,2,,19,15,34
021 Kiens,3,,13,16,29
021 Kiens,4,,16,19,35
021 Kiens,5,,23,6,29
021 Kiens,6,,14,25,39
021 Kiens,7,,14,9,23
021 Kiens,8,,19,15,34
021 Kiens,9,,8,21,29
021 Kiens,10,,14,9,23
021 Kiens,11,,13,14,27
021 Kiens,12,,16,6,22
021 Kiens,13,,17,21,38
021 Kiens,14,,20,13,33
021 Kiens,15,,17,21,38
021 Kiens,16,,10,14,24
021 Kiens,17,,21,22,43
021 Kiens,18,,9,21,30
021 Kiens,19,,20,19,39
021 Kiens,20,,22,11,33
021 Kiens,21,,20,17,37
021 Kiens,22,,15,19,34
021 Kiens,23,,17,22,39
021 Kiens,24,,19,15,34
021 Kiens,25,,20,20,40
021 Kiens,26,,25,17,42
021 Kiens,27,,16,17,33
021 Kiens,28,,16,22,38
021 Kiens,29,,17,16,33
021 Kiens,30,,15,13,28
021 Kiens,31,,15,20,35
021 Kiens,32,,18,10,28
021 Kiens,33,,21,13,34
021 Kiens,34,,20,15,35
021 Kiens,35,,16,17,33
021 Kiens,36,,27,21,48
021 Kiens,37,,18,19,37
021 Kiens,38,,21,17,38
021 Kiens,39,,13,14,27
021 Kiens,40,,24,17,41
021 Kiens,41,,19,15,34
021 Kiens,42,,19,28,47
021 Kiens,43,,16,22,38
021 Kiens,44,,14,19,33
021 Kiens,45,,33,23,56
021 Kiens,46,,24,17,41
021 Kiens,47,,26,21,47
021 Kiens,48,,21,29,50
021 Kiens,49,,30,26,56
021 Kiens,50,,38,27,65
021 Kiens,51,,23,24,47
021 Kiens,52,,26,25,51
021 Kiens,53,,20,24,44
021 Kiens,54,,31,25,56
021 Kiens,55,,17,23,40
021 Kiens,56,,30,20,50
021 Kiens,57,,19,25,44
021 Kiens,58,,20,18,38
021 Kiens,59,,24,14,38
021 Kiens,60,,16,14,30
021 Kiens,61,,13,14,27
021 Kiens,62,,16,13,29
021 Kiens,63,,14,9,23
021 Kiens,64,,12,16,28
021 Kiens,65,,16,23,39
021 Kiens,66,,12,10,22
021 Kiens,67,,14,12,26
021 Kiens,68,,13,9,22
021 Kiens,69,,9,13,22
021 Kiens,70,,15,16,31
021 Kiens,71,,9,15,24
021 Kiens,72,,19,14,33
021 Kiens,73,,8,11,19
021 Kiens,74,,6,12,18
021 Kiens,75,,15,9,24
021 Kiens,76,,15,10,25
021 Kiens,77,,13,10,23
021 Kiens,78,,10,16,26
021 Kiens,79,,10,7,17
021 Kiens,80,,8,10,18
021 Kiens,81,,9,7,16
021 Kiens,82,,8,7,15
021 Kiens,83,,1,10,11
021 Kiens,84,,5,5,10
021 Kiens,85,,5,6,11
021 Kiens,86,,5,6,11
021 Kiens,87,,10,5,15
021 Kiens,88,,1,5,6
021 Kiens,89,,2,2,4
021 Kiens,90,,-,2,2
021 Kiens,91,,1,4,5
021 Kiens,93,,1,2,3
021 Kiens,94,,-,2,2
021 Kiens,95,,-,2,2
021 Kiens,96,,1,-,1
022 Klausen,0,,33,30,63
022 Klausen,1,,27,29,56
022 Klausen,2,,27,24,51
022 Klausen,3,,33,30,63
022 Klausen,4,,25,31,56
022 Klausen,5,,30,21,51
022 Klausen,6,,40,25,65
022 Klausen,7,,33,33,66
022 Klausen,8,,18,35,53
022 Klausen,9,,26,24,50
022 Klausen,10,,24,27,51
022 Klausen,11,,23,27,50
022 Klausen,12,,41,41,82
022 Klausen,13,,37,31,68
022 Klausen,14,,35,35,70
022 Klausen,15,,28,31,59
022 Klausen,16,,41,30,71
022 Klausen,17,,29,27,56
022 Klausen,18,,30,34,64
022 Klausen,19,,26,31,57
022 Klausen,20,,24,32,56
022 Klausen,21,,37,34,71
022 Klausen,22,,28,25,53
022 Klausen,23,,29,36,65
022 Klausen,24,,19,33,52
022 Klausen,25,,32,23,55
022 Klausen,26,,36,20,56
022 Klausen,27,,34,35,69
022 Klausen,28,,45,27,72
022 Klausen,29,,34,35,69
022 Klausen,30,,25,36,61
022 Klausen,31,,28,27,55
022 Klausen,32,,32,17,49
022 Klausen,33,,32,33,65
022 Klausen,34,,26,24,50
022 Klausen,35,,30,36,66
022 Klausen,36,,39,41,80
022 Klausen,37,,31,35,66
022 Klausen,38,,31,38,69
022 Klausen,39,,32,26,58
022 Klausen,40,,40,30,70
022 Klausen,41,,34,29,63
022 Klausen,42,,35,29,64
022 Klausen,43,,41,40,81
022 Klausen,44,,35,35,70
022 Klausen,45,,42,30,72
022 Klausen,46,,39,38,77
022 Klausen,47,,32,43,75
022 Klausen,48,,46,43,89
022 Klausen,49,,46,50,96
022 Klausen,50,,48,43,91
022 Klausen,51,,49,41,90
022 Klausen,52,,65,41,106
022 Klausen,53,,39,47,86
022 Klausen,54,,44,44,88
022 Klausen,55,,40,36,76
022 Klausen,56,,30,42,72
022 Klausen,57,,50,41,91
022 Klausen,58,,38,26,64
022 Klausen,59,,31,37,68
022 Klausen,60,,30,27,57
022 Klausen,61,,30,28,58
022 Klausen,62,,27,24,51
022 Klausen,63,,26,31,57
022 Klausen,64,,26,37,63
022 Klausen,65,,20,32,52
022 Klausen,66,,28,15,43
022 Klausen,67,,34,25,59
022 Klausen,68,,27,20,47
022 Klausen,69,,28,29,57
022 Klausen,70,,24,26,50
022 Klausen,71,,22,20,42
022 Klausen,72,,24,23,47
022 Klausen,73,,9,17,26
022 Klausen,74,,19,17,36
022 Klausen,75,,11,26,37
022 Klausen,76,,18,24,42
022 Klausen,77,,23,19,42
022 Klausen,78,,13,21,34
022 Klausen,79,,19,17,36
022 Klausen,80,,9,19,28
022 Klausen,81,,13,13,26
022 Klausen,82,,15,17,32
022 Klausen,83,,9,14,23
022 Klausen,84,,9,8,17
022 Klausen,85,,11,12,23
022 Klausen,86,,9,12,21
022 Klausen,87,,7,10,17
022 Klausen,88,,6,13,19
022 Klausen,89,,7,7,14
022 Klausen,90,,2,8,10
022 Klausen,91,,-,7,7
022 Klausen,92,,1,2,3
022 Klausen,93,,2,4,6
022 Klausen,94,,1,1,2
022 Klausen,95,,1,3,4
023 Karneid,0,,14,21,35
023 Karneid,1,,21,16,37
023 Karneid,2,,13,21,34
023 Karneid,3,,17,21,38
023 Karneid,4,,19,26,45
023 Karneid,5,,11,18,29
023 Karneid,6,,20,18,38
023 Karneid,7,,32,16,48
023 Karneid,8,,17,16,33
023 Karneid,9,,17,20,37
023 Karneid,10,,30,20,50
023 Karneid,11,,27,21,48
023 Karneid,12,,24,16,40
023 Karneid,13,,24,23,47
023 Karneid,14,,21,25,46
023 Karneid,15,,27,21,48
023 Karneid,16,,14,14,28
023 Karneid,17,,23,22,45
023 Karneid,18,,14,15,29
023 Karneid,19,,25,26,51
023 Karneid,20,,15,19,34
023 Karneid,21,,30,14,44
023 Karneid,22,,19,21,40
023 Karneid,23,,26,20,46
023 Karneid,24,,20,21,41
023 Karneid,25,,25,21,46
023 Karneid,26,,20,21,41
023 Karneid,27,,19,15,34
023 Karneid,28,,20,19,39
023 Karneid,29,,22,18,40
023 Karneid,30,,17,18,35
023 Karneid,31,,17,17,34
023 Karneid,32,,23,19,42
023 Karneid,33,,22,14,36
023 Karneid,34,,25,14,39
023 Karneid,35,,16,13,29
023 Karneid,36,,17,16,33
023 Karneid,37,,30,26,56
023 Karneid,38,,28,18,46
023 Karneid,39,,25,29,54
023 Karneid,40,,24,14,38
023 Karneid,41,,17,22,39
023 Karneid,42,,30,28,58
023 Karneid,43,,22,14,36
023 Karneid,44,,22,28,50
023 Karneid,45,,30,33,63
023 Karneid,46,,27,26,53
023 Karneid,47,,30,37,67
023 Karneid,48,,31,22,53
023 Karneid,49,,24,27,51
023 Karneid,50,,35,25,60
023 Karneid,51,,28,32,60
023 Karneid,52,,34,30,64
023 Karneid,53,,36,25,61
023 Karneid,54,,29,24,53
023 Karneid,55,,39,25,64
023 Karneid,56,,27,40,67
023 Karneid,57,,29,23,52
023 Karneid,58,,28,28,56
023 Karneid,59,,25,16,41
023 Karneid,60,,24,17,41
023 Karneid,61,,16,15,31
023 Karneid,62,,22,16,38
023 Karneid,63,,12,8,20
023 Karneid,64,,16,12,28
023 Karneid,65,,15,11,26
023 Karneid,66,,10,21,31
023 Karneid,67,,15,11,26
023 Karneid,68,,19,13,32
023 Karneid,69,,6,14,20
023 Karneid,70,,10,26,36
023 Karneid,71,,6,17,23
023 Karneid,72,,10,20,30
023 Karneid,73,,11,13,24
023 Karneid,74,,8,14,22
023 Karneid,75,,16,13,29
023 Karneid,76,,15,24,39
023 Karneid,77,,13,11,24
023 Karneid,78,,8,13,21
023 Karneid,79,,11,13,24
023 Karneid,80,,12,10,22
023 Karneid,81,,6,8,14
023 Karneid,82,,9,9,18
023 Karneid,83,,9,7,16
023 Karneid,84,,6,11,17
023 Karneid,85,,4,9,13
023 Karneid,86,,8,4,12
023 Karneid,87,,8,8,16
023 Karneid,88,,4,6,10
023 Karneid,89,,4,3,7
023 Karneid,90,,3,2,5
023 Karneid,91,,-,2,2
023 Karneid,92,,3,3,6
023 Karneid,93,,1,1,2
023 Karneid,94,,2,1,3
023 Karneid,95,,-,1,1
023 Karneid,96,,-,2,2
023 Karneid,98,,1,1,2
024 Kurtatsch a.d.Weinstr.,0,,4,8,12
024 Kurtatsch a.d.Weinstr.,1,,7,10,17
024 Kurtatsch a.d.Weinstr.,2,,12,13,25
024 Kurtatsch a.d.Weinstr.,3,,9,16,25
024 Kurtatsch a.d.Weinstr.,4,,7,6,13
024 Kurtatsch a.d.Weinstr.,5,,23,6,29
024 Kurtatsch a.d.Weinstr.,6,,15,10,25
024 Kurtatsch a.d.Weinstr.,7,,11,9,20
024 Kurtatsch a.d.Weinstr.,8,,7,9,16
024 Kurtatsch a.d.Weinstr.,9,,9,11,20
024 Kurtatsch a.d.Weinstr.,10,,17,8,25
024 Kurtatsch a.d.Weinstr.,11,,6,4,10
024 Kurtatsch a.d.Weinstr.,12,,9,17,26
024 Kurtatsch a.d.Weinstr.,13,,13,15,28
024 Kurtatsch a.d.Weinstr.,14,,11,12,23
024 Kurtatsch a.d.Weinstr.,15,,10,12,22
024 Kurtatsch a.d.Weinstr.,16,,13,14,27
024 Kurtatsch a.d.Weinstr.,17,,17,11,28
024 Kurtatsch a.d.Weinstr.,18,,20,14,34
024 Kurtatsch a.d.Weinstr.,19,,19,12,31
024 Kurtatsch a.d.Weinstr.,20,,18,12,30
024 Kurtatsch a.d.Weinstr.,21,,14,13,27
024 Kurtatsch a.d.Weinstr.,22,,24,16,40
024 Kurtatsch a.d.Weinstr.,23,,19,12,31
024 Kurtatsch a.d.Weinstr.,24,,14,8,22
024 Kurtatsch a.d.Weinstr.,25,,22,13,35
024 Kurtatsch a.d.Weinstr.,26,,16,13,29
024 Kurtatsch a.d.Weinstr.,27,,18,11,29
024 Kurtatsch a.d.Weinstr.,28,,13,7,20
024 Kurtatsch a.d.Weinstr.,29,,8,14,22
024 Kurtatsch a.d.Weinstr.,30,,8,13,21
024 Kurtatsch a.d.Weinstr.,31,,11,13,24
024 Kurtatsch a.d.Weinstr.,32,,11,16,27
024 Kurtatsch a.d.Weinstr.,33,,18,10,28
024 Kurtatsch a.d.Weinstr.,34,,16,4,20
024 Kurtatsch a.d.Weinstr.,35,,14,7,21
024 Kurtatsch a.d.Weinstr.,36,,11,23,34
024 Kurtatsch a.d.Weinstr.,37,,15,14,29
024 Kurtatsch a.d.Weinstr.,38,,10,10,20
024 Kurtatsch a.d.Weinstr.,39,,13,16,29
024 Kurtatsch a.d.Weinstr.,40,,10,17,27
024 Kurtatsch a.d.Weinstr.,41,,9,15,24
024 Kurtatsch a.d.Weinstr.,42,,10,11,21
024 Kurtatsch a.d.Weinstr.,43,,11,12,23
024 Kurtatsch a.d.Weinstr.,44,,14,21,35
024 Kurtatsch a.d.Weinstr.,45,,15,19,34
024 Kurtatsch a.d.Weinstr.,46,,10,13,23
024 Kurtatsch a.d.Weinstr.,47,,18,22,40
024 Kurtatsch a.d.Weinstr.,48,,15,23,38
024 Kurtatsch a.d.Weinstr.,49,,26,20,46
024 Kurtatsch a.d.Weinstr.,50,,27,16,43
024 Kurtatsch a.d.Weinstr.,51,,17,19,36
024 Kurtatsch a.d.Weinstr.,52,,27,16,43
024 Kurtatsch a.d.Weinstr.,53,,27,26,53
024 Kurtatsch a.d.Weinstr.,54,,18,25,43
024 Kurtatsch a.d.Weinstr.,55,,23,21,44
024 Kurtatsch a.d.Weinstr.,56,,21,12,33
024 Kurtatsch a.d.Weinstr.,57,,19,18,37
024 Kurtatsch a.d.Weinstr.,58,,19,20,39
024 Kurtatsch a.d.Weinstr.,59,,19,9,28
024 Kurtatsch a.d.Weinstr.,60,,12,12,24
024 Kurtatsch a.d.Weinstr.,61,,12,13,25
024 Kurtatsch a.d.Weinstr.,62,,13,8,21
024 Kurtatsch a.d.Weinstr.,63,,14,18,32
024 Kurtatsch a.d.Weinstr.,64,,13,8,21
024 Kurtatsch a.d.Weinstr.,65,,16,20,36
024 Kurtatsch a.d.Weinstr.,66,,7,8,15
024 Kurtatsch a.d.Weinstr.,67,,9,13,22
024 Kurtatsch a.d.Weinstr.,68,,13,4,17
024 Kurtatsch a.d.Weinstr.,69,,11,9,20
024 Kurtatsch a.d.Weinstr.,70,,9,8,17
024 Kurtatsch a.d.Weinstr.,71,,10,10,20
024 Kurtatsch a.d.Weinstr.,72,,7,10,17
024 Kurtatsch a.d.Weinstr.,73,,5,7,12
024 Kurtatsch a.d.Weinstr.,74,,5,8,13
024 Kurtatsch a.d.Weinstr.,75,,8,6,14
024 Kurtatsch a.d.Weinstr.,76,,7,11,18
024 Kurtatsch a.d.Weinstr.,77,,5,10,15
024 Kurtatsch a.d.Weinstr.,78,,10,11,21
024 Kurtatsch a.d.Weinstr.,79,,3,14,17
024 Kurtatsch a.d.Weinstr.,80,,7,12,19
024 Kurtatsch a.d.Weinstr.,81,,4,8,12
024 Kurtatsch a.d.Weinstr.,82,,4,7,11
024 Kurtatsch a.d.Weinstr.,83,,2,6,8
024 Kurtatsch a.d.Weinstr.,84,,-,6,6
024 Kurtatsch a.d.Weinstr.,85,,6,4,10
024 Kurtatsch a.d.Weinstr.,86,,7,9,16
024 Kurtatsch a.d.Weinstr.,87,,4,6,10
024 Kurtatsch a.d.Weinstr.,88,,2,8,10
024 Kurtatsch a.d.Weinstr.,89,,4,5,9
024 Kurtatsch a.d.Weinstr.,90,,2,5,7
024 Kurtatsch a.d.Weinstr.,91,,2,1,3
024 Kurtatsch a.d.Weinstr.,92,,1,1,2
024 Kurtatsch a.d.Weinstr.,93,,1,3,4
024 Kurtatsch a.d.Weinstr.,94,,1,4,5
024 Kurtatsch a.d.Weinstr.,95,,1,2,3
024 Kurtatsch a.d.Weinstr.,97,,-,1,1
024 Kurtatsch a.d.Weinstr.,98,,-,1,1
025 Kurtinig a.d. Weinstr.,0,,3,1,4
025 Kurtinig a.d. Weinstr.,1,,5,3,8
025 Kurtinig a.d. Weinstr.,2,,2,3,5
025 Kurtinig a.d. Weinstr.,3,,7,1,8
025 Kurtinig a.d. Weinstr.,4,,2,8,10
025 Kurtinig a.d. Weinstr.,5,,3,2,5
025 Kurtinig a.d. Weinstr.,6,,2,4,6
025 Kurtinig a.d. Weinstr.,7,,3,3,6
025 Kurtinig a.d. Weinstr.,8,,3,4,7
025 Kurtinig a.d. Weinstr.,9,,5,3,8
025 Kurtinig a.d. Weinstr.,10,,4,-,4
025 Kurtinig a.d. Weinstr.,11,,6,3,9
025 Kurtinig a.d. Weinstr.,12,,4,1,5
025 Kurtinig a.d. Weinstr.,13,,-,4,4
025 Kurtinig a.d. Weinstr.,14,,1,2,3
025 Kurtinig a.d. Weinstr.,15,,5,2,7
025 Kurtinig a.d. Weinstr.,16,,3,3,6
025 Kurtinig a.d. Weinstr.,17,,1,7,8
025 Kurtinig a.d. Weinstr.,18,,2,5,7
025 Kurtinig a.d. Weinstr.,19,,3,2,5
025 Kurtinig a.d. Weinstr.,20,,2,5,7
025 Kurtinig a.d. Weinstr.,21,,2,4,6
025 Kurtinig a.d. Weinstr.,22,,2,4,6
025 Kurtinig a.d. Weinstr.,23,,7,4,11
025 Kurtinig a.d. Weinstr.,24,,3,2,5
025 Kurtinig a.d. Weinstr.,25,,5,7,12
025 Kurtinig a.d. Weinstr.,26,,3,4,7
025 Kurtinig a.d. Weinstr.,27,,5,4,9
025 Kurtinig a.d. Weinstr.,28,,3,5,8
025 Kurtinig a.d. Weinstr.,29,,7,4,11
025 Kurtinig a.d. Weinstr.,30,,7,3,10
025 Kurtinig a.d. Weinstr.,31,,8,4,12
025 Kurtinig a.d. Weinstr.,32,,7,6,13
025 Kurtinig a.d. Weinstr.,33,,5,1,6
025 Kurtinig a.d. Weinstr.,34,,5,7,12
025 Kurtinig a.d. Weinstr.,35,,4,1,5
025 Kurtinig a.d. Weinstr.,36,,4,6,10
025 Kurtinig a.d. Weinstr.,37,,8,5,13
025 Kurtinig a.d. Weinstr.,38,,3,4,7
025 Kurtinig a.d. Weinstr.,39,,4,8,12
025 Kurtinig a.d. Weinstr.,40,,5,2,7
025 Kurtinig a.d. Weinstr.,41,,4,1,5
025 Kurtinig a.d. Weinstr.,42,,1,2,3
025 Kurtinig a.d. Weinstr.,43,,2,6,8
025 Kurtinig a.d. Weinstr.,44,,3,2,5
025 Kurtinig a.d. Weinstr.,45,,5,5,10
025 Kurtinig a.d. Weinstr.,46,,3,7,10
025 Kurtinig a.d. Weinstr.,47,,4,3,7
025 Kurtinig a.d. Weinstr.,48,,5,4,9
025 Kurtinig a.d. Weinstr.,49,,6,5,11
025 Kurtinig a.d. Weinstr.,50,,4,2,6
025 Kurtinig a.d. Weinstr.,51,,4,7,11
025 Kurtinig a.d. Weinstr.,52,,1,6,7
025 Kurtinig a.d. Weinstr.,53,,3,5,8
025 Kurtinig a.d. Weinstr.,54,,6,6,12
025 Kurtinig a.d. Weinstr.,55,,8,5,13
025 Kurtinig a.d. Weinstr.,56,,5,5,10
025 Kurtinig a.d. Weinstr.,57,,7,9,16
025 Kurtinig a.d. Weinstr.,58,,6,4,10
025 Kurtinig a.d. Weinstr.,59,,11,7,18
025 Kurtinig a.d. Weinstr.,60,,4,8,12
025 Kurtinig a.d. Weinstr.,61,,8,9,17
025 Kurtinig a.d. Weinstr.,62,,5,1,6
025 Kurtinig a.d. Weinstr.,63,,1,1,2
025 Kurtinig a.d. Weinstr.,64,,6,4,10
025 Kurtinig a.d. Weinstr.,65,,4,7,11
025 Kurtinig a.d. Weinstr.,66,,2,4,6
025 Kurtinig a.d. Weinstr.,67,,3,4,7
025 Kurtinig a.d. Weinstr.,68,,1,2,3
025 Kurtinig a.d. Weinstr.,69,,3,3,6
025 Kurtinig a.d. Weinstr.,70,,3,3,6
025 Kurtinig a.d. Weinstr.,71,,5,1,6
025 Kurtinig a.d. Weinstr.,72,,-,4,4
025 Kurtinig a.d. Weinstr.,73,,2,2,4
025 Kurtinig a.d. Weinstr.,74,,2,1,3
025 Kurtinig a.d. Weinstr.,75,,4,2,6
025 Kurtinig a.d. Weinstr.,76,,2,2,4
025 Kurtinig a.d. Weinstr.,77,,3,2,5
025 Kurtinig a.d. Weinstr.,78,,2,3,5
025 Kurtinig a.d. Weinstr.,79,,4,3,7
025 Kurtinig a.d. Weinstr.,80,,1,1,2
025 Kurtinig a.d. Weinstr.,81,,1,3,4
025 Kurtinig a.d. Weinstr.,82,,3,3,6
025 Kurtinig a.d. Weinstr.,83,,-,4,4
025 Kurtinig a.d. Weinstr.,84,,2,4,6
025 Kurtinig a.d. Weinstr.,85,,-,2,2
025 Kurtinig a.d. Weinstr.,86,,1,3,4
025 Kurtinig a.d. Weinstr.,87,,1,2,3
025 Kurtinig a.d. Weinstr.,88,,1,1,2
025 Kurtinig a.d. Weinstr.,89,,1,1,2
025 Kurtinig a.d. Weinstr.,90,,-,1,1
025 Kurtinig a.d. Weinstr.,91,,1,1,2
025 Kurtinig a.d. Weinstr.,93,,-,2,2
025 Kurtinig a.d. Weinstr.,94,,-,1,1
025 Kurtinig a.d. Weinstr.,100,,-,1,1
026 Corvara,0,,8,7,15
026 Corvara,1,,5,6,11
026 Corvara,2,,10,6,16
026 Corvara,3,,10,5,15
026 Corvara,4,,9,13,22
026 Corvara,5,,3,9,12
026 Corvara,6,,10,8,18
026 Corvara,7,,6,3,9
026 Corvara,8,,12,8,20
026 Corvara,9,,9,7,16
026 Corvara,10,,7,5,12
026 Corvara,11,,5,10,15
026 Corvara,12,,8,3,11
026 Corvara,13,,8,7,15
026 Corvara,14,,6,3,9
026 Corvara,15,,12,5,17
026 Corvara,16,,5,3,8
026 Corvara,17,,5,6,11
026 Corvara,18,,8,4,12
026 Corvara,19,,8,7,15
026 Corvara,20,,9,8,17
026 Corvara,21,,3,7,10
026 Corvara,22,,8,5,13
026 Corvara,23,,8,7,15
026 Corvara,24,,8,4,12
026 Corvara,25,,6,4,10
026 Corvara,26,,8,8,16
026 Corvara,27,,6,5,11
026 Corvara,28,,9,11,20
026 Corvara,29,,5,6,11
026 Corvara,30,,4,7,11
026 Corvara,31,,10,8,18
026 Corvara,32,,5,1,6
026 Corvara,33,,5,13,18
026 Corvara,34,,5,3,8
026 Corvara,35,,4,5,9
026 Corvara,36,,11,12,23
026 Corvara,37,,11,4,15
026 Corvara,38,,8,9,17
026 Corvara,39,,8,9,17
026 Corvara,40,,13,6,19
026 Corvara,41,,14,11,25
026 Corvara,42,,12,7,19
026 Corvara,43,,7,22,29
026 Corvara,44,,6,13,19
026 Corvara,45,,10,16,26
026 Corvara,46,,11,7,18
026 Corvara,47,,11,6,17
026 Corvara,48,,10,13,23
026 Corvara,49,,16,14,30
026 Corvara,50,,8,15,23
026 Corvara,51,,15,19,34
026 Corvara,52,,14,16,30
026 Corvara,53,,16,18,34
026 Corvara,54,,6,9,15
026 Corvara,55,,15,6,21
026 Corvara,56,,12,12,24
026 Corvara,57,,8,8,16
026 Corvara,58,,13,13,26
026 Corvara,59,,10,7,17
026 Corvara,60,,11,11,22
026 Corvara,61,,8,5,13
026 Corvara,62,,5,5,10
026 Corvara,63,,11,7,18
026 Corvara,64,,9,9,18
026 Corvara,65,,5,11,16
026 Corvara,66,,4,8,12
026 Corvara,67,,4,10,14
026 Corvara,68,,6,8,14
026 Corvara,69,,2,8,10
026 Corvara,70,,5,5,10
026 Corvara,71,,3,9,12
026 Corvara,72,,10,8,18
026 Corvara,73,,5,3,8
026 Corvara,74,,5,9,14
026 Corvara,75,,4,10,14
026 Corvara,76,,6,7,13
026 Corvara,77,,8,8,16
026 Corvara,78,,7,6,13
026 Corvara,79,,5,3,8
026 Corvara,80,,2,7,9
026 Corvara,81,,5,6,11
026 Corvara,82,,3,6,9
026 Corvara,83,,2,2,4
026 Corvara,84,,2,8,10
026 Corvara,85,,3,3,6
026 Corvara,86,,4,3,7
026 Corvara,87,,2,4,6
026 Corvara,88,,2,3,5
026 Corvara,89,,2,3,5
026 Corvara,90,,1,1,2
026 Corvara,91,,1,1,2
026 Corvara,92,,1,-,1
026 Corvara,93,,1,2,3
026 Corvara,94,,1,-,1
026 Corvara,95,,-,1,1
026 Corvara,96,,1,1,2
027 Graun im Vinschgau,0,,13,7,20
027 Graun im Vinschgau,1,,5,17,22
027 Graun im Vinschgau,2,,14,8,22
027 Graun im Vinschgau,3,,6,11,17
027 Graun im Vinschgau,4,,14,10,24
027 Graun im Vinschgau,5,,16,9,25
027 Graun im Vinschgau,6,,15,18,33
027 Graun im Vinschgau,7,,20,14,34
027 Graun im Vinschgau,8,,10,14,24
027 Graun im Vinschgau,9,,18,19,37
027 Graun im Vinschgau,10,,17,8,25
027 Graun im Vinschgau,11,,18,12,30
027 Graun im Vinschgau,12,,16,20,36
027 Graun im Vinschgau,13,,13,15,28
027 Graun im Vinschgau,14,,15,13,28
027 Graun im Vinschgau,15,,9,10,19
027 Graun im Vinschgau,16,,10,11,21
027 Graun im Vinschgau,17,,14,12,26
027 Graun im Vinschgau,18,,13,16,29
027 Graun im Vinschgau,19,,13,8,21
027 Graun im Vinschgau,20,,10,14,24
027 Graun im Vinschgau,21,,15,17,32
027 Graun im Vinschgau,22,,16,15,31
027 Graun im Vinschgau,23,,17,15,32
027 Graun im Vinschgau,24,,18,11,29
027 Graun im Vinschgau,25,,20,14,34
027 Graun im Vinschgau,26,,16,13,29
027 Graun im Vinschgau,27,,10,17,27
027 Graun im Vinschgau,28,,17,15,32
027 Graun im Vinschgau,29,,23,20,43
027 Graun im Vinschgau,30,,19,8,27
027 Graun im Vinschgau,31,,16,13,29
027 Graun im Vinschgau,32,,7,7,14
027 Graun im Vinschgau,33,,20,6,26
027 Graun im Vinschgau,34,,14,7,21
027 Graun im Vinschgau,35,,8,13,21
027 Graun im Vinschgau,36,,17,14,31
027 Graun im Vinschgau,37,,22,16,38
027 Graun im Vinschgau,38,,21,17,38
027 Graun im Vinschgau,39,,14,17,31
027 Graun im Vinschgau,40,,13,15,28
027 Graun im Vinschgau,41,,15,20,35
027 Graun im Vinschgau,42,,10,23,33
027 Graun im Vinschgau,43,,21,18,39
027 Graun im Vinschgau,44,,18,15,33
027 Graun im Vinschgau,45,,17,19,36
027 Graun im Vinschgau,46,,20,18,38
027 Graun im Vinschgau,47,,21,10,31
027 Graun im Vinschgau,48,,23,15,38
027 Graun im Vinschgau,49,,26,17,43
027 Graun im Vinschgau,50,,16,22,38
027 Graun im Vinschgau,51,,23,18,41
027 Graun im Vinschgau,52,,18,23,41
027 Graun im Vinschgau,53,,14,18,32
027 Graun im Vinschgau,54,,21,22,43
027 Graun im Vinschgau,55,,18,17,35
027 Graun im Vinschgau,56,,20,22,42
027 Graun im Vinschgau,57,,19,12,31
027 Graun im Vinschgau,58,,19,19,38
027 Graun im Vinschgau,59,,16,11,27
027 Graun im Vinschgau,60,,17,15,32
027 Graun im Vinschgau,61,,11,14,25
027 Graun im Vinschgau,62,,13,10,23
027 Graun im Vinschgau,63,,13,8,21
027 Graun im Vinschgau,64,,13,13,26
027 Graun im Vinschgau,65,,10,6,16
027 Graun im Vinschgau,66,,14,8,22
027 Graun im Vinschgau,67,,11,16,27
027 Graun im Vinschgau,68,,9,12,21
027 Graun im Vinschgau,69,,7,19,26
027 Graun im Vinschgau,70,,13,11,24
027 Graun im Vinschgau,71,,5,9,14
027 Graun im Vinschgau,72,,8,7,15
027 Graun im Vinschgau,73,,6,6,12
027 Graun im Vinschgau,74,,7,10,17
027 Graun im Vinschgau,75,,8,10,18
027 Graun im Vinschgau,76,,8,9,17
027 Graun im Vinschgau,77,,11,10,21
027 Graun im Vinschgau,78,,10,9,19
027 Graun im Vinschgau,79,,6,9,15
027 Graun im Vinschgau,80,,8,11,19
027 Graun im Vinschgau,81,,10,3,13
027 Graun im Vinschgau,82,,9,12,21
027 Graun im Vinschgau,83,,4,7,11
027 Graun im Vinschgau,84,,8,7,15
027 Graun im Vinschgau,85,,4,7,11
027 Graun im Vinschgau,86,,7,2,9
027 Graun im Vinschgau,87,,3,6,9
027 Graun im Vinschgau,88,,2,3,5
027 Graun im Vinschgau,89,,2,9,11
027 Graun im Vinschgau,90,,2,5,7
027 Graun im Vinschgau,91,,1,-,1
027 Graun im Vinschgau,92,,2,5,7
027 Graun im Vinschgau,93,,-,2,2
027 Graun im Vinschgau,94,,-,1,1
027 Graun im Vinschgau,95,,1,2,3
027 Graun im Vinschgau,96,,-,1,1
028 Toblach,0,,18,12,30
028 Toblach,1,,16,14,30
028 Toblach,2,,15,19,34
028 Toblach,3,,18,16,34
028 Toblach,4,,19,15,34
028 Toblach,5,,19,16,35
028 Toblach,6,,17,25,42
028 Toblach,7,,17,23,40
028 Toblach,8,,19,22,41
028 Toblach,9,,18,18,36
028 Toblach,10,,23,25,48
028 Toblach,11,,25,17,42
028 Toblach,12,,24,9,33
028 Toblach,13,,15,20,35
028 Toblach,14,,21,24,45
028 Toblach,15,,19,24,43
028 Toblach,16,,14,18,32
028 Toblach,17,,24,18,42
028 Toblach,18,,24,15,39
028 Toblach,19,,15,23,38
028 Toblach,20,,18,12,30
028 Toblach,21,,24,16,40
028 Toblach,22,,27,16,43
028 Toblach,23,,18,10,28
028 Toblach,24,,19,16,35
028 Toblach,25,,18,16,34
028 Toblach,26,,14,15,29
028 Toblach,27,,24,19,43
028 Toblach,28,,15,20,35
028 Toblach,29,,14,18,32
028 Toblach,30,,18,21,39
028 Toblach,31,,27,17,44
028 Toblach,32,,17,20,37
028 Toblach,33,,19,18,37
028 Toblach,34,,18,20,38
028 Toblach,35,,19,23,42
028 Toblach,36,,20,28,48
028 Toblach,37,,20,23,43
028 Toblach,38,,22,25,47
028 Toblach,39,,25,26,51
028 Toblach,40,,20,20,40
028 Toblach,41,,14,19,33
028 Toblach,42,,26,34,60
028 Toblach,43,,23,23,46
028 Toblach,44,,28,25,53
028 Toblach,45,,31,25,56
028 Toblach,46,,26,34,60
028 Toblach,47,,29,22,51
028 Toblach,48,,20,24,44
028 Toblach,49,,38,23,61
028 Toblach,50,,30,28,58
028 Toblach,51,,25,17,42
028 Toblach,52,,30,27,57
028 Toblach,53,,30,31,61
028 Toblach,54,,36,30,66
028 Toblach,55,,25,25,50
028 Toblach,56,,35,29,64
028 Toblach,57,,24,33,57
028 Toblach,58,,19,18,37
028 Toblach,59,,29,24,53
028 Toblach,60,,18,17,35
028 Toblach,61,,28,21,49
028 Toblach,62,,16,24,40
028 Toblach,63,,15,26,41
028 Toblach,64,,20,19,39
028 Toblach,65,,19,23,42
028 Toblach,66,,17,15,32
028 Toblach,67,,21,11,32
028 Toblach,68,,14,15,29
028 Toblach,69,,18,13,31
028 Toblach,70,,15,23,38
028 Toblach,71,,15,15,30
028 Toblach,72,,12,13,25
028 Toblach,73,,7,17,24
028 Toblach,74,,14,10,24
028 Toblach,75,,10,17,27
028 Toblach,76,,12,15,27
028 Toblach,77,,15,11,26
028 Toblach,78,,9,11,20
028 Toblach,79,,12,11,23
028 Toblach,80,,12,5,17
028 Toblach,81,,2,10,12
028 Toblach,82,,4,14,18
028 Toblach,83,,5,13,18
028 Toblach,84,,5,11,16
028 Toblach,85,,4,6,10
028 Toblach,86,,5,8,13
028 Toblach,87,,4,8,12
028 Toblach,88,,5,3,8
028 Toblach,89,,2,5,7
028 Toblach,90,,4,1,5
028 Toblach,91,,2,1,3
028 Toblach,92,,-,2,2
028 Toblach,93,,1,1,2
028 Toblach,94,,2,-,2
028 Toblach,95,,2,-,2
028 Toblach,96,,-,1,1
028 Toblach,97,,-,1,1
029 Neumarkt,0,,19,22,41
029 Neumarkt,1,,23,17,40
029 Neumarkt,2,,30,27,57
029 Neumarkt,3,,24,24,48
029 Neumarkt,4,,32,28,60
029 Neumarkt,5,,25,25,50
029 Neumarkt,6,,40,38,78
029 Neumarkt,7,,31,20,51
029 Neumarkt,8,,28,28,56
029 Neumarkt,9,,32,29,61
029 Neumarkt,10,,31,31,62
029 Neumarkt,11,,28,24,52
029 Neumarkt,12,,26,27,53
029 Neumarkt,13,,38,39,77
029 Neumarkt,14,,27,21,48
029 Neumarkt,15,,40,34,74
029 Neumarkt,16,,31,25,56
029 Neumarkt,17,,34,34,68
029 Neumarkt,18,,31,25,56
029 Neumarkt,19,,26,28,54
029 Neumarkt,20,,20,43,63
029 Neumarkt,21,,26,19,45
029 Neumarkt,22,,23,29,52
029 Neumarkt,23,,29,23,52
029 Neumarkt,24,,26,29,55
029 Neumarkt,25,,24,37,61
029 Neumarkt,26,,25,33,58
029 Neumarkt,27,,26,28,54
029 Neumarkt,28,,29,31,60
029 Neumarkt,29,,35,30,65
029 Neumarkt,30,,32,33,65
029 Neumarkt,31,,32,38,70
029 Neumarkt,32,,34,25,59
029 Neumarkt,33,,20,22,42
029 Neumarkt,34,,32,32,64
029 Neumarkt,35,,29,25,54
029 Neumarkt,36,,35,34,69
029 Neumarkt,37,,37,30,67
029 Neumarkt,38,,33,52,85
029 Neumarkt,39,,35,32,67
029 Neumarkt,40,,40,41,81
029 Neumarkt,41,,26,30,56
029 Neumarkt,42,,36,39,75
029 Neumarkt,43,,43,44,87
029 Neumarkt,44,,37,44,81
029 Neumarkt,45,,37,41,78
029 Neumarkt,46,,41,37,78
029 Neumarkt,47,,37,49,86
029 Neumarkt,48,,42,41,83
029 Neumarkt,49,,44,38,82
029 Neumarkt,50,,37,53,90
029 Neumarkt,51,,50,48,98
029 Neumarkt,52,,57,58,115
029 Neumarkt,53,,58,44,102
029 Neumarkt,54,,45,49,94
029 Neumarkt,55,,51,52,103
029 Neumarkt,56,,46,34,80
029 Neumarkt,57,,38,47,85
029 Neumarkt,58,,52,40,92
029 Neumarkt,59,,46,33,79
029 Neumarkt,60,,27,34,61
029 Neumarkt,61,,41,33,74
029 Neumarkt,62,,24,33,57
029 Neumarkt,63,,41,45,86
029 Neumarkt,64,,36,28,64
029 Neumarkt,65,,19,18,37
029 Neumarkt,66,,25,21,46
029 Neumarkt,67,,25,26,51
029 Neumarkt,68,,19,24,43
029 Neumarkt,69,,14,24,38
029 Neumarkt,70,,18,25,43
029 Neumarkt,71,,21,29,50
029 Neumarkt,72,,28,34,62
029 Neumarkt,73,,18,23,41
029 Neumarkt,74,,18,14,32
029 Neumarkt,75,,19,21,40
029 Neumarkt,76,,21,24,45
029 Neumarkt,77,,32,23,55
029 Neumarkt,78,,19,29,48
029 Neumarkt,79,,13,23,36
029 Neumarkt,80,,20,12,32
029 Neumarkt,81,,16,13,29
029 Neumarkt,82,,13,18,31
029 Neumarkt,83,,11,19,30
029 Neumarkt,84,,8,17,25
029 Neumarkt,85,,12,12,24
029 Neumarkt,86,,6,21,27
029 Neumarkt,87,,11,21,32
029 Neumarkt,88,,4,19,23
029 Neumarkt,89,,5,13,18
029 Neumarkt,90,,2,10,12
029 Neumarkt,91,,5,5,10
029 Neumarkt,92,,3,8,11
029 Neumarkt,93,,5,5,10
029 Neumarkt,94,,-,5,5
029 Neumarkt,95,,2,1,3
029 Neumarkt,96,,-,1,1
029 Neumarkt,97,,1,2,3
029 Neumarkt,98,,-,2,2
029 Neumarkt,99,,1,-,1
029 Neumarkt,101,,-,1,1
030 Pfalzen,0,,17,15,32
030 Pfalzen,1,,23,23,46
030 Pfalzen,2,,20,20,40
030 Pfalzen,3,,14,15,29
030 Pfalzen,4,,14,6,20
030 Pfalzen,5,,15,24,39
030 Pfalzen,6,,22,11,33
030 Pfalzen,7,,18,26,44
030 Pfalzen,8,,16,15,31
030 Pfalzen,9,,16,17,33
030 Pfalzen,10,,16,22,38
030 Pfalzen,11,,13,10,23
030 Pfalzen,12,,21,19,40
030 Pfalzen,13,,16,17,33
030 Pfalzen,14,,12,20,32
030 Pfalzen,15,,20,14,34
030 Pfalzen,16,,15,18,33
030 Pfalzen,17,,15,13,28
030 Pfalzen,18,,17,21,38
030 Pfalzen,19,,21,22,43
030 Pfalzen,20,,16,16,32
030 Pfalzen,21,,11,16,27
030 Pfalzen,22,,20,14,34
030 Pfalzen,23,,21,22,43
030 Pfalzen,24,,13,14,27
030 Pfalzen,25,,11,14,25
030 Pfalzen,26,,14,23,37
030 Pfalzen,27,,16,14,30
030 Pfalzen,28,,16,15,31
030 Pfalzen,29,,19,26,45
030 Pfalzen,30,,19,9,28
030 Pfalzen,31,,11,22,33
030 Pfalzen,32,,14,14,28
030 Pfalzen,33,,21,15,36
030 Pfalzen,34,,17,12,29
030 Pfalzen,35,,13,16,29
030 Pfalzen,36,,19,20,39
030 Pfalzen,37,,20,22,42
030 Pfalzen,38,,24,22,46
030 Pfalzen,39,,26,23,49
030 Pfalzen,40,,17,24,41
030 Pfalzen,41,,21,25,46
030 Pfalzen,42,,18,11,29
030 Pfalzen,43,,18,15,33
030 Pfalzen,44,,24,16,40
030 Pfalzen,45,,16,23,39
030 Pfalzen,46,,25,25,50
030 Pfalzen,47,,29,24,53
030 Pfalzen,48,,23,25,48
030 Pfalzen,49,,29,15,44
030 Pfalzen,50,,25,33,58
030 Pfalzen,51,,22,24,46
030 Pfalzen,52,,24,22,46
030 Pfalzen,53,,22,27,49
030 Pfalzen,54,,19,23,42
030 Pfalzen,55,,31,20,51
030 Pfalzen,56,,24,32,56
030 Pfalzen,57,,26,21,47
030 Pfalzen,58,,21,16,37
030 Pfalzen,59,,16,18,34
030 Pfalzen,60,,17,22,39
030 Pfalzen,61,,24,21,45
030 Pfalzen,62,,17,16,33
030 Pfalzen,63,,18,12,30
030 Pfalzen,64,,17,10,27
030 Pfalzen,65,,15,13,28
030 Pfalzen,66,,11,10,21
030 Pfalzen,67,,15,14,29
030 Pfalzen,68,,11,13,24
030 Pfalzen,69,,15,7,22
030 Pfalzen,70,,10,11,21
030 Pfalzen,71,,12,3,15
030 Pfalzen,72,,7,10,17
030 Pfalzen,73,,4,7,11
030 Pfalzen,74,,10,4,14
030 Pfalzen,75,,7,10,17
030 Pfalzen,76,,6,10,16
030 Pfalzen,77,,8,8,16
030 Pfalzen,78,,13,9,22
030 Pfalzen,79,,8,5,13
030 Pfalzen,80,,10,8,18
030 Pfalzen,81,,4,4,8
030 Pfalzen,82,,1,7,8
030 Pfalzen,83,,5,5,10
030 Pfalzen,84,,6,6,12
030 Pfalzen,85,,2,5,7
030 Pfalzen,86,,3,2,5
030 Pfalzen,87,,4,5,9
030 Pfalzen,88,,4,6,10
030 Pfalzen,89,,3,2,5
030 Pfalzen,91,,-,2,2
030 Pfalzen,92,,-,1,1
030 Pfalzen,93,,-,1,1
030 Pfalzen,95,,1,-,1
031 Völs am Schlern,0,,19,22,41
031 Völs am Schlern,1,,19,16,35
031 Völs am Schlern,2,,20,17,37
031 Völs am Schlern,3,,17,18,35
031 Völs am Schlern,4,,23,17,40
031 Völs am Schlern,5,,20,14,34
031 Völs am Schlern,6,,16,23,39
031 Völs am Schlern,7,,16,20,36
031 Völs am Schlern,8,,25,17,42
031 Völs am Schlern,9,,24,14,38
031 Völs am Schlern,10,,23,33,56
031 Völs am Schlern,11,,22,23,45
031 Völs am Schlern,12,,19,25,44
031 Völs am Schlern,13,,37,18,55
031 Völs am Schlern,14,,21,12,33
031 Völs am Schlern,15,,15,22,37
031 Völs am Schlern,16,,18,33,51
031 Völs am Schlern,17,,21,27,48
031 Völs am Schlern,18,,24,28,52
031 Völs am Schlern,19,,21,17,38
031 Völs am Schlern,20,,29,32,61
031 Völs am Schlern,21,,21,26,47
031 Völs am Schlern,22,,15,21,36
031 Völs am Schlern,23,,24,25,49
031 Völs am Schlern,24,,21,18,39
031 Völs am Schlern,25,,17,14,31
031 Völs am Schlern,26,,21,15,36
031 Völs am Schlern,27,,16,23,39
031 Völs am Schlern,28,,21,21,42
031 Völs am Schlern,29,,23,22,45
031 Völs am Schlern,30,,18,19,37
031 Völs am Schlern,31,,25,24,49
031 Völs am Schlern,32,,23,19,42
031 Völs am Schlern,33,,16,16,32
031 Völs am Schlern,34,,17,10,27
031 Völs am Schlern,35,,15,28,43
031 Völs am Schlern,36,,22,27,49
031 Völs am Schlern,37,,37,21,58
031 Völs am Schlern,38,,31,14,45
031 Völs am Schlern,39,,29,31,60
031 Völs am Schlern,40,,24,21,45
031 Völs am Schlern,41,,18,25,43
031 Völs am Schlern,42,,27,25,52
031 Völs am Schlern,43,,21,16,37
031 Völs am Schlern,44,,27,23,50
031 Völs am Schlern,45,,25,32,57
031 Völs am Schlern,46,,38,28,66
031 Völs am Schlern,47,,39,40,79
031 Völs am Schlern,48,,34,40,74
031 Völs am Schlern,49,,38,38,76
031 Völs am Schlern,50,,36,36,72
031 Völs am Schlern,51,,29,26,55
031 Völs am Schlern,52,,35,30,65
031 Völs am Schlern,53,,25,29,54
031 Völs am Schlern,54,,27,22,49
031 Völs am Schlern,55,,27,24,51
031 Völs am Schlern,56,,27,24,51
031 Völs am Schlern,57,,23,24,47
031 Völs am Schlern,58,,18,22,40
031 Völs am Schlern,59,,22,15,37
031 Völs am Schlern,60,,20,13,33
031 Völs am Schlern,61,,15,20,35
031 Völs am Schlern,62,,18,17,35
031 Völs am Schlern,63,,17,14,31
031 Völs am Schlern,64,,18,26,44
031 Völs am Schlern,65,,16,25,41
031 Völs am Schlern,66,,15,18,33
031 Völs am Schlern,67,,18,22,40
031 Völs am Schlern,68,,18,16,34
031 Völs am Schlern,69,,14,10,24
031 Völs am Schlern,70,,16,15,31
031 Völs am Schlern,71,,10,18,28
031 Völs am Schlern,72,,14,11,25
031 Völs am Schlern,73,,5,8,13
031 Völs am Schlern,74,,11,8,19
031 Völs am Schlern,75,,14,19,33
031 Völs am Schlern,76,,15,17,32
031 Völs am Schlern,77,,15,16,31
031 Völs am Schlern,78,,8,19,27
031 Völs am Schlern,79,,8,9,17
031 Völs am Schlern,80,,10,13,23
031 Völs am Schlern,81,,7,8,15
031 Völs am Schlern,82,,5,17,22
031 Völs am Schlern,83,,11,11,22
031 Völs am Schlern,84,,8,5,13
031 Völs am Schlern,85,,3,10,13
031 Völs am Schlern,86,,6,5,11
031 Völs am Schlern,87,,6,8,14
031 Völs am Schlern,88,,2,6,8
031 Völs am Schlern,89,,1,5,6
031 Völs am Schlern,90,,1,9,10
031 Völs am Schlern,91,,2,5,7
031 Völs am Schlern,92,,-,2,2
031 Völs am Schlern,93,,1,1,2
031 Völs am Schlern,94,,-,4,4
031 Völs am Schlern,95,,1,1,2
031 Völs am Schlern,96,,-,2,2
031 Völs am Schlern,97,,-,2,2
031 Völs am Schlern,100,,-,1,1
032 Franzensfeste,0,,7,3,10
032 Franzensfeste,1,,9,5,14
032 Franzensfeste,2,,10,6,16
032 Franzensfeste,3,,8,5,13
032 Franzensfeste,4,,5,14,19
032 Franzensfeste,5,,5,4,9
032 Franzensfeste,6,,6,11,17
032 Franzensfeste,7,,6,8,14
032 Franzensfeste,8,,15,10,25
032 Franzensfeste,9,,5,7,12
032 Franzensfeste,10,,8,8,16
032 Franzensfeste,11,,8,5,13
032 Franzensfeste,12,,4,5,9
032 Franzensfeste,13,,4,5,9
032 Franzensfeste,14,,4,3,7
032 Franzensfeste,15,,11,3,14
032 Franzensfeste,16,,9,1,10
032 Franzensfeste,17,,3,6,9
032 Franzensfeste,18,,4,6,10
032 Franzensfeste,19,,4,4,8
032 Franzensfeste,20,,8,7,15
032 Franzensfeste,21,,4,7,11
032 Franzensfeste,22,,6,3,9
032 Franzensfeste,23,,5,4,9
032 Franzensfeste,24,,9,5,14
032 Franzensfeste,25,,5,6,11
032 Franzensfeste,26,,8,7,15
032 Franzensfeste,27,,2,4,6
032 Franzensfeste,28,,3,6,9
032 Franzensfeste,29,,5,4,9
032 Franzensfeste,30,,3,5,8
032 Franzensfeste,31,,10,8,18
032 Franzensfeste,32,,5,3,8
032 Franzensfeste,33,,8,9,17
032 Franzensfeste,34,,3,6,9
032 Franzensfeste,35,,4,7,11
032 Franzensfeste,36,,6,13,19
032 Franzensfeste,37,,10,4,14
032 Franzensfeste,38,,11,10,21
032 Franzensfeste,39,,11,4,15
032 Franzensfeste,40,,7,8,15
032 Franzensfeste,41,,3,7,10
032 Franzensfeste,42,,4,5,9
032 Franzensfeste,43,,8,11,19
032 Franzensfeste,44,,13,5,18
032 Franzensfeste,45,,1,4,5
032 Franzensfeste,46,,10,7,17
032 Franzensfeste,47,,3,5,8
032 Franzensfeste,48,,7,6,13
032 Franzensfeste,49,,10,10,20
032 Franzensfeste,50,,7,12,19
032 Franzensfeste,51,,10,5,15
032 Franzensfeste,52,,10,5,15
032 Franzensfeste,53,,9,7,16
032 Franzensfeste,54,,14,7,21
032 Franzensfeste,55,,10,6,16
032 Franzensfeste,56,,11,4,15
032 Franzensfeste,57,,3,4,7
032 Franzensfeste,58,,1,9,10
032 Franzensfeste,59,,6,8,14
032 Franzensfeste,60,,9,3,12
032 Franzensfeste,61,,4,7,11
032 Franzensfeste,62,,5,6,11
032 Franzensfeste,63,,6,8,14
032 Franzensfeste,64,,7,5,12
032 Franzensfeste,65,,3,7,10
032 Franzensfeste,66,,3,4,7
032 Franzensfeste,67,,6,1,7
032 Franzensfeste,68,,10,3,13
032 Franzensfeste,69,,2,4,6
032 Franzensfeste,70,,6,4,10
032 Franzensfeste,71,,2,4,6
032 Franzensfeste,72,,7,5,12
032 Franzensfeste,73,,3,6,9
032 Franzensfeste,74,,3,7,10
032 Franzensfeste,75,,3,1,4
032 Franzensfeste,76,,4,-,4
032 Franzensfeste,77,,2,3,5
032 Franzensfeste,78,,2,2,4
032 Franzensfeste,79,,3,2,5
032 Franzensfeste,80,,1,3,4
032 Franzensfeste,81,,3,5,8
032 Franzensfeste,82,,-,1,1
032 Franzensfeste,83,,-,2,2
032 Franzensfeste,84,,1,3,4
032 Franzensfeste,85,,-,3,3
032 Franzensfeste,86,,3,2,5
032 Franzensfeste,87,,-,2,2
032 Franzensfeste,88,,3,2,5
032 Franzensfeste,89,,-,2,2
032 Franzensfeste,90,,-,2,2
032 Franzensfeste,92,,-,3,3
032 Franzensfeste,94,,1,-,1
032 Franzensfeste,95,,-,3,3
032 Franzensfeste,96,,-,1,1
033 Villnöss,0,,25,17,42
033 Villnöss,1,,11,16,27
033 Villnöss,2,,18,16,34
033 Villnöss,3,,15,18,33
033 Villnöss,4,,19,14,33
033 Villnöss,5,,14,9,23
033 Villnöss,6,,19,19,38
033 Villnöss,7,,8,22,30
033 Villnöss,8,,16,19,35
033 Villnöss,9,,17,14,31
033 Villnöss,10,,18,9,27
033 Villnöss,11,,16,15,31
033 Villnöss,12,,15,24,39
033 Villnöss,13,,19,22,41
033 Villnöss,14,,10,18,28
033 Villnöss,15,,16,14,30
033 Villnöss,16,,22,14,36
033 Villnöss,17,,15,24,39
033 Villnöss,18,,18,15,33
033 Villnöss,19,,17,30,47
033 Villnöss,20,,23,19,42
033 Villnöss,21,,20,24,44
033 Villnöss,22,,21,17,38
033 Villnöss,23,,18,15,33
033 Villnöss,24,,13,13,26
033 Villnöss,25,,14,7,21
033 Villnöss,26,,15,14,29
033 Villnöss,27,,22,10,32
033 Villnöss,28,,14,11,25
033 Villnöss,29,,10,9,19
033 Villnöss,30,,12,20,32
033 Villnöss,31,,17,15,32
033 Villnöss,32,,10,18,28
033 Villnöss,33,,11,16,27
033 Villnöss,34,,17,17,34
033 Villnöss,35,,14,15,29
033 Villnöss,36,,12,9,21
033 Villnöss,37,,11,17,28
033 Villnöss,38,,20,10,30
033 Villnöss,39,,8,12,20
033 Villnöss,40,,15,16,31
033 Villnöss,41,,13,10,23
033 Villnöss,42,,18,12,30
033 Villnöss,43,,21,13,34
033 Villnöss,44,,19,16,35
033 Villnöss,45,,15,17,32
033 Villnöss,46,,17,28,45
033 Villnöss,47,,22,23,45
033 Villnöss,48,,17,28,45
033 Villnöss,49,,29,21,50
033 Villnöss,50,,30,17,47
033 Villnöss,51,,17,17,34
033 Villnöss,52,,24,19,43
033 Villnöss,53,,29,23,52
033 Villnöss,54,,32,22,54
033 Villnöss,55,,30,20,50
033 Villnöss,56,,28,21,49
033 Villnöss,57,,19,15,34
033 Villnöss,58,,21,12,33
033 Villnöss,59,,10,9,19
033 Villnöss,60,,10,12,22
033 Villnöss,61,,12,15,27
033 Villnöss,62,,12,18,30
033 Villnöss,63,,12,3,15
033 Villnöss,64,,14,11,25
033 Villnöss,65,,11,14,25
033 Villnöss,66,,9,12,21
033 Villnöss,67,,11,9,20
033 Villnöss,68,,6,7,13
033 Villnöss,69,,7,13,20
033 Villnöss,70,,7,10,17
033 Villnöss,71,,13,10,23
033 Villnöss,72,,8,5,13
033 Villnöss,73,,7,5,12
033 Villnöss,74,,5,12,17
033 Villnöss,75,,10,8,18
033 Villnöss,76,,11,18,29
033 Villnöss,77,,10,8,18
033 Villnöss,78,,6,16,22
033 Villnöss,79,,7,12,19
033 Villnöss,80,,8,8,16
033 Villnöss,81,,6,14,20
033 Villnöss,82,,3,13,16
033 Villnöss,83,,3,8,11
033 Villnöss,84,,3,8,11
033 Villnöss,85,,6,5,11
033 Villnöss,86,,10,9,19
033 Villnöss,87,,6,9,15
033 Villnöss,88,,4,7,11
033 Villnöss,89,,2,6,8
033 Villnöss,90,,5,5,10
033 Villnöss,91,,2,4,6
033 Villnöss,92,,-,4,4
033 Villnöss,93,,1,1,2
033 Villnöss,94,,1,1,2
033 Villnöss,95,,1,3,4
033 Villnöss,96,,1,3,4
033 Villnöss,98,,-,1,1
034 Gais,0,,15,14,29
034 Gais,1,,16,11,27
034 Gais,2,,16,16,32
034 Gais,3,,16,15,31
034 Gais,4,,18,12,30
034 Gais,5,,22,14,36
034 Gais,6,,17,17,34
034 Gais,7,,19,20,39
034 Gais,8,,31,16,47
034 Gais,9,,27,15,42
034 Gais,10,,15,19,34
034 Gais,11,,18,17,35
034 Gais,12,,23,15,38
034 Gais,13,,27,18,45
034 Gais,14,,18,24,42
034 Gais,15,,16,17,33
034 Gais,16,,21,24,45
034 Gais,17,,21,17,38
034 Gais,18,,21,20,41
034 Gais,19,,22,22,44
034 Gais,20,,27,19,46
034 Gais,21,,31,15,46
034 Gais,22,,10,17,27
034 Gais,23,,27,18,45
034 Gais,24,,25,22,47
034 Gais,25,,16,22,38
034 Gais,26,,17,24,41
034 Gais,27,,22,25,47
034 Gais,28,,16,15,31
034 Gais,29,,17,15,32
034 Gais,30,,20,17,37
034 Gais,31,,13,18,31
034 Gais,32,,15,18,33
034 Gais,33,,16,17,33
034 Gais,34,,30,22,52
034 Gais,35,,19,22,41
034 Gais,36,,24,18,42
034 Gais,37,,22,24,46
034 Gais,38,,25,28,53
034 Gais,39,,21,16,37
034 Gais,40,,25,22,47
034 Gais,41,,20,24,44
034 Gais,42,,24,23,47
034 Gais,43,,21,27,48
034 Gais,44,,34,29,63
034 Gais,45,,27,23,50
034 Gais,46,,31,42,73
034 Gais,47,,35,27,62
034 Gais,48,,28,23,51
034 Gais,49,,36,31,67
034 Gais,50,,25,22,47
034 Gais,51,,29,31,60
034 Gais,52,,28,25,53
034 Gais,53,,25,26,51
034 Gais,54,,29,31,60
034 Gais,55,,20,19,39
034 Gais,56,,31,19,50
034 Gais,57,,19,24,43
034 Gais,58,,17,12,29
034 Gais,59,,17,22,39
034 Gais,60,,22,20,42
034 Gais,61,,10,16,26
034 Gais,62,,23,21,44
034 Gais,63,,17,10,27
034 Gais,64,,15,13,28
034 Gais,65,,13,12,25
034 Gais,66,,14,17,31
034 Gais,67,,16,21,37
034 Gais,68,,20,24,44
034 Gais,69,,13,11,24
034 Gais,70,,21,13,34
034 Gais,71,,19,11,30
034 Gais,72,,15,15,30
034 Gais,73,,12,9,21
034 Gais,74,,13,13,26
034 Gais,75,,9,15,24
034 Gais,76,,8,13,21
034 Gais,77,,17,12,29
034 Gais,78,,15,12,27
034 Gais,79,,11,14,25
034 Gais,80,,14,12,26
034 Gais,81,,11,11,22
034 Gais,82,,7,10,17
034 Gais,83,,7,11,18
034 Gais,84,,4,3,7
034 Gais,85,,3,7,10
034 Gais,86,,2,5,7
034 Gais,87,,5,3,8
034 Gais,88,,4,4,8
034 Gais,89,,-,2,2
034 Gais,90,,1,2,3
034 Gais,91,,1,4,5
034 Gais,92,,1,1,2
034 Gais,93,,1,1,2
034 Gais,94,,1,1,2
034 Gais,95,,-,3,3
034 Gais,96,,-,1,1
034 Gais,100,,1,-,1
035 Gargazon,0,,9,9,18
035 Gargazon,1,,12,7,19
035 Gargazon,2,,11,6,17
035 Gargazon,3,,9,11,20
035 Gargazon,4,,11,6,17
035 Gargazon,5,,12,9,21
035 Gargazon,6,,7,9,16
035 Gargazon,7,,7,7,14
035 Gargazon,8,,7,11,18
035 Gargazon,9,,10,11,21
035 Gargazon,10,,13,8,21
035 Gargazon,11,,8,6,14
035 Gargazon,12,,9,13,22
035 Gargazon,13,,9,7,16
035 Gargazon,14,,7,5,12
035 Gargazon,15,,5,13,18
035 Gargazon,16,,7,12,19
035 Gargazon,17,,4,8,12
035 Gargazon,18,,11,5,16
035 Gargazon,19,,14,9,23
035 Gargazon,20,,13,10,23
035 Gargazon,21,,5,14,19
035 Gargazon,22,,6,11,17
035 Gargazon,23,,10,4,14
035 Gargazon,24,,3,7,10
035 Gargazon,25,,8,8,16
035 Gargazon,26,,13,13,26
035 Gargazon,27,,18,11,29
035 Gargazon,28,,6,10,16
035 Gargazon,29,,11,5,16
035 Gargazon,30,,10,8,18
035 Gargazon,31,,9,11,20
035 Gargazon,32,,10,12,22
035 Gargazon,33,,15,8,23
035 Gargazon,34,,12,12,24
035 Gargazon,35,,9,13,22
035 Gargazon,36,,10,6,16
035 Gargazon,37,,13,10,23
035 Gargazon,38,,10,10,20
035 Gargazon,39,,5,6,11
035 Gargazon,40,,7,20,27
035 Gargazon,41,,9,10,19
035 Gargazon,42,,5,13,18
035 Gargazon,43,,10,11,21
035 Gargazon,44,,12,15,27
035 Gargazon,45,,12,7,19
035 Gargazon,46,,16,21,37
035 Gargazon,47,,17,16,33
035 Gargazon,48,,17,13,30
035 Gargazon,49,,23,14,37
035 Gargazon,50,,18,21,39
035 Gargazon,51,,12,17,29
035 Gargazon,52,,13,16,29
035 Gargazon,53,,14,10,24
035 Gargazon,54,,19,17,36
035 Gargazon,55,,17,20,37
035 Gargazon,56,,18,14,32
035 Gargazon,57,,9,12,21
035 Gargazon,58,,10,13,23
035 Gargazon,59,,18,15,33
035 Gargazon,60,,7,14,21
035 Gargazon,61,,14,13,27
035 Gargazon,62,,12,7,19
035 Gargazon,63,,10,5,15
035 Gargazon,64,,9,10,19
035 Gargazon,65,,16,10,26
035 Gargazon,66,,4,8,12
035 Gargazon,67,,9,8,17
035 Gargazon,68,,7,6,13
035 Gargazon,69,,5,8,13
035 Gargazon,70,,5,8,13
035 Gargazon,71,,5,7,12
035 Gargazon,72,,11,13,24
035 Gargazon,73,,9,4,13
035 Gargazon,74,,1,4,5
035 Gargazon,75,,5,8,13
035 Gargazon,76,,3,8,11
035 Gargazon,77,,9,9,18
035 Gargazon,78,,4,16,20
035 Gargazon,79,,6,5,11
035 Gargazon,80,,8,7,15
035 Gargazon,81,,5,9,14
035 Gargazon,82,,3,2,5
035 Gargazon,83,,10,2,12
035 Gargazon,84,,5,5,10
035 Gargazon,85,,1,7,8
035 Gargazon,86,,3,2,5
035 Gargazon,87,,2,5,7
035 Gargazon,88,,2,3,5
035 Gargazon,89,,-,3,3
035 Gargazon,91,,1,2,3
035 Gargazon,92,,2,-,2
035 Gargazon,93,,1,1,2
035 Gargazon,95,,1,-,1
035 Gargazon,96,,-,1,1
035 Gargazon,97,,-,1,1
036 Glurns,0,,6,4,10
036 Glurns,1,,3,5,8
036 Glurns,2,,2,8,10
036 Glurns,3,,7,2,9
036 Glurns,4,,5,-,5
036 Glurns,5,,7,5,12
036 Glurns,6,,6,4,10
036 Glurns,7,,3,5,8
036 Glurns,8,,6,4,10
036 Glurns,9,,2,5,7
036 Glurns,10,,9,2,11
036 Glurns,11,,5,2,7
036 Glurns,12,,5,8,13
036 Glurns,13,,7,6,13
036 Glurns,14,,3,6,9
036 Glurns,15,,6,6,12
036 Glurns,16,,3,4,7
036 Glurns,17,,5,-,5
036 Glurns,18,,5,3,8
036 Glurns,19,,4,2,6
036 Glurns,20,,11,3,14
036 Glurns,21,,5,8,13
036 Glurns,22,,8,5,13
036 Glurns,23,,6,5,11
036 Glurns,24,,4,3,7
036 Glurns,25,,7,6,13
036 Glurns,26,,4,4,8
036 Glurns,27,,7,4,11
036 Glurns,28,,5,3,8
036 Glurns,29,,4,3,7
036 Glurns,30,,2,7,9
036 Glurns,31,,4,6,10
036 Glurns,32,,4,6,10
036 Glurns,33,,5,3,8
036 Glurns,34,,7,5,12
036 Glurns,35,,9,6,15
036 Glurns,36,,6,9,15
036 Glurns,37,,8,4,12
036 Glurns,38,,12,2,14
036 Glurns,39,,3,8,11
036 Glurns,40,,8,5,13
036 Glurns,41,,2,1,3
036 Glurns,42,,13,3,16
036 Glurns,43,,5,8,13
036 Glurns,44,,7,11,18
036 Glurns,45,,3,2,5
036 Glurns,46,,6,8,14
036 Glurns,47,,5,6,11
036 Glurns,48,,4,3,7
036 Glurns,49,,2,7,9
036 Glurns,50,,6,3,9
036 Glurns,51,,4,9,13
036 Glurns,52,,6,7,13
036 Glurns,53,,1,6,7
036 Glurns,54,,9,5,14
036 Glurns,55,,5,7,12
036 Glurns,56,,6,5,11
036 Glurns,57,,8,6,14
036 Glurns,58,,5,9,14
036 Glurns,59,,12,8,20
036 Glurns,60,,4,9,13
036 Glurns,61,,6,12,18
036 Glurns,62,,5,6,11
036 Glurns,63,,8,8,16
036 Glurns,64,,10,3,13
036 Glurns,65,,8,9,17
036 Glurns,66,,4,8,12
036 Glurns,67,,8,8,16
036 Glurns,68,,7,4,11
036 Glurns,69,,5,2,7
036 Glurns,70,,8,5,13
036 Glurns,71,,10,7,17
036 Glurns,72,,7,2,9
036 Glurns,73,,6,1,7
036 Glurns,74,,5,4,9
036 Glurns,75,,1,4,5
036 Glurns,76,,3,6,9
036 Glurns,77,,3,2,5
036 Glurns,78,,5,1,6
036 Glurns,79,,2,2,4
036 Glurns,80,,4,4,8
036 Glurns,81,,3,3,6
036 Glurns,82,,-,2,2
036 Glurns,83,,2,3,5
036 Glurns,84,,-,4,4
036 Glurns,85,,-,1,1
036 Glurns,86,,4,2,6
036 Glurns,87,,2,-,2
036 Glurns,88,,-,2,2
036 Glurns,89,,1,4,5
036 Glurns,90,,-,1,1
036 Glurns,91,,-,1,1
036 Glurns,93,,-,1,1
036 Glurns,94,,-,1,1/n/037 Latsch,0,,26,30,56
037 Latsch,1,,26,20,46
037 Latsch,2,,24,37,61
037 Latsch,3,,36,22,58
037 Latsch,4,,30,25,55
037 Latsch,5,,34,32,66
037 Latsch,6,,27,29,56
037 Latsch,7,,23,20,43
037 Latsch,8,,26,20,46
037 Latsch,9,,19,30,49
037 Latsch,10,,24,25,49
037 Latsch,11,,29,29,58
037 Latsch,12,,25,22,47
037 Latsch,13,,25,29,54
037 Latsch,14,,30,27,57
037 Latsch,15,,23,24,47
037 Latsch,16,,27,24,51
037 Latsch,17,,34,20,54
037 Latsch,18,,34,29,63
037 Latsch,19,,34,18,52
037 Latsch,20,,26,21,47
037 Latsch,21,,39,38,77
037 Latsch,22,,38,35,73
037 Latsch,23,,45,30,75
037 Latsch,24,,39,30,69
037 Latsch,25,,32,29,61
037 Latsch,26,,33,44,77
037 Latsch,27,,30,40,70
037 Latsch,28,,32,37,69
037 Latsch,29,,35,26,61
037 Latsch,30,,40,32,72
037 Latsch,31,,30,28,58
037 Latsch,32,,31,36,67
037 Latsch,33,,34,41,75
037 Latsch,34,,43,30,73
037 Latsch,35,,22,26,48
037 Latsch,36,,34,44,78
037 Latsch,37,,27,43,70
037 Latsch,38,,36,32,68
037 Latsch,39,,36,29,65
037 Latsch,40,,38,27,65
037 Latsch,41,,36,28,64
037 Latsch,42,,28,21,49
037 Latsch,43,,33,38,71
037 Latsch,44,,30,27,57
037 Latsch,45,,34,35,69
037 Latsch,46,,36,41,77
037 Latsch,47,,45,39,84
037 Latsch,48,,33,38,71
037 Latsch,49,,44,37,81
037 Latsch,50,,44,55,99
037 Latsch,51,,54,48,102
037 Latsch,52,,30,51,81
037 Latsch,53,,48,45,93
037 Latsch,54,,54,45,99
037 Latsch,55,,49,49,98
037 Latsch,56,,44,46,90
037 Latsch,57,,42,41,83
037 Latsch,58,,39,48,87
037 Latsch,59,,43,44,87
037 Latsch,60,,38,31,69
037 Latsch,61,,28,36,64
037 Latsch,62,,26,32,58
037 Latsch,63,,36,29,65
037 Latsch,64,,23,16,39
037 Latsch,65,,21,21,42
037 Latsch,66,,35,22,57
037 Latsch,67,,21,28,49
037 Latsch,68,,33,15,48
037 Latsch,69,,14,20,34
037 Latsch,70,,14,21,35
037 Latsch,71,,18,16,34
037 Latsch,72,,18,17,35
037 Latsch,73,,14,21,35
037 Latsch,74,,16,12,28
037 Latsch,75,,19,23,42
037 Latsch,76,,22,24,46
037 Latsch,77,,13,22,35
037 Latsch,78,,16,19,35
037 Latsch,79,,13,16,29
037 Latsch,80,,8,23,31
037 Latsch,81,,7,23,30
037 Latsch,82,,11,12,23
037 Latsch,83,,17,10,27
037 Latsch,84,,13,19,32
037 Latsch,85,,10,15,25
037 Latsch,86,,13,13,26
037 Latsch,87,,7,14,21
037 Latsch,88,,8,10,18
037 Latsch,89,,8,10,18
037 Latsch,90,,9,9,18
037 Latsch,91,,3,9,12
037 Latsch,92,,4,4,8
037 Latsch,93,,2,6,8
037 Latsch,94,,1,3,4
037 Latsch,95,,1,1,2
037 Latsch,96,,1,1,2
037 Latsch,97,,-,2,2
037 Latsch,98,,1,1,2
038 Algund,0,,27,30,57
038 Algund,1,,25,23,48
038 Algund,2,,27,27,54
038 Algund,3,,23,38,61
038 Algund,4,,24,28,52
038 Algund,5,,31,27,58
038 Algund,6,,23,33,56
038 Algund,7,,19,18,37
038 Algund,8,,27,21,48
038 Algund,9,,17,34,51
038 Algund,10,,20,21,41
038 Algund,11,,22,19,41
038 Algund,12,,31,22,53
038 Algund,13,,24,28,52
038 Algund,14,,25,26,51
038 Algund,15,,31,26,57
038 Algund,16,,23,26,49
038 Algund,17,,35,23,58
038 Algund,18,,25,30,55
038 Algund,19,,45,25,70
038 Algund,20,,23,28,51
038 Algund,21,,30,22,52
038 Algund,22,,22,25,47
038 Algund,23,,31,26,57
038 Algund,24,,37,20,57
038 Algund,25,,23,20,43
038 Algund,26,,25,26,51
038 Algund,27,,29,31,60
038 Algund,28,,29,22,51
038 Algund,29,,22,26,48
038 Algund,30,,20,31,51
038 Algund,31,,35,26,61
038 Algund,32,,25,29,54
038 Algund,33,,27,22,49
038 Algund,34,,26,36,62
038 Algund,35,,17,36,53
038 Algund,36,,26,26,52
038 Algund,37,,32,34,66
038 Algund,38,,35,37,72
038 Algund,39,,27,35,62
038 Algund,40,,36,30,66
038 Algund,41,,38,39,77
038 Algund,42,,35,33,68
038 Algund,43,,34,41,75
038 Algund,44,,34,36,70
038 Algund,45,,35,40,75
038 Algund,46,,43,39,82
038 Algund,47,,38,42,80
038 Algund,48,,47,41,88
038 Algund,49,,43,55,98
038 Algund,50,,49,34,83
038 Algund,51,,37,46,83
038 Algund,52,,42,43,85
038 Algund,53,,45,51,96
038 Algund,54,,47,28,75
038 Algund,55,,41,41,82
038 Algund,56,,36,42,78
038 Algund,57,,27,49,76
038 Algund,58,,37,41,78
038 Algund,59,,42,38,80
038 Algund,60,,41,31,72
038 Algund,61,,26,36,62
038 Algund,62,,37,30,67
038 Algund,63,,22,28,50
038 Algund,64,,33,28,61
038 Algund,65,,19,29,48
038 Algund,66,,23,26,49
038 Algund,67,,26,27,53
038 Algund,68,,21,25,46
038 Algund,69,,18,28,46
038 Algund,70,,26,22,48
038 Algund,71,,16,18,34
038 Algund,72,,27,29,56
038 Algund,73,,24,23,47
038 Algund,74,,21,27,48
038 Algund,75,,20,18,38
038 Algund,76,,14,30,44
038 Algund,77,,15,19,34
038 Algund,78,,15,20,35
038 Algund,79,,17,24,41
038 Algund,80,,17,17,34
038 Algund,81,,16,13,29
038 Algund,82,,10,25,35
038 Algund,83,,7,17,24
038 Algund,84,,19,20,39
038 Algund,85,,13,13,26
038 Algund,86,,7,16,23
038 Algund,87,,7,15,22
038 Algund,88,,6,17,23
038 Algund,89,,4,9,13
038 Algund,90,,2,11,13
038 Algund,91,,4,7,11
038 Algund,92,,4,3,7
038 Algund,93,,2,10,12
038 Algund,94,,-,2,2
038 Algund,96,,-,1,1
038 Algund,97,,-,1,1
038 Algund,98,,1,-,1
038 Algund,99,,-,1,1
039 Lajen,0,,12,14,26
039 Lajen,1,,15,11,26
039 Lajen,2,,14,17,31
039 Lajen,3,,14,13,27
039 Lajen,4,,12,21,33
039 Lajen,5,,22,19,41
039 Lajen,6,,16,14,30
039 Lajen,7,,15,13,28
039 Lajen,8,,16,21,37
039 Lajen,9,,19,6,25
039 Lajen,10,,16,16,32
039 Lajen,11,,18,23,41
039 Lajen,12,,11,19,30
039 Lajen,13,,20,15,35
039 Lajen,14,,17,24,41
039 Lajen,15,,22,22,44
039 Lajen,16,,21,9,30
039 Lajen,17,,21,21,42
039 Lajen,18,,25,15,40
039 Lajen,19,,19,15,34
039 Lajen,20,,20,18,38
039 Lajen,21,,15,23,38
039 Lajen,22,,14,10,24
039 Lajen,23,,11,10,21
039 Lajen,24,,15,13,28
039 Lajen,25,,13,16,29
039 Lajen,26,,15,11,26
039 Lajen,27,,19,19,38
039 Lajen,28,,11,14,25
039 Lajen,29,,17,9,26
039 Lajen,30,,16,16,32
039 Lajen,31,,18,13,31
039 Lajen,32,,16,17,33
039 Lajen,33,,19,14,33
039 Lajen,34,,15,13,28
039 Lajen,35,,9,25,34
039 Lajen,36,,12,20,32
039 Lajen,37,,13,18,31
039 Lajen,38,,17,13,30
039 Lajen,39,,21,20,41
039 Lajen,40,,22,24,46
039 Lajen,41,,20,15,35
039 Lajen,42,,26,17,43
039 Lajen,43,,21,25,46
039 Lajen,44,,28,18,46
039 Lajen,45,,24,20,44
039 Lajen,46,,21,27,48
039 Lajen,47,,19,22,41
039 Lajen,48,,17,28,45
039 Lajen,49,,32,23,55
039 Lajen,50,,24,24,48
039 Lajen,51,,20,23,43
039 Lajen,52,,23,17,40
039 Lajen,53,,30,22,52
039 Lajen,54,,21,23,44
039 Lajen,55,,18,12,30
039 Lajen,56,,30,20,50
039 Lajen,57,,9,19,28
039 Lajen,58,,14,10,24
039 Lajen,59,,18,24,42
039 Lajen,60,,21,13,34
039 Lajen,61,,11,10,21
039 Lajen,62,,12,13,25
039 Lajen,63,,12,13,25
039 Lajen,64,,10,16,26
039 Lajen,65,,10,6,16
039 Lajen,66,,8,11,19
039 Lajen,67,,8,13,21
039 Lajen,68,,9,11,20
039 Lajen,69,,4,14,18
039 Lajen,70,,7,15,22
039 Lajen,71,,15,7,22
039 Lajen,72,,13,13,26
039 Lajen,73,,9,11,20
039 Lajen,74,,13,9,22
039 Lajen,75,,10,12,22
039 Lajen,76,,12,12,24
039 Lajen,77,,14,14,28
039 Lajen,78,,13,8,21
039 Lajen,79,,7,8,15
039 Lajen,80,,6,14,20
039 Lajen,81,,6,10,16
039 Lajen,82,,3,7,10
039 Lajen,83,,3,5,8
039 Lajen,84,,3,5,8
039 Lajen,85,,5,8,13
039 Lajen,86,,4,3,7
039 Lajen,87,,-,3,3
039 Lajen,88,,4,4,8
039 Lajen,89,,-,4,4
039 Lajen,90,,3,3,6
039 Lajen,91,,3,7,10
039 Lajen,92,,1,3,4
039 Lajen,93,,1,1,2
039 Lajen,94,,-,3,3
039 Lajen,95,,-,1,1
039 Lajen,96,,2,2,4
039 Lajen,97,,-,2,2
040 Leifers,0,,97,83,180
040 Leifers,1,,103,82,185
040 Leifers,2,,83,89,172
040 Leifers,3,,104,71,175
040 Leifers,4,,77,84,161
040 Leifers,5,,92,81,173
040 Leifers,6,,118,96,214
040 Leifers,7,,110,85,195
040 Leifers,8,,101,102,203
040 Leifers,9,,97,76,173
040 Leifers,10,,96,107,203
040 Leifers,11,,92,86,178
040 Leifers,12,,93,82,175
040 Leifers,13,,101,69,170
040 Leifers,14,,85,77,162
040 Leifers,15,,100,89,189
040 Leifers,16,,94,94,188
040 Leifers,17,,97,80,177
040 Leifers,18,,97,92,189
040 Leifers,19,,96,90,186
040 Leifers,20,,84,114,198
040 Leifers,21,,107,83,190
040 Leifers,22,,115,97,212
040 Leifers,23,,101,96,197
040 Leifers,24,,107,102,209
040 Leifers,25,,95,87,182
040 Leifers,26,,109,103,212
040 Leifers,27,,107,111,218
040 Leifers,28,,109,114,223
040 Leifers,29,,97,123,220
040 Leifers,30,,121,106,227
040 Leifers,31,,107,89,196
040 Leifers,32,,120,105,225
040 Leifers,33,,111,89,200
040 Leifers,34,,123,103,226
040 Leifers,35,,139,110,249
040 Leifers,36,,114,105,219
040 Leifers,37,,102,100,202
040 Leifers,38,,107,108,215
040 Leifers,39,,109,120,229
040 Leifers,40,,111,99,210
040 Leifers,41,,108,138,246
040 Leifers,42,,124,125,249
040 Leifers,43,,143,142,285
040 Leifers,44,,153,162,315
040 Leifers,45,,163,157,320
040 Leifers,46,,155,142,297
040 Leifers,47,,134,145,279
040 Leifers,48,,171,147,318
040 Leifers,49,,169,138,307
040 Leifers,50,,145,169,314
040 Leifers,51,,145,133,278
040 Leifers,52,,138,141,279
040 Leifers,53,,152,134,286
040 Leifers,54,,159,168,327
040 Leifers,55,,144,139,283
040 Leifers,56,,132,130,262
040 Leifers,57,,133,142,275
040 Leifers,58,,137,126,263
040 Leifers,59,,109,109,218
040 Leifers,60,,94,113,207
040 Leifers,61,,102,117,219
040 Leifers,62,,141,123,264
040 Leifers,63,,99,124,223
040 Leifers,64,,82,103,185
040 Leifers,65,,98,113,211
040 Leifers,66,,106,94,200
040 Leifers,67,,89,86,175
040 Leifers,68,,83,88,171
040 Leifers,69,,79,93,172
040 Leifers,70,,95,104,199
040 Leifers,71,,80,94,174
040 Leifers,72,,98,142,240
040 Leifers,73,,66,77,143
040 Leifers,74,,79,86,165
040 Leifers,75,,75,83,158
040 Leifers,76,,67,86,153
040 Leifers,77,,71,72,143
040 Leifers,78,,78,75,153
040 Leifers,79,,65,81,146
040 Leifers,80,,60,62,122
040 Leifers,81,,39,59,98
040 Leifers,82,,28,54,82
040 Leifers,83,,33,53,86
040 Leifers,84,,40,51,91
040 Leifers,85,,28,42,70
040 Leifers,86,,32,53,85
040 Leifers,87,,20,39,59
040 Leifers,88,,18,37,55
040 Leifers,89,,18,28,46
040 Leifers,90,,10,17,27
040 Leifers,91,,7,21,28
040 Leifers,92,,2,18,20
040 Leifers,93,,5,17,22
040 Leifers,94,,3,14,17
040 Leifers,95,,3,11,14
040 Leifers,96,,2,10,12
040 Leifers,97,,2,4,6
040 Leifers,98,,-,1,1
040 Leifers,100,,-,1,1
040 Leifers,102,,-,1,1
040 Leifers,103,,-,1,1
041 Lana,0,,86,64,150
041 Lana,1,,64,69,133
041 Lana,2,,72,79,151
041 Lana,3,,87,71,158
041 Lana,4,,66,76,142
041 Lana,5,,62,83,145
041 Lana,6,,68,67,135
041 Lana,7,,73,68,141
041 Lana,8,,65,64,129
041 Lana,9,,66,49,115
041 Lana,10,,68,65,133
041 Lana,11,,75,58,133
041 Lana,12,,75,65,140
041 Lana,13,,69,66,135
041 Lana,14,,76,52,128
041 Lana,15,,62,67,129
041 Lana,16,,61,54,115
041 Lana,17,,74,56,130
041 Lana,18,,77,70,147
041 Lana,19,,75,65,140
041 Lana,20,,68,69,137
041 Lana,21,,63,74,137
041 Lana,22,,83,82,165
041 Lana,23,,80,73,153
041 Lana,24,,74,82,156
041 Lana,25,,66,77,143
041 Lana,26,,75,62,137
041 Lana,27,,73,76,149
041 Lana,28,,66,90,156
041 Lana,29,,53,95,148
041 Lana,30,,83,76,159
041 Lana,31,,83,69,152
041 Lana,32,,74,71,145
041 Lana,33,,67,85,152
041 Lana,34,,86,80,166
041 Lana,35,,96,88,184
041 Lana,36,,92,91,183
041 Lana,37,,61,92,153
041 Lana,38,,80,78,158
041 Lana,39,,80,103,183
041 Lana,40,,89,89,178
041 Lana,41,,75,76,151
041 Lana,42,,89,97,186
041 Lana,43,,81,102,183
041 Lana,44,,99,94,193
041 Lana,45,,85,91,176
041 Lana,46,,106,90,196
041 Lana,47,,97,111,208
041 Lana,48,,101,107,208
041 Lana,49,,133,84,217
041 Lana,50,,88,104,192
041 Lana,51,,92,97,189
041 Lana,52,,99,108,207
041 Lana,53,,101,93,194
041 Lana,54,,103,116,219
041 Lana,55,,107,83,190
041 Lana,56,,90,84,174
041 Lana,57,,94,95,189
041 Lana,58,,77,82,159
041 Lana,59,,82,84,166
041 Lana,60,,74,89,163
041 Lana,61,,75,83,158
041 Lana,62,,57,63,120
041 Lana,63,,61,72,133
041 Lana,64,,53,59,112
041 Lana,65,,55,59,114
041 Lana,66,,46,59,105
041 Lana,67,,49,66,115
041 Lana,68,,51,57,108
041 Lana,69,,49,55,104
041 Lana,70,,48,64,112
041 Lana,71,,52,46,98
041 Lana,72,,56,63,119
041 Lana,73,,39,51,90
041 Lana,74,,42,62,104
041 Lana,75,,51,56,107
041 Lana,76,,47,64,111
041 Lana,77,,47,46,93
041 Lana,78,,37,49,86
041 Lana,79,,43,49,92
041 Lana,80,,31,47,78
041 Lana,81,,28,32,60
041 Lana,82,,31,40,71
041 Lana,83,,22,30,52
041 Lana,84,,29,37,66
041 Lana,85,,14,33,47
041 Lana,86,,15,28,43
041 Lana,87,,12,24,36
041 Lana,88,,12,24,36
041 Lana,89,,8,21,29
041 Lana,90,,13,18,31
041 Lana,91,,11,17,28
041 Lana,92,,7,11,18
041 Lana,93,,8,20,28
041 Lana,94,,2,8,10
041 Lana,95,,5,11,16
041 Lana,96,,3,8,11
041 Lana,97,,3,4,7
041 Lana,98,,-,3,3
041 Lana,100,,-,1,1
041 Lana,101,,-,1,1
042 Laas,0,,21,17,38
042 Laas,1,,19,29,48
042 Laas,2,,26,18,44
042 Laas,3,,15,19,34
042 Laas,4,,25,22,47
042 Laas,5,,28,29,57
042 Laas,6,,22,25,47
042 Laas,7,,21,26,47
042 Laas,8,,35,28,63
042 Laas,9,,22,29,51
042 Laas,10,,23,26,49
042 Laas,11,,29,17,46
042 Laas,12,,18,30,48
042 Laas,13,,35,14,49
042 Laas,14,,25,19,44
042 Laas,15,,24,21,45
042 Laas,16,,30,15,45
042 Laas,17,,19,21,40
042 Laas,18,,26,25,51
042 Laas,19,,19,16,35
042 Laas,20,,30,34,64
042 Laas,21,,28,25,53
042 Laas,22,,31,31,62
042 Laas,23,,30,30,60
042 Laas,24,,25,25,50
042 Laas,25,,25,19,44
042 Laas,26,,17,20,37
042 Laas,27,,23,18,41
042 Laas,28,,18,21,39
042 Laas,29,,24,16,40
042 Laas,30,,20,17,37
042 Laas,31,,23,18,41
042 Laas,32,,30,24,54
042 Laas,33,,21,20,41
042 Laas,34,,21,31,52
042 Laas,35,,15,43,58
042 Laas,36,,28,31,59
042 Laas,37,,26,35,61
042 Laas,38,,22,24,46
042 Laas,39,,34,27,61
042 Laas,40,,23,36,59
042 Laas,41,,27,22,49
042 Laas,42,,27,28,55
042 Laas,43,,31,19,50
042 Laas,44,,41,30,71
042 Laas,45,,36,28,64
042 Laas,46,,31,24,55
042 Laas,47,,26,26,52
042 Laas,48,,38,29,67
042 Laas,49,,29,37,66
042 Laas,50,,34,33,67
042 Laas,51,,29,27,56
042 Laas,52,,29,27,56
042 Laas,53,,34,33,67
042 Laas,54,,30,28,58
042 Laas,55,,29,29,58
042 Laas,56,,35,28,63
042 Laas,57,,25,29,54
042 Laas,58,,38,26,64
042 Laas,59,,30,28,58
042 Laas,60,,23,23,46
042 Laas,61,,16,25,41
042 Laas,62,,21,15,36
042 Laas,63,,16,13,29
042 Laas,64,,16,24,40
042 Laas,65,,18,12,30
042 Laas,66,,29,25,54
042 Laas,67,,11,15,26
042 Laas,68,,17,23,40
042 Laas,69,,19,18,37
042 Laas,70,,16,20,36
042 Laas,71,,22,11,33
042 Laas,72,,13,16,29
042 Laas,73,,13,12,25
042 Laas,74,,10,13,23
042 Laas,75,,10,15,25
042 Laas,76,,14,17,31
042 Laas,77,,12,21,33
042 Laas,78,,16,20,36
042 Laas,79,,12,22,34
042 Laas,80,,13,10,23
042 Laas,81,,6,13,19
042 Laas,82,,16,11,27
042 Laas,83,,15,16,31
042 Laas,84,,6,12,18
042 Laas,85,,9,11,20
042 Laas,86,,8,10,18
042 Laas,87,,8,18,26
042 Laas,88,,5,8,13
042 Laas,89,,4,6,10
042 Laas,90,,4,6,10
042 Laas,91,,2,3,5
042 Laas,92,,5,4,9
042 Laas,93,,-,2,2
042 Laas,94,,-,7,7
042 Laas,95,,1,2,3
042 Laas,96,,1,1,2
042 Laas,97,,-,1,1
043 Laurein,0,,3,2,5
043 Laurein,1,,1,-,1
043 Laurein,2,,1,-,1
043 Laurein,3,,2,1,3
043 Laurein,4,,2,1,3
043 Laurein,5,,2,1,3
043 Laurein,6,,-,1,1
043 Laurein,7,,3,-,3
043 Laurein,8,,2,1,3
043 Laurein,9,,2,3,5
043 Laurein,10,,2,1,3
043 Laurein,11,,1,-,1
043 Laurein,12,,8,-,8
043 Laurein,13,,3,4,7
043 Laurein,14,,3,1,4
043 Laurein,15,,3,3,6
043 Laurein,16,,2,3,5
043 Laurein,17,,7,1,8
043 Laurein,18,,3,7,10
043 Laurein,19,,2,2,4
043 Laurein,20,,4,3,7
043 Laurein,21,,3,6,9
043 Laurein,22,,1,2,3
043 Laurein,23,,2,2,4
043 Laurein,24,,2,3,5
043 Laurein,25,,2,5,7
043 Laurein,26,,1,1,2
043 Laurein,27,,1,1,2
043 Laurein,28,,4,1,5
043 Laurein,29,,3,3,6
043 Laurein,30,,1,1,2
043 Laurein,31,,1,1,2
043 Laurein,32,,3,1,4
043 Laurein,33,,-,2,2
043 Laurein,34,,1,1,2
043 Laurein,35,,-,1,1
043 Laurein,36,,1,1,2
043 Laurein,37,,3,-,3
043 Laurein,38,,2,-,2
043 Laurein,39,,2,-,2
043 Laurein,40,,3,3,6
043 Laurein,41,,-,3,3
043 Laurein,42,,5,1,6
043 Laurein,43,,-,4,4
043 Laurein,44,,-,1,1
043 Laurein,45,,5,3,8
043 Laurein,46,,1,2,3
043 Laurein,47,,4,5,9
043 Laurein,48,,4,3,7
043 Laurein,49,,5,4,9
043 Laurein,50,,-,2,2
043 Laurein,51,,4,6,10
043 Laurein,52,,6,3,9
043 Laurein,53,,4,1,5
043 Laurein,54,,5,3,8
043 Laurein,55,,-,2,2
043 Laurein,56,,2,2,4
043 Laurein,57,,5,4,9
043 Laurein,58,,1,-,1
043 Laurein,59,,4,4,8
043 Laurein,60,,2,2,4
043 Laurein,61,,6,-,6
043 Laurein,63,,2,-,2
043 Laurein,64,,3,1,4
043 Laurein,65,,2,1,3
043 Laurein,66,,2,-,2
043 Laurein,68,,1,1,2
043 Laurein,69,,2,2,4
043 Laurein,70,,2,-,2
043 Laurein,71,,2,2,4
043 Laurein,72,,-,1,1
043 Laurein,73,,-,1,1
043 Laurein,74,,-,1,1
043 Laurein,75,,1,-,1
043 Laurein,76,,1,-,1
043 Laurein,78,,2,2,4
043 Laurein,79,,1,1,2
043 Laurein,80,,1,1,2
043 Laurein,81,,2,1,3
043 Laurein,82,,1,2,3
043 Laurein,83,,-,3,3
043 Laurein,84,,1,4,5
043 Laurein,86,,-,2,2
043 Laurein,87,,-,1,1
043 Laurein,88,,-,3,3
043 Laurein,89,,1,-,1
043 Laurein,90,,2,-,2
043 Laurein,91,,2,-,2
043 Laurein,94,,-,1,1
044 Lüsen,0,,9,9,18
044 Lüsen,1,,12,10,22
044 Lüsen,2,,11,8,19
044 Lüsen,3,,6,6,12
044 Lüsen,4,,12,11,23
044 Lüsen,5,,2,10,12
044 Lüsen,6,,10,8,18
044 Lüsen,7,,12,6,18
044 Lüsen,8,,13,10,23
044 Lüsen,9,,12,8,20
044 Lüsen,10,,8,8,16
044 Lüsen,11,,13,11,24
044 Lüsen,12,,10,15,25
044 Lüsen,13,,9,10,19
044 Lüsen,14,,11,10,21
044 Lüsen,15,,13,10,23
044 Lüsen,16,,9,8,17
044 Lüsen,17,,10,10,20
044 Lüsen,18,,12,11,23
044 Lüsen,19,,4,9,13
044 Lüsen,20,,11,12,23
044 Lüsen,21,,16,6,22
044 Lüsen,22,,6,11,17
044 Lüsen,23,,10,11,21
044 Lüsen,24,,15,13,28
044 Lüsen,25,,10,9,19
044 Lüsen,26,,9,10,19
044 Lüsen,27,,7,8,15
044 Lüsen,28,,9,13,22
044 Lüsen,29,,14,12,26
044 Lüsen,30,,9,9,18
044 Lüsen,31,,10,6,16
044 Lüsen,32,,9,8,17
044 Lüsen,33,,8,4,12
044 Lüsen,34,,8,15,23
044 Lüsen,35,,5,8,13
044 Lüsen,36,,8,8,16
044 Lüsen,37,,9,11,20
044 Lüsen,38,,12,9,21
044 Lüsen,39,,9,8,17
044 Lüsen,40,,15,14,29
044 Lüsen,41,,9,13,22
044 Lüsen,42,,14,10,24
044 Lüsen,43,,10,12,22
044 Lüsen,44,,13,17,30
044 Lüsen,45,,7,6,13
044 Lüsen,46,,9,9,18
044 Lüsen,47,,13,9,22
044 Lüsen,48,,18,14,32
044 Lüsen,49,,11,10,21
044 Lüsen,50,,11,17,28
044 Lüsen,51,,11,19,30
044 Lüsen,52,,15,11,26
044 Lüsen,53,,13,10,23
044 Lüsen,54,,12,8,20
044 Lüsen,55,,13,11,24
044 Lüsen,56,,7,11,18
044 Lüsen,57,,11,10,21
044 Lüsen,58,,8,13,21
044 Lüsen,59,,10,6,16
044 Lüsen,60,,11,14,25
044 Lüsen,61,,10,10,20
044 Lüsen,62,,7,8,15
044 Lüsen,63,,6,7,13
044 Lüsen,64,,10,7,17
044 Lüsen,65,,7,10,17
044 Lüsen,66,,9,4,13
044 Lüsen,67,,5,5,10
044 Lüsen,68,,4,8,12
044 Lüsen,69,,7,10,17
044 Lüsen,70,,6,1,7
044 Lüsen,71,,4,5,9
044 Lüsen,72,,9,6,15
044 Lüsen,73,,3,7,10
044 Lüsen,74,,4,2,6
044 Lüsen,75,,7,7,14
044 Lüsen,76,,3,6,9
044 Lüsen,77,,5,2,7
044 Lüsen,78,,3,8,11
044 Lüsen,79,,8,6,14
044 Lüsen,80,,5,4,9
044 Lüsen,81,,5,4,9
044 Lüsen,82,,3,8,11
044 Lüsen,83,,1,4,5
044 Lüsen,84,,2,4,6
044 Lüsen,85,,6,1,7
044 Lüsen,86,,1,6,7
044 Lüsen,87,,3,2,5
044 Lüsen,88,,-,3,3
044 Lüsen,89,,1,2,3
044 Lüsen,90,,1,2,3
044 Lüsen,91,,1,2,3
044 Lüsen,92,,2,1,3
044 Lüsen,94,,1,-,1
044 Lüsen,95,,-,2,2
044 Lüsen,97,,-,1,1
045 Margreid a.d. Weinstr.,0,,7,7,14
045 Margreid a.d. Weinstr.,1,,8,10,18
045 Margreid a.d. Weinstr.,2,,8,3,11
045 Margreid a.d. Weinstr.,3,,6,5,11
045 Margreid a.d. Weinstr.,4,,8,12,20
045 Margreid a.d. Weinstr.,5,,7,5,12
045 Margreid a.d. Weinstr.,6,,5,9,14
045 Margreid a.d. Weinstr.,7,,4,8,12
045 Margreid a.d. Weinstr.,8,,6,7,13
045 Margreid a.d. Weinstr.,9,,5,7,12
045 Margreid a.d. Weinstr.,10,,9,8,17
045 Margreid a.d. Weinstr.,11,,7,5,12
045 Margreid a.d. Weinstr.,12,,10,4,14
045 Margreid a.d. Weinstr.,13,,7,11,18
045 Margreid a.d. Weinstr.,14,,8,10,18
045 Margreid a.d. Weinstr.,15,,7,3,10
045 Margreid a.d. Weinstr.,16,,10,9,19
045 Margreid a.d. Weinstr.,17,,10,10,20
045 Margreid a.d. Weinstr.,18,,8,7,15
045 Margreid a.d. Weinstr.,19,,6,11,17
045 Margreid a.d. Weinstr.,20,,2,12,14
045 Margreid a.d. Weinstr.,21,,11,15,26
045 Margreid a.d. Weinstr.,22,,3,2,5
045 Margreid a.d. Weinstr.,23,,1,4,5
045 Margreid a.d. Weinstr.,24,,7,6,13
045 Margreid a.d. Weinstr.,25,,3,13,16
045 Margreid a.d. Weinstr.,26,,4,4,8
045 Margreid a.d. Weinstr.,27,,4,7,11
045 Margreid a.d. Weinstr.,28,,5,8,13
045 Margreid a.d. Weinstr.,29,,4,6,10
045 Margreid a.d. Weinstr.,30,,10,7,17
045 Margreid a.d. Weinstr.,31,,9,11,20
045 Margreid a.d. Weinstr.,32,,6,8,14
045 Margreid a.d. Weinstr.,33,,15,1,16
045 Margreid a.d. Weinstr.,34,,7,11,18
045 Margreid a.d. Weinstr.,35,,8,11,19
045 Margreid a.d. Weinstr.,36,,12,7,19
045 Margreid a.d. Weinstr.,37,,11,7,18
045 Margreid a.d. Weinstr.,38,,4,10,14
045 Margreid a.d. Weinstr.,39,,8,2,10
045 Margreid a.d. Weinstr.,40,,8,7,15
045 Margreid a.d. Weinstr.,41,,6,9,15
045 Margreid a.d. Weinstr.,42,,11,18,29
045 Margreid a.d. Weinstr.,43,,9,6,15
045 Margreid a.d. Weinstr.,44,,10,6,16
045 Margreid a.d. Weinstr.,45,,8,12,20
045 Margreid a.d. Weinstr.,46,,7,6,13
045 Margreid a.d. Weinstr.,47,,10,8,18
045 Margreid a.d. Weinstr.,48,,8,11,19
045 Margreid a.d. Weinstr.,49,,6,11,17
045 Margreid a.d. Weinstr.,50,,17,15,32
045 Margreid a.d. Weinstr.,51,,13,17,30
045 Margreid a.d. Weinstr.,52,,18,10,28
045 Margreid a.d. Weinstr.,53,,11,4,15
045 Margreid a.d. Weinstr.,54,,7,3,10
045 Margreid a.d. Weinstr.,55,,9,11,20
045 Margreid a.d. Weinstr.,56,,6,15,21
045 Margreid a.d. Weinstr.,57,,14,13,27
045 Margreid a.d. Weinstr.,58,,13,10,23
045 Margreid a.d. Weinstr.,59,,8,11,19
045 Margreid a.d. Weinstr.,60,,8,6,14
045 Margreid a.d. Weinstr.,61,,9,7,16
045 Margreid a.d. Weinstr.,62,,13,6,19
045 Margreid a.d. Weinstr.,63,,8,7,15
045 Margreid a.d. Weinstr.,64,,4,5,9
045 Margreid a.d. Weinstr.,65,,7,8,15
045 Margreid a.d. Weinstr.,66,,6,6,12
045 Margreid a.d. Weinstr.,67,,3,7,10
045 Margreid a.d. Weinstr.,68,,7,6,13
045 Margreid a.d. Weinstr.,69,,8,2,10
045 Margreid a.d. Weinstr.,70,,5,9,14
045 Margreid a.d. Weinstr.,71,,4,5,9
045 Margreid a.d. Weinstr.,72,,2,3,5
045 Margreid a.d. Weinstr.,73,,6,6,12
045 Margreid a.d. Weinstr.,74,,3,5,8
045 Margreid a.d. Weinstr.,75,,6,3,9
045 Margreid a.d. Weinstr.,76,,7,5,12
045 Margreid a.d. Weinstr.,77,,7,5,12
045 Margreid a.d. Weinstr.,78,,6,4,10
045 Margreid a.d. Weinstr.,79,,2,4,6
045 Margreid a.d. Weinstr.,80,,3,8,11
045 Margreid a.d. Weinstr.,81,,3,3,6
045 Margreid a.d. Weinstr.,82,,3,4,7
045 Margreid a.d. Weinstr.,83,,2,5,7
045 Margreid a.d. Weinstr.,84,,1,4,5
045 Margreid a.d. Weinstr.,85,,1,3,4
045 Margreid a.d. Weinstr.,86,,3,2,5
045 Margreid a.d. Weinstr.,87,,-,4,4
045 Margreid a.d. Weinstr.,88,,1,1,2
045 Margreid a.d. Weinstr.,89,,-,1,1
045 Margreid a.d. Weinstr.,90,,1,-,1
045 Margreid a.d. Weinstr.,91,,-,3,3
045 Margreid a.d. Weinstr.,92,,-,4,4
045 Margreid a.d. Weinstr.,93,,-,1,1
046 Mals,0,,23,28,51
046 Mals,1,,31,36,67
046 Mals,2,,48,23,71
046 Mals,3,,30,23,53
046 Mals,4,,33,24,57
046 Mals,5,,33,30,63
046 Mals,6,,29,25,54
046 Mals,7,,31,22,53
046 Mals,8,,31,27,58
046 Mals,9,,33,17,50
046 Mals,10,,26,24,50
046 Mals,11,,21,35,56
046 Mals,12,,35,34,69
046 Mals,13,,24,29,53
046 Mals,14,,29,25,54
046 Mals,15,,30,19,49
046 Mals,16,,25,27,52
046 Mals,17,,32,28,60
046 Mals,18,,31,37,68
046 Mals,19,,43,30,73
046 Mals,20,,38,35,73
046 Mals,21,,36,36,72
046 Mals,22,,43,33,76
046 Mals,23,,36,43,79
046 Mals,24,,37,36,73
046 Mals,25,,35,33,68
046 Mals,26,,34,39,73
046 Mals,27,,42,38,80
046 Mals,28,,40,35,75
046 Mals,29,,45,29,74
046 Mals,30,,38,26,64
046 Mals,31,,27,26,53
046 Mals,32,,24,34,58
046 Mals,33,,37,31,68
046 Mals,34,,38,31,69
046 Mals,35,,35,34,69
046 Mals,36,,34,33,67
046 Mals,37,,32,37,69
046 Mals,38,,39,33,72
046 Mals,39,,29,31,60
046 Mals,40,,41,31,72
046 Mals,41,,28,26,54
046 Mals,42,,29,29,58
046 Mals,43,,36,32,68
046 Mals,44,,47,28,75
046 Mals,45,,31,35,66
046 Mals,46,,27,46,73
046 Mals,47,,34,49,83
046 Mals,48,,43,48,91
046 Mals,49,,47,44,91
046 Mals,50,,53,39,92
046 Mals,51,,46,34,80
046 Mals,52,,50,50,100
046 Mals,53,,50,39,89
046 Mals,54,,43,41,84
046 Mals,55,,48,54,102
046 Mals,56,,37,30,67
046 Mals,57,,47,37,84
046 Mals,58,,33,40,73
046 Mals,59,,33,33,66
046 Mals,60,,29,23,52
046 Mals,61,,34,32,66
046 Mals,62,,32,26,58
046 Mals,63,,27,24,51
046 Mals,64,,19,19,38
046 Mals,65,,31,31,62
046 Mals,66,,25,22,47
046 Mals,67,,28,20,48
046 Mals,68,,33,22,55
046 Mals,69,,20,25,45
046 Mals,70,,23,15,38
046 Mals,71,,19,20,39
046 Mals,72,,16,25,41
046 Mals,73,,10,18,28
046 Mals,74,,27,14,41
046 Mals,75,,22,18,40
046 Mals,76,,13,23,36
046 Mals,77,,12,13,25
046 Mals,78,,13,24,37
046 Mals,79,,18,24,42
046 Mals,80,,13,17,30
046 Mals,81,,9,24,33
046 Mals,82,,14,14,28
046 Mals,83,,8,14,22
046 Mals,84,,6,11,17
046 Mals,85,,9,15,24
046 Mals,86,,11,7,18
046 Mals,87,,6,11,17
046 Mals,88,,10,10,20
046 Mals,89,,4,8,12
046 Mals,90,,4,7,11
046 Mals,91,,3,2,5
046 Mals,92,,1,8,9
046 Mals,93,,1,4,5
046 Mals,94,,-,5,5
046 Mals,95,,-,1,1
046 Mals,96,,1,2,3
046 Mals,98,,-,1,1
046 Mals,101,,-,1,1
047 Enneberg,0,,26,20,46
047 Enneberg,1,,29,15,44
047 Enneberg,2,,24,23,47
047 Enneberg,3,,21,25,46
047 Enneberg,4,,15,24,39
047 Enneberg,5,,15,19,34
047 Enneberg,6,,18,15,33
047 Enneberg,7,,24,17,41
047 Enneberg,8,,19,11,30
047 Enneberg,9,,15,13,28
047 Enneberg,10,,16,20,36
047 Enneberg,11,,15,15,30
047 Enneberg,12,,23,21,44
047 Enneberg,13,,19,16,35
047 Enneberg,14,,14,18,32
047 Enneberg,15,,21,27,48
047 Enneberg,16,,17,14,31
047 Enneberg,17,,29,16,45
047 Enneberg,18,,20,20,40
047 Enneberg,19,,25,18,43
047 Enneberg,20,,20,11,31
047 Enneberg,21,,24,13,37
047 Enneberg,22,,16,16,32
047 Enneberg,23,,22,9,31
047 Enneberg,24,,20,14,34
047 Enneberg,25,,23,20,43
047 Enneberg,26,,13,16,29
047 Enneberg,27,,17,21,38
047 Enneberg,28,,17,25,42
047 Enneberg,29,,21,17,38
047 Enneberg,30,,18,11,29
047 Enneberg,31,,18,15,33
047 Enneberg,32,,18,11,29
047 Enneberg,33,,23,18,41
047 Enneberg,34,,18,17,35
047 Enneberg,35,,17,14,31
047 Enneberg,36,,22,22,44
047 Enneberg,37,,17,22,39
047 Enneberg,38,,20,21,41
047 Enneberg,39,,13,21,34
047 Enneberg,40,,19,24,43
047 Enneberg,41,,22,20,42
047 Enneberg,42,,14,17,31
047 Enneberg,43,,16,26,42
047 Enneberg,44,,25,33,58
047 Enneberg,45,,28,23,51
047 Enneberg,46,,23,25,48
047 Enneberg,47,,27,39,66
047 Enneberg,48,,25,17,42
047 Enneberg,49,,33,18,51
047 Enneberg,50,,24,23,47
047 Enneberg,51,,25,22,47
047 Enneberg,52,,22,19,41
047 Enneberg,53,,25,22,47
047 Enneberg,54,,22,20,42
047 Enneberg,55,,22,20,42
047 Enneberg,56,,18,16,34
047 Enneberg,57,,19,17,36
047 Enneberg,58,,15,16,31
047 Enneberg,59,,23,15,38
047 Enneberg,60,,21,13,34
047 Enneberg,61,,14,16,30
047 Enneberg,62,,14,18,32
047 Enneberg,63,,14,15,29
047 Enneberg,64,,14,14,28
047 Enneberg,65,,17,21,38
047 Enneberg,66,,14,18,32
047 Enneberg,67,,18,9,27
047 Enneberg,68,,9,16,25
047 Enneberg,69,,17,7,24
047 Enneberg,70,,15,13,28
047 Enneberg,71,,6,11,17
047 Enneberg,72,,10,18,28
047 Enneberg,73,,3,12,15
047 Enneberg,74,,17,18,35
047 Enneberg,75,,15,8,23
047 Enneberg,76,,10,16,26
047 Enneberg,77,,12,12,24
047 Enneberg,78,,8,6,14
047 Enneberg,79,,14,8,22
047 Enneberg,80,,10,12,22
047 Enneberg,81,,12,10,22
047 Enneberg,82,,8,9,17
047 Enneberg,83,,9,12,21
047 Enneberg,84,,4,9,13
047 Enneberg,85,,6,7,13
047 Enneberg,86,,4,15,19
047 Enneberg,87,,7,6,13
047 Enneberg,88,,6,11,17
047 Enneberg,89,,3,6,9
047 Enneberg,90,,2,5,7
047 Enneberg,91,,1,4,5
047 Enneberg,92,,3,1,4
047 Enneberg,93,,2,4,6
047 Enneberg,94,,-,2,2
047 Enneberg,95,,-,4,4
047 Enneberg,96,,1,4,5
047 Enneberg,97,,1,1,2
047 Enneberg,99,,-,1,1
047 Enneberg,104,,-,1,1
048 Marling,0,,20,17,37
048 Marling,1,,18,17,35
048 Marling,2,,13,20,33
048 Marling,3,,19,9,28
048 Marling,4,,12,16,28
048 Marling,5,,12,10,22
048 Marling,6,,13,11,24
048 Marling,7,,19,7,26
048 Marling,8,,20,9,29
048 Marling,9,,22,5,27
048 Marling,10,,12,13,25
048 Marling,11,,19,12,31
048 Marling,12,,9,17,26
048 Marling,13,,26,13,39
048 Marling,14,,13,14,27
048 Marling,15,,12,14,26
048 Marling,16,,13,19,32
048 Marling,17,,12,16,28
048 Marling,18,,20,18,38
048 Marling,19,,14,9,23
048 Marling,20,,13,14,27
048 Marling,21,,15,10,25
048 Marling,22,,15,15,30
048 Marling,23,,22,13,35
048 Marling,24,,14,11,25
048 Marling,25,,17,19,36
048 Marling,26,,19,17,36
048 Marling,27,,14,19,33
048 Marling,28,,20,27,47
048 Marling,29,,23,19,42
048 Marling,30,,16,14,30
048 Marling,31,,20,15,35
048 Marling,32,,9,20,29
048 Marling,33,,11,24,35
048 Marling,34,,22,13,35
048 Marling,35,,17,17,34
048 Marling,36,,20,16,36
048 Marling,37,,21,16,37
048 Marling,38,,19,15,34
048 Marling,39,,17,23,40
048 Marling,40,,19,25,44
048 Marling,41,,23,16,39
048 Marling,42,,16,24,40
048 Marling,43,,28,17,45
048 Marling,44,,16,10,26
048 Marling,45,,21,22,43
048 Marling,46,,25,25,50
048 Marling,47,,26,17,43
048 Marling,48,,19,21,40
048 Marling,49,,21,18,39
048 Marling,50,,27,20,47
048 Marling,51,,18,20,38
048 Marling,52,,28,30,58
048 Marling,53,,27,18,45
048 Marling,54,,28,20,48
048 Marling,55,,29,29,58
048 Marling,56,,17,21,38
048 Marling,57,,25,14,39
048 Marling,58,,14,23,37
048 Marling,59,,20,18,38
048 Marling,60,,17,11,28
048 Marling,61,,11,13,24
048 Marling,62,,12,13,25
048 Marling,63,,13,6,19
048 Marling,64,,18,12,30
048 Marling,65,,9,15,24
048 Marling,66,,11,16,27
048 Marling,67,,6,16,22
048 Marling,68,,10,15,25
048 Marling,69,,18,16,34
048 Marling,70,,5,13,18
048 Marling,71,,15,13,28
048 Marling,72,,12,14,26
048 Marling,73,,16,11,27
048 Marling,74,,17,14,31
048 Marling,75,,10,16,26
048 Marling,76,,7,12,19
048 Marling,77,,17,15,32
048 Marling,78,,10,11,21
048 Marling,79,,13,13,26
048 Marling,80,,7,10,17
048 Marling,81,,8,12,20
048 Marling,82,,11,7,18
048 Marling,83,,3,14,17
048 Marling,84,,6,6,12
048 Marling,85,,6,11,17
048 Marling,86,,5,6,11
048 Marling,87,,6,7,13
048 Marling,88,,1,7,8
048 Marling,89,,4,4,8
048 Marling,90,,3,-,3
048 Marling,91,,3,3,6
048 Marling,92,,1,2,3
048 Marling,93,,-,4,4
048 Marling,94,,-,4,4
048 Marling,95,,-,3,3
048 Marling,97,,1,1,2
049 Martell,0,,2,6,8
049 Martell,1,,6,2,8
049 Martell,2,,4,3,7
049 Martell,3,,3,3,6
049 Martell,4,,3,5,8
049 Martell,5,,7,2,9
049 Martell,6,,3,4,7
049 Martell,7,,9,4,13
049 Martell,8,,8,3,11
049 Martell,9,,3,1,4
049 Martell,10,,6,1,7
049 Martell,11,,7,1,8
049 Martell,12,,3,5,8
049 Martell,13,,9,3,12
049 Martell,14,,6,2,8
049 Martell,15,,5,5,10
049 Martell,16,,2,6,8
049 Martell,17,,5,7,12
049 Martell,18,,7,3,10
049 Martell,19,,1,7,8
049 Martell,20,,6,6,12
049 Martell,21,,6,7,13
049 Martell,22,,4,6,10
049 Martell,23,,6,7,13
049 Martell,24,,6,7,13
049 Martell,25,,6,3,9
049 Martell,26,,3,3,6
049 Martell,27,,7,4,11
049 Martell,28,,3,4,7
049 Martell,29,,7,5,12
049 Martell,30,,4,2,6
049 Martell,31,,8,5,13
049 Martell,32,,-,3,3
049 Martell,33,,4,4,8
049 Martell,34,,4,-,4
049 Martell,35,,7,6,13
049 Martell,36,,6,6,12
049 Martell,37,,5,5,10
049 Martell,38,,6,5,11
049 Martell,39,,7,1,8
049 Martell,40,,4,5,9
049 Martell,41,,7,3,10
049 Martell,42,,5,7,12
049 Martell,43,,2,6,8
049 Martell,44,,8,11,19
049 Martell,45,,10,4,14
049 Martell,46,,6,8,14
049 Martell,47,,9,4,13
049 Martell,48,,6,3,9
049 Martell,49,,6,12,18
049 Martell,50,,8,6,14
049 Martell,51,,6,7,13
049 Martell,52,,15,5,20
049 Martell,53,,17,11,28
049 Martell,54,,6,9,15
049 Martell,55,,14,1,15
049 Martell,56,,10,6,16
049 Martell,57,,6,5,11
049 Martell,58,,9,3,12
049 Martell,59,,7,6,13
049 Martell,60,,6,6,12
049 Martell,61,,6,3,9
049 Martell,62,,5,4,9
049 Martell,63,,7,3,10
049 Martell,64,,5,5,10
049 Martell,65,,2,4,6
049 Martell,66,,3,3,6
049 Martell,67,,4,8,12
049 Martell,68,,3,5,8
049 Martell,69,,3,1,4
049 Martell,70,,4,4,8
049 Martell,71,,3,3,6
049 Martell,72,,3,-,3
049 Martell,73,,4,1,5
049 Martell,74,,1,3,4
049 Martell,75,,4,3,7
049 Martell,76,,5,4,9
049 Martell,77,,2,3,5
049 Martell,78,,6,2,8
049 Martell,79,,1,4,5
049 Martell,80,,1,3,4
049 Martell,81,,1,3,4
049 Martell,82,,1,4,5
049 Martell,83,,1,6,7
049 Martell,84,,3,1,4
049 Martell,85,,4,3,7
049 Martell,86,,1,1,2
049 Martell,87,,2,-,2
049 Martell,88,,2,-,2
049 Martell,89,,-,1,1
049 Martell,90,,-,1,1
049 Martell,91,,1,2,3
049 Martell,92,,-,2,2
049 Martell,93,,-,1,1
049 Martell,94,,1,-,1
050 Mölten,0,,11,10,21
050 Mölten,1,,4,6,10
050 Mölten,2,,8,10,18
050 Mölten,3,,15,8,23
050 Mölten,4,,9,7,16
050 Mölten,5,,14,14,28
050 Mölten,6,,9,8,17
050 Mölten,7,,13,10,23
050 Mölten,8,,5,13,18
050 Mölten,9,,14,12,26
050 Mölten,10,,10,16,26
050 Mölten,11,,14,10,24
050 Mölten,12,,8,8,16
050 Mölten,13,,10,12,22
050 Mölten,14,,12,12,24
050 Mölten,15,,11,9,20
050 Mölten,16,,15,10,25
050 Mölten,17,,15,16,31
050 Mölten,18,,13,13,26
050 Mölten,19,,12,15,27
050 Mölten,20,,9,14,23
050 Mölten,21,,10,4,14
050 Mölten,22,,15,12,27
050 Mölten,23,,11,8,19
050 Mölten,24,,13,7,20
050 Mölten,25,,12,9,21
050 Mölten,26,,6,12,18
050 Mölten,27,,11,8,19
050 Mölten,28,,9,5,14
050 Mölten,29,,10,6,16
050 Mölten,30,,9,10,19
050 Mölten,31,,9,6,15
050 Mölten,32,,9,6,15
050 Mölten,33,,7,6,13
050 Mölten,34,,6,8,14
050 Mölten,35,,7,5,12
050 Mölten,36,,11,12,23
050 Mölten,37,,13,12,25
050 Mölten,38,,15,8,23
050 Mölten,39,,11,16,27
050 Mölten,40,,11,7,18
050 Mölten,41,,5,17,22
050 Mölten,42,,11,21,32
050 Mölten,43,,24,11,35
050 Mölten,44,,11,15,26
050 Mölten,45,,18,18,36
050 Mölten,46,,9,12,21
050 Mölten,47,,12,16,28
050 Mölten,48,,15,11,26
050 Mölten,49,,15,13,28
050 Mölten,50,,18,16,34
050 Mölten,51,,18,13,31
050 Mölten,52,,17,13,30
050 Mölten,53,,14,12,26
050 Mölten,54,,21,15,36
050 Mölten,55,,19,7,26
050 Mölten,56,,15,10,25
050 Mölten,57,,17,10,27
050 Mölten,58,,9,10,19
050 Mölten,59,,14,5,19
050 Mölten,60,,4,8,12
050 Mölten,61,,7,3,10
050 Mölten,62,,6,8,14
050 Mölten,63,,12,8,20
050 Mölten,64,,6,6,12
050 Mölten,65,,5,7,12
050 Mölten,66,,8,7,15
050 Mölten,67,,5,4,9
050 Mölten,68,,9,10,19
050 Mölten,69,,8,4,12
050 Mölten,70,,8,5,13
050 Mölten,71,,3,8,11
050 Mölten,72,,8,1,9
050 Mölten,73,,5,4,9
050 Mölten,74,,1,7,8
050 Mölten,75,,10,8,18
050 Mölten,76,,4,9,13
050 Mölten,77,,8,5,13
050 Mölten,78,,4,8,12
050 Mölten,79,,3,5,8
050 Mölten,80,,4,2,6
050 Mölten,81,,2,5,7
050 Mölten,82,,2,3,5
050 Mölten,83,,7,5,12
050 Mölten,84,,7,4,11
050 Mölten,85,,4,6,10
050 Mölten,86,,3,5,8
050 Mölten,87,,3,-,3
050 Mölten,88,,2,2,4
050 Mölten,89,,1,3,4
050 Mölten,90,,1,2,3
050 Mölten,91,,-,1,1
050 Mölten,92,,-,1,1
050 Mölten,93,,-,2,2
050 Mölten,95,,-,1,1
050 Mölten,96,,1,1,2
050 Mölten,97,,-,1,1
051 Meran,0,,182,197,379
051 Meran,1,,199,170,369
051 Meran,2,,191,184,375
051 Meran,3,,189,199,388
051 Meran,4,,212,195,407
051 Meran,5,,194,181,375
051 Meran,6,,201,187,388
051 Meran,7,,197,218,415
051 Meran,8,,221,204,425
051 Meran,9,,224,195,419
051 Meran,10,,217,184,401
051 Meran,11,,239,210,449
051 Meran,12,,210,227,437
051 Meran,13,,200,199,399
051 Meran,14,,252,194,446
051 Meran,15,,210,171,381
051 Meran,16,,202,186,388
051 Meran,17,,222,196,418
051 Meran,18,,228,179,407
051 Meran,19,,202,203,405
051 Meran,20,,190,188,378
051 Meran,21,,231,189,420
051 Meran,22,,226,188,414
051 Meran,23,,222,184,406
051 Meran,24,,211,226,437
051 Meran,25,,195,199,394
051 Meran,26,,225,197,422
051 Meran,27,,220,232,452
051 Meran,28,,201,207,408
051 Meran,29,,232,216,448
051 Meran,30,,238,202,440
051 Meran,31,,219,239,458
051 Meran,32,,244,204,448
051 Meran,33,,211,260,471
051 Meran,34,,226,233,459
051 Meran,35,,243,243,486
051 Meran,36,,235,268,503
051 Meran,37,,258,258,516
051 Meran,38,,262,248,510
051 Meran,39,,236,250,486
051 Meran,40,,259,259,518
051 Meran,41,,258,286,544
051 Meran,42,,244,298,542
051 Meran,43,,270,298,568
051 Meran,44,,290,337,627
051 Meran,45,,277,326,603
051 Meran,46,,303,317,620
051 Meran,47,,336,304,640
051 Meran,48,,326,357,683
051 Meran,49,,352,347,699
051 Meran,50,,346,349,695
051 Meran,51,,366,357,723
051 Meran,52,,327,332,659
051 Meran,53,,324,345,669
051 Meran,54,,345,329,674
051 Meran,55,,348,308,656
051 Meran,56,,270,290,560
051 Meran,57,,287,317,604
051 Meran,58,,292,276,568
051 Meran,59,,257,253,510
051 Meran,60,,251,258,509
051 Meran,61,,211,260,471
051 Meran,62,,213,230,443
051 Meran,63,,192,232,424
051 Meran,64,,179,241,420
051 Meran,65,,172,247,419
051 Meran,66,,200,221,421
051 Meran,67,,182,226,408
051 Meran,68,,185,234,419
051 Meran,69,,222,254,476
051 Meran,70,,194,260,454
051 Meran,71,,209,268,477
051 Meran,72,,207,289,496
051 Meran,73,,172,200,372
051 Meran,74,,172,211,383
051 Meran,75,,230,236,466
051 Meran,76,,203,278,481
051 Meran,77,,180,263,443
051 Meran,78,,151,206,357
051 Meran,79,,151,213,364
051 Meran,80,,135,204,339
051 Meran,81,,138,188,326
051 Meran,82,,119,168,287
051 Meran,83,,102,159,261
051 Meran,84,,99,141,240
051 Meran,85,,91,121,212
051 Meran,86,,73,124,197
051 Meran,87,,51,111,162
051 Meran,88,,59,95,154
051 Meran,89,,47,75,122
051 Meran,90,,36,90,126
051 Meran,91,,31,63,94
051 Meran,92,,20,59,79
051 Meran,93,,14,49,63
051 Meran,94,,20,55,75
051 Meran,95,,5,32,37
051 Meran,96,,8,27,35
051 Meran,97,,3,28,31
051 Meran,98,,3,18,21
051 Meran,99,,3,6,9
051 Meran,100,,-,2,2
051 Meran,101,,-,1,1
051 Meran,102,,1,1,2
051 Meran,103,,-,1,1
051 Meran,104,,-,2,2
052 Welsberg-Taisten,0,,16,13,29
052 Welsberg-Taisten,1,,10,9,19
052 Welsberg-Taisten,2,,12,8,20
052 Welsberg-Taisten,3,,13,16,29
052 Welsberg-Taisten,4,,22,15,37
052 Welsberg-Taisten,5,,18,10,28
052 Welsberg-Taisten,6,,10,12,22
052 Welsberg-Taisten,7,,14,22,36
052 Welsberg-Taisten,8,,8,17,25
052 Welsberg-Taisten,9,,12,16,28
052 Welsberg-Taisten,10,,21,18,39
052 Welsberg-Taisten,11,,21,23,44
052 Welsberg-Taisten,12,,12,25,37
052 Welsberg-Taisten,13,,22,26,48
052 Welsberg-Taisten,14,,15,19,34
052 Welsberg-Taisten,15,,20,21,41
052 Welsberg-Taisten,16,,23,24,47
052 Welsberg-Taisten,17,,32,20,52
052 Welsberg-Taisten,18,,19,13,32
052 Welsberg-Taisten,19,,20,23,43
052 Welsberg-Taisten,20,,26,12,38
052 Welsberg-Taisten,21,,22,20,42
052 Welsberg-Taisten,22,,16,20,36
052 Welsberg-Taisten,23,,19,17,36
052 Welsberg-Taisten,24,,12,15,27
052 Welsberg-Taisten,25,,17,22,39
052 Welsberg-Taisten,26,,14,15,29
052 Welsberg-Taisten,27,,22,16,38
052 Welsberg-Taisten,28,,9,15,24
052 Welsberg-Taisten,29,,8,22,30
052 Welsberg-Taisten,30,,16,19,35
052 Welsberg-Taisten,31,,12,10,22
052 Welsberg-Taisten,32,,17,13,30
052 Welsberg-Taisten,33,,7,26,33
052 Welsberg-Taisten,34,,26,16,42
052 Welsberg-Taisten,35,,19,17,36
052 Welsberg-Taisten,36,,16,17,33
052 Welsberg-Taisten,37,,12,16,28
052 Welsberg-Taisten,38,,21,13,34
052 Welsberg-Taisten,39,,22,23,45
052 Welsberg-Taisten,40,,17,19,36
052 Welsberg-Taisten,41,,17,26,43
052 Welsberg-Taisten,42,,14,13,27
052 Welsberg-Taisten,43,,14,24,38
052 Welsberg-Taisten,44,,26,25,51
052 Welsberg-Taisten,45,,25,13,38
052 Welsberg-Taisten,46,,16,29,45
052 Welsberg-Taisten,47,,32,23,55
052 Welsberg-Taisten,48,,28,26,54
052 Welsberg-Taisten,49,,19,23,42
052 Welsberg-Taisten,50,,26,24,50
052 Welsberg-Taisten,51,,34,24,58
052 Welsberg-Taisten,52,,30,22,52
052 Welsberg-Taisten,53,,21,15,36
052 Welsberg-Taisten,54,,32,19,51
052 Welsberg-Taisten,55,,26,24,50
052 Welsberg-Taisten,56,,21,23,44
052 Welsberg-Taisten,57,,19,14,33
052 Welsberg-Taisten,58,,10,17,27
052 Welsberg-Taisten,59,,20,20,40
052 Welsberg-Taisten,60,,25,16,41
052 Welsberg-Taisten,61,,15,19,34
052 Welsberg-Taisten,62,,16,19,35
052 Welsberg-Taisten,63,,15,7,22
052 Welsberg-Taisten,64,,15,16,31
052 Welsberg-Taisten,65,,17,14,31
052 Welsberg-Taisten,66,,16,12,28
052 Welsberg-Taisten,67,,15,9,24
052 Welsberg-Taisten,68,,14,11,25
052 Welsberg-Taisten,69,,13,10,23
052 Welsberg-Taisten,70,,16,16,32
052 Welsberg-Taisten,71,,10,12,22
052 Welsberg-Taisten,72,,12,12,24
052 Welsberg-Taisten,73,,9,11,20
052 Welsberg-Taisten,74,,13,11,24
052 Welsberg-Taisten,75,,8,12,20
052 Welsberg-Taisten,76,,9,13,22
052 Welsberg-Taisten,77,,13,16,29
052 Welsberg-Taisten,78,,6,11,17
052 Welsberg-Taisten,79,,12,7,19
052 Welsberg-Taisten,80,,6,8,14
052 Welsberg-Taisten,81,,7,8,15
052 Welsberg-Taisten,82,,3,8,11
052 Welsberg-Taisten,83,,3,11,14
052 Welsberg-Taisten,84,,9,10,19
052 Welsberg-Taisten,85,,7,9,16
052 Welsberg-Taisten,86,,6,8,14
052 Welsberg-Taisten,87,,2,7,9
052 Welsberg-Taisten,88,,3,6,9
052 Welsberg-Taisten,89,,4,7,11
052 Welsberg-Taisten,90,,4,11,15
052 Welsberg-Taisten,91,,1,2,3
052 Welsberg-Taisten,92,,1,4,5
052 Welsberg-Taisten,93,,-,1,1
052 Welsberg-Taisten,94,,-,4,4
052 Welsberg-Taisten,95,,1,2,3
052 Welsberg-Taisten,97,,1,2,3
052 Welsberg-Taisten,98,,-,1,1
053 Montan,0,,10,13,23
053 Montan,1,,15,14,29
053 Montan,2,,9,12,21
053 Montan,3,,6,13,19
053 Montan,4,,13,5,18
053 Montan,5,,9,4,13
053 Montan,6,,9,8,17
053 Montan,7,,11,2,13
053 Montan,8,,15,8,23
053 Montan,9,,9,7,16
053 Montan,10,,12,9,21
053 Montan,11,,8,6,14
053 Montan,12,,8,7,15
053 Montan,13,,8,9,17
053 Montan,14,,7,10,17
053 Montan,15,,8,12,20
053 Montan,16,,6,4,10
053 Montan,17,,13,4,17
053 Montan,18,,10,6,16
053 Montan,19,,8,10,18
053 Montan,20,,9,13,22
053 Montan,21,,7,9,16
053 Montan,22,,14,10,24
053 Montan,23,,16,15,31
053 Montan,24,,14,5,19
053 Montan,25,,4,7,11
053 Montan,26,,6,9,15
053 Montan,27,,12,9,21
053 Montan,28,,9,12,21
053 Montan,29,,14,12,26
053 Montan,30,,10,19,29
053 Montan,31,,13,17,30
053 Montan,32,,16,10,26
053 Montan,33,,8,9,17
053 Montan,34,,10,10,20
053 Montan,35,,16,12,28
053 Montan,36,,9,7,16
053 Montan,37,,13,17,30
053 Montan,38,,8,7,15
053 Montan,39,,11,10,21
053 Montan,40,,11,5,16
053 Montan,41,,9,6,15
053 Montan,42,,8,5,13
053 Montan,43,,9,16,25
053 Montan,44,,10,16,26
053 Montan,45,,12,8,20
053 Montan,46,,10,10,20
053 Montan,47,,11,10,21
053 Montan,48,,14,11,25
053 Montan,49,,12,20,32
053 Montan,50,,12,19,31
053 Montan,51,,11,11,22
053 Montan,52,,13,16,29
053 Montan,53,,28,16,44
053 Montan,54,,14,10,24
053 Montan,55,,11,19,30
053 Montan,56,,15,17,32
053 Montan,57,,17,11,28
053 Montan,58,,14,10,24
053 Montan,59,,15,11,26
053 Montan,60,,7,12,19
053 Montan,61,,10,12,22
053 Montan,62,,9,14,23
053 Montan,63,,7,14,21
053 Montan,64,,9,11,20
053 Montan,65,,11,6,17
053 Montan,66,,11,3,14
053 Montan,67,,6,7,13
053 Montan,68,,4,4,8
053 Montan,69,,8,4,12
053 Montan,70,,5,5,10
053 Montan,71,,7,11,18
053 Montan,72,,5,4,9
053 Montan,73,,5,3,8
053 Montan,74,,2,7,9
053 Montan,75,,5,6,11
053 Montan,76,,4,7,11
053 Montan,77,,4,5,9
053 Montan,78,,6,7,13
053 Montan,79,,3,9,12
053 Montan,80,,4,10,14
053 Montan,81,,1,6,7
053 Montan,82,,4,8,12
053 Montan,83,,1,6,7
053 Montan,84,,2,2,4
053 Montan,85,,10,3,13
053 Montan,86,,4,4,8
053 Montan,87,,3,9,12
053 Montan,88,,6,11,17
053 Montan,89,,4,8,12
053 Montan,90,,1,1,2
053 Montan,91,,1,2,3
053 Montan,92,,2,6,8
053 Montan,93,,-,1,1
053 Montan,94,,-,2,2
053 Montan,95,,-,2,2
053 Montan,96,,-,1,1
054 Moos in Passeier,0,,13,7,20
054 Moos in Passeier,1,,15,11,26
054 Moos in Passeier,2,,16,16,32
054 Moos in Passeier,3,,10,6,16
054 Moos in Passeier,4,,17,18,35
054 Moos in Passeier,5,,14,11,25
054 Moos in Passeier,6,,12,13,25
054 Moos in Passeier,7,,21,8,29
054 Moos in Passeier,8,,8,10,18
054 Moos in Passeier,9,,9,14,23
054 Moos in Passeier,10,,17,11,28
054 Moos in Passeier,11,,17,7,24
054 Moos in Passeier,12,,17,9,26
054 Moos in Passeier,13,,18,14,32
054 Moos in Passeier,14,,17,21,38
054 Moos in Passeier,15,,17,10,27
054 Moos in Passeier,16,,20,19,39
054 Moos in Passeier,17,,12,12,24
054 Moos in Passeier,18,,11,17,28
054 Moos in Passeier,19,,24,9,33
054 Moos in Passeier,20,,16,12,28
054 Moos in Passeier,21,,11,14,25
054 Moos in Passeier,22,,18,17,35
054 Moos in Passeier,23,,7,10,17
054 Moos in Passeier,24,,15,14,29
054 Moos in Passeier,25,,17,15,32
054 Moos in Passeier,26,,16,12,28
054 Moos in Passeier,27,,14,9,23
054 Moos in Passeier,28,,11,15,26
054 Moos in Passeier,29,,12,10,22
054 Moos in Passeier,30,,15,11,26
054 Moos in Passeier,31,,16,10,26
054 Moos in Passeier,32,,10,8,18
054 Moos in Passeier,33,,20,11,31
054 Moos in Passeier,34,,16,16,32
054 Moos in Passeier,35,,9,14,23
054 Moos in Passeier,36,,13,13,26
054 Moos in Passeier,37,,8,13,21
054 Moos in Passeier,38,,7,12,19
054 Moos in Passeier,39,,15,8,23
054 Moos in Passeier,40,,15,13,28
054 Moos in Passeier,41,,18,15,33
054 Moos in Passeier,42,,15,7,22
054 Moos in Passeier,43,,14,12,26
054 Moos in Passeier,44,,23,14,37
054 Moos in Passeier,45,,5,19,24
054 Moos in Passeier,46,,17,14,31
054 Moos in Passeier,47,,18,15,33
054 Moos in Passeier,48,,19,8,27
054 Moos in Passeier,49,,15,17,32
054 Moos in Passeier,50,,16,17,33
054 Moos in Passeier,51,,20,15,35
054 Moos in Passeier,52,,20,16,36
054 Moos in Passeier,53,,17,9,26
054 Moos in Passeier,54,,21,11,32
054 Moos in Passeier,55,,15,19,34
054 Moos in Passeier,56,,9,17,26
054 Moos in Passeier,57,,9,7,16
054 Moos in Passeier,58,,14,14,28
054 Moos in Passeier,59,,14,10,24
054 Moos in Passeier,60,,13,12,25
054 Moos in Passeier,61,,19,5,24
054 Moos in Passeier,62,,8,8,16
054 Moos in Passeier,63,,7,6,13
054 Moos in Passeier,64,,13,9,22
054 Moos in Passeier,65,,5,8,13
054 Moos in Passeier,66,,8,3,11
054 Moos in Passeier,67,,9,10,19
054 Moos in Passeier,68,,5,9,14
054 Moos in Passeier,69,,9,9,18
054 Moos in Passeier,70,,5,6,11
054 Moos in Passeier,71,,15,10,25
054 Moos in Passeier,72,,7,7,14
054 Moos in Passeier,73,,7,5,12
054 Moos in Passeier,74,,8,7,15
054 Moos in Passeier,75,,12,11,23
054 Moos in Passeier,76,,3,11,14
054 Moos in Passeier,77,,7,13,20
054 Moos in Passeier,78,,6,5,11
054 Moos in Passeier,79,,5,4,9
054 Moos in Passeier,80,,8,5,13
054 Moos in Passeier,81,,2,6,8
054 Moos in Passeier,82,,7,5,12
054 Moos in Passeier,83,,7,4,11
054 Moos in Passeier,84,,6,11,17
054 Moos in Passeier,85,,3,7,10
054 Moos in Passeier,86,,5,1,6
054 Moos in Passeier,87,,2,4,6
054 Moos in Passeier,88,,3,2,5
054 Moos in Passeier,89,,3,7,10
054 Moos in Passeier,90,,2,4,6
054 Moos in Passeier,91,,1,1,2
054 Moos in Passeier,92,,1,1,2
054 Moos in Passeier,93,,-,3,3
054 Moos in Passeier,94,,-,2,2
054 Moos in Passeier,95,,1,1,2
054 Moos in Passeier,98,,-,1,1
054 Moos in Passeier,99,,-,1,1
055 Nals,0,,14,8,22
055 Nals,1,,20,8,28
055 Nals,2,,5,10,15
055 Nals,3,,20,13,33
055 Nals,4,,13,8,21
055 Nals,5,,19,11,30
055 Nals,6,,8,8,16
055 Nals,7,,12,14,26
055 Nals,8,,9,15,24
055 Nals,9,,9,12,21
055 Nals,10,,11,5,16
055 Nals,11,,10,10,20
055 Nals,12,,11,3,14
055 Nals,13,,10,12,22
055 Nals,14,,9,9,18
055 Nals,15,,13,7,20
055 Nals,16,,14,14,28
055 Nals,17,,10,9,19
055 Nals,18,,11,16,27
055 Nals,19,,12,11,23
055 Nals,20,,18,13,31
055 Nals,21,,10,8,18
055 Nals,22,,13,11,24
055 Nals,23,,7,9,16
055 Nals,24,,9,10,19
055 Nals,25,,5,12,17
055 Nals,26,,11,9,20
055 Nals,27,,12,7,19
055 Nals,28,,11,12,23
055 Nals,29,,13,14,27
055 Nals,30,,15,15,30
055 Nals,31,,10,10,20
055 Nals,32,,8,9,17
055 Nals,33,,17,15,32
055 Nals,34,,8,8,16
055 Nals,35,,9,10,19
055 Nals,36,,10,16,26
055 Nals,37,,8,16,24
055 Nals,38,,15,11,26
055 Nals,39,,13,12,25
055 Nals,40,,14,13,27
055 Nals,41,,12,16,28
055 Nals,42,,13,16,29
055 Nals,43,,11,14,25
055 Nals,44,,24,19,43
055 Nals,45,,18,12,30
055 Nals,46,,13,18,31
055 Nals,47,,17,19,36
055 Nals,48,,22,14,36
055 Nals,49,,20,19,39
055 Nals,50,,26,18,44
055 Nals,51,,19,17,36
055 Nals,52,,15,17,32
055 Nals,53,,18,20,38
055 Nals,54,,19,24,43
055 Nals,55,,14,21,35
055 Nals,56,,14,14,28
055 Nals,57,,16,14,30
055 Nals,58,,17,14,31
055 Nals,59,,15,19,34
055 Nals,60,,15,14,29
055 Nals,61,,9,6,15
055 Nals,62,,7,9,16
055 Nals,63,,21,13,34
055 Nals,64,,7,6,13
055 Nals,65,,8,8,16
055 Nals,66,,4,6,10
055 Nals,67,,5,8,13
055 Nals,68,,7,9,16
055 Nals,69,,10,7,17
055 Nals,70,,8,12,20
055 Nals,71,,11,6,17
055 Nals,72,,7,13,20
055 Nals,73,,7,12,19
055 Nals,74,,6,10,16
055 Nals,75,,8,6,14
055 Nals,76,,3,9,12
055 Nals,77,,10,5,15
055 Nals,78,,6,11,17
055 Nals,79,,7,10,17
055 Nals,80,,4,8,12
055 Nals,81,,3,12,15
055 Nals,82,,5,4,9
055 Nals,83,,5,5,10
055 Nals,84,,1,6,7
055 Nals,85,,4,9,13
055 Nals,86,,4,2,6
055 Nals,87,,2,5,7
055 Nals,88,,1,4,5
055 Nals,89,,4,3,7
055 Nals,90,,2,3,5
055 Nals,91,,1,3,4
055 Nals,92,,4,1,5
055 Nals,94,,1,-,1
055 Nals,96,,-,1,1
055 Nals,97,,-,1,1
056 Naturns,0,,30,26,56
056 Naturns,1,,41,33,74
056 Naturns,2,,24,41,65
056 Naturns,3,,27,33,60
056 Naturns,4,,32,19,51
056 Naturns,5,,36,31,67
056 Naturns,6,,37,33,70
056 Naturns,7,,36,29,65
056 Naturns,8,,31,21,52
056 Naturns,9,,24,26,50
056 Naturns,10,,37,21,58
056 Naturns,11,,33,38,71
056 Naturns,12,,38,30,68
056 Naturns,13,,31,25,56
056 Naturns,14,,36,32,68
056 Naturns,15,,37,23,60
056 Naturns,16,,29,32,61
056 Naturns,17,,34,28,62
056 Naturns,18,,32,29,61
056 Naturns,19,,29,28,57
056 Naturns,20,,29,34,63
056 Naturns,21,,20,17,37
056 Naturns,22,,36,36,72
056 Naturns,23,,44,40,84
056 Naturns,24,,38,38,76
056 Naturns,25,,39,40,79
056 Naturns,26,,32,39,71
056 Naturns,27,,47,39,86
056 Naturns,28,,40,32,72
056 Naturns,29,,39,34,73
056 Naturns,30,,41,32,73
056 Naturns,31,,35,24,59
056 Naturns,32,,36,46,82
056 Naturns,33,,42,32,74
056 Naturns,34,,36,29,65
056 Naturns,35,,36,37,73
056 Naturns,36,,47,41,88
056 Naturns,37,,38,48,86
056 Naturns,38,,38,48,86
056 Naturns,39,,46,36,82
056 Naturns,40,,40,44,84
056 Naturns,41,,36,45,81
056 Naturns,42,,45,36,81
056 Naturns,43,,45,37,82
056 Naturns,44,,41,45,86
056 Naturns,45,,47,55,102
056 Naturns,46,,53,55,108
056 Naturns,47,,44,50,94
056 Naturns,48,,55,44,99
056 Naturns,49,,45,49,94
056 Naturns,50,,46,40,86
056 Naturns,51,,48,46,94
056 Naturns,52,,53,46,99
056 Naturns,53,,37,56,93
056 Naturns,54,,49,35,84
056 Naturns,55,,41,47,88
056 Naturns,56,,42,43,85
056 Naturns,57,,40,51,91
056 Naturns,58,,55,41,96
056 Naturns,59,,42,40,82
056 Naturns,60,,31,34,65
056 Naturns,61,,33,36,69
056 Naturns,62,,45,44,89
056 Naturns,63,,30,31,61
056 Naturns,64,,38,34,72
056 Naturns,65,,30,24,54
056 Naturns,66,,27,35,62
056 Naturns,67,,32,30,62
056 Naturns,68,,26,31,57
056 Naturns,69,,22,18,40
056 Naturns,70,,24,22,46
056 Naturns,71,,8,23,31
056 Naturns,72,,21,27,48
056 Naturns,73,,23,16,39
056 Naturns,74,,14,19,33
056 Naturns,75,,23,31,54
056 Naturns,76,,26,30,56
056 Naturns,77,,28,28,56
056 Naturns,78,,21,19,40
056 Naturns,79,,17,22,39
056 Naturns,80,,17,14,31
056 Naturns,81,,16,15,31
056 Naturns,82,,14,18,32
056 Naturns,83,,11,8,19
056 Naturns,84,,12,17,29
056 Naturns,85,,12,12,24
056 Naturns,86,,6,11,17
056 Naturns,87,,7,10,17
056 Naturns,88,,10,15,25
056 Naturns,89,,4,11,15
056 Naturns,90,,6,3,9
056 Naturns,91,,-,5,5
056 Naturns,92,,5,3,8
056 Naturns,93,,3,2,5
056 Naturns,94,,3,3,6
056 Naturns,95,,-,2,2
056 Naturns,96,,-,1,1
056 Naturns,97,,-,1,1
057 Natz-Schabs,0,,25,30,55
057 Natz-Schabs,1,,21,22,43
057 Natz-Schabs,2,,25,27,52
057 Natz-Schabs,3,,21,24,45
057 Natz-Schabs,4,,31,22,53
057 Natz-Schabs,5,,19,23,42
057 Natz-Schabs,6,,13,27,40
057 Natz-Schabs,7,,26,14,40
057 Natz-Schabs,8,,15,10,25
057 Natz-Schabs,9,,12,22,34
057 Natz-Schabs,10,,17,23,40
057 Natz-Schabs,11,,15,14,29
057 Natz-Schabs,12,,15,17,32
057 Natz-Schabs,13,,14,15,29
057 Natz-Schabs,14,,14,16,30
057 Natz-Schabs,15,,16,17,33
057 Natz-Schabs,16,,23,19,42
057 Natz-Schabs,17,,17,14,31
057 Natz-Schabs,18,,23,18,41
057 Natz-Schabs,19,,14,20,34
057 Natz-Schabs,20,,22,19,41
057 Natz-Schabs,21,,22,19,41
057 Natz-Schabs,22,,21,20,41
057 Natz-Schabs,23,,19,18,37
057 Natz-Schabs,24,,20,17,37
057 Natz-Schabs,25,,17,20,37
057 Natz-Schabs,26,,16,19,35
057 Natz-Schabs,27,,27,22,49
057 Natz-Schabs,28,,15,20,35
057 Natz-Schabs,29,,18,33,51
057 Natz-Schabs,30,,26,17,43
057 Natz-Schabs,31,,21,23,44
057 Natz-Schabs,32,,20,21,41
057 Natz-Schabs,33,,20,24,44
057 Natz-Schabs,34,,27,17,44
057 Natz-Schabs,35,,14,34,48
057 Natz-Schabs,36,,15,27,42
057 Natz-Schabs,37,,23,16,39
057 Natz-Schabs,38,,26,20,46
057 Natz-Schabs,39,,20,19,39
057 Natz-Schabs,40,,21,30,51
057 Natz-Schabs,41,,25,19,44
057 Natz-Schabs,42,,14,23,37
057 Natz-Schabs,43,,25,29,54
057 Natz-Schabs,44,,29,28,57
057 Natz-Schabs,45,,31,17,48
057 Natz-Schabs,46,,21,28,49
057 Natz-Schabs,47,,24,23,47
057 Natz-Schabs,48,,32,25,57
057 Natz-Schabs,49,,30,24,54
057 Natz-Schabs,50,,28,22,50
057 Natz-Schabs,51,,28,20,48
057 Natz-Schabs,52,,32,23,55
057 Natz-Schabs,53,,35,35,70
057 Natz-Schabs,54,,32,28,60
057 Natz-Schabs,55,,22,33,55
057 Natz-Schabs,56,,19,23,42
057 Natz-Schabs,57,,16,21,37
057 Natz-Schabs,58,,29,23,52
057 Natz-Schabs,59,,23,20,43
057 Natz-Schabs,60,,29,19,48
057 Natz-Schabs,61,,22,22,44
057 Natz-Schabs,62,,18,22,40
057 Natz-Schabs,63,,21,18,39
057 Natz-Schabs,64,,10,17,27
057 Natz-Schabs,65,,22,14,36
057 Natz-Schabs,66,,12,10,22
057 Natz-Schabs,67,,16,12,28
057 Natz-Schabs,68,,13,12,25
057 Natz-Schabs,69,,18,14,32
057 Natz-Schabs,70,,15,12,27
057 Natz-Schabs,71,,11,16,27
057 Natz-Schabs,72,,14,13,27
057 Natz-Schabs,73,,9,7,16
057 Natz-Schabs,74,,13,10,23
057 Natz-Schabs,75,,11,6,17
057 Natz-Schabs,76,,10,7,17
057 Natz-Schabs,77,,12,8,20
057 Natz-Schabs,78,,2,6,8
057 Natz-Schabs,79,,1,5,6
057 Natz-Schabs,80,,3,5,8
057 Natz-Schabs,81,,6,5,11
057 Natz-Schabs,82,,5,4,9
057 Natz-Schabs,83,,3,5,8
057 Natz-Schabs,84,,2,4,6
057 Natz-Schabs,85,,4,6,10
057 Natz-Schabs,86,,1,5,6
057 Natz-Schabs,87,,2,4,6
057 Natz-Schabs,88,,3,5,8
057 Natz-Schabs,89,,3,2,5
057 Natz-Schabs,90,,1,2,3
057 Natz-Schabs,91,,-,2,2
057 Natz-Schabs,92,,-,1,1
057 Natz-Schabs,93,,1,-,1
057 Natz-Schabs,94,,-,2,2
057 Natz-Schabs,95,,-,1,1
057 Natz-Schabs,96,,1,-,1
057 Natz-Schabs,97,,-,1,1
058 Welschnofen,0,,12,11,23
058 Welschnofen,1,,9,15,24
058 Welschnofen,2,,6,15,21
058 Welschnofen,3,,6,10,16
058 Welschnofen,4,,11,8,19
058 Welschnofen,5,,9,6,15
058 Welschnofen,6,,10,10,20
058 Welschnofen,7,,12,6,18
058 Welschnofen,8,,4,9,13
058 Welschnofen,9,,9,3,12
058 Welschnofen,10,,9,8,17
058 Welschnofen,11,,9,6,15
058 Welschnofen,12,,8,8,16
058 Welschnofen,13,,9,10,19
058 Welschnofen,14,,13,8,21
058 Welschnofen,15,,10,8,18
058 Welschnofen,16,,17,6,23
058 Welschnofen,17,,7,9,16
058 Welschnofen,18,,9,8,17
058 Welschnofen,19,,10,13,23
058 Welschnofen,20,,14,9,23
058 Welschnofen,21,,14,12,26
058 Welschnofen,22,,9,9,18
058 Welschnofen,23,,15,14,29
058 Welschnofen,24,,15,10,25
058 Welschnofen,25,,12,10,22
058 Welschnofen,26,,16,12,28
058 Welschnofen,27,,17,13,30
058 Welschnofen,28,,15,12,27
058 Welschnofen,29,,16,8,24
058 Welschnofen,30,,13,12,25
058 Welschnofen,31,,12,20,32
058 Welschnofen,32,,9,11,20
058 Welschnofen,33,,15,11,26
058 Welschnofen,34,,8,7,15
058 Welschnofen,35,,13,13,26
058 Welschnofen,36,,13,11,24
058 Welschnofen,37,,14,15,29
058 Welschnofen,38,,13,13,26
058 Welschnofen,39,,9,10,19
058 Welschnofen,40,,12,14,26
058 Welschnofen,41,,12,14,26
058 Welschnofen,42,,14,7,21
058 Welschnofen,43,,21,14,35
058 Welschnofen,44,,12,15,27
058 Welschnofen,45,,17,17,34
058 Welschnofen,46,,11,13,24
058 Welschnofen,47,,17,21,38
058 Welschnofen,48,,21,16,37
058 Welschnofen,49,,12,14,26
058 Welschnofen,50,,24,18,42
058 Welschnofen,51,,15,16,31
058 Welschnofen,52,,13,17,30
058 Welschnofen,53,,24,13,37
058 Welschnofen,54,,16,9,25
058 Welschnofen,55,,18,15,33
058 Welschnofen,56,,15,11,26
058 Welschnofen,57,,14,15,29
058 Welschnofen,58,,19,11,30
058 Welschnofen,59,,13,14,27
058 Welschnofen,60,,17,10,27
058 Welschnofen,61,,11,13,24
058 Welschnofen,62,,11,13,24
058 Welschnofen,63,,14,15,29
058 Welschnofen,64,,13,11,24
058 Welschnofen,65,,11,12,23
058 Welschnofen,66,,11,11,22
058 Welschnofen,67,,12,6,18
058 Welschnofen,68,,7,8,15
058 Welschnofen,69,,8,12,20
058 Welschnofen,70,,8,11,19
058 Welschnofen,71,,8,5,13
058 Welschnofen,72,,10,10,20
058 Welschnofen,73,,11,4,15
058 Welschnofen,74,,5,9,14
058 Welschnofen,75,,13,8,21
058 Welschnofen,76,,10,11,21
058 Welschnofen,77,,8,6,14
058 Welschnofen,78,,4,5,9
058 Welschnofen,79,,10,6,16
058 Welschnofen,80,,6,7,13
058 Welschnofen,81,,7,2,9
058 Welschnofen,82,,3,9,12
058 Welschnofen,83,,5,6,11
058 Welschnofen,84,,8,9,17
058 Welschnofen,85,,5,10,15
058 Welschnofen,86,,6,5,11
058 Welschnofen,87,,2,4,6
058 Welschnofen,88,,1,5,6
058 Welschnofen,89,,1,6,7
058 Welschnofen,90,,5,1,6
058 Welschnofen,91,,-,1,1
058 Welschnofen,92,,1,2,3
058 Welschnofen,93,,1,1,2
058 Welschnofen,94,,-,2,2
058 Welschnofen,95,,1,-,1
058 Welschnofen,96,,1,-,1
058 Welschnofen,97,,-,3,3
058 Welschnofen,98,,-,2,2
059 Deutschnofen,0,,34,13,47
059 Deutschnofen,1,,29,22,51
059 Deutschnofen,2,,27,19,46
059 Deutschnofen,3,,20,16,36
059 Deutschnofen,4,,21,12,33
059 Deutschnofen,5,,27,10,37
059 Deutschnofen,6,,20,19,39
059 Deutschnofen,7,,14,17,31
059 Deutschnofen,8,,22,18,40
059 Deutschnofen,9,,26,18,44
059 Deutschnofen,10,,20,19,39
059 Deutschnofen,11,,17,17,34
059 Deutschnofen,12,,22,27,49
059 Deutschnofen,13,,26,33,59
059 Deutschnofen,14,,18,30,48
059 Deutschnofen,15,,17,33,50
059 Deutschnofen,16,,32,13,45
059 Deutschnofen,17,,24,31,55
059 Deutschnofen,18,,20,26,46
059 Deutschnofen,19,,29,25,54
059 Deutschnofen,20,,34,13,47
059 Deutschnofen,21,,21,32,53
059 Deutschnofen,22,,21,31,52
059 Deutschnofen,23,,28,26,54
059 Deutschnofen,24,,26,15,41
059 Deutschnofen,25,,26,28,54
059 Deutschnofen,26,,36,29,65
059 Deutschnofen,27,,27,19,46
059 Deutschnofen,28,,28,26,54
059 Deutschnofen,29,,24,22,46
059 Deutschnofen,30,,21,27,48
059 Deutschnofen,31,,19,17,36
059 Deutschnofen,32,,25,22,47
059 Deutschnofen,33,,26,28,54
059 Deutschnofen,34,,30,23,53
059 Deutschnofen,35,,23,22,45
059 Deutschnofen,36,,21,31,52
059 Deutschnofen,37,,20,17,37
059 Deutschnofen,38,,22,31,53
059 Deutschnofen,39,,22,23,45
059 Deutschnofen,40,,22,16,38
059 Deutschnofen,41,,30,21,51
059 Deutschnofen,42,,24,29,53
059 Deutschnofen,43,,21,21,42
059 Deutschnofen,44,,28,33,61
059 Deutschnofen,45,,26,27,53
059 Deutschnofen,46,,31,34,65
059 Deutschnofen,47,,30,26,56
059 Deutschnofen,48,,31,31,62
059 Deutschnofen,49,,37,28,65
059 Deutschnofen,50,,27,32,59
059 Deutschnofen,51,,24,30,54
059 Deutschnofen,52,,38,38,76
059 Deutschnofen,53,,32,22,54
059 Deutschnofen,54,,30,31,61
059 Deutschnofen,55,,37,26,63
059 Deutschnofen,56,,25,30,55
059 Deutschnofen,57,,33,24,57
059 Deutschnofen,58,,41,29,70
059 Deutschnofen,59,,27,18,45
059 Deutschnofen,60,,19,27,46
059 Deutschnofen,61,,20,25,45
059 Deutschnofen,62,,28,25,53
059 Deutschnofen,63,,32,22,54
059 Deutschnofen,64,,28,22,50
059 Deutschnofen,65,,23,16,39
059 Deutschnofen,66,,21,22,43
059 Deutschnofen,67,,19,15,34
059 Deutschnofen,68,,16,17,33
059 Deutschnofen,69,,16,17,33
059 Deutschnofen,70,,23,15,38
059 Deutschnofen,71,,9,13,22
059 Deutschnofen,72,,16,21,37
059 Deutschnofen,73,,13,14,27
059 Deutschnofen,74,,16,15,31
059 Deutschnofen,75,,17,22,39
059 Deutschnofen,76,,15,17,32
059 Deutschnofen,77,,16,18,34
059 Deutschnofen,78,,12,16,28
059 Deutschnofen,79,,15,13,28
059 Deutschnofen,80,,14,18,32
059 Deutschnofen,81,,10,4,14
059 Deutschnofen,82,,8,8,16
059 Deutschnofen,83,,3,8,11
059 Deutschnofen,84,,9,5,14
059 Deutschnofen,85,,3,10,13
059 Deutschnofen,86,,8,10,18
059 Deutschnofen,87,,4,4,8
059 Deutschnofen,88,,4,8,12
059 Deutschnofen,89,,3,1,4
059 Deutschnofen,90,,4,10,14
059 Deutschnofen,91,,4,7,11
059 Deutschnofen,92,,2,4,6
059 Deutschnofen,93,,1,7,8
059 Deutschnofen,94,,-,3,3
059 Deutschnofen,95,,-,3,3
059 Deutschnofen,96,,-,1,1
059 Deutschnofen,97,,-,1,1
059 Deutschnofen,98,,-,1,1
060 Auer,0,,21,21,42
060 Auer,1,,18,17,35
060 Auer,2,,21,18,39
060 Auer,3,,21,19,40
060 Auer,4,,23,31,54
060 Auer,5,,24,14,38
060 Auer,6,,21,12,33
060 Auer,7,,22,25,47
060 Auer,8,,27,14,41
060 Auer,9,,16,32,48
060 Auer,10,,12,24,36
060 Auer,11,,24,15,39
060 Auer,12,,18,17,35
060 Auer,13,,25,20,45
060 Auer,14,,21,22,43
060 Auer,15,,24,14,38
060 Auer,16,,30,18,48
060 Auer,17,,15,25,40
060 Auer,18,,22,19,41
060 Auer,19,,19,26,45
060 Auer,20,,21,25,46
060 Auer,21,,27,19,46
060 Auer,22,,19,23,42
060 Auer,23,,23,19,42
060 Auer,24,,24,28,52
060 Auer,25,,13,25,38
060 Auer,26,,24,21,45
060 Auer,27,,28,21,49
060 Auer,28,,22,20,42
060 Auer,29,,20,21,41
060 Auer,30,,22,39,61
060 Auer,31,,25,24,49
060 Auer,32,,23,20,43
060 Auer,33,,24,36,60
060 Auer,34,,25,22,47
060 Auer,35,,17,18,35
060 Auer,36,,26,26,52
060 Auer,37,,27,19,46
060 Auer,38,,21,17,38
060 Auer,39,,28,29,57
060 Auer,40,,24,22,46
060 Auer,41,,22,34,56
060 Auer,42,,23,30,53
060 Auer,43,,17,20,37
060 Auer,44,,30,31,61
060 Auer,45,,27,28,55
060 Auer,46,,16,26,42
060 Auer,47,,43,29,72
060 Auer,48,,27,27,54
060 Auer,49,,24,30,54
060 Auer,50,,34,40,74
060 Auer,51,,28,23,51
060 Auer,52,,35,41,76
060 Auer,53,,31,28,59
060 Auer,54,,30,26,56
060 Auer,55,,30,40,70
060 Auer,56,,26,22,48
060 Auer,57,,34,32,66
060 Auer,58,,25,29,54
060 Auer,59,,34,29,63
060 Auer,60,,35,25,60
060 Auer,61,,20,25,45
060 Auer,62,,30,30,60
060 Auer,63,,14,22,36
060 Auer,64,,20,15,35
060 Auer,65,,16,21,37
060 Auer,66,,18,23,41
060 Auer,67,,15,19,34
060 Auer,68,,13,19,32
060 Auer,69,,15,14,29
060 Auer,70,,25,15,40
060 Auer,71,,16,15,31
060 Auer,72,,16,25,41
060 Auer,73,,9,13,22
060 Auer,74,,22,14,36
060 Auer,75,,10,17,27
060 Auer,76,,15,18,33
060 Auer,77,,17,13,30
060 Auer,78,,10,9,19
060 Auer,79,,9,20,29
060 Auer,80,,12,14,26
060 Auer,81,,7,10,17
060 Auer,82,,9,8,17
060 Auer,83,,7,14,21
060 Auer,84,,8,10,18
060 Auer,85,,2,11,13
060 Auer,86,,1,9,10
060 Auer,87,,2,6,8
060 Auer,88,,3,5,8
060 Auer,89,,3,10,13
060 Auer,90,,3,5,8
060 Auer,91,,-,5,5
060 Auer,92,,-,12,12
060 Auer,93,,3,4,7
060 Auer,94,,2,4,6
060 Auer,95,,2,4,6
060 Auer,96,,1,4,5
060 Auer,98,,1,1,2
061 St.Ulrich,0,,25,18,43
061 St.Ulrich,1,,26,25,51
061 St.Ulrich,2,,27,20,47
061 St.Ulrich,3,,28,17,45
061 St.Ulrich,4,,31,24,55
061 St.Ulrich,5,,20,19,39
061 St.Ulrich,6,,21,14,35
061 St.Ulrich,7,,31,31,62
061 St.Ulrich,8,,23,21,44
061 St.Ulrich,9,,24,25,49
061 St.Ulrich,10,,36,25,61
061 St.Ulrich,11,,30,35,65
061 St.Ulrich,12,,36,27,63
061 St.Ulrich,13,,33,22,55
061 St.Ulrich,14,,23,32,55
061 St.Ulrich,15,,24,26,50
061 St.Ulrich,16,,25,41,66
061 St.Ulrich,17,,20,22,42
061 St.Ulrich,18,,29,36,65
061 St.Ulrich,19,,44,30,74
061 St.Ulrich,20,,47,37,84
061 St.Ulrich,21,,40,32,72
061 St.Ulrich,22,,31,25,56
061 St.Ulrich,23,,30,32,62
061 St.Ulrich,24,,28,33,61
061 St.Ulrich,25,,26,39,65
061 St.Ulrich,26,,39,31,70
061 St.Ulrich,27,,33,34,67
061 St.Ulrich,28,,32,32,64
061 St.Ulrich,29,,22,19,41
061 St.Ulrich,30,,21,29,50
061 St.Ulrich,31,,32,22,54
061 St.Ulrich,32,,26,21,47
061 St.Ulrich,33,,18,20,38
061 St.Ulrich,34,,25,19,44
061 St.Ulrich,35,,22,29,51
061 St.Ulrich,36,,31,32,63
061 St.Ulrich,37,,27,34,61
061 St.Ulrich,38,,22,36,58
061 St.Ulrich,39,,25,38,63
061 St.Ulrich,40,,22,31,53
061 St.Ulrich,41,,26,22,48
061 St.Ulrich,42,,33,32,65
061 St.Ulrich,43,,37,25,62
061 St.Ulrich,44,,37,35,72
061 St.Ulrich,45,,35,34,69
061 St.Ulrich,46,,42,32,74
061 St.Ulrich,47,,38,40,78
061 St.Ulrich,48,,40,38,78
061 St.Ulrich,49,,40,45,85
061 St.Ulrich,50,,38,43,81
061 St.Ulrich,51,,42,39,81
061 St.Ulrich,52,,36,40,76
061 St.Ulrich,53,,39,29,68
061 St.Ulrich,54,,32,41,73
061 St.Ulrich,55,,38,37,75
061 St.Ulrich,56,,33,37,70
061 St.Ulrich,57,,25,28,53
061 St.Ulrich,58,,32,25,57
061 St.Ulrich,59,,38,24,62
061 St.Ulrich,60,,21,16,37
061 St.Ulrich,61,,23,31,54
061 St.Ulrich,62,,17,28,45
061 St.Ulrich,63,,23,35,58
061 St.Ulrich,64,,28,35,63
061 St.Ulrich,65,,27,18,45
061 St.Ulrich,66,,13,27,40
061 St.Ulrich,67,,25,25,50
061 St.Ulrich,68,,17,24,41
061 St.Ulrich,69,,15,27,42
061 St.Ulrich,70,,28,28,56
061 St.Ulrich,71,,17,21,38
061 St.Ulrich,72,,27,23,50
061 St.Ulrich,73,,15,16,31
061 St.Ulrich,74,,20,32,52
061 St.Ulrich,75,,33,35,68
061 St.Ulrich,76,,22,31,53
061 St.Ulrich,77,,29,38,67
061 St.Ulrich,78,,24,26,50
061 St.Ulrich,79,,17,15,32
061 St.Ulrich,80,,21,22,43
061 St.Ulrich,81,,20,21,41
061 St.Ulrich,82,,16,13,29
061 St.Ulrich,83,,9,19,28
061 St.Ulrich,84,,8,6,14
061 St.Ulrich,85,,7,11,18
061 St.Ulrich,86,,9,18,27
061 St.Ulrich,87,,9,11,20
061 St.Ulrich,88,,8,3,11
061 St.Ulrich,89,,6,3,9
061 St.Ulrich,90,,4,8,12
061 St.Ulrich,91,,4,4,8
061 St.Ulrich,92,,-,4,4
061 St.Ulrich,93,,1,1,2
061 St.Ulrich,94,,1,1,2
061 St.Ulrich,95,,-,3,3
061 St.Ulrich,96,,1,2,3
061 St.Ulrich,97,,1,2,3
061 St.Ulrich,98,,-,2,2
061 St.Ulrich,99,,-,1,1
061 St.Ulrich,100,,-,1,1
062 Partschins,0,,20,17,37
062 Partschins,1,,19,16,35
062 Partschins,2,,17,29,46
062 Partschins,3,,25,18,43
062 Partschins,4,,24,19,43
062 Partschins,5,,18,21,39
062 Partschins,6,,28,16,44
062 Partschins,7,,19,17,36
062 Partschins,8,,24,20,44
062 Partschins,9,,18,16,34
062 Partschins,10,,23,14,37
062 Partschins,11,,16,20,36
062 Partschins,12,,19,19,38
062 Partschins,13,,17,25,42
062 Partschins,14,,16,24,40
062 Partschins,15,,28,17,45
062 Partschins,16,,26,16,42
062 Partschins,17,,16,14,30
062 Partschins,18,,22,17,39
062 Partschins,19,,19,21,40
062 Partschins,20,,20,11,31
062 Partschins,21,,27,21,48
062 Partschins,22,,15,22,37
062 Partschins,23,,25,16,41
062 Partschins,24,,22,26,48
062 Partschins,25,,28,21,49
062 Partschins,26,,23,13,36
062 Partschins,27,,25,32,57
062 Partschins,28,,24,22,46
062 Partschins,29,,15,30,45
062 Partschins,30,,23,32,55
062 Partschins,31,,16,18,34
062 Partschins,32,,23,21,44
062 Partschins,33,,15,15,30
062 Partschins,34,,22,23,45
062 Partschins,35,,18,26,44
062 Partschins,36,,14,25,39
062 Partschins,37,,22,35,57
062 Partschins,38,,31,28,59
062 Partschins,39,,27,24,51
062 Partschins,40,,23,15,38
062 Partschins,41,,28,23,51
062 Partschins,42,,21,19,40
062 Partschins,43,,31,21,52
062 Partschins,44,,23,23,46
062 Partschins,45,,32,26,58
062 Partschins,46,,30,27,57
062 Partschins,47,,28,35,63
062 Partschins,48,,28,37,65
062 Partschins,49,,39,24,63
062 Partschins,50,,25,32,57
062 Partschins,51,,36,27,63
062 Partschins,52,,37,44,81
062 Partschins,53,,33,28,61
062 Partschins,54,,30,41,71
062 Partschins,55,,31,23,54
062 Partschins,56,,33,27,60
062 Partschins,57,,21,25,46
062 Partschins,58,,25,42,67
062 Partschins,59,,29,25,54
062 Partschins,60,,22,19,41
062 Partschins,61,,23,25,48
062 Partschins,62,,22,17,39
062 Partschins,63,,26,22,48
062 Partschins,64,,13,31,44
062 Partschins,65,,20,16,36
062 Partschins,66,,17,16,33
062 Partschins,67,,19,18,37
062 Partschins,68,,18,19,37
062 Partschins,69,,11,10,21
062 Partschins,70,,18,18,36
062 Partschins,71,,13,19,32
062 Partschins,72,,25,26,51
062 Partschins,73,,13,15,28
062 Partschins,74,,15,15,30
062 Partschins,75,,17,23,40
062 Partschins,76,,14,16,30
062 Partschins,77,,19,28,47
062 Partschins,78,,12,14,26
062 Partschins,79,,8,13,21
062 Partschins,80,,13,10,23
062 Partschins,81,,11,13,24
062 Partschins,82,,11,17,28
062 Partschins,83,,6,7,13
062 Partschins,84,,6,15,21
062 Partschins,85,,5,13,18
062 Partschins,86,,10,9,19
062 Partschins,87,,7,11,18
062 Partschins,88,,4,3,7
062 Partschins,89,,4,4,8
062 Partschins,90,,4,5,9
062 Partschins,91,,4,8,12
062 Partschins,92,,2,5,7
062 Partschins,93,,2,4,6
062 Partschins,94,,-,4,4
062 Partschins,95,,2,2,4
062 Partschins,96,,1,2,3
062 Partschins,97,,-,2,2
062 Partschins,99,,-,1,1
063 Percha,0,,10,9,19
063 Percha,1,,6,12,18
063 Percha,2,,11,7,18
063 Percha,3,,12,5,17
063 Percha,4,,13,10,23
063 Percha,5,,12,16,28
063 Percha,6,,8,6,14
063 Percha,7,,8,8,16
063 Percha,8,,4,10,14
063 Percha,9,,10,8,18
063 Percha,10,,8,5,13
063 Percha,11,,9,5,14
063 Percha,12,,5,5,10
063 Percha,13,,5,10,15
063 Percha,14,,10,17,27
063 Percha,15,,9,8,17
063 Percha,16,,10,7,17
063 Percha,17,,4,5,9
063 Percha,18,,13,10,23
063 Percha,19,,6,8,14
063 Percha,20,,8,10,18
063 Percha,21,,14,16,30
063 Percha,22,,9,6,15
063 Percha,23,,9,8,17
063 Percha,24,,11,11,22
063 Percha,25,,6,11,17
063 Percha,26,,13,9,22
063 Percha,27,,11,10,21
063 Percha,28,,5,9,14
063 Percha,29,,9,10,19
063 Percha,30,,5,5,10
063 Percha,31,,12,18,30
063 Percha,32,,7,7,14
063 Percha,33,,8,9,17
063 Percha,34,,9,7,16
063 Percha,35,,11,10,21
063 Percha,36,,10,17,27
063 Percha,37,,13,12,25
063 Percha,38,,10,6,16
063 Percha,39,,5,12,17
063 Percha,40,,12,14,26
063 Percha,41,,11,4,15
063 Percha,42,,14,20,34
063 Percha,43,,7,13,20
063 Percha,44,,9,12,21
063 Percha,45,,15,12,27
063 Percha,46,,15,9,24
063 Percha,47,,20,17,37
063 Percha,48,,7,10,17
063 Percha,49,,22,15,37
063 Percha,50,,17,16,33
063 Percha,51,,9,11,20
063 Percha,52,,20,6,26
063 Percha,53,,15,18,33
063 Percha,54,,16,6,22
063 Percha,55,,12,14,26
063 Percha,56,,19,9,28
063 Percha,57,,8,13,21
063 Percha,58,,12,8,20
063 Percha,59,,6,12,18
063 Percha,60,,9,8,17
063 Percha,61,,8,6,14
063 Percha,62,,6,13,19
063 Percha,63,,9,9,18
063 Percha,64,,5,6,11
063 Percha,65,,7,7,14
063 Percha,66,,4,10,14
063 Percha,67,,6,6,12
063 Percha,68,,6,7,13
063 Percha,69,,10,5,15
063 Percha,70,,5,5,10
063 Percha,71,,6,5,11
063 Percha,72,,7,8,15
063 Percha,73,,5,5,10
063 Percha,74,,12,5,17
063 Percha,75,,5,8,13
063 Percha,76,,7,5,12
063 Percha,77,,6,7,13
063 Percha,78,,4,6,10
063 Percha,79,,6,4,10
063 Percha,80,,5,7,12
063 Percha,81,,2,4,6
063 Percha,82,,2,1,3
063 Percha,83,,4,4,8
063 Percha,84,,3,3,6
063 Percha,85,,-,4,4
063 Percha,86,,2,3,5
063 Percha,87,,1,-,1
063 Percha,88,,2,2,4
063 Percha,89,,-,2,2
063 Percha,90,,-,1,1
063 Percha,91,,1,1,2
063 Percha,92,,1,3,4
063 Percha,93,,1,1,2
063 Percha,95,,-,1,1
064 Plaus,0,,3,3,6
064 Plaus,1,,2,6,8
064 Plaus,2,,4,7,11
064 Plaus,3,,3,4,7
064 Plaus,4,,1,3,4
064 Plaus,5,,4,4,8
064 Plaus,6,,2,4,6
064 Plaus,7,,5,1,6
064 Plaus,8,,5,6,11
064 Plaus,9,,4,2,6
064 Plaus,10,,4,4,8
064 Plaus,11,,5,2,7
064 Plaus,12,,4,2,6
064 Plaus,13,,4,1,5
064 Plaus,14,,6,4,10
064 Plaus,15,,3,4,7
064 Plaus,16,,3,5,8
064 Plaus,17,,8,4,12
064 Plaus,18,,11,5,16
064 Plaus,19,,13,5,18
064 Plaus,20,,6,7,13
064 Plaus,21,,8,4,12
064 Plaus,22,,3,3,6
064 Plaus,23,,3,2,5
064 Plaus,24,,5,2,7
064 Plaus,25,,10,5,15
064 Plaus,26,,6,9,15
064 Plaus,27,,4,9,13
064 Plaus,28,,6,2,8
064 Plaus,29,,8,5,13
064 Plaus,30,,3,3,6
064 Plaus,31,,6,4,10
064 Plaus,32,,1,4,5
064 Plaus,33,,6,4,10
064 Plaus,34,,3,5,8
064 Plaus,35,,1,2,3
064 Plaus,36,,-,5,5
064 Plaus,37,,6,6,12
064 Plaus,38,,3,3,6
064 Plaus,39,,4,7,11
064 Plaus,40,,4,3,7
064 Plaus,41,,3,9,12
064 Plaus,42,,5,4,9
064 Plaus,43,,13,4,17
064 Plaus,44,,8,11,19
064 Plaus,45,,11,6,17
064 Plaus,46,,9,5,14
064 Plaus,47,,6,8,14
064 Plaus,48,,8,3,11
064 Plaus,49,,6,10,16
064 Plaus,50,,4,8,12
064 Plaus,51,,7,9,16
064 Plaus,52,,4,5,9
064 Plaus,53,,10,4,14
064 Plaus,54,,8,9,17
064 Plaus,55,,2,4,6
064 Plaus,56,,7,5,12
064 Plaus,57,,6,5,11
064 Plaus,58,,3,7,10
064 Plaus,59,,6,-,6
064 Plaus,60,,4,3,7
064 Plaus,61,,4,1,5
064 Plaus,62,,2,3,5
064 Plaus,63,,1,5,6
064 Plaus,64,,1,3,4
064 Plaus,65,,2,6,8
064 Plaus,66,,4,2,6
064 Plaus,67,,4,3,7
064 Plaus,68,,2,1,3
064 Plaus,69,,4,3,7
064 Plaus,70,,-,3,3
064 Plaus,71,,1,3,4
064 Plaus,72,,5,1,6
064 Plaus,73,,3,1,4
064 Plaus,74,,-,2,2
064 Plaus,75,,5,1,6
064 Plaus,76,,-,5,5
064 Plaus,77,,3,2,5
064 Plaus,78,,3,1,4
064 Plaus,79,,2,2,4
064 Plaus,81,,-,3,3
064 Plaus,83,,1,3,4
064 Plaus,84,,3,1,4
064 Plaus,85,,2,2,4
064 Plaus,86,,2,3,5
064 Plaus,91,,1,1,2
064 Plaus,99,,-,1,1
065 Waidbruck,0,,-,2,2
065 Waidbruck,1,,1,1,2
065 Waidbruck,2,,1,-,1
065 Waidbruck,3,,1,1,2
065 Waidbruck,4,,1,-,1
065 Waidbruck,5,,1,-,1
065 Waidbruck,6,,1,1,2
065 Waidbruck,7,,1,-,1
065 Waidbruck,8,,-,1,1
065 Waidbruck,9,,2,2,4
065 Waidbruck,10,,2,-,2
065 Waidbruck,11,,2,-,2
065 Waidbruck,12,,2,-,2
065 Waidbruck,14,,1,1,2
065 Waidbruck,15,,-,2,2
065 Waidbruck,16,,1,1,2
065 Waidbruck,17,,1,2,3
065 Waidbruck,18,,1,1,2
065 Waidbruck,19,,2,1,3
065 Waidbruck,20,,1,-,1
065 Waidbruck,21,,4,3,7
065 Waidbruck,22,,2,1,3
065 Waidbruck,23,,2,2,4
065 Waidbruck,24,,4,1,5
065 Waidbruck,25,,-,3,3
065 Waidbruck,26,,-,1,1
065 Waidbruck,27,,2,1,3
065 Waidbruck,28,,1,1,2
065 Waidbruck,29,,3,1,4
065 Waidbruck,30,,2,1,3
065 Waidbruck,31,,1,-,1
065 Waidbruck,32,,1,1,2
065 Waidbruck,33,,2,-,2
065 Waidbruck,34,,2,-,2
065 Waidbruck,37,,2,-,2
065 Waidbruck,38,,1,1,2
065 Waidbruck,39,,1,-,1
065 Waidbruck,40,,5,-,5
065 Waidbruck,41,,-,1,1
065 Waidbruck,42,,-,1,1
065 Waidbruck,43,,3,2,5
065 Waidbruck,44,,4,2,6
065 Waidbruck,45,,2,1,3
065 Waidbruck,46,,-,2,2
065 Waidbruck,47,,2,-,2
065 Waidbruck,48,,2,1,3
065 Waidbruck,49,,3,3,6
065 Waidbruck,50,,2,2,4
065 Waidbruck,51,,3,4,7
065 Waidbruck,52,,3,2,5
065 Waidbruck,53,,2,2,4
065 Waidbruck,54,,2,-,2
065 Waidbruck,55,,-,1,1
065 Waidbruck,56,,2,-,2
065 Waidbruck,57,,1,2,3
065 Waidbruck,58,,3,-,3
065 Waidbruck,59,,2,1,3
065 Waidbruck,60,,-,1,1
065 Waidbruck,61,,1,1,2
065 Waidbruck,62,,2,-,2
065 Waidbruck,63,,3,-,3
065 Waidbruck,66,,1,-,1
065 Waidbruck,67,,-,1,1
065 Waidbruck,69,,-,1,1
065 Waidbruck,72,,-,3,3
065 Waidbruck,73,,1,1,2
065 Waidbruck,74,,2,1,3
065 Waidbruck,75,,-,1,1
065 Waidbruck,76,,1,1,2
065 Waidbruck,77,,-,1,1
065 Waidbruck,78,,1,2,3
065 Waidbruck,79,,1,-,1
065 Waidbruck,80,,-,2,2
065 Waidbruck,81,,1,-,1
065 Waidbruck,82,,1,1,2
065 Waidbruck,83,,-,2,2
065 Waidbruck,84,,-,1,1
065 Waidbruck,86,,-,1,1
065 Waidbruck,87,,1,-,1
065 Waidbruck,89,,-,1,1
065 Waidbruck,91,,1,1,2
065 Waidbruck,92,,-,1,1
065 Waidbruck,93,,1,-,1
066 Burgstall,0,,7,6,13
066 Burgstall,1,,11,5,16
066 Burgstall,2,,14,7,21
066 Burgstall,3,,10,12,22
066 Burgstall,4,,8,7,15
066 Burgstall,5,,14,15,29
066 Burgstall,6,,6,7,13
066 Burgstall,7,,9,14,23
066 Burgstall,8,,10,13,23
066 Burgstall,9,,14,7,21
066 Burgstall,10,,11,12,23
066 Burgstall,11,,9,7,16
066 Burgstall,12,,9,9,18
066 Burgstall,13,,6,7,13
066 Burgstall,14,,13,8,21
066 Burgstall,15,,9,9,18
066 Burgstall,16,,6,12,18
066 Burgstall,17,,9,9,18
066 Burgstall,18,,12,12,24
066 Burgstall,19,,10,9,19
066 Burgstall,20,,9,11,20
066 Burgstall,21,,15,7,22
066 Burgstall,22,,8,8,16
066 Burgstall,23,,11,7,18
066 Burgstall,24,,5,5,10
066 Burgstall,25,,8,11,19
066 Burgstall,26,,8,5,13
066 Burgstall,27,,9,12,21
066 Burgstall,28,,12,12,24
066 Burgstall,29,,10,8,18
066 Burgstall,30,,9,16,25
066 Burgstall,31,,10,12,22
066 Burgstall,32,,8,6,14
066 Burgstall,33,,12,14,26
066 Burgstall,34,,7,16,23
066 Burgstall,35,,10,14,24
066 Burgstall,36,,8,16,24
066 Burgstall,37,,12,7,19
066 Burgstall,38,,12,10,22
066 Burgstall,39,,15,10,25
066 Burgstall,40,,15,15,30
066 Burgstall,41,,8,19,27
066 Burgstall,42,,8,11,19
066 Burgstall,43,,20,15,35
066 Burgstall,44,,7,16,23
066 Burgstall,45,,11,19,30
066 Burgstall,46,,15,22,37
066 Burgstall,47,,14,11,25
066 Burgstall,48,,21,16,37
066 Burgstall,49,,17,12,29
066 Burgstall,50,,18,21,39
066 Burgstall,51,,16,16,32
066 Burgstall,52,,13,16,29
066 Burgstall,53,,19,20,39
066 Burgstall,54,,17,13,30
066 Burgstall,55,,20,16,36
066 Burgstall,56,,19,13,32
066 Burgstall,57,,16,21,37
066 Burgstall,58,,17,13,30
066 Burgstall,59,,11,7,18
066 Burgstall,60,,16,11,27
066 Burgstall,61,,11,11,22
066 Burgstall,62,,14,11,25
066 Burgstall,63,,7,13,20
066 Burgstall,64,,10,15,25
066 Burgstall,65,,8,11,19
066 Burgstall,66,,14,11,25
066 Burgstall,67,,13,6,19
066 Burgstall,68,,9,8,17
066 Burgstall,69,,10,8,18
066 Burgstall,70,,6,11,17
066 Burgstall,71,,6,9,15
066 Burgstall,72,,8,8,16
066 Burgstall,73,,7,6,13
066 Burgstall,74,,8,9,17
066 Burgstall,75,,9,7,16
066 Burgstall,76,,5,5,10
066 Burgstall,77,,5,6,11
066 Burgstall,78,,4,11,15
066 Burgstall,79,,4,8,12
066 Burgstall,80,,8,12,20
066 Burgstall,81,,4,7,11
066 Burgstall,82,,4,6,10
066 Burgstall,83,,6,3,9
066 Burgstall,84,,2,7,9
066 Burgstall,85,,4,3,7
066 Burgstall,86,,2,4,6
066 Burgstall,87,,4,2,6
066 Burgstall,88,,2,4,6
066 Burgstall,89,,-,2,2
066 Burgstall,90,,2,3,5
066 Burgstall,91,,-,5,5
066 Burgstall,92,,1,5,6
066 Burgstall,93,,1,1,2
066 Burgstall,94,,-,2,2
066 Burgstall,96,,-,1,1
066 Burgstall,100,,-,1,1
067 Prad am Stilfser Joch,0,,22,20,42
067 Prad am Stilfser Joch,1,,20,23,43
067 Prad am Stilfser Joch,2,,28,19,47
067 Prad am Stilfser Joch,3,,28,23,51
067 Prad am Stilfser Joch,4,,25,32,57
067 Prad am Stilfser Joch,5,,10,17,27
067 Prad am Stilfser Joch,6,,15,19,34
067 Prad am Stilfser Joch,7,,17,16,33
067 Prad am Stilfser Joch,8,,22,10,32
067 Prad am Stilfser Joch,9,,19,11,30
067 Prad am Stilfser Joch,10,,16,19,35
067 Prad am Stilfser Joch,11,,17,12,29
067 Prad am Stilfser Joch,12,,17,19,36
067 Prad am Stilfser Joch,13,,24,15,39
067 Prad am Stilfser Joch,14,,21,20,41
067 Prad am Stilfser Joch,15,,19,14,33
067 Prad am Stilfser Joch,16,,13,17,30
067 Prad am Stilfser Joch,17,,26,18,44
067 Prad am Stilfser Joch,18,,19,18,37
067 Prad am Stilfser Joch,19,,19,21,40
067 Prad am Stilfser Joch,20,,19,24,43
067 Prad am Stilfser Joch,21,,29,17,46
067 Prad am Stilfser Joch,22,,24,20,44
067 Prad am Stilfser Joch,23,,23,14,37
067 Prad am Stilfser Joch,24,,21,30,51
067 Prad am Stilfser Joch,25,,21,31,52
067 Prad am Stilfser Joch,26,,22,20,42
067 Prad am Stilfser Joch,27,,21,14,35
067 Prad am Stilfser Joch,28,,23,26,49
067 Prad am Stilfser Joch,29,,18,22,40
067 Prad am Stilfser Joch,30,,30,16,46
067 Prad am Stilfser Joch,31,,20,19,39
067 Prad am Stilfser Joch,32,,24,27,51
067 Prad am Stilfser Joch,33,,30,24,54
067 Prad am Stilfser Joch,34,,24,34,58
067 Prad am Stilfser Joch,35,,26,23,49
067 Prad am Stilfser Joch,36,,29,20,49
067 Prad am Stilfser Joch,37,,23,25,48
067 Prad am Stilfser Joch,38,,28,21,49
067 Prad am Stilfser Joch,39,,21,22,43
067 Prad am Stilfser Joch,40,,22,22,44
067 Prad am Stilfser Joch,41,,23,26,49
067 Prad am Stilfser Joch,42,,27,23,50
067 Prad am Stilfser Joch,43,,21,23,44
067 Prad am Stilfser Joch,44,,29,17,46
067 Prad am Stilfser Joch,45,,26,42,68
067 Prad am Stilfser Joch,46,,22,24,46
067 Prad am Stilfser Joch,47,,27,26,53
067 Prad am Stilfser Joch,48,,22,23,45
067 Prad am Stilfser Joch,49,,31,35,66
067 Prad am Stilfser Joch,50,,37,36,73
067 Prad am Stilfser Joch,51,,30,25,55
067 Prad am Stilfser Joch,52,,33,28,61
067 Prad am Stilfser Joch,53,,35,29,64
067 Prad am Stilfser Joch,54,,25,30,55
067 Prad am Stilfser Joch,55,,27,11,38
067 Prad am Stilfser Joch,56,,28,34,62
067 Prad am Stilfser Joch,57,,22,26,48
067 Prad am Stilfser Joch,58,,20,26,46
067 Prad am Stilfser Joch,59,,35,18,53
067 Prad am Stilfser Joch,60,,20,27,47
067 Prad am Stilfser Joch,61,,25,23,48
067 Prad am Stilfser Joch,62,,25,22,47
067 Prad am Stilfser Joch,63,,23,18,41
067 Prad am Stilfser Joch,64,,25,17,42
067 Prad am Stilfser Joch,65,,28,18,46
067 Prad am Stilfser Joch,66,,13,19,32
067 Prad am Stilfser Joch,67,,16,23,39
067 Prad am Stilfser Joch,68,,16,17,33
067 Prad am Stilfser Joch,69,,16,21,37
067 Prad am Stilfser Joch,70,,17,12,29
067 Prad am Stilfser Joch,71,,14,12,26
067 Prad am Stilfser Joch,72,,10,14,24
067 Prad am Stilfser Joch,73,,12,9,21
067 Prad am Stilfser Joch,74,,9,14,23
067 Prad am Stilfser Joch,75,,21,19,40
067 Prad am Stilfser Joch,76,,11,16,27
067 Prad am Stilfser Joch,77,,24,8,32
067 Prad am Stilfser Joch,78,,7,15,22
067 Prad am Stilfser Joch,79,,10,16,26
067 Prad am Stilfser Joch,80,,13,10,23
067 Prad am Stilfser Joch,81,,5,7,12
067 Prad am Stilfser Joch,82,,6,8,14
067 Prad am Stilfser Joch,83,,9,11,20
067 Prad am Stilfser Joch,84,,5,18,23
067 Prad am Stilfser Joch,85,,8,8,16
067 Prad am Stilfser Joch,86,,2,15,17
067 Prad am Stilfser Joch,87,,5,7,12
067 Prad am Stilfser Joch,88,,5,6,11
067 Prad am Stilfser Joch,89,,2,9,11
067 Prad am Stilfser Joch,90,,2,4,6
067 Prad am Stilfser Joch,91,,3,6,9
067 Prad am Stilfser Joch,92,,1,-,1
067 Prad am Stilfser Joch,93,,4,-,4
067 Prad am Stilfser Joch,94,,-,3,3
067 Prad am Stilfser Joch,95,,1,4,5
067 Prad am Stilfser Joch,96,,-,2,2
067 Prad am Stilfser Joch,98,,-,1,1
067 Prad am Stilfser Joch,99,,-,1,1
067 Prad am Stilfser Joch,102,,-,1,1
068 Prettau,0,,2,2,4
068 Prettau,1,,2,1,3
068 Prettau,2,,3,-,3
068 Prettau,3,,-,2,2
068 Prettau,4,,1,1,2
068 Prettau,5,,2,2,4
068 Prettau,6,,2,-,2
068 Prettau,7,,4,3,7
068 Prettau,8,,1,1,2
068 Prettau,9,,1,1,2
068 Prettau,10,,7,3,10
068 Prettau,11,,5,2,7
068 Prettau,12,,5,7,12
068 Prettau,13,,2,1,3
068 Prettau,14,,4,5,9
068 Prettau,15,,2,4,6
068 Prettau,16,,1,2,3
068 Prettau,17,,3,5,8
068 Prettau,18,,1,3,4
068 Prettau,19,,4,6,10
068 Prettau,20,,5,3,8
068 Prettau,21,,2,3,5
068 Prettau,22,,2,2,4
068 Prettau,23,,5,4,9
068 Prettau,24,,5,7,12
068 Prettau,25,,2,4,6
068 Prettau,26,,2,3,5
068 Prettau,27,,1,2,3
068 Prettau,28,,2,5,7
068 Prettau,29,,1,1,2
068 Prettau,30,,4,2,6
068 Prettau,31,,4,1,5
068 Prettau,32,,2,3,5
068 Prettau,33,,-,1,1
068 Prettau,34,,1,5,6
068 Prettau,35,,3,1,4
068 Prettau,36,,2,4,6
068 Prettau,37,,3,-,3
068 Prettau,38,,2,5,7
068 Prettau,39,,4,3,7
068 Prettau,40,,1,2,3
068 Prettau,41,,3,2,5
068 Prettau,42,,3,2,5
068 Prettau,43,,3,1,4
068 Prettau,44,,4,1,5
068 Prettau,45,,5,5,10
068 Prettau,46,,10,3,13
068 Prettau,47,,4,6,10
068 Prettau,48,,3,6,9
068 Prettau,49,,5,5,10
068 Prettau,50,,3,-,3
068 Prettau,51,,10,2,12
068 Prettau,52,,6,-,6
068 Prettau,53,,3,7,10
068 Prettau,54,,5,6,11
068 Prettau,55,,4,5,9
068 Prettau,56,,1,5,6
068 Prettau,57,,5,6,11
068 Prettau,58,,6,4,10
068 Prettau,59,,5,2,7
068 Prettau,60,,7,-,7
068 Prettau,61,,2,1,3
068 Prettau,62,,4,5,9
068 Prettau,63,,6,4,10
068 Prettau,64,,4,2,6
068 Prettau,65,,3,3,6
068 Prettau,66,,4,3,7
068 Prettau,67,,2,2,4
068 Prettau,68,,2,2,4
068 Prettau,69,,2,3,5
068 Prettau,70,,2,1,3
068 Prettau,71,,4,5,9
068 Prettau,72,,6,2,8
068 Prettau,73,,1,2,3
068 Prettau,74,,6,5,11
068 Prettau,75,,2,3,5
068 Prettau,76,,3,2,5
068 Prettau,77,,3,2,5
068 Prettau,78,,3,3,6
068 Prettau,79,,4,3,7
068 Prettau,80,,5,5,10
068 Prettau,81,,2,5,7
068 Prettau,82,,3,3,6
068 Prettau,83,,2,-,2
068 Prettau,84,,-,3,3
068 Prettau,85,,2,3,5
068 Prettau,86,,1,-,1
068 Prettau,87,,-,1,1
068 Prettau,88,,3,2,5
068 Prettau,89,,2,4,6
068 Prettau,90,,-,1,1
068 Prettau,91,,1,-,1
068 Prettau,93,,-,1,1
068 Prettau,95,,-,1,1
069 Proveis,0,,1,1,2
069 Proveis,1,,-,3,3
069 Proveis,2,,2,1,3
069 Proveis,3,,1,-,1
069 Proveis,4,,2,2,4
069 Proveis,5,,2,1,3
069 Proveis,6,,1,2,3
069 Proveis,7,,-,2,2
069 Proveis,8,,2,1,3
069 Proveis,9,,3,1,4
069 Proveis,10,,-,1,1
069 Proveis,11,,1,1,2
069 Proveis,12,,1,-,1
069 Proveis,13,,-,4,4
069 Proveis,14,,3,2,5
069 Proveis,15,,2,1,3
069 Proveis,16,,4,-,4
069 Proveis,17,,1,1,2
069 Proveis,18,,-,1,1
069 Proveis,19,,4,-,4
069 Proveis,20,,2,2,4
069 Proveis,21,,2,2,4
069 Proveis,22,,2,1,3
069 Proveis,23,,-,4,4
069 Proveis,24,,3,1,4
069 Proveis,25,,3,1,4
069 Proveis,26,,3,2,5
069 Proveis,27,,4,2,6
069 Proveis,28,,1,1,2
069 Proveis,29,,1,1,2
069 Proveis,30,,2,1,3
069 Proveis,31,,1,4,5
069 Proveis,32,,2,-,2
069 Proveis,33,,5,-,5
069 Proveis,34,,3,2,5
069 Proveis,35,,2,-,2
069 Proveis,36,,2,-,2
069 Proveis,37,,2,3,5
069 Proveis,39,,2,-,2
069 Proveis,40,,2,3,5
069 Proveis,41,,2,1,3
069 Proveis,42,,1,1,2
069 Proveis,43,,2,-,2
069 Proveis,44,,3,2,5
069 Proveis,45,,2,-,2
069 Proveis,46,,-,1,1
069 Proveis,47,,-,1,1
069 Proveis,48,,3,3,6
069 Proveis,49,,3,3,6
069 Proveis,50,,4,1,5
069 Proveis,51,,3,1,4
069 Proveis,52,,2,3,5
069 Proveis,53,,1,2,3
069 Proveis,54,,3,1,4
069 Proveis,55,,4,2,6
069 Proveis,56,,2,2,4
069 Proveis,57,,3,1,4
069 Proveis,58,,-,4,4
069 Proveis,59,,4,-,4
069 Proveis,60,,1,3,4
069 Proveis,61,,2,2,4
069 Proveis,62,,4,2,6
069 Proveis,63,,4,4,8
069 Proveis,64,,2,2,4
069 Proveis,65,,1,1,2
069 Proveis,66,,1,3,4
069 Proveis,67,,2,-,2
069 Proveis,68,,1,1,2
069 Proveis,69,,1,-,1
069 Proveis,70,,2,-,2
069 Proveis,71,,1,2,3
069 Proveis,72,,2,-,2
069 Proveis,73,,1,-,1
069 Proveis,74,,1,-,1
069 Proveis,75,,1,1,2
069 Proveis,76,,1,1,2
069 Proveis,77,,1,-,1
069 Proveis,78,,2,-,2
069 Proveis,79,,-,3,3
069 Proveis,80,,-,2,2
069 Proveis,81,,1,1,2
069 Proveis,82,,-,1,1
069 Proveis,87,,1,-,1
069 Proveis,90,,2,-,2
069 Proveis,91,,-,1,1
070 Ratschings,0,,24,36,60
070 Ratschings,1,,28,22,50
070 Ratschings,2,,22,36,58
070 Ratschings,3,,25,22,47
070 Ratschings,4,,28,25,53
070 Ratschings,5,,22,28,50
070 Ratschings,6,,27,28,55
070 Ratschings,7,,15,24,39
070 Ratschings,8,,27,27,54
070 Ratschings,9,,22,21,43
070 Ratschings,10,,21,16,37
070 Ratschings,11,,29,25,54
070 Ratschings,12,,25,23,48
070 Ratschings,13,,22,26,48
070 Ratschings,14,,34,27,61
070 Ratschings,15,,33,21,54
070 Ratschings,16,,17,27,44
070 Ratschings,17,,26,33,59
070 Ratschings,18,,34,25,59
070 Ratschings,19,,30,21,51
070 Ratschings,20,,35,21,56
070 Ratschings,21,,34,35,69
070 Ratschings,22,,29,31,60
070 Ratschings,23,,28,26,54
070 Ratschings,24,,22,25,47
070 Ratschings,25,,25,21,46
070 Ratschings,26,,35,36,71
070 Ratschings,27,,21,24,45
070 Ratschings,28,,31,24,55
070 Ratschings,29,,27,23,50
070 Ratschings,30,,33,26,59
070 Ratschings,31,,26,24,50
070 Ratschings,32,,27,28,55
070 Ratschings,33,,30,40,70
070 Ratschings,34,,32,21,53
070 Ratschings,35,,37,24,61
070 Ratschings,36,,37,30,67
070 Ratschings,37,,31,32,63
070 Ratschings,38,,28,29,57
070 Ratschings,39,,30,28,58
070 Ratschings,40,,33,22,55
070 Ratschings,41,,31,29,60
070 Ratschings,42,,19,23,42
070 Ratschings,43,,37,34,71
070 Ratschings,44,,34,23,57
070 Ratschings,45,,35,33,68
070 Ratschings,46,,37,39,76
070 Ratschings,47,,40,35,75
070 Ratschings,48,,31,42,73
070 Ratschings,49,,36,43,79
070 Ratschings,50,,50,47,97
070 Ratschings,51,,34,34,68
070 Ratschings,52,,43,47,90
070 Ratschings,53,,33,44,77
070 Ratschings,54,,47,42,89
070 Ratschings,55,,44,25,69
070 Ratschings,56,,35,40,75
070 Ratschings,57,,35,27,62
070 Ratschings,58,,39,24,63
070 Ratschings,59,,43,23,66
070 Ratschings,60,,25,27,52
070 Ratschings,61,,27,18,45
070 Ratschings,62,,38,20,58
070 Ratschings,63,,14,32,46
070 Ratschings,64,,25,16,41
070 Ratschings,65,,22,24,46
070 Ratschings,66,,17,21,38
070 Ratschings,67,,19,15,34
070 Ratschings,68,,22,20,42
070 Ratschings,69,,18,25,43
070 Ratschings,70,,28,18,46
070 Ratschings,71,,14,16,30
070 Ratschings,72,,20,5,25
070 Ratschings,73,,16,18,34
070 Ratschings,74,,13,10,23
070 Ratschings,75,,14,13,27
070 Ratschings,76,,14,15,29
070 Ratschings,77,,15,14,29
070 Ratschings,78,,13,15,28
070 Ratschings,79,,9,15,24
070 Ratschings,80,,12,14,26
070 Ratschings,81,,11,7,18
070 Ratschings,82,,5,9,14
070 Ratschings,83,,7,12,19
070 Ratschings,84,,6,6,12
070 Ratschings,85,,8,13,21
070 Ratschings,86,,5,7,12
070 Ratschings,87,,2,8,10
070 Ratschings,88,,2,5,7
070 Ratschings,89,,4,9,13
070 Ratschings,90,,2,4,6
070 Ratschings,91,,2,6,8
070 Ratschings,92,,2,3,5
070 Ratschings,93,,2,1,3
070 Ratschings,94,,1,-,1
070 Ratschings,95,,-,1,1
070 Ratschings,96,,-,1,1
070 Ratschings,97,,-,1,1
071 Rasen-Antholz,0,,18,11,29
071 Rasen-Antholz,1,,18,17,35
071 Rasen-Antholz,2,,15,12,27
071 Rasen-Antholz,3,,16,15,31
071 Rasen-Antholz,4,,11,17,28
071 Rasen-Antholz,5,,14,9,23
071 Rasen-Antholz,6,,10,20,30
071 Rasen-Antholz,7,,17,18,35
071 Rasen-Antholz,8,,10,8,18
071 Rasen-Antholz,9,,14,16,30
071 Rasen-Antholz,10,,21,8,29
071 Rasen-Antholz,11,,20,17,37
071 Rasen-Antholz,12,,15,21,36
071 Rasen-Antholz,13,,26,17,43
071 Rasen-Antholz,14,,15,21,36
071 Rasen-Antholz,15,,11,24,35
071 Rasen-Antholz,16,,13,18,31
071 Rasen-Antholz,17,,20,22,42
071 Rasen-Antholz,18,,24,23,47
071 Rasen-Antholz,19,,13,18,31
071 Rasen-Antholz,20,,22,16,38
071 Rasen-Antholz,21,,25,24,49
071 Rasen-Antholz,22,,24,20,44
071 Rasen-Antholz,23,,8,17,25
071 Rasen-Antholz,24,,22,12,34
071 Rasen-Antholz,25,,18,15,33
071 Rasen-Antholz,26,,22,17,39
071 Rasen-Antholz,27,,17,18,35
071 Rasen-Antholz,28,,15,21,36
071 Rasen-Antholz,29,,15,16,31
071 Rasen-Antholz,30,,17,14,31
071 Rasen-Antholz,31,,28,11,39
071 Rasen-Antholz,32,,13,19,32
071 Rasen-Antholz,33,,20,10,30
071 Rasen-Antholz,34,,18,25,43
071 Rasen-Antholz,35,,14,22,36
071 Rasen-Antholz,36,,19,17,36
071 Rasen-Antholz,37,,20,12,32
071 Rasen-Antholz,38,,14,11,25
071 Rasen-Antholz,39,,17,23,40
071 Rasen-Antholz,40,,18,22,40
071 Rasen-Antholz,41,,10,14,24
071 Rasen-Antholz,42,,24,13,37
071 Rasen-Antholz,43,,20,21,41
071 Rasen-Antholz,44,,25,21,46
071 Rasen-Antholz,45,,30,23,53
071 Rasen-Antholz,46,,19,21,40
071 Rasen-Antholz,47,,28,23,51
071 Rasen-Antholz,48,,23,27,50
071 Rasen-Antholz,49,,23,25,48
071 Rasen-Antholz,50,,26,29,55
071 Rasen-Antholz,51,,25,30,55
071 Rasen-Antholz,52,,28,21,49
071 Rasen-Antholz,53,,29,25,54
071 Rasen-Antholz,54,,28,24,52
071 Rasen-Antholz,55,,17,22,39
071 Rasen-Antholz,56,,26,20,46
071 Rasen-Antholz,57,,18,26,44
071 Rasen-Antholz,58,,23,25,48
071 Rasen-Antholz,59,,27,18,45
071 Rasen-Antholz,60,,25,16,41
071 Rasen-Antholz,61,,20,9,29
071 Rasen-Antholz,62,,20,14,34
071 Rasen-Antholz,63,,18,16,34
071 Rasen-Antholz,64,,15,15,30
071 Rasen-Antholz,65,,14,9,23
071 Rasen-Antholz,66,,9,14,23
071 Rasen-Antholz,67,,12,11,23
071 Rasen-Antholz,68,,11,9,20
071 Rasen-Antholz,69,,13,11,24
071 Rasen-Antholz,70,,13,10,23
071 Rasen-Antholz,71,,12,14,26
071 Rasen-Antholz,72,,9,14,23
071 Rasen-Antholz,73,,9,8,17
071 Rasen-Antholz,74,,8,8,16
071 Rasen-Antholz,75,,13,11,24
071 Rasen-Antholz,76,,8,13,21
071 Rasen-Antholz,77,,12,11,23
071 Rasen-Antholz,78,,8,16,24
071 Rasen-Antholz,79,,14,12,26
071 Rasen-Antholz,80,,9,6,15
071 Rasen-Antholz,81,,6,9,15
071 Rasen-Antholz,82,,8,9,17
071 Rasen-Antholz,83,,5,6,11
071 Rasen-Antholz,84,,7,7,14
071 Rasen-Antholz,85,,4,11,15
071 Rasen-Antholz,86,,5,8,13
071 Rasen-Antholz,87,,5,10,15
071 Rasen-Antholz,88,,4,5,9
071 Rasen-Antholz,89,,5,3,8
071 Rasen-Antholz,90,,-,4,4
071 Rasen-Antholz,91,,2,1,3
071 Rasen-Antholz,92,,1,3,4
071 Rasen-Antholz,93,,-,1,1
071 Rasen-Antholz,94,,1,-,1
071 Rasen-Antholz,95,,-,3,3
071 Rasen-Antholz,96,,1,-,1
072 Ritten,0,,35,38,73
072 Ritten,1,,47,44,91
072 Ritten,2,,43,50,93
072 Ritten,3,,44,47,91
072 Ritten,4,,41,33,74
072 Ritten,5,,41,42,83
072 Ritten,6,,41,44,85
072 Ritten,7,,45,42,87
072 Ritten,8,,48,42,90
072 Ritten,9,,43,44,87
072 Ritten,10,,38,53,91
072 Ritten,11,,44,51,95
072 Ritten,12,,55,47,102
072 Ritten,13,,44,50,94
072 Ritten,14,,53,54,107
072 Ritten,15,,42,41,83
072 Ritten,16,,34,49,83
072 Ritten,17,,50,47,97
072 Ritten,18,,47,45,92
072 Ritten,19,,52,55,107
072 Ritten,20,,45,49,94
072 Ritten,21,,56,52,108
072 Ritten,22,,43,58,101
072 Ritten,23,,57,44,101
072 Ritten,24,,61,44,105
072 Ritten,25,,50,51,101
072 Ritten,26,,39,69,108
072 Ritten,27,,55,48,103
072 Ritten,28,,65,48,113
072 Ritten,29,,50,36,86
072 Ritten,30,,51,54,105
072 Ritten,31,,59,50,109
072 Ritten,32,,53,45,98
072 Ritten,33,,47,52,99
072 Ritten,34,,51,33,84
072 Ritten,35,,54,61,115
072 Ritten,36,,41,54,95
072 Ritten,37,,52,53,105
072 Ritten,38,,58,48,106
072 Ritten,39,,58,53,111
072 Ritten,40,,50,46,96
072 Ritten,41,,62,34,96
072 Ritten,42,,45,58,103
072 Ritten,43,,53,50,103
072 Ritten,44,,65,58,123
072 Ritten,45,,57,46,103
072 Ritten,46,,52,67,119
072 Ritten,47,,58,65,123
072 Ritten,48,,52,69,121
072 Ritten,49,,51,72,123
072 Ritten,50,,69,65,134
072 Ritten,51,,74,50,124
072 Ritten,52,,57,49,106
072 Ritten,53,,71,43,114
072 Ritten,54,,65,61,126
072 Ritten,55,,66,52,118
072 Ritten,56,,56,60,116
072 Ritten,57,,51,57,108
072 Ritten,58,,62,56,118
072 Ritten,59,,71,50,121
072 Ritten,60,,37,48,85
072 Ritten,61,,38,42,80
072 Ritten,62,,43,45,88
072 Ritten,63,,47,40,87
072 Ritten,64,,36,34,70
072 Ritten,65,,46,30,76
072 Ritten,66,,41,42,83
072 Ritten,67,,46,36,82
072 Ritten,68,,30,38,68
072 Ritten,69,,32,44,76
072 Ritten,70,,50,39,89
072 Ritten,71,,26,29,55
072 Ritten,72,,19,37,56
072 Ritten,73,,19,25,44
072 Ritten,74,,34,39,73
072 Ritten,75,,30,37,67
072 Ritten,76,,38,32,70
072 Ritten,77,,29,34,63
072 Ritten,78,,28,21,49
072 Ritten,79,,32,27,59
072 Ritten,80,,26,29,55
072 Ritten,81,,20,21,41
072 Ritten,82,,14,24,38
072 Ritten,83,,15,24,39
072 Ritten,84,,10,24,34
072 Ritten,85,,9,18,27
072 Ritten,86,,10,15,25
072 Ritten,87,,7,23,30
072 Ritten,88,,6,14,20
072 Ritten,89,,7,10,17
072 Ritten,90,,5,6,11
072 Ritten,91,,6,5,11
072 Ritten,92,,4,8,12
072 Ritten,93,,-,10,10
072 Ritten,94,,2,8,10
072 Ritten,95,,2,5,7
072 Ritten,97,,-,4,4
072 Ritten,98,,-,1,1
073 Riffian,0,,5,4,9
073 Riffian,1,,10,5,15
073 Riffian,2,,9,8,17
073 Riffian,3,,6,4,10
073 Riffian,4,,6,2,8
073 Riffian,5,,8,5,13
073 Riffian,6,,2,6,8
073 Riffian,7,,11,12,23
073 Riffian,8,,7,7,14
073 Riffian,9,,8,8,16
073 Riffian,10,,12,5,17
073 Riffian,11,,11,7,18
073 Riffian,12,,6,12,18
073 Riffian,13,,9,9,18
073 Riffian,14,,9,3,12
073 Riffian,15,,9,7,16
073 Riffian,16,,10,7,17
073 Riffian,17,,11,8,19
073 Riffian,18,,9,10,19
073 Riffian,19,,11,9,20
073 Riffian,20,,12,6,18
073 Riffian,21,,11,7,18
073 Riffian,22,,7,10,17
073 Riffian,23,,7,10,17
073 Riffian,24,,12,10,22
073 Riffian,25,,7,6,13
073 Riffian,26,,13,6,19
073 Riffian,27,,9,15,24
073 Riffian,28,,9,5,14
073 Riffian,29,,12,3,15
073 Riffian,30,,10,10,20
073 Riffian,31,,8,9,17
073 Riffian,32,,12,8,20
073 Riffian,33,,9,5,14
073 Riffian,34,,6,7,13
073 Riffian,35,,9,6,15
073 Riffian,36,,11,10,21
073 Riffian,37,,8,7,15
073 Riffian,38,,1,5,6
073 Riffian,39,,10,9,19
073 Riffian,40,,13,6,19
073 Riffian,41,,12,14,26
073 Riffian,42,,8,4,12
073 Riffian,43,,10,14,24
073 Riffian,44,,10,11,21
073 Riffian,45,,9,9,18
073 Riffian,46,,12,22,34
073 Riffian,47,,10,16,26
073 Riffian,48,,8,8,16
073 Riffian,49,,15,11,26
073 Riffian,50,,10,11,21
073 Riffian,51,,12,15,27
073 Riffian,52,,12,6,18
073 Riffian,53,,11,6,17
073 Riffian,54,,10,8,18
073 Riffian,55,,14,9,23
073 Riffian,56,,10,12,22
073 Riffian,57,,6,8,14
073 Riffian,58,,13,6,19
073 Riffian,59,,7,14,21
073 Riffian,60,,8,5,13
073 Riffian,61,,5,13,18
073 Riffian,62,,9,6,15
073 Riffian,63,,3,7,10
073 Riffian,64,,9,6,15
073 Riffian,65,,7,4,11
073 Riffian,66,,6,3,9
073 Riffian,67,,5,9,14
073 Riffian,68,,4,3,7
073 Riffian,69,,8,6,14
073 Riffian,70,,3,2,5
073 Riffian,71,,3,3,6
073 Riffian,72,,3,7,10
073 Riffian,73,,6,3,9
073 Riffian,74,,6,8,14
073 Riffian,75,,5,7,12
073 Riffian,76,,12,6,18
073 Riffian,77,,4,3,7
073 Riffian,78,,3,3,6
073 Riffian,79,,4,9,13
073 Riffian,80,,6,4,10
073 Riffian,81,,5,5,10
073 Riffian,82,,1,3,4
073 Riffian,83,,1,2,3
073 Riffian,84,,-,2,2
073 Riffian,85,,2,5,7
073 Riffian,86,,1,5,6
073 Riffian,87,,2,3,5
073 Riffian,88,,3,2,5
073 Riffian,89,,-,4,4
073 Riffian,90,,1,3,4
073 Riffian,91,,1,2,3
073 Riffian,92,,2,1,3
073 Riffian,93,,-,1,1
073 Riffian,94,,-,1,1
073 Riffian,95,,-,2,2
074 Mühlbach,0,,12,15,27
074 Mühlbach,1,,13,22,35
074 Mühlbach,2,,20,20,40
074 Mühlbach,3,,32,21,53
074 Mühlbach,4,,21,14,35
074 Mühlbach,5,,25,11,36
074 Mühlbach,6,,20,23,43
074 Mühlbach,7,,25,18,43
074 Mühlbach,8,,17,25,42
074 Mühlbach,9,,20,16,36
074 Mühlbach,10,,22,17,39
074 Mühlbach,11,,22,27,49
074 Mühlbach,12,,16,9,25
074 Mühlbach,13,,16,11,27
074 Mühlbach,14,,15,21,36
074 Mühlbach,15,,23,12,35
074 Mühlbach,16,,20,19,39
074 Mühlbach,17,,16,18,34
074 Mühlbach,18,,15,17,32
074 Mühlbach,19,,19,14,33
074 Mühlbach,20,,19,22,41
074 Mühlbach,21,,18,16,34
074 Mühlbach,22,,22,15,37
074 Mühlbach,23,,16,19,35
074 Mühlbach,24,,23,14,37
074 Mühlbach,25,,24,25,49
074 Mühlbach,26,,15,21,36
074 Mühlbach,27,,22,18,40
074 Mühlbach,28,,19,21,40
074 Mühlbach,29,,13,19,32
074 Mühlbach,30,,18,22,40
074 Mühlbach,31,,21,19,40
074 Mühlbach,32,,14,12,26
074 Mühlbach,33,,21,24,45
074 Mühlbach,34,,21,26,47
074 Mühlbach,35,,20,22,42
074 Mühlbach,36,,30,32,62
074 Mühlbach,37,,24,16,40
074 Mühlbach,38,,23,21,44
074 Mühlbach,39,,23,19,42
074 Mühlbach,40,,27,27,54
074 Mühlbach,41,,22,17,39
074 Mühlbach,42,,26,19,45
074 Mühlbach,43,,19,21,40
074 Mühlbach,44,,22,18,40
074 Mühlbach,45,,24,20,44
074 Mühlbach,46,,27,22,49
074 Mühlbach,47,,30,27,57
074 Mühlbach,48,,26,17,43
074 Mühlbach,49,,24,34,58
074 Mühlbach,50,,32,20,52
074 Mühlbach,51,,22,23,45
074 Mühlbach,52,,30,20,50
074 Mühlbach,53,,26,19,45
074 Mühlbach,54,,15,20,35
074 Mühlbach,55,,19,22,41
074 Mühlbach,56,,24,17,41
074 Mühlbach,57,,25,24,49
074 Mühlbach,58,,21,14,35
074 Mühlbach,59,,21,17,38
074 Mühlbach,60,,17,13,30
074 Mühlbach,61,,15,23,38
074 Mühlbach,62,,18,24,42
074 Mühlbach,63,,19,19,38
074 Mühlbach,64,,13,19,32
074 Mühlbach,65,,18,18,36
074 Mühlbach,66,,15,20,35
074 Mühlbach,67,,13,18,31
074 Mühlbach,68,,20,16,36
074 Mühlbach,69,,13,13,26
074 Mühlbach,70,,19,12,31
074 Mühlbach,71,,10,17,27
074 Mühlbach,72,,17,10,27
074 Mühlbach,73,,6,6,12
074 Mühlbach,74,,11,11,22
074 Mühlbach,75,,8,9,17
074 Mühlbach,76,,11,13,24
074 Mühlbach,77,,14,16,30
074 Mühlbach,78,,11,9,20
074 Mühlbach,79,,7,14,21
074 Mühlbach,80,,10,6,16
074 Mühlbach,81,,4,9,13
074 Mühlbach,82,,3,7,10
074 Mühlbach,83,,5,5,10
074 Mühlbach,84,,6,6,12
074 Mühlbach,85,,8,9,17
074 Mühlbach,86,,1,3,4
074 Mühlbach,87,,1,6,7
074 Mühlbach,88,,1,4,5
074 Mühlbach,89,,1,1,2
074 Mühlbach,90,,2,7,9
074 Mühlbach,91,,-,5,5
074 Mühlbach,92,,2,2,4
074 Mühlbach,93,,-,2,2
074 Mühlbach,94,,3,2,5
074 Mühlbach,95,,-,2,2
074 Mühlbach,96,,-,4,4
074 Mühlbach,97,,-,1,1
075 Rodeneck,0,,9,8,17
075 Rodeneck,1,,7,9,16
075 Rodeneck,2,,7,7,14
075 Rodeneck,3,,8,4,12
075 Rodeneck,4,,7,8,15
075 Rodeneck,5,,7,6,13
075 Rodeneck,6,,7,5,12
075 Rodeneck,7,,2,6,8
075 Rodeneck,8,,7,4,11
075 Rodeneck,9,,3,6,9
075 Rodeneck,10,,7,9,16
075 Rodeneck,11,,7,6,13
075 Rodeneck,12,,5,5,10
075 Rodeneck,13,,10,8,18
075 Rodeneck,14,,7,5,12
075 Rodeneck,15,,7,7,14
075 Rodeneck,16,,9,3,12
075 Rodeneck,17,,9,5,14
075 Rodeneck,18,,6,14,20
075 Rodeneck,19,,10,11,21
075 Rodeneck,20,,11,9,20
075 Rodeneck,21,,10,7,17
075 Rodeneck,22,,13,9,22
075 Rodeneck,23,,7,6,13
075 Rodeneck,24,,7,12,19
075 Rodeneck,25,,5,10,15
075 Rodeneck,26,,9,8,17
075 Rodeneck,27,,8,7,15
075 Rodeneck,28,,9,9,18
075 Rodeneck,29,,5,8,13
075 Rodeneck,30,,15,8,23
075 Rodeneck,31,,6,6,12
075 Rodeneck,32,,6,13,19
075 Rodeneck,33,,11,7,18
075 Rodeneck,34,,11,8,19
075 Rodeneck,35,,10,10,20
075 Rodeneck,36,,8,6,14
075 Rodeneck,37,,8,4,12
075 Rodeneck,38,,8,13,21
075 Rodeneck,39,,5,5,10
075 Rodeneck,40,,6,7,13
075 Rodeneck,41,,7,5,12
075 Rodeneck,42,,9,8,17
075 Rodeneck,43,,9,6,15
075 Rodeneck,44,,6,6,12
075 Rodeneck,45,,15,11,26
075 Rodeneck,46,,8,8,16
075 Rodeneck,47,,15,4,19
075 Rodeneck,48,,8,11,19
075 Rodeneck,49,,14,10,24
075 Rodeneck,50,,11,11,22
075 Rodeneck,51,,13,8,21
075 Rodeneck,52,,18,10,28
075 Rodeneck,53,,7,8,15
075 Rodeneck,54,,13,14,27
075 Rodeneck,55,,11,10,21
075 Rodeneck,56,,10,12,22
075 Rodeneck,57,,9,10,19
075 Rodeneck,58,,6,10,16
075 Rodeneck,59,,10,6,16
075 Rodeneck,60,,7,4,11
075 Rodeneck,61,,5,7,12
075 Rodeneck,62,,8,4,12
075 Rodeneck,63,,5,5,10
075 Rodeneck,64,,8,3,11
075 Rodeneck,65,,4,1,5
075 Rodeneck,66,,9,4,13
075 Rodeneck,67,,2,2,4
075 Rodeneck,68,,2,8,10
075 Rodeneck,69,,3,4,7
075 Rodeneck,70,,4,7,11
075 Rodeneck,71,,4,5,9
075 Rodeneck,72,,8,6,14
075 Rodeneck,73,,2,5,7
075 Rodeneck,74,,4,4,8
075 Rodeneck,75,,2,2,4
075 Rodeneck,76,,1,6,7
075 Rodeneck,77,,9,3,12
075 Rodeneck,78,,3,3,6
075 Rodeneck,79,,1,8,9
075 Rodeneck,80,,2,3,5
075 Rodeneck,81,,-,3,3
075 Rodeneck,82,,1,2,3
075 Rodeneck,83,,1,2,3
075 Rodeneck,84,,1,9,10
075 Rodeneck,85,,1,-,1
075 Rodeneck,86,,4,5,9
075 Rodeneck,87,,4,2,6
075 Rodeneck,88,,3,3,6
075 Rodeneck,89,,1,1,2
075 Rodeneck,90,,3,4,7
075 Rodeneck,91,,1,2,3
075 Rodeneck,92,,1,1,2
075 Rodeneck,93,,-,2,2
075 Rodeneck,94,,-,2,2
076 Salurn,0,,22,20,42
076 Salurn,1,,20,23,43
076 Salurn,2,,25,20,45
076 Salurn,3,,23,22,45
076 Salurn,4,,28,23,51
076 Salurn,5,,20,25,45
076 Salurn,6,,22,23,45
076 Salurn,7,,29,26,55
076 Salurn,8,,29,20,49
076 Salurn,9,,26,29,55
076 Salurn,10,,28,22,50
076 Salurn,11,,30,21,51
076 Salurn,12,,20,21,41
076 Salurn,13,,16,26,42
076 Salurn,14,,24,17,41
076 Salurn,15,,29,16,45
076 Salurn,16,,18,19,37
076 Salurn,17,,17,17,34
076 Salurn,18,,20,19,39
076 Salurn,19,,23,19,42
076 Salurn,20,,19,25,44
076 Salurn,21,,14,16,30
076 Salurn,22,,24,21,45
076 Salurn,23,,22,16,38
076 Salurn,24,,19,26,45
076 Salurn,25,,20,30,50
076 Salurn,26,,25,22,47
076 Salurn,27,,15,21,36
076 Salurn,28,,12,24,36
076 Salurn,29,,15,23,38
076 Salurn,30,,23,26,49
076 Salurn,31,,23,17,40
076 Salurn,32,,23,25,48
076 Salurn,33,,22,29,51
076 Salurn,34,,17,24,41
076 Salurn,35,,15,24,39
076 Salurn,36,,24,21,45
076 Salurn,37,,23,32,55
076 Salurn,38,,32,29,61
076 Salurn,39,,29,28,57
076 Salurn,40,,22,24,46
076 Salurn,41,,31,27,58
076 Salurn,42,,30,25,55
076 Salurn,43,,27,30,57
076 Salurn,44,,28,21,49
076 Salurn,45,,29,35,64
076 Salurn,46,,29,28,57
076 Salurn,47,,38,28,66
076 Salurn,48,,31,30,61
076 Salurn,49,,31,31,62
076 Salurn,50,,36,26,62
076 Salurn,51,,29,22,51
076 Salurn,52,,27,29,56
076 Salurn,53,,29,32,61
076 Salurn,54,,31,31,62
076 Salurn,55,,38,26,64
076 Salurn,56,,31,30,61
076 Salurn,57,,25,33,58
076 Salurn,58,,20,25,45
076 Salurn,59,,25,28,53
076 Salurn,60,,30,16,46
076 Salurn,61,,18,25,43
076 Salurn,62,,20,16,36
076 Salurn,63,,20,22,42
076 Salurn,64,,18,18,36
076 Salurn,65,,17,17,34
076 Salurn,66,,25,21,46
076 Salurn,67,,22,18,40
076 Salurn,68,,23,16,39
076 Salurn,69,,27,10,37
076 Salurn,70,,15,20,35
076 Salurn,71,,14,18,32
076 Salurn,72,,19,17,36
076 Salurn,73,,10,11,21
076 Salurn,74,,16,17,33
076 Salurn,75,,16,17,33
076 Salurn,76,,20,17,37
076 Salurn,77,,13,14,27
076 Salurn,78,,12,12,24
076 Salurn,79,,11,6,17
076 Salurn,80,,4,9,13
076 Salurn,81,,9,9,18
076 Salurn,82,,12,18,30
076 Salurn,83,,8,14,22
076 Salurn,84,,6,5,11
076 Salurn,85,,3,5,8
076 Salurn,86,,3,12,15
076 Salurn,87,,4,4,8
076 Salurn,88,,6,7,13
076 Salurn,89,,6,8,14
076 Salurn,90,,2,13,15
076 Salurn,91,,1,8,9
076 Salurn,92,,1,4,5
076 Salurn,93,,2,1,3
076 Salurn,94,,-,8,8
076 Salurn,95,,1,2,3
076 Salurn,96,,-,3,3
076 Salurn,97,,-,1,1
076 Salurn,98,,-,1,1
076 Salurn,101,,-,1,1
077 Innichen,0,,11,21,32
077 Innichen,1,,16,21,37
077 Innichen,2,,20,16,36
077 Innichen,3,,9,15,24
077 Innichen,4,,21,17,38
077 Innichen,5,,18,20,38
077 Innichen,6,,17,24,41
077 Innichen,7,,25,20,45
077 Innichen,8,,18,13,31
077 Innichen,9,,10,22,32
077 Innichen,10,,21,14,35
077 Innichen,11,,15,16,31
077 Innichen,12,,10,16,26
077 Innichen,13,,12,17,29
077 Innichen,14,,13,17,30
077 Innichen,15,,18,16,34
077 Innichen,16,,15,16,31
077 Innichen,17,,22,17,39
077 Innichen,18,,13,15,28
077 Innichen,19,,11,17,28
077 Innichen,20,,21,12,33
077 Innichen,21,,22,14,36
077 Innichen,22,,23,18,41
077 Innichen,23,,28,13,41
077 Innichen,24,,25,21,46
077 Innichen,25,,31,19,50
077 Innichen,26,,23,12,35
077 Innichen,27,,18,27,45
077 Innichen,28,,20,17,37
077 Innichen,29,,24,19,43
077 Innichen,30,,23,18,41
077 Innichen,31,,24,13,37
077 Innichen,32,,21,16,37
077 Innichen,33,,23,30,53
077 Innichen,34,,18,20,38
077 Innichen,35,,22,19,41
077 Innichen,36,,27,28,55
077 Innichen,37,,16,18,34
077 Innichen,38,,23,18,41
077 Innichen,39,,29,26,55
077 Innichen,40,,15,17,32
077 Innichen,41,,18,26,44
077 Innichen,42,,18,26,44
077 Innichen,43,,19,18,37
077 Innichen,44,,24,17,41
077 Innichen,45,,22,23,45
077 Innichen,46,,25,24,49
077 Innichen,47,,26,15,41
077 Innichen,48,,24,31,55
077 Innichen,49,,20,28,48
077 Innichen,50,,25,26,51
077 Innichen,51,,29,27,56
077 Innichen,52,,27,31,58
077 Innichen,53,,38,27,65
077 Innichen,54,,31,32,63
077 Innichen,55,,31,26,57
077 Innichen,56,,27,23,50
077 Innichen,57,,21,25,46
077 Innichen,58,,27,22,49
077 Innichen,59,,26,22,48
077 Innichen,60,,21,26,47
077 Innichen,61,,17,25,42
077 Innichen,62,,23,16,39
077 Innichen,63,,24,20,44
077 Innichen,64,,26,11,37
077 Innichen,65,,21,19,40
077 Innichen,66,,12,26,38
077 Innichen,67,,12,17,29
077 Innichen,68,,15,17,32
077 Innichen,69,,17,16,33
077 Innichen,70,,15,15,30
077 Innichen,71,,11,14,25
077 Innichen,72,,11,16,27
077 Innichen,73,,11,10,21
077 Innichen,74,,8,16,24
077 Innichen,75,,18,9,27
077 Innichen,76,,16,18,34
077 Innichen,77,,10,16,26
077 Innichen,78,,9,22,31
077 Innichen,79,,10,10,20
077 Innichen,80,,8,11,19
077 Innichen,81,,8,9,17
077 Innichen,82,,7,18,25
077 Innichen,83,,4,15,19
077 Innichen,84,,9,12,21
077 Innichen,85,,8,8,16
077 Innichen,86,,7,15,22
077 Innichen,87,,6,10,16
077 Innichen,88,,7,9,16
077 Innichen,89,,5,11,16
077 Innichen,90,,5,12,17
077 Innichen,91,,1,8,9
077 Innichen,92,,3,7,10
077 Innichen,93,,1,6,7
077 Innichen,94,,2,1,3
077 Innichen,95,,-,2,2
077 Innichen,96,,1,5,6
077 Innichen,97,,-,1,1
077 Innichen,98,,2,1,3
079 Jenesien,0,,17,13,30
079 Jenesien,1,,22,10,32
079 Jenesien,2,,23,10,33
079 Jenesien,3,,14,14,28
079 Jenesien,4,,20,17,37
079 Jenesien,5,,19,17,36
079 Jenesien,6,,16,11,27
079 Jenesien,7,,13,12,25
079 Jenesien,8,,18,16,34
079 Jenesien,9,,18,15,33
079 Jenesien,10,,20,19,39
079 Jenesien,11,,22,17,39
079 Jenesien,12,,21,21,42
079 Jenesien,13,,15,16,31
079 Jenesien,14,,19,20,39
079 Jenesien,15,,18,21,39
079 Jenesien,16,,12,17,29
079 Jenesien,17,,20,22,42
079 Jenesien,18,,18,19,37
079 Jenesien,19,,27,20,47
079 Jenesien,20,,17,28,45
079 Jenesien,21,,25,20,45
079 Jenesien,22,,25,16,41
079 Jenesien,23,,24,19,43
079 Jenesien,24,,21,20,41
079 Jenesien,25,,16,16,32
079 Jenesien,26,,27,18,45
079 Jenesien,27,,21,21,42
079 Jenesien,28,,18,12,30
079 Jenesien,29,,18,11,29
079 Jenesien,30,,17,13,30
079 Jenesien,31,,18,14,32
079 Jenesien,32,,20,15,35
079 Jenesien,33,,19,13,32
079 Jenesien,34,,18,15,33
079 Jenesien,35,,16,21,37
079 Jenesien,36,,21,22,43
079 Jenesien,37,,19,19,38
079 Jenesien,38,,18,15,33
079 Jenesien,39,,20,18,38
079 Jenesien,40,,17,21,38
079 Jenesien,41,,19,14,33
079 Jenesien,42,,12,22,34
079 Jenesien,43,,13,21,34
079 Jenesien,44,,23,25,48
079 Jenesien,45,,23,29,52
079 Jenesien,46,,25,27,52
079 Jenesien,47,,30,27,57
079 Jenesien,48,,31,34,65
079 Jenesien,49,,32,22,54
079 Jenesien,50,,17,27,44
079 Jenesien,51,,17,24,41
079 Jenesien,52,,38,29,67
079 Jenesien,53,,33,30,63
079 Jenesien,54,,34,35,69
079 Jenesien,55,,26,23,49
079 Jenesien,56,,26,20,46
079 Jenesien,57,,29,21,50
079 Jenesien,58,,23,12,35
079 Jenesien,59,,23,16,39
079 Jenesien,60,,24,10,34
079 Jenesien,61,,13,16,29
079 Jenesien,62,,14,13,27
079 Jenesien,63,,10,12,22
079 Jenesien,64,,18,12,30
079 Jenesien,65,,12,9,21
079 Jenesien,66,,14,18,32
079 Jenesien,67,,11,9,20
079 Jenesien,68,,12,21,33
079 Jenesien,69,,13,13,26
079 Jenesien,70,,12,8,20
079 Jenesien,71,,13,11,24
079 Jenesien,72,,10,9,19
079 Jenesien,73,,7,14,21
079 Jenesien,74,,11,11,22
079 Jenesien,75,,14,9,23
079 Jenesien,76,,14,9,23
079 Jenesien,77,,11,17,28
079 Jenesien,78,,12,10,22
079 Jenesien,79,,11,18,29
079 Jenesien,80,,9,10,19
079 Jenesien,81,,7,15,22
079 Jenesien,82,,3,16,19
079 Jenesien,83,,4,7,11
079 Jenesien,84,,7,6,13
079 Jenesien,85,,9,7,16
079 Jenesien,86,,3,6,9
079 Jenesien,87,,4,3,7
079 Jenesien,88,,3,10,13
079 Jenesien,89,,1,5,6
079 Jenesien,90,,3,2,5
079 Jenesien,91,,-,3,3
079 Jenesien,92,,1,2,3
079 Jenesien,93,,-,1,1
079 Jenesien,96,,-,3,3
080 St.Leonhard in Pass.,0,,26,17,43
080 St.Leonhard in Pass.,1,,19,19,38
080 St.Leonhard in Pass.,2,,21,14,35
080 St.Leonhard in Pass.,3,,20,28,48
080 St.Leonhard in Pass.,4,,25,19,44
080 St.Leonhard in Pass.,5,,20,22,42
080 St.Leonhard in Pass.,6,,9,20,29
080 St.Leonhard in Pass.,7,,15,19,34
080 St.Leonhard in Pass.,8,,22,21,43
080 St.Leonhard in Pass.,9,,17,19,36
080 St.Leonhard in Pass.,10,,20,22,42
080 St.Leonhard in Pass.,11,,22,20,42
080 St.Leonhard in Pass.,12,,17,26,43
080 St.Leonhard in Pass.,13,,20,21,41
080 St.Leonhard in Pass.,14,,18,22,40
080 St.Leonhard in Pass.,15,,23,15,38
080 St.Leonhard in Pass.,16,,26,19,45
080 St.Leonhard in Pass.,17,,27,13,40
080 St.Leonhard in Pass.,18,,23,18,41
080 St.Leonhard in Pass.,19,,21,21,42
080 St.Leonhard in Pass.,20,,23,23,46
080 St.Leonhard in Pass.,21,,25,19,44
080 St.Leonhard in Pass.,22,,23,19,42
080 St.Leonhard in Pass.,23,,22,12,34
080 St.Leonhard in Pass.,24,,20,20,40
080 St.Leonhard in Pass.,25,,27,20,47
080 St.Leonhard in Pass.,26,,18,15,33
080 St.Leonhard in Pass.,27,,22,27,49
080 St.Leonhard in Pass.,28,,24,13,37
080 St.Leonhard in Pass.,29,,34,29,63
080 St.Leonhard in Pass.,30,,21,18,39
080 St.Leonhard in Pass.,31,,23,23,46
080 St.Leonhard in Pass.,32,,28,28,56
080 St.Leonhard in Pass.,33,,23,21,44
080 St.Leonhard in Pass.,34,,26,22,48
080 St.Leonhard in Pass.,35,,27,18,45
080 St.Leonhard in Pass.,36,,21,29,50
080 St.Leonhard in Pass.,37,,22,28,50
080 St.Leonhard in Pass.,38,,20,25,45
080 St.Leonhard in Pass.,39,,30,21,51
080 St.Leonhard in Pass.,40,,25,28,53
080 St.Leonhard in Pass.,41,,27,25,52
080 St.Leonhard in Pass.,42,,15,29,44
080 St.Leonhard in Pass.,43,,28,11,39
080 St.Leonhard in Pass.,44,,31,21,52
080 St.Leonhard in Pass.,45,,27,26,53
080 St.Leonhard in Pass.,46,,26,26,52
080 St.Leonhard in Pass.,47,,29,20,49
080 St.Leonhard in Pass.,48,,18,23,41
080 St.Leonhard in Pass.,49,,23,27,50
080 St.Leonhard in Pass.,50,,31,22,53
080 St.Leonhard in Pass.,51,,21,25,46
080 St.Leonhard in Pass.,52,,33,29,62
080 St.Leonhard in Pass.,53,,29,28,57
080 St.Leonhard in Pass.,54,,22,26,48
080 St.Leonhard in Pass.,55,,21,25,46
080 St.Leonhard in Pass.,56,,21,32,53
080 St.Leonhard in Pass.,57,,26,20,46
080 St.Leonhard in Pass.,58,,31,19,50
080 St.Leonhard in Pass.,59,,29,24,53
080 St.Leonhard in Pass.,60,,22,19,41
080 St.Leonhard in Pass.,61,,20,28,48
080 St.Leonhard in Pass.,62,,26,18,44
080 St.Leonhard in Pass.,63,,23,17,40
080 St.Leonhard in Pass.,64,,18,13,31
080 St.Leonhard in Pass.,65,,28,25,53
080 St.Leonhard in Pass.,66,,18,21,39
080 St.Leonhard in Pass.,67,,24,16,40
080 St.Leonhard in Pass.,68,,13,16,29
080 St.Leonhard in Pass.,69,,21,10,31
080 St.Leonhard in Pass.,70,,20,10,30
080 St.Leonhard in Pass.,71,,17,14,31
080 St.Leonhard in Pass.,72,,13,16,29
080 St.Leonhard in Pass.,73,,10,10,20
080 St.Leonhard in Pass.,74,,10,12,22
080 St.Leonhard in Pass.,75,,6,23,29
080 St.Leonhard in Pass.,76,,7,11,18
080 St.Leonhard in Pass.,77,,11,13,24
080 St.Leonhard in Pass.,78,,15,11,26
080 St.Leonhard in Pass.,79,,17,17,34
080 St.Leonhard in Pass.,80,,9,12,21
080 St.Leonhard in Pass.,81,,13,7,20
080 St.Leonhard in Pass.,82,,13,12,25
080 St.Leonhard in Pass.,83,,8,10,18
080 St.Leonhard in Pass.,84,,7,8,15
080 St.Leonhard in Pass.,85,,8,12,20
080 St.Leonhard in Pass.,86,,3,11,14
080 St.Leonhard in Pass.,87,,1,12,13
080 St.Leonhard in Pass.,88,,3,5,8
080 St.Leonhard in Pass.,89,,3,2,5
080 St.Leonhard in Pass.,90,,1,5,6
080 St.Leonhard in Pass.,91,,2,2,4
080 St.Leonhard in Pass.,92,,3,4,7
080 St.Leonhard in Pass.,93,,2,2,4
080 St.Leonhard in Pass.,94,,-,1,1
080 St.Leonhard in Pass.,95,,3,2,5
080 St.Leonhard in Pass.,96,,-,1,1
081 St.Lorenzen,0,,18,24,42
081 St.Lorenzen,1,,18,19,37
081 St.Lorenzen,2,,20,20,40
081 St.Lorenzen,3,,16,25,41
081 St.Lorenzen,4,,20,25,45
081 St.Lorenzen,5,,26,25,51
081 St.Lorenzen,6,,19,9,28
081 St.Lorenzen,7,,21,23,44
081 St.Lorenzen,8,,26,18,44
081 St.Lorenzen,9,,21,22,43
081 St.Lorenzen,10,,24,21,45
081 St.Lorenzen,11,,26,22,48
081 St.Lorenzen,12,,19,19,38
081 St.Lorenzen,13,,27,22,49
081 St.Lorenzen,14,,27,21,48
081 St.Lorenzen,15,,27,19,46
081 St.Lorenzen,16,,24,21,45
081 St.Lorenzen,17,,28,18,46
081 St.Lorenzen,18,,23,28,51
081 St.Lorenzen,19,,27,26,53
081 St.Lorenzen,20,,36,21,57
081 St.Lorenzen,21,,17,31,48
081 St.Lorenzen,22,,25,29,54
081 St.Lorenzen,23,,23,16,39
081 St.Lorenzen,24,,30,22,52
081 St.Lorenzen,25,,26,33,59
081 St.Lorenzen,26,,25,21,46
081 St.Lorenzen,27,,23,23,46
081 St.Lorenzen,28,,22,15,37
081 St.Lorenzen,29,,20,17,37
081 St.Lorenzen,30,,18,24,42
081 St.Lorenzen,31,,19,19,38
081 St.Lorenzen,32,,13,31,44
081 St.Lorenzen,33,,27,26,53
081 St.Lorenzen,34,,24,21,45
081 St.Lorenzen,35,,29,16,45
081 St.Lorenzen,36,,30,22,52
081 St.Lorenzen,37,,21,25,46
081 St.Lorenzen,38,,17,28,45
081 St.Lorenzen,39,,26,32,58
081 St.Lorenzen,40,,27,20,47
081 St.Lorenzen,41,,29,13,42
081 St.Lorenzen,42,,24,17,41
081 St.Lorenzen,43,,26,29,55
081 St.Lorenzen,44,,29,32,61
081 St.Lorenzen,45,,35,41,76
081 St.Lorenzen,46,,40,33,73
081 St.Lorenzen,47,,36,30,66
081 St.Lorenzen,48,,31,29,60
081 St.Lorenzen,49,,22,33,55
081 St.Lorenzen,50,,44,36,80
081 St.Lorenzen,51,,28,40,68
081 St.Lorenzen,52,,37,31,68
081 St.Lorenzen,53,,33,27,60
081 St.Lorenzen,54,,37,24,61
081 St.Lorenzen,55,,32,32,64
081 St.Lorenzen,56,,29,35,64
081 St.Lorenzen,57,,24,38,62
081 St.Lorenzen,58,,30,20,50
081 St.Lorenzen,59,,32,25,57
081 St.Lorenzen,60,,28,34,62
081 St.Lorenzen,61,,22,27,49
081 St.Lorenzen,62,,23,29,52
081 St.Lorenzen,63,,16,14,30
081 St.Lorenzen,64,,12,19,31
081 St.Lorenzen,65,,22,15,37
081 St.Lorenzen,66,,16,11,27
081 St.Lorenzen,67,,13,14,27
081 St.Lorenzen,68,,17,18,35
081 St.Lorenzen,69,,10,22,32
081 St.Lorenzen,70,,14,11,25
081 St.Lorenzen,71,,17,8,25
081 St.Lorenzen,72,,16,9,25
081 St.Lorenzen,73,,8,18,26
081 St.Lorenzen,74,,14,14,28
081 St.Lorenzen,75,,9,15,24
081 St.Lorenzen,76,,16,18,34
081 St.Lorenzen,77,,15,15,30
081 St.Lorenzen,78,,11,11,22
081 St.Lorenzen,79,,10,16,26
081 St.Lorenzen,80,,11,10,21
081 St.Lorenzen,81,,17,15,32
081 St.Lorenzen,82,,7,12,19
081 St.Lorenzen,83,,7,10,17
081 St.Lorenzen,84,,11,7,18
081 St.Lorenzen,85,,6,7,13
081 St.Lorenzen,86,,4,9,13
081 St.Lorenzen,87,,4,11,15
081 St.Lorenzen,88,,2,3,5
081 St.Lorenzen,89,,6,8,14
081 St.Lorenzen,90,,3,5,8
081 St.Lorenzen,91,,3,1,4
081 St.Lorenzen,92,,3,3,6
081 St.Lorenzen,93,,1,6,7
081 St.Lorenzen,94,,-,4,4
081 St.Lorenzen,95,,-,4,4
081 St.Lorenzen,98,,-,1,1
082 St.Martin in Thurn,0,,11,7,18
082 St.Martin in Thurn,1,,8,16,24
082 St.Martin in Thurn,2,,8,7,15
082 St.Martin in Thurn,3,,11,6,17
082 St.Martin in Thurn,4,,14,15,29
082 St.Martin in Thurn,5,,12,7,19
082 St.Martin in Thurn,6,,6,7,13
082 St.Martin in Thurn,7,,13,6,19
082 St.Martin in Thurn,8,,5,7,12
082 St.Martin in Thurn,9,,5,6,11
082 St.Martin in Thurn,10,,7,5,12
082 St.Martin in Thurn,11,,3,10,13
082 St.Martin in Thurn,12,,9,14,23
082 St.Martin in Thurn,13,,10,9,19
082 St.Martin in Thurn,14,,17,13,30
082 St.Martin in Thurn,15,,4,6,10
082 St.Martin in Thurn,16,,15,9,24
082 St.Martin in Thurn,17,,8,15,23
082 St.Martin in Thurn,18,,7,9,16
082 St.Martin in Thurn,19,,9,21,30
082 St.Martin in Thurn,20,,11,11,22
082 St.Martin in Thurn,21,,16,9,25
082 St.Martin in Thurn,22,,23,14,37
082 St.Martin in Thurn,23,,15,13,28
082 St.Martin in Thurn,24,,15,10,25
082 St.Martin in Thurn,25,,8,12,20
082 St.Martin in Thurn,26,,17,12,29
082 St.Martin in Thurn,27,,13,13,26
082 St.Martin in Thurn,28,,4,14,18
082 St.Martin in Thurn,29,,18,11,29
082 St.Martin in Thurn,30,,7,9,16
082 St.Martin in Thurn,31,,13,10,23
082 St.Martin in Thurn,32,,11,12,23
082 St.Martin in Thurn,33,,12,11,23
082 St.Martin in Thurn,34,,9,6,15
082 St.Martin in Thurn,35,,11,12,23
082 St.Martin in Thurn,36,,14,13,27
082 St.Martin in Thurn,37,,14,6,20
082 St.Martin in Thurn,38,,11,7,18
082 St.Martin in Thurn,39,,7,10,17
082 St.Martin in Thurn,40,,19,9,28
082 St.Martin in Thurn,41,,13,11,24
082 St.Martin in Thurn,42,,12,10,22
082 St.Martin in Thurn,43,,8,11,19
082 St.Martin in Thurn,44,,7,11,18
082 St.Martin in Thurn,45,,11,12,23
082 St.Martin in Thurn,46,,14,9,23
082 St.Martin in Thurn,47,,16,14,30
082 St.Martin in Thurn,48,,13,16,29
082 St.Martin in Thurn,49,,18,15,33
082 St.Martin in Thurn,50,,15,14,29
082 St.Martin in Thurn,51,,13,10,23
082 St.Martin in Thurn,52,,14,25,39
082 St.Martin in Thurn,53,,16,23,39
082 St.Martin in Thurn,54,,11,15,26
082 St.Martin in Thurn,55,,14,14,28
082 St.Martin in Thurn,56,,15,15,30
082 St.Martin in Thurn,57,,15,19,34
082 St.Martin in Thurn,58,,14,7,21
082 St.Martin in Thurn,59,,12,9,21
082 St.Martin in Thurn,60,,12,8,20
082 St.Martin in Thurn,61,,12,10,22
082 St.Martin in Thurn,62,,7,6,13
082 St.Martin in Thurn,63,,13,9,22
082 St.Martin in Thurn,64,,8,8,16
082 St.Martin in Thurn,65,,5,9,14
082 St.Martin in Thurn,66,,1,3,4
082 St.Martin in Thurn,67,,8,7,15
082 St.Martin in Thurn,68,,9,6,15
082 St.Martin in Thurn,69,,3,6,9
082 St.Martin in Thurn,70,,7,7,14
082 St.Martin in Thurn,71,,9,7,16
082 St.Martin in Thurn,72,,7,7,14
082 St.Martin in Thurn,73,,7,4,11
082 St.Martin in Thurn,74,,10,8,18
082 St.Martin in Thurn,75,,3,8,11
082 St.Martin in Thurn,76,,7,6,13
082 St.Martin in Thurn,77,,3,4,7
082 St.Martin in Thurn,78,,2,4,6
082 St.Martin in Thurn,79,,6,6,12
082 St.Martin in Thurn,80,,8,6,14
082 St.Martin in Thurn,81,,4,11,15
082 St.Martin in Thurn,82,,4,5,9
082 St.Martin in Thurn,83,,5,3,8
082 St.Martin in Thurn,84,,3,3,6
082 St.Martin in Thurn,85,,3,6,9
082 St.Martin in Thurn,86,,7,6,13
082 St.Martin in Thurn,87,,4,5,9
082 St.Martin in Thurn,88,,1,6,7
082 St.Martin in Thurn,89,,3,3,6
082 St.Martin in Thurn,90,,1,3,4
082 St.Martin in Thurn,91,,1,2,3
082 St.Martin in Thurn,92,,-,1,1
082 St.Martin in Thurn,93,,1,2,3
082 St.Martin in Thurn,94,,1,2,3
082 St.Martin in Thurn,95,,-,3,3
082 St.Martin in Thurn,96,,-,1,1
082 St.Martin in Thurn,99,,-,1,1
083 St.Martin in Passeier,0,,21,14,35
083 St.Martin in Passeier,1,,16,22,38
083 St.Martin in Passeier,2,,15,21,36
083 St.Martin in Passeier,3,,18,24,42
083 St.Martin in Passeier,4,,21,10,31
083 St.Martin in Passeier,5,,20,14,34
083 St.Martin in Passeier,6,,21,26,47
083 St.Martin in Passeier,7,,12,22,34
083 St.Martin in Passeier,8,,24,18,42
083 St.Martin in Passeier,9,,15,22,37
083 St.Martin in Passeier,10,,20,25,45
083 St.Martin in Passeier,11,,16,21,37
083 St.Martin in Passeier,12,,23,17,40
083 St.Martin in Passeier,13,,21,19,40
083 St.Martin in Passeier,14,,20,19,39
083 St.Martin in Passeier,15,,18,17,35
083 St.Martin in Passeier,16,,15,12,27
083 St.Martin in Passeier,17,,18,18,36
083 St.Martin in Passeier,18,,14,23,37
083 St.Martin in Passeier,19,,9,21,30
083 St.Martin in Passeier,20,,21,21,42
083 St.Martin in Passeier,21,,26,27,53
083 St.Martin in Passeier,22,,22,20,42
083 St.Martin in Passeier,23,,22,15,37
083 St.Martin in Passeier,24,,23,20,43
083 St.Martin in Passeier,25,,21,23,44
083 St.Martin in Passeier,26,,22,20,42
083 St.Martin in Passeier,27,,23,24,47
083 St.Martin in Passeier,28,,21,20,41
083 St.Martin in Passeier,29,,15,20,35
083 St.Martin in Passeier,30,,12,21,33
083 St.Martin in Passeier,31,,18,23,41
083 St.Martin in Passeier,32,,28,21,49
083 St.Martin in Passeier,33,,22,29,51
083 St.Martin in Passeier,34,,23,29,52
083 St.Martin in Passeier,35,,20,13,33
083 St.Martin in Passeier,36,,24,16,40
083 St.Martin in Passeier,37,,24,24,48
083 St.Martin in Passeier,38,,21,25,46
083 St.Martin in Passeier,39,,11,19,30
083 St.Martin in Passeier,40,,32,17,49
083 St.Martin in Passeier,41,,29,21,50
083 St.Martin in Passeier,42,,18,19,37
083 St.Martin in Passeier,43,,20,21,41
083 St.Martin in Passeier,44,,24,25,49
083 St.Martin in Passeier,45,,26,25,51
083 St.Martin in Passeier,46,,22,21,43
083 St.Martin in Passeier,47,,24,23,47
083 St.Martin in Passeier,48,,30,24,54
083 St.Martin in Passeier,49,,27,26,53
083 St.Martin in Passeier,50,,25,21,46
083 St.Martin in Passeier,51,,22,27,49
083 St.Martin in Passeier,52,,27,30,57
083 St.Martin in Passeier,53,,33,24,57
083 St.Martin in Passeier,54,,18,19,37
083 St.Martin in Passeier,55,,30,19,49
083 St.Martin in Passeier,56,,24,31,55
083 St.Martin in Passeier,57,,32,22,54
083 St.Martin in Passeier,58,,25,20,45
083 St.Martin in Passeier,59,,20,24,44
083 St.Martin in Passeier,60,,25,20,45
083 St.Martin in Passeier,61,,25,12,37
083 St.Martin in Passeier,62,,18,17,35
083 St.Martin in Passeier,63,,26,16,42
083 St.Martin in Passeier,64,,10,13,23
083 St.Martin in Passeier,65,,21,15,36
083 St.Martin in Passeier,66,,6,20,26
083 St.Martin in Passeier,67,,22,11,33
083 St.Martin in Passeier,68,,12,15,27
083 St.Martin in Passeier,69,,14,11,25
083 St.Martin in Passeier,70,,5,9,14
083 St.Martin in Passeier,71,,14,14,28
083 St.Martin in Passeier,72,,10,9,19
083 St.Martin in Passeier,73,,10,10,20
083 St.Martin in Passeier,74,,16,11,27
083 St.Martin in Passeier,75,,11,11,22
083 St.Martin in Passeier,76,,11,14,25
083 St.Martin in Passeier,77,,6,14,20
083 St.Martin in Passeier,78,,4,11,15
083 St.Martin in Passeier,79,,6,13,19
083 St.Martin in Passeier,80,,6,5,11
083 St.Martin in Passeier,81,,9,18,27
083 St.Martin in Passeier,82,,11,7,18
083 St.Martin in Passeier,83,,6,11,17
083 St.Martin in Passeier,84,,12,7,19
083 St.Martin in Passeier,85,,5,6,11
083 St.Martin in Passeier,86,,3,7,10
083 St.Martin in Passeier,87,,3,6,9
083 St.Martin in Passeier,88,,2,6,8
083 St.Martin in Passeier,89,,1,5,6
083 St.Martin in Passeier,90,,1,4,5
083 St.Martin in Passeier,91,,2,2,4
083 St.Martin in Passeier,92,,-,7,7
083 St.Martin in Passeier,93,,1,1,2
083 St.Martin in Passeier,94,,-,2,2
083 St.Martin in Passeier,95,,1,-,1
083 St.Martin in Passeier,97,,-,2,2
084 St.Pankraz,0,,9,9,18
084 St.Pankraz,1,,6,3,9
084 St.Pankraz,2,,10,6,16
084 St.Pankraz,3,,3,3,6
084 St.Pankraz,4,,2,9,11
084 St.Pankraz,5,,6,3,9
084 St.Pankraz,6,,4,2,6
084 St.Pankraz,7,,8,4,12
084 St.Pankraz,8,,8,5,13
084 St.Pankraz,9,,9,12,21
084 St.Pankraz,10,,8,13,21
084 St.Pankraz,11,,9,11,20
084 St.Pankraz,12,,8,12,20
084 St.Pankraz,13,,11,11,22
084 St.Pankraz,14,,13,9,22
084 St.Pankraz,15,,14,8,22
084 St.Pankraz,16,,7,4,11
084 St.Pankraz,17,,13,15,28
084 St.Pankraz,18,,12,14,26
084 St.Pankraz,19,,8,4,12
084 St.Pankraz,20,,13,6,19
084 St.Pankraz,21,,7,11,18
084 St.Pankraz,22,,9,10,19
084 St.Pankraz,23,,10,7,17
084 St.Pankraz,24,,8,6,14
084 St.Pankraz,25,,5,9,14
084 St.Pankraz,26,,10,8,18
084 St.Pankraz,27,,8,14,22
084 St.Pankraz,28,,8,6,14
084 St.Pankraz,29,,12,16,28
084 St.Pankraz,30,,6,8,14
084 St.Pankraz,31,,7,4,11
084 St.Pankraz,32,,8,1,9
084 St.Pankraz,33,,6,3,9
084 St.Pankraz,34,,9,4,13
084 St.Pankraz,35,,9,4,13
084 St.Pankraz,36,,15,6,21
084 St.Pankraz,37,,6,15,21
084 St.Pankraz,38,,11,9,20
084 St.Pankraz,39,,3,7,10
084 St.Pankraz,40,,12,8,20
084 St.Pankraz,41,,11,9,20
084 St.Pankraz,42,,6,8,14
084 St.Pankraz,43,,8,14,22
084 St.Pankraz,44,,15,12,27
084 St.Pankraz,45,,13,5,18
084 St.Pankraz,46,,10,19,29
084 St.Pankraz,47,,9,12,21
084 St.Pankraz,48,,14,12,26
084 St.Pankraz,49,,19,10,29
084 St.Pankraz,50,,16,17,33
084 St.Pankraz,51,,7,17,24
084 St.Pankraz,52,,14,7,21
084 St.Pankraz,53,,19,13,32
084 St.Pankraz,54,,13,12,25
084 St.Pankraz,55,,10,8,18
084 St.Pankraz,56,,14,8,22
084 St.Pankraz,57,,12,13,25
084 St.Pankraz,58,,12,4,16
084 St.Pankraz,59,,11,13,24
084 St.Pankraz,60,,7,9,16
084 St.Pankraz,61,,9,8,17
084 St.Pankraz,62,,10,16,26
084 St.Pankraz,63,,6,5,11
084 St.Pankraz,64,,11,7,18
084 St.Pankraz,65,,10,11,21
084 St.Pankraz,66,,16,8,24
084 St.Pankraz,67,,5,3,8
084 St.Pankraz,68,,10,5,15
084 St.Pankraz,69,,8,5,13
084 St.Pankraz,70,,6,2,8
084 St.Pankraz,71,,8,6,14
084 St.Pankraz,72,,2,7,9
084 St.Pankraz,73,,2,5,7
084 St.Pankraz,74,,4,7,11
084 St.Pankraz,75,,9,14,23
084 St.Pankraz,76,,9,14,23
084 St.Pankraz,77,,6,11,17
084 St.Pankraz,78,,6,6,12
084 St.Pankraz,79,,8,7,15
084 St.Pankraz,80,,4,10,14
084 St.Pankraz,81,,9,7,16
084 St.Pankraz,82,,5,2,7
084 St.Pankraz,83,,5,2,7
084 St.Pankraz,84,,3,4,7
084 St.Pankraz,85,,6,2,8
084 St.Pankraz,86,,6,8,14
084 St.Pankraz,87,,3,4,7
084 St.Pankraz,88,,2,5,7
084 St.Pankraz,89,,4,9,13
084 St.Pankraz,90,,2,5,7
084 St.Pankraz,91,,3,3,6
084 St.Pankraz,92,,-,1,1
084 St.Pankraz,93,,1,-,1
084 St.Pankraz,94,,-,1,1
084 St.Pankraz,95,,1,-,1
084 St.Pankraz,96,,-,2,2
084 St.Pankraz,98,,-,1,1
084 St.Pankraz,99,,-,1,1
085 St.Christina in Gröden,0,,11,11,22
085 St.Christina in Gröden,1,,14,10,24
085 St.Christina in Gröden,2,,10,14,24
085 St.Christina in Gröden,3,,11,7,18
085 St.Christina in Gröden,4,,10,12,22
085 St.Christina in Gröden,5,,12,8,20
085 St.Christina in Gröden,6,,8,10,18
085 St.Christina in Gröden,7,,11,8,19
085 St.Christina in Gröden,8,,10,6,16
085 St.Christina in Gröden,9,,9,5,14
085 St.Christina in Gröden,10,,12,8,20
085 St.Christina in Gröden,11,,9,7,16
085 St.Christina in Gröden,12,,7,10,17
085 St.Christina in Gröden,13,,12,10,22
085 St.Christina in Gröden,14,,13,11,24
085 St.Christina in Gröden,15,,9,7,16
085 St.Christina in Gröden,16,,10,14,24
085 St.Christina in Gröden,17,,11,12,23
085 St.Christina in Gröden,18,,20,12,32
085 St.Christina in Gröden,19,,20,8,28
085 St.Christina in Gröden,20,,11,15,26
085 St.Christina in Gröden,21,,8,10,18
085 St.Christina in Gröden,22,,12,7,19
085 St.Christina in Gröden,23,,15,11,26
085 St.Christina in Gröden,24,,8,16,24
085 St.Christina in Gröden,25,,11,10,21
085 St.Christina in Gröden,26,,18,18,36
085 St.Christina in Gröden,27,,16,15,31
085 St.Christina in Gröden,28,,10,16,26
085 St.Christina in Gröden,29,,5,11,16
085 St.Christina in Gröden,30,,11,10,21
085 St.Christina in Gröden,31,,11,8,19
085 St.Christina in Gröden,32,,14,13,27
085 St.Christina in Gröden,33,,9,10,19
085 St.Christina in Gröden,34,,11,9,20
085 St.Christina in Gröden,35,,19,12,31
085 St.Christina in Gröden,36,,11,9,20
085 St.Christina in Gröden,37,,6,13,19
085 St.Christina in Gröden,38,,14,18,32
085 St.Christina in Gröden,39,,13,12,25
085 St.Christina in Gröden,40,,3,9,12
085 St.Christina in Gröden,41,,11,12,23
085 St.Christina in Gröden,42,,14,16,30
085 St.Christina in Gröden,43,,11,13,24
085 St.Christina in Gröden,44,,14,26,40
085 St.Christina in Gröden,45,,10,13,23
085 St.Christina in Gröden,46,,18,11,29
085 St.Christina in Gröden,47,,16,12,28
085 St.Christina in Gröden,48,,20,21,41
085 St.Christina in Gröden,49,,20,13,33
085 St.Christina in Gröden,50,,26,26,52
085 St.Christina in Gröden,51,,13,14,27
085 St.Christina in Gröden,52,,18,11,29
085 St.Christina in Gröden,53,,12,18,30
085 St.Christina in Gröden,54,,12,20,32
085 St.Christina in Gröden,55,,11,17,28
085 St.Christina in Gröden,56,,17,15,32
085 St.Christina in Gröden,57,,20,15,35
085 St.Christina in Gröden,58,,23,18,41
085 St.Christina in Gröden,59,,10,9,19
085 St.Christina in Gröden,60,,7,13,20
085 St.Christina in Gröden,61,,16,11,27
085 St.Christina in Gröden,62,,11,12,23
085 St.Christina in Gröden,63,,9,9,18
085 St.Christina in Gröden,64,,11,15,26
085 St.Christina in Gröden,65,,9,10,19
085 St.Christina in Gröden,66,,5,6,11
085 St.Christina in Gröden,67,,10,5,15
085 St.Christina in Gröden,68,,6,5,11
085 St.Christina in Gröden,69,,8,9,17
085 St.Christina in Gröden,70,,8,5,13
085 St.Christina in Gröden,71,,6,9,15
085 St.Christina in Gröden,72,,7,9,16
085 St.Christina in Gröden,73,,6,7,13
085 St.Christina in Gröden,74,,4,12,16
085 St.Christina in Gröden,75,,9,14,23
085 St.Christina in Gröden,76,,9,4,13
085 St.Christina in Gröden,77,,11,6,17
085 St.Christina in Gröden,78,,7,8,15
085 St.Christina in Gröden,79,,6,7,13
085 St.Christina in Gröden,80,,6,7,13
085 St.Christina in Gröden,81,,7,4,11
085 St.Christina in Gröden,82,,9,7,16
085 St.Christina in Gröden,83,,9,2,11
085 St.Christina in Gröden,84,,6,10,16
085 St.Christina in Gröden,85,,4,7,11
085 St.Christina in Gröden,86,,5,5,10
085 St.Christina in Gröden,87,,2,4,6
085 St.Christina in Gröden,88,,6,3,9
085 St.Christina in Gröden,89,,1,8,9
085 St.Christina in Gröden,90,,1,2,3
085 St.Christina in Gröden,91,,4,5,9
085 St.Christina in Gröden,92,,1,-,1
085 St.Christina in Gröden,93,,1,-,1
085 St.Christina in Gröden,95,,-,2,2
085 St.Christina in Gröden,96,,-,2,2
085 St.Christina in Gröden,99,,-,1,1
086 Sarntal,0,,34,45,79
086 Sarntal,1,,37,43,80
086 Sarntal,2,,40,36,76
086 Sarntal,3,,54,34,88
086 Sarntal,4,,49,41,90
086 Sarntal,5,,48,32,80
086 Sarntal,6,,41,47,88
086 Sarntal,7,,48,44,92
086 Sarntal,8,,40,38,78
086 Sarntal,9,,36,36,72
086 Sarntal,10,,40,57,97
086 Sarntal,11,,54,41,95
086 Sarntal,12,,43,50,93
086 Sarntal,13,,39,37,76
086 Sarntal,14,,39,41,80
086 Sarntal,15,,47,33,80
086 Sarntal,16,,28,41,69
086 Sarntal,17,,49,25,74
086 Sarntal,18,,36,42,78
086 Sarntal,19,,35,35,70
086 Sarntal,20,,53,44,97
086 Sarntal,21,,44,46,90
086 Sarntal,22,,43,46,89
086 Sarntal,23,,45,42,87
086 Sarntal,24,,33,44,77
086 Sarntal,25,,35,44,79
086 Sarntal,26,,43,40,83
086 Sarntal,27,,49,53,102
086 Sarntal,28,,43,27,70
086 Sarntal,29,,54,32,86
086 Sarntal,30,,48,47,95
086 Sarntal,31,,39,39,78
086 Sarntal,32,,37,40,77
086 Sarntal,33,,42,40,82
086 Sarntal,34,,40,43,83
086 Sarntal,35,,54,42,96
086 Sarntal,36,,54,35,89
086 Sarntal,37,,50,50,100
086 Sarntal,38,,53,38,91
086 Sarntal,39,,56,52,108
086 Sarntal,40,,55,61,116
086 Sarntal,41,,54,44,98
086 Sarntal,42,,43,35,78
086 Sarntal,43,,56,51,107
086 Sarntal,44,,44,58,102
086 Sarntal,45,,57,67,124
086 Sarntal,46,,68,41,109
086 Sarntal,47,,45,45,90
086 Sarntal,48,,63,59,122
086 Sarntal,49,,64,54,118
086 Sarntal,50,,53,44,97
086 Sarntal,51,,56,50,106
086 Sarntal,52,,49,46,95
086 Sarntal,53,,65,57,122
086 Sarntal,54,,58,64,122
086 Sarntal,55,,41,48,89
086 Sarntal,56,,60,36,96
086 Sarntal,57,,40,50,90
086 Sarntal,58,,66,43,109
086 Sarntal,59,,38,41,79
086 Sarntal,60,,51,44,95
086 Sarntal,61,,30,40,70
086 Sarntal,62,,36,30,66
086 Sarntal,63,,36,40,76
086 Sarntal,64,,36,29,65
086 Sarntal,65,,40,29,69
086 Sarntal,66,,32,40,72
086 Sarntal,67,,43,32,75
086 Sarntal,68,,37,32,69
086 Sarntal,69,,46,28,74
086 Sarntal,70,,30,39,69
086 Sarntal,71,,30,29,59
086 Sarntal,72,,33,36,69
086 Sarntal,73,,24,29,53
086 Sarntal,74,,26,27,53
086 Sarntal,75,,35,36,71
086 Sarntal,76,,29,34,63
086 Sarntal,77,,26,27,53
086 Sarntal,78,,25,40,65
086 Sarntal,79,,31,27,58
086 Sarntal,80,,22,27,49
086 Sarntal,81,,14,27,41
086 Sarntal,82,,12,19,31
086 Sarntal,83,,11,17,28
086 Sarntal,84,,10,16,26
086 Sarntal,85,,11,12,23
086 Sarntal,86,,9,16,25
086 Sarntal,87,,7,14,21
086 Sarntal,88,,5,9,14
086 Sarntal,89,,7,16,23
086 Sarntal,90,,5,7,12
086 Sarntal,91,,4,17,21
086 Sarntal,92,,2,5,7
086 Sarntal,93,,3,3,6
086 Sarntal,94,,-,6,6
086 Sarntal,95,,-,3,3
086 Sarntal,96,,-,4,4
086 Sarntal,97,,-,1,1
086 Sarntal,99,,-,1,1
087 Schenna,0,,15,14,29
087 Schenna,1,,17,14,31
087 Schenna,2,,17,13,30
087 Schenna,3,,18,20,38
087 Schenna,4,,18,15,33
087 Schenna,5,,11,13,24
087 Schenna,6,,16,16,32
087 Schenna,7,,13,13,26
087 Schenna,8,,10,20,30
087 Schenna,9,,11,18,29
087 Schenna,10,,11,19,30
087 Schenna,11,,18,13,31
087 Schenna,12,,20,26,46
087 Schenna,13,,11,9,20
087 Schenna,14,,19,15,34
087 Schenna,15,,14,15,29
087 Schenna,16,,15,19,34
087 Schenna,17,,19,14,33
087 Schenna,18,,19,21,40
087 Schenna,19,,24,18,42
087 Schenna,20,,18,9,27
087 Schenna,21,,13,21,34
087 Schenna,22,,18,19,37
087 Schenna,23,,20,18,38
087 Schenna,24,,22,17,39
087 Schenna,25,,12,11,23
087 Schenna,26,,18,17,35
087 Schenna,27,,9,18,27
087 Schenna,28,,15,19,34
087 Schenna,29,,24,11,35
087 Schenna,30,,21,15,36
087 Schenna,31,,18,10,28
087 Schenna,32,,19,14,33
087 Schenna,33,,10,14,24
087 Schenna,34,,16,19,35
087 Schenna,35,,18,13,31
087 Schenna,36,,12,19,31
087 Schenna,37,,20,19,39
087 Schenna,38,,18,29,47
087 Schenna,39,,27,17,44
087 Schenna,40,,17,18,35
087 Schenna,41,,23,25,48
087 Schenna,42,,21,13,34
087 Schenna,43,,17,31,48
087 Schenna,44,,24,20,44
087 Schenna,45,,28,20,48
087 Schenna,46,,26,16,42
087 Schenna,47,,27,27,54
087 Schenna,48,,22,22,44
087 Schenna,49,,26,22,48
087 Schenna,50,,25,22,47
087 Schenna,51,,27,17,44
087 Schenna,52,,19,18,37
087 Schenna,53,,29,29,58
087 Schenna,54,,18,26,44
087 Schenna,55,,22,20,42
087 Schenna,56,,20,11,31
087 Schenna,57,,30,23,53
087 Schenna,58,,28,24,52
087 Schenna,59,,13,13,26
087 Schenna,60,,20,20,40
087 Schenna,61,,13,18,31
087 Schenna,62,,15,18,33
087 Schenna,63,,9,18,27
087 Schenna,64,,15,16,31
087 Schenna,65,,10,16,26
087 Schenna,66,,10,14,24
087 Schenna,67,,14,11,25
087 Schenna,68,,16,14,30
087 Schenna,69,,17,18,35
087 Schenna,70,,12,17,29
087 Schenna,71,,16,18,34
087 Schenna,72,,14,18,32
087 Schenna,73,,11,13,24
087 Schenna,74,,14,8,22
087 Schenna,75,,18,12,30
087 Schenna,76,,5,17,22
087 Schenna,77,,12,10,22
087 Schenna,78,,10,9,19
087 Schenna,79,,7,11,18
087 Schenna,80,,11,15,26
087 Schenna,81,,4,9,13
087 Schenna,82,,6,10,16
087 Schenna,83,,9,6,15
087 Schenna,84,,10,9,19
087 Schenna,85,,5,4,9
087 Schenna,86,,3,8,11
087 Schenna,87,,4,5,9
087 Schenna,88,,6,3,9
087 Schenna,89,,1,6,7
087 Schenna,90,,3,4,7
087 Schenna,91,,1,3,4
087 Schenna,92,,3,3,6
087 Schenna,93,,-,4,4
087 Schenna,94,,-,1,1
087 Schenna,95,,-,1,1
087 Schenna,96,,1,2,3
087 Schenna,97,,-,2,2
087 Schenna,99,,-,1,1
088 Mühlwald,0,,8,6,14
088 Mühlwald,1,,7,6,13
088 Mühlwald,2,,12,11,23
088 Mühlwald,3,,8,4,12
088 Mühlwald,4,,10,4,14
088 Mühlwald,5,,9,11,20
088 Mühlwald,6,,9,5,14
088 Mühlwald,7,,4,10,14
088 Mühlwald,8,,6,8,14
088 Mühlwald,9,,4,6,10
088 Mühlwald,10,,10,8,18
088 Mühlwald,11,,7,8,15
088 Mühlwald,12,,5,12,17
088 Mühlwald,13,,8,4,12
088 Mühlwald,14,,11,8,19
088 Mühlwald,15,,13,9,22
088 Mühlwald,16,,10,11,21
088 Mühlwald,17,,10,14,24
088 Mühlwald,18,,8,10,18
088 Mühlwald,19,,14,11,25
088 Mühlwald,20,,13,15,28
088 Mühlwald,21,,9,8,17
088 Mühlwald,22,,15,13,28
088 Mühlwald,23,,12,3,15
088 Mühlwald,24,,10,5,15
088 Mühlwald,25,,14,13,27
088 Mühlwald,26,,5,5,10
088 Mühlwald,27,,10,8,18
088 Mühlwald,28,,5,7,12
088 Mühlwald,29,,11,7,18
088 Mühlwald,30,,7,4,11
088 Mühlwald,31,,10,6,16
088 Mühlwald,32,,7,3,10
088 Mühlwald,33,,8,9,17
088 Mühlwald,34,,7,13,20
088 Mühlwald,35,,10,4,14
088 Mühlwald,36,,2,7,9
088 Mühlwald,37,,12,10,22
088 Mühlwald,38,,16,4,20
088 Mühlwald,39,,4,13,17
088 Mühlwald,40,,12,5,17
088 Mühlwald,41,,6,6,12
088 Mühlwald,42,,12,10,22
088 Mühlwald,43,,11,6,17
088 Mühlwald,44,,8,7,15
088 Mühlwald,45,,13,11,24
088 Mühlwald,46,,7,10,17
088 Mühlwald,47,,18,14,32
088 Mühlwald,48,,6,10,16
088 Mühlwald,49,,13,14,27
088 Mühlwald,50,,15,9,24
088 Mühlwald,51,,15,16,31
088 Mühlwald,52,,12,7,19
088 Mühlwald,53,,15,12,27
088 Mühlwald,54,,14,12,26
088 Mühlwald,55,,9,11,20
088 Mühlwald,56,,7,11,18
088 Mühlwald,57,,6,11,17
088 Mühlwald,58,,13,10,23
088 Mühlwald,59,,13,5,18
088 Mühlwald,60,,9,5,14
088 Mühlwald,61,,13,12,25
088 Mühlwald,62,,7,7,14
088 Mühlwald,63,,8,7,15
088 Mühlwald,64,,8,4,12
088 Mühlwald,65,,8,9,17
088 Mühlwald,66,,7,7,14
088 Mühlwald,67,,10,4,14
088 Mühlwald,68,,3,9,12
088 Mühlwald,69,,7,2,9
088 Mühlwald,70,,12,4,16
088 Mühlwald,71,,8,7,15
088 Mühlwald,72,,6,3,9
088 Mühlwald,73,,3,2,5
088 Mühlwald,74,,7,4,11
088 Mühlwald,75,,7,2,9
088 Mühlwald,76,,6,7,13
088 Mühlwald,77,,3,7,10
088 Mühlwald,78,,3,9,12
088 Mühlwald,79,,3,11,14
088 Mühlwald,80,,5,4,9
088 Mühlwald,81,,6,2,8
088 Mühlwald,82,,3,3,6
088 Mühlwald,83,,2,2,4
088 Mühlwald,84,,3,5,8
088 Mühlwald,85,,2,7,9
088 Mühlwald,86,,-,2,2
088 Mühlwald,87,,-,2,2
088 Mühlwald,88,,-,3,3
088 Mühlwald,89,,3,3,6
088 Mühlwald,90,,2,2,4
088 Mühlwald,91,,2,-,2
088 Mühlwald,92,,-,2,2
088 Mühlwald,93,,1,-,1
088 Mühlwald,95,,-,1,1
088 Mühlwald,96,,-,1,1
089 Wolkenstein in Gröden,0,,13,9,22
089 Wolkenstein in Gröden,1,,16,16,32
089 Wolkenstein in Gröden,2,,15,11,26
089 Wolkenstein in Gröden,3,,10,15,25
089 Wolkenstein in Gröden,4,,10,11,21
089 Wolkenstein in Gröden,5,,15,8,23
089 Wolkenstein in Gröden,6,,11,9,20
089 Wolkenstein in Gröden,7,,11,17,28
089 Wolkenstein in Gröden,8,,15,12,27
089 Wolkenstein in Gröden,9,,9,9,18
089 Wolkenstein in Gröden,10,,18,13,31
089 Wolkenstein in Gröden,11,,17,11,28
089 Wolkenstein in Gröden,12,,10,15,25
089 Wolkenstein in Gröden,13,,16,19,35
089 Wolkenstein in Gröden,14,,12,7,19
089 Wolkenstein in Gröden,15,,15,20,35
089 Wolkenstein in Gröden,16,,24,18,42
089 Wolkenstein in Gröden,17,,19,19,38
089 Wolkenstein in Gröden,18,,18,24,42
089 Wolkenstein in Gröden,19,,11,17,28
089 Wolkenstein in Gröden,20,,18,23,41
089 Wolkenstein in Gröden,21,,20,26,46
089 Wolkenstein in Gröden,22,,15,10,25
089 Wolkenstein in Gröden,23,,17,11,28
089 Wolkenstein in Gröden,24,,16,18,34
089 Wolkenstein in Gröden,25,,15,15,30
089 Wolkenstein in Gröden,26,,21,12,33
089 Wolkenstein in Gröden,27,,13,17,30
089 Wolkenstein in Gröden,28,,15,10,25
089 Wolkenstein in Gröden,29,,15,16,31
089 Wolkenstein in Gröden,30,,18,9,27
089 Wolkenstein in Gröden,31,,12,16,28
089 Wolkenstein in Gröden,32,,17,17,34
089 Wolkenstein in Gröden,33,,18,12,30
089 Wolkenstein in Gröden,34,,15,7,22
089 Wolkenstein in Gröden,35,,14,10,24
089 Wolkenstein in Gröden,36,,11,20,31
089 Wolkenstein in Gröden,37,,17,12,29
089 Wolkenstein in Gröden,38,,15,17,32
089 Wolkenstein in Gröden,39,,10,16,26
089 Wolkenstein in Gröden,40,,13,12,25
089 Wolkenstein in Gröden,41,,12,11,23
089 Wolkenstein in Gröden,42,,12,10,22
089 Wolkenstein in Gröden,43,,21,25,46
089 Wolkenstein in Gröden,44,,10,15,25
089 Wolkenstein in Gröden,45,,24,26,50
089 Wolkenstein in Gröden,46,,18,25,43
089 Wolkenstein in Gröden,47,,19,21,40
089 Wolkenstein in Gröden,48,,24,22,46
089 Wolkenstein in Gröden,49,,28,22,50
089 Wolkenstein in Gröden,50,,25,22,47
089 Wolkenstein in Gröden,51,,29,28,57
089 Wolkenstein in Gröden,52,,27,25,52
089 Wolkenstein in Gröden,53,,19,32,51
089 Wolkenstein in Gröden,54,,30,22,52
089 Wolkenstein in Gröden,55,,23,19,42
089 Wolkenstein in Gröden,56,,19,21,40
089 Wolkenstein in Gröden,57,,25,20,45
089 Wolkenstein in Gröden,58,,25,19,44
089 Wolkenstein in Gröden,59,,14,16,30
089 Wolkenstein in Gröden,60,,15,14,29
089 Wolkenstein in Gröden,61,,20,16,36
089 Wolkenstein in Gröden,62,,10,14,24
089 Wolkenstein in Gröden,63,,10,9,19
089 Wolkenstein in Gröden,64,,12,10,22
089 Wolkenstein in Gröden,65,,9,13,22
089 Wolkenstein in Gröden,66,,9,6,15
089 Wolkenstein in Gröden,67,,11,10,21
089 Wolkenstein in Gröden,68,,6,17,23
089 Wolkenstein in Gröden,69,,13,10,23
089 Wolkenstein in Gröden,70,,11,12,23
089 Wolkenstein in Gröden,71,,11,13,24
089 Wolkenstein in Gröden,72,,17,17,34
089 Wolkenstein in Gröden,73,,4,14,18
089 Wolkenstein in Gröden,74,,9,8,17
089 Wolkenstein in Gröden,75,,14,11,25
089 Wolkenstein in Gröden,76,,9,11,20
089 Wolkenstein in Gröden,77,,11,11,22
089 Wolkenstein in Gröden,78,,13,16,29
089 Wolkenstein in Gröden,79,,14,11,25
089 Wolkenstein in Gröden,80,,13,8,21
089 Wolkenstein in Gröden,81,,8,15,23
089 Wolkenstein in Gröden,82,,9,11,20
089 Wolkenstein in Gröden,83,,12,3,15
089 Wolkenstein in Gröden,84,,7,9,16
089 Wolkenstein in Gröden,85,,2,6,8
089 Wolkenstein in Gröden,86,,2,9,11
089 Wolkenstein in Gröden,87,,2,5,7
089 Wolkenstein in Gröden,88,,5,4,9
089 Wolkenstein in Gröden,89,,-,2,2
089 Wolkenstein in Gröden,90,,1,4,5
089 Wolkenstein in Gröden,91,,4,2,6
089 Wolkenstein in Gröden,92,,1,2,3
089 Wolkenstein in Gröden,93,,1,5,6
089 Wolkenstein in Gröden,94,,-,1,1
089 Wolkenstein in Gröden,95,,-,1,1
089 Wolkenstein in Gröden,96,,2,2,4
089 Wolkenstein in Gröden,97,,1,1,2
091 Schnals,0,,7,6,13
091 Schnals,1,,8,8,16
091 Schnals,2,,6,5,11
091 Schnals,3,,3,5,8
091 Schnals,4,,10,8,18
091 Schnals,5,,7,2,9
091 Schnals,6,,8,3,11
091 Schnals,7,,5,5,10
091 Schnals,8,,3,5,8
091 Schnals,9,,7,8,15
091 Schnals,10,,9,4,13
091 Schnals,11,,4,4,8
091 Schnals,12,,2,4,6
091 Schnals,13,,4,5,9
091 Schnals,14,,5,6,11
091 Schnals,15,,3,7,10
091 Schnals,16,,12,2,14
091 Schnals,17,,3,5,8
091 Schnals,18,,4,5,9
091 Schnals,19,,5,7,12
091 Schnals,20,,6,13,19
091 Schnals,21,,11,11,22
091 Schnals,22,,5,12,17
091 Schnals,23,,5,9,14
091 Schnals,24,,3,9,12
091 Schnals,25,,8,5,13
091 Schnals,26,,8,5,13
091 Schnals,27,,13,8,21
091 Schnals,28,,5,7,12
091 Schnals,29,,17,8,25
091 Schnals,30,,7,4,11
091 Schnals,31,,9,7,16
091 Schnals,32,,7,5,12
091 Schnals,33,,4,5,9
091 Schnals,34,,10,10,20
091 Schnals,35,,5,6,11
091 Schnals,36,,6,4,10
091 Schnals,37,,12,7,19
091 Schnals,38,,8,7,15
091 Schnals,39,,5,8,13
091 Schnals,40,,8,7,15
091 Schnals,41,,6,10,16
091 Schnals,42,,9,1,10
091 Schnals,43,,7,5,12
091 Schnals,44,,13,8,21
091 Schnals,45,,8,8,16
091 Schnals,46,,9,9,18
091 Schnals,47,,9,6,15
091 Schnals,48,,8,8,16
091 Schnals,49,,10,7,17
091 Schnals,50,,10,7,17
091 Schnals,51,,14,11,25
091 Schnals,52,,13,13,26
091 Schnals,53,,13,7,20
091 Schnals,54,,6,9,15
091 Schnals,55,,9,16,25
091 Schnals,56,,12,9,21
091 Schnals,57,,9,11,20
091 Schnals,58,,12,6,18
091 Schnals,59,,13,12,25
091 Schnals,60,,11,11,22
091 Schnals,61,,11,5,16
091 Schnals,62,,11,4,15
091 Schnals,63,,9,7,16
091 Schnals,64,,7,10,17
091 Schnals,65,,11,7,18
091 Schnals,66,,13,6,19
091 Schnals,67,,10,8,18
091 Schnals,68,,8,6,14
091 Schnals,69,,9,9,18
091 Schnals,70,,3,2,5
091 Schnals,71,,8,7,15
091 Schnals,72,,5,4,9
091 Schnals,73,,6,2,8
091 Schnals,74,,2,7,9
091 Schnals,75,,4,8,12
091 Schnals,76,,3,4,7
091 Schnals,77,,2,4,6
091 Schnals,78,,6,7,13
091 Schnals,79,,2,7,9
091 Schnals,80,,1,10,11
091 Schnals,81,,4,4,8
091 Schnals,82,,4,2,6
091 Schnals,83,,1,4,5
091 Schnals,84,,2,3,5
091 Schnals,85,,3,2,5
091 Schnals,86,,2,7,9
091 Schnals,87,,1,4,5
091 Schnals,88,,-,2,2
091 Schnals,89,,2,4,6
091 Schnals,90,,1,2,3
091 Schnals,92,,-,1,1
091 Schnals,93,,-,1,1
091 Schnals,94,,-,1,1
091 Schnals,96,,-,1,1
091 Schnals,100,,1,1,2
092 Sexten,0,,3,6,9
092 Sexten,1,,9,10,19
092 Sexten,2,,10,6,16
092 Sexten,3,,3,10,13
092 Sexten,4,,6,3,9
092 Sexten,5,,11,7,18
092 Sexten,6,,9,8,17
092 Sexten,7,,10,2,12
092 Sexten,8,,9,6,15
092 Sexten,9,,12,5,17
092 Sexten,10,,6,9,15
092 Sexten,11,,8,16,24
092 Sexten,12,,4,7,11
092 Sexten,13,,11,8,19
092 Sexten,14,,14,5,19
092 Sexten,15,,11,11,22
092 Sexten,16,,17,18,35
092 Sexten,17,,16,12,28
092 Sexten,18,,10,19,29
092 Sexten,19,,9,13,22
092 Sexten,20,,14,7,21
092 Sexten,21,,14,11,25
092 Sexten,22,,14,10,24
092 Sexten,23,,15,14,29
092 Sexten,24,,15,8,23
092 Sexten,25,,9,6,15
092 Sexten,26,,12,10,22
092 Sexten,27,,11,11,22
092 Sexten,28,,13,16,29
092 Sexten,29,,10,9,19
092 Sexten,30,,9,5,14
092 Sexten,31,,11,12,23
092 Sexten,32,,7,9,16
092 Sexten,33,,11,8,19
092 Sexten,34,,8,6,14
092 Sexten,35,,10,7,17
092 Sexten,36,,11,8,19
092 Sexten,37,,13,9,22
092 Sexten,38,,12,9,21
092 Sexten,39,,14,24,38
092 Sexten,40,,12,10,22
092 Sexten,41,,7,5,12
092 Sexten,42,,18,14,32
092 Sexten,43,,8,14,22
092 Sexten,44,,10,5,15
092 Sexten,45,,8,9,17
092 Sexten,46,,11,18,29
092 Sexten,47,,14,17,31
092 Sexten,48,,12,20,32
092 Sexten,49,,18,17,35
092 Sexten,50,,16,17,33
092 Sexten,51,,23,20,43
092 Sexten,52,,14,18,32
092 Sexten,53,,19,18,37
092 Sexten,54,,21,15,36
092 Sexten,55,,27,19,46
092 Sexten,56,,14,17,31
092 Sexten,57,,18,12,30
092 Sexten,58,,19,9,28
092 Sexten,59,,15,14,29
092 Sexten,60,,20,15,35
092 Sexten,61,,17,11,28
092 Sexten,62,,11,15,26
092 Sexten,63,,9,11,20
092 Sexten,64,,11,12,23
092 Sexten,65,,3,10,13
092 Sexten,66,,5,12,17
092 Sexten,67,,7,9,16
092 Sexten,68,,11,7,18
092 Sexten,69,,5,5,10
092 Sexten,70,,9,7,16
092 Sexten,71,,9,3,12
092 Sexten,72,,4,8,12
092 Sexten,73,,6,4,10
092 Sexten,74,,5,10,15
092 Sexten,75,,8,4,12
092 Sexten,76,,5,4,9
092 Sexten,77,,6,15,21
092 Sexten,78,,6,11,17
092 Sexten,79,,2,9,11
092 Sexten,80,,11,9,20
092 Sexten,81,,6,4,10
092 Sexten,82,,5,8,13
092 Sexten,83,,5,11,16
092 Sexten,84,,5,4,9
092 Sexten,85,,2,8,10
092 Sexten,86,,3,6,9
092 Sexten,87,,1,9,10
092 Sexten,88,,2,6,8
092 Sexten,89,,1,6,7
092 Sexten,90,,4,5,9
092 Sexten,91,,1,7,8
092 Sexten,92,,2,3,5
092 Sexten,93,,-,5,5
092 Sexten,94,,-,2,2
092 Sexten,95,,1,2,3
092 Sexten,96,,-,3,3
093 Schlanders,0,,43,31,74
093 Schlanders,1,,36,36,72
093 Schlanders,2,,22,37,59
093 Schlanders,3,,37,39,76
093 Schlanders,4,,33,35,68
093 Schlanders,5,,29,26,55
093 Schlanders,6,,39,39,78
093 Schlanders,7,,31,22,53
093 Schlanders,8,,32,28,60
093 Schlanders,9,,23,36,59
093 Schlanders,10,,39,24,63
093 Schlanders,11,,33,30,63
093 Schlanders,12,,29,26,55
093 Schlanders,13,,29,36,65
093 Schlanders,14,,27,35,62
093 Schlanders,15,,29,22,51
093 Schlanders,16,,27,34,61
093 Schlanders,17,,34,33,67
093 Schlanders,18,,38,38,76
093 Schlanders,19,,28,40,68
093 Schlanders,20,,38,39,77
093 Schlanders,21,,53,47,100
093 Schlanders,22,,44,38,82
093 Schlanders,23,,37,28,65
093 Schlanders,24,,44,45,89
093 Schlanders,25,,52,46,98
093 Schlanders,26,,38,45,83
093 Schlanders,27,,41,28,69
093 Schlanders,28,,53,43,96
093 Schlanders,29,,39,36,75
093 Schlanders,30,,36,40,76
093 Schlanders,31,,35,37,72
093 Schlanders,32,,41,38,79
093 Schlanders,33,,43,34,77
093 Schlanders,34,,47,43,90
093 Schlanders,35,,35,39,74
093 Schlanders,36,,45,49,94
093 Schlanders,37,,47,40,87
093 Schlanders,38,,32,42,74
093 Schlanders,39,,28,30,58
093 Schlanders,40,,42,34,76
093 Schlanders,41,,33,45,78
093 Schlanders,42,,41,23,64
093 Schlanders,43,,47,36,83
093 Schlanders,44,,47,38,85
093 Schlanders,45,,38,50,88
093 Schlanders,46,,54,39,93
093 Schlanders,47,,44,53,97
093 Schlanders,48,,47,44,91
093 Schlanders,49,,61,45,106
093 Schlanders,50,,48,41,89
093 Schlanders,51,,43,52,95
093 Schlanders,52,,45,57,102
093 Schlanders,53,,57,50,107
093 Schlanders,54,,37,46,83
093 Schlanders,55,,53,58,111
093 Schlanders,56,,46,48,94
093 Schlanders,57,,36,53,89
093 Schlanders,58,,40,36,76
093 Schlanders,59,,36,43,79
093 Schlanders,60,,47,51,98
093 Schlanders,61,,40,37,77
093 Schlanders,62,,28,34,62
093 Schlanders,63,,27,34,61
093 Schlanders,64,,30,31,61
093 Schlanders,65,,34,38,72
093 Schlanders,66,,32,21,53
093 Schlanders,67,,29,31,60
093 Schlanders,68,,22,34,56
093 Schlanders,69,,26,37,63
093 Schlanders,70,,36,25,61
093 Schlanders,71,,23,25,48
093 Schlanders,72,,21,20,41
093 Schlanders,73,,29,17,46
093 Schlanders,74,,22,34,56
093 Schlanders,75,,24,32,56
093 Schlanders,76,,28,31,59
093 Schlanders,77,,26,34,60
093 Schlanders,78,,22,23,45
093 Schlanders,79,,27,31,58
093 Schlanders,80,,12,15,27
093 Schlanders,81,,17,20,37
093 Schlanders,82,,13,20,33
093 Schlanders,83,,9,20,29
093 Schlanders,84,,8,17,25
093 Schlanders,85,,14,24,38
093 Schlanders,86,,10,11,21
093 Schlanders,87,,8,10,18
093 Schlanders,88,,8,13,21
093 Schlanders,89,,6,10,16
093 Schlanders,90,,8,11,19
093 Schlanders,91,,3,9,12
093 Schlanders,92,,2,12,14
093 Schlanders,93,,4,6,10
093 Schlanders,94,,1,3,4
093 Schlanders,95,,2,3,5
093 Schlanders,96,,-,2,2
093 Schlanders,97,,-,4,4
093 Schlanders,98,,-,1,1
093 Schlanders,102,,-,1,1
094 Schluderns,0,,11,7,18
094 Schluderns,1,,12,8,20
094 Schluderns,2,,16,7,23
094 Schluderns,3,,5,13,18
094 Schluderns,4,,12,14,26
094 Schluderns,5,,12,5,17
094 Schluderns,6,,10,11,21
094 Schluderns,7,,13,10,23
094 Schluderns,8,,8,5,13
094 Schluderns,9,,12,9,21
094 Schluderns,10,,7,2,9
094 Schluderns,11,,12,13,25
094 Schluderns,12,,8,8,16
094 Schluderns,13,,7,5,12
094 Schluderns,14,,6,10,16
094 Schluderns,15,,15,10,25
094 Schluderns,16,,15,8,23
094 Schluderns,17,,11,7,18
094 Schluderns,18,,18,9,27
094 Schluderns,19,,7,16,23
094 Schluderns,20,,5,12,17
094 Schluderns,21,,10,9,19
094 Schluderns,22,,12,14,26
094 Schluderns,23,,12,10,22
094 Schluderns,24,,10,19,29
094 Schluderns,25,,18,4,22
094 Schluderns,26,,6,10,16
094 Schluderns,27,,8,12,20
094 Schluderns,28,,16,12,28
094 Schluderns,29,,13,13,26
094 Schluderns,30,,12,11,23
094 Schluderns,31,,6,7,13
094 Schluderns,32,,6,13,19
094 Schluderns,33,,16,13,29
094 Schluderns,34,,10,11,21
094 Schluderns,35,,9,13,22
094 Schluderns,36,,13,10,23
094 Schluderns,37,,20,14,34
094 Schluderns,38,,12,14,26
094 Schluderns,39,,3,15,18
094 Schluderns,40,,12,11,23
094 Schluderns,41,,7,12,19
094 Schluderns,42,,15,15,30
094 Schluderns,43,,17,7,24
094 Schluderns,44,,21,13,34
094 Schluderns,45,,17,12,29
094 Schluderns,46,,15,12,27
094 Schluderns,47,,9,14,23
094 Schluderns,48,,8,10,18
094 Schluderns,49,,15,10,25
094 Schluderns,50,,17,16,33
094 Schluderns,51,,13,14,27
094 Schluderns,52,,19,15,34
094 Schluderns,53,,25,9,34
094 Schluderns,54,,27,12,39
094 Schluderns,55,,13,18,31
094 Schluderns,56,,12,20,32
094 Schluderns,57,,12,18,30
094 Schluderns,58,,6,5,11
094 Schluderns,59,,10,16,26
094 Schluderns,60,,9,15,24
094 Schluderns,61,,17,8,25
094 Schluderns,62,,10,16,26
094 Schluderns,63,,14,11,25
094 Schluderns,64,,13,8,21
094 Schluderns,65,,14,7,21
094 Schluderns,66,,5,5,10
094 Schluderns,67,,12,3,15
094 Schluderns,68,,7,13,20
094 Schluderns,69,,10,9,19
094 Schluderns,70,,7,8,15
094 Schluderns,71,,6,6,12
094 Schluderns,72,,5,10,15
094 Schluderns,73,,6,2,8
094 Schluderns,74,,5,10,15
094 Schluderns,75,,2,7,9
094 Schluderns,76,,5,7,12
094 Schluderns,77,,10,11,21
094 Schluderns,78,,4,5,9
094 Schluderns,79,,7,8,15
094 Schluderns,80,,7,7,14
094 Schluderns,81,,5,9,14
094 Schluderns,82,,1,6,7
094 Schluderns,83,,4,8,12
094 Schluderns,84,,6,9,15
094 Schluderns,85,,2,6,8
094 Schluderns,86,,4,5,9
094 Schluderns,87,,2,2,4
094 Schluderns,88,,3,2,5
094 Schluderns,89,,1,3,4
094 Schluderns,90,,1,3,4
094 Schluderns,91,,1,-,1
094 Schluderns,92,,1,5,6
094 Schluderns,97,,-,2,2
094 Schluderns,98,,-,1,1
095 Stilfs,0,,11,9,20
095 Stilfs,1,,5,6,11
095 Stilfs,2,,5,2,7
095 Stilfs,3,,7,5,12
095 Stilfs,4,,7,9,16
095 Stilfs,5,,5,4,9
095 Stilfs,6,,9,5,14
095 Stilfs,7,,4,2,6
095 Stilfs,8,,2,3,5
095 Stilfs,9,,5,2,7
095 Stilfs,10,,3,4,7
095 Stilfs,11,,4,4,8
095 Stilfs,12,,4,1,5
095 Stilfs,13,,7,4,11
095 Stilfs,14,,6,5,11
095 Stilfs,15,,5,6,11
095 Stilfs,16,,5,2,7
095 Stilfs,17,,4,11,15
095 Stilfs,18,,9,5,14
095 Stilfs,19,,4,6,10
095 Stilfs,20,,8,4,12
095 Stilfs,21,,10,11,21
095 Stilfs,22,,12,1,13
095 Stilfs,23,,5,5,10
095 Stilfs,24,,8,6,14
095 Stilfs,25,,6,9,15
095 Stilfs,26,,3,7,10
095 Stilfs,27,,11,2,13
095 Stilfs,28,,16,11,27
095 Stilfs,29,,7,6,13
095 Stilfs,30,,7,-,7
095 Stilfs,31,,4,4,8
095 Stilfs,32,,10,6,16
095 Stilfs,33,,6,5,11
095 Stilfs,34,,9,10,19
095 Stilfs,35,,7,3,10
095 Stilfs,36,,8,4,12
095 Stilfs,37,,10,8,18
095 Stilfs,38,,3,4,7
095 Stilfs,39,,5,7,12
095 Stilfs,40,,6,7,13
095 Stilfs,41,,6,4,10
095 Stilfs,42,,6,6,12
095 Stilfs,43,,6,8,14
095 Stilfs,44,,6,3,9
095 Stilfs,45,,9,19,28
095 Stilfs,46,,10,7,17
095 Stilfs,47,,10,11,21
095 Stilfs,48,,10,12,22
095 Stilfs,49,,9,11,20
095 Stilfs,50,,7,8,15
095 Stilfs,51,,5,8,13
095 Stilfs,52,,20,9,29
095 Stilfs,53,,13,11,24
095 Stilfs,54,,14,7,21
095 Stilfs,55,,11,6,17
095 Stilfs,56,,7,11,18
095 Stilfs,57,,9,3,12
095 Stilfs,58,,8,7,15
095 Stilfs,59,,9,9,18
095 Stilfs,60,,7,12,19
095 Stilfs,61,,11,6,17
095 Stilfs,62,,5,8,13
095 Stilfs,63,,4,4,8
095 Stilfs,64,,13,7,20
095 Stilfs,65,,7,4,11
095 Stilfs,66,,8,6,14
095 Stilfs,67,,13,8,21
095 Stilfs,68,,1,6,7
095 Stilfs,69,,5,3,8
095 Stilfs,70,,6,9,15
095 Stilfs,71,,6,3,9
095 Stilfs,72,,9,8,17
095 Stilfs,73,,2,4,6
095 Stilfs,74,,12,9,21
095 Stilfs,75,,7,6,13
095 Stilfs,76,,2,11,13
095 Stilfs,77,,6,4,10
095 Stilfs,78,,4,6,10
095 Stilfs,79,,3,5,8
095 Stilfs,80,,1,4,5
095 Stilfs,81,,4,5,9
095 Stilfs,82,,1,6,7
095 Stilfs,83,,-,4,4
095 Stilfs,84,,2,4,6
095 Stilfs,85,,2,5,7
095 Stilfs,86,,1,2,3
095 Stilfs,87,,2,1,3
095 Stilfs,88,,1,1,2
095 Stilfs,89,,1,-,1
095 Stilfs,90,,1,2,3
095 Stilfs,91,,1,2,3
095 Stilfs,92,,-,2,2
095 Stilfs,93,,1,-,1
095 Stilfs,94,,-,1,1
095 Stilfs,96,,-,2,2
095 Stilfs,97,,-,1,1
096 Terenten,0,,14,10,24
096 Terenten,1,,6,11,17
096 Terenten,2,,13,12,25
096 Terenten,3,,11,8,19
096 Terenten,4,,16,8,24
096 Terenten,5,,11,10,21
096 Terenten,6,,5,10,15
096 Terenten,7,,8,8,16
096 Terenten,8,,3,8,11
096 Terenten,9,,13,7,20
096 Terenten,10,,10,4,14
096 Terenten,11,,8,11,19
096 Terenten,12,,15,10,25
096 Terenten,13,,17,9,26
096 Terenten,14,,10,19,29
096 Terenten,15,,9,12,21
096 Terenten,16,,8,7,15
096 Terenten,17,,14,15,29
096 Terenten,18,,10,8,18
096 Terenten,19,,10,17,27
096 Terenten,20,,22,19,41
096 Terenten,21,,9,8,17
096 Terenten,22,,14,10,24
096 Terenten,23,,13,7,20
096 Terenten,24,,12,13,25
096 Terenten,25,,8,12,20
096 Terenten,26,,9,10,19
096 Terenten,27,,7,17,24
096 Terenten,28,,14,12,26
096 Terenten,29,,14,8,22
096 Terenten,30,,8,11,19
096 Terenten,31,,12,9,21
096 Terenten,32,,12,5,17
096 Terenten,33,,7,11,18
096 Terenten,34,,8,9,17
096 Terenten,35,,11,12,23
096 Terenten,36,,12,10,22
096 Terenten,37,,14,12,26
096 Terenten,38,,7,7,14
096 Terenten,39,,9,10,19
096 Terenten,40,,14,18,32
096 Terenten,41,,9,5,14
096 Terenten,42,,14,10,24
096 Terenten,43,,16,10,26
096 Terenten,44,,14,17,31
096 Terenten,45,,8,16,24
096 Terenten,46,,17,11,28
096 Terenten,47,,17,14,31
096 Terenten,48,,19,12,31
096 Terenten,49,,16,13,29
096 Terenten,50,,12,14,26
096 Terenten,51,,17,18,35
096 Terenten,52,,13,17,30
096 Terenten,53,,15,9,24
096 Terenten,54,,17,12,29
096 Terenten,55,,22,12,34
096 Terenten,56,,20,13,33
096 Terenten,57,,11,19,30
096 Terenten,58,,12,9,21
096 Terenten,59,,13,10,23
096 Terenten,60,,14,9,23
096 Terenten,61,,12,8,20
096 Terenten,62,,10,11,21
096 Terenten,63,,11,11,22
096 Terenten,64,,13,10,23
096 Terenten,65,,10,8,18
096 Terenten,66,,6,7,13
096 Terenten,67,,6,5,11
096 Terenten,68,,8,6,14
096 Terenten,69,,7,5,12
096 Terenten,70,,10,8,18
096 Terenten,71,,7,3,10
096 Terenten,72,,8,4,12
096 Terenten,73,,6,4,10
096 Terenten,74,,3,6,9
096 Terenten,75,,7,5,12
096 Terenten,76,,5,5,10
096 Terenten,77,,3,4,7
096 Terenten,78,,7,5,12
096 Terenten,79,,2,5,7
096 Terenten,80,,4,8,12
096 Terenten,81,,4,5,9
096 Terenten,82,,2,6,8
096 Terenten,83,,2,4,6
096 Terenten,84,,-,1,1
096 Terenten,85,,3,2,5
096 Terenten,86,,2,1,3
096 Terenten,87,,4,8,12
096 Terenten,88,,2,2,4
096 Terenten,89,,3,1,4
096 Terenten,90,,1,4,5
096 Terenten,91,,-,2,2
096 Terenten,92,,1,2,3
096 Terenten,93,,1,-,1
096 Terenten,94,,-,1,1
096 Terenten,97,,-,1,1
097 Terlan,0,,20,21,41
097 Terlan,1,,24,22,46
097 Terlan,2,,20,18,38
097 Terlan,3,,22,21,43
097 Terlan,4,,30,20,50
097 Terlan,5,,22,30,52
097 Terlan,6,,35,20,55
097 Terlan,7,,39,35,74
097 Terlan,8,,22,16,38
097 Terlan,9,,34,32,66
097 Terlan,10,,31,24,55
097 Terlan,11,,20,22,42
097 Terlan,12,,21,28,49
097 Terlan,13,,21,26,47
097 Terlan,14,,32,23,55
097 Terlan,15,,22,23,45
097 Terlan,16,,24,21,45
097 Terlan,17,,22,28,50
097 Terlan,18,,31,28,59
097 Terlan,19,,30,18,48
097 Terlan,20,,22,23,45
097 Terlan,21,,38,28,66
097 Terlan,22,,21,29,50
097 Terlan,23,,28,27,55
097 Terlan,24,,22,22,44
097 Terlan,25,,28,21,49
097 Terlan,26,,24,28,52
097 Terlan,27,,30,26,56
097 Terlan,28,,25,21,46
097 Terlan,29,,25,26,51
097 Terlan,30,,21,26,47
097 Terlan,31,,27,28,55
097 Terlan,32,,19,27,46
097 Terlan,33,,29,27,56
097 Terlan,34,,25,14,39
097 Terlan,35,,28,22,50
097 Terlan,36,,22,30,52
097 Terlan,37,,30,21,51
097 Terlan,38,,43,40,83
097 Terlan,39,,22,30,52
097 Terlan,40,,26,37,63
097 Terlan,41,,43,30,73
097 Terlan,42,,36,41,77
097 Terlan,43,,39,36,75
097 Terlan,44,,31,48,79
097 Terlan,45,,32,35,67
097 Terlan,46,,44,30,74
097 Terlan,47,,31,27,58
097 Terlan,48,,41,46,87
097 Terlan,49,,36,36,72
097 Terlan,50,,35,36,71
097 Terlan,51,,31,38,69
097 Terlan,52,,37,31,68
097 Terlan,53,,33,27,60
097 Terlan,54,,40,29,69
097 Terlan,55,,32,32,64
097 Terlan,56,,26,37,63
097 Terlan,57,,39,28,67
097 Terlan,58,,27,35,62
097 Terlan,59,,19,24,43
097 Terlan,60,,34,27,61
097 Terlan,61,,23,30,53
097 Terlan,62,,30,32,62
097 Terlan,63,,25,28,53
097 Terlan,64,,26,20,46
097 Terlan,65,,15,23,38
097 Terlan,66,,18,25,43
097 Terlan,67,,20,15,35
097 Terlan,68,,22,20,42
097 Terlan,69,,17,13,30
097 Terlan,70,,15,24,39
097 Terlan,71,,15,20,35
097 Terlan,72,,9,21,30
097 Terlan,73,,18,20,38
097 Terlan,74,,22,21,43
097 Terlan,75,,10,25,35
097 Terlan,76,,29,20,49
097 Terlan,77,,21,23,44
097 Terlan,78,,17,15,32
097 Terlan,79,,15,14,29
097 Terlan,80,,14,14,28
097 Terlan,81,,9,14,23
097 Terlan,82,,5,8,13
097 Terlan,83,,9,15,24
097 Terlan,84,,5,17,22
097 Terlan,85,,8,12,20
097 Terlan,86,,7,9,16
097 Terlan,87,,13,8,21
097 Terlan,88,,5,7,12
097 Terlan,89,,6,10,16
097 Terlan,90,,5,6,11
097 Terlan,91,,2,6,8
097 Terlan,92,,3,4,7
097 Terlan,93,,1,4,5
097 Terlan,94,,-,6,6
097 Terlan,95,,1,6,7
097 Terlan,96,,-,2,2
097 Terlan,97,,-,2,2
097 Terlan,98,,-,1,1
097 Terlan,100,,-,1,1
097 Terlan,102,,-,2,2
098 Tramin a.d. Weinstr.,0,,20,18,38
098 Tramin a.d. Weinstr.,1,,20,20,40
098 Tramin a.d. Weinstr.,2,,22,19,41
098 Tramin a.d. Weinstr.,3,,21,16,37
098 Tramin a.d. Weinstr.,4,,22,25,47
098 Tramin a.d. Weinstr.,5,,25,15,40
098 Tramin a.d. Weinstr.,6,,21,22,43
098 Tramin a.d. Weinstr.,7,,13,13,26
098 Tramin a.d. Weinstr.,8,,20,17,37
098 Tramin a.d. Weinstr.,9,,21,13,34
098 Tramin a.d. Weinstr.,10,,18,12,30
098 Tramin a.d. Weinstr.,11,,17,14,31
098 Tramin a.d. Weinstr.,12,,14,11,25
098 Tramin a.d. Weinstr.,13,,17,13,30
098 Tramin a.d. Weinstr.,14,,13,17,30
098 Tramin a.d. Weinstr.,15,,27,13,40
098 Tramin a.d. Weinstr.,16,,18,18,36
098 Tramin a.d. Weinstr.,17,,20,19,39
098 Tramin a.d. Weinstr.,18,,26,16,42
098 Tramin a.d. Weinstr.,19,,18,16,34
098 Tramin a.d. Weinstr.,20,,16,22,38
098 Tramin a.d. Weinstr.,21,,26,16,42
098 Tramin a.d. Weinstr.,22,,21,29,50
098 Tramin a.d. Weinstr.,23,,20,23,43
098 Tramin a.d. Weinstr.,24,,21,20,41
098 Tramin a.d. Weinstr.,25,,14,18,32
098 Tramin a.d. Weinstr.,26,,22,22,44
098 Tramin a.d. Weinstr.,27,,14,13,27
098 Tramin a.d. Weinstr.,28,,22,24,46
098 Tramin a.d. Weinstr.,29,,19,30,49
098 Tramin a.d. Weinstr.,30,,16,28,44
098 Tramin a.d. Weinstr.,31,,18,19,37
098 Tramin a.d. Weinstr.,32,,17,13,30
098 Tramin a.d. Weinstr.,33,,24,24,48
098 Tramin a.d. Weinstr.,34,,22,16,38
098 Tramin a.d. Weinstr.,35,,14,20,34
098 Tramin a.d. Weinstr.,36,,21,28,49
098 Tramin a.d. Weinstr.,37,,31,14,45
098 Tramin a.d. Weinstr.,38,,26,23,49
098 Tramin a.d. Weinstr.,39,,17,14,31
098 Tramin a.d. Weinstr.,40,,14,23,37
098 Tramin a.d. Weinstr.,41,,24,18,42
098 Tramin a.d. Weinstr.,42,,27,20,47
098 Tramin a.d. Weinstr.,43,,22,18,40
098 Tramin a.d. Weinstr.,44,,28,16,44
098 Tramin a.d. Weinstr.,45,,21,20,41
098 Tramin a.d. Weinstr.,46,,18,28,46
098 Tramin a.d. Weinstr.,47,,21,32,53
098 Tramin a.d. Weinstr.,48,,26,21,47
098 Tramin a.d. Weinstr.,49,,29,35,64
098 Tramin a.d. Weinstr.,50,,26,22,48
098 Tramin a.d. Weinstr.,51,,27,31,58
098 Tramin a.d. Weinstr.,52,,33,25,58
098 Tramin a.d. Weinstr.,53,,32,27,59
098 Tramin a.d. Weinstr.,54,,27,33,60
098 Tramin a.d. Weinstr.,55,,24,20,44
098 Tramin a.d. Weinstr.,56,,25,17,42
098 Tramin a.d. Weinstr.,57,,31,23,54
098 Tramin a.d. Weinstr.,58,,26,34,60
098 Tramin a.d. Weinstr.,59,,16,30,46
098 Tramin a.d. Weinstr.,60,,28,21,49
098 Tramin a.d. Weinstr.,61,,18,22,40
098 Tramin a.d. Weinstr.,62,,21,19,40
098 Tramin a.d. Weinstr.,63,,14,17,31
098 Tramin a.d. Weinstr.,64,,18,19,37
098 Tramin a.d. Weinstr.,65,,15,13,28
098 Tramin a.d. Weinstr.,66,,19,17,36
098 Tramin a.d. Weinstr.,67,,11,14,25
098 Tramin a.d. Weinstr.,68,,16,19,35
098 Tramin a.d. Weinstr.,69,,14,17,31
098 Tramin a.d. Weinstr.,70,,15,18,33
098 Tramin a.d. Weinstr.,71,,13,21,34
098 Tramin a.d. Weinstr.,72,,18,18,36
098 Tramin a.d. Weinstr.,73,,6,9,15
098 Tramin a.d. Weinstr.,74,,21,23,44
098 Tramin a.d. Weinstr.,75,,16,20,36
098 Tramin a.d. Weinstr.,76,,18,14,32
098 Tramin a.d. Weinstr.,77,,11,24,35
098 Tramin a.d. Weinstr.,78,,19,13,32
098 Tramin a.d. Weinstr.,79,,9,11,20
098 Tramin a.d. Weinstr.,80,,4,18,22
098 Tramin a.d. Weinstr.,81,,10,11,21
098 Tramin a.d. Weinstr.,82,,12,13,25
098 Tramin a.d. Weinstr.,83,,9,10,19
098 Tramin a.d. Weinstr.,84,,8,12,20
098 Tramin a.d. Weinstr.,85,,4,9,13
098 Tramin a.d. Weinstr.,86,,5,14,19
098 Tramin a.d. Weinstr.,87,,4,12,16
098 Tramin a.d. Weinstr.,88,,6,9,15
098 Tramin a.d. Weinstr.,89,,3,11,14
098 Tramin a.d. Weinstr.,90,,5,2,7
098 Tramin a.d. Weinstr.,91,,2,6,8
098 Tramin a.d. Weinstr.,92,,1,9,10
098 Tramin a.d. Weinstr.,93,,2,10,12
098 Tramin a.d. Weinstr.,94,,-,3,3
098 Tramin a.d. Weinstr.,95,,-,2,2
098 Tramin a.d. Weinstr.,96,,-,4,4
098 Tramin a.d. Weinstr.,97,,1,1,2
098 Tramin a.d. Weinstr.,98,,-,3,3
099 Tisens,0,,11,15,26
099 Tisens,1,,13,5,18
099 Tisens,2,,15,8,23
099 Tisens,3,,7,6,13
099 Tisens,4,,10,8,18
099 Tisens,5,,6,8,14
099 Tisens,6,,7,13,20
099 Tisens,7,,5,9,14
099 Tisens,8,,8,9,17
099 Tisens,9,,5,2,7
099 Tisens,10,,15,8,23
099 Tisens,11,,10,9,19
099 Tisens,12,,9,9,18
099 Tisens,13,,12,17,29
099 Tisens,14,,12,14,26
099 Tisens,15,,11,12,23
099 Tisens,16,,13,9,22
099 Tisens,17,,10,19,29
099 Tisens,18,,11,12,23
099 Tisens,19,,11,7,18
099 Tisens,20,,15,13,28
099 Tisens,21,,5,8,13
099 Tisens,22,,13,8,21
099 Tisens,23,,11,6,17
099 Tisens,24,,14,13,27
099 Tisens,25,,6,13,19
099 Tisens,26,,8,17,25
099 Tisens,27,,16,11,27
099 Tisens,28,,15,15,30
099 Tisens,29,,11,12,23
099 Tisens,30,,12,13,25
099 Tisens,31,,15,8,23
099 Tisens,32,,16,10,26
099 Tisens,33,,8,11,19
099 Tisens,34,,11,14,25
099 Tisens,35,,18,6,24
099 Tisens,36,,19,17,36
099 Tisens,37,,10,16,26
099 Tisens,38,,8,12,20
099 Tisens,39,,11,12,23
099 Tisens,40,,13,21,34
099 Tisens,41,,13,10,23
099 Tisens,42,,8,8,16
099 Tisens,43,,16,13,29
099 Tisens,44,,14,9,23
099 Tisens,45,,10,14,24
099 Tisens,46,,11,13,24
099 Tisens,47,,17,14,31
099 Tisens,48,,15,17,32
099 Tisens,49,,17,18,35
099 Tisens,50,,22,19,41
099 Tisens,51,,22,20,42
099 Tisens,52,,20,9,29
099 Tisens,53,,18,28,46
099 Tisens,54,,17,10,27
099 Tisens,55,,17,13,30
099 Tisens,56,,21,6,27
099 Tisens,57,,13,10,23
099 Tisens,58,,14,6,20
099 Tisens,59,,12,12,24
099 Tisens,60,,11,14,25
099 Tisens,61,,15,18,33
099 Tisens,62,,9,13,22
099 Tisens,63,,17,11,28
099 Tisens,64,,6,8,14
099 Tisens,65,,11,10,21
099 Tisens,66,,6,12,18
099 Tisens,67,,14,10,24
099 Tisens,68,,9,4,13
099 Tisens,69,,5,6,11
099 Tisens,70,,14,7,21
099 Tisens,71,,9,9,18
099 Tisens,72,,8,6,14
099 Tisens,73,,3,6,9
099 Tisens,74,,7,11,18
099 Tisens,75,,12,7,19
099 Tisens,76,,9,11,20
099 Tisens,77,,6,10,16
099 Tisens,78,,2,7,9
099 Tisens,79,,9,9,18
099 Tisens,80,,5,11,16
099 Tisens,81,,4,3,7
099 Tisens,82,,6,6,12
099 Tisens,83,,3,10,13
099 Tisens,84,,5,6,11
099 Tisens,85,,3,7,10
099 Tisens,86,,2,7,9
099 Tisens,87,,3,6,9
099 Tisens,88,,2,12,14
099 Tisens,89,,1,4,5
099 Tisens,90,,1,6,7
099 Tisens,91,,2,3,5
099 Tisens,92,,2,6,8
099 Tisens,93,,1,6,7
099 Tisens,94,,1,3,4
099 Tisens,95,,-,1,1
099 Tisens,96,,1,-,1
099 Tisens,98,,1,1,2
100 Tiers,0,,4,11,15
100 Tiers,1,,3,7,10
100 Tiers,2,,4,6,10
100 Tiers,3,,4,5,9
100 Tiers,4,,7,4,11
100 Tiers,5,,6,6,12
100 Tiers,6,,4,7,11
100 Tiers,7,,2,6,8
100 Tiers,8,,8,6,14
100 Tiers,9,,3,4,7
100 Tiers,10,,9,7,16
100 Tiers,11,,8,3,11
100 Tiers,12,,2,6,8
100 Tiers,13,,2,10,12
100 Tiers,14,,5,2,7
100 Tiers,15,,4,8,12
100 Tiers,16,,6,4,10
100 Tiers,17,,2,9,11
100 Tiers,18,,2,7,9
100 Tiers,19,,4,9,13
100 Tiers,20,,5,9,14
100 Tiers,21,,9,7,16
100 Tiers,22,,7,3,10
100 Tiers,23,,9,11,20
100 Tiers,24,,5,7,12
100 Tiers,25,,5,3,8
100 Tiers,26,,4,5,9
100 Tiers,27,,6,7,13
100 Tiers,28,,8,8,16
100 Tiers,29,,5,5,10
100 Tiers,30,,6,9,15
100 Tiers,31,,4,9,13
100 Tiers,32,,10,7,17
100 Tiers,33,,5,4,9
100 Tiers,34,,2,9,11
100 Tiers,35,,9,5,14
100 Tiers,36,,7,3,10
100 Tiers,37,,6,8,14
100 Tiers,38,,3,5,8
100 Tiers,39,,1,3,4
100 Tiers,40,,11,7,18
100 Tiers,41,,5,2,7
100 Tiers,42,,2,4,6
100 Tiers,43,,10,8,18
100 Tiers,44,,4,8,12
100 Tiers,45,,9,6,15
100 Tiers,46,,10,9,19
100 Tiers,47,,5,7,12
100 Tiers,48,,6,8,14
100 Tiers,49,,15,11,26
100 Tiers,50,,7,3,10
100 Tiers,51,,10,11,21
100 Tiers,52,,9,6,15
100 Tiers,53,,5,5,10
100 Tiers,54,,9,6,15
100 Tiers,55,,6,11,17
100 Tiers,56,,7,6,13
100 Tiers,57,,6,5,11
100 Tiers,58,,4,9,13
100 Tiers,59,,12,6,18
100 Tiers,60,,8,4,12
100 Tiers,61,,5,8,13
100 Tiers,62,,9,7,16
100 Tiers,63,,7,4,11
100 Tiers,64,,6,5,11
100 Tiers,65,,5,6,11
100 Tiers,66,,4,2,6
100 Tiers,67,,1,4,5
100 Tiers,68,,9,5,14
100 Tiers,69,,3,4,7
100 Tiers,70,,3,5,8
100 Tiers,71,,-,4,4
100 Tiers,72,,5,4,9
100 Tiers,73,,7,3,10
100 Tiers,74,,2,4,6
100 Tiers,75,,10,10,20
100 Tiers,76,,2,5,7
100 Tiers,77,,2,4,6
100 Tiers,78,,2,2,4
100 Tiers,79,,5,6,11
100 Tiers,80,,5,5,10
100 Tiers,81,,3,4,7
100 Tiers,82,,3,5,8
100 Tiers,83,,4,3,7
100 Tiers,84,,2,5,7
100 Tiers,85,,2,1,3
100 Tiers,86,,2,4,6
100 Tiers,87,,2,3,5
100 Tiers,88,,2,-,2
100 Tiers,89,,-,1,1
100 Tiers,90,,2,1,3
100 Tiers,91,,1,1,2
100 Tiers,92,,-,1,1
100 Tiers,93,,3,-,3
100 Tiers,94,,1,1,2
100 Tiers,95,,-,1,1
100 Tiers,100,,1,-,1
101 Tirol,0,,6,11,17
101 Tirol,1,,7,13,20
101 Tirol,2,,14,12,26
101 Tirol,3,,17,10,27
101 Tirol,4,,8,11,19
101 Tirol,5,,12,7,19
101 Tirol,6,,19,11,30
101 Tirol,7,,7,16,23
101 Tirol,8,,17,14,31
101 Tirol,9,,11,8,19
101 Tirol,10,,10,16,26
101 Tirol,11,,13,10,23
101 Tirol,12,,13,9,22
101 Tirol,13,,14,5,19
101 Tirol,14,,13,14,27
101 Tirol,15,,10,13,23
101 Tirol,16,,15,11,26
101 Tirol,17,,19,11,30
101 Tirol,18,,21,12,33
101 Tirol,19,,14,17,31
101 Tirol,20,,15,12,27
101 Tirol,21,,21,24,45
101 Tirol,22,,21,15,36
101 Tirol,23,,12,18,30
101 Tirol,24,,14,15,29
101 Tirol,25,,20,12,32
101 Tirol,26,,12,14,26
101 Tirol,27,,5,8,13
101 Tirol,28,,14,12,26
101 Tirol,29,,9,18,27
101 Tirol,30,,13,16,29
101 Tirol,31,,15,8,23
101 Tirol,32,,11,15,26
101 Tirol,33,,12,17,29
101 Tirol,34,,16,15,31
101 Tirol,35,,13,16,29
101 Tirol,36,,19,13,32
101 Tirol,37,,17,16,33
101 Tirol,38,,18,7,25
101 Tirol,39,,13,10,23
101 Tirol,40,,6,10,16
101 Tirol,41,,14,17,31
101 Tirol,42,,13,17,30
101 Tirol,43,,19,17,36
101 Tirol,44,,16,19,35
101 Tirol,45,,23,17,40
101 Tirol,46,,25,20,45
101 Tirol,47,,21,22,43
101 Tirol,48,,17,16,33
101 Tirol,49,,20,22,42
101 Tirol,50,,25,25,50
101 Tirol,51,,23,19,42
101 Tirol,52,,23,19,42
101 Tirol,53,,22,20,42
101 Tirol,54,,27,20,47
101 Tirol,55,,18,17,35
101 Tirol,56,,17,20,37
101 Tirol,57,,16,21,37
101 Tirol,58,,24,16,40
101 Tirol,59,,15,16,31
101 Tirol,60,,9,14,23
101 Tirol,61,,15,20,35
101 Tirol,62,,6,14,20
101 Tirol,63,,14,15,29
101 Tirol,64,,14,17,31
101 Tirol,65,,17,16,33
101 Tirol,66,,10,13,23
101 Tirol,67,,14,16,30
101 Tirol,68,,14,9,23
101 Tirol,69,,14,16,30
101 Tirol,70,,18,14,32
101 Tirol,71,,9,12,21
101 Tirol,72,,11,6,17
101 Tirol,73,,10,12,22
101 Tirol,74,,12,15,27
101 Tirol,75,,11,12,23
101 Tirol,76,,10,17,27
101 Tirol,77,,8,11,19
101 Tirol,78,,6,12,18
101 Tirol,79,,6,10,16
101 Tirol,80,,6,8,14
101 Tirol,81,,5,14,19
101 Tirol,82,,4,6,10
101 Tirol,83,,5,5,10
101 Tirol,84,,12,5,17
101 Tirol,85,,4,10,14
101 Tirol,86,,4,5,9
101 Tirol,87,,1,3,4
101 Tirol,88,,2,3,5
101 Tirol,89,,4,6,10
101 Tirol,90,,-,4,4
101 Tirol,91,,2,6,8
101 Tirol,92,,-,1,1
101 Tirol,93,,2,2,4
101 Tirol,94,,1,3,4
101 Tirol,95,,-,1,1
101 Tirol,96,,1,1,2
101 Tirol,98,,-,1,1
102 Truden im Naturpark,0,,6,8,14
102 Truden im Naturpark,1,,4,7,11
102 Truden im Naturpark,2,,4,6,10
102 Truden im Naturpark,3,,5,5,10
102 Truden im Naturpark,4,,4,4,8
102 Truden im Naturpark,5,,11,6,17
102 Truden im Naturpark,6,,7,9,16
102 Truden im Naturpark,7,,3,2,5
102 Truden im Naturpark,8,,11,8,19
102 Truden im Naturpark,9,,10,7,17
102 Truden im Naturpark,10,,4,8,12
102 Truden im Naturpark,11,,9,9,18
102 Truden im Naturpark,12,,5,1,6
102 Truden im Naturpark,13,,4,5,9
102 Truden im Naturpark,14,,4,9,13
102 Truden im Naturpark,15,,5,4,9
102 Truden im Naturpark,16,,1,6,7
102 Truden im Naturpark,17,,4,2,6
102 Truden im Naturpark,18,,8,6,14
102 Truden im Naturpark,19,,-,1,1
102 Truden im Naturpark,20,,2,7,9
102 Truden im Naturpark,21,,5,6,11
102 Truden im Naturpark,22,,4,5,9
102 Truden im Naturpark,23,,6,5,11
102 Truden im Naturpark,24,,5,4,9
102 Truden im Naturpark,25,,11,5,16
102 Truden im Naturpark,26,,6,4,10
102 Truden im Naturpark,27,,6,4,10
102 Truden im Naturpark,28,,2,5,7
102 Truden im Naturpark,29,,7,9,16
102 Truden im Naturpark,30,,8,13,21
102 Truden im Naturpark,31,,7,7,14
102 Truden im Naturpark,32,,4,8,12
102 Truden im Naturpark,33,,9,6,15
102 Truden im Naturpark,34,,9,2,11
102 Truden im Naturpark,35,,6,9,15
102 Truden im Naturpark,36,,9,5,14
102 Truden im Naturpark,37,,6,11,17
102 Truden im Naturpark,38,,8,6,14
102 Truden im Naturpark,39,,8,4,12
102 Truden im Naturpark,40,,7,6,13
102 Truden im Naturpark,41,,3,6,9
102 Truden im Naturpark,42,,11,6,17
102 Truden im Naturpark,43,,10,2,12
102 Truden im Naturpark,44,,8,12,20
102 Truden im Naturpark,45,,6,10,16
102 Truden im Naturpark,46,,6,8,14
102 Truden im Naturpark,47,,4,4,8
102 Truden im Naturpark,48,,2,8,10
102 Truden im Naturpark,49,,9,9,18
102 Truden im Naturpark,50,,8,7,15
102 Truden im Naturpark,51,,11,7,18
102 Truden im Naturpark,52,,5,12,17
102 Truden im Naturpark,53,,7,7,14
102 Truden im Naturpark,54,,10,6,16
102 Truden im Naturpark,55,,12,6,18
102 Truden im Naturpark,56,,9,4,13
102 Truden im Naturpark,57,,9,5,14
102 Truden im Naturpark,58,,6,12,18
102 Truden im Naturpark,59,,6,8,14
102 Truden im Naturpark,60,,6,11,17
102 Truden im Naturpark,61,,5,7,12
102 Truden im Naturpark,62,,5,6,11
102 Truden im Naturpark,63,,9,9,18
102 Truden im Naturpark,64,,5,7,12
102 Truden im Naturpark,65,,10,6,16
102 Truden im Naturpark,66,,2,6,8
102 Truden im Naturpark,67,,9,7,16
102 Truden im Naturpark,68,,3,3,6
102 Truden im Naturpark,69,,4,4,8
102 Truden im Naturpark,70,,1,5,6
102 Truden im Naturpark,71,,6,2,8
102 Truden im Naturpark,72,,9,6,15
102 Truden im Naturpark,73,,5,3,8
102 Truden im Naturpark,74,,3,6,9
102 Truden im Naturpark,75,,5,4,9
102 Truden im Naturpark,76,,3,6,9
102 Truden im Naturpark,77,,4,6,10
102 Truden im Naturpark,78,,2,4,6
102 Truden im Naturpark,79,,7,2,9
102 Truden im Naturpark,80,,3,4,7
102 Truden im Naturpark,81,,1,4,5
102 Truden im Naturpark,82,,3,2,5
102 Truden im Naturpark,83,,3,1,4
102 Truden im Naturpark,84,,4,1,5
102 Truden im Naturpark,85,,2,4,6
102 Truden im Naturpark,86,,1,2,3
102 Truden im Naturpark,87,,1,1,2
102 Truden im Naturpark,88,,-,4,4
102 Truden im Naturpark,89,,-,4,4
102 Truden im Naturpark,90,,-,3,3
102 Truden im Naturpark,92,,-,2,2
102 Truden im Naturpark,93,,-,3,3
102 Truden im Naturpark,94,,-,1,1
102 Truden im Naturpark,95,,-,2,2
102 Truden im Naturpark,96,,-,2,2
102 Truden im Naturpark,97,,-,1,1
103 Taufers im Münstertal,0,,4,3,7
103 Taufers im Münstertal,1,,10,9,19
103 Taufers im Münstertal,2,,1,4,5
103 Taufers im Münstertal,3,,5,12,17
103 Taufers im Münstertal,4,,1,8,9
103 Taufers im Münstertal,5,,5,4,9
103 Taufers im Münstertal,6,,4,5,9
103 Taufers im Münstertal,7,,5,8,13
103 Taufers im Münstertal,8,,4,1,5
103 Taufers im Münstertal,9,,7,8,15
103 Taufers im Münstertal,10,,3,5,8
103 Taufers im Münstertal,11,,6,2,8
103 Taufers im Münstertal,12,,3,10,13
103 Taufers im Münstertal,13,,2,5,7
103 Taufers im Münstertal,14,,7,3,10
103 Taufers im Münstertal,15,,3,2,5
103 Taufers im Münstertal,16,,4,5,9
103 Taufers im Münstertal,17,,6,6,12
103 Taufers im Münstertal,18,,4,3,7
103 Taufers im Münstertal,19,,3,3,6
103 Taufers im Münstertal,20,,7,9,16
103 Taufers im Münstertal,21,,6,4,10
103 Taufers im Münstertal,22,,8,3,11
103 Taufers im Münstertal,23,,8,6,14
103 Taufers im Münstertal,24,,6,7,13
103 Taufers im Münstertal,25,,5,6,11
103 Taufers im Münstertal,26,,6,7,13
103 Taufers im Münstertal,27,,7,8,15
103 Taufers im Münstertal,28,,7,9,16
103 Taufers im Münstertal,29,,8,3,11
103 Taufers im Münstertal,30,,9,6,15
103 Taufers im Münstertal,31,,3,7,10
103 Taufers im Münstertal,32,,6,3,9
103 Taufers im Münstertal,33,,9,5,14
103 Taufers im Münstertal,34,,7,5,12
103 Taufers im Münstertal,35,,4,7,11
103 Taufers im Münstertal,36,,6,9,15
103 Taufers im Münstertal,37,,8,6,14
103 Taufers im Münstertal,38,,7,3,10
103 Taufers im Münstertal,39,,6,3,9
103 Taufers im Münstertal,40,,5,5,10
103 Taufers im Münstertal,41,,5,4,9
103 Taufers im Münstertal,42,,1,7,8
103 Taufers im Münstertal,43,,11,5,16
103 Taufers im Münstertal,44,,5,4,9
103 Taufers im Münstertal,45,,2,8,10
103 Taufers im Münstertal,46,,3,8,11
103 Taufers im Münstertal,47,,7,13,20
103 Taufers im Münstertal,48,,7,7,14
103 Taufers im Münstertal,49,,9,7,16
103 Taufers im Münstertal,50,,8,12,20
103 Taufers im Münstertal,51,,4,5,9
103 Taufers im Münstertal,52,,5,10,15
103 Taufers im Münstertal,53,,11,5,16
103 Taufers im Münstertal,54,,8,12,20
103 Taufers im Münstertal,55,,9,10,19
103 Taufers im Münstertal,56,,10,8,18
103 Taufers im Münstertal,57,,8,6,14
103 Taufers im Münstertal,58,,13,6,19
103 Taufers im Münstertal,59,,7,10,17
103 Taufers im Münstertal,60,,5,6,11
103 Taufers im Münstertal,61,,8,6,14
103 Taufers im Münstertal,62,,10,8,18
103 Taufers im Münstertal,63,,3,3,6
103 Taufers im Münstertal,64,,4,6,10
103 Taufers im Münstertal,65,,6,4,10
103 Taufers im Münstertal,66,,8,2,10
103 Taufers im Münstertal,67,,4,5,9
103 Taufers im Münstertal,68,,7,2,9
103 Taufers im Münstertal,69,,5,1,6
103 Taufers im Münstertal,70,,4,1,5
103 Taufers im Münstertal,71,,3,6,9
103 Taufers im Münstertal,72,,2,3,5
103 Taufers im Münstertal,73,,2,4,6
103 Taufers im Münstertal,75,,5,4,9
103 Taufers im Münstertal,76,,3,4,7
103 Taufers im Münstertal,77,,3,4,7
103 Taufers im Münstertal,78,,1,3,4
103 Taufers im Münstertal,79,,4,4,8
103 Taufers im Münstertal,80,,5,7,12
103 Taufers im Münstertal,81,,2,3,5
103 Taufers im Münstertal,82,,2,8,10
103 Taufers im Münstertal,83,,1,2,3
103 Taufers im Münstertal,84,,1,6,7
103 Taufers im Münstertal,85,,3,5,8
103 Taufers im Münstertal,86,,4,-,4
103 Taufers im Münstertal,87,,3,3,6
103 Taufers im Münstertal,88,,-,2,2
103 Taufers im Münstertal,89,,1,4,5
103 Taufers im Münstertal,90,,3,1,4
103 Taufers im Münstertal,91,,-,2,2
103 Taufers im Münstertal,92,,-,2,2
103 Taufers im Münstertal,93,,-,2,2
103 Taufers im Münstertal,95,,-,2,2
103 Taufers im Münstertal,96,,-,1,1
104 Ulten,0,,21,16,37
104 Ulten,1,,22,21,43
104 Ulten,2,,22,20,42
104 Ulten,3,,18,16,34
104 Ulten,4,,16,15,31
104 Ulten,5,,22,14,36
104 Ulten,6,,10,15,25
104 Ulten,7,,16,22,38
104 Ulten,8,,14,11,25
104 Ulten,9,,17,13,30
104 Ulten,10,,19,11,30
104 Ulten,11,,6,11,17
104 Ulten,12,,14,11,25
104 Ulten,13,,17,21,38
104 Ulten,14,,17,12,29
104 Ulten,15,,19,18,37
104 Ulten,16,,14,18,32
104 Ulten,17,,21,16,37
104 Ulten,18,,16,18,34
104 Ulten,19,,14,13,27
104 Ulten,20,,16,17,33
104 Ulten,21,,13,20,33
104 Ulten,22,,11,11,22
104 Ulten,23,,12,14,26
104 Ulten,24,,18,16,34
104 Ulten,25,,22,15,37
104 Ulten,26,,16,14,30
104 Ulten,27,,20,23,43
104 Ulten,28,,17,17,34
104 Ulten,29,,15,23,38
104 Ulten,30,,15,14,29
104 Ulten,31,,16,15,31
104 Ulten,32,,22,10,32
104 Ulten,33,,14,19,33
104 Ulten,34,,20,16,36
104 Ulten,35,,20,11,31
104 Ulten,36,,12,21,33
104 Ulten,37,,20,17,37
104 Ulten,38,,18,25,43
104 Ulten,39,,19,15,34
104 Ulten,40,,22,8,30
104 Ulten,41,,16,13,29
104 Ulten,42,,15,21,36
104 Ulten,43,,21,20,41
104 Ulten,44,,12,22,34
104 Ulten,45,,23,15,38
104 Ulten,46,,21,17,38
104 Ulten,47,,30,20,50
104 Ulten,48,,19,25,44
104 Ulten,49,,26,19,45
104 Ulten,50,,30,25,55
104 Ulten,51,,13,19,32
104 Ulten,52,,19,16,35
104 Ulten,53,,24,29,53
104 Ulten,54,,21,16,37
104 Ulten,55,,25,23,48
104 Ulten,56,,31,21,52
104 Ulten,57,,27,18,45
104 Ulten,58,,24,21,45
104 Ulten,59,,23,21,44
104 Ulten,60,,24,15,39
104 Ulten,61,,32,21,53
104 Ulten,62,,17,16,33
104 Ulten,63,,13,12,25
104 Ulten,64,,17,15,32
104 Ulten,65,,22,12,34
104 Ulten,66,,17,12,29
104 Ulten,67,,14,16,30
104 Ulten,68,,15,12,27
104 Ulten,69,,15,10,25
104 Ulten,70,,14,13,27
104 Ulten,71,,14,9,23
104 Ulten,72,,14,14,28
104 Ulten,73,,7,12,19
104 Ulten,74,,8,18,26
104 Ulten,75,,15,14,29
104 Ulten,76,,7,10,17
104 Ulten,77,,8,10,18
104 Ulten,78,,12,8,20
104 Ulten,79,,15,17,32
104 Ulten,80,,4,8,12
104 Ulten,81,,7,7,14
104 Ulten,82,,4,9,13
104 Ulten,83,,5,6,11
104 Ulten,84,,9,9,18
104 Ulten,85,,2,11,13
104 Ulten,86,,6,6,12
104 Ulten,87,,4,6,10
104 Ulten,88,,6,11,17
104 Ulten,89,,2,8,10
104 Ulten,90,,1,8,9
104 Ulten,91,,3,9,12
104 Ulten,92,,2,8,10
104 Ulten,93,,-,4,4
104 Ulten,94,,2,5,7
104 Ulten,95,,2,4,6
104 Ulten,96,,2,1,3
104 Ulten,97,,2,1,3
104 Ulten,99,,-,1,1
105 Pfatten,0,,8,2,10
105 Pfatten,1,,11,9,20
105 Pfatten,2,,6,1,7
105 Pfatten,3,,7,2,9
105 Pfatten,4,,9,4,13
105 Pfatten,5,,11,4,15
105 Pfatten,6,,1,8,9
105 Pfatten,7,,12,6,18
105 Pfatten,8,,5,2,7
105 Pfatten,9,,7,5,12
105 Pfatten,10,,6,6,12
105 Pfatten,11,,9,6,15
105 Pfatten,12,,7,2,9
105 Pfatten,13,,6,9,15
105 Pfatten,14,,1,7,8
105 Pfatten,15,,10,5,15
105 Pfatten,16,,5,4,9
105 Pfatten,17,,5,1,6
105 Pfatten,18,,2,5,7
105 Pfatten,19,,7,6,13
105 Pfatten,20,,8,7,15
105 Pfatten,21,,3,4,7
105 Pfatten,22,,5,7,12
105 Pfatten,23,,7,4,11
105 Pfatten,24,,8,10,18
105 Pfatten,25,,10,6,16
105 Pfatten,26,,6,6,12
105 Pfatten,27,,7,6,13
105 Pfatten,28,,9,10,19
105 Pfatten,29,,4,13,17
105 Pfatten,30,,12,9,21
105 Pfatten,31,,8,7,15
105 Pfatten,32,,4,10,14
105 Pfatten,33,,6,8,14
105 Pfatten,34,,6,6,12
105 Pfatten,35,,9,10,19
105 Pfatten,36,,8,5,13
105 Pfatten,37,,12,5,17
105 Pfatten,38,,5,6,11
105 Pfatten,39,,4,9,13
105 Pfatten,40,,7,6,13
105 Pfatten,41,,5,6,11
105 Pfatten,42,,6,9,15
105 Pfatten,43,,3,10,13
105 Pfatten,44,,14,8,22
105 Pfatten,45,,12,6,18
105 Pfatten,46,,6,9,15
105 Pfatten,47,,10,5,15
105 Pfatten,48,,11,6,17
105 Pfatten,49,,7,4,11
105 Pfatten,50,,5,9,14
105 Pfatten,51,,14,6,20
105 Pfatten,52,,11,8,19
105 Pfatten,53,,9,10,19
105 Pfatten,54,,12,5,17
105 Pfatten,55,,7,9,16
105 Pfatten,56,,9,12,21
105 Pfatten,57,,11,16,27
105 Pfatten,58,,7,10,17
105 Pfatten,59,,5,14,19
105 Pfatten,60,,9,7,16
105 Pfatten,61,,11,5,16
105 Pfatten,62,,7,7,14
105 Pfatten,63,,6,5,11
105 Pfatten,64,,11,2,13
105 Pfatten,65,,4,5,9
105 Pfatten,66,,2,5,7
105 Pfatten,67,,4,2,6
105 Pfatten,68,,5,5,10
105 Pfatten,69,,7,2,9
105 Pfatten,70,,3,-,3
105 Pfatten,71,,6,7,13
105 Pfatten,72,,2,3,5
105 Pfatten,73,,6,3,9
105 Pfatten,74,,3,1,4
105 Pfatten,75,,1,1,2
105 Pfatten,76,,1,2,3
105 Pfatten,77,,3,4,7
105 Pfatten,78,,3,3,6
105 Pfatten,79,,3,1,4
105 Pfatten,80,,2,1,3
105 Pfatten,81,,3,2,5
105 Pfatten,82,,1,3,4
105 Pfatten,83,,4,1,5
105 Pfatten,84,,-,4,4
105 Pfatten,85,,1,-,1
105 Pfatten,86,,-,3,3
105 Pfatten,87,,1,3,4
105 Pfatten,88,,-,1,1
105 Pfatten,89,,-,3,3
105 Pfatten,90,,-,1,1
105 Pfatten,92,,1,1,2
105 Pfatten,93,,-,1,1
106 Olang,0,,16,18,34
106 Olang,1,,20,21,41
106 Olang,2,,25,12,37
106 Olang,3,,18,18,36
106 Olang,4,,21,16,37
106 Olang,5,,20,18,38
106 Olang,6,,14,25,39
106 Olang,7,,19,20,39
106 Olang,8,,21,21,42
106 Olang,9,,13,20,33
106 Olang,10,,25,20,45
106 Olang,11,,12,25,37
106 Olang,12,,8,15,23
106 Olang,13,,24,12,36
106 Olang,14,,15,13,28
106 Olang,15,,20,11,31
106 Olang,16,,17,10,27
106 Olang,17,,17,20,37
106 Olang,18,,23,22,45
106 Olang,19,,15,11,26
106 Olang,20,,18,23,41
106 Olang,21,,22,17,39
106 Olang,22,,26,23,49
106 Olang,23,,19,14,33
106 Olang,24,,19,13,32
106 Olang,25,,20,22,42
106 Olang,26,,15,14,29
106 Olang,27,,21,18,39
106 Olang,28,,29,23,52
106 Olang,29,,20,18,38
106 Olang,30,,15,20,35
106 Olang,31,,24,18,42
106 Olang,32,,15,22,37
106 Olang,33,,16,17,33
106 Olang,34,,24,16,40
106 Olang,35,,19,16,35
106 Olang,36,,21,18,39
106 Olang,37,,10,28,38
106 Olang,38,,27,22,49
106 Olang,39,,23,22,45
106 Olang,40,,23,23,46
106 Olang,41,,33,31,64
106 Olang,42,,20,25,45
106 Olang,43,,28,23,51
106 Olang,44,,16,27,43
106 Olang,45,,30,27,57
106 Olang,46,,25,19,44
106 Olang,47,,33,18,51
106 Olang,48,,21,18,39
106 Olang,49,,22,28,50
106 Olang,50,,30,25,55
106 Olang,51,,32,27,59
106 Olang,52,,29,22,51
106 Olang,53,,19,25,44
106 Olang,54,,19,30,49
106 Olang,55,,26,23,49
106 Olang,56,,23,13,36
106 Olang,57,,16,22,38
106 Olang,58,,20,25,45
106 Olang,59,,23,15,38
106 Olang,60,,22,12,34
106 Olang,61,,22,13,35
106 Olang,62,,12,28,40
106 Olang,63,,17,17,34
106 Olang,64,,16,17,33
106 Olang,65,,15,19,34
106 Olang,66,,15,12,27
106 Olang,67,,10,15,25
106 Olang,68,,29,14,43
106 Olang,69,,17,11,28
106 Olang,70,,17,19,36
106 Olang,71,,11,22,33
106 Olang,72,,13,12,25
106 Olang,73,,16,12,28
106 Olang,74,,14,6,20
106 Olang,75,,11,14,25
106 Olang,76,,12,16,28
106 Olang,77,,13,11,24
106 Olang,78,,14,8,22
106 Olang,79,,8,11,19
106 Olang,80,,5,12,17
106 Olang,81,,4,6,10
106 Olang,82,,5,8,13
106 Olang,83,,4,10,14
106 Olang,84,,7,10,17
106 Olang,85,,8,11,19
106 Olang,86,,8,8,16
106 Olang,87,,2,4,6
106 Olang,88,,4,6,10
106 Olang,89,,4,8,12
106 Olang,90,,2,4,6
106 Olang,91,,-,2,2
106 Olang,92,,1,7,8
106 Olang,93,,-,1,1
106 Olang,94,,-,4,4
106 Olang,95,,1,1,2
106 Olang,96,,-,2,2
106 Olang,98,,-,1,1
106 Olang,99,,1,-,1
107 Pfitsch,0,,13,19,32
107 Pfitsch,1,,18,22,40
107 Pfitsch,2,,19,18,37
107 Pfitsch,3,,16,22,38
107 Pfitsch,4,,18,15,33
107 Pfitsch,5,,17,22,39
107 Pfitsch,6,,27,22,49
107 Pfitsch,7,,14,17,31
107 Pfitsch,8,,24,17,41
107 Pfitsch,9,,19,13,32
107 Pfitsch,10,,13,21,34
107 Pfitsch,11,,18,10,28
107 Pfitsch,12,,28,15,43
107 Pfitsch,13,,18,22,40
107 Pfitsch,14,,22,15,37
107 Pfitsch,15,,16,17,33
107 Pfitsch,16,,22,20,42
107 Pfitsch,17,,14,11,25
107 Pfitsch,18,,23,22,45
107 Pfitsch,19,,18,14,32
107 Pfitsch,20,,12,15,27
107 Pfitsch,21,,19,20,39
107 Pfitsch,22,,16,17,33
107 Pfitsch,23,,20,10,30
107 Pfitsch,24,,18,18,36
107 Pfitsch,25,,19,16,35
107 Pfitsch,26,,17,26,43
107 Pfitsch,27,,27,18,45
107 Pfitsch,28,,21,16,37
107 Pfitsch,29,,23,14,37
107 Pfitsch,30,,21,22,43
107 Pfitsch,31,,14,15,29
107 Pfitsch,32,,17,19,36
107 Pfitsch,33,,16,16,32
107 Pfitsch,34,,27,17,44
107 Pfitsch,35,,21,27,48
107 Pfitsch,36,,30,18,48
107 Pfitsch,37,,23,25,48
107 Pfitsch,38,,22,25,47
107 Pfitsch,39,,26,18,44
107 Pfitsch,40,,23,23,46
107 Pfitsch,41,,20,16,36
107 Pfitsch,42,,21,30,51
107 Pfitsch,43,,20,23,43
107 Pfitsch,44,,18,20,38
107 Pfitsch,45,,24,18,42
107 Pfitsch,46,,20,20,40
107 Pfitsch,47,,30,17,47
107 Pfitsch,48,,20,24,44
107 Pfitsch,49,,26,19,45
107 Pfitsch,50,,20,19,39
107 Pfitsch,51,,23,20,43
107 Pfitsch,52,,24,20,44
107 Pfitsch,53,,19,20,39
107 Pfitsch,54,,17,23,40
107 Pfitsch,55,,19,18,37
107 Pfitsch,56,,22,22,44
107 Pfitsch,57,,24,20,44
107 Pfitsch,58,,15,26,41
107 Pfitsch,59,,9,19,28
107 Pfitsch,60,,21,14,35
107 Pfitsch,61,,26,22,48
107 Pfitsch,62,,20,17,37
107 Pfitsch,63,,16,13,29
107 Pfitsch,64,,20,22,42
107 Pfitsch,65,,20,17,37
107 Pfitsch,66,,13,21,34
107 Pfitsch,67,,22,19,41
107 Pfitsch,68,,20,19,39
107 Pfitsch,69,,11,17,28
107 Pfitsch,70,,9,7,16
107 Pfitsch,71,,8,12,20
107 Pfitsch,72,,13,13,26
107 Pfitsch,73,,10,12,22
107 Pfitsch,74,,11,13,24
107 Pfitsch,75,,17,10,27
107 Pfitsch,76,,19,12,31
107 Pfitsch,77,,12,14,26
107 Pfitsch,78,,11,10,21
107 Pfitsch,79,,8,7,15
107 Pfitsch,80,,4,9,13
107 Pfitsch,81,,7,9,16
107 Pfitsch,82,,5,9,14
107 Pfitsch,83,,4,5,9
107 Pfitsch,84,,8,2,10
107 Pfitsch,85,,9,8,17
107 Pfitsch,86,,1,8,9
107 Pfitsch,87,,6,8,14
107 Pfitsch,88,,2,5,7
107 Pfitsch,89,,4,6,10
107 Pfitsch,90,,2,7,9
107 Pfitsch,91,,1,7,8
107 Pfitsch,92,,1,4,5
107 Pfitsch,93,,2,4,6
107 Pfitsch,94,,-,1,1
107 Pfitsch,96,,1,2,3
107 Pfitsch,97,,-,1,1
107 Pfitsch,98,,-,1,1
107 Pfitsch,99,,-,1,1
108 Ahrntal,0,,26,40,66
108 Ahrntal,1,,32,37,69
108 Ahrntal,2,,34,38,72
108 Ahrntal,3,,35,29,64
108 Ahrntal,4,,40,21,61
108 Ahrntal,5,,31,27,58
108 Ahrntal,6,,49,28,77
108 Ahrntal,7,,39,35,74
108 Ahrntal,8,,30,31,61
108 Ahrntal,9,,45,42,87
108 Ahrntal,10,,29,46,75
108 Ahrntal,11,,41,36,77
108 Ahrntal,12,,43,34,77
108 Ahrntal,13,,32,40,72
108 Ahrntal,14,,35,39,74
108 Ahrntal,15,,37,39,76
108 Ahrntal,16,,32,36,68
108 Ahrntal,17,,33,32,65
108 Ahrntal,18,,49,41,90
108 Ahrntal,19,,38,39,77
108 Ahrntal,20,,35,37,72
108 Ahrntal,21,,40,48,88
108 Ahrntal,22,,39,47,86
108 Ahrntal,23,,33,29,62
108 Ahrntal,24,,29,27,56
108 Ahrntal,25,,38,40,78
108 Ahrntal,26,,47,32,79
108 Ahrntal,27,,25,38,63
108 Ahrntal,28,,38,32,70
108 Ahrntal,29,,40,23,63
108 Ahrntal,30,,30,25,55
108 Ahrntal,31,,38,34,72
108 Ahrntal,32,,36,38,74
108 Ahrntal,33,,39,47,86
108 Ahrntal,34,,37,26,63
108 Ahrntal,35,,46,45,91
108 Ahrntal,36,,39,38,77
108 Ahrntal,37,,43,42,85
108 Ahrntal,38,,39,35,74
108 Ahrntal,39,,39,37,76
108 Ahrntal,40,,34,39,73
108 Ahrntal,41,,49,45,94
108 Ahrntal,42,,47,43,90
108 Ahrntal,43,,48,40,88
108 Ahrntal,44,,43,37,80
108 Ahrntal,45,,43,39,82
108 Ahrntal,46,,53,50,103
108 Ahrntal,47,,66,42,108
108 Ahrntal,48,,54,45,99
108 Ahrntal,49,,51,43,94
108 Ahrntal,50,,51,41,92
108 Ahrntal,51,,41,50,91
108 Ahrntal,52,,60,44,104
108 Ahrntal,53,,57,40,97
108 Ahrntal,54,,47,41,88
108 Ahrntal,55,,49,42,91
108 Ahrntal,56,,34,46,80
108 Ahrntal,57,,34,36,70
108 Ahrntal,58,,35,29,64
108 Ahrntal,59,,40,39,79
108 Ahrntal,60,,44,30,74
108 Ahrntal,61,,26,38,64
108 Ahrntal,62,,33,20,53
108 Ahrntal,63,,34,22,56
108 Ahrntal,64,,33,17,50
108 Ahrntal,65,,25,28,53
108 Ahrntal,66,,25,34,59
108 Ahrntal,67,,29,21,50
108 Ahrntal,68,,29,19,48
108 Ahrntal,69,,27,30,57
108 Ahrntal,70,,27,26,53
108 Ahrntal,71,,19,15,34
108 Ahrntal,72,,16,22,38
108 Ahrntal,73,,18,11,29
108 Ahrntal,74,,12,18,30
108 Ahrntal,75,,18,29,47
108 Ahrntal,76,,24,23,47
108 Ahrntal,77,,23,30,53
108 Ahrntal,78,,24,23,47
108 Ahrntal,79,,18,19,37
108 Ahrntal,80,,25,25,50
108 Ahrntal,81,,18,19,37
108 Ahrntal,82,,15,11,26
108 Ahrntal,83,,9,33,42
108 Ahrntal,84,,9,18,27
108 Ahrntal,85,,15,15,30
108 Ahrntal,86,,11,22,33
108 Ahrntal,87,,16,15,31
108 Ahrntal,88,,13,10,23
108 Ahrntal,89,,5,9,14
108 Ahrntal,90,,5,14,19
108 Ahrntal,91,,2,8,10
108 Ahrntal,92,,5,7,12
108 Ahrntal,93,,-,7,7
108 Ahrntal,94,,3,1,4
108 Ahrntal,95,,1,3,4
108 Ahrntal,96,,-,2,2
108 Ahrntal,99,,1,-,1
108 Ahrntal,104,,-,1,1
109 Gsies,0,,19,8,27
109 Gsies,1,,10,19,29
109 Gsies,2,,13,13,26
109 Gsies,3,,17,18,35
109 Gsies,4,,18,19,37
109 Gsies,5,,18,14,32
109 Gsies,6,,15,14,29
109 Gsies,7,,12,20,32
109 Gsies,8,,19,15,34
109 Gsies,9,,15,18,33
109 Gsies,10,,15,13,28
109 Gsies,11,,17,12,29
109 Gsies,12,,22,20,42
109 Gsies,13,,18,18,36
109 Gsies,14,,10,14,24
109 Gsies,15,,19,18,37
109 Gsies,16,,13,12,25
109 Gsies,17,,15,14,29
109 Gsies,18,,10,12,22
109 Gsies,19,,28,10,38
109 Gsies,20,,19,6,25
109 Gsies,21,,13,17,30
109 Gsies,22,,10,18,28
109 Gsies,23,,15,16,31
109 Gsies,24,,9,17,26
109 Gsies,25,,15,17,32
109 Gsies,26,,14,9,23
109 Gsies,27,,15,24,39
109 Gsies,28,,14,8,22
109 Gsies,29,,8,10,18
109 Gsies,30,,7,15,22
109 Gsies,31,,18,15,33
109 Gsies,32,,12,13,25
109 Gsies,33,,15,13,28
109 Gsies,34,,15,15,30
109 Gsies,35,,16,8,24
109 Gsies,36,,18,12,30
109 Gsies,37,,15,23,38
109 Gsies,38,,19,19,38
109 Gsies,39,,10,17,27
109 Gsies,40,,16,11,27
109 Gsies,41,,14,16,30
109 Gsies,42,,12,18,30
109 Gsies,43,,19,20,39
109 Gsies,44,,18,15,33
109 Gsies,45,,14,11,25
109 Gsies,46,,11,18,29
109 Gsies,47,,17,20,37
109 Gsies,48,,26,14,40
109 Gsies,49,,24,9,33
109 Gsies,50,,14,14,28
109 Gsies,51,,17,13,30
109 Gsies,52,,14,18,32
109 Gsies,53,,17,6,23
109 Gsies,54,,16,18,34
109 Gsies,55,,13,14,27
109 Gsies,56,,16,8,24
109 Gsies,57,,9,12,21
109 Gsies,58,,15,16,31
109 Gsies,59,,9,13,22
109 Gsies,60,,15,15,30
109 Gsies,61,,11,13,24
109 Gsies,62,,17,7,24
109 Gsies,63,,14,10,24
109 Gsies,64,,15,6,21
109 Gsies,65,,16,5,21
109 Gsies,66,,18,14,32
109 Gsies,67,,14,12,26
109 Gsies,68,,7,7,14
109 Gsies,69,,15,17,32
109 Gsies,70,,7,9,16
109 Gsies,71,,19,6,25
109 Gsies,72,,14,9,23
109 Gsies,73,,4,11,15
109 Gsies,74,,6,12,18
109 Gsies,75,,7,7,14
109 Gsies,76,,4,11,15
109 Gsies,77,,5,8,13
109 Gsies,78,,4,9,13
109 Gsies,79,,4,8,12
109 Gsies,80,,6,6,12
109 Gsies,81,,7,6,13
109 Gsies,82,,1,9,10
109 Gsies,83,,3,7,10
109 Gsies,84,,3,5,8
109 Gsies,85,,5,5,10
109 Gsies,86,,4,3,7
109 Gsies,87,,3,5,8
109 Gsies,88,,7,3,10
109 Gsies,89,,1,2,3
109 Gsies,90,,4,3,7
109 Gsies,91,,-,5,5
109 Gsies,92,,1,2,3
109 Gsies,93,,1,3,4
109 Gsies,94,,-,3,3
109 Gsies,95,,-,2,2
109 Gsies,96,,1,2,3
109 Gsies,97,,1,1,2
109 Gsies,98,,1,-,1
110 Vintl,0,,18,14,32
110 Vintl,1,,23,17,40
110 Vintl,2,,18,19,37
110 Vintl,3,,16,22,38
110 Vintl,4,,17,28,45
110 Vintl,5,,19,20,39
110 Vintl,6,,21,23,44
110 Vintl,7,,9,19,28
110 Vintl,8,,13,17,30
110 Vintl,9,,24,20,44
110 Vintl,10,,19,19,38
110 Vintl,11,,23,17,40
110 Vintl,12,,14,14,28
110 Vintl,13,,19,21,40
110 Vintl,14,,13,13,26
110 Vintl,15,,19,17,36
110 Vintl,16,,17,23,40
110 Vintl,17,,17,21,38
110 Vintl,18,,22,15,37
110 Vintl,19,,24,18,42
110 Vintl,20,,19,28,47
110 Vintl,21,,20,15,35
110 Vintl,22,,21,25,46
110 Vintl,23,,38,24,62
110 Vintl,24,,20,18,38
110 Vintl,25,,25,18,43
110 Vintl,26,,29,23,52
110 Vintl,27,,21,29,50
110 Vintl,28,,23,22,45
110 Vintl,29,,26,15,41
110 Vintl,30,,19,13,32
110 Vintl,31,,22,19,41
110 Vintl,32,,26,22,48
110 Vintl,33,,8,16,24
110 Vintl,34,,23,11,34
110 Vintl,35,,18,13,31
110 Vintl,36,,23,24,47
110 Vintl,37,,16,20,36
110 Vintl,38,,30,20,50
110 Vintl,39,,25,26,51
110 Vintl,40,,23,38,61
110 Vintl,41,,17,19,36
110 Vintl,42,,24,18,42
110 Vintl,43,,25,19,44
110 Vintl,44,,22,22,44
110 Vintl,45,,18,21,39
110 Vintl,46,,29,17,46
110 Vintl,47,,27,28,55
110 Vintl,48,,19,19,38
110 Vintl,49,,22,22,44
110 Vintl,50,,25,21,46
110 Vintl,51,,28,34,62
110 Vintl,52,,30,29,59
110 Vintl,53,,30,31,61
110 Vintl,54,,36,21,57
110 Vintl,55,,36,29,65
110 Vintl,56,,33,22,55
110 Vintl,57,,25,31,56
110 Vintl,58,,18,22,40
110 Vintl,59,,20,23,43
110 Vintl,60,,19,15,34
110 Vintl,61,,21,30,51
110 Vintl,62,,22,19,41
110 Vintl,63,,20,13,33
110 Vintl,64,,15,19,34
110 Vintl,65,,20,9,29
110 Vintl,66,,14,18,32
110 Vintl,67,,21,18,39
110 Vintl,68,,21,20,41
110 Vintl,69,,16,19,35
110 Vintl,70,,12,13,25
110 Vintl,71,,18,13,31
110 Vintl,72,,12,12,24
110 Vintl,73,,11,16,27
110 Vintl,74,,10,4,14
110 Vintl,75,,17,12,29
110 Vintl,76,,5,9,14
110 Vintl,77,,7,12,19
110 Vintl,78,,8,16,24
110 Vintl,79,,9,13,22
110 Vintl,80,,7,5,12
110 Vintl,81,,6,7,13
110 Vintl,82,,7,8,15
110 Vintl,83,,8,10,18
110 Vintl,84,,8,5,13
110 Vintl,85,,2,16,18
110 Vintl,86,,4,10,14
110 Vintl,87,,3,7,10
110 Vintl,88,,1,8,9
110 Vintl,89,,-,7,7
110 Vintl,90,,3,3,6
110 Vintl,91,,2,4,6
110 Vintl,92,,2,1,3
110 Vintl,93,,-,1,1
110 Vintl,94,,1,-,1
110 Vintl,95,,1,1,2
110 Vintl,96,,-,2,2
110 Vintl,97,,-,2,2
110 Vintl,98,,-,1,1
111 Vahrn,0,,20,22,42
111 Vahrn,1,,27,28,55
111 Vahrn,2,,32,28,60
111 Vahrn,3,,36,33,69
111 Vahrn,4,,28,27,55
111 Vahrn,5,,36,20,56
111 Vahrn,6,,34,28,62
111 Vahrn,7,,39,28,67
111 Vahrn,8,,24,30,54
111 Vahrn,9,,30,29,59
111 Vahrn,10,,29,26,55
111 Vahrn,11,,40,20,60
111 Vahrn,12,,34,34,68
111 Vahrn,13,,32,32,64
111 Vahrn,14,,28,29,57
111 Vahrn,15,,30,14,44
111 Vahrn,16,,27,30,57
111 Vahrn,17,,29,21,50
111 Vahrn,18,,28,22,50
111 Vahrn,19,,34,31,65
111 Vahrn,20,,22,27,49
111 Vahrn,21,,21,23,44
111 Vahrn,22,,35,16,51
111 Vahrn,23,,25,27,52
111 Vahrn,24,,21,25,46
111 Vahrn,25,,21,20,41
111 Vahrn,26,,23,35,58
111 Vahrn,27,,30,24,54
111 Vahrn,28,,29,38,67
111 Vahrn,29,,30,27,57
111 Vahrn,30,,32,22,54
111 Vahrn,31,,30,28,58
111 Vahrn,32,,29,24,53
111 Vahrn,33,,29,29,58
111 Vahrn,34,,23,22,45
111 Vahrn,35,,30,31,61
111 Vahrn,36,,32,39,71
111 Vahrn,37,,33,29,62
111 Vahrn,38,,31,28,59
111 Vahrn,39,,27,31,58
111 Vahrn,40,,36,38,74
111 Vahrn,41,,23,31,54
111 Vahrn,42,,39,27,66
111 Vahrn,43,,32,34,66
111 Vahrn,44,,35,43,78
111 Vahrn,45,,46,47,93
111 Vahrn,46,,35,44,79
111 Vahrn,47,,39,30,69
111 Vahrn,48,,51,45,96
111 Vahrn,49,,42,47,89
111 Vahrn,50,,39,37,76
111 Vahrn,51,,43,31,74
111 Vahrn,52,,35,30,65
111 Vahrn,53,,43,39,82
111 Vahrn,54,,40,39,79
111 Vahrn,55,,36,35,71
111 Vahrn,56,,25,36,61
111 Vahrn,57,,29,24,53
111 Vahrn,58,,32,29,61
111 Vahrn,59,,30,27,57
111 Vahrn,60,,19,20,39
111 Vahrn,61,,29,28,57
111 Vahrn,62,,21,22,43
111 Vahrn,63,,26,31,57
111 Vahrn,64,,24,35,59
111 Vahrn,65,,23,24,47
111 Vahrn,66,,20,13,33
111 Vahrn,67,,19,13,32
111 Vahrn,68,,21,21,42
111 Vahrn,69,,24,31,55
111 Vahrn,70,,17,16,33
111 Vahrn,71,,13,25,38
111 Vahrn,72,,19,19,38
111 Vahrn,73,,12,14,26
111 Vahrn,74,,12,20,32
111 Vahrn,75,,18,22,40
111 Vahrn,76,,13,23,36
111 Vahrn,77,,13,20,33
111 Vahrn,78,,17,15,32
111 Vahrn,79,,16,19,35
111 Vahrn,80,,12,9,21
111 Vahrn,81,,11,16,27
111 Vahrn,82,,6,14,20
111 Vahrn,83,,6,12,18
111 Vahrn,84,,11,11,22
111 Vahrn,85,,6,9,15
111 Vahrn,86,,3,6,9
111 Vahrn,87,,3,10,13
111 Vahrn,88,,5,4,9
111 Vahrn,89,,2,11,13
111 Vahrn,90,,2,5,7
111 Vahrn,91,,2,9,11
111 Vahrn,92,,1,2,3
111 Vahrn,93,,-,3,3
111 Vahrn,94,,2,1,3
111 Vahrn,95,,1,2,3
111 Vahrn,96,,-,1,1
112 Vöran,0,,8,3,11
112 Vöran,1,,9,8,17
112 Vöran,2,,6,7,13
112 Vöran,3,,5,3,8
112 Vöran,4,,6,9,15
112 Vöran,5,,4,5,9
112 Vöran,6,,10,6,16
112 Vöran,7,,2,3,5
112 Vöran,8,,9,6,15
112 Vöran,9,,5,6,11
112 Vöran,10,,8,3,11
112 Vöran,11,,4,5,9
112 Vöran,12,,9,3,12
112 Vöran,13,,3,5,8
112 Vöran,14,,3,5,8
112 Vöran,15,,9,5,14
112 Vöran,16,,5,7,12
112 Vöran,17,,9,4,13
112 Vöran,18,,11,5,16
112 Vöran,19,,5,3,8
112 Vöran,20,,6,4,10
112 Vöran,21,,11,7,18
112 Vöran,22,,11,6,17
112 Vöran,23,,5,8,13
112 Vöran,24,,7,6,13
112 Vöran,25,,7,5,12
112 Vöran,26,,5,4,9
112 Vöran,27,,5,6,11
112 Vöran,28,,6,4,10
112 Vöran,29,,10,8,18
112 Vöran,30,,6,5,11
112 Vöran,31,,10,7,17
112 Vöran,32,,5,8,13
112 Vöran,33,,6,7,13
112 Vöran,34,,6,3,9
112 Vöran,35,,2,5,7
112 Vöran,36,,6,10,16
112 Vöran,37,,7,9,16
112 Vöran,38,,6,3,9
112 Vöran,39,,2,5,7
112 Vöran,40,,7,7,14
112 Vöran,41,,7,6,13
112 Vöran,42,,4,6,10
112 Vöran,43,,9,5,14
112 Vöran,44,,14,11,25
112 Vöran,45,,6,6,12
112 Vöran,46,,8,8,16
112 Vöran,47,,6,10,16
112 Vöran,48,,7,6,13
112 Vöran,49,,7,4,11
112 Vöran,50,,13,4,17
112 Vöran,51,,5,7,12
112 Vöran,52,,7,6,13
112 Vöran,53,,4,5,9
112 Vöran,54,,11,4,15
112 Vöran,55,,7,9,16
112 Vöran,56,,12,14,26
112 Vöran,57,,3,5,8
112 Vöran,58,,6,6,12
112 Vöran,59,,4,7,11
112 Vöran,60,,6,5,11
112 Vöran,61,,6,10,16
112 Vöran,62,,2,2,4
112 Vöran,63,,4,3,7
112 Vöran,64,,5,5,10
112 Vöran,65,,5,4,9
112 Vöran,66,,9,2,11
112 Vöran,67,,2,-,2
112 Vöran,68,,7,4,11
112 Vöran,69,,7,5,12
112 Vöran,70,,4,3,7
112 Vöran,71,,5,2,7
112 Vöran,72,,4,2,6
112 Vöran,73,,-,4,4
112 Vöran,74,,4,1,5
112 Vöran,75,,2,5,7
112 Vöran,76,,4,3,7
112 Vöran,77,,5,5,10
112 Vöran,78,,1,3,4
112 Vöran,79,,1,2,3
112 Vöran,80,,4,3,7
112 Vöran,81,,2,2,4
112 Vöran,82,,2,5,7
112 Vöran,83,,2,-,2
112 Vöran,84,,1,5,6
112 Vöran,85,,4,4,8
112 Vöran,86,,-,1,1
112 Vöran,87,,1,-,1
112 Vöran,88,,1,1,2
112 Vöran,89,,1,1,2
112 Vöran,90,,1,-,1
112 Vöran,93,,-,1,1
112 Vöran,98,,-,1,1
113 Niederdorf,0,,10,3,13
113 Niederdorf,1,,12,10,22
113 Niederdorf,2,,5,10,15
113 Niederdorf,3,,9,8,17
113 Niederdorf,4,,9,6,15
113 Niederdorf,5,,13,9,22
113 Niederdorf,6,,9,7,16
113 Niederdorf,7,,12,7,19
113 Niederdorf,8,,10,6,16
113 Niederdorf,9,,14,8,22
113 Niederdorf,10,,9,8,17
113 Niederdorf,11,,10,11,21
113 Niederdorf,12,,10,8,18
113 Niederdorf,13,,15,8,23
113 Niederdorf,14,,11,16,27
113 Niederdorf,15,,6,16,22
113 Niederdorf,16,,8,13,21
113 Niederdorf,17,,10,10,20
113 Niederdorf,18,,15,11,26
113 Niederdorf,19,,8,6,14
113 Niederdorf,20,,9,13,22
113 Niederdorf,21,,10,8,18
113 Niederdorf,22,,5,9,14
113 Niederdorf,23,,7,11,18
113 Niederdorf,24,,14,8,22
113 Niederdorf,25,,8,8,16
113 Niederdorf,26,,8,10,18
113 Niederdorf,27,,9,9,18
113 Niederdorf,28,,17,11,28
113 Niederdorf,29,,6,6,12
113 Niederdorf,30,,10,10,20
113 Niederdorf,31,,5,10,15
113 Niederdorf,32,,7,9,16
113 Niederdorf,33,,15,6,21
113 Niederdorf,34,,11,2,13
113 Niederdorf,35,,5,9,14
113 Niederdorf,36,,6,17,23
113 Niederdorf,37,,9,4,13
113 Niederdorf,38,,9,5,14
113 Niederdorf,39,,14,10,24
113 Niederdorf,40,,5,6,11
113 Niederdorf,41,,8,10,18
113 Niederdorf,42,,10,8,18
113 Niederdorf,43,,7,11,18
113 Niederdorf,44,,10,5,15
113 Niederdorf,45,,12,13,25
113 Niederdorf,46,,20,10,30
113 Niederdorf,47,,8,16,24
113 Niederdorf,48,,9,10,19
113 Niederdorf,49,,24,17,41
113 Niederdorf,50,,13,11,24
113 Niederdorf,51,,18,17,35
113 Niederdorf,52,,24,13,37
113 Niederdorf,53,,17,13,30
113 Niederdorf,54,,15,17,32
113 Niederdorf,55,,14,9,23
113 Niederdorf,56,,24,9,33
113 Niederdorf,57,,11,11,22
113 Niederdorf,58,,8,10,18
113 Niederdorf,59,,14,12,26
113 Niederdorf,60,,7,5,12
113 Niederdorf,61,,9,10,19
113 Niederdorf,62,,7,11,18
113 Niederdorf,63,,9,6,15
113 Niederdorf,64,,10,8,18
113 Niederdorf,65,,8,4,12
113 Niederdorf,66,,9,5,14
113 Niederdorf,67,,2,1,3
113 Niederdorf,68,,5,6,11
113 Niederdorf,69,,9,4,13
113 Niederdorf,70,,5,9,14
113 Niederdorf,71,,5,6,11
113 Niederdorf,72,,8,7,15
113 Niederdorf,73,,3,7,10
113 Niederdorf,74,,6,5,11
113 Niederdorf,75,,4,8,12
113 Niederdorf,76,,5,5,10
113 Niederdorf,77,,3,5,8
113 Niederdorf,78,,3,7,10
113 Niederdorf,79,,1,4,5
113 Niederdorf,80,,7,4,11
113 Niederdorf,81,,5,7,12
113 Niederdorf,82,,3,10,13
113 Niederdorf,83,,3,4,7
113 Niederdorf,84,,3,13,16
113 Niederdorf,85,,3,5,8
113 Niederdorf,86,,5,2,7
113 Niederdorf,87,,4,4,8
113 Niederdorf,88,,2,5,7
113 Niederdorf,89,,1,8,9
113 Niederdorf,90,,-,2,2
113 Niederdorf,91,,-,2,2
113 Niederdorf,92,,-,3,3
113 Niederdorf,93,,1,-,1
113 Niederdorf,94,,1,2,3
113 Niederdorf,96,,1,1,2
113 Niederdorf,97,,-,1,1
114 Villanders,0,,13,7,20
114 Villanders,1,,8,10,18
114 Villanders,2,,7,7,14
114 Villanders,3,,8,7,15
114 Villanders,4,,8,10,18
114 Villanders,5,,8,9,17
114 Villanders,6,,11,11,22
114 Villanders,7,,5,5,10
114 Villanders,8,,15,6,21
114 Villanders,9,,12,8,20
114 Villanders,10,,6,9,15
114 Villanders,11,,14,14,28
114 Villanders,12,,13,15,28
114 Villanders,13,,17,7,24
114 Villanders,14,,13,14,27
114 Villanders,15,,5,12,17
114 Villanders,16,,9,10,19
114 Villanders,17,,13,12,25
114 Villanders,18,,11,16,27
114 Villanders,19,,14,12,26
114 Villanders,20,,11,8,19
114 Villanders,21,,10,10,20
114 Villanders,22,,16,7,23
114 Villanders,23,,18,5,23
114 Villanders,24,,13,13,26
114 Villanders,25,,8,14,22
114 Villanders,26,,14,9,23
114 Villanders,27,,16,18,34
114 Villanders,28,,18,14,32
114 Villanders,29,,11,9,20
114 Villanders,30,,10,12,22
114 Villanders,31,,8,9,17
114 Villanders,32,,9,11,20
114 Villanders,33,,8,8,16
114 Villanders,34,,13,13,26
114 Villanders,35,,15,5,20
114 Villanders,36,,16,13,29
114 Villanders,37,,19,10,29
114 Villanders,38,,9,16,25
114 Villanders,39,,11,5,16
114 Villanders,40,,11,8,19
114 Villanders,41,,16,11,27
114 Villanders,42,,11,5,16
114 Villanders,43,,13,10,23
114 Villanders,44,,15,11,26
114 Villanders,45,,10,14,24
114 Villanders,46,,14,24,38
114 Villanders,47,,16,18,34
114 Villanders,48,,16,10,26
114 Villanders,49,,26,17,43
114 Villanders,50,,21,15,36
114 Villanders,51,,19,13,32
114 Villanders,52,,19,17,36
114 Villanders,53,,19,18,37
114 Villanders,54,,19,17,36
114 Villanders,55,,14,12,26
114 Villanders,56,,18,12,30
114 Villanders,57,,12,11,23
114 Villanders,58,,16,6,22
114 Villanders,59,,14,10,24
114 Villanders,60,,15,9,24
114 Villanders,61,,9,7,16
114 Villanders,62,,10,6,16
114 Villanders,63,,10,17,27
114 Villanders,64,,6,7,13
114 Villanders,65,,10,11,21
114 Villanders,66,,11,7,18
114 Villanders,67,,10,7,17
114 Villanders,68,,10,8,18
114 Villanders,69,,8,5,13
114 Villanders,70,,5,11,16
114 Villanders,71,,6,7,13
114 Villanders,72,,7,10,17
114 Villanders,73,,6,2,8
114 Villanders,74,,3,9,12
114 Villanders,75,,6,8,14
114 Villanders,76,,6,8,14
114 Villanders,77,,6,9,15
114 Villanders,78,,8,10,18
114 Villanders,79,,5,4,9
114 Villanders,80,,4,4,8
114 Villanders,81,,3,7,10
114 Villanders,82,,5,6,11
114 Villanders,83,,2,5,7
114 Villanders,84,,1,7,8
114 Villanders,85,,5,7,12
114 Villanders,86,,5,7,12
114 Villanders,87,,2,8,10
114 Villanders,88,,3,1,4
114 Villanders,89,,3,5,8
114 Villanders,90,,1,2,3
114 Villanders,91,,-,2,2
114 Villanders,92,,1,2,3
114 Villanders,93,,-,3,3
114 Villanders,94,,2,-,2
114 Villanders,95,,-,1,1
114 Villanders,97,,-,1,1
115 Sterzing,0,,40,27,67
115 Sterzing,1,,35,36,71
115 Sterzing,2,,43,34,77
115 Sterzing,3,,34,32,66
115 Sterzing,4,,42,39,81
115 Sterzing,5,,31,35,66
115 Sterzing,6,,40,40,80
115 Sterzing,7,,34,30,64
115 Sterzing,8,,35,35,70
115 Sterzing,9,,36,30,66
115 Sterzing,10,,35,42,77
115 Sterzing,11,,34,35,69
115 Sterzing,12,,37,34,71
115 Sterzing,13,,31,32,63
115 Sterzing,14,,27,27,54
115 Sterzing,15,,34,35,69
115 Sterzing,16,,31,28,59
115 Sterzing,17,,32,33,65
115 Sterzing,18,,36,37,73
115 Sterzing,19,,31,23,54
115 Sterzing,20,,33,29,62
115 Sterzing,21,,38,42,80
115 Sterzing,22,,33,45,78
115 Sterzing,23,,45,35,80
115 Sterzing,24,,37,37,74
115 Sterzing,25,,59,36,95
115 Sterzing,26,,49,48,97
115 Sterzing,27,,52,39,91
115 Sterzing,28,,50,51,101
115 Sterzing,29,,66,41,107
115 Sterzing,30,,56,42,98
115 Sterzing,31,,52,41,93
115 Sterzing,32,,57,42,99
115 Sterzing,33,,43,42,85
115 Sterzing,34,,54,40,94
115 Sterzing,35,,52,49,101
115 Sterzing,36,,64,40,104
115 Sterzing,37,,63,43,106
115 Sterzing,38,,55,60,115
115 Sterzing,39,,50,52,102
115 Sterzing,40,,55,39,94
115 Sterzing,41,,45,33,78
115 Sterzing,42,,38,39,77
115 Sterzing,43,,51,49,100
115 Sterzing,44,,51,49,100
115 Sterzing,45,,61,70,131
115 Sterzing,46,,66,46,112
115 Sterzing,47,,48,54,102
115 Sterzing,48,,58,66,124
115 Sterzing,49,,45,40,85
115 Sterzing,50,,54,51,105
115 Sterzing,51,,60,53,113
115 Sterzing,52,,63,54,117
115 Sterzing,53,,56,50,106
115 Sterzing,54,,48,47,95
115 Sterzing,55,,53,50,103
115 Sterzing,56,,48,45,93
115 Sterzing,57,,36,38,74
115 Sterzing,58,,43,46,89
115 Sterzing,59,,56,43,99
115 Sterzing,60,,39,41,80
115 Sterzing,61,,33,46,79
115 Sterzing,62,,34,24,58
115 Sterzing,63,,35,46,81
115 Sterzing,64,,35,35,70
115 Sterzing,65,,28,43,71
115 Sterzing,66,,39,44,83
115 Sterzing,67,,30,42,72
115 Sterzing,68,,36,35,71
115 Sterzing,69,,36,44,80
115 Sterzing,70,,31,44,75
115 Sterzing,71,,23,29,52
115 Sterzing,72,,38,41,79
115 Sterzing,73,,27,38,65
115 Sterzing,74,,29,25,54
115 Sterzing,75,,34,47,81
115 Sterzing,76,,27,36,63
115 Sterzing,77,,27,28,55
115 Sterzing,78,,29,29,58
115 Sterzing,79,,23,31,54
115 Sterzing,80,,27,26,53
115 Sterzing,81,,18,30,48
115 Sterzing,82,,14,35,49
115 Sterzing,83,,13,18,31
115 Sterzing,84,,9,13,22
115 Sterzing,85,,17,21,38
115 Sterzing,86,,9,9,18
115 Sterzing,87,,12,22,34
115 Sterzing,88,,4,12,16
115 Sterzing,89,,5,6,11
115 Sterzing,90,,6,13,19
115 Sterzing,91,,7,8,15
115 Sterzing,92,,2,3,5
115 Sterzing,93,,1,7,8
115 Sterzing,94,,-,5,5
115 Sterzing,95,,3,5,8
115 Sterzing,96,,1,1,2
115 Sterzing,97,,1,2,3
115 Sterzing,98,,-,1,1
115 Sterzing,99,,-,2,2
116 Feldthurns,0,,25,28,53
116 Feldthurns,1,,25,25,50
116 Feldthurns,2,,21,24,45
116 Feldthurns,3,,23,21,44
116 Feldthurns,4,,18,15,33
116 Feldthurns,5,,22,18,40
116 Feldthurns,6,,19,15,34
116 Feldthurns,7,,15,15,30
116 Feldthurns,8,,27,19,46
116 Feldthurns,9,,15,13,28
116 Feldthurns,10,,15,20,35
116 Feldthurns,11,,24,18,42
116 Feldthurns,12,,26,20,46
116 Feldthurns,13,,26,15,41
116 Feldthurns,14,,23,16,39
116 Feldthurns,15,,11,13,24
116 Feldthurns,16,,21,22,43
116 Feldthurns,17,,15,19,34
116 Feldthurns,18,,24,14,38
116 Feldthurns,19,,18,24,42
116 Feldthurns,20,,23,19,42
116 Feldthurns,21,,22,19,41
116 Feldthurns,22,,20,17,37
116 Feldthurns,23,,19,17,36
116 Feldthurns,24,,15,18,33
116 Feldthurns,25,,32,19,51
116 Feldthurns,26,,20,23,43
116 Feldthurns,27,,10,14,24
116 Feldthurns,28,,16,19,35
116 Feldthurns,29,,20,21,41
116 Feldthurns,30,,17,18,35
116 Feldthurns,31,,20,12,32
116 Feldthurns,32,,21,20,41
116 Feldthurns,33,,19,22,41
116 Feldthurns,34,,17,19,36
116 Feldthurns,35,,26,14,40
116 Feldthurns,36,,13,17,30
116 Feldthurns,37,,26,24,50
116 Feldthurns,38,,13,25,38
116 Feldthurns,39,,10,21,31
116 Feldthurns,40,,34,23,57
116 Feldthurns,41,,23,17,40
116 Feldthurns,42,,24,25,49
116 Feldthurns,43,,24,15,39
116 Feldthurns,44,,28,24,52
116 Feldthurns,45,,20,19,39
116 Feldthurns,46,,29,22,51
116 Feldthurns,47,,19,24,43
116 Feldthurns,48,,18,22,40
116 Feldthurns,49,,26,26,52
116 Feldthurns,50,,20,27,47
116 Feldthurns,51,,23,23,46
116 Feldthurns,52,,19,21,40
116 Feldthurns,53,,28,26,54
116 Feldthurns,54,,20,18,38
116 Feldthurns,55,,30,19,49
116 Feldthurns,56,,15,19,34
116 Feldthurns,57,,18,18,36
116 Feldthurns,58,,17,13,30
116 Feldthurns,59,,15,16,31
116 Feldthurns,60,,10,18,28
116 Feldthurns,61,,14,11,25
116 Feldthurns,62,,11,21,32
116 Feldthurns,63,,12,14,26
116 Feldthurns,64,,14,14,28
116 Feldthurns,65,,15,12,27
116 Feldthurns,66,,22,14,36
116 Feldthurns,67,,12,11,23
116 Feldthurns,68,,14,13,27
116 Feldthurns,69,,5,13,18
116 Feldthurns,70,,13,11,24
116 Feldthurns,71,,14,8,22
116 Feldthurns,72,,11,8,19
116 Feldthurns,73,,7,11,18
116 Feldthurns,74,,16,10,26
116 Feldthurns,75,,9,11,20
116 Feldthurns,76,,8,6,14
116 Feldthurns,77,,4,3,7
116 Feldthurns,78,,8,6,14
116 Feldthurns,79,,6,11,17
116 Feldthurns,80,,11,6,17
116 Feldthurns,81,,3,7,10
116 Feldthurns,82,,5,7,12
116 Feldthurns,83,,8,9,17
116 Feldthurns,84,,2,4,6
116 Feldthurns,85,,5,4,9
116 Feldthurns,86,,4,6,10
116 Feldthurns,87,,4,5,9
116 Feldthurns,88,,3,11,14
116 Feldthurns,89,,1,8,9
116 Feldthurns,90,,5,4,9
116 Feldthurns,91,,-,2,2
116 Feldthurns,92,,-,1,1
116 Feldthurns,93,,-,4,4
116 Feldthurns,94,,-,4,4
116 Feldthurns,95,,2,-,2
116 Feldthurns,96,,-,2,2
116 Feldthurns,98,,-,1,1
117 Wengen,0,,7,5,12
117 Wengen,1,,7,11,18
117 Wengen,2,,9,10,19
117 Wengen,3,,7,6,13
117 Wengen,4,,7,9,16
117 Wengen,5,,9,8,17
117 Wengen,6,,12,11,23
117 Wengen,7,,11,3,14
117 Wengen,8,,12,16,28
117 Wengen,9,,7,8,15
117 Wengen,10,,7,10,17
117 Wengen,11,,10,12,22
117 Wengen,12,,9,10,19
117 Wengen,13,,10,5,15
117 Wengen,14,,5,9,14
117 Wengen,15,,5,6,11
117 Wengen,16,,10,4,14
117 Wengen,17,,5,10,15
117 Wengen,18,,8,6,14
117 Wengen,19,,9,7,16
117 Wengen,20,,7,7,14
117 Wengen,21,,14,10,24
117 Wengen,22,,10,9,19
117 Wengen,23,,12,9,21
117 Wengen,24,,11,7,18
117 Wengen,25,,10,6,16
117 Wengen,26,,10,10,20
117 Wengen,27,,17,9,26
117 Wengen,28,,16,8,24
117 Wengen,29,,4,7,11
117 Wengen,30,,4,14,18
117 Wengen,31,,8,5,13
117 Wengen,32,,9,8,17
117 Wengen,33,,8,4,12
117 Wengen,34,,9,10,19
117 Wengen,35,,14,4,18
117 Wengen,36,,14,8,22
117 Wengen,37,,6,6,12
117 Wengen,38,,9,15,24
117 Wengen,39,,13,5,18
117 Wengen,40,,4,6,10
117 Wengen,41,,8,7,15
117 Wengen,42,,6,5,11
117 Wengen,43,,18,11,29
117 Wengen,44,,11,5,16
117 Wengen,45,,14,9,23
117 Wengen,46,,14,10,24
117 Wengen,47,,12,14,26
117 Wengen,48,,13,12,25
117 Wengen,49,,7,9,16
117 Wengen,50,,16,9,25
117 Wengen,51,,10,13,23
117 Wengen,52,,11,5,16
117 Wengen,53,,8,10,18
117 Wengen,54,,12,7,19
117 Wengen,55,,14,13,27
117 Wengen,56,,14,8,22
117 Wengen,57,,7,10,17
117 Wengen,58,,10,12,22
117 Wengen,59,,7,6,13
117 Wengen,60,,6,7,13
117 Wengen,61,,6,12,18
117 Wengen,62,,5,6,11
117 Wengen,63,,7,6,13
117 Wengen,64,,9,5,14
117 Wengen,65,,6,2,8
117 Wengen,66,,4,5,9
117 Wengen,67,,7,5,12
117 Wengen,68,,2,6,8
117 Wengen,69,,4,8,12
117 Wengen,70,,1,12,13
117 Wengen,71,,7,3,10
117 Wengen,72,,4,4,8
117 Wengen,73,,5,3,8
117 Wengen,74,,5,8,13
117 Wengen,75,,3,6,9
117 Wengen,76,,7,7,14
117 Wengen,77,,4,4,8
117 Wengen,78,,5,6,11
117 Wengen,79,,6,4,10
117 Wengen,80,,5,3,8
117 Wengen,81,,7,7,14
117 Wengen,83,,2,6,8
117 Wengen,84,,2,6,8
117 Wengen,85,,3,2,5
117 Wengen,86,,-,4,4
117 Wengen,87,,3,1,4
117 Wengen,88,,2,2,4
117 Wengen,89,,2,4,6
117 Wengen,90,,1,2,3
117 Wengen,92,,-,1,1
117 Wengen,93,,-,1,1
117 Wengen,95,,-,2,2
117 Wengen,96,,2,1,3
117 Wengen,97,,-,3,3
118 U.L.Frau i.W.-St.Felix,0,,1,2,3
118 U.L.Frau i.W.-St.Felix,1,,5,3,8
118 U.L.Frau i.W.-St.Felix,2,,3,1,4
118 U.L.Frau i.W.-St.Felix,3,,6,8,14
118 U.L.Frau i.W.-St.Felix,4,,5,5,10
118 U.L.Frau i.W.-St.Felix,5,,4,2,6
118 U.L.Frau i.W.-St.Felix,6,,3,7,10
118 U.L.Frau i.W.-St.Felix,7,,3,2,5
118 U.L.Frau i.W.-St.Felix,8,,3,4,7
118 U.L.Frau i.W.-St.Felix,9,,6,3,9
118 U.L.Frau i.W.-St.Felix,10,,1,9,10
118 U.L.Frau i.W.-St.Felix,11,,3,-,3
118 U.L.Frau i.W.-St.Felix,12,,3,3,6
118 U.L.Frau i.W.-St.Felix,13,,5,7,12
118 U.L.Frau i.W.-St.Felix,14,,3,3,6
118 U.L.Frau i.W.-St.Felix,15,,8,6,14
118 U.L.Frau i.W.-St.Felix,16,,7,3,10
118 U.L.Frau i.W.-St.Felix,17,,9,4,13
118 U.L.Frau i.W.-St.Felix,18,,3,2,5
118 U.L.Frau i.W.-St.Felix,19,,5,5,10
118 U.L.Frau i.W.-St.Felix,20,,6,10,16
118 U.L.Frau i.W.-St.Felix,21,,5,4,9
118 U.L.Frau i.W.-St.Felix,22,,8,4,12
118 U.L.Frau i.W.-St.Felix,23,,3,10,13
118 U.L.Frau i.W.-St.Felix,24,,8,5,13
118 U.L.Frau i.W.-St.Felix,25,,8,2,10
118 U.L.Frau i.W.-St.Felix,26,,5,4,9
118 U.L.Frau i.W.-St.Felix,27,,7,6,13
118 U.L.Frau i.W.-St.Felix,28,,5,2,7
118 U.L.Frau i.W.-St.Felix,29,,5,3,8
118 U.L.Frau i.W.-St.Felix,30,,8,3,11
118 U.L.Frau i.W.-St.Felix,31,,4,5,9
118 U.L.Frau i.W.-St.Felix,32,,6,3,9
118 U.L.Frau i.W.-St.Felix,33,,7,1,8
118 U.L.Frau i.W.-St.Felix,34,,5,4,9
118 U.L.Frau i.W.-St.Felix,35,,1,9,10
118 U.L.Frau i.W.-St.Felix,36,,3,6,9
118 U.L.Frau i.W.-St.Felix,37,,4,1,5
118 U.L.Frau i.W.-St.Felix,38,,2,4,6
118 U.L.Frau i.W.-St.Felix,39,,1,3,4
118 U.L.Frau i.W.-St.Felix,40,,-,3,3
118 U.L.Frau i.W.-St.Felix,41,,4,3,7
118 U.L.Frau i.W.-St.Felix,42,,4,8,12
118 U.L.Frau i.W.-St.Felix,43,,7,1,8
118 U.L.Frau i.W.-St.Felix,44,,5,5,10
118 U.L.Frau i.W.-St.Felix,45,,2,2,4
118 U.L.Frau i.W.-St.Felix,46,,9,5,14
118 U.L.Frau i.W.-St.Felix,47,,4,5,9
118 U.L.Frau i.W.-St.Felix,48,,6,9,15
118 U.L.Frau i.W.-St.Felix,49,,6,4,10
118 U.L.Frau i.W.-St.Felix,50,,3,8,11
118 U.L.Frau i.W.-St.Felix,51,,3,4,7
118 U.L.Frau i.W.-St.Felix,52,,9,7,16
118 U.L.Frau i.W.-St.Felix,53,,9,7,16
118 U.L.Frau i.W.-St.Felix,54,,4,8,12
118 U.L.Frau i.W.-St.Felix,55,,16,8,24
118 U.L.Frau i.W.-St.Felix,56,,8,9,17
118 U.L.Frau i.W.-St.Felix,57,,4,4,8
118 U.L.Frau i.W.-St.Felix,58,,8,8,16
118 U.L.Frau i.W.-St.Felix,59,,5,4,9
118 U.L.Frau i.W.-St.Felix,60,,4,3,7
118 U.L.Frau i.W.-St.Felix,61,,3,6,9
118 U.L.Frau i.W.-St.Felix,62,,5,5,10
118 U.L.Frau i.W.-St.Felix,63,,3,4,7
118 U.L.Frau i.W.-St.Felix,64,,6,3,9
118 U.L.Frau i.W.-St.Felix,65,,2,3,5
118 U.L.Frau i.W.-St.Felix,66,,6,3,9
118 U.L.Frau i.W.-St.Felix,67,,6,3,9
118 U.L.Frau i.W.-St.Felix,68,,3,4,7
118 U.L.Frau i.W.-St.Felix,69,,4,-,4
118 U.L.Frau i.W.-St.Felix,70,,4,-,4
118 U.L.Frau i.W.-St.Felix,71,,1,7,8
118 U.L.Frau i.W.-St.Felix,72,,1,3,4
118 U.L.Frau i.W.-St.Felix,73,,2,1,3
118 U.L.Frau i.W.-St.Felix,74,,5,-,5
118 U.L.Frau i.W.-St.Felix,75,,5,4,9
118 U.L.Frau i.W.-St.Felix,76,,2,3,5
118 U.L.Frau i.W.-St.Felix,77,,3,7,10
118 U.L.Frau i.W.-St.Felix,78,,2,-,2
118 U.L.Frau i.W.-St.Felix,79,,1,3,4
118 U.L.Frau i.W.-St.Felix,80,,1,4,5
118 U.L.Frau i.W.-St.Felix,81,,3,-,3
118 U.L.Frau i.W.-St.Felix,82,,3,2,5
118 U.L.Frau i.W.-St.Felix,83,,2,3,5
118 U.L.Frau i.W.-St.Felix,84,,2,2,4
118 U.L.Frau i.W.-St.Felix,85,,2,2,4
118 U.L.Frau i.W.-St.Felix,86,,3,-,3
118 U.L.Frau i.W.-St.Felix,87,,2,-,2
118 U.L.Frau i.W.-St.Felix,88,,3,5,8
118 U.L.Frau i.W.-St.Felix,89,,-,1,1
118 U.L.Frau i.W.-St.Felix,90,,-,2,2
118 U.L.Frau i.W.-St.Felix,91,,-,2,2
118 U.L.Frau i.W.-St.Felix,92,,-,1,1
118 U.L.Frau i.W.-St.Felix,93,,-,1,1
118 U.L.Frau i.W.-St.Felix,94,,-,1,1
118 U.L.Frau i.W.-St.Felix,95,,-,2,2
118 U.L.Frau i.W.-St.Felix,101,,-,1,1
